time,subj_course_id,sec_code,sec_id,prof,available,waitlist,total,enrolled_ct
1746530278463,AESE 279B,A00,891859,Staff,13,0,35,22
1746530279494,AIP 197,001,891854,Vespa; Emanuel Ignacio,9999,0,9999,0
1746530280523,ANTH 289S,A00,891856,Gagneux; Pascal,12,0,12,0
1746530281562,BENG 196,001,957946,Engler; Adam J.,9996,0,9999,3
1746530282591,BISP 197,001,959851,Wilhelm; James E.,9999,0,9999,0
1746530283626,CAT 124RS,A01,956906,Staff,6,0,25,19
1746530284659,CAT 125RS,A01,922013,Staff,6,0,25,19
1746530285691,CLRE 250,A00,891860,Morris; Sheldon,9995,0,9999,4
1746530287762,CLRE 251R,A00,907817,Mehta; Ravindra L.,9994,0,9999,5
1746530288793,CLRE 252,A00,891864,Cuomo; Raphael Eduardo,9993,0,9999,6
1746530289824,CLRE 253,A00,891867,Vaida; Florin,9994,0,9999,5
1746530289824,CLRE 253,B00,907819,Staff,9999,0,9999,0
1746530290853,CLRE 259,A00,891868,Patel; Hemal,9998,0,9999,1
1746530291884,CLRE 260,A00,891872,Cuomo; Raphael Eduardo,9999,0,9999,0
1746530292911,CLRE 297,001,891888,Cuomo; Raphael Eduardo,9999,0,9999,0
1746530293942,CSE 191,A00,958773,Minnes Kemp; Mor Mia,9996,0,9999,3
1746530294973,CSE 197,001,959846,Minnes Kemp; Mor Mia,9993,0,9999,6
1746530296011,CSS 201S,A01,892054,Mignozzetti; Umberto,26,0,30,4
1746530297045,CSS 202S,A01,892056,Mignozzetti; Umberto,26,0,30,4
1746530298076,DSC 197,001,956898,Eldridge; Justin Matthew,9998,0,9999,1
1746530299107,DSC 297,001,958000,Mazumdar; Arya,9998,0,9999,1
1746530299107,DSC 297,002,959862,Wang; Yusu,9999,0,9999,0
1746530300138,EAP 100,A00,905686,Staff,9778,0,9999,221
1746530301170,ECE 45,A01,892618,Staff,0,0,65,65
1746530303235,ECE 111,A01,892719,Staff,4,0,65,61
1746530304264,ECE 197,001,957920,Mercier; Patrick Philip,9991,0,9999,8
1746530305297,ECON 178,A01,907814,Zhu; Ying,26,0,35,9
1746530306326,EDS 115,A00,895312,Staff,36,0,45,9
1746530307354,EDS 117,A01,895337,Staff,24,0,30,6
1746530308380,EDS 125,A00,895341,Jones; Gabrielle Anastasia,37,0,45,8
1746530309414,EDS 128A,A01,895459,Fargason; Sharon Gayle,44,0,45,1
1746530310444,EDS 128B,A01,895543,Pappas; Elizabeth,44,0,45,1
1746530311473,EDS 139,A00,897203,Pappas; Elizabeth,44,0,45,1
1746530311473,EDS 139,B00,897209,Fargason; Sharon Gayle,41,0,45,4
1746530312507,EDS 201,A00,895545,Staff,23,0,45,22
1746530313541,EDS 203,A01,895581,Halter; Christopher P.,23,0,45,22
1746530314574,EDS 204R,A01,895625,Heinzman; Erica M.,39,0,45,6
1746530314574,EDS 204R,B01,895693,Halter; Christopher P.,10,0,45,35
1746530315604,EDS 206R,A00,895694,Fargason; Sharon Gayle,1,0,30,29
1746530315604,EDS 206R,B00,895695,Choi; Bailey Miyeon,16,0,30,14
1746530316635,EDS 250,A00,895697,Hemans; Patricia Ann Benitez,23,0,45,22
1746530317665,EDS 281,A00,895701,Meyerott; Theresa Ann,1,0,15,14
1746530318698,EDS 284,A00,895736,Meyerott; Theresa Ann,1,0,15,14
1746530319728,EDS 286,A00,897210,Fine; Sarah,0,0,15,15
1746530320764,EDS 289C,A01,895770,Daly; Alan J.,15,0,15,0
1746530321799,EDS 290,A00,897211,Hofstetter; Carolyn,0,0,15,15
1746530322830,LIGM 5A,A00,896162,Fischer-Grunski; Eva K,13,0,20,7
1746530323867,LIGM 5B,A00,896260,Fischer-Grunski; Eva K,17,0,20,3
1746530324906,LIGM 5C,A00,896308,Fischer-Grunski; Eva K,18,0,20,2
1746530325946,LIIT 5AS,A00,896313,Carnelos; Chiara,18,0,20,2
1746530326976,LIIT 5BS,A00,896416,Carnelos; Chiara,20,0,20,0
1746530328005,LIIT 5CS,A00,896564,Carnelos; Chiara,20,0,20,0
1746530329036,LISP 5A,A00,896588,Munoz Sanchez; Alicia,3,0,20,17
1746530330066,LISP 5B,A00,896653,Munoz Sanchez; Alicia,7,0,20,13
1746530331107,LISP 5C,A00,896655,Munoz Sanchez; Alicia,0,1,20,20
1746530332136,MAE 197,001,957918,Kleissl; Jan,9996,0,9999,3
1746530332136,MAE 197,002,959806,Boechler; Nicholas Sebastia,9998,0,9999,1
1746530332136,MAE 197,003,959852,Mullin; Jennifer S,9999,0,9999,0
1746530333166,MATH 2,A01,957937,Staff,33,0,35,2
1746530334199,MATH 197,001,957876,Kedlaya; Kiran S.,9993,0,9999,6
1746530335231,MCWP 40,A00,892729,Duru; Nur,10,0,20,10
1746530335231,MCWP 40,B00,893304,Montejo; Carolina,14,0,20,6
1746530336258,MCWP 40R,A00,893757,Redela; Pamela Morgan,0,5,20,20
1746530337290,MCWP 50,A00,893758,Morshed; Michael James,0,0,20,20
1746530337290,MCWP 50,B00,893761,Bartulis; Jason Michael,17,0,20,3
1746530338323,MCWP 50R,A00,893766,Compas; Sean Matthew,0,1,20,20
1746530338323,MCWP 50R,B00,893769,Carter; Jennifer A,0,1,20,20
1746530338323,MCWP 50R,C00,893771,Krone; Jarret,0,3,20,20
1746530338323,MCWP 50R,D00,893772,Miller; Elizabeth Deen,0,0,20,20
1746530338323,MCWP 50R,E00,893775,Carter; Andrea L,0,1,20,20
1746530339356,MMW 11R,A01,892721,Herbst; Matthew,11,0,27,16
1746530339356,MMW 11R,A02,892722,Herbst; Matthew,0,0,0,3
1746530340387,MMW 12R,A01,892724,Herbst; Matthew,0,11,16,16
1746530340387,MMW 12R,A02,892725,Herbst; Matthew,0,10,16,16
1746530341413,MMW 13R,A01,892727,Staff,0,4,16,16
1746530341413,MMW 13R,A02,892728,Staff,0,4,16,16
1746530341413,MMW 13R,A03,958032,Staff,0,4,16,16
1746530341413,MMW 13R,A04,958033,Staff,0,4,16,16
1746530341413,MMW 13R,A05,958034,Staff,0,4,16,16
1746530342448,SIO 295LS,A00,894015,Staff,5,0,25,20
1746530343478,SIO 295S,A00,894020,Staff,5,0,25,20
1746530344509,SIOC 290S,B01,958918,Merrifield; Mark A,14,0,30,16
1746530345545,SIOC 291S,B01,958922,Gabriel; Corey John,14,0,30,16
1746530346580,SOCI 117,A01,895339,Staff,3,0,5,2
1746530347608,WES 237B,A00,894149,Staff,11,0,20,9
1746530349725,AESE 279B,A00,891859,Staff,13,0,35,22
1746530350754,AIP 197,001,891854,Vespa; Emanuel Ignacio,9999,0,9999,0
1746530351781,ANTH 289S,A00,891856,Gagneux; Pascal,12,0,12,0
1746530352812,BENG 196,001,957946,Engler; Adam J.,9996,0,9999,3
1746530353840,BISP 197,001,959851,Wilhelm; James E.,9999,0,9999,0
1746530354870,CAT 124RS,A01,956906,Staff,6,0,25,19
1746530355900,CAT 125RS,A01,922013,Staff,6,0,25,19
1746530356927,CLRE 250,A00,891860,Morris; Sheldon,9995,0,9999,4
1746530358993,CLRE 251R,A00,907817,Mehta; Ravindra L.,9994,0,9999,5
1746530360034,CLRE 252,A00,891864,Cuomo; Raphael Eduardo,9993,0,9999,6
1746530361065,CLRE 253,A00,891867,Vaida; Florin,9994,0,9999,5
1746530361065,CLRE 253,B00,907819,Staff,9999,0,9999,0
1746530362095,CLRE 259,A00,891868,Patel; Hemal,9998,0,9999,1
1746530363124,CLRE 260,A00,891872,Cuomo; Raphael Eduardo,9999,0,9999,0
1746530364151,CLRE 297,001,891888,Cuomo; Raphael Eduardo,9999,0,9999,0
1746530365180,CSE 191,A00,958773,Minnes Kemp; Mor Mia,9996,0,9999,3
1746530366211,CSE 197,001,959846,Minnes Kemp; Mor Mia,9993,0,9999,6
1746530367247,CSS 201S,A01,892054,Mignozzetti; Umberto,26,0,30,4
1746530368281,CSS 202S,A01,892056,Mignozzetti; Umberto,26,0,30,4
1746530369311,DSC 197,001,956898,Eldridge; Justin Matthew,9998,0,9999,1
1746530370342,DSC 297,001,958000,Mazumdar; Arya,9998,0,9999,1
1746530370342,DSC 297,002,959862,Wang; Yusu,9999,0,9999,0
1746530371368,EAP 100,A00,905686,Staff,9778,0,9999,221
1746530372398,ECE 45,A01,892618,Staff,0,0,65,65
1746530374456,ECE 111,A01,892719,Staff,4,0,65,61
1746530375489,ECE 197,001,957920,Mercier; Patrick Philip,9991,0,9999,8
1746530376519,ECON 178,A01,907814,Zhu; Ying,26,0,35,9
1746530377550,EDS 115,A00,895312,Staff,36,0,45,9
1746530378585,EDS 117,A01,895337,Staff,24,0,30,6
1746530379617,EDS 125,A00,895341,Jones; Gabrielle Anastasia,37,0,45,8
1746530380643,EDS 128A,A01,895459,Fargason; Sharon Gayle,44,0,45,1
1746530381672,EDS 128B,A01,895543,Pappas; Elizabeth,44,0,45,1
1746530382702,EDS 139,A00,897203,Pappas; Elizabeth,44,0,45,1
1746530382702,EDS 139,B00,897209,Fargason; Sharon Gayle,41,0,45,4
1746530383730,EDS 201,A00,895545,Staff,23,0,45,22
1746530384757,EDS 203,A01,895581,Halter; Christopher P.,23,0,45,22
1746530385789,EDS 204R,A01,895625,Heinzman; Erica M.,39,0,45,6
1746530385789,EDS 204R,B01,895693,Halter; Christopher P.,10,0,45,35
1746530386820,EDS 206R,A00,895694,Fargason; Sharon Gayle,1,0,30,29
1746530386820,EDS 206R,B00,895695,Choi; Bailey Miyeon,16,0,30,14
1746530387847,EDS 250,A00,895697,Hemans; Patricia Ann Benitez,23,0,45,22
1746530388875,EDS 281,A00,895701,Meyerott; Theresa Ann,1,0,15,14
1746530389905,EDS 284,A00,895736,Meyerott; Theresa Ann,1,0,15,14
1746530390934,EDS 286,A00,897210,Fine; Sarah,0,0,15,15
1746530391961,EDS 289C,A01,895770,Daly; Alan J.,15,0,15,0
1746530392991,EDS 290,A00,897211,Hofstetter; Carolyn,0,0,15,15
1746530394020,LIGM 5A,A00,896162,Fischer-Grunski; Eva K,13,0,20,7
1746530395050,LIGM 5B,A00,896260,Fischer-Grunski; Eva K,17,0,20,3
1746530396080,LIGM 5C,A00,896308,Fischer-Grunski; Eva K,18,0,20,2
1746530397114,LIIT 5AS,A00,896313,Carnelos; Chiara,18,0,20,2
1746530398142,LIIT 5BS,A00,896416,Carnelos; Chiara,20,0,20,0
1746530399168,LIIT 5CS,A00,896564,Carnelos; Chiara,20,0,20,0
1746530400196,LISP 5A,A00,896588,Munoz Sanchez; Alicia,3,0,20,17
1746530401232,LISP 5B,A00,896653,Munoz Sanchez; Alicia,7,0,20,13
1746530402265,LISP 5C,A00,896655,Munoz Sanchez; Alicia,0,1,20,20
1746530403298,MAE 197,001,957918,Kleissl; Jan,9996,0,9999,3
1746530403298,MAE 197,002,959806,Boechler; Nicholas Sebastia,9998,0,9999,1
1746530403298,MAE 197,003,959852,Mullin; Jennifer S,9999,0,9999,0
1746530404324,MATH 2,A01,957937,Staff,33,0,35,2
1746530405358,MATH 197,001,957876,Kedlaya; Kiran S.,9993,0,9999,6
1746530406387,MCWP 40,A00,892729,Duru; Nur,10,0,20,10
1746530406387,MCWP 40,B00,893304,Montejo; Carolina,14,0,20,6
1746530407417,MCWP 40R,A00,893757,Redela; Pamela Morgan,0,5,20,20
1746530408444,MCWP 50,A00,893758,Morshed; Michael James,0,0,20,20
1746530408444,MCWP 50,B00,893761,Bartulis; Jason Michael,17,0,20,3
1746530409472,MCWP 50R,A00,893766,Compas; Sean Matthew,0,1,20,20
1746530409472,MCWP 50R,B00,893769,Carter; Jennifer A,0,1,20,20
1746530409472,MCWP 50R,C00,893771,Krone; Jarret,0,3,20,20
1746530409472,MCWP 50R,D00,893772,Miller; Elizabeth Deen,0,0,20,20
1746530409472,MCWP 50R,E00,893775,Carter; Andrea L,0,1,20,20
1746530410504,MMW 11R,A01,892721,Herbst; Matthew,11,0,27,16
1746530410504,MMW 11R,A02,892722,Herbst; Matthew,0,0,0,3
1746530411532,MMW 12R,A01,892724,Herbst; Matthew,0,11,16,16
1746530411532,MMW 12R,A02,892725,Herbst; Matthew,0,10,16,16
1746530412562,MMW 13R,A01,892727,Staff,0,4,16,16
1746530412562,MMW 13R,A02,892728,Staff,0,4,16,16
1746530412562,MMW 13R,A03,958032,Staff,0,4,16,16
1746530412562,MMW 13R,A04,958033,Staff,0,4,16,16
1746530412562,MMW 13R,A05,958034,Staff,0,4,16,16
1746530413589,SIO 295LS,A00,894015,Staff,5,0,25,20
1746530414620,SIO 295S,A00,894020,Staff,5,0,25,20
1746530415655,SIOC 290S,B01,958918,Merrifield; Mark A,14,0,30,16
1746530416690,SIOC 291S,B01,958922,Gabriel; Corey John,14,0,30,16
1746530417718,SOCI 117,A01,895339,Staff,3,0,5,2
1746530418748,WES 237B,A00,894149,Staff,11,0,20,9
1746530420833,AESE 279B,A00,891859,Staff,13,0,35,22
1746530421862,AIP 197,001,891854,Vespa; Emanuel Ignacio,9999,0,9999,0
1746530422887,ANTH 289S,A00,891856,Gagneux; Pascal,12,0,12,0
1746530423917,BENG 196,001,957946,Engler; Adam J.,9996,0,9999,3
1746530424949,BISP 197,001,959851,Wilhelm; James E.,9999,0,9999,0
1746530425979,CAT 124RS,A01,956906,Staff,6,0,25,19
1746530427009,CAT 125RS,A01,922013,Staff,6,0,25,19
1746530428036,CLRE 250,A00,891860,Morris; Sheldon,9995,0,9999,4
1746530430100,CLRE 251R,A00,907817,Mehta; Ravindra L.,9994,0,9999,5
1746530431132,CLRE 252,A00,891864,Cuomo; Raphael Eduardo,9993,0,9999,6
1746530432166,CLRE 253,A00,891867,Vaida; Florin,9994,0,9999,5
1746530432166,CLRE 253,B00,907819,Staff,9999,0,9999,0
1746530433195,CLRE 259,A00,891868,Patel; Hemal,9998,0,9999,1
1746530434224,CLRE 260,A00,891872,Cuomo; Raphael Eduardo,9999,0,9999,0
1746530435253,CLRE 297,001,891888,Cuomo; Raphael Eduardo,9999,0,9999,0
1746530436285,CSE 191,A00,958773,Minnes Kemp; Mor Mia,9996,0,9999,3
1746530437314,CSE 197,001,959846,Minnes Kemp; Mor Mia,9993,0,9999,6
1746530438341,CSS 201S,A01,892054,Mignozzetti; Umberto,26,0,30,4
1746530439373,CSS 202S,A01,892056,Mignozzetti; Umberto,26,0,30,4
1746530440396,DSC 197,001,956898,Eldridge; Justin Matthew,9998,0,9999,1
1746530441433,DSC 297,001,958000,Mazumdar; Arya,9998,0,9999,1
1746530441433,DSC 297,002,959862,Wang; Yusu,9999,0,9999,0
1746530442460,EAP 100,A00,905686,Staff,9778,0,9999,221
1746530443489,ECE 45,A01,892618,Staff,0,0,65,65
1746530445555,ECE 111,A01,892719,Staff,4,0,65,61
1746530446583,ECE 197,001,957920,Mercier; Patrick Philip,9991,0,9999,8
1746530447611,ECON 178,A01,907814,Zhu; Ying,26,0,35,9
1746530448638,EDS 115,A00,895312,Staff,36,0,45,9
1746530449667,EDS 117,A01,895337,Staff,24,0,30,6
1746530450693,EDS 125,A00,895341,Jones; Gabrielle Anastasia,37,0,45,8
1746530451721,EDS 128A,A01,895459,Fargason; Sharon Gayle,44,0,45,1
1746530452749,EDS 128B,A01,895543,Pappas; Elizabeth,44,0,45,1
1746530453777,EDS 139,A00,897203,Pappas; Elizabeth,44,0,45,1
1746530453777,EDS 139,B00,897209,Fargason; Sharon Gayle,41,0,45,4
1746530454805,EDS 201,A00,895545,Staff,23,0,45,22
1746530455836,EDS 203,A01,895581,Halter; Christopher P.,23,0,45,22
1746530456862,EDS 204R,A01,895625,Heinzman; Erica M.,39,0,45,6
1746530456862,EDS 204R,B01,895693,Halter; Christopher P.,10,0,45,35
1746530457891,EDS 206R,A00,895694,Fargason; Sharon Gayle,1,0,30,29
1746530457891,EDS 206R,B00,895695,Choi; Bailey Miyeon,16,0,30,14
1746530458918,EDS 250,A00,895697,Hemans; Patricia Ann Benitez,23,0,45,22
1746530459946,EDS 281,A00,895701,Meyerott; Theresa Ann,1,0,15,14
1746530460978,EDS 284,A00,895736,Meyerott; Theresa Ann,1,0,15,14
1746530462007,EDS 286,A00,897210,Fine; Sarah,0,0,15,15
1746530463039,EDS 289C,A01,895770,Daly; Alan J.,15,0,15,0
1746530464070,EDS 290,A00,897211,Hofstetter; Carolyn,0,0,15,15
1746530465099,LIGM 5A,A00,896162,Fischer-Grunski; Eva K,13,0,20,7
1746530466129,LIGM 5B,A00,896260,Fischer-Grunski; Eva K,17,0,20,3
1746530467159,LIGM 5C,A00,896308,Fischer-Grunski; Eva K,18,0,20,2
1746530468188,LIIT 5AS,A00,896313,Carnelos; Chiara,18,0,20,2
1746530469225,LIIT 5BS,A00,896416,Carnelos; Chiara,20,0,20,0
1746530470252,LIIT 5CS,A00,896564,Carnelos; Chiara,20,0,20,0
1746530471278,LISP 5A,A00,896588,Munoz Sanchez; Alicia,3,0,20,17
1746530472310,LISP 5B,A00,896653,Munoz Sanchez; Alicia,7,0,20,13
1746530473342,LISP 5C,A00,896655,Munoz Sanchez; Alicia,0,1,20,20
1746530474374,MAE 197,001,957918,Kleissl; Jan,9996,0,9999,3
1746530474374,MAE 197,002,959806,Boechler; Nicholas Sebastia,9998,0,9999,1
1746530474374,MAE 197,003,959852,Mullin; Jennifer S,9999,0,9999,0
1746530475403,MATH 2,A01,957937,Staff,33,0,35,2
1746530476431,MATH 197,001,957876,Kedlaya; Kiran S.,9993,0,9999,6
1746530477463,MCWP 40,A00,892729,Duru; Nur,10,0,20,10
1746530477463,MCWP 40,B00,893304,Montejo; Carolina,14,0,20,6
1746530478494,MCWP 40R,A00,893757,Redela; Pamela Morgan,0,5,20,20
1746530479526,MCWP 50,A00,893758,Morshed; Michael James,0,0,20,20
1746530479526,MCWP 50,B00,893761,Bartulis; Jason Michael,17,0,20,3
1746530480559,MCWP 50R,A00,893766,Compas; Sean Matthew,0,1,20,20
1746530480559,MCWP 50R,B00,893769,Carter; Jennifer A,0,1,20,20
1746530480559,MCWP 50R,C00,893771,Krone; Jarret,0,3,20,20
1746530480559,MCWP 50R,D00,893772,Miller; Elizabeth Deen,0,0,20,20
1746530480559,MCWP 50R,E00,893775,Carter; Andrea L,0,1,20,20
1746530481590,MMW 11R,A01,892721,Herbst; Matthew,11,0,27,16
1746530481590,MMW 11R,A02,892722,Herbst; Matthew,0,0,0,3
1746530482614,MMW 12R,A01,892724,Herbst; Matthew,0,11,16,16
1746530482614,MMW 12R,A02,892725,Herbst; Matthew,0,10,16,16
1746530483641,MMW 13R,A01,892727,Staff,0,4,16,16
1746530483641,MMW 13R,A02,892728,Staff,0,4,16,16
1746530483641,MMW 13R,A03,958032,Staff,0,4,16,16
1746530483641,MMW 13R,A04,958033,Staff,0,4,16,16
1746530483641,MMW 13R,A05,958034,Staff,0,4,16,16
1746530484668,SIO 295LS,A00,894015,Staff,5,0,25,20
1746530485699,SIO 295S,A00,894020,Staff,5,0,25,20
1746530486731,SIOC 290S,B01,958918,Merrifield; Mark A,14,0,30,16
1746530487760,SIOC 291S,B01,958922,Gabriel; Corey John,14,0,30,16
1746530488787,SOCI 117,A01,895339,Staff,3,0,5,2
1746530489817,WES 237B,A00,894149,Staff,11,0,20,9
1746530491877,AESE 279B,A00,891859,Staff,13,0,35,22
1746530492906,AIP 197,001,891854,Vespa; Emanuel Ignacio,9999,0,9999,0
1746530493935,ANTH 289S,A00,891856,Gagneux; Pascal,12,0,12,0
1746530494964,BENG 196,001,957946,Engler; Adam J.,9996,0,9999,3
1746530495993,BISP 197,001,959851,Wilhelm; James E.,9999,0,9999,0
1746530497025,CAT 124RS,A01,956906,Staff,6,0,25,19
1746530498054,CAT 125RS,A01,922013,Staff,6,0,25,19
1746530499084,CLRE 250,A00,891860,Morris; Sheldon,9995,0,9999,4
1746530501148,CLRE 251R,A00,907817,Mehta; Ravindra L.,9994,0,9999,5
1746530502178,CLRE 252,A00,891864,Cuomo; Raphael Eduardo,9993,0,9999,6
1746530503203,CLRE 253,A00,891867,Vaida; Florin,9994,0,9999,5
1746530503203,CLRE 253,B00,907819,Staff,9999,0,9999,0
1746530504232,CLRE 259,A00,891868,Patel; Hemal,9998,0,9999,1
1746530505262,CLRE 260,A00,891872,Cuomo; Raphael Eduardo,9999,0,9999,0
1746530506294,CLRE 297,001,891888,Cuomo; Raphael Eduardo,9999,0,9999,0
1746530507320,CSE 191,A00,958773,Minnes Kemp; Mor Mia,9996,0,9999,3
1746530508346,CSE 197,001,959846,Minnes Kemp; Mor Mia,9993,0,9999,6
1746530509378,CSS 201S,A01,892054,Mignozzetti; Umberto,26,0,30,4
1746530510408,CSS 202S,A01,892056,Mignozzetti; Umberto,26,0,30,4
1746530511438,DSC 197,001,956898,Eldridge; Justin Matthew,9998,0,9999,1
1746530512470,DSC 297,001,958000,Mazumdar; Arya,9998,0,9999,1
1746530512470,DSC 297,002,959862,Wang; Yusu,9999,0,9999,0
1746530513499,EAP 100,A00,905686,Staff,9778,0,9999,221
1746530514534,ECE 45,A01,892618,Staff,0,0,65,65
1746530516593,ECE 111,A01,892719,Staff,4,0,65,61
1746530517622,ECE 197,001,957920,Mercier; Patrick Philip,9991,0,9999,8
1746530518651,ECON 178,A01,907814,Zhu; Ying,26,0,35,9
1746530519681,EDS 115,A00,895312,Staff,36,0,45,9
1746530520708,EDS 117,A01,895337,Staff,24,0,30,6
1746530521735,EDS 125,A00,895341,Jones; Gabrielle Anastasia,37,0,45,8
1746530522767,EDS 128A,A01,895459,Fargason; Sharon Gayle,44,0,45,1
1746530523802,EDS 128B,A01,895543,Pappas; Elizabeth,44,0,45,1
1746530524831,EDS 139,A00,897203,Pappas; Elizabeth,44,0,45,1
1746530524831,EDS 139,B00,897209,Fargason; Sharon Gayle,41,0,45,4
1746530525856,EDS 201,A00,895545,Staff,23,0,45,22
1746530526886,EDS 203,A01,895581,Halter; Christopher P.,23,0,45,22
1746530527918,EDS 204R,A01,895625,Heinzman; Erica M.,39,0,45,6
1746530527918,EDS 204R,B01,895693,Halter; Christopher P.,10,0,45,35
1746530528946,EDS 206R,A00,895694,Fargason; Sharon Gayle,1,0,30,29
1746530528946,EDS 206R,B00,895695,Choi; Bailey Miyeon,16,0,30,14
1746530529983,EDS 250,A00,895697,Hemans; Patricia Ann Benitez,23,0,45,22
1746530531010,EDS 281,A00,895701,Meyerott; Theresa Ann,1,0,15,14
1746530532042,EDS 284,A00,895736,Meyerott; Theresa Ann,1,0,15,14
1746530533072,EDS 286,A00,897210,Fine; Sarah,0,0,15,15
1746530534098,EDS 289C,A01,895770,Daly; Alan J.,15,0,15,0
1746530535128,EDS 290,A00,897211,Hofstetter; Carolyn,0,0,15,15
1746530536158,LIGM 5A,A00,896162,Fischer-Grunski; Eva K,13,0,20,7
1746530537183,LIGM 5B,A00,896260,Fischer-Grunski; Eva K,17,0,20,3
1746530538211,LIGM 5C,A00,896308,Fischer-Grunski; Eva K,18,0,20,2
1746530539238,LIIT 5AS,A00,896313,Carnelos; Chiara,18,0,20,2
1746530540264,LIIT 5BS,A00,896416,Carnelos; Chiara,20,0,20,0
1746530541296,LIIT 5CS,A00,896564,Carnelos; Chiara,20,0,20,0
1746530542322,LISP 5A,A00,896588,Munoz Sanchez; Alicia,3,0,20,17
1746530543351,LISP 5B,A00,896653,Munoz Sanchez; Alicia,7,0,20,13
1746530544383,LISP 5C,A00,896655,Munoz Sanchez; Alicia,0,1,20,20
1746530545414,MAE 197,001,957918,Kleissl; Jan,9996,0,9999,3
1746530545414,MAE 197,002,959806,Boechler; Nicholas Sebastia,9998,0,9999,1
1746530545414,MAE 197,003,959852,Mullin; Jennifer S,9999,0,9999,0
1746530546445,MATH 2,A01,957937,Staff,33,0,35,2
1746530547475,MATH 197,001,957876,Kedlaya; Kiran S.,9993,0,9999,6
1746530548503,MCWP 40,A00,892729,Duru; Nur,10,0,20,10
1746530548503,MCWP 40,B00,893304,Montejo; Carolina,14,0,20,6
1746530549535,MCWP 40R,A00,893757,Redela; Pamela Morgan,0,5,20,20
1746530550567,MCWP 50,A00,893758,Morshed; Michael James,0,0,20,20
1746530550567,MCWP 50,B00,893761,Bartulis; Jason Michael,17,0,20,3
1746530551593,MCWP 50R,A00,893766,Compas; Sean Matthew,0,1,20,20
1746530551593,MCWP 50R,B00,893769,Carter; Jennifer A,0,1,20,20
1746530551593,MCWP 50R,C00,893771,Krone; Jarret,0,3,20,20
1746530551593,MCWP 50R,D00,893772,Miller; Elizabeth Deen,0,0,20,20
1746530551593,MCWP 50R,E00,893775,Carter; Andrea L,0,1,20,20
1746530552625,MMW 11R,A01,892721,Herbst; Matthew,11,0,27,16
1746530552625,MMW 11R,A02,892722,Herbst; Matthew,0,0,0,3
1746530553654,MMW 12R,A01,892724,Herbst; Matthew,0,11,16,16
1746530553654,MMW 12R,A02,892725,Herbst; Matthew,0,10,16,16
1746530554683,MMW 13R,A01,892727,Staff,0,4,16,16
1746530554683,MMW 13R,A02,892728,Staff,0,4,16,16
1746530554683,MMW 13R,A03,958032,Staff,0,4,16,16
1746530554683,MMW 13R,A04,958033,Staff,0,4,16,16
1746530554683,MMW 13R,A05,958034,Staff,0,4,16,16
1746530555713,SIO 295LS,A00,894015,Staff,5,0,25,20
1746530556741,SIO 295S,A00,894020,Staff,5,0,25,20
1746530557776,SIOC 290S,B01,958918,Merrifield; Mark A,14,0,30,16
1746530558806,SIOC 291S,B01,958922,Gabriel; Corey John,14,0,30,16
1746530559836,SOCI 117,A01,895339,Staff,3,0,5,2
1746530560866,WES 237B,A00,894149,Staff,11,0,20,9
1746530562942,AESE 279B,A00,891859,Staff,13,0,35,22
1746530563970,AIP 197,001,891854,Vespa; Emanuel Ignacio,9999,0,9999,0
1746530565004,ANTH 289S,A00,891856,Gagneux; Pascal,12,0,12,0
1746530566031,BENG 196,001,957946,Engler; Adam J.,9996,0,9999,3
1746530567058,BISP 197,001,959851,Wilhelm; James E.,9999,0,9999,0
1746530568090,CAT 124RS,A01,956906,Staff,6,0,25,19
1746530569120,CAT 125RS,A01,922013,Staff,6,0,25,19
1746530570145,CLRE 250,A00,891860,Morris; Sheldon,9995,0,9999,4
1746530572206,CLRE 251R,A00,907817,Mehta; Ravindra L.,9994,0,9999,5
1746530573233,CLRE 252,A00,891864,Cuomo; Raphael Eduardo,9993,0,9999,6
1746530574263,CLRE 253,A00,891867,Vaida; Florin,9994,0,9999,5
1746530574263,CLRE 253,B00,907819,Staff,9999,0,9999,0
1746530575292,CLRE 259,A00,891868,Patel; Hemal,9998,0,9999,1
1746530576320,CLRE 260,A00,891872,Cuomo; Raphael Eduardo,9999,0,9999,0
1746530577350,CLRE 297,001,891888,Cuomo; Raphael Eduardo,9999,0,9999,0
1746530578377,CSE 191,A00,958773,Minnes Kemp; Mor Mia,9996,0,9999,3
1746530579409,CSE 197,001,959846,Minnes Kemp; Mor Mia,9993,0,9999,6
1746530580438,CSS 201S,A01,892054,Mignozzetti; Umberto,26,0,30,4
1746530581469,CSS 202S,A01,892056,Mignozzetti; Umberto,26,0,30,4
1746530582496,DSC 197,001,956898,Eldridge; Justin Matthew,9998,0,9999,1
1746530583525,DSC 297,001,958000,Mazumdar; Arya,9998,0,9999,1
1746530583525,DSC 297,002,959862,Wang; Yusu,9999,0,9999,0
1746530584553,EAP 100,A00,905686,Staff,9778,0,9999,221
1746530585586,ECE 45,A01,892618,Staff,0,0,65,65
1746530587644,ECE 111,A01,892719,Staff,4,0,65,61
1746530588670,ECE 197,001,957920,Mercier; Patrick Philip,9991,0,9999,8
1746530589699,ECON 178,A01,907814,Zhu; Ying,26,0,35,9
1746530590727,EDS 115,A00,895312,Staff,36,0,45,9
1746530591754,EDS 117,A01,895337,Staff,24,0,30,6
1746530592782,EDS 125,A00,895341,Jones; Gabrielle Anastasia,37,0,45,8
1746530593808,EDS 128A,A01,895459,Fargason; Sharon Gayle,44,0,45,1
1746530594837,EDS 128B,A01,895543,Pappas; Elizabeth,44,0,45,1
1746530595865,EDS 139,A00,897203,Pappas; Elizabeth,44,0,45,1
1746530595865,EDS 139,B00,897209,Fargason; Sharon Gayle,41,0,45,4
1746530596891,EDS 201,A00,895545,Staff,23,0,45,22
1746530597918,EDS 203,A01,895581,Halter; Christopher P.,23,0,45,22
1746530598948,EDS 204R,A01,895625,Heinzman; Erica M.,39,0,45,6
1746530598948,EDS 204R,B01,895693,Halter; Christopher P.,10,0,45,35
1746530599979,EDS 206R,A00,895694,Fargason; Sharon Gayle,1,0,30,29
1746530599979,EDS 206R,B00,895695,Choi; Bailey Miyeon,16,0,30,14
1746530601004,EDS 250,A00,895697,Hemans; Patricia Ann Benitez,23,0,45,22
1746530602033,EDS 281,A00,895701,Meyerott; Theresa Ann,1,0,15,14
1746530603061,EDS 284,A00,895736,Meyerott; Theresa Ann,1,0,15,14
1746530604090,EDS 286,A00,897210,Fine; Sarah,0,0,15,15
1746530605119,EDS 289C,A01,895770,Daly; Alan J.,15,0,15,0
1746530606146,EDS 290,A00,897211,Hofstetter; Carolyn,0,0,15,15
1746530607173,LIGM 5A,A00,896162,Fischer-Grunski; Eva K,13,0,20,7
1746530608204,LIGM 5B,A00,896260,Fischer-Grunski; Eva K,17,0,20,3
1746530609229,LIGM 5C,A00,896308,Fischer-Grunski; Eva K,18,0,20,2
1746530610256,LIIT 5AS,A00,896313,Carnelos; Chiara,18,0,20,2
1746530611290,LIIT 5BS,A00,896416,Carnelos; Chiara,20,0,20,0
1746530612321,LIIT 5CS,A00,896564,Carnelos; Chiara,20,0,20,0
1746530613349,LISP 5A,A00,896588,Munoz Sanchez; Alicia,3,0,20,17
1746530614375,LISP 5B,A00,896653,Munoz Sanchez; Alicia,7,0,20,13
1746530615410,LISP 5C,A00,896655,Munoz Sanchez; Alicia,0,1,20,20
1746530616436,MAE 197,001,957918,Kleissl; Jan,9996,0,9999,3
1746530616436,MAE 197,002,959806,Boechler; Nicholas Sebastia,9998,0,9999,1
1746530616436,MAE 197,003,959852,Mullin; Jennifer S,9999,0,9999,0
1746530617460,MATH 2,A01,957937,Staff,33,0,35,2
1746530618487,MATH 197,001,957876,Kedlaya; Kiran S.,9993,0,9999,6
1746530619514,MCWP 40,A00,892729,Duru; Nur,10,0,20,10
1746530619514,MCWP 40,B00,893304,Montejo; Carolina,14,0,20,6
1746530620544,MCWP 40R,A00,893757,Redela; Pamela Morgan,0,5,20,20
1746530621574,MCWP 50,A00,893758,Morshed; Michael James,0,0,20,20
1746530621574,MCWP 50,B00,893761,Bartulis; Jason Michael,17,0,20,3
1746530622601,MCWP 50R,A00,893766,Compas; Sean Matthew,0,1,20,20
1746530622601,MCWP 50R,B00,893769,Carter; Jennifer A,0,1,20,20
1746530622601,MCWP 50R,C00,893771,Krone; Jarret,0,3,20,20
1746530622601,MCWP 50R,D00,893772,Miller; Elizabeth Deen,0,0,20,20
1746530622601,MCWP 50R,E00,893775,Carter; Andrea L,0,1,20,20
1746530623632,MMW 11R,A01,892721,Herbst; Matthew,11,0,27,16
1746530623632,MMW 11R,A02,892722,Herbst; Matthew,0,0,0,3
1746530624658,MMW 12R,A01,892724,Herbst; Matthew,0,11,16,16
1746530624658,MMW 12R,A02,892725,Herbst; Matthew,0,10,16,16
1746530625684,MMW 13R,A01,892727,Staff,0,4,16,16
1746530625684,MMW 13R,A02,892728,Staff,0,4,16,16
1746530625684,MMW 13R,A03,958032,Staff,0,4,16,16
1746530625684,MMW 13R,A04,958033,Staff,0,4,16,16
1746530625684,MMW 13R,A05,958034,Staff,0,4,16,16
1746530626737,SIO 295LS,A00,894015,Staff,5,0,25,20
1746530627763,SIO 295S,A00,894020,Staff,5,0,25,20
1746530628791,SIOC 290S,B01,958918,Merrifield; Mark A,14,0,30,16
1746530629825,SIOC 291S,B01,958922,Gabriel; Corey John,14,0,30,16
1746530630863,SOCI 117,A01,895339,Staff,3,0,5,2
1746530631890,WES 237B,A00,894149,Staff,11,0,20,9
1746530633965,AESE 279B,A00,891859,Staff,13,0,35,22
1746530634995,AIP 197,001,891854,Vespa; Emanuel Ignacio,9999,0,9999,0
1746530636025,ANTH 289S,A00,891856,Gagneux; Pascal,12,0,12,0
1746530637053,BENG 196,001,957946,Engler; Adam J.,9996,0,9999,3
1746530638084,BISP 197,001,959851,Wilhelm; James E.,9999,0,9999,0
1746530639113,CAT 124RS,A01,956906,Staff,6,0,25,19
1746530640142,CAT 125RS,A01,922013,Staff,6,0,25,19
1746530641173,CLRE 250,A00,891860,Morris; Sheldon,9995,0,9999,4
1746530643228,CLRE 251R,A00,907817,Mehta; Ravindra L.,9994,0,9999,5
1746530644255,CLRE 252,A00,891864,Cuomo; Raphael Eduardo,9993,0,9999,6
1746530645283,CLRE 253,A00,891867,Vaida; Florin,9994,0,9999,5
1746530645283,CLRE 253,B00,907819,Staff,9999,0,9999,0
1746530646311,CLRE 259,A00,891868,Patel; Hemal,9998,0,9999,1
1746530647337,CLRE 260,A00,891872,Cuomo; Raphael Eduardo,9999,0,9999,0
1746530648362,CLRE 297,001,891888,Cuomo; Raphael Eduardo,9999,0,9999,0
1746530649390,CSE 191,A00,958773,Minnes Kemp; Mor Mia,9996,0,9999,3
1746530650419,CSE 197,001,959846,Minnes Kemp; Mor Mia,9993,0,9999,6
1746530651447,CSS 201S,A01,892054,Mignozzetti; Umberto,26,0,30,4
1746530652474,CSS 202S,A01,892056,Mignozzetti; Umberto,26,0,30,4
1746530653499,DSC 197,001,956898,Eldridge; Justin Matthew,9998,0,9999,1
1746530654526,DSC 297,001,958000,Mazumdar; Arya,9998,0,9999,1
1746530654526,DSC 297,002,959862,Wang; Yusu,9999,0,9999,0
1746530655550,EAP 100,A00,905686,Staff,9778,0,9999,221
1746530656583,ECE 45,A01,892618,Staff,0,0,65,65
1746530658639,ECE 111,A01,892719,Staff,4,0,65,61
1746530659668,ECE 197,001,957920,Mercier; Patrick Philip,9991,0,9999,8
1746530660695,ECON 178,A01,907814,Zhu; Ying,26,0,35,9
1746530661722,EDS 115,A00,895312,Staff,36,0,45,9
1746530662746,EDS 117,A01,895337,Staff,24,0,30,6
1746530663773,EDS 125,A00,895341,Jones; Gabrielle Anastasia,37,0,45,8
1746530664800,EDS 128A,A01,895459,Fargason; Sharon Gayle,44,0,45,1
1746530665827,EDS 128B,A01,895543,Pappas; Elizabeth,44,0,45,1
1746530666855,EDS 139,A00,897203,Pappas; Elizabeth,44,0,45,1
1746530666855,EDS 139,B00,897209,Fargason; Sharon Gayle,41,0,45,4
1746530667881,EDS 201,A00,895545,Staff,23,0,45,22
1746530668910,EDS 203,A01,895581,Halter; Christopher P.,23,0,45,22
1746530669939,EDS 204R,A01,895625,Heinzman; Erica M.,39,0,45,6
1746530669939,EDS 204R,B01,895693,Halter; Christopher P.,10,0,45,35
1746530670968,EDS 206R,A00,895694,Fargason; Sharon Gayle,1,0,30,29
1746530670968,EDS 206R,B00,895695,Choi; Bailey Miyeon,16,0,30,14
1746530671994,EDS 250,A00,895697,Hemans; Patricia Ann Benitez,23,0,45,22
1746530673025,EDS 281,A00,895701,Meyerott; Theresa Ann,1,0,15,14
1746530674051,EDS 284,A00,895736,Meyerott; Theresa Ann,1,0,15,14
1746530675079,EDS 286,A00,897210,Fine; Sarah,0,0,15,15
1746530676105,EDS 289C,A01,895770,Daly; Alan J.,15,0,15,0
1746530677132,EDS 290,A00,897211,Hofstetter; Carolyn,0,0,15,15
1746530678158,LIGM 5A,A00,896162,Fischer-Grunski; Eva K,13,0,20,7
1746530679185,LIGM 5B,A00,896260,Fischer-Grunski; Eva K,17,0,20,3
1746530680211,LIGM 5C,A00,896308,Fischer-Grunski; Eva K,18,0,20,2
1746530681242,LIIT 5AS,A00,896313,Carnelos; Chiara,18,0,20,2
1746530682269,LIIT 5BS,A00,896416,Carnelos; Chiara,20,0,20,0
1746530683299,LIIT 5CS,A00,896564,Carnelos; Chiara,20,0,20,0
1746530684327,LISP 5A,A00,896588,Munoz Sanchez; Alicia,3,0,20,17
1746530685357,LISP 5B,A00,896653,Munoz Sanchez; Alicia,7,0,20,13
1746530686385,LISP 5C,A00,896655,Munoz Sanchez; Alicia,0,1,20,20
1746530687414,MAE 197,001,957918,Kleissl; Jan,9996,0,9999,3
1746530687414,MAE 197,002,959806,Boechler; Nicholas Sebastia,9998,0,9999,1
1746530687414,MAE 197,003,959852,Mullin; Jennifer S,9999,0,9999,0
1746530688440,MATH 2,A01,957937,Staff,33,0,35,2
1746530689466,MATH 197,001,957876,Kedlaya; Kiran S.,9993,0,9999,6
1746530690494,MCWP 40,A00,892729,Duru; Nur,10,0,20,10
1746530690494,MCWP 40,B00,893304,Montejo; Carolina,14,0,20,6
1746530691526,MCWP 40R,A00,893757,Redela; Pamela Morgan,0,5,20,20
1746530692556,MCWP 50,A00,893758,Morshed; Michael James,0,0,20,20
1746530692556,MCWP 50,B00,893761,Bartulis; Jason Michael,17,0,20,3
1746530693587,MCWP 50R,A00,893766,Compas; Sean Matthew,0,1,20,20
1746530693587,MCWP 50R,B00,893769,Carter; Jennifer A,0,1,20,20
1746530693587,MCWP 50R,C00,893771,Krone; Jarret,0,3,20,20
1746530693587,MCWP 50R,D00,893772,Miller; Elizabeth Deen,0,0,20,20
1746530693587,MCWP 50R,E00,893775,Carter; Andrea L,0,1,20,20
1746530694618,MMW 11R,A01,892721,Herbst; Matthew,11,0,27,16
1746530694618,MMW 11R,A02,892722,Herbst; Matthew,0,0,0,3
1746530695646,MMW 12R,A01,892724,Herbst; Matthew,0,11,16,16
1746530695646,MMW 12R,A02,892725,Herbst; Matthew,0,10,16,16
1746530696677,MMW 13R,A01,892727,Staff,0,4,16,16
1746530696677,MMW 13R,A02,892728,Staff,0,4,16,16
1746530696677,MMW 13R,A03,958032,Staff,0,4,16,16
1746530696677,MMW 13R,A04,958033,Staff,0,4,16,16
1746530696677,MMW 13R,A05,958034,Staff,0,4,16,16
1746530697703,SIO 295LS,A00,894015,Staff,5,0,25,20
1746530698731,SIO 295S,A00,894020,Staff,5,0,25,20
1746530699763,SIOC 290S,B01,958918,Merrifield; Mark A,14,0,30,16
1746530700795,SIOC 291S,B01,958922,Gabriel; Corey John,14,0,30,16
1746530701821,SOCI 117,A01,895339,Staff,3,0,5,2
1746530702850,WES 237B,A00,894149,Staff,11,0,20,9
1746530704925,AESE 279B,A00,891859,Staff,13,0,35,22
1746530705954,AIP 197,001,891854,Vespa; Emanuel Ignacio,9999,0,9999,0
1746530706986,ANTH 289S,A00,891856,Gagneux; Pascal,12,0,12,0
1746530708014,BENG 196,001,957946,Engler; Adam J.,9996,0,9999,3
1746530709041,BISP 197,001,959851,Wilhelm; James E.,9999,0,9999,0
1746530710067,CAT 124RS,A01,956906,Staff,6,0,25,19
1746530711094,CAT 125RS,A01,922013,Staff,6,0,25,19
1746530712122,CLRE 250,A00,891860,Morris; Sheldon,9995,0,9999,4
1746530714181,CLRE 251R,A00,907817,Mehta; Ravindra L.,9994,0,9999,5
1746530715206,CLRE 252,A00,891864,Cuomo; Raphael Eduardo,9993,0,9999,6
1746530716233,CLRE 253,A00,891867,Vaida; Florin,9994,0,9999,5
1746530716233,CLRE 253,B00,907819,Staff,9999,0,9999,0
1746530717286,CLRE 259,A00,891868,Patel; Hemal,9998,0,9999,1
1746530718312,CLRE 260,A00,891872,Cuomo; Raphael Eduardo,9999,0,9999,0
1746530719340,CLRE 297,001,891888,Cuomo; Raphael Eduardo,9999,0,9999,0
1746530720366,CSE 191,A00,958773,Minnes Kemp; Mor Mia,9996,0,9999,3
1746530721394,CSE 197,001,959846,Minnes Kemp; Mor Mia,9993,0,9999,6
1746530722421,CSS 201S,A01,892054,Mignozzetti; Umberto,26,0,30,4
1746530723446,CSS 202S,A01,892056,Mignozzetti; Umberto,26,0,30,4
1746530724473,DSC 197,001,956898,Eldridge; Justin Matthew,9998,0,9999,1
1746530725499,DSC 297,001,958000,Mazumdar; Arya,9998,0,9999,1
1746530725499,DSC 297,002,959862,Wang; Yusu,9999,0,9999,0
1746530726530,EAP 100,A00,905686,Staff,9778,0,9999,221
1746530727562,ECE 45,A01,892618,Staff,0,0,65,65
1746530729616,ECE 111,A01,892719,Staff,4,0,65,61
1746530730644,ECE 197,001,957920,Mercier; Patrick Philip,9991,0,9999,8
1746530731672,ECON 178,A01,907814,Zhu; Ying,26,0,35,9
1746530732698,EDS 115,A00,895312,Staff,36,0,45,9
1746530733726,EDS 117,A01,895337,Staff,24,0,30,6
1746530734753,EDS 125,A00,895341,Jones; Gabrielle Anastasia,37,0,45,8
1746530735786,EDS 128A,A01,895459,Fargason; Sharon Gayle,44,0,45,1
1746530736810,EDS 128B,A01,895543,Pappas; Elizabeth,44,0,45,1
1746530737837,EDS 139,A00,897203,Pappas; Elizabeth,44,0,45,1
1746530737837,EDS 139,B00,897209,Fargason; Sharon Gayle,41,0,45,4
1746530738867,EDS 201,A00,895545,Staff,23,0,45,22
1746530739898,EDS 203,A01,895581,Halter; Christopher P.,23,0,45,22
1746530740929,EDS 204R,A01,895625,Heinzman; Erica M.,39,0,45,6
1746530740929,EDS 204R,B01,895693,Halter; Christopher P.,10,0,45,35
1746530741958,EDS 206R,A00,895694,Fargason; Sharon Gayle,1,0,30,29
1746530741958,EDS 206R,B00,895695,Choi; Bailey Miyeon,16,0,30,14
1746530742989,EDS 250,A00,895697,Hemans; Patricia Ann Benitez,23,0,45,22
1746530744015,EDS 281,A00,895701,Meyerott; Theresa Ann,1,0,15,14
1746530745039,EDS 284,A00,895736,Meyerott; Theresa Ann,1,0,15,14
1746530746067,EDS 286,A00,897210,Fine; Sarah,0,0,15,15
1746530747099,EDS 289C,A01,895770,Daly; Alan J.,15,0,15,0
1746530748125,EDS 290,A00,897211,Hofstetter; Carolyn,0,0,15,15
1746530749152,LIGM 5A,A00,896162,Fischer-Grunski; Eva K,13,0,20,7
1746530750182,LIGM 5B,A00,896260,Fischer-Grunski; Eva K,17,0,20,3
1746530751213,LIGM 5C,A00,896308,Fischer-Grunski; Eva K,18,0,20,2
1746530752243,LIIT 5AS,A00,896313,Carnelos; Chiara,18,0,20,2
1746530753269,LIIT 5BS,A00,896416,Carnelos; Chiara,20,0,20,0
1746530754297,LIIT 5CS,A00,896564,Carnelos; Chiara,20,0,20,0
1746530755325,LISP 5A,A00,896588,Munoz Sanchez; Alicia,3,0,20,17
1746530756354,LISP 5B,A00,896653,Munoz Sanchez; Alicia,7,0,20,13
1746530757383,LISP 5C,A00,896655,Munoz Sanchez; Alicia,0,1,20,20
1746530758413,MAE 197,001,957918,Kleissl; Jan,9996,0,9999,3
1746530758413,MAE 197,002,959806,Boechler; Nicholas Sebastia,9998,0,9999,1
1746530758413,MAE 197,003,959852,Mullin; Jennifer S,9999,0,9999,0
1746530759444,MATH 2,A01,957937,Staff,33,0,35,2
1746530760474,MATH 197,001,957876,Kedlaya; Kiran S.,9993,0,9999,6
1746530761502,MCWP 40,A00,892729,Duru; Nur,10,0,20,10
1746530761502,MCWP 40,B00,893304,Montejo; Carolina,14,0,20,6
1746530762531,MCWP 40R,A00,893757,Redela; Pamela Morgan,0,5,20,20
1746530763563,MCWP 50,A00,893758,Morshed; Michael James,0,0,20,20
1746530763563,MCWP 50,B00,893761,Bartulis; Jason Michael,17,0,20,3
1746530764595,MCWP 50R,A00,893766,Compas; Sean Matthew,0,1,20,20
1746530764595,MCWP 50R,B00,893769,Carter; Jennifer A,0,1,20,20
1746530764595,MCWP 50R,C00,893771,Krone; Jarret,0,3,20,20
1746530764595,MCWP 50R,D00,893772,Miller; Elizabeth Deen,0,0,20,20
1746530764595,MCWP 50R,E00,893775,Carter; Andrea L,0,1,20,20
1746530765622,MMW 11R,A01,892721,Herbst; Matthew,11,0,27,16
1746530765622,MMW 11R,A02,892722,Herbst; Matthew,0,0,0,3
1746530766650,MMW 12R,A01,892724,Herbst; Matthew,0,11,16,16
1746530766650,MMW 12R,A02,892725,Herbst; Matthew,0,10,16,16
1746530767675,MMW 13R,A01,892727,Staff,0,4,16,16
1746530767675,MMW 13R,A02,892728,Staff,0,4,16,16
1746530767675,MMW 13R,A03,958032,Staff,0,4,16,16
1746530767675,MMW 13R,A04,958033,Staff,0,4,16,16
1746530767675,MMW 13R,A05,958034,Staff,0,4,16,16
1746530768703,SIO 295LS,A00,894015,Staff,5,0,25,20
1746530769728,SIO 295S,A00,894020,Staff,5,0,25,20
1746530770760,SIOC 290S,B01,958918,Merrifield; Mark A,14,0,30,16
1746530771793,SIOC 291S,B01,958922,Gabriel; Corey John,14,0,30,16
1746530772825,SOCI 117,A01,895339,Staff,3,0,5,2
1746530773852,WES 237B,A00,894149,Staff,11,0,20,9
1746530775915,AESE 279B,A00,891859,Staff,13,0,35,22
1746530776943,AIP 197,001,891854,Vespa; Emanuel Ignacio,9999,0,9999,0
1746530777970,ANTH 289S,A00,891856,Gagneux; Pascal,12,0,12,0
1746530778996,BENG 196,001,957946,Engler; Adam J.,9996,0,9999,3
1746530780024,BISP 197,001,959851,Wilhelm; James E.,9999,0,9999,0
1746530781052,CAT 124RS,A01,956906,Staff,6,0,25,19
1746530782080,CAT 125RS,A01,922013,Staff,6,0,25,19
1746530783109,CLRE 250,A00,891860,Morris; Sheldon,9995,0,9999,4
1746530785166,CLRE 251R,A00,907817,Mehta; Ravindra L.,9994,0,9999,5
1746530786193,CLRE 252,A00,891864,Cuomo; Raphael Eduardo,9993,0,9999,6
1746530787224,CLRE 253,A00,891867,Vaida; Florin,9994,0,9999,5
1746530787224,CLRE 253,B00,907819,Staff,9999,0,9999,0
1746530788254,CLRE 259,A00,891868,Patel; Hemal,9998,0,9999,1
1746530789282,CLRE 260,A00,891872,Cuomo; Raphael Eduardo,9999,0,9999,0
1746530790309,CLRE 297,001,891888,Cuomo; Raphael Eduardo,9999,0,9999,0
1746530791336,CSE 191,A00,958773,Minnes Kemp; Mor Mia,9996,0,9999,3
1746530792365,CSE 197,001,959846,Minnes Kemp; Mor Mia,9993,0,9999,6
1746530793398,CSS 201S,A01,892054,Mignozzetti; Umberto,26,0,30,4
1746530794423,CSS 202S,A01,892056,Mignozzetti; Umberto,26,0,30,4
1746530795449,DSC 197,001,956898,Eldridge; Justin Matthew,9998,0,9999,1
1746530796479,DSC 297,001,958000,Mazumdar; Arya,9998,0,9999,1
1746530796479,DSC 297,002,959862,Wang; Yusu,9999,0,9999,0
1746530797508,EAP 100,A00,905686,Staff,9778,0,9999,221
1746530798538,ECE 45,A01,892618,Staff,0,0,65,65
1746530800598,ECE 111,A01,892719,Staff,4,0,65,61
1746530801626,ECE 197,001,957920,Mercier; Patrick Philip,9991,0,9999,8
1746530802708,ECON 178,A01,907814,Zhu; Ying,26,0,35,9
1746530803739,EDS 115,A00,895312,Staff,36,0,45,9
1746530804764,EDS 117,A01,895337,Staff,24,0,30,6
1746530805791,EDS 125,A00,895341,Jones; Gabrielle Anastasia,37,0,45,8
1746530806819,EDS 128A,A01,895459,Fargason; Sharon Gayle,44,0,45,1
1746530807848,EDS 128B,A01,895543,Pappas; Elizabeth,44,0,45,1
1746530808878,EDS 139,A00,897203,Pappas; Elizabeth,44,0,45,1
1746530808878,EDS 139,B00,897209,Fargason; Sharon Gayle,41,0,45,4
1746530809907,EDS 201,A00,895545,Staff,23,0,45,22
1746530810935,EDS 203,A01,895581,Halter; Christopher P.,23,0,45,22
1746530811963,EDS 204R,A01,895625,Heinzman; Erica M.,39,0,45,6
1746530811963,EDS 204R,B01,895693,Halter; Christopher P.,10,0,45,35
1746530812991,EDS 206R,A00,895694,Fargason; Sharon Gayle,1,0,30,29
1746530812991,EDS 206R,B00,895695,Choi; Bailey Miyeon,16,0,30,14
1746530814021,EDS 250,A00,895697,Hemans; Patricia Ann Benitez,23,0,45,22
1746530815048,EDS 281,A00,895701,Meyerott; Theresa Ann,1,0,15,14
1746530816077,EDS 284,A00,895736,Meyerott; Theresa Ann,1,0,15,14
1746530817105,EDS 286,A00,897210,Fine; Sarah,0,0,15,15
1746530818130,EDS 289C,A01,895770,Daly; Alan J.,15,0,15,0
1746530819158,EDS 290,A00,897211,Hofstetter; Carolyn,0,0,15,15
1746530820187,LIGM 5A,A00,896162,Fischer-Grunski; Eva K,13,0,20,7
1746530821213,LIGM 5B,A00,896260,Fischer-Grunski; Eva K,17,0,20,3
1746530822243,LIGM 5C,A00,896308,Fischer-Grunski; Eva K,18,0,20,2
1746530823270,LIIT 5AS,A00,896313,Carnelos; Chiara,18,0,20,2
1746530824296,LIIT 5BS,A00,896416,Carnelos; Chiara,20,0,20,0
1746530825328,LIIT 5CS,A00,896564,Carnelos; Chiara,20,0,20,0
1746530826357,LISP 5A,A00,896588,Munoz Sanchez; Alicia,3,0,20,17
1746530827385,LISP 5B,A00,896653,Munoz Sanchez; Alicia,7,0,20,13
1746530828414,LISP 5C,A00,896655,Munoz Sanchez; Alicia,0,1,20,20
1746530829440,MAE 197,001,957918,Kleissl; Jan,9996,0,9999,3
1746530829440,MAE 197,002,959806,Boechler; Nicholas Sebastia,9998,0,9999,1
1746530829440,MAE 197,003,959852,Mullin; Jennifer S,9999,0,9999,0
1746530830469,MATH 2,A01,957937,Staff,33,0,35,2
1746530831498,MATH 197,001,957876,Kedlaya; Kiran S.,9993,0,9999,6
1746530832526,MCWP 40,A00,892729,Duru; Nur,10,0,20,10
1746530832526,MCWP 40,B00,893304,Montejo; Carolina,14,0,20,6
1746530833551,MCWP 40R,A00,893757,Redela; Pamela Morgan,0,5,20,20
1746530834579,MCWP 50,A00,893758,Morshed; Michael James,0,0,20,20
1746530834579,MCWP 50,B00,893761,Bartulis; Jason Michael,17,0,20,3
1746530835613,MCWP 50R,A00,893766,Compas; Sean Matthew,0,1,20,20
1746530835613,MCWP 50R,B00,893769,Carter; Jennifer A,0,1,20,20
1746530835613,MCWP 50R,C00,893771,Krone; Jarret,0,3,20,20
1746530835613,MCWP 50R,D00,893772,Miller; Elizabeth Deen,0,0,20,20
1746530835613,MCWP 50R,E00,893775,Carter; Andrea L,0,1,20,20
1746530836639,MMW 11R,A01,892721,Herbst; Matthew,11,0,27,16
1746530836639,MMW 11R,A02,892722,Herbst; Matthew,0,0,0,3
1746530837677,MMW 12R,A01,892724,Herbst; Matthew,0,11,16,16
1746530837677,MMW 12R,A02,892725,Herbst; Matthew,0,10,16,16
1746530838707,MMW 13R,A01,892727,Staff,0,4,16,16
1746530838707,MMW 13R,A02,892728,Staff,0,4,16,16
1746530838707,MMW 13R,A03,958032,Staff,0,4,16,16
1746530838707,MMW 13R,A04,958033,Staff,0,4,16,16
1746530838707,MMW 13R,A05,958034,Staff,0,4,16,16
1746530839736,SIO 295LS,A00,894015,Staff,5,0,25,20
1746530840764,SIO 295S,A00,894020,Staff,5,0,25,20
1746530841791,SIOC 290S,B01,958918,Merrifield; Mark A,14,0,30,16
1746530842820,SIOC 291S,B01,958922,Gabriel; Corey John,14,0,30,16
1746530843849,SOCI 117,A01,895339,Staff,3,0,5,2
1746530844876,WES 237B,A00,894149,Staff,11,0,20,9
1746530846942,AESE 279B,A00,891859,Staff,13,0,35,22
1746530847968,AIP 197,001,891854,Vespa; Emanuel Ignacio,9999,0,9999,0
1746530848995,ANTH 289S,A00,891856,Gagneux; Pascal,12,0,12,0
1746530850024,BENG 196,001,957946,Engler; Adam J.,9996,0,9999,3
1746530851074,BISP 197,001,959851,Wilhelm; James E.,9999,0,9999,0
1746530852101,CAT 124RS,A01,956906,Staff,6,0,25,19
1746530853128,CAT 125RS,A01,922013,Staff,6,0,25,19
1746530854153,CLRE 250,A00,891860,Morris; Sheldon,9995,0,9999,4
1746530856209,CLRE 251R,A00,907817,Mehta; Ravindra L.,9994,0,9999,5
1746530857234,CLRE 252,A00,891864,Cuomo; Raphael Eduardo,9993,0,9999,6
1746530858263,CLRE 253,A00,891867,Vaida; Florin,9994,0,9999,5
1746530858263,CLRE 253,B00,907819,Staff,9999,0,9999,0
1746530859291,CLRE 259,A00,891868,Patel; Hemal,9998,0,9999,1
1746530860319,CLRE 260,A00,891872,Cuomo; Raphael Eduardo,9999,0,9999,0
1746530861347,CLRE 297,001,891888,Cuomo; Raphael Eduardo,9999,0,9999,0
1746530862375,CSE 191,A00,958773,Minnes Kemp; Mor Mia,9996,0,9999,3
1746530863405,CSE 197,001,959846,Minnes Kemp; Mor Mia,9993,0,9999,6
1746530864431,CSS 201S,A01,892054,Mignozzetti; Umberto,26,0,30,4
1746530865464,CSS 202S,A01,892056,Mignozzetti; Umberto,26,0,30,4
1746530866493,DSC 197,001,956898,Eldridge; Justin Matthew,9998,0,9999,1
1746530867521,DSC 297,001,958000,Mazumdar; Arya,9998,0,9999,1
1746530867521,DSC 297,002,959862,Wang; Yusu,9999,0,9999,0
1746530868549,EAP 100,A00,905686,Staff,9778,0,9999,221
1746530869577,ECE 45,A01,892618,Staff,0,0,65,65
1746530871648,ECE 111,A01,892719,Staff,4,0,65,61
1746530872674,ECE 197,001,957920,Mercier; Patrick Philip,9991,0,9999,8
1746530873703,ECON 178,A01,907814,Zhu; Ying,26,0,35,9
1746530874731,EDS 115,A00,895312,Staff,36,0,45,9
1746530875760,EDS 117,A01,895337,Staff,24,0,30,6
1746530876786,EDS 125,A00,895341,Jones; Gabrielle Anastasia,37,0,45,8
1746530877814,EDS 128A,A01,895459,Fargason; Sharon Gayle,44,0,45,1
1746530878839,EDS 128B,A01,895543,Pappas; Elizabeth,44,0,45,1
1746530879867,EDS 139,A00,897203,Pappas; Elizabeth,44,0,45,1
1746530879867,EDS 139,B00,897209,Fargason; Sharon Gayle,41,0,45,4
1746530880892,EDS 201,A00,895545,Staff,23,0,45,22
1746530881919,EDS 203,A01,895581,Halter; Christopher P.,23,0,45,22
1746530882947,EDS 204R,A01,895625,Heinzman; Erica M.,39,0,45,6
1746530882947,EDS 204R,B01,895693,Halter; Christopher P.,10,0,45,35
1746530883975,EDS 206R,A00,895694,Fargason; Sharon Gayle,1,0,30,29
1746530883975,EDS 206R,B00,895695,Choi; Bailey Miyeon,16,0,30,14
1746530885003,EDS 250,A00,895697,Hemans; Patricia Ann Benitez,23,0,45,22
1746530886027,EDS 281,A00,895701,Meyerott; Theresa Ann,1,0,15,14
1746530898063,EDS 284,A00,895736,Meyerott; Theresa Ann,1,0,15,14
1746530899102,EDS 286,A00,897210,Fine; Sarah,0,0,15,15
1746530900225,EDS 289C,A01,895770,Daly; Alan J.,15,0,15,0
1746530901262,EDS 290,A00,897211,Hofstetter; Carolyn,0,0,15,15
1746530902291,LIGM 5A,A00,896162,Fischer-Grunski; Eva K,13,0,20,7
1746530903321,LIGM 5B,A00,896260,Fischer-Grunski; Eva K,17,0,20,3
1746530904349,LIGM 5C,A00,896308,Fischer-Grunski; Eva K,18,0,20,2
1746530905379,LIIT 5AS,A00,896313,Carnelos; Chiara,18,0,20,2
1746530906418,LIIT 5BS,A00,896416,Carnelos; Chiara,20,0,20,0
1746530907453,LIIT 5CS,A00,896564,Carnelos; Chiara,20,0,20,0
1746530919611,LISP 5A,A00,896588,Munoz Sanchez; Alicia,3,0,20,17
1746530920640,LISP 5B,A00,896653,Munoz Sanchez; Alicia,7,0,20,13
1746530921673,LISP 5C,A00,896655,Munoz Sanchez; Alicia,0,1,20,20
1746530922707,MAE 197,001,957918,Kleissl; Jan,9996,0,9999,3
1746530922707,MAE 197,002,959806,Boechler; Nicholas Sebastia,9998,0,9999,1
1746530922707,MAE 197,003,959852,Mullin; Jennifer S,9999,0,9999,0
1746530923740,MATH 2,A01,957937,Staff,33,0,35,2
1746530924771,MATH 197,001,957876,Kedlaya; Kiran S.,9993,0,9999,6
1746530925798,MCWP 40,A00,892729,Duru; Nur,10,0,20,10
1746530925798,MCWP 40,B00,893304,Montejo; Carolina,14,0,20,6
1746530926825,MCWP 40R,A00,893757,Redela; Pamela Morgan,0,5,20,20
1746530927857,MCWP 50,A00,893758,Morshed; Michael James,0,0,20,20
1746530927857,MCWP 50,B00,893761,Bartulis; Jason Michael,17,0,20,3
1746530928890,MCWP 50R,A00,893766,Compas; Sean Matthew,0,1,20,20
1746530928890,MCWP 50R,B00,893769,Carter; Jennifer A,0,1,20,20
1746530928890,MCWP 50R,C00,893771,Krone; Jarret,0,3,20,20
1746530928890,MCWP 50R,D00,893772,Miller; Elizabeth Deen,0,0,20,20
1746530928890,MCWP 50R,E00,893775,Carter; Andrea L,0,1,20,20
1746530940915,MMW 11R,A01,892721,Herbst; Matthew,11,0,27,16
1746530940915,MMW 11R,A02,892722,Herbst; Matthew,0,0,0,3
1746530941950,MMW 12R,A01,892724,Herbst; Matthew,0,11,16,16
1746530941950,MMW 12R,A02,892725,Herbst; Matthew,0,10,16,16
1746530942982,MMW 13R,A01,892727,Staff,0,4,16,16
1746530942982,MMW 13R,A02,892728,Staff,0,4,16,16
1746530942982,MMW 13R,A03,958032,Staff,0,4,16,16
1746530942982,MMW 13R,A04,958033,Staff,0,4,16,16
1746530942982,MMW 13R,A05,958034,Staff,0,4,16,16
1746530944008,SIO 295LS,A00,894015,Staff,5,0,25,20
1746530945038,SIO 295S,A00,894020,Staff,5,0,25,20
1746530946071,SIOC 290S,B01,958918,Merrifield; Mark A,14,0,30,16
1746530947102,SIOC 291S,B01,958922,Gabriel; Corey John,14,0,30,16
1746530948132,SOCI 117,A01,895339,Staff,3,0,5,2
1746530949160,WES 237B,A00,894149,Staff,11,0,20,9
1746530951246,AESE 279B,A00,891859,Staff,13,0,35,22
1746530962679,AIP 197,001,891854,Vespa; Emanuel Ignacio,9999,0,9999,0
1746530963713,ANTH 289S,A00,891856,Gagneux; Pascal,12,0,12,0
1746530964740,BENG 196,001,957946,Engler; Adam J.,9996,0,9999,3
1746530965770,BISP 197,001,959851,Wilhelm; James E.,9999,0,9999,0
1746530966801,CAT 124RS,A01,956906,Staff,6,0,25,19
1746530967831,CAT 125RS,A01,922013,Staff,6,0,25,19
1746530968861,CLRE 250,A00,891860,Morris; Sheldon,9995,0,9999,4
1746530970921,CLRE 251R,A00,907817,Mehta; Ravindra L.,9994,0,9999,5
1746530971950,CLRE 252,A00,891864,Cuomo; Raphael Eduardo,9993,0,9999,6
1746530984239,CLRE 253,A00,891867,Vaida; Florin,9994,0,9999,5
1746530984239,CLRE 253,B00,907819,Staff,9999,0,9999,0
1746530985268,CLRE 259,A00,891868,Patel; Hemal,9998,0,9999,1
1746530986294,CLRE 260,A00,891872,Cuomo; Raphael Eduardo,9999,0,9999,0
1746530987326,CLRE 297,001,891888,Cuomo; Raphael Eduardo,9999,0,9999,0
1746530988354,CSE 191,A00,958773,Minnes Kemp; Mor Mia,9996,0,9999,3
1746530989384,CSE 197,001,959846,Minnes Kemp; Mor Mia,9993,0,9999,6
1746530990414,CSS 201S,A01,892054,Mignozzetti; Umberto,26,0,30,4
1746530991447,CSS 202S,A01,892056,Mignozzetti; Umberto,26,0,30,4
1746530992476,DSC 197,001,956898,Eldridge; Justin Matthew,9998,0,9999,1
1746530993508,DSC 297,001,958000,Mazumdar; Arya,9998,0,9999,1
1746530993508,DSC 297,002,959862,Wang; Yusu,9999,0,9999,0
1746531005716,EAP 100,A00,905686,Staff,9778,0,9999,221
1746531006748,ECE 45,A01,892618,Staff,0,0,65,65
1746531008809,ECE 111,A01,892719,Staff,4,0,65,61
1746531009838,ECE 197,001,957920,Mercier; Patrick Philip,9991,0,9999,8
1746531010867,ECON 178,A01,907814,Zhu; Ying,26,0,35,9
1746531011899,EDS 115,A00,895312,Staff,36,0,45,9
1746531012934,EDS 117,A01,895337,Staff,24,0,30,6
1746531013963,EDS 125,A00,895341,Jones; Gabrielle Anastasia,37,0,45,8
1746531014994,EDS 128A,A01,895459,Fargason; Sharon Gayle,44,0,45,1
1746531027517,EDS 128B,A01,895543,Pappas; Elizabeth,44,0,45,1
1746531028544,EDS 139,A00,897203,Pappas; Elizabeth,44,0,45,1
1746531028544,EDS 139,B00,897209,Fargason; Sharon Gayle,41,0,45,4
1746531029573,EDS 201,A00,895545,Staff,23,0,45,22
1746531030600,EDS 203,A01,895581,Halter; Christopher P.,23,0,45,22
1746531031633,EDS 204R,A01,895625,Heinzman; Erica M.,39,0,45,6
1746531031633,EDS 204R,B01,895693,Halter; Christopher P.,10,0,45,35
1746531032661,EDS 206R,A00,895694,Fargason; Sharon Gayle,1,0,30,29
1746531032661,EDS 206R,B00,895695,Choi; Bailey Miyeon,16,0,30,14
1746531033696,EDS 250,A00,895697,Hemans; Patricia Ann Benitez,23,0,45,22
1746531034723,EDS 281,A00,895701,Meyerott; Theresa Ann,1,0,15,14
1746531035754,EDS 284,A00,895736,Meyerott; Theresa Ann,1,0,15,14
1746531036785,EDS 286,A00,897210,Fine; Sarah,0,0,15,15
1746531041172,EDS 289C,A01,895770,Daly; Alan J.,15,0,15,0
1746531042201,EDS 290,A00,897211,Hofstetter; Carolyn,0,0,15,15
1746531043229,LIGM 5A,A00,896162,Fischer-Grunski; Eva K,13,0,20,7
1746531044257,LIGM 5B,A00,896260,Fischer-Grunski; Eva K,17,0,20,3
1746531045291,LIGM 5C,A00,896308,Fischer-Grunski; Eva K,18,0,20,2
1746531046321,LIIT 5AS,A00,896313,Carnelos; Chiara,18,0,20,2
1746531047354,LIIT 5BS,A00,896416,Carnelos; Chiara,20,0,20,0
1746531048379,LIIT 5CS,A00,896564,Carnelos; Chiara,20,0,20,0
1746531049409,LISP 5A,A00,896588,Munoz Sanchez; Alicia,3,0,20,17
1746531050440,LISP 5B,A00,896653,Munoz Sanchez; Alicia,7,0,20,13
1746531051469,LISP 5C,A00,896655,Munoz Sanchez; Alicia,0,1,20,20
1746531052497,MAE 197,001,957918,Kleissl; Jan,9996,0,9999,3
1746531052497,MAE 197,002,959806,Boechler; Nicholas Sebastia,9998,0,9999,1
1746531052497,MAE 197,003,959852,Mullin; Jennifer S,9999,0,9999,0
1746531054048,MATH 2,A01,957937,Staff,33,0,35,2
1746531055076,MATH 197,001,957876,Kedlaya; Kiran S.,9993,0,9999,6
1746531056107,MCWP 40,A00,892729,Duru; Nur,10,0,20,10
1746531056107,MCWP 40,B00,893304,Montejo; Carolina,14,0,20,6
1746531057137,MCWP 40R,A00,893757,Redela; Pamela Morgan,0,5,20,20
1746531058168,MCWP 50,A00,893758,Morshed; Michael James,0,0,20,20
1746531058168,MCWP 50,B00,893761,Bartulis; Jason Michael,17,0,20,3
1746531059242,MCWP 50R,A00,893766,Compas; Sean Matthew,0,1,20,20
1746531059242,MCWP 50R,B00,893769,Carter; Jennifer A,0,1,20,20
1746531059242,MCWP 50R,C00,893771,Krone; Jarret,0,3,20,20
1746531059242,MCWP 50R,D00,893772,Miller; Elizabeth Deen,0,0,20,20
1746531059242,MCWP 50R,E00,893775,Carter; Andrea L,0,1,20,20
1746531060272,MMW 11R,A01,892721,Herbst; Matthew,11,0,27,16
1746531060272,MMW 11R,A02,892722,Herbst; Matthew,0,0,0,3
1746531061298,MMW 12R,A01,892724,Herbst; Matthew,0,11,16,16
1746531061298,MMW 12R,A02,892725,Herbst; Matthew,0,10,16,16
1746531062326,MMW 13R,A01,892727,Staff,0,4,16,16
1746531062326,MMW 13R,A02,892728,Staff,0,4,16,16
1746531062326,MMW 13R,A03,958032,Staff,0,4,16,16
1746531062326,MMW 13R,A04,958033,Staff,0,4,16,16
1746531062326,MMW 13R,A05,958034,Staff,0,4,16,16
1746531063355,SIO 295LS,A00,894015,Staff,5,0,25,20
1746531064382,SIO 295S,A00,894020,Staff,5,0,25,20
1746531065412,SIOC 290S,B01,958918,Merrifield; Mark A,14,0,30,16
1746531066441,SIOC 291S,B01,958922,Gabriel; Corey John,14,0,30,16
1746531067466,SOCI 117,A01,895339,Staff,3,0,5,2
1746531068494,WES 237B,A00,894149,Staff,11,0,20,9
1746531070580,AESE 279B,A00,891859,Staff,13,0,35,22
1746531071609,AIP 197,001,891854,Vespa; Emanuel Ignacio,9999,0,9999,0
1746531072639,ANTH 289S,A00,891856,Gagneux; Pascal,12,0,12,0
1746531073665,BENG 196,001,957946,Engler; Adam J.,9996,0,9999,3
1746531074693,BISP 197,001,959851,Wilhelm; James E.,9999,0,9999,0
1746531075722,CAT 124RS,A01,956906,Staff,6,0,25,19
1746531076751,CAT 125RS,A01,922013,Staff,6,0,25,19
1746531077780,CLRE 250,A00,891860,Morris; Sheldon,9995,0,9999,4
1746531079837,CLRE 251R,A00,907817,Mehta; Ravindra L.,9994,0,9999,5
1746531080868,CLRE 252,A00,891864,Cuomo; Raphael Eduardo,9993,0,9999,6
1746531081900,CLRE 253,A00,891867,Vaida; Florin,9994,0,9999,5
1746531081900,CLRE 253,B00,907819,Staff,9999,0,9999,0
1746531082931,CLRE 259,A00,891868,Patel; Hemal,9998,0,9999,1
1746531083962,CLRE 260,A00,891872,Cuomo; Raphael Eduardo,9999,0,9999,0
1746531084994,CLRE 297,001,891888,Cuomo; Raphael Eduardo,9999,0,9999,0
1746531086023,CSE 191,A00,958773,Minnes Kemp; Mor Mia,9996,0,9999,3
1746531087050,CSE 197,001,959846,Minnes Kemp; Mor Mia,9993,0,9999,6
1746531088080,CSS 201S,A01,892054,Mignozzetti; Umberto,26,0,30,4
1746531089110,CSS 202S,A01,892056,Mignozzetti; Umberto,26,0,30,4
1746531090138,DSC 197,001,956898,Eldridge; Justin Matthew,9998,0,9999,1
1746531091169,DSC 297,001,958000,Mazumdar; Arya,9998,0,9999,1
1746531091169,DSC 297,002,959862,Wang; Yusu,9999,0,9999,0
1746531092199,EAP 100,A00,905686,Staff,9778,0,9999,221
1746531093230,ECE 45,A01,892618,Staff,0,0,65,65
1746531095288,ECE 111,A01,892719,Staff,4,0,65,61
1746531096316,ECE 197,001,957920,Mercier; Patrick Philip,9991,0,9999,8
1746531097347,ECON 178,A01,907814,Zhu; Ying,26,0,35,9
1746531098378,EDS 115,A00,895312,Staff,36,0,45,9
1746531099406,EDS 117,A01,895337,Staff,24,0,30,6
1746531100436,EDS 125,A00,895341,Jones; Gabrielle Anastasia,37,0,45,8
1746531101465,EDS 128A,A01,895459,Fargason; Sharon Gayle,44,0,45,1
1746531102494,EDS 128B,A01,895543,Pappas; Elizabeth,44,0,45,1
1746531103521,EDS 139,A00,897203,Pappas; Elizabeth,44,0,45,1
1746531103521,EDS 139,B00,897209,Fargason; Sharon Gayle,41,0,45,4
1746531104550,EDS 201,A00,895545,Staff,23,0,45,22
1746531105580,EDS 203,A01,895581,Halter; Christopher P.,23,0,45,22
1746531106613,EDS 204R,A01,895625,Heinzman; Erica M.,39,0,45,6
1746531106613,EDS 204R,B01,895693,Halter; Christopher P.,10,0,45,35
1746531107640,EDS 206R,A00,895694,Fargason; Sharon Gayle,1,0,30,29
1746531107640,EDS 206R,B00,895695,Choi; Bailey Miyeon,16,0,30,14
1746531108670,EDS 250,A00,895697,Hemans; Patricia Ann Benitez,23,0,45,22
1746531109697,EDS 281,A00,895701,Meyerott; Theresa Ann,1,0,15,14
1746531110724,EDS 284,A00,895736,Meyerott; Theresa Ann,1,0,15,14
1746531111750,EDS 286,A00,897210,Fine; Sarah,0,0,15,15
1746531112778,EDS 289C,A01,895770,Daly; Alan J.,15,0,15,0
1746531113807,EDS 290,A00,897211,Hofstetter; Carolyn,0,0,15,15
1746531114836,LIGM 5A,A00,896162,Fischer-Grunski; Eva K,13,0,20,7
1746531115863,LIGM 5B,A00,896260,Fischer-Grunski; Eva K,17,0,20,3
1746531116891,LIGM 5C,A00,896308,Fischer-Grunski; Eva K,18,0,20,2
1746531117919,LIIT 5AS,A00,896313,Carnelos; Chiara,18,0,20,2
1746531118946,LIIT 5BS,A00,896416,Carnelos; Chiara,20,0,20,0
1746531119976,LIIT 5CS,A00,896564,Carnelos; Chiara,20,0,20,0
1746531121007,LISP 5A,A00,896588,Munoz Sanchez; Alicia,3,0,20,17
1746531122035,LISP 5B,A00,896653,Munoz Sanchez; Alicia,7,0,20,13
1746531123064,LISP 5C,A00,896655,Munoz Sanchez; Alicia,0,1,20,20
1746531124094,MAE 197,001,957918,Kleissl; Jan,9996,0,9999,3
1746531124094,MAE 197,002,959806,Boechler; Nicholas Sebastia,9998,0,9999,1
1746531124094,MAE 197,003,959852,Mullin; Jennifer S,9999,0,9999,0
1746531125124,MATH 2,A01,957937,Staff,33,0,35,2
1746531126153,MATH 197,001,957876,Kedlaya; Kiran S.,9993,0,9999,6
1746531127182,MCWP 40,A00,892729,Duru; Nur,10,0,20,10
1746531127182,MCWP 40,B00,893304,Montejo; Carolina,14,0,20,6
1746531128212,MCWP 40R,A00,893757,Redela; Pamela Morgan,0,5,20,20
1746531129238,MCWP 50,A00,893758,Morshed; Michael James,0,0,20,20
1746531129238,MCWP 50,B00,893761,Bartulis; Jason Michael,17,0,20,3
1746531130266,MCWP 50R,A00,893766,Compas; Sean Matthew,0,1,20,20
1746531130266,MCWP 50R,B00,893769,Carter; Jennifer A,0,1,20,20
1746531130266,MCWP 50R,C00,893771,Krone; Jarret,0,3,20,20
1746531130266,MCWP 50R,D00,893772,Miller; Elizabeth Deen,0,0,20,20
1746531130266,MCWP 50R,E00,893775,Carter; Andrea L,0,1,20,20
1746531131294,MMW 11R,A01,892721,Herbst; Matthew,11,0,27,16
1746531131294,MMW 11R,A02,892722,Herbst; Matthew,0,0,0,3
1746531132321,MMW 12R,A01,892724,Herbst; Matthew,0,11,16,16
1746531132321,MMW 12R,A02,892725,Herbst; Matthew,0,10,16,16
1746531133348,MMW 13R,A01,892727,Staff,0,4,16,16
1746531133348,MMW 13R,A02,892728,Staff,0,4,16,16
1746531133348,MMW 13R,A03,958032,Staff,0,4,16,16
1746531133348,MMW 13R,A04,958033,Staff,0,4,16,16
1746531133348,MMW 13R,A05,958034,Staff,0,4,16,16
1746531134375,SIO 295LS,A00,894015,Staff,5,0,25,20
1746531135404,SIO 295S,A00,894020,Staff,5,0,25,20
1746531136435,SIOC 290S,B01,958918,Merrifield; Mark A,14,0,30,16
1746531137461,SIOC 291S,B01,958922,Gabriel; Corey John,14,0,30,16
1746531138491,SOCI 117,A01,895339,Staff,3,0,5,2
1746531139520,WES 237B,A00,894149,Staff,11,0,20,9
1746531141592,AESE 279B,A00,891859,Staff,13,0,35,22
1746531142620,AIP 197,001,891854,Vespa; Emanuel Ignacio,9999,0,9999,0
1746531143649,ANTH 289S,A00,891856,Gagneux; Pascal,12,0,12,0
1746531144677,BENG 196,001,957946,Engler; Adam J.,9996,0,9999,3
1746531145705,BISP 197,001,959851,Wilhelm; James E.,9999,0,9999,0
1746531146731,CAT 124RS,A01,956906,Staff,6,0,25,19
1746531147759,CAT 125RS,A01,922013,Staff,6,0,25,19
1746531148785,CLRE 250,A00,891860,Morris; Sheldon,9995,0,9999,4
1746531150843,CLRE 251R,A00,907817,Mehta; Ravindra L.,9994,0,9999,5
1746531151875,CLRE 252,A00,891864,Cuomo; Raphael Eduardo,9993,0,9999,6
1746531152903,CLRE 253,A00,891867,Vaida; Florin,9994,0,9999,5
1746531152903,CLRE 253,B00,907819,Staff,9999,0,9999,0
1746531153930,CLRE 259,A00,891868,Patel; Hemal,9998,0,9999,1
1746531154962,CLRE 260,A00,891872,Cuomo; Raphael Eduardo,9999,0,9999,0
1746531155991,CLRE 297,001,891888,Cuomo; Raphael Eduardo,9999,0,9999,0
1746531157022,CSE 191,A00,958773,Minnes Kemp; Mor Mia,9996,0,9999,3
1746531158049,CSE 197,001,959846,Minnes Kemp; Mor Mia,9993,0,9999,6
1746531159079,CSS 201S,A01,892054,Mignozzetti; Umberto,26,0,30,4
1746531160109,CSS 202S,A01,892056,Mignozzetti; Umberto,26,0,30,4
1746531161138,DSC 197,001,956898,Eldridge; Justin Matthew,9998,0,9999,1
1746531162166,DSC 297,001,958000,Mazumdar; Arya,9998,0,9999,1
1746531162166,DSC 297,002,959862,Wang; Yusu,9999,0,9999,0
1746531163193,EAP 100,A00,905686,Staff,9778,0,9999,221
1746531164226,ECE 45,A01,892618,Staff,0,0,65,65
1746531166286,ECE 111,A01,892719,Staff,4,0,65,61
1746531167315,ECE 197,001,957920,Mercier; Patrick Philip,9991,0,9999,8
1746531168346,ECON 178,A01,907814,Zhu; Ying,26,0,35,9
1746531169373,EDS 115,A00,895312,Staff,36,0,45,9
1746531170403,EDS 117,A01,895337,Staff,24,0,30,6
1746531171435,EDS 125,A00,895341,Jones; Gabrielle Anastasia,37,0,45,8
1746531172464,EDS 128A,A01,895459,Fargason; Sharon Gayle,44,0,45,1
1746531173492,EDS 128B,A01,895543,Pappas; Elizabeth,44,0,45,1
1746531174520,EDS 139,A00,897203,Pappas; Elizabeth,44,0,45,1
1746531174520,EDS 139,B00,897209,Fargason; Sharon Gayle,41,0,45,4
1746531175547,EDS 201,A00,895545,Staff,23,0,45,22
1746531176577,EDS 203,A01,895581,Halter; Christopher P.,23,0,45,22
1746531177607,EDS 204R,A01,895625,Heinzman; Erica M.,39,0,45,6
1746531177607,EDS 204R,B01,895693,Halter; Christopher P.,10,0,45,35
1746531178633,EDS 206R,A00,895694,Fargason; Sharon Gayle,1,0,30,29
1746531178633,EDS 206R,B00,895695,Choi; Bailey Miyeon,16,0,30,14
1746531179665,EDS 250,A00,895697,Hemans; Patricia Ann Benitez,23,0,45,22
1746531180697,EDS 281,A00,895701,Meyerott; Theresa Ann,1,0,15,14
1746531181724,EDS 284,A00,895736,Meyerott; Theresa Ann,1,0,15,14
1746531182759,EDS 286,A00,897210,Fine; Sarah,0,0,15,15
1746531183788,EDS 289C,A01,895770,Daly; Alan J.,15,0,15,0
1746531184814,EDS 290,A00,897211,Hofstetter; Carolyn,0,0,15,15
1746531185847,LIGM 5A,A00,896162,Fischer-Grunski; Eva K,13,0,20,7
1746531186875,LIGM 5B,A00,896260,Fischer-Grunski; Eva K,17,0,20,3
1746531187904,LIGM 5C,A00,896308,Fischer-Grunski; Eva K,18,0,20,2
1746531188935,LIIT 5AS,A00,896313,Carnelos; Chiara,18,0,20,2
1746531189963,LIIT 5BS,A00,896416,Carnelos; Chiara,20,0,20,0
1746531190996,LIIT 5CS,A00,896564,Carnelos; Chiara,20,0,20,0
1746531192028,LISP 5A,A00,896588,Munoz Sanchez; Alicia,3,0,20,17
1746531193056,LISP 5B,A00,896653,Munoz Sanchez; Alicia,7,0,20,13
1746531194088,LISP 5C,A00,896655,Munoz Sanchez; Alicia,0,1,20,20
1746531195116,MAE 197,001,957918,Kleissl; Jan,9996,0,9999,3
1746531195116,MAE 197,002,959806,Boechler; Nicholas Sebastia,9998,0,9999,1
1746531195116,MAE 197,003,959852,Mullin; Jennifer S,9999,0,9999,0
1746531196143,MATH 2,A01,957937,Staff,33,0,35,2
1746531197169,MATH 197,001,957876,Kedlaya; Kiran S.,9993,0,9999,6
1746531198198,MCWP 40,A00,892729,Duru; Nur,10,0,20,10
1746531198198,MCWP 40,B00,893304,Montejo; Carolina,14,0,20,6
1746531199224,MCWP 40R,A00,893757,Redela; Pamela Morgan,0,5,20,20
1746531200252,MCWP 50,A00,893758,Morshed; Michael James,0,0,20,20
1746531200252,MCWP 50,B00,893761,Bartulis; Jason Michael,17,0,20,3
1746531201279,MCWP 50R,A00,893766,Compas; Sean Matthew,0,1,20,20
1746531201279,MCWP 50R,B00,893769,Carter; Jennifer A,0,1,20,20
1746531201279,MCWP 50R,C00,893771,Krone; Jarret,0,3,20,20
1746531201279,MCWP 50R,D00,893772,Miller; Elizabeth Deen,0,0,20,20
1746531201279,MCWP 50R,E00,893775,Carter; Andrea L,0,1,20,20
1746531202305,MMW 11R,A01,892721,Herbst; Matthew,11,0,27,16
1746531202305,MMW 11R,A02,892722,Herbst; Matthew,0,0,0,3
1746531203335,MMW 12R,A01,892724,Herbst; Matthew,0,11,16,16
1746531203335,MMW 12R,A02,892725,Herbst; Matthew,0,10,16,16
1746531204361,MMW 13R,A01,892727,Staff,0,4,16,16
1746531204361,MMW 13R,A02,892728,Staff,0,4,16,16
1746531204361,MMW 13R,A03,958032,Staff,0,4,16,16
1746531204361,MMW 13R,A04,958033,Staff,0,4,16,16
1746531204361,MMW 13R,A05,958034,Staff,0,4,16,16
1746531205390,SIO 295LS,A00,894015,Staff,5,0,25,20
1746531206415,SIO 295S,A00,894020,Staff,5,0,25,20
1746531207442,SIOC 290S,B01,958918,Merrifield; Mark A,14,0,30,16
1746531208473,SIOC 291S,B01,958922,Gabriel; Corey John,14,0,30,16
1746531209499,SOCI 117,A01,895339,Staff,3,0,5,2
1746531210527,WES 237B,A00,894149,Staff,11,0,20,9
1746531212591,AESE 279B,A00,891859,Staff,13,0,35,22
1746531213619,AIP 197,001,891854,Vespa; Emanuel Ignacio,9999,0,9999,0
1746531214648,ANTH 289S,A00,891856,Gagneux; Pascal,12,0,12,0
1746531215674,BENG 196,001,957946,Engler; Adam J.,9996,0,9999,3
1746531216702,BISP 197,001,959851,Wilhelm; James E.,9999,0,9999,0
1746531217729,CAT 124RS,A01,956906,Staff,6,0,25,19
1746531218756,CAT 125RS,A01,922013,Staff,6,0,25,19
1746531219783,CLRE 250,A00,891860,Morris; Sheldon,9995,0,9999,4
1746531221840,CLRE 251R,A00,907817,Mehta; Ravindra L.,9994,0,9999,5
1746531222871,CLRE 252,A00,891864,Cuomo; Raphael Eduardo,9993,0,9999,6
1746531223903,CLRE 253,A00,891867,Vaida; Florin,9994,0,9999,5
1746531223903,CLRE 253,B00,907819,Staff,9999,0,9999,0
1746531224932,CLRE 259,A00,891868,Patel; Hemal,9998,0,9999,1
1746531225962,CLRE 260,A00,891872,Cuomo; Raphael Eduardo,9999,0,9999,0
1746531226991,CLRE 297,001,891888,Cuomo; Raphael Eduardo,9999,0,9999,0
1746531228023,CSE 191,A00,958773,Minnes Kemp; Mor Mia,9996,0,9999,3
1746531229054,CSE 197,001,959846,Minnes Kemp; Mor Mia,9993,0,9999,6
1746531230080,CSS 201S,A01,892054,Mignozzetti; Umberto,26,0,30,4
1746531231109,CSS 202S,A01,892056,Mignozzetti; Umberto,26,0,30,4
1746531232141,DSC 197,001,956898,Eldridge; Justin Matthew,9998,0,9999,1
1746531233169,DSC 297,001,958000,Mazumdar; Arya,9998,0,9999,1
1746531233169,DSC 297,002,959862,Wang; Yusu,9999,0,9999,0
1746531234194,EAP 100,A00,905686,Staff,9778,0,9999,221
1746531235221,ECE 45,A01,892618,Staff,0,0,65,65
1746531237279,ECE 111,A01,892719,Staff,4,0,65,61
1746531238331,ECE 197,001,957920,Mercier; Patrick Philip,9991,0,9999,8
1746531239362,ECON 178,A01,907814,Zhu; Ying,26,0,35,9
1746531240389,EDS 115,A00,895312,Staff,36,0,45,9
1746531241417,EDS 117,A01,895337,Staff,24,0,30,6
1746531242445,EDS 125,A00,895341,Jones; Gabrielle Anastasia,37,0,45,8
1746531243472,EDS 128A,A01,895459,Fargason; Sharon Gayle,44,0,45,1
1746531244498,EDS 128B,A01,895543,Pappas; Elizabeth,44,0,45,1
1746531245527,EDS 139,A00,897203,Pappas; Elizabeth,44,0,45,1
1746531245527,EDS 139,B00,897209,Fargason; Sharon Gayle,41,0,45,4
1746531246554,EDS 201,A00,895545,Staff,23,0,45,22
1746531247583,EDS 203,A01,895581,Halter; Christopher P.,23,0,45,22
1746531248611,EDS 204R,A01,895625,Heinzman; Erica M.,39,0,45,6
1746531248611,EDS 204R,B01,895693,Halter; Christopher P.,10,0,45,35
1746531249641,EDS 206R,A00,895694,Fargason; Sharon Gayle,1,0,30,29
1746531249641,EDS 206R,B00,895695,Choi; Bailey Miyeon,16,0,30,14
1746531250669,EDS 250,A00,895697,Hemans; Patricia Ann Benitez,23,0,45,22
1746531251699,EDS 281,A00,895701,Meyerott; Theresa Ann,1,0,15,14
1746531252726,EDS 284,A00,895736,Meyerott; Theresa Ann,1,0,15,14
1746531253752,EDS 286,A00,897210,Fine; Sarah,0,0,15,15
1746531254777,EDS 289C,A01,895770,Daly; Alan J.,15,0,15,0
1746531255804,EDS 290,A00,897211,Hofstetter; Carolyn,0,0,15,15
1746531256832,LIGM 5A,A00,896162,Fischer-Grunski; Eva K,13,0,20,7
1746531257857,LIGM 5B,A00,896260,Fischer-Grunski; Eva K,17,0,20,3
1746531258887,LIGM 5C,A00,896308,Fischer-Grunski; Eva K,18,0,20,2
1746531259918,LIIT 5AS,A00,896313,Carnelos; Chiara,18,0,20,2
1746531260944,LIIT 5BS,A00,896416,Carnelos; Chiara,20,0,20,0
1746531261974,LIIT 5CS,A00,896564,Carnelos; Chiara,20,0,20,0
1746531263003,LISP 5A,A00,896588,Munoz Sanchez; Alicia,3,0,20,17
1746531264030,LISP 5B,A00,896653,Munoz Sanchez; Alicia,7,0,20,13
1746531265060,LISP 5C,A00,896655,Munoz Sanchez; Alicia,0,1,20,20
1746531266090,MAE 197,001,957918,Kleissl; Jan,9996,0,9999,3
1746531266090,MAE 197,002,959806,Boechler; Nicholas Sebastia,9998,0,9999,1
1746531266090,MAE 197,003,959852,Mullin; Jennifer S,9999,0,9999,0
1746531267120,MATH 2,A01,957937,Staff,33,0,35,2
1746531268147,MATH 197,001,957876,Kedlaya; Kiran S.,9993,0,9999,6
1746531269174,MCWP 40,A00,892729,Duru; Nur,10,0,20,10
1746531269174,MCWP 40,B00,893304,Montejo; Carolina,14,0,20,6
1746531270200,MCWP 40R,A00,893757,Redela; Pamela Morgan,0,5,20,20
1746531271229,MCWP 50,A00,893758,Morshed; Michael James,0,0,20,20
1746531271229,MCWP 50,B00,893761,Bartulis; Jason Michael,17,0,20,3
1746531272262,MCWP 50R,A00,893766,Compas; Sean Matthew,0,1,20,20
1746531272262,MCWP 50R,B00,893769,Carter; Jennifer A,0,1,20,20
1746531272262,MCWP 50R,C00,893771,Krone; Jarret,0,3,20,20
1746531272262,MCWP 50R,D00,893772,Miller; Elizabeth Deen,0,0,20,20
1746531272262,MCWP 50R,E00,893775,Carter; Andrea L,0,1,20,20
1746531273293,MMW 11R,A01,892721,Herbst; Matthew,11,0,27,16
1746531273293,MMW 11R,A02,892722,Herbst; Matthew,0,0,0,3
1746531274322,MMW 12R,A01,892724,Herbst; Matthew,0,11,16,16
1746531274322,MMW 12R,A02,892725,Herbst; Matthew,0,10,16,16
1746531275352,MMW 13R,A01,892727,Staff,0,4,16,16
1746531275352,MMW 13R,A02,892728,Staff,0,4,16,16
1746531275352,MMW 13R,A03,958032,Staff,0,4,16,16
1746531275352,MMW 13R,A04,958033,Staff,0,4,16,16
1746531275352,MMW 13R,A05,958034,Staff,0,4,16,16
1746531276381,SIO 295LS,A00,894015,Staff,5,0,25,20
1746531277409,SIO 295S,A00,894020,Staff,5,0,25,20
1746531278435,SIOC 290S,B01,958918,Merrifield; Mark A,14,0,30,16
1746531279464,SIOC 291S,B01,958922,Gabriel; Corey John,14,0,30,16
1746531280493,SOCI 117,A01,895339,Staff,3,0,5,2
1746531281521,WES 237B,A00,894149,Staff,11,0,20,9
1746531283596,AESE 279B,A00,891859,Staff,13,0,35,22
1746531284623,AIP 197,001,891854,Vespa; Emanuel Ignacio,9999,0,9999,0
1746531285649,ANTH 289S,A00,891856,Gagneux; Pascal,12,0,12,0
1746531286678,BENG 196,001,957946,Engler; Adam J.,9996,0,9999,3
1746531287703,BISP 197,001,959851,Wilhelm; James E.,9999,0,9999,0
1746531288734,CAT 124RS,A01,956906,Staff,6,0,25,19
1746531289761,CAT 125RS,A01,922013,Staff,6,0,25,19
1746531290790,CLRE 250,A00,891860,Morris; Sheldon,9995,0,9999,4
1746531292849,CLRE 251R,A00,907817,Mehta; Ravindra L.,9994,0,9999,5
1746531293876,CLRE 252,A00,891864,Cuomo; Raphael Eduardo,9993,0,9999,6
1746531294903,CLRE 253,A00,891867,Vaida; Florin,9994,0,9999,5
1746531294903,CLRE 253,B00,907819,Staff,9999,0,9999,0
1746531295932,CLRE 259,A00,891868,Patel; Hemal,9998,0,9999,1
1746531296959,CLRE 260,A00,891872,Cuomo; Raphael Eduardo,9999,0,9999,0
1746531297986,CLRE 297,001,891888,Cuomo; Raphael Eduardo,9999,0,9999,0
1746531299012,CSE 191,A00,958773,Minnes Kemp; Mor Mia,9996,0,9999,3
1746531300040,CSE 197,001,959846,Minnes Kemp; Mor Mia,9993,0,9999,6
1746531301108,CSS 201S,A01,892054,Mignozzetti; Umberto,26,0,30,4
1746531302138,CSS 202S,A01,892056,Mignozzetti; Umberto,26,0,30,4
1746531303171,DSC 197,001,956898,Eldridge; Justin Matthew,9998,0,9999,1
1746531304198,DSC 297,001,958000,Mazumdar; Arya,9998,0,9999,1
1746531304198,DSC 297,002,959862,Wang; Yusu,9999,0,9999,0
1746531305227,EAP 100,A00,905686,Staff,9778,0,9999,221
1746531306258,ECE 45,A01,892618,Staff,0,0,65,65
1746531308313,ECE 111,A01,892719,Staff,4,0,65,61
1746531309341,ECE 197,001,957920,Mercier; Patrick Philip,9991,0,9999,8
1746531310371,ECON 178,A01,907814,Zhu; Ying,26,0,35,9
1746531311400,EDS 115,A00,895312,Staff,36,0,45,9
1746531312428,EDS 117,A01,895337,Staff,24,0,30,6
1746531313454,EDS 125,A00,895341,Jones; Gabrielle Anastasia,37,0,45,8
1746531314481,EDS 128A,A01,895459,Fargason; Sharon Gayle,44,0,45,1
1746531315508,EDS 128B,A01,895543,Pappas; Elizabeth,44,0,45,1
1746531316535,EDS 139,A00,897203,Pappas; Elizabeth,44,0,45,1
1746531316535,EDS 139,B00,897209,Fargason; Sharon Gayle,41,0,45,4
1746531317560,EDS 201,A00,895545,Staff,23,0,45,22
1746531318587,EDS 203,A01,895581,Halter; Christopher P.,23,0,45,22
1746531319617,EDS 204R,A01,895625,Heinzman; Erica M.,39,0,45,6
1746531319617,EDS 204R,B01,895693,Halter; Christopher P.,10,0,45,35
1746531320643,EDS 206R,A00,895694,Fargason; Sharon Gayle,1,0,30,29
1746531320643,EDS 206R,B00,895695,Choi; Bailey Miyeon,16,0,30,14
1746531321674,EDS 250,A00,895697,Hemans; Patricia Ann Benitez,23,0,45,22
1746531322701,EDS 281,A00,895701,Meyerott; Theresa Ann,1,0,15,14
1746531323735,EDS 284,A00,895736,Meyerott; Theresa Ann,1,0,15,14
1746531324765,EDS 286,A00,897210,Fine; Sarah,0,0,15,15
1746531325791,EDS 289C,A01,895770,Daly; Alan J.,15,0,15,0
1746531326821,EDS 290,A00,897211,Hofstetter; Carolyn,0,0,15,15
1746531327852,LIGM 5A,A00,896162,Fischer-Grunski; Eva K,13,0,20,7
1746531328878,LIGM 5B,A00,896260,Fischer-Grunski; Eva K,17,0,20,3
1746531329910,LIGM 5C,A00,896308,Fischer-Grunski; Eva K,18,0,20,2
1746531330940,LIIT 5AS,A00,896313,Carnelos; Chiara,18,0,20,2
1746531331972,LIIT 5BS,A00,896416,Carnelos; Chiara,20,0,20,0
1746531333004,LIIT 5CS,A00,896564,Carnelos; Chiara,20,0,20,0
1746531334035,LISP 5A,A00,896588,Munoz Sanchez; Alicia,3,0,20,17
1746531335064,LISP 5B,A00,896653,Munoz Sanchez; Alicia,7,0,20,13
1746531336094,LISP 5C,A00,896655,Munoz Sanchez; Alicia,0,1,20,20
1746531337122,MAE 197,001,957918,Kleissl; Jan,9996,0,9999,3
1746531337122,MAE 197,002,959806,Boechler; Nicholas Sebastia,9998,0,9999,1
1746531337122,MAE 197,003,959852,Mullin; Jennifer S,9999,0,9999,0
1746531338152,MATH 2,A01,957937,Staff,33,0,35,2
1746531339180,MATH 197,001,957876,Kedlaya; Kiran S.,9993,0,9999,6
1746531340206,MCWP 40,A00,892729,Duru; Nur,10,0,20,10
1746531340206,MCWP 40,B00,893304,Montejo; Carolina,14,0,20,6
1746531341234,MCWP 40R,A00,893757,Redela; Pamela Morgan,0,5,20,20
1746531342264,MCWP 50,A00,893758,Morshed; Michael James,0,0,20,20
1746531342264,MCWP 50,B00,893761,Bartulis; Jason Michael,17,0,20,3
1746531343293,MCWP 50R,A00,893766,Compas; Sean Matthew,0,1,20,20
1746531343293,MCWP 50R,B00,893769,Carter; Jennifer A,0,1,20,20
1746531343293,MCWP 50R,C00,893771,Krone; Jarret,0,3,20,20
1746531343293,MCWP 50R,D00,893772,Miller; Elizabeth Deen,0,0,20,20
1746531343293,MCWP 50R,E00,893775,Carter; Andrea L,0,1,20,20
1746531344321,MMW 11R,A01,892721,Herbst; Matthew,11,0,27,16
1746531344321,MMW 11R,A02,892722,Herbst; Matthew,0,0,0,3
1746531345347,MMW 12R,A01,892724,Herbst; Matthew,0,11,16,16
1746531345347,MMW 12R,A02,892725,Herbst; Matthew,0,10,16,16
1746531346377,MMW 13R,A01,892727,Staff,0,4,16,16
1746531346377,MMW 13R,A02,892728,Staff,0,4,16,16
1746531346377,MMW 13R,A03,958032,Staff,0,4,16,16
1746531346377,MMW 13R,A04,958033,Staff,0,4,16,16
1746531346377,MMW 13R,A05,958034,Staff,0,4,16,16
1746531347404,SIO 295LS,A00,894015,Staff,5,0,25,20
1746531348434,SIO 295S,A00,894020,Staff,5,0,25,20
1746531349464,SIOC 290S,B01,958918,Merrifield; Mark A,14,0,30,16
1746531350490,SIOC 291S,B01,958922,Gabriel; Corey John,14,0,30,16
1746531351521,SOCI 117,A01,895339,Staff,3,0,5,2
1746531352548,WES 237B,A00,894149,Staff,11,0,20,9
1746531354611,AESE 279B,A00,891859,Staff,13,0,35,22
1746531355639,AIP 197,001,891854,Vespa; Emanuel Ignacio,9999,0,9999,0
1746531356672,ANTH 289S,A00,891856,Gagneux; Pascal,12,0,12,0
1746531357699,BENG 196,001,957946,Engler; Adam J.,9996,0,9999,3
1746531358727,BISP 197,001,959851,Wilhelm; James E.,9999,0,9999,0
1746531359754,CAT 124RS,A01,956906,Staff,6,0,25,19
1746531360784,CAT 125RS,A01,922013,Staff,6,0,25,19
1746531361813,CLRE 250,A00,891860,Morris; Sheldon,9995,0,9999,4
1746531363870,CLRE 251R,A00,907817,Mehta; Ravindra L.,9994,0,9999,5
1746531364898,CLRE 252,A00,891864,Cuomo; Raphael Eduardo,9993,0,9999,6
1746531365929,CLRE 253,A00,891867,Vaida; Florin,9994,0,9999,5
1746531365929,CLRE 253,B00,907819,Staff,9999,0,9999,0
1746531366954,CLRE 259,A00,891868,Patel; Hemal,9998,0,9999,1
1746531367980,CLRE 260,A00,891872,Cuomo; Raphael Eduardo,9999,0,9999,0
1746531369009,CLRE 297,001,891888,Cuomo; Raphael Eduardo,9999,0,9999,0
1746531370041,CSE 191,A00,958773,Minnes Kemp; Mor Mia,9996,0,9999,3
1746531371068,CSE 197,001,959846,Minnes Kemp; Mor Mia,9993,0,9999,6
1746531372094,CSS 201S,A01,892054,Mignozzetti; Umberto,26,0,30,4
1746531373120,CSS 202S,A01,892056,Mignozzetti; Umberto,26,0,30,4
1746531374150,DSC 197,001,956898,Eldridge; Justin Matthew,9998,0,9999,1
1746531375177,DSC 297,001,958000,Mazumdar; Arya,9998,0,9999,1
1746531375177,DSC 297,002,959862,Wang; Yusu,9999,0,9999,0
1746531376205,EAP 100,A00,905686,Staff,9778,0,9999,221
1746531377233,ECE 45,A01,892618,Staff,0,0,65,65
1746531379287,ECE 111,A01,892719,Staff,4,0,65,61
1746531380315,ECE 197,001,957920,Mercier; Patrick Philip,9991,0,9999,8
1746531381346,ECON 178,A01,907814,Zhu; Ying,26,0,35,9
1746531382372,EDS 115,A00,895312,Staff,36,0,45,9
1746531383399,EDS 117,A01,895337,Staff,24,0,30,6
1746531384429,EDS 125,A00,895341,Jones; Gabrielle Anastasia,37,0,45,8
1746531385457,EDS 128A,A01,895459,Fargason; Sharon Gayle,44,0,45,1
1746531386484,EDS 128B,A01,895543,Pappas; Elizabeth,44,0,45,1
1746531387515,EDS 139,A00,897203,Pappas; Elizabeth,44,0,45,1
1746531387515,EDS 139,B00,897209,Fargason; Sharon Gayle,41,0,45,4
1746531388543,EDS 201,A00,895545,Staff,23,0,45,22
1746531389571,EDS 203,A01,895581,Halter; Christopher P.,23,0,45,22
1746531390602,EDS 204R,A01,895625,Heinzman; Erica M.,39,0,45,6
1746531390602,EDS 204R,B01,895693,Halter; Christopher P.,10,0,45,35
1746531391627,EDS 206R,A00,895694,Fargason; Sharon Gayle,1,0,30,29
1746531391627,EDS 206R,B00,895695,Choi; Bailey Miyeon,16,0,30,14
1746531392656,EDS 250,A00,895697,Hemans; Patricia Ann Benitez,23,0,45,22
1746531393685,EDS 281,A00,895701,Meyerott; Theresa Ann,1,0,15,14
1746531394711,EDS 284,A00,895736,Meyerott; Theresa Ann,1,0,15,14
1746531395740,EDS 286,A00,897210,Fine; Sarah,0,0,15,15
1746531396772,EDS 289C,A01,895770,Daly; Alan J.,15,0,15,0
1746531397801,EDS 290,A00,897211,Hofstetter; Carolyn,0,0,15,15
1746531398828,LIGM 5A,A00,896162,Fischer-Grunski; Eva K,13,0,20,7
1746531399862,LIGM 5B,A00,896260,Fischer-Grunski; Eva K,17,0,20,3
1746531400891,LIGM 5C,A00,896308,Fischer-Grunski; Eva K,18,0,20,2
1746531401919,LIIT 5AS,A00,896313,Carnelos; Chiara,18,0,20,2
1746531402948,LIIT 5BS,A00,896416,Carnelos; Chiara,20,0,20,0
1746531403978,LIIT 5CS,A00,896564,Carnelos; Chiara,20,0,20,0
1746531405045,LISP 5A,A00,896588,Munoz Sanchez; Alicia,3,0,20,17
1746531406073,LISP 5B,A00,896653,Munoz Sanchez; Alicia,7,0,20,13
1746531407100,LISP 5C,A00,896655,Munoz Sanchez; Alicia,0,1,20,20
1746531408125,MAE 197,001,957918,Kleissl; Jan,9996,0,9999,3
1746531408125,MAE 197,002,959806,Boechler; Nicholas Sebastia,9998,0,9999,1
1746531408125,MAE 197,003,959852,Mullin; Jennifer S,9999,0,9999,0
1746531409155,MATH 2,A01,957937,Staff,33,0,35,2
1746531410184,MATH 197,001,957876,Kedlaya; Kiran S.,9993,0,9999,6
1746531411214,MCWP 40,A00,892729,Duru; Nur,10,0,20,10
1746531411214,MCWP 40,B00,893304,Montejo; Carolina,14,0,20,6
1746531412243,MCWP 40R,A00,893757,Redela; Pamela Morgan,0,5,20,20
1746531413269,MCWP 50,A00,893758,Morshed; Michael James,0,0,20,20
1746531413269,MCWP 50,B00,893761,Bartulis; Jason Michael,17,0,20,3
1746531414299,MCWP 50R,A00,893766,Compas; Sean Matthew,0,1,20,20
1746531414299,MCWP 50R,B00,893769,Carter; Jennifer A,0,1,20,20
1746531414299,MCWP 50R,C00,893771,Krone; Jarret,0,3,20,20
1746531414299,MCWP 50R,D00,893772,Miller; Elizabeth Deen,0,0,20,20
1746531414299,MCWP 50R,E00,893775,Carter; Andrea L,0,1,20,20
1746531415325,MMW 11R,A01,892721,Herbst; Matthew,11,0,27,16
1746531415325,MMW 11R,A02,892722,Herbst; Matthew,0,0,0,3
1746531416356,MMW 12R,A01,892724,Herbst; Matthew,0,11,16,16
1746531416356,MMW 12R,A02,892725,Herbst; Matthew,0,10,16,16
1746531417382,MMW 13R,A01,892727,Staff,0,4,16,16
1746531417382,MMW 13R,A02,892728,Staff,0,4,16,16
1746531417382,MMW 13R,A03,958032,Staff,0,4,16,16
1746531417382,MMW 13R,A04,958033,Staff,0,4,16,16
1746531417382,MMW 13R,A05,958034,Staff,0,4,16,16
1746531418409,SIO 295LS,A00,894015,Staff,5,0,25,20
1746531419441,SIO 295S,A00,894020,Staff,5,0,25,20
1746531420468,SIOC 290S,B01,958918,Merrifield; Mark A,14,0,30,16
1746531421498,SIOC 291S,B01,958922,Gabriel; Corey John,14,0,30,16
1746531422526,SOCI 117,A01,895339,Staff,3,0,5,2
1746531435249,WES 237B,A00,894149,Staff,11,0,20,9
1746531437325,AESE 279B,A00,891859,Staff,13,0,35,22
1746531438351,AIP 197,001,891854,Vespa; Emanuel Ignacio,9999,0,9999,0
1746531439376,ANTH 289S,A00,891856,Gagneux; Pascal,12,0,12,0
1746531440404,BENG 196,001,957946,Engler; Adam J.,9996,0,9999,3
1746531441430,BISP 197,001,959851,Wilhelm; James E.,9999,0,9999,0
1746531442456,CAT 124RS,A01,956906,Staff,6,0,25,19
1746531443484,CAT 125RS,A01,922013,Staff,6,0,25,19
1746531444513,CLRE 250,A00,891860,Morris; Sheldon,9995,0,9999,4
1746531452717,CLRE 251R,A00,907817,Mehta; Ravindra L.,9994,0,9999,5
1746531453748,CLRE 252,A00,891864,Cuomo; Raphael Eduardo,9993,0,9999,6
1746531454778,CLRE 253,A00,891867,Vaida; Florin,9994,0,9999,5
1746531454778,CLRE 253,B00,907819,Staff,9999,0,9999,0
1746531455805,CLRE 259,A00,891868,Patel; Hemal,9998,0,9999,1
1746531456830,CLRE 260,A00,891872,Cuomo; Raphael Eduardo,9999,0,9999,0
1746531457856,CLRE 297,001,891888,Cuomo; Raphael Eduardo,9999,0,9999,0
1746531458883,CSE 191,A00,958773,Minnes Kemp; Mor Mia,9996,0,9999,3
1746531459913,CSE 197,001,959846,Minnes Kemp; Mor Mia,9993,0,9999,6
1746531460942,CSS 201S,A01,892054,Mignozzetti; Umberto,26,0,30,4
1746531461971,CSS 202S,A01,892056,Mignozzetti; Umberto,26,0,30,4
1746531462998,DSC 197,001,956898,Eldridge; Justin Matthew,9998,0,9999,1
1746531464026,DSC 297,001,958000,Mazumdar; Arya,9998,0,9999,1
1746531464026,DSC 297,002,959862,Wang; Yusu,9999,0,9999,0
1746531465054,EAP 100,A00,905686,Staff,9778,0,9999,221
1746531466083,ECE 45,A01,892618,Staff,0,0,65,65
1746531468141,ECE 111,A01,892719,Staff,4,0,65,61
1746531469171,ECE 197,001,957920,Mercier; Patrick Philip,9991,0,9999,8
1746531470199,ECON 178,A01,907814,Zhu; Ying,26,0,35,9
1746531471231,EDS 115,A00,895312,Staff,36,0,45,9
1746531472255,EDS 117,A01,895337,Staff,24,0,30,6
1746531473284,EDS 125,A00,895341,Jones; Gabrielle Anastasia,37,0,45,8
1746531474317,EDS 128A,A01,895459,Fargason; Sharon Gayle,44,0,45,1
1746531475345,EDS 128B,A01,895543,Pappas; Elizabeth,44,0,45,1
1746531476373,EDS 139,A00,897203,Pappas; Elizabeth,44,0,45,1
1746531476373,EDS 139,B00,897209,Fargason; Sharon Gayle,41,0,45,4
1746531477401,EDS 201,A00,895545,Staff,23,0,45,22
1746531478431,EDS 203,A01,895581,Halter; Christopher P.,23,0,45,22
1746531479463,EDS 204R,A01,895625,Heinzman; Erica M.,39,0,45,6
1746531479463,EDS 204R,B01,895693,Halter; Christopher P.,10,0,45,35
1746531480488,EDS 206R,A00,895694,Fargason; Sharon Gayle,1,0,30,29
1746531480488,EDS 206R,B00,895695,Choi; Bailey Miyeon,16,0,30,14
1746531481513,EDS 250,A00,895697,Hemans; Patricia Ann Benitez,23,0,45,22
1746531482542,EDS 281,A00,895701,Meyerott; Theresa Ann,1,0,15,14
1746531483573,EDS 284,A00,895736,Meyerott; Theresa Ann,1,0,15,14
1746531484599,EDS 286,A00,897210,Fine; Sarah,0,0,15,15
1746531485630,EDS 289C,A01,895770,Daly; Alan J.,15,0,15,0
1746531486657,EDS 290,A00,897211,Hofstetter; Carolyn,0,0,15,15
1746531487686,LIGM 5A,A00,896162,Fischer-Grunski; Eva K,13,0,20,7
1746531488719,LIGM 5B,A00,896260,Fischer-Grunski; Eva K,17,0,20,3
1746531489749,LIGM 5C,A00,896308,Fischer-Grunski; Eva K,18,0,20,2
1746531490777,LIIT 5AS,A00,896313,Carnelos; Chiara,18,0,20,2
1746531491804,LIIT 5BS,A00,896416,Carnelos; Chiara,20,0,20,0
1746531492835,LIIT 5CS,A00,896564,Carnelos; Chiara,20,0,20,0
1746531493862,LISP 5A,A00,896588,Munoz Sanchez; Alicia,3,0,20,17
1746531494895,LISP 5B,A00,896653,Munoz Sanchez; Alicia,7,0,20,13
1746531495924,LISP 5C,A00,896655,Munoz Sanchez; Alicia,0,1,20,20
1746531496953,MAE 197,001,957918,Kleissl; Jan,9996,0,9999,3
1746531496953,MAE 197,002,959806,Boechler; Nicholas Sebastia,9998,0,9999,1
1746531496953,MAE 197,003,959852,Mullin; Jennifer S,9999,0,9999,0
1746531497981,MATH 2,A01,957937,Staff,33,0,35,2
1746531499011,MATH 197,001,957876,Kedlaya; Kiran S.,9993,0,9999,6
1746531500040,MCWP 40,A00,892729,Duru; Nur,10,0,20,10
1746531500040,MCWP 40,B00,893304,Montejo; Carolina,14,0,20,6
1746531501067,MCWP 40R,A00,893757,Redela; Pamela Morgan,0,5,20,20
1746531502093,MCWP 50,A00,893758,Morshed; Michael James,0,0,20,20
1746531502093,MCWP 50,B00,893761,Bartulis; Jason Michael,17,0,20,3
1746531503125,MCWP 50R,A00,893766,Compas; Sean Matthew,0,1,20,20
1746531503125,MCWP 50R,B00,893769,Carter; Jennifer A,0,1,20,20
1746531503125,MCWP 50R,C00,893771,Krone; Jarret,0,3,20,20
1746531503125,MCWP 50R,D00,893772,Miller; Elizabeth Deen,0,0,20,20
1746531503125,MCWP 50R,E00,893775,Carter; Andrea L,0,1,20,20
1746531504154,MMW 11R,A01,892721,Herbst; Matthew,11,0,27,16
1746531504154,MMW 11R,A02,892722,Herbst; Matthew,0,0,0,3
1746531505181,MMW 12R,A01,892724,Herbst; Matthew,0,11,16,16
1746531505181,MMW 12R,A02,892725,Herbst; Matthew,0,10,16,16
1746531506211,MMW 13R,A01,892727,Staff,0,4,16,16
1746531506211,MMW 13R,A02,892728,Staff,0,4,16,16
1746531506211,MMW 13R,A03,958032,Staff,0,4,16,16
1746531506211,MMW 13R,A04,958033,Staff,0,4,16,16
1746531506211,MMW 13R,A05,958034,Staff,0,4,16,16
1746531507242,SIO 295LS,A00,894015,Staff,5,0,25,20
1746531508269,SIO 295S,A00,894020,Staff,5,0,25,20
1746531509300,SIOC 290S,B01,958918,Merrifield; Mark A,14,0,30,16
1746531510326,SIOC 291S,B01,958922,Gabriel; Corey John,14,0,30,16
1746531511352,SOCI 117,A01,895339,Staff,3,0,5,2
1746531512380,WES 237B,A00,894149,Staff,11,0,20,9
1746531514458,AESE 279B,A00,891859,Staff,13,0,35,22
1746531515484,AIP 197,001,891854,Vespa; Emanuel Ignacio,9999,0,9999,0
1746531516515,ANTH 289S,A00,891856,Gagneux; Pascal,12,0,12,0
1746531517540,BENG 196,001,957946,Engler; Adam J.,9996,0,9999,3
1746531518569,BISP 197,001,959851,Wilhelm; James E.,9999,0,9999,0
1746531519599,CAT 124RS,A01,956906,Staff,6,0,25,19
1746531520628,CAT 125RS,A01,922013,Staff,6,0,25,19
1746531521656,CLRE 250,A00,891860,Morris; Sheldon,9995,0,9999,4
1746531523711,CLRE 251R,A00,907817,Mehta; Ravindra L.,9994,0,9999,5
1746531524743,CLRE 252,A00,891864,Cuomo; Raphael Eduardo,9993,0,9999,6
1746531525767,CLRE 253,A00,891867,Vaida; Florin,9994,0,9999,5
1746531525767,CLRE 253,B00,907819,Staff,9999,0,9999,0
1746531526797,CLRE 259,A00,891868,Patel; Hemal,9998,0,9999,1
1746531527821,CLRE 260,A00,891872,Cuomo; Raphael Eduardo,9999,0,9999,0
1746531528847,CLRE 297,001,891888,Cuomo; Raphael Eduardo,9999,0,9999,0
1746531529877,CSE 191,A00,958773,Minnes Kemp; Mor Mia,9996,0,9999,3
1746531530903,CSE 197,001,959846,Minnes Kemp; Mor Mia,9993,0,9999,6
1746531531929,CSS 201S,A01,892054,Mignozzetti; Umberto,26,0,30,4
1746531532955,CSS 202S,A01,892056,Mignozzetti; Umberto,26,0,30,4
1746531533983,DSC 197,001,956898,Eldridge; Justin Matthew,9998,0,9999,1
1746531535013,DSC 297,001,958000,Mazumdar; Arya,9998,0,9999,1
1746531535013,DSC 297,002,959862,Wang; Yusu,9999,0,9999,0
1746531536041,EAP 100,A00,905686,Staff,9778,0,9999,221
1746531537069,ECE 45,A01,892618,Staff,0,0,65,65
1746531539126,ECE 111,A01,892719,Staff,4,0,65,61
1746531540153,ECE 197,001,957920,Mercier; Patrick Philip,9991,0,9999,8
1746531541181,ECON 178,A01,907814,Zhu; Ying,26,0,35,9
1746531542236,EDS 115,A00,895312,Staff,36,0,45,9
1746531543266,EDS 117,A01,895337,Staff,24,0,30,6
1746531544295,EDS 125,A00,895341,Jones; Gabrielle Anastasia,37,0,45,8
1746531545321,EDS 128A,A01,895459,Fargason; Sharon Gayle,44,0,45,1
1746531546350,EDS 128B,A01,895543,Pappas; Elizabeth,44,0,45,1
1746531547376,EDS 139,A00,897203,Pappas; Elizabeth,44,0,45,1
1746531547376,EDS 139,B00,897209,Fargason; Sharon Gayle,41,0,45,4
1746531548403,EDS 201,A00,895545,Staff,23,0,45,22
1746531549432,EDS 203,A01,895581,Halter; Christopher P.,23,0,45,22
1746531550458,EDS 204R,A01,895625,Heinzman; Erica M.,39,0,45,6
1746531550458,EDS 204R,B01,895693,Halter; Christopher P.,10,0,45,35
1746531551483,EDS 206R,A00,895694,Fargason; Sharon Gayle,1,0,30,29
1746531551483,EDS 206R,B00,895695,Choi; Bailey Miyeon,16,0,30,14
1746531552510,EDS 250,A00,895697,Hemans; Patricia Ann Benitez,23,0,45,22
1746531553541,EDS 281,A00,895701,Meyerott; Theresa Ann,1,0,15,14
1746531554570,EDS 284,A00,895736,Meyerott; Theresa Ann,1,0,15,14
1746531555599,EDS 286,A00,897210,Fine; Sarah,0,0,15,15
1746531556629,EDS 289C,A01,895770,Daly; Alan J.,15,0,15,0
1746531557655,EDS 290,A00,897211,Hofstetter; Carolyn,0,0,15,15
1746531558684,LIGM 5A,A00,896162,Fischer-Grunski; Eva K,13,0,20,7
1746531559721,LIGM 5B,A00,896260,Fischer-Grunski; Eva K,17,0,20,3
1746531560751,LIGM 5C,A00,896308,Fischer-Grunski; Eva K,18,0,20,2
1746531561779,LIIT 5AS,A00,896313,Carnelos; Chiara,18,0,20,2
1746531562808,LIIT 5BS,A00,896416,Carnelos; Chiara,20,0,20,0
1746531563841,LIIT 5CS,A00,896564,Carnelos; Chiara,20,0,20,0
1746531564870,LISP 5A,A00,896588,Munoz Sanchez; Alicia,3,0,20,17
1746531565897,LISP 5B,A00,896653,Munoz Sanchez; Alicia,7,0,20,13
1746531566924,LISP 5C,A00,896655,Munoz Sanchez; Alicia,0,1,20,20
1746531567953,MAE 197,001,957918,Kleissl; Jan,9996,0,9999,3
1746531567953,MAE 197,002,959806,Boechler; Nicholas Sebastia,9998,0,9999,1
1746531567953,MAE 197,003,959852,Mullin; Jennifer S,9999,0,9999,0
1746531568979,MATH 2,A01,957937,Staff,33,0,35,2
1746531570009,MATH 197,001,957876,Kedlaya; Kiran S.,9993,0,9999,6
1746531571038,MCWP 40,A00,892729,Duru; Nur,10,0,20,10
1746531571038,MCWP 40,B00,893304,Montejo; Carolina,14,0,20,6
1746531572066,MCWP 40R,A00,893757,Redela; Pamela Morgan,0,5,20,20
1746531573093,MCWP 50,A00,893758,Morshed; Michael James,0,0,20,20
1746531573093,MCWP 50,B00,893761,Bartulis; Jason Michael,17,0,20,3
1746531574120,MCWP 50R,A00,893766,Compas; Sean Matthew,0,1,20,20
1746531574120,MCWP 50R,B00,893769,Carter; Jennifer A,0,1,20,20
1746531574120,MCWP 50R,C00,893771,Krone; Jarret,0,3,20,20
1746531574120,MCWP 50R,D00,893772,Miller; Elizabeth Deen,0,0,20,20
1746531574120,MCWP 50R,E00,893775,Carter; Andrea L,0,1,20,20
1746531575146,MMW 11R,A01,892721,Herbst; Matthew,11,0,27,16
1746531575146,MMW 11R,A02,892722,Herbst; Matthew,0,0,0,3
1746531576176,MMW 12R,A01,892724,Herbst; Matthew,0,11,16,16
1746531576176,MMW 12R,A02,892725,Herbst; Matthew,0,10,16,16
1746531577201,MMW 13R,A01,892727,Staff,0,4,16,16
1746531577201,MMW 13R,A02,892728,Staff,0,4,16,16
1746531577201,MMW 13R,A03,958032,Staff,0,4,16,16
1746531577201,MMW 13R,A04,958033,Staff,0,4,16,16
1746531577201,MMW 13R,A05,958034,Staff,0,4,16,16
1746531578232,SIO 295LS,A00,894015,Staff,5,0,25,20
1746531579258,SIO 295S,A00,894020,Staff,5,0,25,20
1746531580286,SIOC 290S,B01,958918,Merrifield; Mark A,14,0,30,16
1746531581313,SIOC 291S,B01,958922,Gabriel; Corey John,14,0,30,16
1746531582345,SOCI 117,A01,895339,Staff,3,0,5,2
1746531583373,WES 237B,A00,894149,Staff,11,0,20,9
1746531585433,AESE 279B,A00,891859,Staff,13,0,35,22
1746531586463,AIP 197,001,891854,Vespa; Emanuel Ignacio,9999,0,9999,0
1746531587489,ANTH 289S,A00,891856,Gagneux; Pascal,12,0,12,0
1746531588517,BENG 196,001,957946,Engler; Adam J.,9996,0,9999,3
1746531589546,BISP 197,001,959851,Wilhelm; James E.,9999,0,9999,0
1746531590576,CAT 124RS,A01,956906,Staff,6,0,25,19
1746531591606,CAT 125RS,A01,922013,Staff,6,0,25,19
1746531592633,CLRE 250,A00,891860,Morris; Sheldon,9995,0,9999,4
1746531594684,CLRE 251R,A00,907817,Mehta; Ravindra L.,9994,0,9999,5
1746531595713,CLRE 252,A00,891864,Cuomo; Raphael Eduardo,9993,0,9999,6
1746531596741,CLRE 253,A00,891867,Vaida; Florin,9994,0,9999,5
1746531596741,CLRE 253,B00,907819,Staff,9999,0,9999,0
1746531597766,CLRE 259,A00,891868,Patel; Hemal,9998,0,9999,1
1746531598795,CLRE 260,A00,891872,Cuomo; Raphael Eduardo,9999,0,9999,0
1746531599826,CLRE 297,001,891888,Cuomo; Raphael Eduardo,9999,0,9999,0
1746531600854,CSE 191,A00,958773,Minnes Kemp; Mor Mia,9996,0,9999,3
1746531601882,CSE 197,001,959846,Minnes Kemp; Mor Mia,9993,0,9999,6
1746531602908,CSS 201S,A01,892054,Mignozzetti; Umberto,26,0,30,4
1746531603937,CSS 202S,A01,892056,Mignozzetti; Umberto,26,0,30,4
1746531604965,DSC 197,001,956898,Eldridge; Justin Matthew,9998,0,9999,1
1746531605995,DSC 297,001,958000,Mazumdar; Arya,9998,0,9999,1
1746531605995,DSC 297,002,959862,Wang; Yusu,9999,0,9999,0
1746531607023,EAP 100,A00,905686,Staff,9778,0,9999,221
1746531608055,ECE 45,A01,892618,Staff,0,0,65,65
1746531610113,ECE 111,A01,892719,Staff,4,0,65,61
1746531611142,ECE 197,001,957920,Mercier; Patrick Philip,9991,0,9999,8
1746531612171,ECON 178,A01,907814,Zhu; Ying,26,0,35,9
1746531613200,EDS 115,A00,895312,Staff,36,0,45,9
1746531614230,EDS 117,A01,895337,Staff,24,0,30,6
1746531615257,EDS 125,A00,895341,Jones; Gabrielle Anastasia,37,0,45,8
1746531616282,EDS 128A,A01,895459,Fargason; Sharon Gayle,44,0,45,1
1746531617310,EDS 128B,A01,895543,Pappas; Elizabeth,44,0,45,1
1746531618338,EDS 139,A00,897203,Pappas; Elizabeth,44,0,45,1
1746531618338,EDS 139,B00,897209,Fargason; Sharon Gayle,41,0,45,4
1746531619365,EDS 201,A00,895545,Staff,23,0,45,22
1746531620396,EDS 203,A01,895581,Halter; Christopher P.,23,0,45,22
1746531621426,EDS 204R,A01,895625,Heinzman; Erica M.,39,0,45,6
1746531621426,EDS 204R,B01,895693,Halter; Christopher P.,10,0,45,35
1746531622456,EDS 206R,A00,895694,Fargason; Sharon Gayle,1,0,30,29
1746531622456,EDS 206R,B00,895695,Choi; Bailey Miyeon,16,0,30,14
1746531623484,EDS 250,A00,895697,Hemans; Patricia Ann Benitez,23,0,45,22
1746531624511,EDS 281,A00,895701,Meyerott; Theresa Ann,1,0,15,14
1746531625541,EDS 284,A00,895736,Meyerott; Theresa Ann,1,0,15,14
1746531626571,EDS 286,A00,897210,Fine; Sarah,0,0,15,15
1746531627600,EDS 289C,A01,895770,Daly; Alan J.,15,0,15,0
1746531628630,EDS 290,A00,897211,Hofstetter; Carolyn,0,0,15,15
1746531629660,LIGM 5A,A00,896162,Fischer-Grunski; Eva K,13,0,20,7
1746531630691,LIGM 5B,A00,896260,Fischer-Grunski; Eva K,17,0,20,3
1746531631716,LIGM 5C,A00,896308,Fischer-Grunski; Eva K,18,0,20,2
1746531632741,LIIT 5AS,A00,896313,Carnelos; Chiara,18,0,20,2
1746531633776,LIIT 5BS,A00,896416,Carnelos; Chiara,20,0,20,0
1746531634804,LIIT 5CS,A00,896564,Carnelos; Chiara,20,0,20,0
1746531635835,LISP 5A,A00,896588,Munoz Sanchez; Alicia,3,0,20,17
1746531636865,LISP 5B,A00,896653,Munoz Sanchez; Alicia,7,0,20,13
1746531637895,LISP 5C,A00,896655,Munoz Sanchez; Alicia,0,1,20,20
1746531638921,MAE 197,001,957918,Kleissl; Jan,9996,0,9999,3
1746531638921,MAE 197,002,959806,Boechler; Nicholas Sebastia,9998,0,9999,1
1746531638921,MAE 197,003,959852,Mullin; Jennifer S,9999,0,9999,0
1746531639948,MATH 2,A01,957937,Staff,33,0,35,2
1746531640976,MATH 197,001,957876,Kedlaya; Kiran S.,9993,0,9999,6
1746531642003,MCWP 40,A00,892729,Duru; Nur,10,0,20,10
1746531642003,MCWP 40,B00,893304,Montejo; Carolina,14,0,20,6
1746531643032,MCWP 40R,A00,893757,Redela; Pamela Morgan,0,5,20,20
1746531644060,MCWP 50,A00,893758,Morshed; Michael James,0,0,20,20
1746531644060,MCWP 50,B00,893761,Bartulis; Jason Michael,17,0,20,3
1746531645088,MCWP 50R,A00,893766,Compas; Sean Matthew,0,1,20,20
1746531645088,MCWP 50R,B00,893769,Carter; Jennifer A,0,1,20,20
1746531645088,MCWP 50R,C00,893771,Krone; Jarret,0,3,20,20
1746531645088,MCWP 50R,D00,893772,Miller; Elizabeth Deen,0,0,20,20
1746531645088,MCWP 50R,E00,893775,Carter; Andrea L,0,1,20,20
1746531646118,MMW 11R,A01,892721,Herbst; Matthew,11,0,27,16
1746531646118,MMW 11R,A02,892722,Herbst; Matthew,0,0,0,3
1746531647145,MMW 12R,A01,892724,Herbst; Matthew,0,11,16,16
1746531647145,MMW 12R,A02,892725,Herbst; Matthew,0,10,16,16
1746531648173,MMW 13R,A01,892727,Staff,0,4,16,16
1746531648173,MMW 13R,A02,892728,Staff,0,4,16,16
1746531648173,MMW 13R,A03,958032,Staff,0,4,16,16
1746531648173,MMW 13R,A04,958033,Staff,0,4,16,16
1746531648173,MMW 13R,A05,958034,Staff,0,4,16,16
1746531649199,SIO 295LS,A00,894015,Staff,5,0,25,20
1746531650226,SIO 295S,A00,894020,Staff,5,0,25,20
1746531651252,SIOC 290S,B01,958918,Merrifield; Mark A,14,0,30,16
1746531652286,SIOC 291S,B01,958922,Gabriel; Corey John,14,0,30,16
1746531653312,SOCI 117,A01,895339,Staff,3,0,5,2
1746531654342,WES 237B,A00,894149,Staff,11,0,20,9
1746531656410,AESE 279B,A00,891859,Staff,13,0,35,22
1746531657435,AIP 197,001,891854,Vespa; Emanuel Ignacio,9999,0,9999,0
1746531658462,ANTH 289S,A00,891856,Gagneux; Pascal,12,0,12,0
1746531659491,BENG 196,001,957946,Engler; Adam J.,9996,0,9999,3
1746531660519,BISP 197,001,959851,Wilhelm; James E.,9999,0,9999,0
1746531661547,CAT 124RS,A01,956906,Staff,6,0,25,19
1746531662577,CAT 125RS,A01,922013,Staff,6,0,25,19
1746531663606,CLRE 250,A00,891860,Morris; Sheldon,9995,0,9999,4
1746531665661,CLRE 251R,A00,907817,Mehta; Ravindra L.,9994,0,9999,5
1746531666694,CLRE 252,A00,891864,Cuomo; Raphael Eduardo,9993,0,9999,6
1746531667724,CLRE 253,A00,891867,Vaida; Florin,9994,0,9999,5
1746531667724,CLRE 253,B00,907819,Staff,9999,0,9999,0
1746531668752,CLRE 259,A00,891868,Patel; Hemal,9998,0,9999,1
1746531669782,CLRE 260,A00,891872,Cuomo; Raphael Eduardo,9999,0,9999,0
1746531670808,CLRE 297,001,891888,Cuomo; Raphael Eduardo,9999,0,9999,0
1746531671837,CSE 191,A00,958773,Minnes Kemp; Mor Mia,9996,0,9999,3
1746531672865,CSE 197,001,959846,Minnes Kemp; Mor Mia,9993,0,9999,6
1746531673897,CSS 201S,A01,892054,Mignozzetti; Umberto,26,0,30,4
1746531674928,CSS 202S,A01,892056,Mignozzetti; Umberto,26,0,30,4
1746531675956,DSC 197,001,956898,Eldridge; Justin Matthew,9998,0,9999,1
1746531676983,DSC 297,001,958000,Mazumdar; Arya,9998,0,9999,1
1746531676983,DSC 297,002,959862,Wang; Yusu,9999,0,9999,0
1746531678010,EAP 100,A00,905686,Staff,9778,0,9999,221
1746531679039,ECE 45,A01,892618,Staff,0,0,65,65
1746531681109,ECE 111,A01,892719,Staff,4,0,65,61
1746531682138,ECE 197,001,957920,Mercier; Patrick Philip,9991,0,9999,8
1746531683162,ECON 178,A01,907814,Zhu; Ying,26,0,35,9
1746531684192,EDS 115,A00,895312,Staff,36,0,45,9
1746531685218,EDS 117,A01,895337,Staff,24,0,30,6
1746531686246,EDS 125,A00,895341,Jones; Gabrielle Anastasia,37,0,45,8
1746531687276,EDS 128A,A01,895459,Fargason; Sharon Gayle,44,0,45,1
1746531688307,EDS 128B,A01,895543,Pappas; Elizabeth,44,0,45,1
1746531689332,EDS 139,A00,897203,Pappas; Elizabeth,44,0,45,1
1746531689332,EDS 139,B00,897209,Fargason; Sharon Gayle,41,0,45,4
1746531690359,EDS 201,A00,895545,Staff,23,0,45,22
1746531691387,EDS 203,A01,895581,Halter; Christopher P.,23,0,45,22
1746531692414,EDS 204R,A01,895625,Heinzman; Erica M.,39,0,45,6
1746531692414,EDS 204R,B01,895693,Halter; Christopher P.,10,0,45,35
1746531693446,EDS 206R,A00,895694,Fargason; Sharon Gayle,1,0,30,29
1746531693446,EDS 206R,B00,895695,Choi; Bailey Miyeon,16,0,30,14
1746531694474,EDS 250,A00,895697,Hemans; Patricia Ann Benitez,23,0,45,22
1746531695502,EDS 281,A00,895701,Meyerott; Theresa Ann,1,0,15,14
1746531696531,EDS 284,A00,895736,Meyerott; Theresa Ann,1,0,15,14
1746531697558,EDS 286,A00,897210,Fine; Sarah,0,0,15,15
1746531698589,EDS 289C,A01,895770,Daly; Alan J.,15,0,15,0
1746531699620,EDS 290,A00,897211,Hofstetter; Carolyn,0,0,15,15
1746531700648,LIGM 5A,A00,896162,Fischer-Grunski; Eva K,13,0,20,7
1746531701681,LIGM 5B,A00,896260,Fischer-Grunski; Eva K,17,0,20,3
1746531702710,LIGM 5C,A00,896308,Fischer-Grunski; Eva K,18,0,20,2
1746531703741,LIIT 5AS,A00,896313,Carnelos; Chiara,18,0,20,2
1746531704771,LIIT 5BS,A00,896416,Carnelos; Chiara,20,0,20,0
1746531705800,LIIT 5CS,A00,896564,Carnelos; Chiara,20,0,20,0
1746531706827,LISP 5A,A00,896588,Munoz Sanchez; Alicia,3,0,20,17
1746531707856,LISP 5B,A00,896653,Munoz Sanchez; Alicia,7,0,20,13
1746531708885,LISP 5C,A00,896655,Munoz Sanchez; Alicia,0,1,20,20
1746531709912,MAE 197,001,957918,Kleissl; Jan,9996,0,9999,3
1746531709912,MAE 197,002,959806,Boechler; Nicholas Sebastia,9998,0,9999,1
1746531709912,MAE 197,003,959852,Mullin; Jennifer S,9999,0,9999,0
1746531710938,MATH 2,A01,957937,Staff,33,0,35,2
1746531711965,MATH 197,001,957876,Kedlaya; Kiran S.,9993,0,9999,6
1746531712992,MCWP 40,A00,892729,Duru; Nur,10,0,20,10
1746531712992,MCWP 40,B00,893304,Montejo; Carolina,14,0,20,6
1746531714046,MCWP 40R,A00,893757,Redela; Pamela Morgan,0,5,20,20
1746531715076,MCWP 50,A00,893758,Morshed; Michael James,0,0,20,20
1746531715076,MCWP 50,B00,893761,Bartulis; Jason Michael,17,0,20,3
1746531716104,MCWP 50R,A00,893766,Compas; Sean Matthew,0,1,20,20
1746531716104,MCWP 50R,B00,893769,Carter; Jennifer A,0,1,20,20
1746531716104,MCWP 50R,C00,893771,Krone; Jarret,0,3,20,20
1746531716104,MCWP 50R,D00,893772,Miller; Elizabeth Deen,0,0,20,20
1746531716104,MCWP 50R,E00,893775,Carter; Andrea L,0,1,20,20
1746531717131,MMW 11R,A01,892721,Herbst; Matthew,11,0,27,16
1746531717131,MMW 11R,A02,892722,Herbst; Matthew,0,0,0,3
1746531718157,MMW 12R,A01,892724,Herbst; Matthew,0,11,16,16
1746531718157,MMW 12R,A02,892725,Herbst; Matthew,0,10,16,16
1746531719184,MMW 13R,A01,892727,Staff,0,4,16,16
1746531719184,MMW 13R,A02,892728,Staff,0,4,16,16
1746531719184,MMW 13R,A03,958032,Staff,0,4,16,16
1746531719184,MMW 13R,A04,958033,Staff,0,4,16,16
1746531719184,MMW 13R,A05,958034,Staff,0,4,16,16
1746531720212,SIO 295LS,A00,894015,Staff,5,0,25,20
1746531721239,SIO 295S,A00,894020,Staff,5,0,25,20
1746531722266,SIOC 290S,B01,958918,Merrifield; Mark A,14,0,30,16
1746531723292,SIOC 291S,B01,958922,Gabriel; Corey John,14,0,30,16
1746531724320,SOCI 117,A01,895339,Staff,3,0,5,2
1746531725349,WES 237B,A00,894149,Staff,11,0,20,9
1746531727414,AESE 279B,A00,891859,Staff,13,0,35,22
1746531728441,AIP 197,001,891854,Vespa; Emanuel Ignacio,9999,0,9999,0
1746531729468,ANTH 289S,A00,891856,Gagneux; Pascal,12,0,12,0
1746531730494,BENG 196,001,957946,Engler; Adam J.,9996,0,9999,3
1746531731519,BISP 197,001,959851,Wilhelm; James E.,9999,0,9999,0
1746531732547,CAT 124RS,A01,956906,Staff,6,0,25,19
1746531733574,CAT 125RS,A01,922013,Staff,6,0,25,19
1746531734602,CLRE 250,A00,891860,Morris; Sheldon,9995,0,9999,4
1746531736656,CLRE 251R,A00,907817,Mehta; Ravindra L.,9994,0,9999,5
1746531737683,CLRE 252,A00,891864,Cuomo; Raphael Eduardo,9993,0,9999,6
1746531738709,CLRE 253,A00,891867,Vaida; Florin,9994,0,9999,5
1746531738709,CLRE 253,B00,907819,Staff,9999,0,9999,0
1746531739739,CLRE 259,A00,891868,Patel; Hemal,9998,0,9999,1
1746531740766,CLRE 260,A00,891872,Cuomo; Raphael Eduardo,9999,0,9999,0
1746531741792,CLRE 297,001,891888,Cuomo; Raphael Eduardo,9999,0,9999,0
1746531742822,CSE 191,A00,958773,Minnes Kemp; Mor Mia,9996,0,9999,3
1746531743850,CSE 197,001,959846,Minnes Kemp; Mor Mia,9993,0,9999,6
1746531744884,CSS 201S,A01,892054,Mignozzetti; Umberto,26,0,30,4
1746531745912,CSS 202S,A01,892056,Mignozzetti; Umberto,26,0,30,4
1746531746939,DSC 197,001,956898,Eldridge; Justin Matthew,9998,0,9999,1
1746531747970,DSC 297,001,958000,Mazumdar; Arya,9998,0,9999,1
1746531747970,DSC 297,002,959862,Wang; Yusu,9999,0,9999,0
1746531748998,EAP 100,A00,905686,Staff,9778,0,9999,221
1746531750032,ECE 45,A01,892618,Staff,0,0,65,65
1746531752087,ECE 111,A01,892719,Staff,4,0,65,61
1746531753115,ECE 197,001,957920,Mercier; Patrick Philip,9991,0,9999,8
1746531754145,ECON 178,A01,907814,Zhu; Ying,26,0,35,9
1746531755173,EDS 115,A00,895312,Staff,36,0,45,9
1746531756203,EDS 117,A01,895337,Staff,24,0,30,6
1746531757229,EDS 125,A00,895341,Jones; Gabrielle Anastasia,37,0,45,8
1746531758256,EDS 128A,A01,895459,Fargason; Sharon Gayle,44,0,45,1
1746531759284,EDS 128B,A01,895543,Pappas; Elizabeth,44,0,45,1
1746531760314,EDS 139,A00,897203,Pappas; Elizabeth,44,0,45,1
1746531760314,EDS 139,B00,897209,Fargason; Sharon Gayle,41,0,45,4
1746531761342,EDS 201,A00,895545,Staff,23,0,45,22
1746531762370,EDS 203,A01,895581,Halter; Christopher P.,23,0,45,22
1746531763401,EDS 204R,A01,895625,Heinzman; Erica M.,39,0,45,6
1746531763401,EDS 204R,B01,895693,Halter; Christopher P.,10,0,45,35
1746531764429,EDS 206R,A00,895694,Fargason; Sharon Gayle,1,0,30,29
1746531764429,EDS 206R,B00,895695,Choi; Bailey Miyeon,16,0,30,14
1746531765453,EDS 250,A00,895697,Hemans; Patricia Ann Benitez,23,0,45,22
1746531766480,EDS 281,A00,895701,Meyerott; Theresa Ann,1,0,15,14
1746531767508,EDS 284,A00,895736,Meyerott; Theresa Ann,1,0,15,14
1746531768534,EDS 286,A00,897210,Fine; Sarah,0,0,15,15
1746531769565,EDS 289C,A01,895770,Daly; Alan J.,15,0,15,0
1746531770597,EDS 290,A00,897211,Hofstetter; Carolyn,0,0,15,15
1746531771625,LIGM 5A,A00,896162,Fischer-Grunski; Eva K,13,0,20,7
1746531772656,LIGM 5B,A00,896260,Fischer-Grunski; Eva K,17,0,20,3
1746531773685,LIGM 5C,A00,896308,Fischer-Grunski; Eva K,18,0,20,2
1746531774720,LIIT 5AS,A00,896313,Carnelos; Chiara,18,0,20,2
1746531775747,LIIT 5BS,A00,896416,Carnelos; Chiara,20,0,20,0
1746531776771,LIIT 5CS,A00,896564,Carnelos; Chiara,20,0,20,0
1746531777801,LISP 5A,A00,896588,Munoz Sanchez; Alicia,3,0,20,17
1746531778835,LISP 5B,A00,896653,Munoz Sanchez; Alicia,7,0,20,13
1746531779865,LISP 5C,A00,896655,Munoz Sanchez; Alicia,0,1,20,20
1746531780894,MAE 197,001,957918,Kleissl; Jan,9996,0,9999,3
1746531780894,MAE 197,002,959806,Boechler; Nicholas Sebastia,9998,0,9999,1
1746531780894,MAE 197,003,959852,Mullin; Jennifer S,9999,0,9999,0
1746531781922,MATH 2,A01,957937,Staff,33,0,35,2
1746531782947,MATH 197,001,957876,Kedlaya; Kiran S.,9993,0,9999,6
1746531783976,MCWP 40,A00,892729,Duru; Nur,10,0,20,10
1746531783976,MCWP 40,B00,893304,Montejo; Carolina,14,0,20,6
1746531785002,MCWP 40R,A00,893757,Redela; Pamela Morgan,0,5,20,20
1746531786033,MCWP 50,A00,893758,Morshed; Michael James,0,0,20,20
1746531786033,MCWP 50,B00,893761,Bartulis; Jason Michael,17,0,20,3
1746531787064,MCWP 50R,A00,893766,Compas; Sean Matthew,0,1,20,20
1746531787064,MCWP 50R,B00,893769,Carter; Jennifer A,0,1,20,20
1746531787064,MCWP 50R,C00,893771,Krone; Jarret,0,3,20,20
1746531787064,MCWP 50R,D00,893772,Miller; Elizabeth Deen,0,0,20,20
1746531787064,MCWP 50R,E00,893775,Carter; Andrea L,0,1,20,20
1746531788092,MMW 11R,A01,892721,Herbst; Matthew,11,0,27,16
1746531788092,MMW 11R,A02,892722,Herbst; Matthew,0,0,0,3
1746531789119,MMW 12R,A01,892724,Herbst; Matthew,0,11,16,16
1746531789119,MMW 12R,A02,892725,Herbst; Matthew,0,10,16,16
1746531790150,MMW 13R,A01,892727,Staff,0,4,16,16
1746531790150,MMW 13R,A02,892728,Staff,0,4,16,16
1746531790150,MMW 13R,A03,958032,Staff,0,4,16,16
1746531790150,MMW 13R,A04,958033,Staff,0,4,16,16
1746531790150,MMW 13R,A05,958034,Staff,0,4,16,16
1746531791178,SIO 295LS,A00,894015,Staff,5,0,25,20
1746531792205,SIO 295S,A00,894020,Staff,5,0,25,20
1746531793231,SIOC 290S,B01,958918,Merrifield; Mark A,14,0,30,16
1746531794256,SIOC 291S,B01,958922,Gabriel; Corey John,14,0,30,16
1746531795284,SOCI 117,A01,895339,Staff,3,0,5,2
1746531796312,WES 237B,A00,894149,Staff,11,0,20,9
1746531798380,AESE 279B,A00,891859,Staff,13,0,35,22
1746531799415,AIP 197,001,891854,Vespa; Emanuel Ignacio,9999,0,9999,0
1746531800443,ANTH 289S,A00,891856,Gagneux; Pascal,12,0,12,0
1746531801475,BENG 196,001,957946,Engler; Adam J.,9996,0,9999,3
1746531802503,BISP 197,001,959851,Wilhelm; James E.,9999,0,9999,0
1746531803530,CAT 124RS,A01,956906,Staff,6,0,25,19
1746531804560,CAT 125RS,A01,922013,Staff,6,0,25,19
1746531805588,CLRE 250,A00,891860,Morris; Sheldon,9995,0,9999,4
1746531807642,CLRE 251R,A00,907817,Mehta; Ravindra L.,9994,0,9999,5
1746531808672,CLRE 252,A00,891864,Cuomo; Raphael Eduardo,9993,0,9999,6
1746531809697,CLRE 253,A00,891867,Vaida; Florin,9994,0,9999,5
1746531809697,CLRE 253,B00,907819,Staff,9999,0,9999,0
1746531810723,CLRE 259,A00,891868,Patel; Hemal,9998,0,9999,1
1746531811758,CLRE 260,A00,891872,Cuomo; Raphael Eduardo,9999,0,9999,0
1746531812784,CLRE 297,001,891888,Cuomo; Raphael Eduardo,9999,0,9999,0
1746531813813,CSE 191,A00,958773,Minnes Kemp; Mor Mia,9996,0,9999,3
1746531814840,CSE 197,001,959846,Minnes Kemp; Mor Mia,9993,0,9999,6
1746531815868,CSS 201S,A01,892054,Mignozzetti; Umberto,26,0,30,4
1746531816895,CSS 202S,A01,892056,Mignozzetti; Umberto,26,0,30,4
1746531817922,DSC 197,001,956898,Eldridge; Justin Matthew,9998,0,9999,1
1746531818947,DSC 297,001,958000,Mazumdar; Arya,9998,0,9999,1
1746531818947,DSC 297,002,959862,Wang; Yusu,9999,0,9999,0
1746531819972,EAP 100,A00,905686,Staff,9778,0,9999,221
1746531821005,ECE 45,A01,892618,Staff,0,0,65,65
1746531823064,ECE 111,A01,892719,Staff,4,0,65,61
1746531824091,ECE 197,001,957920,Mercier; Patrick Philip,9991,0,9999,8
1746531825119,ECON 178,A01,907814,Zhu; Ying,26,0,35,9
1746531826145,EDS 115,A00,895312,Staff,36,0,45,9
1746531827171,EDS 117,A01,895337,Staff,24,0,30,6
1746531828199,EDS 125,A00,895341,Jones; Gabrielle Anastasia,37,0,45,8
1746531829225,EDS 128A,A01,895459,Fargason; Sharon Gayle,44,0,45,1
1746531830257,EDS 128B,A01,895543,Pappas; Elizabeth,44,0,45,1
1746531831286,EDS 139,A00,897203,Pappas; Elizabeth,44,0,45,1
1746531831286,EDS 139,B00,897209,Fargason; Sharon Gayle,41,0,45,4
1746531832314,EDS 201,A00,895545,Staff,23,0,45,22
1746531833342,EDS 203,A01,895581,Halter; Christopher P.,23,0,45,22
1746531834370,EDS 204R,A01,895625,Heinzman; Erica M.,39,0,45,6
1746531834370,EDS 204R,B01,895693,Halter; Christopher P.,10,0,45,35
1746531835401,EDS 206R,A00,895694,Fargason; Sharon Gayle,1,0,30,29
1746531835401,EDS 206R,B00,895695,Choi; Bailey Miyeon,16,0,30,14
1746531836429,EDS 250,A00,895697,Hemans; Patricia Ann Benitez,23,0,45,22
1746531837454,EDS 281,A00,895701,Meyerott; Theresa Ann,1,0,15,14
1746531838479,EDS 284,A00,895736,Meyerott; Theresa Ann,1,0,15,14
1746531839506,EDS 286,A00,897210,Fine; Sarah,0,0,15,15
1746531840533,EDS 289C,A01,895770,Daly; Alan J.,15,0,15,0
1746531841562,EDS 290,A00,897211,Hofstetter; Carolyn,0,0,15,15
1746531842595,LIGM 5A,A00,896162,Fischer-Grunski; Eva K,13,0,20,7
1746531843627,LIGM 5B,A00,896260,Fischer-Grunski; Eva K,17,0,20,3
1746531844659,LIGM 5C,A00,896308,Fischer-Grunski; Eva K,18,0,20,2
1746531845690,LIIT 5AS,A00,896313,Carnelos; Chiara,18,0,20,2
1746531846720,LIIT 5BS,A00,896416,Carnelos; Chiara,20,0,20,0
1746531847747,LIIT 5CS,A00,896564,Carnelos; Chiara,20,0,20,0
1746531848779,LISP 5A,A00,896588,Munoz Sanchez; Alicia,3,0,20,17
1746531849805,LISP 5B,A00,896653,Munoz Sanchez; Alicia,7,0,20,13
1746531850835,LISP 5C,A00,896655,Munoz Sanchez; Alicia,0,1,20,20
1746531851863,MAE 197,001,957918,Kleissl; Jan,9996,0,9999,3
1746531851863,MAE 197,002,959806,Boechler; Nicholas Sebastia,9998,0,9999,1
1746531851863,MAE 197,003,959852,Mullin; Jennifer S,9999,0,9999,0
1746531852892,MATH 2,A01,957937,Staff,33,0,35,2
1746531853919,MATH 197,001,957876,Kedlaya; Kiran S.,9993,0,9999,6
1746531854950,MCWP 40,A00,892729,Duru; Nur,10,0,20,10
1746531854950,MCWP 40,B00,893304,Montejo; Carolina,14,0,20,6
1746531855975,MCWP 40R,A00,893757,Redela; Pamela Morgan,0,5,20,20
1746531857008,MCWP 50,A00,893758,Morshed; Michael James,0,0,20,20
1746531857008,MCWP 50,B00,893761,Bartulis; Jason Michael,17,0,20,3
1746531858037,MCWP 50R,A00,893766,Compas; Sean Matthew,0,1,20,20
1746531858037,MCWP 50R,B00,893769,Carter; Jennifer A,0,1,20,20
1746531858037,MCWP 50R,C00,893771,Krone; Jarret,0,3,20,20
1746531858037,MCWP 50R,D00,893772,Miller; Elizabeth Deen,0,0,20,20
1746531858037,MCWP 50R,E00,893775,Carter; Andrea L,0,1,20,20
1746531859067,MMW 11R,A01,892721,Herbst; Matthew,11,0,27,16
1746531859067,MMW 11R,A02,892722,Herbst; Matthew,0,0,0,3
1746531860095,MMW 12R,A01,892724,Herbst; Matthew,0,11,16,16
1746531860095,MMW 12R,A02,892725,Herbst; Matthew,0,10,16,16
1746531861124,MMW 13R,A01,892727,Staff,0,4,16,16
1746531861124,MMW 13R,A02,892728,Staff,0,4,16,16
1746531861124,MMW 13R,A03,958032,Staff,0,4,16,16
1746531861124,MMW 13R,A04,958033,Staff,0,4,16,16
1746531861124,MMW 13R,A05,958034,Staff,0,4,16,16
1746531862150,SIO 295LS,A00,894015,Staff,5,0,25,20
1746531863177,SIO 295S,A00,894020,Staff,5,0,25,20
1746531864262,SIOC 290S,B01,958918,Merrifield; Mark A,14,0,30,16
1746531865292,SIOC 291S,B01,958922,Gabriel; Corey John,14,0,30,16
1746531866319,SOCI 117,A01,895339,Staff,3,0,5,2
1746531867349,WES 237B,A00,894149,Staff,11,0,20,9
1746531869425,AESE 279B,A00,891859,Staff,13,0,35,22
1746531870455,AIP 197,001,891854,Vespa; Emanuel Ignacio,9999,0,9999,0
1746531871483,ANTH 289S,A00,891856,Gagneux; Pascal,12,0,12,0
1746531872510,BENG 196,001,957946,Engler; Adam J.,9996,0,9999,3
1746531873541,BISP 197,001,959851,Wilhelm; James E.,9999,0,9999,0
1746531874567,CAT 124RS,A01,956906,Staff,6,0,25,19
1746531875593,CAT 125RS,A01,922013,Staff,6,0,25,19
1746531876626,CLRE 250,A00,891860,Morris; Sheldon,9995,0,9999,4
1746531878683,CLRE 251R,A00,907817,Mehta; Ravindra L.,9994,0,9999,5
1746531879709,CLRE 252,A00,891864,Cuomo; Raphael Eduardo,9993,0,9999,6
1746531880739,CLRE 253,A00,891867,Vaida; Florin,9994,0,9999,5
1746531880739,CLRE 253,B00,907819,Staff,9999,0,9999,0
1746531881768,CLRE 259,A00,891868,Patel; Hemal,9998,0,9999,1
1746531882798,CLRE 260,A00,891872,Cuomo; Raphael Eduardo,9999,0,9999,0
1746531883823,CLRE 297,001,891888,Cuomo; Raphael Eduardo,9999,0,9999,0
1746531884851,CSE 191,A00,958773,Minnes Kemp; Mor Mia,9996,0,9999,3
1746531885880,CSE 197,001,959846,Minnes Kemp; Mor Mia,9993,0,9999,6
1746531886907,CSS 201S,A01,892054,Mignozzetti; Umberto,26,0,30,4
1746531887936,CSS 202S,A01,892056,Mignozzetti; Umberto,26,0,30,4
1746531888966,DSC 197,001,956898,Eldridge; Justin Matthew,9998,0,9999,1
1746531889994,DSC 297,001,958000,Mazumdar; Arya,9998,0,9999,1
1746531889994,DSC 297,002,959862,Wang; Yusu,9999,0,9999,0
1746531891019,EAP 100,A00,905686,Staff,9778,0,9999,221
1746531892052,ECE 45,A01,892618,Staff,0,0,65,65
1746531894112,ECE 111,A01,892719,Staff,4,0,65,61
1746531895141,ECE 197,001,957920,Mercier; Patrick Philip,9991,0,9999,8
1746531896174,ECON 178,A01,907814,Zhu; Ying,26,0,35,9
1746531897204,EDS 115,A00,895312,Staff,36,0,45,9
1746531898234,EDS 117,A01,895337,Staff,24,0,30,6
1746531899261,EDS 125,A00,895341,Jones; Gabrielle Anastasia,37,0,45,8
1746531900293,EDS 128A,A01,895459,Fargason; Sharon Gayle,44,0,45,1
1746531901322,EDS 128B,A01,895543,Pappas; Elizabeth,44,0,45,1
1746531902350,EDS 139,A00,897203,Pappas; Elizabeth,44,0,45,1
1746531902350,EDS 139,B00,897209,Fargason; Sharon Gayle,41,0,45,4
1746531903378,EDS 201,A00,895545,Staff,23,0,45,22
1746531904406,EDS 203,A01,895581,Halter; Christopher P.,23,0,45,22
1746531905435,EDS 204R,A01,895625,Heinzman; Erica M.,39,0,45,6
1746531905435,EDS 204R,B01,895693,Halter; Christopher P.,10,0,45,35
1746531906462,EDS 206R,A00,895694,Fargason; Sharon Gayle,1,0,30,29
1746531906462,EDS 206R,B00,895695,Choi; Bailey Miyeon,16,0,30,14
1746531907490,EDS 250,A00,895697,Hemans; Patricia Ann Benitez,23,0,45,22
1746531908520,EDS 281,A00,895701,Meyerott; Theresa Ann,1,0,15,14
1746531909549,EDS 284,A00,895736,Meyerott; Theresa Ann,1,0,15,14
1746531910577,EDS 286,A00,897210,Fine; Sarah,0,0,15,15
1746531911608,EDS 289C,A01,895770,Daly; Alan J.,15,0,15,0
1746531912633,EDS 290,A00,897211,Hofstetter; Carolyn,0,0,15,15
1746531913666,LIGM 5A,A00,896162,Fischer-Grunski; Eva K,13,0,20,7
1746531914693,LIGM 5B,A00,896260,Fischer-Grunski; Eva K,17,0,20,3
1746531915719,LIGM 5C,A00,896308,Fischer-Grunski; Eva K,18,0,20,2
1746531916750,LIIT 5AS,A00,896313,Carnelos; Chiara,18,0,20,2
1746531917776,LIIT 5BS,A00,896416,Carnelos; Chiara,20,0,20,0
1746531918802,LIIT 5CS,A00,896564,Carnelos; Chiara,20,0,20,0
1746531919830,LISP 5A,A00,896588,Munoz Sanchez; Alicia,3,0,20,17
1746531920858,LISP 5B,A00,896653,Munoz Sanchez; Alicia,7,0,20,13
1746531921892,LISP 5C,A00,896655,Munoz Sanchez; Alicia,0,1,20,20
1746531922920,MAE 197,001,957918,Kleissl; Jan,9996,0,9999,3
1746531922920,MAE 197,002,959806,Boechler; Nicholas Sebastia,9998,0,9999,1
1746531922920,MAE 197,003,959852,Mullin; Jennifer S,9999,0,9999,0
1746531923951,MATH 2,A01,957937,Staff,33,0,35,2
1746531924982,MATH 197,001,957876,Kedlaya; Kiran S.,9993,0,9999,6
1746531926008,MCWP 40,A00,892729,Duru; Nur,10,0,20,10
1746531926008,MCWP 40,B00,893304,Montejo; Carolina,14,0,20,6
1746531927037,MCWP 40R,A00,893757,Redela; Pamela Morgan,0,5,20,20
1746531928067,MCWP 50,A00,893758,Morshed; Michael James,0,0,20,20
1746531928067,MCWP 50,B00,893761,Bartulis; Jason Michael,17,0,20,3
1746531929096,MCWP 50R,A00,893766,Compas; Sean Matthew,0,1,20,20
1746531929096,MCWP 50R,B00,893769,Carter; Jennifer A,0,1,20,20
1746531929096,MCWP 50R,C00,893771,Krone; Jarret,0,3,20,20
1746531929096,MCWP 50R,D00,893772,Miller; Elizabeth Deen,0,0,20,20
1746531929096,MCWP 50R,E00,893775,Carter; Andrea L,0,1,20,20
1746531930126,MMW 11R,A01,892721,Herbst; Matthew,11,0,27,16
1746531930126,MMW 11R,A02,892722,Herbst; Matthew,0,0,0,3
1746531931153,MMW 12R,A01,892724,Herbst; Matthew,0,11,16,16
1746531931153,MMW 12R,A02,892725,Herbst; Matthew,0,10,16,16
1746531932182,MMW 13R,A01,892727,Staff,0,4,16,16
1746531932182,MMW 13R,A02,892728,Staff,0,4,16,16
1746531932182,MMW 13R,A03,958032,Staff,0,4,16,16
1746531932182,MMW 13R,A04,958033,Staff,0,4,16,16
1746531932182,MMW 13R,A05,958034,Staff,0,4,16,16
1746531933210,SIO 295LS,A00,894015,Staff,5,0,25,20
1746531934234,SIO 295S,A00,894020,Staff,5,0,25,20
1746531935266,SIOC 290S,B01,958918,Merrifield; Mark A,14,0,30,16
1746531936297,SIOC 291S,B01,958922,Gabriel; Corey John,14,0,30,16
1746531937327,SOCI 117,A01,895339,Staff,3,0,5,2
1746531938352,WES 237B,A00,894149,Staff,11,0,20,9
1746531940415,AESE 279B,A00,891859,Staff,13,0,35,22
1746531941439,AIP 197,001,891854,Vespa; Emanuel Ignacio,9999,0,9999,0
1746531942466,ANTH 289S,A00,891856,Gagneux; Pascal,12,0,12,0
1746531943492,BENG 196,001,957946,Engler; Adam J.,9996,0,9999,3
1746531944521,BISP 197,001,959851,Wilhelm; James E.,9999,0,9999,0
1746531945547,CAT 124RS,A01,956906,Staff,6,0,25,19
1746531946572,CAT 125RS,A01,922013,Staff,6,0,25,19
1746531947599,CLRE 250,A00,891860,Morris; Sheldon,9995,0,9999,4
1746531949656,CLRE 251R,A00,907817,Mehta; Ravindra L.,9994,0,9999,5
1746531950688,CLRE 252,A00,891864,Cuomo; Raphael Eduardo,9993,0,9999,6
1746531951713,CLRE 253,A00,891867,Vaida; Florin,9994,0,9999,5
1746531951713,CLRE 253,B00,907819,Staff,9999,0,9999,0
1746531952742,CLRE 259,A00,891868,Patel; Hemal,9998,0,9999,1
1746531953777,CLRE 260,A00,891872,Cuomo; Raphael Eduardo,9999,0,9999,0
1746531954843,CLRE 297,001,891888,Cuomo; Raphael Eduardo,9999,0,9999,0
1746531955868,CSE 191,A00,958773,Minnes Kemp; Mor Mia,9996,0,9999,3
1746531956894,CSE 197,001,959846,Minnes Kemp; Mor Mia,9993,0,9999,6
1746531957921,CSS 201S,A01,892054,Mignozzetti; Umberto,26,0,30,4
1746531958951,CSS 202S,A01,892056,Mignozzetti; Umberto,26,0,30,4
1746531959980,DSC 197,001,956898,Eldridge; Justin Matthew,9998,0,9999,1
1746531961004,DSC 297,001,958000,Mazumdar; Arya,9998,0,9999,1
1746531961004,DSC 297,002,959862,Wang; Yusu,9999,0,9999,0
1746531962031,EAP 100,A00,905686,Staff,9778,0,9999,221
1746531963064,ECE 45,A01,892618,Staff,0,0,65,65
1746531965118,ECE 111,A01,892719,Staff,4,0,65,61
1746531966143,ECE 197,001,957920,Mercier; Patrick Philip,9991,0,9999,8
1746531967171,ECON 178,A01,907814,Zhu; Ying,26,0,35,9
1746531968200,EDS 115,A00,895312,Staff,36,0,45,9
1746531969226,EDS 117,A01,895337,Staff,24,0,30,6
1746531970252,EDS 125,A00,895341,Jones; Gabrielle Anastasia,37,0,45,8
1746531971281,EDS 128A,A01,895459,Fargason; Sharon Gayle,44,0,45,1
1746531972308,EDS 128B,A01,895543,Pappas; Elizabeth,44,0,45,1
1746531973334,EDS 139,A00,897203,Pappas; Elizabeth,44,0,45,1
1746531973334,EDS 139,B00,897209,Fargason; Sharon Gayle,41,0,45,4
1746531974361,EDS 201,A00,895545,Staff,23,0,45,22
1746531975388,EDS 203,A01,895581,Halter; Christopher P.,23,0,45,22
1746531976416,EDS 204R,A01,895625,Heinzman; Erica M.,39,0,45,6
1746531976416,EDS 204R,B01,895693,Halter; Christopher P.,10,0,45,35
1746531977443,EDS 206R,A00,895694,Fargason; Sharon Gayle,1,0,30,29
1746531977443,EDS 206R,B00,895695,Choi; Bailey Miyeon,16,0,30,14
1746531978474,EDS 250,A00,895697,Hemans; Patricia Ann Benitez,23,0,45,22
1746531979504,EDS 281,A00,895701,Meyerott; Theresa Ann,1,0,15,14
1746531980529,EDS 284,A00,895736,Meyerott; Theresa Ann,1,0,15,14
1746531981560,EDS 286,A00,897210,Fine; Sarah,0,0,15,15
1746531982589,EDS 289C,A01,895770,Daly; Alan J.,15,0,15,0
1746531983619,EDS 290,A00,897211,Hofstetter; Carolyn,0,0,15,15
1746531984648,LIGM 5A,A00,896162,Fischer-Grunski; Eva K,13,0,20,7
1746531985678,LIGM 5B,A00,896260,Fischer-Grunski; Eva K,17,0,20,3
1746531986704,LIGM 5C,A00,896308,Fischer-Grunski; Eva K,18,0,20,2
1746531987730,LIIT 5AS,A00,896313,Carnelos; Chiara,18,0,20,2
1746531988760,LIIT 5BS,A00,896416,Carnelos; Chiara,20,0,20,0
1746531989791,LIIT 5CS,A00,896564,Carnelos; Chiara,20,0,20,0
1746531990819,LISP 5A,A00,896588,Munoz Sanchez; Alicia,3,0,20,17
1746531991849,LISP 5B,A00,896653,Munoz Sanchez; Alicia,7,0,20,13
1746531992879,LISP 5C,A00,896655,Munoz Sanchez; Alicia,0,1,20,20
1746531993906,MAE 197,001,957918,Kleissl; Jan,9996,0,9999,3
1746531993906,MAE 197,002,959806,Boechler; Nicholas Sebastia,9998,0,9999,1
1746531993906,MAE 197,003,959852,Mullin; Jennifer S,9999,0,9999,0
1746531994936,MATH 2,A01,957937,Staff,33,0,35,2
1746531995965,MATH 197,001,957876,Kedlaya; Kiran S.,9993,0,9999,6
1746531996994,MCWP 40,A00,892729,Duru; Nur,10,0,20,10
1746531996994,MCWP 40,B00,893304,Montejo; Carolina,14,0,20,6
1746531998022,MCWP 40R,A00,893757,Redela; Pamela Morgan,0,5,20,20
1746531999050,MCWP 50,A00,893758,Morshed; Michael James,0,0,20,20
1746531999050,MCWP 50,B00,893761,Bartulis; Jason Michael,17,0,20,3
1746532000075,MCWP 50R,A00,893766,Compas; Sean Matthew,0,1,20,20
1746532000075,MCWP 50R,B00,893769,Carter; Jennifer A,0,1,20,20
1746532000075,MCWP 50R,C00,893771,Krone; Jarret,0,3,20,20
1746532000075,MCWP 50R,D00,893772,Miller; Elizabeth Deen,0,0,20,20
1746532000075,MCWP 50R,E00,893775,Carter; Andrea L,0,1,20,20
1746532001102,MMW 11R,A01,892721,Herbst; Matthew,11,0,27,16
1746532001102,MMW 11R,A02,892722,Herbst; Matthew,0,0,0,3
1746532002132,MMW 12R,A01,892724,Herbst; Matthew,0,11,16,16
1746532002132,MMW 12R,A02,892725,Herbst; Matthew,0,10,16,16
1746532003158,MMW 13R,A01,892727,Staff,0,4,16,16
1746532003158,MMW 13R,A02,892728,Staff,0,4,16,16
1746532003158,MMW 13R,A03,958032,Staff,0,4,16,16
1746532003158,MMW 13R,A04,958033,Staff,0,4,16,16
1746532003158,MMW 13R,A05,958034,Staff,0,4,16,16
1746532004184,SIO 295LS,A00,894015,Staff,5,0,25,20
1746532005212,SIO 295S,A00,894020,Staff,5,0,25,20
1746532006237,SIOC 290S,B01,958918,Merrifield; Mark A,14,0,30,16
1746532007263,SIOC 291S,B01,958922,Gabriel; Corey John,14,0,30,16
1746532008291,SOCI 117,A01,895339,Staff,3,0,5,2
1746532009315,WES 237B,A00,894149,Staff,11,0,20,9
1746532011383,AESE 279B,A00,891859,Staff,13,0,35,22
1746532012410,AIP 197,001,891854,Vespa; Emanuel Ignacio,9999,0,9999,0
1746532013440,ANTH 289S,A00,891856,Gagneux; Pascal,12,0,12,0
1746532014471,BENG 196,001,957946,Engler; Adam J.,9996,0,9999,3
1746532015497,BISP 197,001,959851,Wilhelm; James E.,9999,0,9999,0
1746532016521,CAT 124RS,A01,956906,Staff,6,0,25,19
1746532017548,CAT 125RS,A01,922013,Staff,6,0,25,19
1746532018574,CLRE 250,A00,891860,Morris; Sheldon,9995,0,9999,4
1746532020631,CLRE 251R,A00,907817,Mehta; Ravindra L.,9994,0,9999,5
1746532021659,CLRE 252,A00,891864,Cuomo; Raphael Eduardo,9993,0,9999,6
1746532022684,CLRE 253,A00,891867,Vaida; Florin,9994,0,9999,5
1746532022684,CLRE 253,B00,907819,Staff,9999,0,9999,0
1746532023714,CLRE 259,A00,891868,Patel; Hemal,9998,0,9999,1
1746532024746,CLRE 260,A00,891872,Cuomo; Raphael Eduardo,9999,0,9999,0
1746532025774,CLRE 297,001,891888,Cuomo; Raphael Eduardo,9999,0,9999,0
1746532026803,CSE 191,A00,958773,Minnes Kemp; Mor Mia,9996,0,9999,3
1746532027831,CSE 197,001,959846,Minnes Kemp; Mor Mia,9993,0,9999,6
1746532028860,CSS 201S,A01,892054,Mignozzetti; Umberto,26,0,30,4
1746532029891,CSS 202S,A01,892056,Mignozzetti; Umberto,26,0,30,4
1746532030918,DSC 197,001,956898,Eldridge; Justin Matthew,9998,0,9999,1
1746532031946,DSC 297,001,958000,Mazumdar; Arya,9998,0,9999,1
1746532031946,DSC 297,002,959862,Wang; Yusu,9999,0,9999,0
1746532032974,EAP 100,A00,905686,Staff,9778,0,9999,221
1746532034000,ECE 45,A01,892618,Staff,0,0,65,65
1746532036059,ECE 111,A01,892719,Staff,4,0,65,61
1746532037087,ECE 197,001,957920,Mercier; Patrick Philip,9991,0,9999,8
1746532038115,ECON 178,A01,907814,Zhu; Ying,26,0,35,9
1746532039145,EDS 115,A00,895312,Staff,36,0,45,9
1746532040175,EDS 117,A01,895337,Staff,24,0,30,6
1746532041206,EDS 125,A00,895341,Jones; Gabrielle Anastasia,37,0,45,8
1746532042234,EDS 128A,A01,895459,Fargason; Sharon Gayle,44,0,45,1
1746532043258,EDS 128B,A01,895543,Pappas; Elizabeth,44,0,45,1
1746532044286,EDS 139,A00,897203,Pappas; Elizabeth,44,0,45,1
1746532044286,EDS 139,B00,897209,Fargason; Sharon Gayle,41,0,45,4
1746532045311,EDS 201,A00,895545,Staff,23,0,45,22
1746532046342,EDS 203,A01,895581,Halter; Christopher P.,23,0,45,22
1746532047373,EDS 204R,A01,895625,Heinzman; Erica M.,39,0,45,6
1746532047373,EDS 204R,B01,895693,Halter; Christopher P.,10,0,45,35
1746532048403,EDS 206R,A00,895694,Fargason; Sharon Gayle,1,0,30,29
1746532048403,EDS 206R,B00,895695,Choi; Bailey Miyeon,16,0,30,14
1746532049433,EDS 250,A00,895697,Hemans; Patricia Ann Benitez,23,0,45,22
1746532050462,EDS 281,A00,895701,Meyerott; Theresa Ann,1,0,15,14
1746532051488,EDS 284,A00,895736,Meyerott; Theresa Ann,1,0,15,14
1746532052517,EDS 286,A00,897210,Fine; Sarah,0,0,15,15
1746532053547,EDS 289C,A01,895770,Daly; Alan J.,15,0,15,0
1746532054574,EDS 290,A00,897211,Hofstetter; Carolyn,0,0,15,15
1746532055600,LIGM 5A,A00,896162,Fischer-Grunski; Eva K,13,0,20,7
1746532056626,LIGM 5B,A00,896260,Fischer-Grunski; Eva K,17,0,20,3
1746532057657,LIGM 5C,A00,896308,Fischer-Grunski; Eva K,18,0,20,2
1746532058687,LIIT 5AS,A00,896313,Carnelos; Chiara,18,0,20,2
1746532059716,LIIT 5BS,A00,896416,Carnelos; Chiara,20,0,20,0
1746532060743,LIIT 5CS,A00,896564,Carnelos; Chiara,20,0,20,0
1746532061774,LISP 5A,A00,896588,Munoz Sanchez; Alicia,3,0,20,17
1746532062805,LISP 5B,A00,896653,Munoz Sanchez; Alicia,7,0,20,13
1746532063833,LISP 5C,A00,896655,Munoz Sanchez; Alicia,0,1,20,20
1746532064860,MAE 197,001,957918,Kleissl; Jan,9996,0,9999,3
1746532064860,MAE 197,002,959806,Boechler; Nicholas Sebastia,9998,0,9999,1
1746532064860,MAE 197,003,959852,Mullin; Jennifer S,9999,0,9999,0
1746532065891,MATH 2,A01,957937,Staff,33,0,35,2
1746532066917,MATH 197,001,957876,Kedlaya; Kiran S.,9993,0,9999,6
1746532067945,MCWP 40,A00,892729,Duru; Nur,10,0,20,10
1746532067945,MCWP 40,B00,893304,Montejo; Carolina,14,0,20,6
1746532068973,MCWP 40R,A00,893757,Redela; Pamela Morgan,0,5,20,20
1746532070007,MCWP 50,A00,893758,Morshed; Michael James,0,0,20,20
1746532070007,MCWP 50,B00,893761,Bartulis; Jason Michael,17,0,20,3
1746532071034,MCWP 50R,A00,893766,Compas; Sean Matthew,0,1,20,20
1746532071034,MCWP 50R,B00,893769,Carter; Jennifer A,0,1,20,20
1746532071034,MCWP 50R,C00,893771,Krone; Jarret,0,3,20,20
1746532071034,MCWP 50R,D00,893772,Miller; Elizabeth Deen,0,0,20,20
1746532071034,MCWP 50R,E00,893775,Carter; Andrea L,0,1,20,20
1746532072059,MMW 11R,A01,892721,Herbst; Matthew,11,0,27,16
1746532072059,MMW 11R,A02,892722,Herbst; Matthew,0,0,0,3
1746532073088,MMW 12R,A01,892724,Herbst; Matthew,0,11,16,16
1746532073088,MMW 12R,A02,892725,Herbst; Matthew,0,10,16,16
1746532074114,MMW 13R,A01,892727,Staff,0,4,16,16
1746532074114,MMW 13R,A02,892728,Staff,0,4,16,16
1746532074114,MMW 13R,A03,958032,Staff,0,4,16,16
1746532074114,MMW 13R,A04,958033,Staff,0,4,16,16
1746532074114,MMW 13R,A05,958034,Staff,0,4,16,16
1746532075144,SIO 295LS,A00,894015,Staff,5,0,25,20
1746532076172,SIO 295S,A00,894020,Staff,5,0,25,20
1746532077202,SIOC 290S,B01,958918,Merrifield; Mark A,14,0,30,16
1746532078229,SIOC 291S,B01,958922,Gabriel; Corey John,14,0,30,16
1746532079257,SOCI 117,A01,895339,Staff,3,0,5,2
1746532080285,WES 237B,A00,894149,Staff,11,0,20,9
1746532082352,AESE 279B,A00,891859,Staff,13,0,35,22
1746532083377,AIP 197,001,891854,Vespa; Emanuel Ignacio,9999,0,9999,0
1746532084402,ANTH 289S,A00,891856,Gagneux; Pascal,12,0,12,0
1746532085428,BENG 196,001,957946,Engler; Adam J.,9996,0,9999,3
1746532086458,BISP 197,001,959851,Wilhelm; James E.,9999,0,9999,0
1746532087484,CAT 124RS,A01,956906,Staff,6,0,25,19
1746532088512,CAT 125RS,A01,922013,Staff,6,0,25,19
1746532089541,CLRE 250,A00,891860,Morris; Sheldon,9995,0,9999,4
1746532091619,CLRE 251R,A00,907817,Mehta; Ravindra L.,9994,0,9999,5
1746532092645,CLRE 252,A00,891864,Cuomo; Raphael Eduardo,9993,0,9999,6
1746532093675,CLRE 253,A00,891867,Vaida; Florin,9994,0,9999,5
1746532093675,CLRE 253,B00,907819,Staff,9999,0,9999,0
1746532094704,CLRE 259,A00,891868,Patel; Hemal,9998,0,9999,1
1746532095730,CLRE 260,A00,891872,Cuomo; Raphael Eduardo,9999,0,9999,0
1746532096755,CLRE 297,001,891888,Cuomo; Raphael Eduardo,9999,0,9999,0
1746532097780,CSE 191,A00,958773,Minnes Kemp; Mor Mia,9996,0,9999,3
1746532098805,CSE 197,001,959846,Minnes Kemp; Mor Mia,9993,0,9999,6
1746532099836,CSS 201S,A01,892054,Mignozzetti; Umberto,26,0,30,4
1746532100868,CSS 202S,A01,892056,Mignozzetti; Umberto,26,0,30,4
1746532101897,DSC 197,001,956898,Eldridge; Justin Matthew,9998,0,9999,1
1746532102927,DSC 297,001,958000,Mazumdar; Arya,9998,0,9999,1
1746532102927,DSC 297,002,959862,Wang; Yusu,9999,0,9999,0
1746532103956,EAP 100,A00,905686,Staff,9778,0,9999,221
1746532104983,ECE 45,A01,892618,Staff,0,0,65,65
1746532107038,ECE 111,A01,892719,Staff,4,0,65,61
1746532108065,ECE 197,001,957920,Mercier; Patrick Philip,9991,0,9999,8
1746532109090,ECON 178,A01,907814,Zhu; Ying,26,0,35,9
1746532110118,EDS 115,A00,895312,Staff,36,0,45,9
1746532111145,EDS 117,A01,895337,Staff,24,0,30,6
1746532112176,EDS 125,A00,895341,Jones; Gabrielle Anastasia,37,0,45,8
1746532113203,EDS 128A,A01,895459,Fargason; Sharon Gayle,44,0,45,1
1746532114229,EDS 128B,A01,895543,Pappas; Elizabeth,44,0,45,1
1746532115258,EDS 139,A00,897203,Pappas; Elizabeth,44,0,45,1
1746532115258,EDS 139,B00,897209,Fargason; Sharon Gayle,41,0,45,4
1746532116286,EDS 201,A00,895545,Staff,23,0,45,22
1746532117313,EDS 203,A01,895581,Halter; Christopher P.,23,0,45,22
1746532118339,EDS 204R,A01,895625,Heinzman; Erica M.,39,0,45,6
1746532118339,EDS 204R,B01,895693,Halter; Christopher P.,10,0,45,35
1746532119367,EDS 206R,A00,895694,Fargason; Sharon Gayle,1,0,30,29
1746532119367,EDS 206R,B00,895695,Choi; Bailey Miyeon,16,0,30,14
1746532120397,EDS 250,A00,895697,Hemans; Patricia Ann Benitez,23,0,45,22
1746532121427,EDS 281,A00,895701,Meyerott; Theresa Ann,1,0,15,14
1746532122455,EDS 284,A00,895736,Meyerott; Theresa Ann,1,0,15,14
1746532123485,EDS 286,A00,897210,Fine; Sarah,0,0,15,15
1746532124512,EDS 289C,A01,895770,Daly; Alan J.,15,0,15,0
1746532125539,EDS 290,A00,897211,Hofstetter; Carolyn,0,0,15,15
1746532126569,LIGM 5A,A00,896162,Fischer-Grunski; Eva K,13,0,20,7
1746532127596,LIGM 5B,A00,896260,Fischer-Grunski; Eva K,17,0,20,3
1746532128622,LIGM 5C,A00,896308,Fischer-Grunski; Eva K,18,0,20,2
1746532129648,LIIT 5AS,A00,896313,Carnelos; Chiara,18,0,20,2
1746532130675,LIIT 5BS,A00,896416,Carnelos; Chiara,20,0,20,0
1746532131702,LIIT 5CS,A00,896564,Carnelos; Chiara,20,0,20,0
1746532132732,LISP 5A,A00,896588,Munoz Sanchez; Alicia,3,0,20,17
1746532133762,LISP 5B,A00,896653,Munoz Sanchez; Alicia,7,0,20,13
1746532134787,LISP 5C,A00,896655,Munoz Sanchez; Alicia,0,1,20,20
1746532135817,MAE 197,001,957918,Kleissl; Jan,9996,0,9999,3
1746532135817,MAE 197,002,959806,Boechler; Nicholas Sebastia,9998,0,9999,1
1746532135817,MAE 197,003,959852,Mullin; Jennifer S,9999,0,9999,0
1746532136845,MATH 2,A01,957937,Staff,33,0,35,2
1746532137877,MATH 197,001,957876,Kedlaya; Kiran S.,9993,0,9999,6
1746532138906,MCWP 40,A00,892729,Duru; Nur,10,0,20,10
1746532138906,MCWP 40,B00,893304,Montejo; Carolina,14,0,20,6
1746532139936,MCWP 40R,A00,893757,Redela; Pamela Morgan,0,5,20,20
1746532140964,MCWP 50,A00,893758,Morshed; Michael James,0,0,20,20
1746532140964,MCWP 50,B00,893761,Bartulis; Jason Michael,17,0,20,3
1746532141991,MCWP 50R,A00,893766,Compas; Sean Matthew,0,1,20,20
1746532141991,MCWP 50R,B00,893769,Carter; Jennifer A,0,1,20,20
1746532141991,MCWP 50R,C00,893771,Krone; Jarret,0,3,20,20
1746532141991,MCWP 50R,D00,893772,Miller; Elizabeth Deen,0,0,20,20
1746532141991,MCWP 50R,E00,893775,Carter; Andrea L,0,1,20,20
1746532143016,MMW 11R,A01,892721,Herbst; Matthew,11,0,27,16
1746532143016,MMW 11R,A02,892722,Herbst; Matthew,0,0,0,3
1746532144046,MMW 12R,A01,892724,Herbst; Matthew,0,11,16,16
1746532144046,MMW 12R,A02,892725,Herbst; Matthew,0,10,16,16
1746532145071,MMW 13R,A01,892727,Staff,0,4,16,16
1746532145071,MMW 13R,A02,892728,Staff,0,4,16,16
1746532145071,MMW 13R,A03,958032,Staff,0,4,16,16
1746532145071,MMW 13R,A04,958033,Staff,0,4,16,16
1746532145071,MMW 13R,A05,958034,Staff,0,4,16,16
1746532146098,SIO 295LS,A00,894015,Staff,5,0,25,20
1746532147124,SIO 295S,A00,894020,Staff,5,0,25,20
1746532148156,SIOC 290S,B01,958918,Merrifield; Mark A,14,0,30,16
1746532149181,SIOC 291S,B01,958922,Gabriel; Corey John,14,0,30,16
1746532150207,SOCI 117,A01,895339,Staff,3,0,5,2
1746532151235,WES 237B,A00,894149,Staff,11,0,20,9
1746532153324,AESE 279B,A00,891859,Staff,13,0,35,22
1746532154349,AIP 197,001,891854,Vespa; Emanuel Ignacio,9999,0,9999,0
1746532155375,ANTH 289S,A00,891856,Gagneux; Pascal,12,0,12,0
1746532156402,BENG 196,001,957946,Engler; Adam J.,9996,0,9999,3
1746532157433,BISP 197,001,959851,Wilhelm; James E.,9999,0,9999,0
1746532158460,CAT 124RS,A01,956906,Staff,6,0,25,19
1746532159486,CAT 125RS,A01,922013,Staff,6,0,25,19
1746532160516,CLRE 250,A00,891860,Morris; Sheldon,9995,0,9999,4
1746532162574,CLRE 251R,A00,907817,Mehta; Ravindra L.,9994,0,9999,5
1746532163602,CLRE 252,A00,891864,Cuomo; Raphael Eduardo,9993,0,9999,6
1746532164634,CLRE 253,A00,891867,Vaida; Florin,9994,0,9999,5
1746532164634,CLRE 253,B00,907819,Staff,9999,0,9999,0
1746532165660,CLRE 259,A00,891868,Patel; Hemal,9998,0,9999,1
1746532166685,CLRE 260,A00,891872,Cuomo; Raphael Eduardo,9999,0,9999,0
1746532167716,CLRE 297,001,891888,Cuomo; Raphael Eduardo,9999,0,9999,0
1746532168747,CSE 191,A00,958773,Minnes Kemp; Mor Mia,9996,0,9999,3
1746532169775,CSE 197,001,959846,Minnes Kemp; Mor Mia,9993,0,9999,6
1746532170802,CSS 201S,A01,892054,Mignozzetti; Umberto,26,0,30,4
1746532171831,CSS 202S,A01,892056,Mignozzetti; Umberto,26,0,30,4
1746532172856,DSC 197,001,956898,Eldridge; Justin Matthew,9998,0,9999,1
1746532173882,DSC 297,001,958000,Mazumdar; Arya,9998,0,9999,1
1746532173882,DSC 297,002,959862,Wang; Yusu,9999,0,9999,0
1746532174909,EAP 100,A00,905686,Staff,9778,0,9999,221
1746532175946,ECE 45,A01,892618,Staff,0,0,65,65
1746532177996,ECE 111,A01,892719,Staff,4,0,65,61
1746532179022,ECE 197,001,957920,Mercier; Patrick Philip,9991,0,9999,8
1746532180052,ECON 178,A01,907814,Zhu; Ying,26,0,35,9
1746532181078,EDS 115,A00,895312,Staff,36,0,45,9
1746532182109,EDS 117,A01,895337,Staff,24,0,30,6
1746532183139,EDS 125,A00,895341,Jones; Gabrielle Anastasia,37,0,45,8
1746532184166,EDS 128A,A01,895459,Fargason; Sharon Gayle,44,0,45,1
1746532185197,EDS 128B,A01,895543,Pappas; Elizabeth,44,0,45,1
1746532186222,EDS 139,A00,897203,Pappas; Elizabeth,44,0,45,1
1746532186222,EDS 139,B00,897209,Fargason; Sharon Gayle,41,0,45,4
1746532187249,EDS 201,A00,895545,Staff,23,0,45,22
1746532188277,EDS 203,A01,895581,Halter; Christopher P.,23,0,45,22
1746532189302,EDS 204R,A01,895625,Heinzman; Erica M.,39,0,45,6
1746532189302,EDS 204R,B01,895693,Halter; Christopher P.,10,0,45,35
1746532190332,EDS 206R,A00,895694,Fargason; Sharon Gayle,1,0,30,29
1746532190332,EDS 206R,B00,895695,Choi; Bailey Miyeon,16,0,30,14
1746532191359,EDS 250,A00,895697,Hemans; Patricia Ann Benitez,23,0,45,22
1746532192383,EDS 281,A00,895701,Meyerott; Theresa Ann,1,0,15,14
1746532193409,EDS 284,A00,895736,Meyerott; Theresa Ann,1,0,15,14
1746532194438,EDS 286,A00,897210,Fine; Sarah,0,0,15,15
1746532195469,EDS 289C,A01,895770,Daly; Alan J.,15,0,15,0
1746532196495,EDS 290,A00,897211,Hofstetter; Carolyn,0,0,15,15
1746532197523,LIGM 5A,A00,896162,Fischer-Grunski; Eva K,13,0,20,7
1746532198549,LIGM 5B,A00,896260,Fischer-Grunski; Eva K,17,0,20,3
1746532199577,LIGM 5C,A00,896308,Fischer-Grunski; Eva K,18,0,20,2
1746532200607,LIIT 5AS,A00,896313,Carnelos; Chiara,18,0,20,2
1746532201636,LIIT 5BS,A00,896416,Carnelos; Chiara,20,0,20,0
1746532202663,LIIT 5CS,A00,896564,Carnelos; Chiara,20,0,20,0
1746532203689,LISP 5A,A00,896588,Munoz Sanchez; Alicia,3,0,20,17
1746532204719,LISP 5B,A00,896653,Munoz Sanchez; Alicia,7,0,20,13
1746532205751,LISP 5C,A00,896655,Munoz Sanchez; Alicia,0,1,20,20
1746532206778,MAE 197,001,957918,Kleissl; Jan,9996,0,9999,3
1746532206778,MAE 197,002,959806,Boechler; Nicholas Sebastia,9998,0,9999,1
1746532206778,MAE 197,003,959852,Mullin; Jennifer S,9999,0,9999,0
1746532207809,MATH 2,A01,957937,Staff,33,0,35,2
1746532208839,MATH 197,001,957876,Kedlaya; Kiran S.,9993,0,9999,6
1746532209869,MCWP 40,A00,892729,Duru; Nur,10,0,20,10
1746532209869,MCWP 40,B00,893304,Montejo; Carolina,14,0,20,6
1746532210898,MCWP 40R,A00,893757,Redela; Pamela Morgan,0,5,20,20
1746532211926,MCWP 50,A00,893758,Morshed; Michael James,0,0,20,20
1746532211926,MCWP 50,B00,893761,Bartulis; Jason Michael,17,0,20,3
1746532212959,MCWP 50R,A00,893766,Compas; Sean Matthew,0,1,20,20
1746532212959,MCWP 50R,B00,893769,Carter; Jennifer A,0,1,20,20
1746532212959,MCWP 50R,C00,893771,Krone; Jarret,0,3,20,20
1746532212959,MCWP 50R,D00,893772,Miller; Elizabeth Deen,0,0,20,20
1746532212959,MCWP 50R,E00,893775,Carter; Andrea L,0,1,20,20
1746532213990,MMW 11R,A01,892721,Herbst; Matthew,11,0,27,16
1746532213990,MMW 11R,A02,892722,Herbst; Matthew,0,0,0,3
1746532215018,MMW 12R,A01,892724,Herbst; Matthew,0,11,16,16
1746532215018,MMW 12R,A02,892725,Herbst; Matthew,0,10,16,16
1746532216046,MMW 13R,A01,892727,Staff,0,4,16,16
1746532216046,MMW 13R,A02,892728,Staff,0,4,16,16
1746532216046,MMW 13R,A03,958032,Staff,0,4,16,16
1746532216046,MMW 13R,A04,958033,Staff,0,4,16,16
1746532216046,MMW 13R,A05,958034,Staff,0,4,16,16
1746532217072,SIO 295LS,A00,894015,Staff,5,0,25,20
1746532218103,SIO 295S,A00,894020,Staff,5,0,25,20
1746532219134,SIOC 290S,B01,958918,Merrifield; Mark A,14,0,30,16
1746532220164,SIOC 291S,B01,958922,Gabriel; Corey John,14,0,30,16
1746532221193,SOCI 117,A01,895339,Staff,3,0,5,2
1746532222221,WES 237B,A00,894149,Staff,11,0,20,9
1746532224286,AESE 279B,A00,891859,Staff,13,0,35,22
1746532225313,AIP 197,001,891854,Vespa; Emanuel Ignacio,9999,0,9999,0
1746532226343,ANTH 289S,A00,891856,Gagneux; Pascal,12,0,12,0
1746532227371,BENG 196,001,957946,Engler; Adam J.,9996,0,9999,3
1746532228398,BISP 197,001,959851,Wilhelm; James E.,9999,0,9999,0
1746532229425,CAT 124RS,A01,956906,Staff,6,0,25,19
1746532230454,CAT 125RS,A01,922013,Staff,6,0,25,19
1746532231482,CLRE 250,A00,891860,Morris; Sheldon,9995,0,9999,4
1746532233538,CLRE 251R,A00,907817,Mehta; Ravindra L.,9994,0,9999,5
1746532234563,CLRE 252,A00,891864,Cuomo; Raphael Eduardo,9993,0,9999,6
1746532235591,CLRE 253,A00,891867,Vaida; Florin,9994,0,9999,5
1746532235591,CLRE 253,B00,907819,Staff,9999,0,9999,0
1746532236619,CLRE 259,A00,891868,Patel; Hemal,9998,0,9999,1
1746532237648,CLRE 260,A00,891872,Cuomo; Raphael Eduardo,9999,0,9999,0
1746532238680,CLRE 297,001,891888,Cuomo; Raphael Eduardo,9999,0,9999,0
1746532239706,CSE 191,A00,958773,Minnes Kemp; Mor Mia,9996,0,9999,3
1746532240736,CSE 197,001,959846,Minnes Kemp; Mor Mia,9993,0,9999,6
1746532241764,CSS 201S,A01,892054,Mignozzetti; Umberto,26,0,30,4
1746532242791,CSS 202S,A01,892056,Mignozzetti; Umberto,26,0,30,4
1746532243825,DSC 197,001,956898,Eldridge; Justin Matthew,9998,0,9999,1
1746532244851,DSC 297,001,958000,Mazumdar; Arya,9998,0,9999,1
1746532244851,DSC 297,002,959862,Wang; Yusu,9999,0,9999,0
1746532245879,EAP 100,A00,905686,Staff,9778,0,9999,221
1746532246911,ECE 45,A01,892618,Staff,0,0,65,65
1746532248970,ECE 111,A01,892719,Staff,4,0,65,61
1746532249997,ECE 197,001,957920,Mercier; Patrick Philip,9991,0,9999,8
1746532251028,ECON 178,A01,907814,Zhu; Ying,26,0,35,9
1746532252059,EDS 115,A00,895312,Staff,36,0,45,9
1746532253085,EDS 117,A01,895337,Staff,24,0,30,6
1746532254117,EDS 125,A00,895341,Jones; Gabrielle Anastasia,37,0,45,8
1746532255146,EDS 128A,A01,895459,Fargason; Sharon Gayle,44,0,45,1
1746532256171,EDS 128B,A01,895543,Pappas; Elizabeth,44,0,45,1
1746532257199,EDS 139,A00,897203,Pappas; Elizabeth,44,0,45,1
1746532257199,EDS 139,B00,897209,Fargason; Sharon Gayle,41,0,45,4
1746532258226,EDS 201,A00,895545,Staff,23,0,45,22
1746532259253,EDS 203,A01,895581,Halter; Christopher P.,23,0,45,22
1746532260286,EDS 204R,A01,895625,Heinzman; Erica M.,39,0,45,6
1746532260286,EDS 204R,B01,895693,Halter; Christopher P.,10,0,45,35
1746532261315,EDS 206R,A00,895694,Fargason; Sharon Gayle,1,0,30,29
1746532261315,EDS 206R,B00,895695,Choi; Bailey Miyeon,16,0,30,14
1746532262345,EDS 250,A00,895697,Hemans; Patricia Ann Benitez,23,0,45,22
1746532263372,EDS 281,A00,895701,Meyerott; Theresa Ann,1,0,15,14
1746532264400,EDS 284,A00,895736,Meyerott; Theresa Ann,1,0,15,14
1746532265427,EDS 286,A00,897210,Fine; Sarah,0,0,15,15
1746532266455,EDS 289C,A01,895770,Daly; Alan J.,15,0,15,0
1746532267484,EDS 290,A00,897211,Hofstetter; Carolyn,0,0,15,15
1746532268514,LIGM 5A,A00,896162,Fischer-Grunski; Eva K,13,0,20,7
1746532269540,LIGM 5B,A00,896260,Fischer-Grunski; Eva K,17,0,20,3
1746532270566,LIGM 5C,A00,896308,Fischer-Grunski; Eva K,18,0,20,2
1746532271597,LIIT 5AS,A00,896313,Carnelos; Chiara,18,0,20,2
1746532272623,LIIT 5BS,A00,896416,Carnelos; Chiara,20,0,20,0
1746532273650,LIIT 5CS,A00,896564,Carnelos; Chiara,20,0,20,0
1746532274681,LISP 5A,A00,896588,Munoz Sanchez; Alicia,3,0,20,17
1746532275709,LISP 5B,A00,896653,Munoz Sanchez; Alicia,7,0,20,13
1746532276734,LISP 5C,A00,896655,Munoz Sanchez; Alicia,0,1,20,20
1746532277763,MAE 197,001,957918,Kleissl; Jan,9996,0,9999,3
1746532277763,MAE 197,002,959806,Boechler; Nicholas Sebastia,9998,0,9999,1
1746532277763,MAE 197,003,959852,Mullin; Jennifer S,9999,0,9999,0
1746532278794,MATH 2,A01,957937,Staff,33,0,35,2
1746532279824,MATH 197,001,957876,Kedlaya; Kiran S.,9993,0,9999,6
1746532280852,MCWP 40,A00,892729,Duru; Nur,10,0,20,10
1746532280852,MCWP 40,B00,893304,Montejo; Carolina,14,0,20,6
1746532281881,MCWP 40R,A00,893757,Redela; Pamela Morgan,0,5,20,20
1746532282912,MCWP 50,A00,893758,Morshed; Michael James,0,0,20,20
1746532282912,MCWP 50,B00,893761,Bartulis; Jason Michael,17,0,20,3
1746532283942,MCWP 50R,A00,893766,Compas; Sean Matthew,0,1,20,20
1746532283942,MCWP 50R,B00,893769,Carter; Jennifer A,0,1,20,20
1746532283942,MCWP 50R,C00,893771,Krone; Jarret,0,3,20,20
1746532283942,MCWP 50R,D00,893772,Miller; Elizabeth Deen,0,0,20,20
1746532283942,MCWP 50R,E00,893775,Carter; Andrea L,0,1,20,20
1746532284972,MMW 11R,A01,892721,Herbst; Matthew,11,0,27,16
1746532284972,MMW 11R,A02,892722,Herbst; Matthew,0,0,0,3
1746532286002,MMW 12R,A01,892724,Herbst; Matthew,0,11,16,16
1746532286002,MMW 12R,A02,892725,Herbst; Matthew,0,10,16,16
1746532287031,MMW 13R,A01,892727,Staff,0,4,16,16
1746532287031,MMW 13R,A02,892728,Staff,0,4,16,16
1746532287031,MMW 13R,A03,958032,Staff,0,4,16,16
1746532287031,MMW 13R,A04,958033,Staff,0,4,16,16
1746532287031,MMW 13R,A05,958034,Staff,0,4,16,16
1746532288057,SIO 295LS,A00,894015,Staff,5,0,25,20
1746532289083,SIO 295S,A00,894020,Staff,5,0,25,20
1746532290112,SIOC 290S,B01,958918,Merrifield; Mark A,14,0,30,16
1746532291140,SIOC 291S,B01,958922,Gabriel; Corey John,14,0,30,16
1746532292166,SOCI 117,A01,895339,Staff,3,0,5,2
1746532293191,WES 237B,A00,894149,Staff,11,0,20,9
1746532295249,AESE 279B,A00,891859,Staff,13,0,35,22
1746532296276,AIP 197,001,891854,Vespa; Emanuel Ignacio,9999,0,9999,0
1746532297302,ANTH 289S,A00,891856,Gagneux; Pascal,12,0,12,0
1746532298331,BENG 196,001,957946,Engler; Adam J.,9996,0,9999,3
1746532299358,BISP 197,001,959851,Wilhelm; James E.,9999,0,9999,0
1746532300383,CAT 124RS,A01,956906,Staff,6,0,25,19
1746532301413,CAT 125RS,A01,922013,Staff,6,0,25,19
1746532302439,CLRE 250,A00,891860,Morris; Sheldon,9995,0,9999,4
1746532304497,CLRE 251R,A00,907817,Mehta; Ravindra L.,9994,0,9999,5
1746532305525,CLRE 252,A00,891864,Cuomo; Raphael Eduardo,9993,0,9999,6
1746532306550,CLRE 253,A00,891867,Vaida; Florin,9994,0,9999,5
1746532306550,CLRE 253,B00,907819,Staff,9999,0,9999,0
1746532307577,CLRE 259,A00,891868,Patel; Hemal,9998,0,9999,1
1746532308602,CLRE 260,A00,891872,Cuomo; Raphael Eduardo,9999,0,9999,0
1746532309630,CLRE 297,001,891888,Cuomo; Raphael Eduardo,9999,0,9999,0
1746532310660,CSE 191,A00,958773,Minnes Kemp; Mor Mia,9996,0,9999,3
1746532311690,CSE 197,001,959846,Minnes Kemp; Mor Mia,9993,0,9999,6
1746532312718,CSS 201S,A01,892054,Mignozzetti; Umberto,26,0,30,4
1746532313743,CSS 202S,A01,892056,Mignozzetti; Umberto,26,0,30,4
1746532314771,DSC 197,001,956898,Eldridge; Justin Matthew,9998,0,9999,1
1746532315800,DSC 297,001,958000,Mazumdar; Arya,9998,0,9999,1
1746532315800,DSC 297,002,959862,Wang; Yusu,9999,0,9999,0
1746532316826,EAP 100,A00,905686,Staff,9778,0,9999,221
1746532317856,ECE 45,A01,892618,Staff,0,0,65,65
1746532319910,ECE 111,A01,892719,Staff,4,0,65,61
1746532320940,ECE 197,001,957920,Mercier; Patrick Philip,9991,0,9999,8
1746532321965,ECON 178,A01,907814,Zhu; Ying,26,0,35,9
1746532322995,EDS 115,A00,895312,Staff,36,0,45,9
1746532324020,EDS 117,A01,895337,Staff,24,0,30,6
1746532325049,EDS 125,A00,895341,Jones; Gabrielle Anastasia,37,0,45,8
1746532326074,EDS 128A,A01,895459,Fargason; Sharon Gayle,44,0,45,1
1746532327100,EDS 128B,A01,895543,Pappas; Elizabeth,44,0,45,1
1746532328127,EDS 139,A00,897203,Pappas; Elizabeth,44,0,45,1
1746532328127,EDS 139,B00,897209,Fargason; Sharon Gayle,41,0,45,4
1746532329156,EDS 201,A00,895545,Staff,23,0,45,22
1746532330186,EDS 203,A01,895581,Halter; Christopher P.,23,0,45,22
1746532331212,EDS 204R,A01,895625,Heinzman; Erica M.,39,0,45,6
1746532331212,EDS 204R,B01,895693,Halter; Christopher P.,10,0,45,35
1746532332237,EDS 206R,A00,895694,Fargason; Sharon Gayle,1,0,30,29
1746532332237,EDS 206R,B00,895695,Choi; Bailey Miyeon,16,0,30,14
1746532333268,EDS 250,A00,895697,Hemans; Patricia Ann Benitez,23,0,45,22
1746532334293,EDS 281,A00,895701,Meyerott; Theresa Ann,1,0,15,14
1746532335322,EDS 284,A00,895736,Meyerott; Theresa Ann,1,0,15,14
1746532336349,EDS 286,A00,897210,Fine; Sarah,0,0,15,15
1746532337378,EDS 289C,A01,895770,Daly; Alan J.,15,0,15,0
1746532338404,EDS 290,A00,897211,Hofstetter; Carolyn,0,0,15,15
1746532339434,LIGM 5A,A00,896162,Fischer-Grunski; Eva K,13,0,20,7
1746532340459,LIGM 5B,A00,896260,Fischer-Grunski; Eva K,17,0,20,3
1746532341485,LIGM 5C,A00,896308,Fischer-Grunski; Eva K,18,0,20,2
1746532342514,LIIT 5AS,A00,896313,Carnelos; Chiara,18,0,20,2
1746532343540,LIIT 5BS,A00,896416,Carnelos; Chiara,20,0,20,0
1746532344564,LIIT 5CS,A00,896564,Carnelos; Chiara,20,0,20,0
1746532345590,LISP 5A,A00,896588,Munoz Sanchez; Alicia,3,0,20,17
1746532346673,LISP 5B,A00,896653,Munoz Sanchez; Alicia,7,0,20,13
1746532347701,LISP 5C,A00,896655,Munoz Sanchez; Alicia,0,1,20,20
1746532348727,MAE 197,001,957918,Kleissl; Jan,9996,0,9999,3
1746532348727,MAE 197,002,959806,Boechler; Nicholas Sebastia,9998,0,9999,1
1746532348727,MAE 197,003,959852,Mullin; Jennifer S,9999,0,9999,0
1746532349754,MATH 2,A01,957937,Staff,33,0,35,2
1746532350781,MATH 197,001,957876,Kedlaya; Kiran S.,9993,0,9999,6
1746532351812,MCWP 40,A00,892729,Duru; Nur,10,0,20,10
1746532351812,MCWP 40,B00,893304,Montejo; Carolina,14,0,20,6
1746532352840,MCWP 40R,A00,893757,Redela; Pamela Morgan,0,5,20,20
1746532353864,MCWP 50,A00,893758,Morshed; Michael James,0,0,20,20
1746532353864,MCWP 50,B00,893761,Bartulis; Jason Michael,17,0,20,3
1746532354889,MCWP 50R,A00,893766,Compas; Sean Matthew,0,1,20,20
1746532354889,MCWP 50R,B00,893769,Carter; Jennifer A,0,1,20,20
1746532354889,MCWP 50R,C00,893771,Krone; Jarret,0,3,20,20
1746532354889,MCWP 50R,D00,893772,Miller; Elizabeth Deen,0,0,20,20
1746532354889,MCWP 50R,E00,893775,Carter; Andrea L,0,1,20,20
1746532355915,MMW 11R,A01,892721,Herbst; Matthew,11,0,27,16
1746532355915,MMW 11R,A02,892722,Herbst; Matthew,0,0,0,3
1746532356942,MMW 12R,A01,892724,Herbst; Matthew,0,11,16,16
1746532356942,MMW 12R,A02,892725,Herbst; Matthew,0,10,16,16
1746532357973,MMW 13R,A01,892727,Staff,0,4,16,16
1746532357973,MMW 13R,A02,892728,Staff,0,4,16,16
1746532357973,MMW 13R,A03,958032,Staff,0,4,16,16
1746532357973,MMW 13R,A04,958033,Staff,0,4,16,16
1746532357973,MMW 13R,A05,958034,Staff,0,4,16,16
1746532359001,SIO 295LS,A00,894015,Staff,5,0,25,20
1746532360029,SIO 295S,A00,894020,Staff,5,0,25,20
1746532361055,SIOC 290S,B01,958918,Merrifield; Mark A,14,0,30,16
1746532362083,SIOC 291S,B01,958922,Gabriel; Corey John,14,0,30,16
1746532363111,SOCI 117,A01,895339,Staff,3,0,5,2
1746532364138,WES 237B,A00,894149,Staff,11,0,20,9
1746532366213,AESE 279B,A00,891859,Staff,13,0,35,22
1746532367241,AIP 197,001,891854,Vespa; Emanuel Ignacio,9999,0,9999,0
1746532368270,ANTH 289S,A00,891856,Gagneux; Pascal,12,0,12,0
1746532369299,BENG 196,001,957946,Engler; Adam J.,9996,0,9999,3
1746532370324,BISP 197,001,959851,Wilhelm; James E.,9999,0,9999,0
1746532371352,CAT 124RS,A01,956906,Staff,6,0,25,19
1746532372379,CAT 125RS,A01,922013,Staff,6,0,25,19
1746532373405,CLRE 250,A00,891860,Morris; Sheldon,9995,0,9999,4
1746532375463,CLRE 251R,A00,907817,Mehta; Ravindra L.,9994,0,9999,5
1746532376490,CLRE 252,A00,891864,Cuomo; Raphael Eduardo,9993,0,9999,6
1746532377518,CLRE 253,A00,891867,Vaida; Florin,9994,0,9999,5
1746532377518,CLRE 253,B00,907819,Staff,9999,0,9999,0
1746532378546,CLRE 259,A00,891868,Patel; Hemal,9998,0,9999,1
1746532379577,CLRE 260,A00,891872,Cuomo; Raphael Eduardo,9999,0,9999,0
1746532380607,CLRE 297,001,891888,Cuomo; Raphael Eduardo,9999,0,9999,0
1746532381636,CSE 191,A00,958773,Minnes Kemp; Mor Mia,9996,0,9999,3
1746532382663,CSE 197,001,959846,Minnes Kemp; Mor Mia,9993,0,9999,6
1746532383690,CSS 201S,A01,892054,Mignozzetti; Umberto,26,0,30,4
1746532384721,CSS 202S,A01,892056,Mignozzetti; Umberto,26,0,30,4
1746532385749,DSC 197,001,956898,Eldridge; Justin Matthew,9998,0,9999,1
1746532386774,DSC 297,001,958000,Mazumdar; Arya,9998,0,9999,1
1746532386774,DSC 297,002,959862,Wang; Yusu,9999,0,9999,0
1746532387803,EAP 100,A00,905686,Staff,9778,0,9999,221
1746532388837,ECE 45,A01,892618,Staff,0,0,65,65
1746532390891,ECE 111,A01,892719,Staff,4,0,65,61
1746532392117,ECE 197,001,957920,Mercier; Patrick Philip,9991,0,9999,8
1746532393148,ECON 178,A01,907814,Zhu; Ying,26,0,35,9
1746532394179,EDS 115,A00,895312,Staff,36,0,45,9
1746532395207,EDS 117,A01,895337,Staff,24,0,30,6
1746532396233,EDS 125,A00,895341,Jones; Gabrielle Anastasia,37,0,45,8
1746532397258,EDS 128A,A01,895459,Fargason; Sharon Gayle,44,0,45,1
1746532398284,EDS 128B,A01,895543,Pappas; Elizabeth,44,0,45,1
1746532399313,EDS 139,A00,897203,Pappas; Elizabeth,44,0,45,1
1746532399313,EDS 139,B00,897209,Fargason; Sharon Gayle,41,0,45,4
1746532400341,EDS 201,A00,895545,Staff,23,0,45,22
1746532401369,EDS 203,A01,895581,Halter; Christopher P.,23,0,45,22
1746532402408,EDS 204R,A01,895625,Heinzman; Erica M.,39,0,45,6
1746532402408,EDS 204R,B01,895693,Halter; Christopher P.,10,0,45,35
1746532403435,EDS 206R,A00,895694,Fargason; Sharon Gayle,1,0,30,29
1746532403435,EDS 206R,B00,895695,Choi; Bailey Miyeon,16,0,30,14
1746532404461,EDS 250,A00,895697,Hemans; Patricia Ann Benitez,23,0,45,22
1746532405486,EDS 281,A00,895701,Meyerott; Theresa Ann,1,0,15,14
1746532406517,EDS 284,A00,895736,Meyerott; Theresa Ann,1,0,15,14
1746532407544,EDS 286,A00,897210,Fine; Sarah,0,0,15,15
1746532408572,EDS 289C,A01,895770,Daly; Alan J.,15,0,15,0
1746532409598,EDS 290,A00,897211,Hofstetter; Carolyn,0,0,15,15
1746532410628,LIGM 5A,A00,896162,Fischer-Grunski; Eva K,13,0,20,7
1746532411657,LIGM 5B,A00,896260,Fischer-Grunski; Eva K,17,0,20,3
1746532412683,LIGM 5C,A00,896308,Fischer-Grunski; Eva K,18,0,20,2
1746532413713,LIIT 5AS,A00,896313,Carnelos; Chiara,18,0,20,2
1746532414739,LIIT 5BS,A00,896416,Carnelos; Chiara,20,0,20,0
1746532415765,LIIT 5CS,A00,896564,Carnelos; Chiara,20,0,20,0
1746532416790,LISP 5A,A00,896588,Munoz Sanchez; Alicia,3,0,20,17
1746532417819,LISP 5B,A00,896653,Munoz Sanchez; Alicia,7,0,20,13
1746532418848,LISP 5C,A00,896655,Munoz Sanchez; Alicia,0,1,20,20
1746532419874,MAE 197,001,957918,Kleissl; Jan,9996,0,9999,3
1746532419874,MAE 197,002,959806,Boechler; Nicholas Sebastia,9998,0,9999,1
1746532419874,MAE 197,003,959852,Mullin; Jennifer S,9999,0,9999,0
1746532420901,MATH 2,A01,957937,Staff,33,0,35,2
1746532421930,MATH 197,001,957876,Kedlaya; Kiran S.,9993,0,9999,6
1746532422960,MCWP 40,A00,892729,Duru; Nur,10,0,20,10
1746532422960,MCWP 40,B00,893304,Montejo; Carolina,14,0,20,6
1746532423985,MCWP 40R,A00,893757,Redela; Pamela Morgan,0,5,20,20
1746532425011,MCWP 50,A00,893758,Morshed; Michael James,0,0,20,20
1746532425011,MCWP 50,B00,893761,Bartulis; Jason Michael,17,0,20,3
1746532426039,MCWP 50R,A00,893766,Compas; Sean Matthew,0,1,20,20
1746532426039,MCWP 50R,B00,893769,Carter; Jennifer A,0,1,20,20
1746532426039,MCWP 50R,C00,893771,Krone; Jarret,0,3,20,20
1746532426039,MCWP 50R,D00,893772,Miller; Elizabeth Deen,0,0,20,20
1746532426039,MCWP 50R,E00,893775,Carter; Andrea L,0,1,20,20
1746532427068,MMW 11R,A01,892721,Herbst; Matthew,11,0,27,16
1746532427068,MMW 11R,A02,892722,Herbst; Matthew,0,0,0,3
1746532428092,MMW 12R,A01,892724,Herbst; Matthew,0,11,16,16
1746532428092,MMW 12R,A02,892725,Herbst; Matthew,0,10,16,16
1746532429122,MMW 13R,A01,892727,Staff,0,4,16,16
1746532429122,MMW 13R,A02,892728,Staff,0,4,16,16
1746532429122,MMW 13R,A03,958032,Staff,0,4,16,16
1746532429122,MMW 13R,A04,958033,Staff,0,4,16,16
1746532429122,MMW 13R,A05,958034,Staff,0,4,16,16
1746532430150,SIO 295LS,A00,894015,Staff,5,0,25,20
1746532431179,SIO 295S,A00,894020,Staff,5,0,25,20
1746532432208,SIOC 290S,B01,958918,Merrifield; Mark A,14,0,30,16
1746532433238,SIOC 291S,B01,958922,Gabriel; Corey John,14,0,30,16
1746532434265,SOCI 117,A01,895339,Staff,3,0,5,2
1746532435290,WES 237B,A00,894149,Staff,11,0,20,9
1746532437354,AESE 279B,A00,891859,Staff,13,0,35,22
1746532438384,AIP 197,001,891854,Vespa; Emanuel Ignacio,9999,0,9999,0
1746532439413,ANTH 289S,A00,891856,Gagneux; Pascal,12,0,12,0
1746532440443,BENG 196,001,957946,Engler; Adam J.,9996,0,9999,3
1746532441469,BISP 197,001,959851,Wilhelm; James E.,9999,0,9999,0
1746532442496,CAT 124RS,A01,956906,Staff,6,0,25,19
1746532443521,CAT 125RS,A01,922013,Staff,6,0,25,19
1746532444548,CLRE 250,A00,891860,Morris; Sheldon,9995,0,9999,4
1746532446606,CLRE 251R,A00,907817,Mehta; Ravindra L.,9994,0,9999,5
1746532447632,CLRE 252,A00,891864,Cuomo; Raphael Eduardo,9993,0,9999,6
1746532448662,CLRE 253,A00,891867,Vaida; Florin,9994,0,9999,5
1746532448662,CLRE 253,B00,907819,Staff,9999,0,9999,0
1746532449688,CLRE 259,A00,891868,Patel; Hemal,9998,0,9999,1
1746532450770,CLRE 260,A00,891872,Cuomo; Raphael Eduardo,9999,0,9999,0
1746532451795,CLRE 297,001,891888,Cuomo; Raphael Eduardo,9999,0,9999,0
1746532452821,CSE 191,A00,958773,Minnes Kemp; Mor Mia,9996,0,9999,3
1746532453848,CSE 197,001,959846,Minnes Kemp; Mor Mia,9993,0,9999,6
1746532454876,CSS 201S,A01,892054,Mignozzetti; Umberto,26,0,30,4
1746532455906,CSS 202S,A01,892056,Mignozzetti; Umberto,26,0,30,4
1746532456932,DSC 197,001,956898,Eldridge; Justin Matthew,9998,0,9999,1
1746532457958,DSC 297,001,958000,Mazumdar; Arya,9998,0,9999,1
1746532457958,DSC 297,002,959862,Wang; Yusu,9999,0,9999,0
1746532458986,EAP 100,A00,905686,Staff,9778,0,9999,221
1746532460015,ECE 45,A01,892618,Staff,0,0,65,65
1746532462066,ECE 111,A01,892719,Staff,4,0,65,61
1746532463094,ECE 197,001,957920,Mercier; Patrick Philip,9991,0,9999,8
1746532464124,ECON 178,A01,907814,Zhu; Ying,26,0,35,9
1746532465152,EDS 115,A00,895312,Staff,36,0,45,9
1746532466181,EDS 117,A01,895337,Staff,24,0,30,6
1746532467207,EDS 125,A00,895341,Jones; Gabrielle Anastasia,37,0,45,8
1746532468235,EDS 128A,A01,895459,Fargason; Sharon Gayle,44,0,45,1
1746532469265,EDS 128B,A01,895543,Pappas; Elizabeth,44,0,45,1
1746532470289,EDS 139,A00,897203,Pappas; Elizabeth,44,0,45,1
1746532470289,EDS 139,B00,897209,Fargason; Sharon Gayle,41,0,45,4
1746532471315,EDS 201,A00,895545,Staff,23,0,45,22
1746532472341,EDS 203,A01,895581,Halter; Christopher P.,23,0,45,22
1746532473370,EDS 204R,A01,895625,Heinzman; Erica M.,39,0,45,6
1746532473370,EDS 204R,B01,895693,Halter; Christopher P.,10,0,45,35
1746532474399,EDS 206R,A00,895694,Fargason; Sharon Gayle,1,0,30,29
1746532474399,EDS 206R,B00,895695,Choi; Bailey Miyeon,16,0,30,14
1746532475423,EDS 250,A00,895697,Hemans; Patricia Ann Benitez,23,0,45,22
1746532476450,EDS 281,A00,895701,Meyerott; Theresa Ann,1,0,15,14
1746532477477,EDS 284,A00,895736,Meyerott; Theresa Ann,1,0,15,14
1746532478506,EDS 286,A00,897210,Fine; Sarah,0,0,15,15
1746532479532,EDS 289C,A01,895770,Daly; Alan J.,15,0,15,0
1746532480558,EDS 290,A00,897211,Hofstetter; Carolyn,0,0,15,15
1746532481587,LIGM 5A,A00,896162,Fischer-Grunski; Eva K,13,0,20,7
1746532482615,LIGM 5B,A00,896260,Fischer-Grunski; Eva K,17,0,20,3
1746532483647,LIGM 5C,A00,896308,Fischer-Grunski; Eva K,18,0,20,2
1746532484677,LIIT 5AS,A00,896313,Carnelos; Chiara,18,0,20,2
1746532485707,LIIT 5BS,A00,896416,Carnelos; Chiara,20,0,20,0
1746532486733,LIIT 5CS,A00,896564,Carnelos; Chiara,20,0,20,0
1746532487760,LISP 5A,A00,896588,Munoz Sanchez; Alicia,3,0,20,17
1746532488790,LISP 5B,A00,896653,Munoz Sanchez; Alicia,7,0,20,13
1746532489816,LISP 5C,A00,896655,Munoz Sanchez; Alicia,0,1,20,20
1746532490844,MAE 197,001,957918,Kleissl; Jan,9996,0,9999,3
1746532490844,MAE 197,002,959806,Boechler; Nicholas Sebastia,9998,0,9999,1
1746532490844,MAE 197,003,959852,Mullin; Jennifer S,9999,0,9999,0
1746532491869,MATH 2,A01,957937,Staff,33,0,35,2
1746532492898,MATH 197,001,957876,Kedlaya; Kiran S.,9993,0,9999,6
1746532493923,MCWP 40,A00,892729,Duru; Nur,10,0,20,10
1746532493923,MCWP 40,B00,893304,Montejo; Carolina,14,0,20,6
1746532494950,MCWP 40R,A00,893757,Redela; Pamela Morgan,0,5,20,20
1746532495981,MCWP 50,A00,893758,Morshed; Michael James,0,0,20,20
1746532495981,MCWP 50,B00,893761,Bartulis; Jason Michael,17,0,20,3
1746532497007,MCWP 50R,A00,893766,Compas; Sean Matthew,0,1,20,20
1746532497007,MCWP 50R,B00,893769,Carter; Jennifer A,0,1,20,20
1746532497007,MCWP 50R,C00,893771,Krone; Jarret,0,3,20,20
1746532497007,MCWP 50R,D00,893772,Miller; Elizabeth Deen,0,0,20,20
1746532497007,MCWP 50R,E00,893775,Carter; Andrea L,0,1,20,20
1746532498033,MMW 11R,A01,892721,Herbst; Matthew,11,0,27,16
1746532498033,MMW 11R,A02,892722,Herbst; Matthew,0,0,0,3
1746532499060,MMW 12R,A01,892724,Herbst; Matthew,0,11,16,16
1746532499060,MMW 12R,A02,892725,Herbst; Matthew,0,10,16,16
1746532500086,MMW 13R,A01,892727,Staff,0,4,16,16
1746532500086,MMW 13R,A02,892728,Staff,0,4,16,16
1746532500086,MMW 13R,A03,958032,Staff,0,4,16,16
1746532500086,MMW 13R,A04,958033,Staff,0,4,16,16
1746532500086,MMW 13R,A05,958034,Staff,0,4,16,16
1746532501113,SIO 295LS,A00,894015,Staff,5,0,25,20
1746532502140,SIO 295S,A00,894020,Staff,5,0,25,20
1746532503170,SIOC 290S,B01,958918,Merrifield; Mark A,14,0,30,16
1746532504199,SIOC 291S,B01,958922,Gabriel; Corey John,14,0,30,16
1746532505228,SOCI 117,A01,895339,Staff,3,0,5,2
1746532506253,WES 237B,A00,894149,Staff,11,0,20,9
1746532508317,AESE 279B,A00,891859,Staff,13,0,35,22
1746532509343,AIP 197,001,891854,Vespa; Emanuel Ignacio,9999,0,9999,0
1746532510369,ANTH 289S,A00,891856,Gagneux; Pascal,12,0,12,0
1746532511404,BENG 196,001,957946,Engler; Adam J.,9996,0,9999,3
1746532512432,BISP 197,001,959851,Wilhelm; James E.,9999,0,9999,0
1746532513460,CAT 124RS,A01,956906,Staff,6,0,25,19
1746532514485,CAT 125RS,A01,922013,Staff,6,0,25,19
1746532515512,CLRE 250,A00,891860,Morris; Sheldon,9995,0,9999,4
1746532517563,CLRE 251R,A00,907817,Mehta; Ravindra L.,9994,0,9999,5
1746532518588,CLRE 252,A00,891864,Cuomo; Raphael Eduardo,9993,0,9999,6
1746532519616,CLRE 253,A00,891867,Vaida; Florin,9994,0,9999,5
1746532519616,CLRE 253,B00,907819,Staff,9999,0,9999,0
1746532520643,CLRE 259,A00,891868,Patel; Hemal,9998,0,9999,1
1746532521669,CLRE 260,A00,891872,Cuomo; Raphael Eduardo,9999,0,9999,0
1746532522704,CLRE 297,001,891888,Cuomo; Raphael Eduardo,9999,0,9999,0
1746532523729,CSE 191,A00,958773,Minnes Kemp; Mor Mia,9996,0,9999,3
1746532524755,CSE 197,001,959846,Minnes Kemp; Mor Mia,9993,0,9999,6
1746532525786,CSS 201S,A01,892054,Mignozzetti; Umberto,26,0,30,4
1746532526812,CSS 202S,A01,892056,Mignozzetti; Umberto,26,0,30,4
1746532527838,DSC 197,001,956898,Eldridge; Justin Matthew,9998,0,9999,1
1746532528867,DSC 297,001,958000,Mazumdar; Arya,9998,0,9999,1
1746532528867,DSC 297,002,959862,Wang; Yusu,9999,0,9999,0
1746532529893,EAP 100,A00,905686,Staff,9778,0,9999,221
1746532530919,ECE 45,A01,892618,Staff,0,0,65,65
1746532532969,ECE 111,A01,892719,Staff,4,0,65,61
1746532533994,ECE 197,001,957920,Mercier; Patrick Philip,9991,0,9999,8
1746532535024,ECON 178,A01,907814,Zhu; Ying,26,0,35,9
1746532536050,EDS 115,A00,895312,Staff,36,0,45,9
1746532537076,EDS 117,A01,895337,Staff,24,0,30,6
1746532538103,EDS 125,A00,895341,Jones; Gabrielle Anastasia,37,0,45,8
1746532539131,EDS 128A,A01,895459,Fargason; Sharon Gayle,44,0,45,1
1746532540160,EDS 128B,A01,895543,Pappas; Elizabeth,44,0,45,1
1746532541188,EDS 139,A00,897203,Pappas; Elizabeth,44,0,45,1
1746532541188,EDS 139,B00,897209,Fargason; Sharon Gayle,41,0,45,4
1746532542216,EDS 201,A00,895545,Staff,23,0,45,22
1746532543243,EDS 203,A01,895581,Halter; Christopher P.,23,0,45,22
1746532544269,EDS 204R,A01,895625,Heinzman; Erica M.,39,0,45,6
1746532544269,EDS 204R,B01,895693,Halter; Christopher P.,10,0,45,35
1746532545296,EDS 206R,A00,895694,Fargason; Sharon Gayle,1,0,30,29
1746532545296,EDS 206R,B00,895695,Choi; Bailey Miyeon,16,0,30,14
1746532546327,EDS 250,A00,895697,Hemans; Patricia Ann Benitez,23,0,45,22
1746532547354,EDS 281,A00,895701,Meyerott; Theresa Ann,1,0,15,14
1746532548381,EDS 284,A00,895736,Meyerott; Theresa Ann,1,0,15,14
1746532549408,EDS 286,A00,897210,Fine; Sarah,0,0,15,15
1746532550432,EDS 289C,A01,895770,Daly; Alan J.,15,0,15,0
1746532551460,EDS 290,A00,897211,Hofstetter; Carolyn,0,0,15,15
1746532552491,LIGM 5A,A00,896162,Fischer-Grunski; Eva K,13,0,20,7
1746532553518,LIGM 5B,A00,896260,Fischer-Grunski; Eva K,17,0,20,3
1746532554547,LIGM 5C,A00,896308,Fischer-Grunski; Eva K,18,0,20,2
1746532555576,LIIT 5AS,A00,896313,Carnelos; Chiara,18,0,20,2
1746532556606,LIIT 5BS,A00,896416,Carnelos; Chiara,20,0,20,0
1746532557632,LIIT 5CS,A00,896564,Carnelos; Chiara,20,0,20,0
1746532558659,LISP 5A,A00,896588,Munoz Sanchez; Alicia,3,0,20,17
1746532559689,LISP 5B,A00,896653,Munoz Sanchez; Alicia,7,0,20,13
1746532560719,LISP 5C,A00,896655,Munoz Sanchez; Alicia,0,1,20,20
1746532561745,MAE 197,001,957918,Kleissl; Jan,9996,0,9999,3
1746532561745,MAE 197,002,959806,Boechler; Nicholas Sebastia,9998,0,9999,1
1746532561745,MAE 197,003,959852,Mullin; Jennifer S,9999,0,9999,0
1746532562772,MATH 2,A01,957937,Staff,33,0,35,2
1746532563800,MATH 197,001,957876,Kedlaya; Kiran S.,9993,0,9999,6
1746532564827,MCWP 40,A00,892729,Duru; Nur,10,0,20,10
1746532564827,MCWP 40,B00,893304,Montejo; Carolina,14,0,20,6
1746532565858,MCWP 40R,A00,893757,Redela; Pamela Morgan,0,5,20,20
1746532566884,MCWP 50,A00,893758,Morshed; Michael James,0,0,20,20
1746532566884,MCWP 50,B00,893761,Bartulis; Jason Michael,17,0,20,3
1746532567913,MCWP 50R,A00,893766,Compas; Sean Matthew,0,1,20,20
1746532567913,MCWP 50R,B00,893769,Carter; Jennifer A,0,1,20,20
1746532567913,MCWP 50R,C00,893771,Krone; Jarret,0,3,20,20
1746532567913,MCWP 50R,D00,893772,Miller; Elizabeth Deen,0,0,20,20
1746532567913,MCWP 50R,E00,893775,Carter; Andrea L,0,1,20,20
1746532568938,MMW 11R,A01,892721,Herbst; Matthew,11,0,27,16
1746532568938,MMW 11R,A02,892722,Herbst; Matthew,0,0,0,3
1746532569968,MMW 12R,A01,892724,Herbst; Matthew,0,11,16,16
1746532569968,MMW 12R,A02,892725,Herbst; Matthew,0,10,16,16
1746532570997,MMW 13R,A01,892727,Staff,0,4,16,16
1746532570997,MMW 13R,A02,892728,Staff,0,4,16,16
1746532570997,MMW 13R,A03,958032,Staff,0,4,16,16
1746532570997,MMW 13R,A04,958033,Staff,0,4,16,16
1746532570997,MMW 13R,A05,958034,Staff,0,4,16,16
1746532572023,SIO 295LS,A00,894015,Staff,5,0,25,20
1746532573052,SIO 295S,A00,894020,Staff,5,0,25,20
1746532574082,SIOC 290S,B01,958918,Merrifield; Mark A,14,0,30,16
1746532575109,SIOC 291S,B01,958922,Gabriel; Corey John,14,0,30,16
1746532576137,SOCI 117,A01,895339,Staff,3,0,5,2
1746532577164,WES 237B,A00,894149,Staff,11,0,20,9
1746532579240,AESE 279B,A00,891859,Staff,13,0,35,22
1746532580265,AIP 197,001,891854,Vespa; Emanuel Ignacio,9999,0,9999,0
1746532581290,ANTH 289S,A00,891856,Gagneux; Pascal,12,0,12,0
1746532582316,BENG 196,001,957946,Engler; Adam J.,9996,0,9999,3
1746532583342,BISP 197,001,959851,Wilhelm; James E.,9999,0,9999,0
1746532584367,CAT 124RS,A01,956906,Staff,6,0,25,19
1746532585404,CAT 125RS,A01,922013,Staff,6,0,25,19
1746532586433,CLRE 250,A00,891860,Morris; Sheldon,9995,0,9999,4
1746532588484,CLRE 251R,A00,907817,Mehta; Ravindra L.,9994,0,9999,5
1746532589510,CLRE 252,A00,891864,Cuomo; Raphael Eduardo,9993,0,9999,6
1746532590536,CLRE 253,A00,891867,Vaida; Florin,9994,0,9999,5
1746532590536,CLRE 253,B00,907819,Staff,9999,0,9999,0
1746532591560,CLRE 259,A00,891868,Patel; Hemal,9998,0,9999,1
1746532592588,CLRE 260,A00,891872,Cuomo; Raphael Eduardo,9999,0,9999,0
1746532593635,CLRE 297,001,891888,Cuomo; Raphael Eduardo,9999,0,9999,0
1746532594662,CSE 191,A00,958773,Minnes Kemp; Mor Mia,9996,0,9999,3
1746532595689,CSE 197,001,959846,Minnes Kemp; Mor Mia,9993,0,9999,6
1746532596715,CSS 201S,A01,892054,Mignozzetti; Umberto,26,0,30,4
1746532597742,CSS 202S,A01,892056,Mignozzetti; Umberto,26,0,30,4
1746532598772,DSC 197,001,956898,Eldridge; Justin Matthew,9998,0,9999,1
1746532599802,DSC 297,001,958000,Mazumdar; Arya,9998,0,9999,1
1746532599802,DSC 297,002,959862,Wang; Yusu,9999,0,9999,0
1746532600828,EAP 100,A00,905686,Staff,9778,0,9999,221
1746532601859,ECE 45,A01,892618,Staff,0,0,65,65
1746532603914,ECE 111,A01,892719,Staff,4,0,65,61
1746532604939,ECE 197,001,957920,Mercier; Patrick Philip,9991,0,9999,8
1746532605966,ECON 178,A01,907814,Zhu; Ying,26,0,35,9
1746532606994,EDS 115,A00,895312,Staff,36,0,45,9
1746532608021,EDS 117,A01,895337,Staff,24,0,30,6
1746532609046,EDS 125,A00,895341,Jones; Gabrielle Anastasia,37,0,45,8
1746532610072,EDS 128A,A01,895459,Fargason; Sharon Gayle,44,0,45,1
1746532611098,EDS 128B,A01,895543,Pappas; Elizabeth,44,0,45,1
1746532612126,EDS 139,A00,897203,Pappas; Elizabeth,44,0,45,1
1746532612126,EDS 139,B00,897209,Fargason; Sharon Gayle,41,0,45,4
1746532613152,EDS 201,A00,895545,Staff,23,0,45,22
1746532614182,EDS 203,A01,895581,Halter; Christopher P.,23,0,45,22
1746532615211,EDS 204R,A01,895625,Heinzman; Erica M.,39,0,45,6
1746532615211,EDS 204R,B01,895693,Halter; Christopher P.,10,0,45,35
1746532616238,EDS 206R,A00,895694,Fargason; Sharon Gayle,1,0,30,29
1746532616238,EDS 206R,B00,895695,Choi; Bailey Miyeon,16,0,30,14
1746532617265,EDS 250,A00,895697,Hemans; Patricia Ann Benitez,23,0,45,22
1746532618291,EDS 281,A00,895701,Meyerott; Theresa Ann,1,0,15,14
1746532619317,EDS 284,A00,895736,Meyerott; Theresa Ann,1,0,15,14
1746532620343,EDS 286,A00,897210,Fine; Sarah,0,0,15,15
1746532621370,EDS 289C,A01,895770,Daly; Alan J.,15,0,15,0
1746532622408,EDS 290,A00,897211,Hofstetter; Carolyn,0,0,15,15
1746532623438,LIGM 5A,A00,896162,Fischer-Grunski; Eva K,13,0,20,7
1746532624463,LIGM 5B,A00,896260,Fischer-Grunski; Eva K,17,0,20,3
1746532625488,LIGM 5C,A00,896308,Fischer-Grunski; Eva K,18,0,20,2
1746532626514,LIIT 5AS,A00,896313,Carnelos; Chiara,18,0,20,2
1746532627546,LIIT 5BS,A00,896416,Carnelos; Chiara,20,0,20,0
1746532628574,LIIT 5CS,A00,896564,Carnelos; Chiara,20,0,20,0
1746532629601,LISP 5A,A00,896588,Munoz Sanchez; Alicia,3,0,20,17
1746532630629,LISP 5B,A00,896653,Munoz Sanchez; Alicia,7,0,20,13
1746532631655,LISP 5C,A00,896655,Munoz Sanchez; Alicia,0,1,20,20
1746532632685,MAE 197,001,957918,Kleissl; Jan,9996,0,9999,3
1746532632685,MAE 197,002,959806,Boechler; Nicholas Sebastia,9998,0,9999,1
1746532632685,MAE 197,003,959852,Mullin; Jennifer S,9999,0,9999,0
1746532633710,MATH 2,A01,957937,Staff,33,0,35,2
1746532634734,MATH 197,001,957876,Kedlaya; Kiran S.,9993,0,9999,6
1746532635762,MCWP 40,A00,892729,Duru; Nur,10,0,20,10
1746532635762,MCWP 40,B00,893304,Montejo; Carolina,14,0,20,6
1746532636790,MCWP 40R,A00,893757,Redela; Pamela Morgan,0,5,20,20
1746532637818,MCWP 50,A00,893758,Morshed; Michael James,0,0,20,20
1746532637818,MCWP 50,B00,893761,Bartulis; Jason Michael,17,0,20,3
1746532638843,MCWP 50R,A00,893766,Compas; Sean Matthew,0,1,20,20
1746532638843,MCWP 50R,B00,893769,Carter; Jennifer A,0,1,20,20
1746532638843,MCWP 50R,C00,893771,Krone; Jarret,0,3,20,20
1746532638843,MCWP 50R,D00,893772,Miller; Elizabeth Deen,0,0,20,20
1746532638843,MCWP 50R,E00,893775,Carter; Andrea L,0,1,20,20
1746532639868,MMW 11R,A01,892721,Herbst; Matthew,11,0,27,16
1746532639868,MMW 11R,A02,892722,Herbst; Matthew,0,0,0,3
1746532640897,MMW 12R,A01,892724,Herbst; Matthew,0,11,16,16
1746532640897,MMW 12R,A02,892725,Herbst; Matthew,0,10,16,16
1746532641922,MMW 13R,A01,892727,Staff,0,4,16,16
1746532641922,MMW 13R,A02,892728,Staff,0,4,16,16
1746532641922,MMW 13R,A03,958032,Staff,0,4,16,16
1746532641922,MMW 13R,A04,958033,Staff,0,4,16,16
1746532641922,MMW 13R,A05,958034,Staff,0,4,16,16
1746532642945,SIO 295LS,A00,894015,Staff,5,0,25,20
1746532643971,SIO 295S,A00,894020,Staff,5,0,25,20
1746532644999,SIOC 290S,B01,958918,Merrifield; Mark A,14,0,30,16
1746532646026,SIOC 291S,B01,958922,Gabriel; Corey John,14,0,30,16
1746532647052,SOCI 117,A01,895339,Staff,3,0,5,2
1746532648078,WES 237B,A00,894149,Staff,11,0,20,9
1746532650145,AESE 279B,A00,891859,Staff,13,0,35,22
1746532651171,AIP 197,001,891854,Vespa; Emanuel Ignacio,9999,0,9999,0
1746532652197,ANTH 289S,A00,891856,Gagneux; Pascal,12,0,12,0
1746532653224,BENG 196,001,957946,Engler; Adam J.,9996,0,9999,3
1746532654248,BISP 197,001,959851,Wilhelm; James E.,9999,0,9999,0
1746532655277,CAT 124RS,A01,956906,Staff,6,0,25,19
1746532656303,CAT 125RS,A01,922013,Staff,6,0,25,19
1746532657328,CLRE 250,A00,891860,Morris; Sheldon,9995,0,9999,4
1746532659385,CLRE 251R,A00,907817,Mehta; Ravindra L.,9994,0,9999,5
1746532660412,CLRE 252,A00,891864,Cuomo; Raphael Eduardo,9993,0,9999,6
1746532661437,CLRE 253,A00,891867,Vaida; Florin,9994,0,9999,5
1746532661437,CLRE 253,B00,907819,Staff,9999,0,9999,0
1746532662476,CLRE 259,A00,891868,Patel; Hemal,9998,0,9999,1
1746532663500,CLRE 260,A00,891872,Cuomo; Raphael Eduardo,9999,0,9999,0
1746532664529,CLRE 297,001,891888,Cuomo; Raphael Eduardo,9999,0,9999,0
1746532665555,CSE 191,A00,958773,Minnes Kemp; Mor Mia,9996,0,9999,3
1746532666583,CSE 197,001,959846,Minnes Kemp; Mor Mia,9993,0,9999,6
1746532667608,CSS 201S,A01,892054,Mignozzetti; Umberto,26,0,30,4
1746532668638,CSS 202S,A01,892056,Mignozzetti; Umberto,26,0,30,4
1746532669664,DSC 197,001,956898,Eldridge; Justin Matthew,9998,0,9999,1
1746532670690,DSC 297,001,958000,Mazumdar; Arya,9998,0,9999,1
1746532670690,DSC 297,002,959862,Wang; Yusu,9999,0,9999,0
1746532671714,EAP 100,A00,905686,Staff,9778,0,9999,221
1746532672742,ECE 45,A01,892618,Staff,0,0,65,65
1746532674796,ECE 111,A01,892719,Staff,4,0,65,61
1746532675820,ECE 197,001,957920,Mercier; Patrick Philip,9991,0,9999,8
1746532676847,ECON 178,A01,907814,Zhu; Ying,26,0,35,9
1746532677873,EDS 115,A00,895312,Staff,36,0,45,9
1746532678901,EDS 117,A01,895337,Staff,24,0,30,6
1746532679929,EDS 125,A00,895341,Jones; Gabrielle Anastasia,37,0,45,8
1746532680958,EDS 128A,A01,895459,Fargason; Sharon Gayle,44,0,45,1
1746532681983,EDS 128B,A01,895543,Pappas; Elizabeth,44,0,45,1
1746532683008,EDS 139,A00,897203,Pappas; Elizabeth,44,0,45,1
1746532683008,EDS 139,B00,897209,Fargason; Sharon Gayle,41,0,45,4
1746532684033,EDS 201,A00,895545,Staff,23,0,45,22
1746532685059,EDS 203,A01,895581,Halter; Christopher P.,23,0,45,22
1746532686085,EDS 204R,A01,895625,Heinzman; Erica M.,39,0,45,6
1746532686085,EDS 204R,B01,895693,Halter; Christopher P.,10,0,45,35
1746532687113,EDS 206R,A00,895694,Fargason; Sharon Gayle,1,0,30,29
1746532687113,EDS 206R,B00,895695,Choi; Bailey Miyeon,16,0,30,14
1746532688140,EDS 250,A00,895697,Hemans; Patricia Ann Benitez,23,0,45,22
1746532689166,EDS 281,A00,895701,Meyerott; Theresa Ann,1,0,15,14
1746532690192,EDS 284,A00,895736,Meyerott; Theresa Ann,1,0,15,14
1746532691218,EDS 286,A00,897210,Fine; Sarah,0,0,15,15
1746532692243,EDS 289C,A01,895770,Daly; Alan J.,15,0,15,0
1746532693269,EDS 290,A00,897211,Hofstetter; Carolyn,0,0,15,15
1746532694294,LIGM 5A,A00,896162,Fischer-Grunski; Eva K,13,0,20,7
1746532695323,LIGM 5B,A00,896260,Fischer-Grunski; Eva K,17,0,20,3
1746532696348,LIGM 5C,A00,896308,Fischer-Grunski; Eva K,18,0,20,2
1746532697378,LIIT 5AS,A00,896313,Carnelos; Chiara,18,0,20,2
1746532698404,LIIT 5BS,A00,896416,Carnelos; Chiara,20,0,20,0
1746532699432,LIIT 5CS,A00,896564,Carnelos; Chiara,20,0,20,0
1746532700459,LISP 5A,A00,896588,Munoz Sanchez; Alicia,3,0,20,17
1746532701487,LISP 5B,A00,896653,Munoz Sanchez; Alicia,7,0,20,13
1746532702513,LISP 5C,A00,896655,Munoz Sanchez; Alicia,0,1,20,20
1746532703539,MAE 197,001,957918,Kleissl; Jan,9996,0,9999,3
1746532703539,MAE 197,002,959806,Boechler; Nicholas Sebastia,9998,0,9999,1
1746532703539,MAE 197,003,959852,Mullin; Jennifer S,9999,0,9999,0
1746532704566,MATH 2,A01,957937,Staff,33,0,35,2
1746532705593,MATH 197,001,957876,Kedlaya; Kiran S.,9993,0,9999,6
1746532706624,MCWP 40,A00,892729,Duru; Nur,10,0,20,10
1746532706624,MCWP 40,B00,893304,Montejo; Carolina,14,0,20,6
1746532707653,MCWP 40R,A00,893757,Redela; Pamela Morgan,0,5,20,20
1746532708678,MCWP 50,A00,893758,Morshed; Michael James,0,0,20,20
1746532708678,MCWP 50,B00,893761,Bartulis; Jason Michael,17,0,20,3
1746532709705,MCWP 50R,A00,893766,Compas; Sean Matthew,0,1,20,20
1746532709705,MCWP 50R,B00,893769,Carter; Jennifer A,0,1,20,20
1746532709705,MCWP 50R,C00,893771,Krone; Jarret,0,3,20,20
1746532709705,MCWP 50R,D00,893772,Miller; Elizabeth Deen,0,0,20,20
1746532709705,MCWP 50R,E00,893775,Carter; Andrea L,0,1,20,20
1746532710733,MMW 11R,A01,892721,Herbst; Matthew,11,0,27,16
1746532710733,MMW 11R,A02,892722,Herbst; Matthew,0,0,0,3
1746532711760,MMW 12R,A01,892724,Herbst; Matthew,0,11,16,16
1746532711760,MMW 12R,A02,892725,Herbst; Matthew,0,10,16,16
1746532712790,MMW 13R,A01,892727,Staff,0,4,16,16
1746532712790,MMW 13R,A02,892728,Staff,0,4,16,16
1746532712790,MMW 13R,A03,958032,Staff,0,4,16,16
1746532712790,MMW 13R,A04,958033,Staff,0,4,16,16
1746532712790,MMW 13R,A05,958034,Staff,0,4,16,16
1746532713821,SIO 295LS,A00,894015,Staff,5,0,25,20
1746532714847,SIO 295S,A00,894020,Staff,5,0,25,20
1746532715877,SIOC 290S,B01,958918,Merrifield; Mark A,14,0,30,16
1746532716903,SIOC 291S,B01,958922,Gabriel; Corey John,14,0,30,16
1746532717931,SOCI 117,A01,895339,Staff,3,0,5,2
1746532718960,WES 237B,A00,894149,Staff,11,0,20,9
1746532721029,AESE 279B,A00,891859,Staff,13,0,35,22
1746532722055,AIP 197,001,891854,Vespa; Emanuel Ignacio,9999,0,9999,0
1746532723083,ANTH 289S,A00,891856,Gagneux; Pascal,12,0,12,0
1746532724111,BENG 196,001,957946,Engler; Adam J.,9996,0,9999,3
1746532725136,BISP 197,001,959851,Wilhelm; James E.,9999,0,9999,0
1746532726163,CAT 124RS,A01,956906,Staff,6,0,25,19
1746532727190,CAT 125RS,A01,922013,Staff,6,0,25,19
1746532728220,CLRE 250,A00,891860,Morris; Sheldon,9995,0,9999,4
1746532730276,CLRE 251R,A00,907817,Mehta; Ravindra L.,9994,0,9999,5
1746532731305,CLRE 252,A00,891864,Cuomo; Raphael Eduardo,9993,0,9999,6
1746532732332,CLRE 253,A00,891867,Vaida; Florin,9994,0,9999,5
1746532732332,CLRE 253,B00,907819,Staff,9999,0,9999,0
1746532733358,CLRE 259,A00,891868,Patel; Hemal,9998,0,9999,1
1746532734387,CLRE 260,A00,891872,Cuomo; Raphael Eduardo,9999,0,9999,0
1746532735417,CLRE 297,001,891888,Cuomo; Raphael Eduardo,9999,0,9999,0
1746532736444,CSE 191,A00,958773,Minnes Kemp; Mor Mia,9996,0,9999,3
1746532737468,CSE 197,001,959846,Minnes Kemp; Mor Mia,9993,0,9999,6
1746532738495,CSS 201S,A01,892054,Mignozzetti; Umberto,26,0,30,4
1746532739520,CSS 202S,A01,892056,Mignozzetti; Umberto,26,0,30,4
1746532740549,DSC 197,001,956898,Eldridge; Justin Matthew,9998,0,9999,1
1746532741574,DSC 297,001,958000,Mazumdar; Arya,9998,0,9999,1
1746532741574,DSC 297,002,959862,Wang; Yusu,9999,0,9999,0
1746532742601,EAP 100,A00,905686,Staff,9778,0,9999,221
1746532743629,ECE 45,A01,892618,Staff,0,0,65,65
1746532745687,ECE 111,A01,892719,Staff,4,0,65,61
1746532746714,ECE 197,001,957920,Mercier; Patrick Philip,9991,0,9999,8
1746532747741,ECON 178,A01,907814,Zhu; Ying,26,0,35,9
1746532748766,EDS 115,A00,895312,Staff,36,0,45,9
1746532749795,EDS 117,A01,895337,Staff,24,0,30,6
1746532750824,EDS 125,A00,895341,Jones; Gabrielle Anastasia,37,0,45,8
1746532751850,EDS 128A,A01,895459,Fargason; Sharon Gayle,44,0,45,1
1746532752878,EDS 128B,A01,895543,Pappas; Elizabeth,44,0,45,1
1746532753909,EDS 139,A00,897203,Pappas; Elizabeth,44,0,45,1
1746532753909,EDS 139,B00,897209,Fargason; Sharon Gayle,41,0,45,4
1746532754939,EDS 201,A00,895545,Staff,23,0,45,22
1746532755966,EDS 203,A01,895581,Halter; Christopher P.,23,0,45,22
1746532756991,EDS 204R,A01,895625,Heinzman; Erica M.,39,0,45,6
1746532756991,EDS 204R,B01,895693,Halter; Christopher P.,10,0,45,35
1746532758018,EDS 206R,A00,895694,Fargason; Sharon Gayle,1,0,30,29
1746532758018,EDS 206R,B00,895695,Choi; Bailey Miyeon,16,0,30,14
1746532759087,EDS 250,A00,895697,Hemans; Patricia Ann Benitez,23,0,45,22
1746532760115,EDS 281,A00,895701,Meyerott; Theresa Ann,1,0,15,14
1746532761139,EDS 284,A00,895736,Meyerott; Theresa Ann,1,0,15,14
1746532762165,EDS 286,A00,897210,Fine; Sarah,0,0,15,15
1746532763193,EDS 289C,A01,895770,Daly; Alan J.,15,0,15,0
1746532764219,EDS 290,A00,897211,Hofstetter; Carolyn,0,0,15,15
1746532765247,LIGM 5A,A00,896162,Fischer-Grunski; Eva K,13,0,20,7
1746532766277,LIGM 5B,A00,896260,Fischer-Grunski; Eva K,17,0,20,3
1746532767305,LIGM 5C,A00,896308,Fischer-Grunski; Eva K,18,0,20,2
1746532768333,LIIT 5AS,A00,896313,Carnelos; Chiara,18,0,20,2
1746532769364,LIIT 5BS,A00,896416,Carnelos; Chiara,20,0,20,0
1746532770390,LIIT 5CS,A00,896564,Carnelos; Chiara,20,0,20,0
1746532771416,LISP 5A,A00,896588,Munoz Sanchez; Alicia,3,0,20,17
1746532772446,LISP 5B,A00,896653,Munoz Sanchez; Alicia,7,0,20,13
1746532773474,LISP 5C,A00,896655,Munoz Sanchez; Alicia,0,1,20,20
1746532774505,MAE 197,001,957918,Kleissl; Jan,9996,0,9999,3
1746532774505,MAE 197,002,959806,Boechler; Nicholas Sebastia,9998,0,9999,1
1746532774505,MAE 197,003,959852,Mullin; Jennifer S,9999,0,9999,0
1746532775532,MATH 2,A01,957937,Staff,33,0,35,2
1746532776558,MATH 197,001,957876,Kedlaya; Kiran S.,9993,0,9999,6
1746532777586,MCWP 40,A00,892729,Duru; Nur,10,0,20,10
1746532777586,MCWP 40,B00,893304,Montejo; Carolina,14,0,20,6
1746532778612,MCWP 40R,A00,893757,Redela; Pamela Morgan,0,5,20,20
1746532779639,MCWP 50,A00,893758,Morshed; Michael James,0,0,20,20
1746532779639,MCWP 50,B00,893761,Bartulis; Jason Michael,17,0,20,3
1746532780666,MCWP 50R,A00,893766,Compas; Sean Matthew,0,1,20,20
1746532780666,MCWP 50R,B00,893769,Carter; Jennifer A,0,1,20,20
1746532780666,MCWP 50R,C00,893771,Krone; Jarret,0,3,20,20
1746532780666,MCWP 50R,D00,893772,Miller; Elizabeth Deen,0,0,20,20
1746532780666,MCWP 50R,E00,893775,Carter; Andrea L,0,1,20,20
1746532781692,MMW 11R,A01,892721,Herbst; Matthew,11,0,27,16
1746532781692,MMW 11R,A02,892722,Herbst; Matthew,0,0,0,3
1746532782724,MMW 12R,A01,892724,Herbst; Matthew,0,11,16,16
1746532782724,MMW 12R,A02,892725,Herbst; Matthew,0,10,16,16
1746532783750,MMW 13R,A01,892727,Staff,0,4,16,16
1746532783750,MMW 13R,A02,892728,Staff,0,4,16,16
1746532783750,MMW 13R,A03,958032,Staff,0,4,16,16
1746532783750,MMW 13R,A04,958033,Staff,0,4,16,16
1746532783750,MMW 13R,A05,958034,Staff,0,4,16,16
1746532784778,SIO 295LS,A00,894015,Staff,5,0,25,20
1746532785803,SIO 295S,A00,894020,Staff,5,0,25,20
1746532786834,SIOC 290S,B01,958918,Merrifield; Mark A,14,0,30,16
1746532787860,SIOC 291S,B01,958922,Gabriel; Corey John,14,0,30,16
1746532788887,SOCI 117,A01,895339,Staff,3,0,5,2
1746532789911,WES 237B,A00,894149,Staff,11,0,20,9
1746532791969,AESE 279B,A00,891859,Staff,13,0,35,22
1746532792994,AIP 197,001,891854,Vespa; Emanuel Ignacio,9999,0,9999,0
1746532794020,ANTH 289S,A00,891856,Gagneux; Pascal,12,0,12,0
1746532795046,BENG 196,001,957946,Engler; Adam J.,9996,0,9999,3
1746532796072,BISP 197,001,959851,Wilhelm; James E.,9999,0,9999,0
1746532797099,CAT 124RS,A01,956906,Staff,6,0,25,19
1746532798127,CAT 125RS,A01,922013,Staff,6,0,25,19
1746532799152,CLRE 250,A00,891860,Morris; Sheldon,9995,0,9999,4
1746532801207,CLRE 251R,A00,907817,Mehta; Ravindra L.,9994,0,9999,5
1746532802236,CLRE 252,A00,891864,Cuomo; Raphael Eduardo,9993,0,9999,6
1746532803261,CLRE 253,A00,891867,Vaida; Florin,9994,0,9999,5
1746532803261,CLRE 253,B00,907819,Staff,9999,0,9999,0
1746532804286,CLRE 259,A00,891868,Patel; Hemal,9998,0,9999,1
1746532805312,CLRE 260,A00,891872,Cuomo; Raphael Eduardo,9999,0,9999,0
1746532806340,CLRE 297,001,891888,Cuomo; Raphael Eduardo,9999,0,9999,0
1746532807366,CSE 191,A00,958773,Minnes Kemp; Mor Mia,9996,0,9999,3
1746532808393,CSE 197,001,959846,Minnes Kemp; Mor Mia,9993,0,9999,6
1746532809418,CSS 201S,A01,892054,Mignozzetti; Umberto,26,0,30,4
1746532810448,CSS 202S,A01,892056,Mignozzetti; Umberto,26,0,30,4
1746532811474,DSC 197,001,956898,Eldridge; Justin Matthew,9998,0,9999,1
1746532812500,DSC 297,001,958000,Mazumdar; Arya,9998,0,9999,1
1746532812500,DSC 297,002,959862,Wang; Yusu,9999,0,9999,0
1746532813529,EAP 100,A00,905686,Staff,9778,0,9999,221
1746532814556,ECE 45,A01,892618,Staff,0,0,65,65
1746532816608,ECE 111,A01,892719,Staff,4,0,65,61
1746532817634,ECE 197,001,957920,Mercier; Patrick Philip,9991,0,9999,8
1746532818663,ECON 178,A01,907814,Zhu; Ying,26,0,35,9
1746532819692,EDS 115,A00,895312,Staff,36,0,45,9
1746532820718,EDS 117,A01,895337,Staff,24,0,30,6
1746532821748,EDS 125,A00,895341,Jones; Gabrielle Anastasia,37,0,45,8
1746532822774,EDS 128A,A01,895459,Fargason; Sharon Gayle,44,0,45,1
1746532823801,EDS 128B,A01,895543,Pappas; Elizabeth,44,0,45,1
1746532824826,EDS 139,A00,897203,Pappas; Elizabeth,44,0,45,1
1746532824826,EDS 139,B00,897209,Fargason; Sharon Gayle,41,0,45,4
1746532825853,EDS 201,A00,895545,Staff,23,0,45,22
1746532826878,EDS 203,A01,895581,Halter; Christopher P.,23,0,45,22
1746532827905,EDS 204R,A01,895625,Heinzman; Erica M.,39,0,45,6
1746532827905,EDS 204R,B01,895693,Halter; Christopher P.,10,0,45,35
1746532828933,EDS 206R,A00,895694,Fargason; Sharon Gayle,1,0,30,29
1746532828933,EDS 206R,B00,895695,Choi; Bailey Miyeon,16,0,30,14
1746532829959,EDS 250,A00,895697,Hemans; Patricia Ann Benitez,23,0,45,22
1746532830989,EDS 281,A00,895701,Meyerott; Theresa Ann,1,0,15,14
1746532832014,EDS 284,A00,895736,Meyerott; Theresa Ann,1,0,15,14
1746532833038,EDS 286,A00,897210,Fine; Sarah,0,0,15,15
1746532834063,EDS 289C,A01,895770,Daly; Alan J.,15,0,15,0
1746532835089,EDS 290,A00,897211,Hofstetter; Carolyn,0,0,15,15
1746532836117,LIGM 5A,A00,896162,Fischer-Grunski; Eva K,13,0,20,7
1746532837144,LIGM 5B,A00,896260,Fischer-Grunski; Eva K,17,0,20,3
1746532838169,LIGM 5C,A00,896308,Fischer-Grunski; Eva K,18,0,20,2
1746532839198,LIIT 5AS,A00,896313,Carnelos; Chiara,18,0,20,2
1746532840230,LIIT 5BS,A00,896416,Carnelos; Chiara,20,0,20,0
1746532841257,LIIT 5CS,A00,896564,Carnelos; Chiara,20,0,20,0
1746532842289,LISP 5A,A00,896588,Munoz Sanchez; Alicia,3,0,20,17
1746532843318,LISP 5B,A00,896653,Munoz Sanchez; Alicia,7,0,20,13
1746532844347,LISP 5C,A00,896655,Munoz Sanchez; Alicia,0,1,20,20
1746532845378,MAE 197,001,957918,Kleissl; Jan,9996,0,9999,3
1746532845378,MAE 197,002,959806,Boechler; Nicholas Sebastia,9998,0,9999,1
1746532845378,MAE 197,003,959852,Mullin; Jennifer S,9999,0,9999,0
1746532846402,MATH 2,A01,957937,Staff,33,0,35,2
1746532847428,MATH 197,001,957876,Kedlaya; Kiran S.,9993,0,9999,6
1746532848453,MCWP 40,A00,892729,Duru; Nur,10,0,20,10
1746532848453,MCWP 40,B00,893304,Montejo; Carolina,14,0,20,6
1746532849483,MCWP 40R,A00,893757,Redela; Pamela Morgan,0,5,20,20
1746532850513,MCWP 50,A00,893758,Morshed; Michael James,0,0,20,20
1746532850513,MCWP 50,B00,893761,Bartulis; Jason Michael,17,0,20,3
1746532851540,MCWP 50R,A00,893766,Compas; Sean Matthew,0,1,20,20
1746532851540,MCWP 50R,B00,893769,Carter; Jennifer A,0,1,20,20
1746532851540,MCWP 50R,C00,893771,Krone; Jarret,0,3,20,20
1746532851540,MCWP 50R,D00,893772,Miller; Elizabeth Deen,0,0,20,20
1746532851540,MCWP 50R,E00,893775,Carter; Andrea L,0,1,20,20
1746532852570,MMW 11R,A01,892721,Herbst; Matthew,11,0,27,16
1746532852570,MMW 11R,A02,892722,Herbst; Matthew,0,0,0,3
1746532853596,MMW 12R,A01,892724,Herbst; Matthew,0,11,16,16
1746532853596,MMW 12R,A02,892725,Herbst; Matthew,0,10,16,16
1746532854626,MMW 13R,A01,892727,Staff,0,4,16,16
1746532854626,MMW 13R,A02,892728,Staff,0,4,16,16
1746532854626,MMW 13R,A03,958032,Staff,0,4,16,16
1746532854626,MMW 13R,A04,958033,Staff,0,4,16,16
1746532854626,MMW 13R,A05,958034,Staff,0,4,16,16
1746532855655,SIO 295LS,A00,894015,Staff,5,0,25,20
1746532856684,SIO 295S,A00,894020,Staff,5,0,25,20
1746532857715,SIOC 290S,B01,958918,Merrifield; Mark A,14,0,30,16
1746532858742,SIOC 291S,B01,958922,Gabriel; Corey John,14,0,30,16
1746532859773,SOCI 117,A01,895339,Staff,3,0,5,2
1746532860799,WES 237B,A00,894149,Staff,11,0,20,9
1746532862926,AESE 279B,A00,891859,Staff,13,0,35,22
1746532863954,AIP 197,001,891854,Vespa; Emanuel Ignacio,9999,0,9999,0
1746532864979,ANTH 289S,A00,891856,Gagneux; Pascal,12,0,12,0
1746532866011,BENG 196,001,957946,Engler; Adam J.,9996,0,9999,3
1746532867037,BISP 197,001,959851,Wilhelm; James E.,9999,0,9999,0
1746532868065,CAT 124RS,A01,956906,Staff,6,0,25,19
1746532869092,CAT 125RS,A01,922013,Staff,6,0,25,19
1746532870123,CLRE 250,A00,891860,Morris; Sheldon,9995,0,9999,4
1746532872181,CLRE 251R,A00,907817,Mehta; Ravindra L.,9994,0,9999,5
1746532873208,CLRE 252,A00,891864,Cuomo; Raphael Eduardo,9993,0,9999,6
1746532874234,CLRE 253,A00,891867,Vaida; Florin,9994,0,9999,5
1746532874234,CLRE 253,B00,907819,Staff,9999,0,9999,0
1746532875260,CLRE 259,A00,891868,Patel; Hemal,9998,0,9999,1
1746532876290,CLRE 260,A00,891872,Cuomo; Raphael Eduardo,9999,0,9999,0
1746532877316,CLRE 297,001,891888,Cuomo; Raphael Eduardo,9999,0,9999,0
1746532878343,CSE 191,A00,958773,Minnes Kemp; Mor Mia,9996,0,9999,3
1746532879372,CSE 197,001,959846,Minnes Kemp; Mor Mia,9993,0,9999,6
1746532880405,CSS 201S,A01,892054,Mignozzetti; Umberto,26,0,30,4
1746532881431,CSS 202S,A01,892056,Mignozzetti; Umberto,26,0,30,4
1746532882457,DSC 197,001,956898,Eldridge; Justin Matthew,9998,0,9999,1
1746532883486,DSC 297,001,958000,Mazumdar; Arya,9998,0,9999,1
1746532883486,DSC 297,002,959862,Wang; Yusu,9999,0,9999,0
1746532884510,EAP 100,A00,905686,Staff,9778,0,9999,221
1746532885538,ECE 45,A01,892618,Staff,0,0,65,65
1746532887595,ECE 111,A01,892719,Staff,4,0,65,61
1746532888622,ECE 197,001,957920,Mercier; Patrick Philip,9991,0,9999,8
1746532889649,ECON 178,A01,907814,Zhu; Ying,26,0,35,9
1746532890678,EDS 115,A00,895312,Staff,36,0,45,9
1746532891705,EDS 117,A01,895337,Staff,24,0,30,6
1746532892736,EDS 125,A00,895341,Jones; Gabrielle Anastasia,37,0,45,8
1746532893762,EDS 128A,A01,895459,Fargason; Sharon Gayle,44,0,45,1
1746532894787,EDS 128B,A01,895543,Pappas; Elizabeth,44,0,45,1
1746532895816,EDS 139,A00,897203,Pappas; Elizabeth,44,0,45,1
1746532895816,EDS 139,B00,897209,Fargason; Sharon Gayle,41,0,45,4
1746532896845,EDS 201,A00,895545,Staff,23,0,45,22
1746532897872,EDS 203,A01,895581,Halter; Christopher P.,23,0,45,22
1746532898899,EDS 204R,A01,895625,Heinzman; Erica M.,39,0,45,6
1746532898899,EDS 204R,B01,895693,Halter; Christopher P.,10,0,45,35
1746532899928,EDS 206R,A00,895694,Fargason; Sharon Gayle,1,0,30,29
1746532899928,EDS 206R,B00,895695,Choi; Bailey Miyeon,16,0,30,14
1746532900953,EDS 250,A00,895697,Hemans; Patricia Ann Benitez,23,0,45,22
1746532901983,EDS 281,A00,895701,Meyerott; Theresa Ann,1,0,15,14
1746532903008,EDS 284,A00,895736,Meyerott; Theresa Ann,1,0,15,14
1746532904033,EDS 286,A00,897210,Fine; Sarah,0,0,15,15
1746532905062,EDS 289C,A01,895770,Daly; Alan J.,15,0,15,0
1746532906128,EDS 290,A00,897211,Hofstetter; Carolyn,0,0,15,15
1746532907161,LIGM 5A,A00,896162,Fischer-Grunski; Eva K,13,0,20,7
1746532908187,LIGM 5B,A00,896260,Fischer-Grunski; Eva K,17,0,20,3
1746532909214,LIGM 5C,A00,896308,Fischer-Grunski; Eva K,18,0,20,2
1746532910246,LIIT 5AS,A00,896313,Carnelos; Chiara,18,0,20,2
1746532911272,LIIT 5BS,A00,896416,Carnelos; Chiara,20,0,20,0
1746532912299,LIIT 5CS,A00,896564,Carnelos; Chiara,20,0,20,0
1746532913325,LISP 5A,A00,896588,Munoz Sanchez; Alicia,3,0,20,17
1746532914351,LISP 5B,A00,896653,Munoz Sanchez; Alicia,7,0,20,13
1746532915381,LISP 5C,A00,896655,Munoz Sanchez; Alicia,0,1,20,20
1746532916407,MAE 197,001,957918,Kleissl; Jan,9996,0,9999,3
1746532916407,MAE 197,002,959806,Boechler; Nicholas Sebastia,9998,0,9999,1
1746532916407,MAE 197,003,959852,Mullin; Jennifer S,9999,0,9999,0
1746532917439,MATH 2,A01,957937,Staff,33,0,35,2
1746532918466,MATH 197,001,957876,Kedlaya; Kiran S.,9993,0,9999,6
1746532919493,MCWP 40,A00,892729,Duru; Nur,10,0,20,10
1746532919493,MCWP 40,B00,893304,Montejo; Carolina,14,0,20,6
1746532920521,MCWP 40R,A00,893757,Redela; Pamela Morgan,0,5,20,20
1746532921547,MCWP 50,A00,893758,Morshed; Michael James,0,0,20,20
1746532921547,MCWP 50,B00,893761,Bartulis; Jason Michael,17,0,20,3
1746532922577,MCWP 50R,A00,893766,Compas; Sean Matthew,0,1,20,20
1746532922577,MCWP 50R,B00,893769,Carter; Jennifer A,0,1,20,20
1746532922577,MCWP 50R,C00,893771,Krone; Jarret,0,3,20,20
1746532922577,MCWP 50R,D00,893772,Miller; Elizabeth Deen,0,0,20,20
1746532922577,MCWP 50R,E00,893775,Carter; Andrea L,0,1,20,20
1746532923603,MMW 11R,A01,892721,Herbst; Matthew,11,0,27,16
1746532923603,MMW 11R,A02,892722,Herbst; Matthew,0,0,0,3
1746532924632,MMW 12R,A01,892724,Herbst; Matthew,0,11,16,16
1746532924632,MMW 12R,A02,892725,Herbst; Matthew,0,10,16,16
1746532925662,MMW 13R,A01,892727,Staff,0,4,16,16
1746532925662,MMW 13R,A02,892728,Staff,0,4,16,16
1746532925662,MMW 13R,A03,958032,Staff,0,4,16,16
1746532925662,MMW 13R,A04,958033,Staff,0,4,16,16
1746532925662,MMW 13R,A05,958034,Staff,0,4,16,16
1746532926689,SIO 295LS,A00,894015,Staff,5,0,25,20
1746532927717,SIO 295S,A00,894020,Staff,5,0,25,20
1746532928746,SIOC 290S,B01,958918,Merrifield; Mark A,14,0,30,16
1746532929784,SIOC 291S,B01,958922,Gabriel; Corey John,14,0,30,16
1746532930810,SOCI 117,A01,895339,Staff,3,0,5,2
1746532931839,WES 237B,A00,894149,Staff,11,0,20,9
1746532933966,AESE 279B,A00,891859,Staff,13,0,35,22
1746532934993,AIP 197,001,891854,Vespa; Emanuel Ignacio,9999,0,9999,0
1746532936020,ANTH 289S,A00,891856,Gagneux; Pascal,12,0,12,0
1746532937046,BENG 196,001,957946,Engler; Adam J.,9996,0,9999,3
1746532938073,BISP 197,001,959851,Wilhelm; James E.,9999,0,9999,0
1746532939103,CAT 124RS,A01,956906,Staff,6,0,25,19
1746532940130,CAT 125RS,A01,922013,Staff,6,0,25,19
1746532941158,CLRE 250,A00,891860,Morris; Sheldon,9995,0,9999,4
1746532943213,CLRE 251R,A00,907817,Mehta; Ravindra L.,9994,0,9999,5
1746532944244,CLRE 252,A00,891864,Cuomo; Raphael Eduardo,9993,0,9999,6
1746532945267,CLRE 253,A00,891867,Vaida; Florin,9994,0,9999,5
1746532945267,CLRE 253,B00,907819,Staff,9999,0,9999,0
1746532946297,CLRE 259,A00,891868,Patel; Hemal,9998,0,9999,1
1746532947324,CLRE 260,A00,891872,Cuomo; Raphael Eduardo,9999,0,9999,0
1746532948352,CLRE 297,001,891888,Cuomo; Raphael Eduardo,9999,0,9999,0
1746532949380,CSE 191,A00,958773,Minnes Kemp; Mor Mia,9996,0,9999,3
1746532950408,CSE 197,001,959846,Minnes Kemp; Mor Mia,9993,0,9999,6
1746532951434,CSS 201S,A01,892054,Mignozzetti; Umberto,26,0,30,4
1746532952462,CSS 202S,A01,892056,Mignozzetti; Umberto,26,0,30,4
1746532953487,DSC 197,001,956898,Eldridge; Justin Matthew,9998,0,9999,1
1746532954514,DSC 297,001,958000,Mazumdar; Arya,9998,0,9999,1
1746532954514,DSC 297,002,959862,Wang; Yusu,9999,0,9999,0
1746532955539,EAP 100,A00,905686,Staff,9778,0,9999,221
1746532956570,ECE 45,A01,892618,Staff,0,0,65,65
1746532958624,ECE 111,A01,892719,Staff,4,0,65,61
1746532959653,ECE 197,001,957920,Mercier; Patrick Philip,9991,0,9999,8
1746532960680,ECON 178,A01,907814,Zhu; Ying,26,0,35,9
1746532961710,EDS 115,A00,895312,Staff,36,0,45,9
1746532962736,EDS 117,A01,895337,Staff,24,0,30,6
1746532963762,EDS 125,A00,895341,Jones; Gabrielle Anastasia,37,0,45,8
1746532964790,EDS 128A,A01,895459,Fargason; Sharon Gayle,44,0,45,1
1746532965814,EDS 128B,A01,895543,Pappas; Elizabeth,44,0,45,1
1746532966840,EDS 139,A00,897203,Pappas; Elizabeth,44,0,45,1
1746532966840,EDS 139,B00,897209,Fargason; Sharon Gayle,41,0,45,4
1746532967866,EDS 201,A00,895545,Staff,23,0,45,22
1746532968896,EDS 203,A01,895581,Halter; Christopher P.,23,0,45,22
1746532969927,EDS 204R,A01,895625,Heinzman; Erica M.,39,0,45,6
1746532969927,EDS 204R,B01,895693,Halter; Christopher P.,10,0,45,35
1746532970954,EDS 206R,A00,895694,Fargason; Sharon Gayle,1,0,30,29
1746532970954,EDS 206R,B00,895695,Choi; Bailey Miyeon,16,0,30,14
1746532971981,EDS 250,A00,895697,Hemans; Patricia Ann Benitez,23,0,45,22
1746532973007,EDS 281,A00,895701,Meyerott; Theresa Ann,1,0,15,14
1746532974035,EDS 284,A00,895736,Meyerott; Theresa Ann,1,0,15,14
1746532975065,EDS 286,A00,897210,Fine; Sarah,0,0,15,15
1746532976091,EDS 289C,A01,895770,Daly; Alan J.,15,0,15,0
1746532977118,EDS 290,A00,897211,Hofstetter; Carolyn,0,0,15,15
1746532978143,LIGM 5A,A00,896162,Fischer-Grunski; Eva K,13,0,20,7
1746532979170,LIGM 5B,A00,896260,Fischer-Grunski; Eva K,17,0,20,3
1746532980197,LIGM 5C,A00,896308,Fischer-Grunski; Eva K,18,0,20,2
1746532981222,LIIT 5AS,A00,896313,Carnelos; Chiara,18,0,20,2
1746532982251,LIIT 5BS,A00,896416,Carnelos; Chiara,20,0,20,0
1746532983282,LIIT 5CS,A00,896564,Carnelos; Chiara,20,0,20,0
1746532984305,LISP 5A,A00,896588,Munoz Sanchez; Alicia,3,0,20,17
1746532985332,LISP 5B,A00,896653,Munoz Sanchez; Alicia,7,0,20,13
1746532986362,LISP 5C,A00,896655,Munoz Sanchez; Alicia,0,1,20,20
1746532987392,MAE 197,001,957918,Kleissl; Jan,9996,0,9999,3
1746532987392,MAE 197,002,959806,Boechler; Nicholas Sebastia,9998,0,9999,1
1746532987392,MAE 197,003,959852,Mullin; Jennifer S,9999,0,9999,0
1746532988419,MATH 2,A01,957937,Staff,33,0,35,2
1746532989488,MATH 197,001,957876,Kedlaya; Kiran S.,9993,0,9999,6
1746532990515,MCWP 40,A00,892729,Duru; Nur,10,0,20,10
1746532990515,MCWP 40,B00,893304,Montejo; Carolina,14,0,20,6
1746532991547,MCWP 40R,A00,893757,Redela; Pamela Morgan,0,5,20,20
1746532992575,MCWP 50,A00,893758,Morshed; Michael James,0,0,20,20
1746532992575,MCWP 50,B00,893761,Bartulis; Jason Michael,17,0,20,3
1746532993605,MCWP 50R,A00,893766,Compas; Sean Matthew,0,1,20,20
1746532993605,MCWP 50R,B00,893769,Carter; Jennifer A,0,1,20,20
1746532993605,MCWP 50R,C00,893771,Krone; Jarret,0,3,20,20
1746532993605,MCWP 50R,D00,893772,Miller; Elizabeth Deen,0,0,20,20
1746532993605,MCWP 50R,E00,893775,Carter; Andrea L,0,1,20,20
1746532994632,MMW 11R,A01,892721,Herbst; Matthew,11,0,27,16
1746532994632,MMW 11R,A02,892722,Herbst; Matthew,0,0,0,3
1746532995662,MMW 12R,A01,892724,Herbst; Matthew,0,11,16,16
1746532995662,MMW 12R,A02,892725,Herbst; Matthew,0,10,16,16
1746532996689,MMW 13R,A01,892727,Staff,0,4,16,16
1746532996689,MMW 13R,A02,892728,Staff,0,4,16,16
1746532996689,MMW 13R,A03,958032,Staff,0,4,16,16
1746532996689,MMW 13R,A04,958033,Staff,0,4,16,16
1746532996689,MMW 13R,A05,958034,Staff,0,4,16,16
1746532997717,SIO 295LS,A00,894015,Staff,5,0,25,20
1746532998748,SIO 295S,A00,894020,Staff,5,0,25,20
1746532999778,SIOC 290S,B01,958918,Merrifield; Mark A,14,0,30,16
1746533000808,SIOC 291S,B01,958922,Gabriel; Corey John,14,0,30,16
1746533001838,SOCI 117,A01,895339,Staff,3,0,5,2
1746533002866,WES 237B,A00,894149,Staff,11,0,20,9
1746533004946,AESE 279B,A00,891859,Staff,13,0,35,22
1746533005971,AIP 197,001,891854,Vespa; Emanuel Ignacio,9999,0,9999,0
1746533006997,ANTH 289S,A00,891856,Gagneux; Pascal,12,0,12,0
1746533008023,BENG 196,001,957946,Engler; Adam J.,9996,0,9999,3
1746533009053,BISP 197,001,959851,Wilhelm; James E.,9999,0,9999,0
1746533010079,CAT 124RS,A01,956906,Staff,6,0,25,19
1746533011105,CAT 125RS,A01,922013,Staff,6,0,25,19
1746533012134,CLRE 250,A00,891860,Morris; Sheldon,9995,0,9999,4
1746533014184,CLRE 251R,A00,907817,Mehta; Ravindra L.,9994,0,9999,5
1746533015210,CLRE 252,A00,891864,Cuomo; Raphael Eduardo,9993,0,9999,6
1746533016240,CLRE 253,A00,891867,Vaida; Florin,9994,0,9999,5
1746533016240,CLRE 253,B00,907819,Staff,9999,0,9999,0
1746533017268,CLRE 259,A00,891868,Patel; Hemal,9998,0,9999,1
1746533018293,CLRE 260,A00,891872,Cuomo; Raphael Eduardo,9999,0,9999,0
1746533019322,CLRE 297,001,891888,Cuomo; Raphael Eduardo,9999,0,9999,0
1746533020349,CSE 191,A00,958773,Minnes Kemp; Mor Mia,9996,0,9999,3
1746533021378,CSE 197,001,959846,Minnes Kemp; Mor Mia,9993,0,9999,6
1746533022413,CSS 201S,A01,892054,Mignozzetti; Umberto,26,0,30,4
1746533023443,CSS 202S,A01,892056,Mignozzetti; Umberto,26,0,30,4
1746533024472,DSC 197,001,956898,Eldridge; Justin Matthew,9998,0,9999,1
1746533025498,DSC 297,001,958000,Mazumdar; Arya,9998,0,9999,1
1746533025498,DSC 297,002,959862,Wang; Yusu,9999,0,9999,0
1746533026525,EAP 100,A00,905686,Staff,9778,0,9999,221
1746533027552,ECE 45,A01,892618,Staff,0,0,65,65
1746533029607,ECE 111,A01,892719,Staff,4,0,65,61
1746533030633,ECE 197,001,957920,Mercier; Patrick Philip,9991,0,9999,8
1746533031658,ECON 178,A01,907814,Zhu; Ying,26,0,35,9
1746533032684,EDS 115,A00,895312,Staff,36,0,45,9
1746533033710,EDS 117,A01,895337,Staff,24,0,30,6
1746533034741,EDS 125,A00,895341,Jones; Gabrielle Anastasia,37,0,45,8
1746533035771,EDS 128A,A01,895459,Fargason; Sharon Gayle,44,0,45,1
1746533036798,EDS 128B,A01,895543,Pappas; Elizabeth,44,0,45,1
1746533037826,EDS 139,A00,897203,Pappas; Elizabeth,44,0,45,1
1746533037826,EDS 139,B00,897209,Fargason; Sharon Gayle,41,0,45,4
1746533038853,EDS 201,A00,895545,Staff,23,0,45,22
1746533039879,EDS 203,A01,895581,Halter; Christopher P.,23,0,45,22
1746533040904,EDS 204R,A01,895625,Heinzman; Erica M.,39,0,45,6
1746533040904,EDS 204R,B01,895693,Halter; Christopher P.,10,0,45,35
1746533041933,EDS 206R,A00,895694,Fargason; Sharon Gayle,1,0,30,29
1746533041933,EDS 206R,B00,895695,Choi; Bailey Miyeon,16,0,30,14
1746533042963,EDS 250,A00,895697,Hemans; Patricia Ann Benitez,23,0,45,22
1746533043989,EDS 281,A00,895701,Meyerott; Theresa Ann,1,0,15,14
1746533045031,EDS 284,A00,895736,Meyerott; Theresa Ann,1,0,15,14
1746533046059,EDS 286,A00,897210,Fine; Sarah,0,0,15,15
1746533047089,EDS 289C,A01,895770,Daly; Alan J.,15,0,15,0
1746533048115,EDS 290,A00,897211,Hofstetter; Carolyn,0,0,15,15
1746533049143,LIGM 5A,A00,896162,Fischer-Grunski; Eva K,13,0,20,7
1746533050168,LIGM 5B,A00,896260,Fischer-Grunski; Eva K,17,0,20,3
1746533051194,LIGM 5C,A00,896308,Fischer-Grunski; Eva K,18,0,20,2
1746533052222,LIIT 5AS,A00,896313,Carnelos; Chiara,18,0,20,2
1746533053253,LIIT 5BS,A00,896416,Carnelos; Chiara,20,0,20,0
1746533054278,LIIT 5CS,A00,896564,Carnelos; Chiara,20,0,20,0
1746533055305,LISP 5A,A00,896588,Munoz Sanchez; Alicia,3,0,20,17
1746533056330,LISP 5B,A00,896653,Munoz Sanchez; Alicia,7,0,20,13
1746533057355,LISP 5C,A00,896655,Munoz Sanchez; Alicia,0,1,20,20
1746533058381,MAE 197,001,957918,Kleissl; Jan,9996,0,9999,3
1746533058381,MAE 197,002,959806,Boechler; Nicholas Sebastia,9998,0,9999,1
1746533058381,MAE 197,003,959852,Mullin; Jennifer S,9999,0,9999,0
1746533059410,MATH 2,A01,957937,Staff,33,0,35,2
1746533060439,MATH 197,001,957876,Kedlaya; Kiran S.,9993,0,9999,6
1746533061469,MCWP 40,A00,892729,Duru; Nur,10,0,20,10
1746533061469,MCWP 40,B00,893304,Montejo; Carolina,14,0,20,6
1746533062501,MCWP 40R,A00,893757,Redela; Pamela Morgan,0,5,20,20
1746533063530,MCWP 50,A00,893758,Morshed; Michael James,0,0,20,20
1746533063530,MCWP 50,B00,893761,Bartulis; Jason Michael,17,0,20,3
1746533064558,MCWP 50R,A00,893766,Compas; Sean Matthew,0,1,20,20
1746533064558,MCWP 50R,B00,893769,Carter; Jennifer A,0,1,20,20
1746533064558,MCWP 50R,C00,893771,Krone; Jarret,0,3,20,20
1746533064558,MCWP 50R,D00,893772,Miller; Elizabeth Deen,0,0,20,20
1746533064558,MCWP 50R,E00,893775,Carter; Andrea L,0,1,20,20
1746533065589,MMW 11R,A01,892721,Herbst; Matthew,11,0,27,16
1746533065589,MMW 11R,A02,892722,Herbst; Matthew,0,0,0,3
1746533066622,MMW 12R,A01,892724,Herbst; Matthew,0,11,16,16
1746533066622,MMW 12R,A02,892725,Herbst; Matthew,0,10,16,16
1746533067655,MMW 13R,A01,892727,Staff,0,4,16,16
1746533067655,MMW 13R,A02,892728,Staff,0,4,16,16
1746533067655,MMW 13R,A03,958032,Staff,0,4,16,16
1746533067655,MMW 13R,A04,958033,Staff,0,4,16,16
1746533067655,MMW 13R,A05,958034,Staff,0,4,16,16
1746533068684,SIO 295LS,A00,894015,Staff,5,0,25,20
1746533069712,SIO 295S,A00,894020,Staff,5,0,25,20
1746533070738,SIOC 290S,B01,958918,Merrifield; Mark A,14,0,30,16
1746533071768,SIOC 291S,B01,958922,Gabriel; Corey John,14,0,30,16
1746533072794,SOCI 117,A01,895339,Staff,3,0,5,2
1746533073820,WES 237B,A00,894149,Staff,11,0,20,9
1746533075963,AESE 279B,A00,891859,Staff,13,0,35,22
1746533076992,AIP 197,001,891854,Vespa; Emanuel Ignacio,9999,0,9999,0
1746533078022,ANTH 289S,A00,891856,Gagneux; Pascal,12,0,12,0
1746533079051,BENG 196,001,957946,Engler; Adam J.,9996,0,9999,3
1746533080081,BISP 197,001,959851,Wilhelm; James E.,9999,0,9999,0
1746533081108,CAT 124RS,A01,956906,Staff,6,0,25,19
1746533082140,CAT 125RS,A01,922013,Staff,6,0,25,19
1746533083166,CLRE 250,A00,891860,Morris; Sheldon,9995,0,9999,4
1746533085225,CLRE 251R,A00,907817,Mehta; Ravindra L.,9994,0,9999,5
1746533086255,CLRE 252,A00,891864,Cuomo; Raphael Eduardo,9993,0,9999,6
1746533087281,CLRE 253,A00,891867,Vaida; Florin,9994,0,9999,5
1746533087281,CLRE 253,B00,907819,Staff,9999,0,9999,0
1746533088308,CLRE 259,A00,891868,Patel; Hemal,9998,0,9999,1
1746533089335,CLRE 260,A00,891872,Cuomo; Raphael Eduardo,9999,0,9999,0
1746533090361,CLRE 297,001,891888,Cuomo; Raphael Eduardo,9999,0,9999,0
1746533091388,CSE 191,A00,958773,Minnes Kemp; Mor Mia,9996,0,9999,3
1746533092420,CSE 197,001,959846,Minnes Kemp; Mor Mia,9993,0,9999,6
1746533093448,CSS 201S,A01,892054,Mignozzetti; Umberto,26,0,30,4
1746533094517,CSS 202S,A01,892056,Mignozzetti; Umberto,26,0,30,4
1746533095544,DSC 197,001,956898,Eldridge; Justin Matthew,9998,0,9999,1
1746533096570,DSC 297,001,958000,Mazumdar; Arya,9998,0,9999,1
1746533096570,DSC 297,002,959862,Wang; Yusu,9999,0,9999,0
1746533097602,EAP 100,A00,905686,Staff,9778,0,9999,221
1746533098629,ECE 45,A01,892618,Staff,0,0,65,65
1746533100690,ECE 111,A01,892719,Staff,4,0,65,61
1746533101729,ECE 197,001,957920,Mercier; Patrick Philip,9991,0,9999,8
1746533102757,ECON 178,A01,907814,Zhu; Ying,26,0,35,9
1746533103784,EDS 115,A00,895312,Staff,36,0,45,9
1746533104812,EDS 117,A01,895337,Staff,24,0,30,6
1746533105841,EDS 125,A00,895341,Jones; Gabrielle Anastasia,37,0,45,8
1746533106867,EDS 128A,A01,895459,Fargason; Sharon Gayle,44,0,45,1
1746533107901,EDS 128B,A01,895543,Pappas; Elizabeth,44,0,45,1
1746533108929,EDS 139,A00,897203,Pappas; Elizabeth,44,0,45,1
1746533108929,EDS 139,B00,897209,Fargason; Sharon Gayle,41,0,45,4
1746533109959,EDS 201,A00,895545,Staff,23,0,45,22
1746533110984,EDS 203,A01,895581,Halter; Christopher P.,23,0,45,22
1746533112011,EDS 204R,A01,895625,Heinzman; Erica M.,39,0,45,6
1746533112011,EDS 204R,B01,895693,Halter; Christopher P.,10,0,45,35
1746533113039,EDS 206R,A00,895694,Fargason; Sharon Gayle,1,0,30,29
1746533113039,EDS 206R,B00,895695,Choi; Bailey Miyeon,16,0,30,14
1746533114064,EDS 250,A00,895697,Hemans; Patricia Ann Benitez,23,0,45,22
1746533115089,EDS 281,A00,895701,Meyerott; Theresa Ann,1,0,15,14
1746533116118,EDS 284,A00,895736,Meyerott; Theresa Ann,1,0,15,14
1746533117146,EDS 286,A00,897210,Fine; Sarah,0,0,15,15
1746533118176,EDS 289C,A01,895770,Daly; Alan J.,15,0,15,0
1746533119202,EDS 290,A00,897211,Hofstetter; Carolyn,0,0,15,15
1746533120232,LIGM 5A,A00,896162,Fischer-Grunski; Eva K,13,0,20,7
1746533121262,LIGM 5B,A00,896260,Fischer-Grunski; Eva K,17,0,20,3
1746533122287,LIGM 5C,A00,896308,Fischer-Grunski; Eva K,18,0,20,2
1746533123318,LIIT 5AS,A00,896313,Carnelos; Chiara,18,0,20,2
1746533124345,LIIT 5BS,A00,896416,Carnelos; Chiara,20,0,20,0
1746533125373,LIIT 5CS,A00,896564,Carnelos; Chiara,20,0,20,0
1746533126400,LISP 5A,A00,896588,Munoz Sanchez; Alicia,3,0,20,17
1746533127431,LISP 5B,A00,896653,Munoz Sanchez; Alicia,7,0,20,13
1746533128458,LISP 5C,A00,896655,Munoz Sanchez; Alicia,0,1,20,20
1746533129485,MAE 197,001,957918,Kleissl; Jan,9996,0,9999,3
1746533129485,MAE 197,002,959806,Boechler; Nicholas Sebastia,9998,0,9999,1
1746533129485,MAE 197,003,959852,Mullin; Jennifer S,9999,0,9999,0
1746533130514,MATH 2,A01,957937,Staff,33,0,35,2
1746533131544,MATH 197,001,957876,Kedlaya; Kiran S.,9993,0,9999,6
1746533132626,MCWP 40,A00,892729,Duru; Nur,10,0,20,10
1746533132626,MCWP 40,B00,893304,Montejo; Carolina,14,0,20,6
1746533133654,MCWP 40R,A00,893757,Redela; Pamela Morgan,0,5,20,20
1746533134680,MCWP 50,A00,893758,Morshed; Michael James,0,0,20,20
1746533134680,MCWP 50,B00,893761,Bartulis; Jason Michael,17,0,20,3
1746533135710,MCWP 50R,A00,893766,Compas; Sean Matthew,0,1,20,20
1746533135710,MCWP 50R,B00,893769,Carter; Jennifer A,0,1,20,20
1746533135710,MCWP 50R,C00,893771,Krone; Jarret,0,3,20,20
1746533135710,MCWP 50R,D00,893772,Miller; Elizabeth Deen,0,0,20,20
1746533135710,MCWP 50R,E00,893775,Carter; Andrea L,0,1,20,20
1746533136740,MMW 11R,A01,892721,Herbst; Matthew,11,0,27,16
1746533136740,MMW 11R,A02,892722,Herbst; Matthew,0,0,0,3
1746533137769,MMW 12R,A01,892724,Herbst; Matthew,0,11,16,16
1746533137769,MMW 12R,A02,892725,Herbst; Matthew,0,10,16,16
1746533138800,MMW 13R,A01,892727,Staff,0,4,16,16
1746533138800,MMW 13R,A02,892728,Staff,0,4,16,16
1746533138800,MMW 13R,A03,958032,Staff,0,4,16,16
1746533138800,MMW 13R,A04,958033,Staff,0,4,16,16
1746533138800,MMW 13R,A05,958034,Staff,0,4,16,16
1746533139825,SIO 295LS,A00,894015,Staff,5,0,25,20
1746533140853,SIO 295S,A00,894020,Staff,5,0,25,20
1746533141882,SIOC 290S,B01,958918,Merrifield; Mark A,14,0,30,16
1746533142916,SIOC 291S,B01,958922,Gabriel; Corey John,14,0,30,16
1746533143961,SOCI 117,A01,895339,Staff,3,0,5,2
1746533144998,WES 237B,A00,894149,Staff,11,0,20,9
1746533147109,AESE 279B,A00,891859,Staff,13,0,35,22
1746533148137,AIP 197,001,891854,Vespa; Emanuel Ignacio,9999,0,9999,0
1746533149166,ANTH 289S,A00,891856,Gagneux; Pascal,12,0,12,0
1746533150193,BENG 196,001,957946,Engler; Adam J.,9996,0,9999,3
1746533151224,BISP 197,001,959851,Wilhelm; James E.,9999,0,9999,0
1746533152253,CAT 124RS,A01,956906,Staff,6,0,25,19
1746533153285,CAT 125RS,A01,922013,Staff,6,0,25,19
1746533154312,CLRE 250,A00,891860,Morris; Sheldon,9995,0,9999,4
1746533156369,CLRE 251R,A00,907817,Mehta; Ravindra L.,9994,0,9999,5
1746533157396,CLRE 252,A00,891864,Cuomo; Raphael Eduardo,9993,0,9999,6
1746533158426,CLRE 253,A00,891867,Vaida; Florin,9994,0,9999,5
1746533158426,CLRE 253,B00,907819,Staff,9999,0,9999,0
1746533159453,CLRE 259,A00,891868,Patel; Hemal,9998,0,9999,1
1746533160484,CLRE 260,A00,891872,Cuomo; Raphael Eduardo,9999,0,9999,0
1746533161510,CLRE 297,001,891888,Cuomo; Raphael Eduardo,9999,0,9999,0
1746533162536,CSE 191,A00,958773,Minnes Kemp; Mor Mia,9996,0,9999,3
1746533163561,CSE 197,001,959846,Minnes Kemp; Mor Mia,9993,0,9999,6
1746533164601,CSS 201S,A01,892054,Mignozzetti; Umberto,26,0,30,4
1746533165628,CSS 202S,A01,892056,Mignozzetti; Umberto,26,0,30,4
1746533166653,DSC 197,001,956898,Eldridge; Justin Matthew,9998,0,9999,1
1746533167683,DSC 297,001,958000,Mazumdar; Arya,9998,0,9999,1
1746533167683,DSC 297,002,959862,Wang; Yusu,9999,0,9999,0
1746533168713,EAP 100,A00,905686,Staff,9778,0,9999,221
1746533169737,ECE 45,A01,892618,Staff,0,0,65,65
1746533171790,ECE 111,A01,892719,Staff,4,0,65,61
1746533172820,ECE 197,001,957920,Mercier; Patrick Philip,9991,0,9999,8
1746533173858,ECON 178,A01,907814,Zhu; Ying,26,0,35,9
1746533174884,EDS 115,A00,895312,Staff,36,0,45,9
1746533175908,EDS 117,A01,895337,Staff,24,0,30,6
1746533176936,EDS 125,A00,895341,Jones; Gabrielle Anastasia,37,0,45,8
1746533177965,EDS 128A,A01,895459,Fargason; Sharon Gayle,44,0,45,1
1746533178991,EDS 128B,A01,895543,Pappas; Elizabeth,44,0,45,1
1746533180022,EDS 139,A00,897203,Pappas; Elizabeth,44,0,45,1
1746533180022,EDS 139,B00,897209,Fargason; Sharon Gayle,41,0,45,4
1746533181053,EDS 201,A00,895545,Staff,23,0,45,22
1746533182081,EDS 203,A01,895581,Halter; Christopher P.,23,0,45,22
1746533183111,EDS 204R,A01,895625,Heinzman; Erica M.,39,0,45,6
1746533183111,EDS 204R,B01,895693,Halter; Christopher P.,10,0,45,35
1746533184141,EDS 206R,A00,895694,Fargason; Sharon Gayle,1,0,30,29
1746533184141,EDS 206R,B00,895695,Choi; Bailey Miyeon,16,0,30,14
1746533185169,EDS 250,A00,895697,Hemans; Patricia Ann Benitez,23,0,45,22
1746533186196,EDS 281,A00,895701,Meyerott; Theresa Ann,1,0,15,14
1746533187222,EDS 284,A00,895736,Meyerott; Theresa Ann,1,0,15,14
1746533188248,EDS 286,A00,897210,Fine; Sarah,0,0,15,15
1746533189279,EDS 289C,A01,895770,Daly; Alan J.,15,0,15,0
1746533190303,EDS 290,A00,897211,Hofstetter; Carolyn,0,0,15,15
1746533191329,LIGM 5A,A00,896162,Fischer-Grunski; Eva K,13,0,20,7
1746533192355,LIGM 5B,A00,896260,Fischer-Grunski; Eva K,17,0,20,3
1746533193381,LIGM 5C,A00,896308,Fischer-Grunski; Eva K,18,0,20,2
1746533194405,LIIT 5AS,A00,896313,Carnelos; Chiara,18,0,20,2
1746533195430,LIIT 5BS,A00,896416,Carnelos; Chiara,20,0,20,0
1746533196462,LIIT 5CS,A00,896564,Carnelos; Chiara,20,0,20,0
1746533197490,LISP 5A,A00,896588,Munoz Sanchez; Alicia,3,0,20,17
1746533198553,LISP 5B,A00,896653,Munoz Sanchez; Alicia,7,0,20,13
1746533199579,LISP 5C,A00,896655,Munoz Sanchez; Alicia,0,1,20,20
1746533200610,MAE 197,001,957918,Kleissl; Jan,9996,0,9999,3
1746533200610,MAE 197,002,959806,Boechler; Nicholas Sebastia,9998,0,9999,1
1746533200610,MAE 197,003,959852,Mullin; Jennifer S,9999,0,9999,0
1746533201634,MATH 2,A01,957937,Staff,33,0,35,2
1746533202662,MATH 197,001,957876,Kedlaya; Kiran S.,9993,0,9999,6
1746533203697,MCWP 40,A00,892729,Duru; Nur,10,0,20,10
1746533203697,MCWP 40,B00,893304,Montejo; Carolina,14,0,20,6
1746533204728,MCWP 40R,A00,893757,Redela; Pamela Morgan,0,5,20,20
1746533205757,MCWP 50,A00,893758,Morshed; Michael James,0,0,20,20
1746533205757,MCWP 50,B00,893761,Bartulis; Jason Michael,17,0,20,3
1746533206789,MCWP 50R,A00,893766,Compas; Sean Matthew,0,1,20,20
1746533206789,MCWP 50R,B00,893769,Carter; Jennifer A,0,1,20,20
1746533206789,MCWP 50R,C00,893771,Krone; Jarret,0,3,20,20
1746533206789,MCWP 50R,D00,893772,Miller; Elizabeth Deen,0,0,20,20
1746533206789,MCWP 50R,E00,893775,Carter; Andrea L,0,1,20,20
1746533207817,MMW 11R,A01,892721,Herbst; Matthew,11,0,27,16
1746533207817,MMW 11R,A02,892722,Herbst; Matthew,0,0,0,3
1746533208845,MMW 12R,A01,892724,Herbst; Matthew,0,11,16,16
1746533208845,MMW 12R,A02,892725,Herbst; Matthew,0,10,16,16
1746533209874,MMW 13R,A01,892727,Staff,0,4,16,16
1746533209874,MMW 13R,A02,892728,Staff,0,4,16,16
1746533209874,MMW 13R,A03,958032,Staff,0,4,16,16
1746533209874,MMW 13R,A04,958033,Staff,0,4,16,16
1746533209874,MMW 13R,A05,958034,Staff,0,4,16,16
1746533210901,SIO 295LS,A00,894015,Staff,5,0,25,20
1746533211927,SIO 295S,A00,894020,Staff,5,0,25,20
1746533212954,SIOC 290S,B01,958918,Merrifield; Mark A,14,0,30,16
1746533213981,SIOC 291S,B01,958922,Gabriel; Corey John,14,0,30,16
1746533215006,SOCI 117,A01,895339,Staff,3,0,5,2
1746533216071,WES 237B,A00,894149,Staff,11,0,20,9
1746533218140,AESE 279B,A00,891859,Staff,13,0,35,22
1746533219181,AIP 197,001,891854,Vespa; Emanuel Ignacio,9999,0,9999,0
1746533220207,ANTH 289S,A00,891856,Gagneux; Pascal,12,0,12,0
1746533221233,BENG 196,001,957946,Engler; Adam J.,9996,0,9999,3
1746533222261,BISP 197,001,959851,Wilhelm; James E.,9999,0,9999,0
1746533223291,CAT 124RS,A01,956906,Staff,6,0,25,19
1746533224319,CAT 125RS,A01,922013,Staff,6,0,25,19
1746533225348,CLRE 250,A00,891860,Morris; Sheldon,9995,0,9999,4
1746533227403,CLRE 251R,A00,907817,Mehta; Ravindra L.,9994,0,9999,5
1746533228430,CLRE 252,A00,891864,Cuomo; Raphael Eduardo,9993,0,9999,6
1746533229462,CLRE 253,A00,891867,Vaida; Florin,9994,0,9999,5
1746533229462,CLRE 253,B00,907819,Staff,9999,0,9999,0
1746533230489,CLRE 259,A00,891868,Patel; Hemal,9998,0,9999,1
1746533231512,CLRE 260,A00,891872,Cuomo; Raphael Eduardo,9999,0,9999,0
1746533232541,CLRE 297,001,891888,Cuomo; Raphael Eduardo,9999,0,9999,0
1746533233567,CSE 191,A00,958773,Minnes Kemp; Mor Mia,9996,0,9999,3
1746533234594,CSE 197,001,959846,Minnes Kemp; Mor Mia,9993,0,9999,6
1746533235621,CSS 201S,A01,892054,Mignozzetti; Umberto,26,0,30,4
1746533236647,CSS 202S,A01,892056,Mignozzetti; Umberto,26,0,30,4
1746533237675,DSC 197,001,956898,Eldridge; Justin Matthew,9998,0,9999,1
1746533238700,DSC 297,001,958000,Mazumdar; Arya,9998,0,9999,1
1746533238700,DSC 297,002,959862,Wang; Yusu,9999,0,9999,0
1746533239726,EAP 100,A00,905686,Staff,9778,0,9999,221
1746533240756,ECE 45,A01,892618,Staff,0,0,65,65
1746533242809,ECE 111,A01,892719,Staff,4,0,65,61
1746533243837,ECE 197,001,957920,Mercier; Patrick Philip,9991,0,9999,8
1746533244868,ECON 178,A01,907814,Zhu; Ying,26,0,35,9
1746533245895,EDS 115,A00,895312,Staff,36,0,45,9
1746533246922,EDS 117,A01,895337,Staff,24,0,30,6
1746533247951,EDS 125,A00,895341,Jones; Gabrielle Anastasia,37,0,45,8
1746533248978,EDS 128A,A01,895459,Fargason; Sharon Gayle,44,0,45,1
1746533250006,EDS 128B,A01,895543,Pappas; Elizabeth,44,0,45,1
1746533251033,EDS 139,A00,897203,Pappas; Elizabeth,44,0,45,1
1746533251033,EDS 139,B00,897209,Fargason; Sharon Gayle,41,0,45,4
1746533252062,EDS 201,A00,895545,Staff,23,0,45,22
1746533253088,EDS 203,A01,895581,Halter; Christopher P.,23,0,45,22
1746533254116,EDS 204R,A01,895625,Heinzman; Erica M.,39,0,45,6
1746533254116,EDS 204R,B01,895693,Halter; Christopher P.,10,0,45,35
1746533255144,EDS 206R,A00,895694,Fargason; Sharon Gayle,1,0,30,29
1746533255144,EDS 206R,B00,895695,Choi; Bailey Miyeon,16,0,30,14
1746533256171,EDS 250,A00,895697,Hemans; Patricia Ann Benitez,23,0,45,22
1746533257195,EDS 281,A00,895701,Meyerott; Theresa Ann,1,0,15,14
1746533258222,EDS 284,A00,895736,Meyerott; Theresa Ann,1,0,15,14
1746533259253,EDS 286,A00,897210,Fine; Sarah,0,0,15,15
1746533260277,EDS 289C,A01,895770,Daly; Alan J.,15,0,15,0
1746533261304,EDS 290,A00,897211,Hofstetter; Carolyn,0,0,15,15
1746533262332,LIGM 5A,A00,896162,Fischer-Grunski; Eva K,13,0,20,7
1746533263357,LIGM 5B,A00,896260,Fischer-Grunski; Eva K,17,0,20,3
1746533264387,LIGM 5C,A00,896308,Fischer-Grunski; Eva K,18,0,20,2
1746533265419,LIIT 5AS,A00,896313,Carnelos; Chiara,18,0,20,2
1746533266446,LIIT 5BS,A00,896416,Carnelos; Chiara,20,0,20,0
1746533267475,LIIT 5CS,A00,896564,Carnelos; Chiara,20,0,20,0
1746533268503,LISP 5A,A00,896588,Munoz Sanchez; Alicia,3,0,20,17
1746533269530,LISP 5B,A00,896653,Munoz Sanchez; Alicia,7,0,20,13
1746533270555,LISP 5C,A00,896655,Munoz Sanchez; Alicia,0,1,20,20
1746533271585,MAE 197,001,957918,Kleissl; Jan,9996,0,9999,3
1746533271585,MAE 197,002,959806,Boechler; Nicholas Sebastia,9998,0,9999,1
1746533271585,MAE 197,003,959852,Mullin; Jennifer S,9999,0,9999,0
1746533272611,MATH 2,A01,957937,Staff,33,0,35,2
1746533273638,MATH 197,001,957876,Kedlaya; Kiran S.,9993,0,9999,6
1746533274668,MCWP 40,A00,892729,Duru; Nur,10,0,20,10
1746533274668,MCWP 40,B00,893304,Montejo; Carolina,14,0,20,6
1746533275694,MCWP 40R,A00,893757,Redela; Pamela Morgan,0,5,20,20
1746533276720,MCWP 50,A00,893758,Morshed; Michael James,0,0,20,20
1746533276720,MCWP 50,B00,893761,Bartulis; Jason Michael,17,0,20,3
1746533277745,MCWP 50R,A00,893766,Compas; Sean Matthew,0,1,20,20
1746533277745,MCWP 50R,B00,893769,Carter; Jennifer A,0,1,20,20
1746533277745,MCWP 50R,C00,893771,Krone; Jarret,0,3,20,20
1746533277745,MCWP 50R,D00,893772,Miller; Elizabeth Deen,0,0,20,20
1746533277745,MCWP 50R,E00,893775,Carter; Andrea L,0,1,20,20
1746533278772,MMW 11R,A01,892721,Herbst; Matthew,11,0,27,16
1746533278772,MMW 11R,A02,892722,Herbst; Matthew,0,0,0,3
1746533279798,MMW 12R,A01,892724,Herbst; Matthew,0,11,16,16
1746533279798,MMW 12R,A02,892725,Herbst; Matthew,0,10,16,16
1746533280825,MMW 13R,A01,892727,Staff,0,4,16,16
1746533280825,MMW 13R,A02,892728,Staff,0,4,16,16
1746533280825,MMW 13R,A03,958032,Staff,0,4,16,16
1746533280825,MMW 13R,A04,958033,Staff,0,4,16,16
1746533280825,MMW 13R,A05,958034,Staff,0,4,16,16
1746533281854,SIO 295LS,A00,894015,Staff,5,0,25,20
1746533282879,SIO 295S,A00,894020,Staff,5,0,25,20
1746533283910,SIOC 290S,B01,958918,Merrifield; Mark A,14,0,30,16
1746533284944,SIOC 291S,B01,958922,Gabriel; Corey John,14,0,30,16
1746533285970,SOCI 117,A01,895339,Staff,3,0,5,2
1746533286997,WES 237B,A00,894149,Staff,11,0,20,9
1746533289063,AESE 279B,A00,891859,Staff,13,0,35,22
1746533290089,AIP 197,001,891854,Vespa; Emanuel Ignacio,9999,0,9999,0
1746533291117,ANTH 289S,A00,891856,Gagneux; Pascal,12,0,12,0
1746533292144,BENG 196,001,957946,Engler; Adam J.,9996,0,9999,3
1746533293174,BISP 197,001,959851,Wilhelm; James E.,9999,0,9999,0
1746533294202,CAT 124RS,A01,956906,Staff,6,0,25,19
1746533295230,CAT 125RS,A01,922013,Staff,6,0,25,19
1746533296256,CLRE 250,A00,891860,Morris; Sheldon,9995,0,9999,4
1746533298310,CLRE 251R,A00,907817,Mehta; Ravindra L.,9994,0,9999,5
1746533299340,CLRE 252,A00,891864,Cuomo; Raphael Eduardo,9993,0,9999,6
1746533300370,CLRE 253,A00,891867,Vaida; Florin,9994,0,9999,5
1746533300370,CLRE 253,B00,907819,Staff,9999,0,9999,0
1746533301399,CLRE 259,A00,891868,Patel; Hemal,9998,0,9999,1
1746533302427,CLRE 260,A00,891872,Cuomo; Raphael Eduardo,9999,0,9999,0
1746533303453,CLRE 297,001,891888,Cuomo; Raphael Eduardo,9999,0,9999,0
1746533304483,CSE 191,A00,958773,Minnes Kemp; Mor Mia,9996,0,9999,3
1746533305509,CSE 197,001,959846,Minnes Kemp; Mor Mia,9993,0,9999,6
1746533306538,CSS 201S,A01,892054,Mignozzetti; Umberto,26,0,30,4
1746533307564,CSS 202S,A01,892056,Mignozzetti; Umberto,26,0,30,4
1746533308594,DSC 197,001,956898,Eldridge; Justin Matthew,9998,0,9999,1
1746533309622,DSC 297,001,958000,Mazumdar; Arya,9998,0,9999,1
1746533309622,DSC 297,002,959862,Wang; Yusu,9999,0,9999,0
1746533310647,EAP 100,A00,905686,Staff,9778,0,9999,221
1746533311676,ECE 45,A01,892618,Staff,0,0,65,65
1746533313729,ECE 111,A01,892719,Staff,4,0,65,61
1746533314757,ECE 197,001,957920,Mercier; Patrick Philip,9991,0,9999,8
1746533315787,ECON 178,A01,907814,Zhu; Ying,26,0,35,9
1746533316816,EDS 115,A00,895312,Staff,36,0,45,9
1746533317843,EDS 117,A01,895337,Staff,24,0,30,6
1746533318873,EDS 125,A00,895341,Jones; Gabrielle Anastasia,37,0,45,8
1746533319901,EDS 128A,A01,895459,Fargason; Sharon Gayle,44,0,45,1
1746533320927,EDS 128B,A01,895543,Pappas; Elizabeth,44,0,45,1
1746533321954,EDS 139,A00,897203,Pappas; Elizabeth,44,0,45,1
1746533321954,EDS 139,B00,897209,Fargason; Sharon Gayle,41,0,45,4
1746533322988,EDS 201,A00,895545,Staff,23,0,45,22
1746533324018,EDS 203,A01,895581,Halter; Christopher P.,23,0,45,22
1746533325046,EDS 204R,A01,895625,Heinzman; Erica M.,39,0,45,6
1746533325046,EDS 204R,B01,895693,Halter; Christopher P.,10,0,45,35
1746533326076,EDS 206R,A00,895694,Fargason; Sharon Gayle,1,0,30,29
1746533326076,EDS 206R,B00,895695,Choi; Bailey Miyeon,16,0,30,14
1746533327106,EDS 250,A00,895697,Hemans; Patricia Ann Benitez,23,0,45,22
1746533328136,EDS 281,A00,895701,Meyerott; Theresa Ann,1,0,15,14
1746533329165,EDS 284,A00,895736,Meyerott; Theresa Ann,1,0,15,14
1746533330191,EDS 286,A00,897210,Fine; Sarah,0,0,15,15
1746533331220,EDS 289C,A01,895770,Daly; Alan J.,15,0,15,0
1746533332248,EDS 290,A00,897211,Hofstetter; Carolyn,0,0,15,15
1746533333277,LIGM 5A,A00,896162,Fischer-Grunski; Eva K,13,0,20,7
1746533334304,LIGM 5B,A00,896260,Fischer-Grunski; Eva K,17,0,20,3
1746533335335,LIGM 5C,A00,896308,Fischer-Grunski; Eva K,18,0,20,2
1746533336365,LIIT 5AS,A00,896313,Carnelos; Chiara,18,0,20,2
1746533337392,LIIT 5BS,A00,896416,Carnelos; Chiara,20,0,20,0
1746533338420,LIIT 5CS,A00,896564,Carnelos; Chiara,20,0,20,0
1746533339452,LISP 5A,A00,896588,Munoz Sanchez; Alicia,3,0,20,17
1746533340484,LISP 5B,A00,896653,Munoz Sanchez; Alicia,7,0,20,13
1746533341510,LISP 5C,A00,896655,Munoz Sanchez; Alicia,0,1,20,20
1746533342537,MAE 197,001,957918,Kleissl; Jan,9996,0,9999,3
1746533342537,MAE 197,002,959806,Boechler; Nicholas Sebastia,9998,0,9999,1
1746533342537,MAE 197,003,959852,Mullin; Jennifer S,9999,0,9999,0
1746533343566,MATH 2,A01,957937,Staff,33,0,35,2
1746533344593,MATH 197,001,957876,Kedlaya; Kiran S.,9993,0,9999,6
1746533345623,MCWP 40,A00,892729,Duru; Nur,10,0,20,10
1746533345623,MCWP 40,B00,893304,Montejo; Carolina,14,0,20,6
1746533346649,MCWP 40R,A00,893757,Redela; Pamela Morgan,0,5,20,20
1746533347681,MCWP 50,A00,893758,Morshed; Michael James,0,0,20,20
1746533347681,MCWP 50,B00,893761,Bartulis; Jason Michael,17,0,20,3
1746533348711,MCWP 50R,A00,893766,Compas; Sean Matthew,0,1,20,20
1746533348711,MCWP 50R,B00,893769,Carter; Jennifer A,0,1,20,20
1746533348711,MCWP 50R,C00,893771,Krone; Jarret,0,3,20,20
1746533348711,MCWP 50R,D00,893772,Miller; Elizabeth Deen,0,0,20,20
1746533348711,MCWP 50R,E00,893775,Carter; Andrea L,0,1,20,20
1746533349738,MMW 11R,A01,892721,Herbst; Matthew,11,0,27,16
1746533349738,MMW 11R,A02,892722,Herbst; Matthew,0,0,0,3
1746533350766,MMW 12R,A01,892724,Herbst; Matthew,0,11,16,16
1746533350766,MMW 12R,A02,892725,Herbst; Matthew,0,10,16,16
1746533351793,MMW 13R,A01,892727,Staff,0,4,16,16
1746533351793,MMW 13R,A02,892728,Staff,0,4,16,16
1746533351793,MMW 13R,A03,958032,Staff,0,4,16,16
1746533351793,MMW 13R,A04,958033,Staff,0,4,16,16
1746533351793,MMW 13R,A05,958034,Staff,0,4,16,16
1746533352822,SIO 295LS,A00,894015,Staff,5,0,25,20
1746533353852,SIO 295S,A00,894020,Staff,5,0,25,20
1746533354883,SIOC 290S,B01,958918,Merrifield; Mark A,14,0,30,16
1746533355914,SIOC 291S,B01,958922,Gabriel; Corey John,14,0,30,16
1746533356942,SOCI 117,A01,895339,Staff,3,0,5,2
1746533357967,WES 237B,A00,894149,Staff,11,0,20,9
1746533360051,AESE 279B,A00,891859,Staff,13,0,35,22
1746533361080,AIP 197,001,891854,Vespa; Emanuel Ignacio,9999,0,9999,0
1746533362106,ANTH 289S,A00,891856,Gagneux; Pascal,12,0,12,0
1746533363131,BENG 196,001,957946,Engler; Adam J.,9996,0,9999,3
1746533364160,BISP 197,001,959851,Wilhelm; James E.,9999,0,9999,0
1746533365189,CAT 124RS,A01,956906,Staff,6,0,25,19
1746533366216,CAT 125RS,A01,922013,Staff,6,0,25,19
1746533367247,CLRE 250,A00,891860,Morris; Sheldon,9995,0,9999,4
1746533369302,CLRE 251R,A00,907817,Mehta; Ravindra L.,9994,0,9999,5
1746533370328,CLRE 252,A00,891864,Cuomo; Raphael Eduardo,9993,0,9999,6
1746533371355,CLRE 253,A00,891867,Vaida; Florin,9994,0,9999,5
1746533371355,CLRE 253,B00,907819,Staff,9999,0,9999,0
1746533372384,CLRE 259,A00,891868,Patel; Hemal,9998,0,9999,1
1746533373415,CLRE 260,A00,891872,Cuomo; Raphael Eduardo,9999,0,9999,0
1746533374439,CLRE 297,001,891888,Cuomo; Raphael Eduardo,9999,0,9999,0
1746533375470,CSE 191,A00,958773,Minnes Kemp; Mor Mia,9996,0,9999,3
1746533376498,CSE 197,001,959846,Minnes Kemp; Mor Mia,9993,0,9999,6
1746533377527,CSS 201S,A01,892054,Mignozzetti; Umberto,26,0,30,4
1746533378554,CSS 202S,A01,892056,Mignozzetti; Umberto,26,0,30,4
1746533379580,DSC 197,001,956898,Eldridge; Justin Matthew,9998,0,9999,1
1746533380607,DSC 297,001,958000,Mazumdar; Arya,9998,0,9999,1
1746533380607,DSC 297,002,959862,Wang; Yusu,9999,0,9999,0
1746533381634,EAP 100,A00,905686,Staff,9778,0,9999,221
1746533382664,ECE 45,A01,892618,Staff,0,0,65,65
1746533384721,ECE 111,A01,892719,Staff,4,0,65,61
1746533385748,ECE 197,001,957920,Mercier; Patrick Philip,9991,0,9999,8
1746533386777,ECON 178,A01,907814,Zhu; Ying,26,0,35,9
1746533387804,EDS 115,A00,895312,Staff,36,0,45,9
1746533388831,EDS 117,A01,895337,Staff,24,0,30,6
1746533389858,EDS 125,A00,895341,Jones; Gabrielle Anastasia,37,0,45,8
1746533390885,EDS 128A,A01,895459,Fargason; Sharon Gayle,44,0,45,1
1746533391914,EDS 128B,A01,895543,Pappas; Elizabeth,44,0,45,1
1746533392941,EDS 139,A00,897203,Pappas; Elizabeth,44,0,45,1
1746533392941,EDS 139,B00,897209,Fargason; Sharon Gayle,41,0,45,4
1746533393968,EDS 201,A00,895545,Staff,23,0,45,22
1746533395000,EDS 203,A01,895581,Halter; Christopher P.,23,0,45,22
1746533396029,EDS 204R,A01,895625,Heinzman; Erica M.,39,0,45,6
1746533396029,EDS 204R,B01,895693,Halter; Christopher P.,10,0,45,35
1746533397056,EDS 206R,A00,895694,Fargason; Sharon Gayle,1,0,30,29
1746533397056,EDS 206R,B00,895695,Choi; Bailey Miyeon,16,0,30,14
1746533398082,EDS 250,A00,895697,Hemans; Patricia Ann Benitez,23,0,45,22
1746533399108,EDS 281,A00,895701,Meyerott; Theresa Ann,1,0,15,14
1746533400136,EDS 284,A00,895736,Meyerott; Theresa Ann,1,0,15,14
1746533401168,EDS 286,A00,897210,Fine; Sarah,0,0,15,15
1746533402195,EDS 289C,A01,895770,Daly; Alan J.,15,0,15,0
1746533403225,EDS 290,A00,897211,Hofstetter; Carolyn,0,0,15,15
1746533404256,LIGM 5A,A00,896162,Fischer-Grunski; Eva K,13,0,20,7
1746533405285,LIGM 5B,A00,896260,Fischer-Grunski; Eva K,17,0,20,3
1746533406315,LIGM 5C,A00,896308,Fischer-Grunski; Eva K,18,0,20,2
1746533407341,LIIT 5AS,A00,896313,Carnelos; Chiara,18,0,20,2
1746533408368,LIIT 5BS,A00,896416,Carnelos; Chiara,20,0,20,0
1746533409399,LIIT 5CS,A00,896564,Carnelos; Chiara,20,0,20,0
1746533410425,LISP 5A,A00,896588,Munoz Sanchez; Alicia,3,0,20,17
1746533411449,LISP 5B,A00,896653,Munoz Sanchez; Alicia,7,0,20,13
1746533412478,LISP 5C,A00,896655,Munoz Sanchez; Alicia,0,1,20,20
1746533413503,MAE 197,001,957918,Kleissl; Jan,9996,0,9999,3
1746533413503,MAE 197,002,959806,Boechler; Nicholas Sebastia,9998,0,9999,1
1746533413503,MAE 197,003,959852,Mullin; Jennifer S,9999,0,9999,0
1746533414529,MATH 2,A01,957937,Staff,33,0,35,2
1746533415557,MATH 197,001,957876,Kedlaya; Kiran S.,9993,0,9999,6
1746533416589,MCWP 40,A00,892729,Duru; Nur,10,0,20,10
1746533416589,MCWP 40,B00,893304,Montejo; Carolina,14,0,20,6
1746533417616,MCWP 40R,A00,893757,Redela; Pamela Morgan,0,5,20,20
1746533418643,MCWP 50,A00,893758,Morshed; Michael James,0,0,20,20
1746533418643,MCWP 50,B00,893761,Bartulis; Jason Michael,17,0,20,3
1746533419669,MCWP 50R,A00,893766,Compas; Sean Matthew,0,1,20,20
1746533419669,MCWP 50R,B00,893769,Carter; Jennifer A,0,1,20,20
1746533419669,MCWP 50R,C00,893771,Krone; Jarret,0,3,20,20
1746533419669,MCWP 50R,D00,893772,Miller; Elizabeth Deen,0,0,20,20
1746533419669,MCWP 50R,E00,893775,Carter; Andrea L,0,1,20,20
1746533420696,MMW 11R,A01,892721,Herbst; Matthew,11,0,27,16
1746533420696,MMW 11R,A02,892722,Herbst; Matthew,0,0,0,3
1746533421723,MMW 12R,A01,892724,Herbst; Matthew,0,11,16,16
1746533421723,MMW 12R,A02,892725,Herbst; Matthew,0,10,16,16
1746533422751,MMW 13R,A01,892727,Staff,0,4,16,16
1746533422751,MMW 13R,A02,892728,Staff,0,4,16,16
1746533422751,MMW 13R,A03,958032,Staff,0,4,16,16
1746533422751,MMW 13R,A04,958033,Staff,0,4,16,16
1746533422751,MMW 13R,A05,958034,Staff,0,4,16,16
1746533423777,SIO 295LS,A00,894015,Staff,5,0,25,20
1746533424807,SIO 295S,A00,894020,Staff,5,0,25,20
1746533425834,SIOC 290S,B01,958918,Merrifield; Mark A,14,0,30,16
1746533426861,SIOC 291S,B01,958922,Gabriel; Corey John,14,0,30,16
1746533427886,SOCI 117,A01,895339,Staff,3,0,5,2
1746533428912,WES 237B,A00,894149,Staff,11,0,20,9
1746533430996,AESE 279B,A00,891859,Staff,13,0,35,22
1746533432021,AIP 197,001,891854,Vespa; Emanuel Ignacio,9999,0,9999,0
1746533433047,ANTH 289S,A00,891856,Gagneux; Pascal,12,0,12,0
1746533434073,BENG 196,001,957946,Engler; Adam J.,9996,0,9999,3
1746533435097,BISP 197,001,959851,Wilhelm; James E.,9999,0,9999,0
1746533436126,CAT 124RS,A01,956906,Staff,6,0,25,19
1746533437152,CAT 125RS,A01,922013,Staff,6,0,25,19
1746533438176,CLRE 250,A00,891860,Morris; Sheldon,9995,0,9999,4
1746533440235,CLRE 251R,A00,907817,Mehta; Ravindra L.,9994,0,9999,5
1746533441260,CLRE 252,A00,891864,Cuomo; Raphael Eduardo,9993,0,9999,6
1746533442289,CLRE 253,A00,891867,Vaida; Florin,9994,0,9999,5
1746533442289,CLRE 253,B00,907819,Staff,9999,0,9999,0
1746533443315,CLRE 259,A00,891868,Patel; Hemal,9998,0,9999,1
1746533444345,CLRE 260,A00,891872,Cuomo; Raphael Eduardo,9999,0,9999,0
1746533445369,CLRE 297,001,891888,Cuomo; Raphael Eduardo,9999,0,9999,0
1746533446398,CSE 191,A00,958773,Minnes Kemp; Mor Mia,9996,0,9999,3
1746533447427,CSE 197,001,959846,Minnes Kemp; Mor Mia,9993,0,9999,6
1746533448456,CSS 201S,A01,892054,Mignozzetti; Umberto,26,0,30,4
1746533449486,CSS 202S,A01,892056,Mignozzetti; Umberto,26,0,30,4
1746533450513,DSC 197,001,956898,Eldridge; Justin Matthew,9998,0,9999,1
1746533451541,DSC 297,001,958000,Mazumdar; Arya,9998,0,9999,1
1746533451541,DSC 297,002,959862,Wang; Yusu,9999,0,9999,0
1746533452567,EAP 100,A00,905686,Staff,9778,0,9999,221
1746533453594,ECE 45,A01,892618,Staff,0,0,65,65
1746533455650,ECE 111,A01,892719,Staff,4,0,65,61
1746533456675,ECE 197,001,957920,Mercier; Patrick Philip,9991,0,9999,8
1746533457702,ECON 178,A01,907814,Zhu; Ying,26,0,35,9
1746533458732,EDS 115,A00,895312,Staff,36,0,45,9
1746533459765,EDS 117,A01,895337,Staff,24,0,30,6
1746533460795,EDS 125,A00,895341,Jones; Gabrielle Anastasia,37,0,45,8
1746533461824,EDS 128A,A01,895459,Fargason; Sharon Gayle,44,0,45,1
1746533462854,EDS 128B,A01,895543,Pappas; Elizabeth,44,0,45,1
1746533463885,EDS 139,A00,897203,Pappas; Elizabeth,44,0,45,1
1746533463885,EDS 139,B00,897209,Fargason; Sharon Gayle,41,0,45,4
1746533464913,EDS 201,A00,895545,Staff,23,0,45,22
1746533465939,EDS 203,A01,895581,Halter; Christopher P.,23,0,45,22
1746533466970,EDS 204R,A01,895625,Heinzman; Erica M.,39,0,45,6
1746533466970,EDS 204R,B01,895693,Halter; Christopher P.,10,0,45,35
1746533467998,EDS 206R,A00,895694,Fargason; Sharon Gayle,1,0,30,29
1746533467998,EDS 206R,B00,895695,Choi; Bailey Miyeon,16,0,30,14
1746533469025,EDS 250,A00,895697,Hemans; Patricia Ann Benitez,23,0,45,22
1746533470055,EDS 281,A00,895701,Meyerott; Theresa Ann,1,0,15,14
1746533471083,EDS 284,A00,895736,Meyerott; Theresa Ann,1,0,15,14
1746533472112,EDS 286,A00,897210,Fine; Sarah,0,0,15,15
1746533473141,EDS 289C,A01,895770,Daly; Alan J.,15,0,15,0
1746533474171,EDS 290,A00,897211,Hofstetter; Carolyn,0,0,15,15
1746533475203,LIGM 5A,A00,896162,Fischer-Grunski; Eva K,13,0,20,7
1746533476229,LIGM 5B,A00,896260,Fischer-Grunski; Eva K,17,0,20,3
1746533477259,LIGM 5C,A00,896308,Fischer-Grunski; Eva K,18,0,20,2
1746533478287,LIIT 5AS,A00,896313,Carnelos; Chiara,18,0,20,2
1746533479314,LIIT 5BS,A00,896416,Carnelos; Chiara,20,0,20,0
1746533480343,LIIT 5CS,A00,896564,Carnelos; Chiara,20,0,20,0
1746533481373,LISP 5A,A00,896588,Munoz Sanchez; Alicia,3,0,20,17
1746533482412,LISP 5B,A00,896653,Munoz Sanchez; Alicia,7,0,20,13
1746533483442,LISP 5C,A00,896655,Munoz Sanchez; Alicia,0,1,20,20
1746533484473,MAE 197,001,957918,Kleissl; Jan,9996,0,9999,3
1746533484473,MAE 197,002,959806,Boechler; Nicholas Sebastia,9998,0,9999,1
1746533484473,MAE 197,003,959852,Mullin; Jennifer S,9999,0,9999,0
1746533485505,MATH 2,A01,957937,Staff,33,0,35,2
1746533486534,MATH 197,001,957876,Kedlaya; Kiran S.,9993,0,9999,6
1746533487562,MCWP 40,A00,892729,Duru; Nur,10,0,20,10
1746533487562,MCWP 40,B00,893304,Montejo; Carolina,14,0,20,6
1746533488589,MCWP 40R,A00,893757,Redela; Pamela Morgan,0,5,20,20
1746533489617,MCWP 50,A00,893758,Morshed; Michael James,0,0,20,20
1746533489617,MCWP 50,B00,893761,Bartulis; Jason Michael,17,0,20,3
1746533490650,MCWP 50R,A00,893766,Compas; Sean Matthew,0,1,20,20
1746533490650,MCWP 50R,B00,893769,Carter; Jennifer A,0,1,20,20
1746533490650,MCWP 50R,C00,893771,Krone; Jarret,0,3,20,20
1746533490650,MCWP 50R,D00,893772,Miller; Elizabeth Deen,0,0,20,20
1746533490650,MCWP 50R,E00,893775,Carter; Andrea L,0,1,20,20
1746533491676,MMW 11R,A01,892721,Herbst; Matthew,11,0,27,16
1746533491676,MMW 11R,A02,892722,Herbst; Matthew,0,0,0,3
1746533492702,MMW 12R,A01,892724,Herbst; Matthew,0,11,16,16
1746533492702,MMW 12R,A02,892725,Herbst; Matthew,0,10,16,16
1746533493729,MMW 13R,A01,892727,Staff,0,4,16,16
1746533493729,MMW 13R,A02,892728,Staff,0,4,16,16
1746533493729,MMW 13R,A03,958032,Staff,0,4,16,16
1746533493729,MMW 13R,A04,958033,Staff,0,4,16,16
1746533493729,MMW 13R,A05,958034,Staff,0,4,16,16
1746533494754,SIO 295LS,A00,894015,Staff,5,0,25,20
1746533495779,SIO 295S,A00,894020,Staff,5,0,25,20
1746533496806,SIOC 290S,B01,958918,Merrifield; Mark A,14,0,30,16
1746533497842,SIOC 291S,B01,958922,Gabriel; Corey John,14,0,30,16
1746533498874,SOCI 117,A01,895339,Staff,3,0,5,2
1746533499901,WES 237B,A00,894149,Staff,11,0,20,9
1746533501987,AESE 279B,A00,891859,Staff,13,0,35,22
1746533503014,AIP 197,001,891854,Vespa; Emanuel Ignacio,9999,0,9999,0
1746533504039,ANTH 289S,A00,891856,Gagneux; Pascal,12,0,12,0
1746533505067,BENG 196,001,957946,Engler; Adam J.,9996,0,9999,3
1746533506097,BISP 197,001,959851,Wilhelm; James E.,9999,0,9999,0
1746533507126,CAT 124RS,A01,956906,Staff,6,0,25,19
1746533508152,CAT 125RS,A01,922013,Staff,6,0,25,19
1746533509180,CLRE 250,A00,891860,Morris; Sheldon,9995,0,9999,4
1746533511235,CLRE 251R,A00,907817,Mehta; Ravindra L.,9994,0,9999,5
1746533512261,CLRE 252,A00,891864,Cuomo; Raphael Eduardo,9993,0,9999,6
1746533513285,CLRE 253,A00,891867,Vaida; Florin,9994,0,9999,5
1746533513285,CLRE 253,B00,907819,Staff,9999,0,9999,0
1746533514310,CLRE 259,A00,891868,Patel; Hemal,9998,0,9999,1
1746533515336,CLRE 260,A00,891872,Cuomo; Raphael Eduardo,9999,0,9999,0
1746533516363,CLRE 297,001,891888,Cuomo; Raphael Eduardo,9999,0,9999,0
1746533517391,CSE 191,A00,958773,Minnes Kemp; Mor Mia,9996,0,9999,3
1746533518419,CSE 197,001,959846,Minnes Kemp; Mor Mia,9993,0,9999,6
1746533519446,CSS 201S,A01,892054,Mignozzetti; Umberto,26,0,30,4
1746533520472,CSS 202S,A01,892056,Mignozzetti; Umberto,26,0,30,4
1746533521499,DSC 197,001,956898,Eldridge; Justin Matthew,9998,0,9999,1
1746533522528,DSC 297,001,958000,Mazumdar; Arya,9998,0,9999,1
1746533522528,DSC 297,002,959862,Wang; Yusu,9999,0,9999,0
1746533523553,EAP 100,A00,905686,Staff,9778,0,9999,221
1746533524583,ECE 45,A01,892618,Staff,0,0,65,65
1746533526633,ECE 111,A01,892719,Staff,4,0,65,61
1746533527661,ECE 197,001,957920,Mercier; Patrick Philip,9991,0,9999,8
1746533528690,ECON 178,A01,907814,Zhu; Ying,26,0,35,9
1746533529716,EDS 115,A00,895312,Staff,36,0,45,9
1746533530742,EDS 117,A01,895337,Staff,24,0,30,6
1746533531769,EDS 125,A00,895341,Jones; Gabrielle Anastasia,37,0,45,8
1746533532799,EDS 128A,A01,895459,Fargason; Sharon Gayle,44,0,45,1
1746533533828,EDS 128B,A01,895543,Pappas; Elizabeth,44,0,45,1
1746533534857,EDS 139,A00,897203,Pappas; Elizabeth,44,0,45,1
1746533534857,EDS 139,B00,897209,Fargason; Sharon Gayle,41,0,45,4
1746533535886,EDS 201,A00,895545,Staff,23,0,45,22
1746533536916,EDS 203,A01,895581,Halter; Christopher P.,23,0,45,22
1746533537946,EDS 204R,A01,895625,Heinzman; Erica M.,39,0,45,6
1746533537946,EDS 204R,B01,895693,Halter; Christopher P.,10,0,45,35
1746533538972,EDS 206R,A00,895694,Fargason; Sharon Gayle,1,0,30,29
1746533538972,EDS 206R,B00,895695,Choi; Bailey Miyeon,16,0,30,14
1746533539999,EDS 250,A00,895697,Hemans; Patricia Ann Benitez,23,0,45,22
1746533541027,EDS 281,A00,895701,Meyerott; Theresa Ann,1,0,15,14
1746533542054,EDS 284,A00,895736,Meyerott; Theresa Ann,1,0,15,14
1746533543084,EDS 286,A00,897210,Fine; Sarah,0,0,15,15
1746533544111,EDS 289C,A01,895770,Daly; Alan J.,15,0,15,0
1746533545139,EDS 290,A00,897211,Hofstetter; Carolyn,0,0,15,15
1746533546165,LIGM 5A,A00,896162,Fischer-Grunski; Eva K,13,0,20,7
1746533547196,LIGM 5B,A00,896260,Fischer-Grunski; Eva K,17,0,20,3
1746533548222,LIGM 5C,A00,896308,Fischer-Grunski; Eva K,18,0,20,2
1746533549248,LIIT 5AS,A00,896313,Carnelos; Chiara,18,0,20,2
1746533550276,LIIT 5BS,A00,896416,Carnelos; Chiara,20,0,20,0
1746533551304,LIIT 5CS,A00,896564,Carnelos; Chiara,20,0,20,0
1746533552329,LISP 5A,A00,896588,Munoz Sanchez; Alicia,3,0,20,17
1746533553361,LISP 5B,A00,896653,Munoz Sanchez; Alicia,7,0,20,13
1746533554386,LISP 5C,A00,896655,Munoz Sanchez; Alicia,0,1,20,20
1746533555417,MAE 197,001,957918,Kleissl; Jan,9996,0,9999,3
1746533555417,MAE 197,002,959806,Boechler; Nicholas Sebastia,9998,0,9999,1
1746533555417,MAE 197,003,959852,Mullin; Jennifer S,9999,0,9999,0
1746533556446,MATH 2,A01,957937,Staff,33,0,35,2
1746533557473,MATH 197,001,957876,Kedlaya; Kiran S.,9993,0,9999,6
1746533558504,MCWP 40,A00,892729,Duru; Nur,10,0,20,10
1746533558504,MCWP 40,B00,893304,Montejo; Carolina,14,0,20,6
1746533559532,MCWP 40R,A00,893757,Redela; Pamela Morgan,0,5,20,20
1746533560564,MCWP 50,A00,893758,Morshed; Michael James,0,0,20,20
1746533560564,MCWP 50,B00,893761,Bartulis; Jason Michael,17,0,20,3
1746533561591,MCWP 50R,A00,893766,Compas; Sean Matthew,0,1,20,20
1746533561591,MCWP 50R,B00,893769,Carter; Jennifer A,0,1,20,20
1746533561591,MCWP 50R,C00,893771,Krone; Jarret,0,3,20,20
1746533561591,MCWP 50R,D00,893772,Miller; Elizabeth Deen,0,0,20,20
1746533561591,MCWP 50R,E00,893775,Carter; Andrea L,0,1,20,20
1746533562618,MMW 11R,A01,892721,Herbst; Matthew,11,0,27,16
1746533562618,MMW 11R,A02,892722,Herbst; Matthew,0,0,0,3
1746533563648,MMW 12R,A01,892724,Herbst; Matthew,0,11,16,16
1746533563648,MMW 12R,A02,892725,Herbst; Matthew,0,10,16,16
1746533564679,MMW 13R,A01,892727,Staff,0,4,16,16
1746533564679,MMW 13R,A02,892728,Staff,0,4,16,16
1746533564679,MMW 13R,A03,958032,Staff,0,4,16,16
1746533564679,MMW 13R,A04,958033,Staff,0,4,16,16
1746533564679,MMW 13R,A05,958034,Staff,0,4,16,16
1746533565707,SIO 295LS,A00,894015,Staff,5,0,25,20
1746533566734,SIO 295S,A00,894020,Staff,5,0,25,20
1746533567765,SIOC 290S,B01,958918,Merrifield; Mark A,14,0,30,16
1746533568793,SIOC 291S,B01,958922,Gabriel; Corey John,14,0,30,16
1746533569822,SOCI 117,A01,895339,Staff,3,0,5,2
1746533570850,WES 237B,A00,894149,Staff,11,0,20,9
1746533572930,AESE 279B,A00,891859,Staff,13,0,35,22
1746533573958,AIP 197,001,891854,Vespa; Emanuel Ignacio,9999,0,9999,0
1746533574986,ANTH 289S,A00,891856,Gagneux; Pascal,12,0,12,0
1746533576012,BENG 196,001,957946,Engler; Adam J.,9996,0,9999,3
1746533577039,BISP 197,001,959851,Wilhelm; James E.,9999,0,9999,0
1746533578065,CAT 124RS,A01,956906,Staff,6,0,25,19
1746533579093,CAT 125RS,A01,922013,Staff,6,0,25,19
1746533580120,CLRE 250,A00,891860,Morris; Sheldon,9995,0,9999,4
1746533582178,CLRE 251R,A00,907817,Mehta; Ravindra L.,9994,0,9999,5
1746533583208,CLRE 252,A00,891864,Cuomo; Raphael Eduardo,9993,0,9999,6
1746533584233,CLRE 253,A00,891867,Vaida; Florin,9994,0,9999,5
1746533584233,CLRE 253,B00,907819,Staff,9999,0,9999,0
1746533585258,CLRE 259,A00,891868,Patel; Hemal,9998,0,9999,1
1746533586284,CLRE 260,A00,891872,Cuomo; Raphael Eduardo,9999,0,9999,0
1746533587309,CLRE 297,001,891888,Cuomo; Raphael Eduardo,9999,0,9999,0
1746533588337,CSE 191,A00,958773,Minnes Kemp; Mor Mia,9996,0,9999,3
1746533589364,CSE 197,001,959846,Minnes Kemp; Mor Mia,9993,0,9999,6
1746533590391,CSS 201S,A01,892054,Mignozzetti; Umberto,26,0,30,4
1746533591423,CSS 202S,A01,892056,Mignozzetti; Umberto,26,0,30,4
1746533592452,DSC 197,001,956898,Eldridge; Justin Matthew,9998,0,9999,1
1746533593480,DSC 297,001,958000,Mazumdar; Arya,9998,0,9999,1
1746533593480,DSC 297,002,959862,Wang; Yusu,9999,0,9999,0
1746533594505,EAP 100,A00,905686,Staff,9778,0,9999,221
1746533595535,ECE 45,A01,892618,Staff,0,0,65,65
1746533597589,ECE 111,A01,892719,Staff,4,0,65,61
1746533598615,ECE 197,001,957920,Mercier; Patrick Philip,9991,0,9999,8
1746533599639,ECON 178,A01,907814,Zhu; Ying,26,0,35,9
1746533600667,EDS 115,A00,895312,Staff,36,0,45,9
1746533601696,EDS 117,A01,895337,Staff,24,0,30,6
1746533602722,EDS 125,A00,895341,Jones; Gabrielle Anastasia,37,0,45,8
1746533603748,EDS 128A,A01,895459,Fargason; Sharon Gayle,44,0,45,1
1746533604775,EDS 128B,A01,895543,Pappas; Elizabeth,44,0,45,1
1746533605802,EDS 139,A00,897203,Pappas; Elizabeth,44,0,45,1
1746533605802,EDS 139,B00,897209,Fargason; Sharon Gayle,41,0,45,4
1746533606828,EDS 201,A00,895545,Staff,23,0,45,22
1746533607854,EDS 203,A01,895581,Halter; Christopher P.,23,0,45,22
1746533608882,EDS 204R,A01,895625,Heinzman; Erica M.,39,0,45,6
1746533608882,EDS 204R,B01,895693,Halter; Christopher P.,10,0,45,35
1746533609909,EDS 206R,A00,895694,Fargason; Sharon Gayle,1,0,30,29
1746533609909,EDS 206R,B00,895695,Choi; Bailey Miyeon,16,0,30,14
1746533610936,EDS 250,A00,895697,Hemans; Patricia Ann Benitez,23,0,45,22
1746533611962,EDS 281,A00,895701,Meyerott; Theresa Ann,1,0,15,14
1746533612988,EDS 284,A00,895736,Meyerott; Theresa Ann,1,0,15,14
1746533614014,EDS 286,A00,897210,Fine; Sarah,0,0,15,15
1746533615042,EDS 289C,A01,895770,Daly; Alan J.,15,0,15,0
1746533616071,EDS 290,A00,897211,Hofstetter; Carolyn,0,0,15,15
1746533617097,LIGM 5A,A00,896162,Fischer-Grunski; Eva K,13,0,20,7
1746533618123,LIGM 5B,A00,896260,Fischer-Grunski; Eva K,17,0,20,3
1746533619153,LIGM 5C,A00,896308,Fischer-Grunski; Eva K,18,0,20,2
1746533620181,LIIT 5AS,A00,896313,Carnelos; Chiara,18,0,20,2
1746533621211,LIIT 5BS,A00,896416,Carnelos; Chiara,20,0,20,0
1746533622238,LIIT 5CS,A00,896564,Carnelos; Chiara,20,0,20,0
1746533623269,LISP 5A,A00,896588,Munoz Sanchez; Alicia,3,0,20,17
1746533624297,LISP 5B,A00,896653,Munoz Sanchez; Alicia,7,0,20,13
1746533625325,LISP 5C,A00,896655,Munoz Sanchez; Alicia,0,1,20,20
1746533626356,MAE 197,001,957918,Kleissl; Jan,9996,0,9999,3
1746533626356,MAE 197,002,959806,Boechler; Nicholas Sebastia,9998,0,9999,1
1746533626356,MAE 197,003,959852,Mullin; Jennifer S,9999,0,9999,0
1746533627384,MATH 2,A01,957937,Staff,33,0,35,2
1746533628409,MATH 197,001,957876,Kedlaya; Kiran S.,9993,0,9999,6
1746533629440,MCWP 40,A00,892729,Duru; Nur,10,0,20,10
1746533629440,MCWP 40,B00,893304,Montejo; Carolina,14,0,20,6
1746533630467,MCWP 40R,A00,893757,Redela; Pamela Morgan,0,5,20,20
1746533631492,MCWP 50,A00,893758,Morshed; Michael James,0,0,20,20
1746533631492,MCWP 50,B00,893761,Bartulis; Jason Michael,17,0,20,3
1746533632520,MCWP 50R,A00,893766,Compas; Sean Matthew,0,1,20,20
1746533632520,MCWP 50R,B00,893769,Carter; Jennifer A,0,1,20,20
1746533632520,MCWP 50R,C00,893771,Krone; Jarret,0,3,20,20
1746533632520,MCWP 50R,D00,893772,Miller; Elizabeth Deen,0,0,20,20
1746533632520,MCWP 50R,E00,893775,Carter; Andrea L,0,1,20,20
1746533633546,MMW 11R,A01,892721,Herbst; Matthew,11,0,27,16
1746533633546,MMW 11R,A02,892722,Herbst; Matthew,0,0,0,3
1746533634577,MMW 12R,A01,892724,Herbst; Matthew,0,11,16,16
1746533634577,MMW 12R,A02,892725,Herbst; Matthew,0,10,16,16
1746533635606,MMW 13R,A01,892727,Staff,0,4,16,16
1746533635606,MMW 13R,A02,892728,Staff,0,4,16,16
1746533635606,MMW 13R,A03,958032,Staff,0,4,16,16
1746533635606,MMW 13R,A04,958033,Staff,0,4,16,16
1746533635606,MMW 13R,A05,958034,Staff,0,4,16,16
1746533636633,SIO 295LS,A00,894015,Staff,5,0,25,20
1746533637664,SIO 295S,A00,894020,Staff,5,0,25,20
1746533638688,SIOC 290S,B01,958918,Merrifield; Mark A,14,0,30,16
1746533639716,SIOC 291S,B01,958922,Gabriel; Corey John,14,0,30,16
1746533640745,SOCI 117,A01,895339,Staff,3,0,5,2
1746533641772,WES 237B,A00,894149,Staff,11,0,20,9
1746533643845,AESE 279B,A00,891859,Staff,13,0,35,22
1746533644873,AIP 197,001,891854,Vespa; Emanuel Ignacio,9999,0,9999,0
1746533645900,ANTH 289S,A00,891856,Gagneux; Pascal,12,0,12,0
1746533646925,BENG 196,001,957946,Engler; Adam J.,9996,0,9999,3
1746533647952,BISP 197,001,959851,Wilhelm; James E.,9999,0,9999,0
1746533648980,CAT 124RS,A01,956906,Staff,6,0,25,19
1746533650008,CAT 125RS,A01,922013,Staff,6,0,25,19
1746533651038,CLRE 250,A00,891860,Morris; Sheldon,9995,0,9999,4
1746533653090,CLRE 251R,A00,907817,Mehta; Ravindra L.,9994,0,9999,5
1746533654116,CLRE 252,A00,891864,Cuomo; Raphael Eduardo,9993,0,9999,6
1746533655142,CLRE 253,A00,891867,Vaida; Florin,9994,0,9999,5
1746533655142,CLRE 253,B00,907819,Staff,9999,0,9999,0
1746533656171,CLRE 259,A00,891868,Patel; Hemal,9998,0,9999,1
1746533657196,CLRE 260,A00,891872,Cuomo; Raphael Eduardo,9999,0,9999,0
1746533658221,CLRE 297,001,891888,Cuomo; Raphael Eduardo,9999,0,9999,0
1746533659246,CSE 191,A00,958773,Minnes Kemp; Mor Mia,9996,0,9999,3
1746533660273,CSE 197,001,959846,Minnes Kemp; Mor Mia,9993,0,9999,6
1746533661809,CSS 201S,A01,892054,Mignozzetti; Umberto,26,0,30,4
1746533662839,CSS 202S,A01,892056,Mignozzetti; Umberto,26,0,30,4
1746533663868,DSC 197,001,956898,Eldridge; Justin Matthew,9998,0,9999,1
1746533664892,DSC 297,001,958000,Mazumdar; Arya,9998,0,9999,1
1746533664892,DSC 297,002,959862,Wang; Yusu,9999,0,9999,0
1746533665920,EAP 100,A00,905686,Staff,9778,0,9999,221
1746533666952,ECE 45,A01,892618,Staff,0,0,65,65
1746533669009,ECE 111,A01,892719,Staff,4,0,65,61
1746533670037,ECE 197,001,957920,Mercier; Patrick Philip,9991,0,9999,8
1746533671067,ECON 178,A01,907814,Zhu; Ying,26,0,35,9
1746533672096,EDS 115,A00,895312,Staff,36,0,45,9
1746533673122,EDS 117,A01,895337,Staff,24,0,30,6
1746533674148,EDS 125,A00,895341,Jones; Gabrielle Anastasia,37,0,45,8
1746533675177,EDS 128A,A01,895459,Fargason; Sharon Gayle,44,0,45,1
1746533676206,EDS 128B,A01,895543,Pappas; Elizabeth,44,0,45,1
1746533677231,EDS 139,A00,897203,Pappas; Elizabeth,44,0,45,1
1746533677231,EDS 139,B00,897209,Fargason; Sharon Gayle,41,0,45,4
1746533678258,EDS 201,A00,895545,Staff,23,0,45,22
1746533679283,EDS 203,A01,895581,Halter; Christopher P.,23,0,45,22
1746533680309,EDS 204R,A01,895625,Heinzman; Erica M.,39,0,45,6
1746533680309,EDS 204R,B01,895693,Halter; Christopher P.,10,0,45,35
1746533681337,EDS 206R,A00,895694,Fargason; Sharon Gayle,1,0,30,29
1746533681337,EDS 206R,B00,895695,Choi; Bailey Miyeon,16,0,30,14
1746533682367,EDS 250,A00,895697,Hemans; Patricia Ann Benitez,23,0,45,22
1746533683396,EDS 281,A00,895701,Meyerott; Theresa Ann,1,0,15,14
1746533684424,EDS 284,A00,895736,Meyerott; Theresa Ann,1,0,15,14
1746533685449,EDS 286,A00,897210,Fine; Sarah,0,0,15,15
1746533686476,EDS 289C,A01,895770,Daly; Alan J.,15,0,15,0
1746533687504,EDS 290,A00,897211,Hofstetter; Carolyn,0,0,15,15
1746533688534,LIGM 5A,A00,896162,Fischer-Grunski; Eva K,13,0,20,7
1746533689559,LIGM 5B,A00,896260,Fischer-Grunski; Eva K,17,0,20,3
1746533690588,LIGM 5C,A00,896308,Fischer-Grunski; Eva K,18,0,20,2
1746533691615,LIIT 5AS,A00,896313,Carnelos; Chiara,18,0,20,2
1746533692642,LIIT 5BS,A00,896416,Carnelos; Chiara,20,0,20,0
1746533693672,LIIT 5CS,A00,896564,Carnelos; Chiara,20,0,20,0
1746533694701,LISP 5A,A00,896588,Munoz Sanchez; Alicia,3,0,20,17
1746533695731,LISP 5B,A00,896653,Munoz Sanchez; Alicia,7,0,20,13
1746533696758,LISP 5C,A00,896655,Munoz Sanchez; Alicia,0,1,20,20
1746533697787,MAE 197,001,957918,Kleissl; Jan,9996,0,9999,3
1746533697787,MAE 197,002,959806,Boechler; Nicholas Sebastia,9998,0,9999,1
1746533697787,MAE 197,003,959852,Mullin; Jennifer S,9999,0,9999,0
1746533698812,MATH 2,A01,957937,Staff,33,0,35,2
1746533699844,MATH 197,001,957876,Kedlaya; Kiran S.,9993,0,9999,6
1746533700876,MCWP 40,A00,892729,Duru; Nur,10,0,20,10
1746533700876,MCWP 40,B00,893304,Montejo; Carolina,14,0,20,6
1746533701905,MCWP 40R,A00,893757,Redela; Pamela Morgan,0,5,20,20
1746533702941,MCWP 50,A00,893758,Morshed; Michael James,0,0,20,20
1746533702941,MCWP 50,B00,893761,Bartulis; Jason Michael,17,0,20,3
1746533703970,MCWP 50R,A00,893766,Compas; Sean Matthew,0,1,20,20
1746533703970,MCWP 50R,B00,893769,Carter; Jennifer A,0,1,20,20
1746533703970,MCWP 50R,C00,893771,Krone; Jarret,0,3,20,20
1746533703970,MCWP 50R,D00,893772,Miller; Elizabeth Deen,0,0,20,20
1746533703970,MCWP 50R,E00,893775,Carter; Andrea L,0,1,20,20
1746533705000,MMW 11R,A01,892721,Herbst; Matthew,11,0,27,16
1746533705000,MMW 11R,A02,892722,Herbst; Matthew,0,0,0,3
1746533706028,MMW 12R,A01,892724,Herbst; Matthew,0,11,16,16
1746533706028,MMW 12R,A02,892725,Herbst; Matthew,0,10,16,16
1746533707054,MMW 13R,A01,892727,Staff,0,4,16,16
1746533707054,MMW 13R,A02,892728,Staff,0,4,16,16
1746533707054,MMW 13R,A03,958032,Staff,0,4,16,16
1746533707054,MMW 13R,A04,958033,Staff,0,4,16,16
1746533707054,MMW 13R,A05,958034,Staff,0,4,16,16
1746533708084,SIO 295LS,A00,894015,Staff,5,0,25,20
1746533709110,SIO 295S,A00,894020,Staff,5,0,25,20
1746533710137,SIOC 290S,B01,958918,Merrifield; Mark A,14,0,30,16
1746533711164,SIOC 291S,B01,958922,Gabriel; Corey John,14,0,30,16
1746533712192,SOCI 117,A01,895339,Staff,3,0,5,2
1746533713218,WES 237B,A00,894149,Staff,11,0,20,9
1746533715294,AESE 279B,A00,891859,Staff,13,0,35,22
1746533716319,AIP 197,001,891854,Vespa; Emanuel Ignacio,9999,0,9999,0
1746533717343,ANTH 289S,A00,891856,Gagneux; Pascal,12,0,12,0
1746533718369,BENG 196,001,957946,Engler; Adam J.,9996,0,9999,3
1746533719395,BISP 197,001,959851,Wilhelm; James E.,9999,0,9999,0
1746533720423,CAT 124RS,A01,956906,Staff,6,0,25,19
1746533721450,CAT 125RS,A01,922013,Staff,6,0,25,19
1746533722477,CLRE 250,A00,891860,Morris; Sheldon,9995,0,9999,4
1746533724532,CLRE 251R,A00,907817,Mehta; Ravindra L.,9994,0,9999,5
1746533725558,CLRE 252,A00,891864,Cuomo; Raphael Eduardo,9993,0,9999,6
1746533726583,CLRE 253,A00,891867,Vaida; Florin,9994,0,9999,5
1746533726583,CLRE 253,B00,907819,Staff,9999,0,9999,0
1746533727609,CLRE 259,A00,891868,Patel; Hemal,9998,0,9999,1
1746533728638,CLRE 260,A00,891872,Cuomo; Raphael Eduardo,9999,0,9999,0
1746533729665,CLRE 297,001,891888,Cuomo; Raphael Eduardo,9999,0,9999,0
1746533730690,CSE 191,A00,958773,Minnes Kemp; Mor Mia,9996,0,9999,3
1746533731716,CSE 197,001,959846,Minnes Kemp; Mor Mia,9993,0,9999,6
1746533732741,CSS 201S,A01,892054,Mignozzetti; Umberto,26,0,30,4
1746533733774,CSS 202S,A01,892056,Mignozzetti; Umberto,26,0,30,4
1746533734801,DSC 197,001,956898,Eldridge; Justin Matthew,9998,0,9999,1
1746533735828,DSC 297,001,958000,Mazumdar; Arya,9998,0,9999,1
1746533735828,DSC 297,002,959862,Wang; Yusu,9999,0,9999,0
1746533736858,EAP 100,A00,905686,Staff,9778,0,9999,221
1746533737889,ECE 45,A01,892618,Staff,0,0,65,65
1746533739945,ECE 111,A01,892719,Staff,4,0,65,61
1746533740973,ECE 197,001,957920,Mercier; Patrick Philip,9991,0,9999,8
1746533742000,ECON 178,A01,907814,Zhu; Ying,26,0,35,9
1746533743025,EDS 115,A00,895312,Staff,36,0,45,9
1746533744050,EDS 117,A01,895337,Staff,24,0,30,6
1746533745078,EDS 125,A00,895341,Jones; Gabrielle Anastasia,37,0,45,8
1746533746104,EDS 128A,A01,895459,Fargason; Sharon Gayle,44,0,45,1
1746533747129,EDS 128B,A01,895543,Pappas; Elizabeth,44,0,45,1
1746533748154,EDS 139,A00,897203,Pappas; Elizabeth,44,0,45,1
1746533748154,EDS 139,B00,897209,Fargason; Sharon Gayle,41,0,45,4
1746533749179,EDS 201,A00,895545,Staff,23,0,45,22
1746533750208,EDS 203,A01,895581,Halter; Christopher P.,23,0,45,22
1746533751238,EDS 204R,A01,895625,Heinzman; Erica M.,39,0,45,6
1746533751238,EDS 204R,B01,895693,Halter; Christopher P.,10,0,45,35
1746533752265,EDS 206R,A00,895694,Fargason; Sharon Gayle,1,0,30,29
1746533752265,EDS 206R,B00,895695,Choi; Bailey Miyeon,16,0,30,14
1746533753291,EDS 250,A00,895697,Hemans; Patricia Ann Benitez,23,0,45,22
1746533754316,EDS 281,A00,895701,Meyerott; Theresa Ann,1,0,15,14
1746533755341,EDS 284,A00,895736,Meyerott; Theresa Ann,1,0,15,14
1746533756369,EDS 286,A00,897210,Fine; Sarah,0,0,15,15
1746533757397,EDS 289C,A01,895770,Daly; Alan J.,15,0,15,0
1746533758423,EDS 290,A00,897211,Hofstetter; Carolyn,0,0,15,15
1746533759449,LIGM 5A,A00,896162,Fischer-Grunski; Eva K,13,0,20,7
1746533760480,LIGM 5B,A00,896260,Fischer-Grunski; Eva K,17,0,20,3
1746533761505,LIGM 5C,A00,896308,Fischer-Grunski; Eva K,18,0,20,2
1746533762535,LIIT 5AS,A00,896313,Carnelos; Chiara,18,0,20,2
1746533763566,LIIT 5BS,A00,896416,Carnelos; Chiara,20,0,20,0
1746533764599,LIIT 5CS,A00,896564,Carnelos; Chiara,20,0,20,0
1746533765630,LISP 5A,A00,896588,Munoz Sanchez; Alicia,3,0,20,17
1746533766657,LISP 5B,A00,896653,Munoz Sanchez; Alicia,7,0,20,13
1746533767687,LISP 5C,A00,896655,Munoz Sanchez; Alicia,0,1,20,20
1746533768715,MAE 197,001,957918,Kleissl; Jan,9996,0,9999,3
1746533768715,MAE 197,002,959806,Boechler; Nicholas Sebastia,9998,0,9999,1
1746533768715,MAE 197,003,959852,Mullin; Jennifer S,9999,0,9999,0
1746533769742,MATH 2,A01,957937,Staff,33,0,35,2
1746533770771,MATH 197,001,957876,Kedlaya; Kiran S.,9993,0,9999,6
1746533771800,MCWP 40,A00,892729,Duru; Nur,10,0,20,10
1746533771800,MCWP 40,B00,893304,Montejo; Carolina,14,0,20,6
1746533772828,MCWP 40R,A00,893757,Redela; Pamela Morgan,0,5,20,20
1746533773858,MCWP 50,A00,893758,Morshed; Michael James,0,0,20,20
1746533773858,MCWP 50,B00,893761,Bartulis; Jason Michael,17,0,20,3
1746533774885,MCWP 50R,A00,893766,Compas; Sean Matthew,0,1,20,20
1746533774885,MCWP 50R,B00,893769,Carter; Jennifer A,0,1,20,20
1746533774885,MCWP 50R,C00,893771,Krone; Jarret,0,3,20,20
1746533774885,MCWP 50R,D00,893772,Miller; Elizabeth Deen,0,0,20,20
1746533774885,MCWP 50R,E00,893775,Carter; Andrea L,0,1,20,20
1746533775916,MMW 11R,A01,892721,Herbst; Matthew,11,0,27,16
1746533775916,MMW 11R,A02,892722,Herbst; Matthew,0,0,0,3
1746533776946,MMW 12R,A01,892724,Herbst; Matthew,0,11,16,16
1746533776946,MMW 12R,A02,892725,Herbst; Matthew,0,10,16,16
1746533777976,MMW 13R,A01,892727,Staff,0,4,16,16
1746533777976,MMW 13R,A02,892728,Staff,0,4,16,16
1746533777976,MMW 13R,A03,958032,Staff,0,4,16,16
1746533777976,MMW 13R,A04,958033,Staff,0,4,16,16
1746533777976,MMW 13R,A05,958034,Staff,0,4,16,16
1746533779007,SIO 295LS,A00,894015,Staff,5,0,25,20
1746533780036,SIO 295S,A00,894020,Staff,5,0,25,20
1746533781063,SIOC 290S,B01,958918,Merrifield; Mark A,14,0,30,16
1746533782091,SIOC 291S,B01,958922,Gabriel; Corey John,14,0,30,16
1746533783119,SOCI 117,A01,895339,Staff,3,0,5,2
1746533784147,WES 237B,A00,894149,Staff,11,0,20,9
1746533786219,AESE 279B,A00,891859,Staff,13,0,35,22
1746533787245,AIP 197,001,891854,Vespa; Emanuel Ignacio,9999,0,9999,0
1746533788273,ANTH 289S,A00,891856,Gagneux; Pascal,12,0,12,0
1746533789300,BENG 196,001,957946,Engler; Adam J.,9996,0,9999,3
1746533790324,BISP 197,001,959851,Wilhelm; James E.,9999,0,9999,0
1746533791351,CAT 124RS,A01,956906,Staff,6,0,25,19
1746533792380,CAT 125RS,A01,922013,Staff,6,0,25,19
1746533793410,CLRE 250,A00,891860,Morris; Sheldon,9995,0,9999,4
1746533795464,CLRE 251R,A00,907817,Mehta; Ravindra L.,9994,0,9999,5
1746533796492,CLRE 252,A00,891864,Cuomo; Raphael Eduardo,9993,0,9999,6
1746533797518,CLRE 253,A00,891867,Vaida; Florin,9994,0,9999,5
1746533797518,CLRE 253,B00,907819,Staff,9999,0,9999,0
1746533798550,CLRE 259,A00,891868,Patel; Hemal,9998,0,9999,1
1746533799575,CLRE 260,A00,891872,Cuomo; Raphael Eduardo,9999,0,9999,0
1746533800604,CLRE 297,001,891888,Cuomo; Raphael Eduardo,9999,0,9999,0
1746533801635,CSE 191,A00,958773,Minnes Kemp; Mor Mia,9996,0,9999,3
1746533802664,CSE 197,001,959846,Minnes Kemp; Mor Mia,9993,0,9999,6
1746533803693,CSS 201S,A01,892054,Mignozzetti; Umberto,26,0,30,4
1746533804718,CSS 202S,A01,892056,Mignozzetti; Umberto,26,0,30,4
1746533805747,DSC 197,001,956898,Eldridge; Justin Matthew,9998,0,9999,1
1746533806777,DSC 297,001,958000,Mazumdar; Arya,9998,0,9999,1
1746533806777,DSC 297,002,959862,Wang; Yusu,9999,0,9999,0
1746533807806,EAP 100,A00,905686,Staff,9778,0,9999,221
1746533808835,ECE 45,A01,892618,Staff,0,0,65,65
1746533810890,ECE 111,A01,892719,Staff,4,0,65,61
1746533811959,ECE 197,001,957920,Mercier; Patrick Philip,9991,0,9999,8
1746533812992,ECON 178,A01,907814,Zhu; Ying,26,0,35,9
1746533814020,EDS 115,A00,895312,Staff,36,0,45,9
1746533815046,EDS 117,A01,895337,Staff,24,0,30,6
1746533816071,EDS 125,A00,895341,Jones; Gabrielle Anastasia,37,0,45,8
1746533817101,EDS 128A,A01,895459,Fargason; Sharon Gayle,44,0,45,1
1746533818127,EDS 128B,A01,895543,Pappas; Elizabeth,44,0,45,1
1746533819155,EDS 139,A00,897203,Pappas; Elizabeth,44,0,45,1
1746533819155,EDS 139,B00,897209,Fargason; Sharon Gayle,41,0,45,4
1746533820183,EDS 201,A00,895545,Staff,23,0,45,22
1746533821207,EDS 203,A01,895581,Halter; Christopher P.,23,0,45,22
1746533822238,EDS 204R,A01,895625,Heinzman; Erica M.,39,0,45,6
1746533822238,EDS 204R,B01,895693,Halter; Christopher P.,10,0,45,35
1746533823262,EDS 206R,A00,895694,Fargason; Sharon Gayle,1,0,30,29
1746533823262,EDS 206R,B00,895695,Choi; Bailey Miyeon,16,0,30,14
1746533824291,EDS 250,A00,895697,Hemans; Patricia Ann Benitez,23,0,45,22
1746533825318,EDS 281,A00,895701,Meyerott; Theresa Ann,1,0,15,14
1746533826342,EDS 284,A00,895736,Meyerott; Theresa Ann,1,0,15,14
1746533827368,EDS 286,A00,897210,Fine; Sarah,0,0,15,15
1746533828395,EDS 289C,A01,895770,Daly; Alan J.,15,0,15,0
1746533829419,EDS 290,A00,897211,Hofstetter; Carolyn,0,0,15,15
1746533830445,LIGM 5A,A00,896162,Fischer-Grunski; Eva K,13,0,20,7
1746533831472,LIGM 5B,A00,896260,Fischer-Grunski; Eva K,17,0,20,3
1746533832500,LIGM 5C,A00,896308,Fischer-Grunski; Eva K,18,0,20,2
1746533833527,LIIT 5AS,A00,896313,Carnelos; Chiara,18,0,20,2
1746533834553,LIIT 5BS,A00,896416,Carnelos; Chiara,20,0,20,0
1746533835581,LIIT 5CS,A00,896564,Carnelos; Chiara,20,0,20,0
1746533836606,LISP 5A,A00,896588,Munoz Sanchez; Alicia,3,0,20,17
1746533837637,LISP 5B,A00,896653,Munoz Sanchez; Alicia,7,0,20,13
1746533838662,LISP 5C,A00,896655,Munoz Sanchez; Alicia,0,1,20,20
1746533839688,MAE 197,001,957918,Kleissl; Jan,9996,0,9999,3
1746533839688,MAE 197,002,959806,Boechler; Nicholas Sebastia,9998,0,9999,1
1746533839688,MAE 197,003,959852,Mullin; Jennifer S,9999,0,9999,0
1746533840717,MATH 2,A01,957937,Staff,33,0,35,2
1746533841742,MATH 197,001,957876,Kedlaya; Kiran S.,9993,0,9999,6
1746533842773,MCWP 40,A00,892729,Duru; Nur,10,0,20,10
1746533842773,MCWP 40,B00,893304,Montejo; Carolina,14,0,20,6
1746533843799,MCWP 40R,A00,893757,Redela; Pamela Morgan,0,5,20,20
1746533844825,MCWP 50,A00,893758,Morshed; Michael James,0,0,20,20
1746533844825,MCWP 50,B00,893761,Bartulis; Jason Michael,17,0,20,3
1746533845856,MCWP 50R,A00,893766,Compas; Sean Matthew,0,1,20,20
1746533845856,MCWP 50R,B00,893769,Carter; Jennifer A,0,1,20,20
1746533845856,MCWP 50R,C00,893771,Krone; Jarret,0,3,20,20
1746533845856,MCWP 50R,D00,893772,Miller; Elizabeth Deen,0,0,20,20
1746533845856,MCWP 50R,E00,893775,Carter; Andrea L,0,1,20,20
1746533846881,MMW 11R,A01,892721,Herbst; Matthew,11,0,27,16
1746533846881,MMW 11R,A02,892722,Herbst; Matthew,0,0,0,3
1746533847909,MMW 12R,A01,892724,Herbst; Matthew,0,11,16,16
1746533847909,MMW 12R,A02,892725,Herbst; Matthew,0,10,16,16
1746533848937,MMW 13R,A01,892727,Staff,0,4,16,16
1746533848937,MMW 13R,A02,892728,Staff,0,4,16,16
1746533848937,MMW 13R,A03,958032,Staff,0,4,16,16
1746533848937,MMW 13R,A04,958033,Staff,0,4,16,16
1746533848937,MMW 13R,A05,958034,Staff,0,4,16,16
1746533850001,SIO 295LS,A00,894015,Staff,5,0,25,20
1746533851032,SIO 295S,A00,894020,Staff,5,0,25,20
1746533852057,SIOC 290S,B01,958918,Merrifield; Mark A,14,0,30,16
1746533853084,SIOC 291S,B01,958922,Gabriel; Corey John,14,0,30,16
1746533854113,SOCI 117,A01,895339,Staff,3,0,5,2
1746533855140,WES 237B,A00,894149,Staff,11,0,20,9
1746533857240,AESE 279B,A00,891859,Staff,13,0,35,22
1746533858265,AIP 197,001,891854,Vespa; Emanuel Ignacio,9999,0,9999,0
1746533859295,ANTH 289S,A00,891856,Gagneux; Pascal,12,0,12,0
1746533860321,BENG 196,001,957946,Engler; Adam J.,9996,0,9999,3
1746533861348,BISP 197,001,959851,Wilhelm; James E.,9999,0,9999,0
1746533862374,CAT 124RS,A01,956906,Staff,6,0,25,19
1746533863399,CAT 125RS,A01,922013,Staff,6,0,25,19
1746533864428,CLRE 250,A00,891860,Morris; Sheldon,9995,0,9999,4
1746533866482,CLRE 251R,A00,907817,Mehta; Ravindra L.,9994,0,9999,5
1746533867508,CLRE 252,A00,891864,Cuomo; Raphael Eduardo,9993,0,9999,6
1746533868538,CLRE 253,A00,891867,Vaida; Florin,9994,0,9999,5
1746533868538,CLRE 253,B00,907819,Staff,9999,0,9999,0
1746533869568,CLRE 259,A00,891868,Patel; Hemal,9998,0,9999,1
1746533870594,CLRE 260,A00,891872,Cuomo; Raphael Eduardo,9999,0,9999,0
1746533871619,CLRE 297,001,891888,Cuomo; Raphael Eduardo,9999,0,9999,0
1746533872644,CSE 191,A00,958773,Minnes Kemp; Mor Mia,9996,0,9999,3
1746533873671,CSE 197,001,959846,Minnes Kemp; Mor Mia,9993,0,9999,6
1746533874698,CSS 201S,A01,892054,Mignozzetti; Umberto,26,0,30,4
1746533875728,CSS 202S,A01,892056,Mignozzetti; Umberto,26,0,30,4
1746533876757,DSC 197,001,956898,Eldridge; Justin Matthew,9998,0,9999,1
1746533877782,DSC 297,001,958000,Mazumdar; Arya,9998,0,9999,1
1746533877782,DSC 297,002,959862,Wang; Yusu,9999,0,9999,0
1746533878810,EAP 100,A00,905686,Staff,9778,0,9999,221
1746533879836,ECE 45,A01,892618,Staff,0,0,65,65
1746533881884,ECE 111,A01,892719,Staff,4,0,65,61
1746533882914,ECE 197,001,957920,Mercier; Patrick Philip,9991,0,9999,8
1746533883944,ECON 178,A01,907814,Zhu; Ying,26,0,35,9
1746533884973,EDS 115,A00,895312,Staff,36,0,45,9
1746533886002,EDS 117,A01,895337,Staff,24,0,30,6
1746533887027,EDS 125,A00,895341,Jones; Gabrielle Anastasia,37,0,45,8
1746533888056,EDS 128A,A01,895459,Fargason; Sharon Gayle,44,0,45,1
1746533889082,EDS 128B,A01,895543,Pappas; Elizabeth,44,0,45,1
1746533890112,EDS 139,A00,897203,Pappas; Elizabeth,44,0,45,1
1746533890112,EDS 139,B00,897209,Fargason; Sharon Gayle,41,0,45,4
1746533891140,EDS 201,A00,895545,Staff,23,0,45,22
1746533892168,EDS 203,A01,895581,Halter; Christopher P.,23,0,45,22
1746533893195,EDS 204R,A01,895625,Heinzman; Erica M.,39,0,45,6
1746533893195,EDS 204R,B01,895693,Halter; Christopher P.,10,0,45,35
1746533894223,EDS 206R,A00,895694,Fargason; Sharon Gayle,1,0,30,29
1746533894223,EDS 206R,B00,895695,Choi; Bailey Miyeon,16,0,30,14
1746533895252,EDS 250,A00,895697,Hemans; Patricia Ann Benitez,23,0,45,22
1746533896282,EDS 281,A00,895701,Meyerott; Theresa Ann,1,0,15,14
1746533897309,EDS 284,A00,895736,Meyerott; Theresa Ann,1,0,15,14
1746533898333,EDS 286,A00,897210,Fine; Sarah,0,0,15,15
1746533899359,EDS 289C,A01,895770,Daly; Alan J.,15,0,15,0
1746533900384,EDS 290,A00,897211,Hofstetter; Carolyn,0,0,15,15
1746533901412,LIGM 5A,A00,896162,Fischer-Grunski; Eva K,13,0,20,7
1746533902441,LIGM 5B,A00,896260,Fischer-Grunski; Eva K,17,0,20,3
1746533903471,LIGM 5C,A00,896308,Fischer-Grunski; Eva K,18,0,20,2
1746533904497,LIIT 5AS,A00,896313,Carnelos; Chiara,18,0,20,2
1746533905526,LIIT 5BS,A00,896416,Carnelos; Chiara,20,0,20,0
1746533906554,LIIT 5CS,A00,896564,Carnelos; Chiara,20,0,20,0
1746533907578,LISP 5A,A00,896588,Munoz Sanchez; Alicia,3,0,20,17
1746533908604,LISP 5B,A00,896653,Munoz Sanchez; Alicia,7,0,20,13
1746533909633,LISP 5C,A00,896655,Munoz Sanchez; Alicia,0,1,20,20
1746533910662,MAE 197,001,957918,Kleissl; Jan,9996,0,9999,3
1746533910662,MAE 197,002,959806,Boechler; Nicholas Sebastia,9998,0,9999,1
1746533910662,MAE 197,003,959852,Mullin; Jennifer S,9999,0,9999,0
1746533911689,MATH 2,A01,957937,Staff,33,0,35,2
1746533912715,MATH 197,001,957876,Kedlaya; Kiran S.,9993,0,9999,6
1746533913744,MCWP 40,A00,892729,Duru; Nur,10,0,20,10
1746533913744,MCWP 40,B00,893304,Montejo; Carolina,14,0,20,6
1746533914771,MCWP 40R,A00,893757,Redela; Pamela Morgan,0,5,20,20
1746533915801,MCWP 50,A00,893758,Morshed; Michael James,0,0,20,20
1746533915801,MCWP 50,B00,893761,Bartulis; Jason Michael,17,0,20,3
1746533916829,MCWP 50R,A00,893766,Compas; Sean Matthew,0,1,20,20
1746533916829,MCWP 50R,B00,893769,Carter; Jennifer A,0,1,20,20
1746533916829,MCWP 50R,C00,893771,Krone; Jarret,0,3,20,20
1746533916829,MCWP 50R,D00,893772,Miller; Elizabeth Deen,0,0,20,20
1746533916829,MCWP 50R,E00,893775,Carter; Andrea L,0,1,20,20
1746533917859,MMW 11R,A01,892721,Herbst; Matthew,11,0,27,16
1746533917859,MMW 11R,A02,892722,Herbst; Matthew,0,0,0,3
1746533918888,MMW 12R,A01,892724,Herbst; Matthew,0,11,16,16
1746533918888,MMW 12R,A02,892725,Herbst; Matthew,0,10,16,16
1746533919915,MMW 13R,A01,892727,Staff,0,4,16,16
1746533919915,MMW 13R,A02,892728,Staff,0,4,16,16
1746533919915,MMW 13R,A03,958032,Staff,0,4,16,16
1746533919915,MMW 13R,A04,958033,Staff,0,4,16,16
1746533919915,MMW 13R,A05,958034,Staff,0,4,16,16
1746533920940,SIO 295LS,A00,894015,Staff,5,0,25,20
1746533921968,SIO 295S,A00,894020,Staff,5,0,25,20
1746533923001,SIOC 290S,B01,958918,Merrifield; Mark A,14,0,30,16
1746533924029,SIOC 291S,B01,958922,Gabriel; Corey John,14,0,30,16
1746533925058,SOCI 117,A01,895339,Staff,3,0,5,2
1746533926085,WES 237B,A00,894149,Staff,11,0,20,9
1746533928147,AESE 279B,A00,891859,Staff,13,0,35,22
1746533929175,AIP 197,001,891854,Vespa; Emanuel Ignacio,9999,0,9999,0
1746533930201,ANTH 289S,A00,891856,Gagneux; Pascal,12,0,12,0
1746533931229,BENG 196,001,957946,Engler; Adam J.,9996,0,9999,3
1746533932257,BISP 197,001,959851,Wilhelm; James E.,9999,0,9999,0
1746533933287,CAT 124RS,A01,956906,Staff,6,0,25,19
1746533934312,CAT 125RS,A01,922013,Staff,6,0,25,19
1746533935343,CLRE 250,A00,891860,Morris; Sheldon,9995,0,9999,4
1746533937396,CLRE 251R,A00,907817,Mehta; Ravindra L.,9994,0,9999,5
1746533938422,CLRE 252,A00,891864,Cuomo; Raphael Eduardo,9993,0,9999,6
1746533939453,CLRE 253,A00,891867,Vaida; Florin,9994,0,9999,5
1746533939453,CLRE 253,B00,907819,Staff,9999,0,9999,0
1746533940478,CLRE 259,A00,891868,Patel; Hemal,9998,0,9999,1
1746533941507,CLRE 260,A00,891872,Cuomo; Raphael Eduardo,9999,0,9999,0
1746533942534,CLRE 297,001,891888,Cuomo; Raphael Eduardo,9999,0,9999,0
1746533943560,CSE 191,A00,958773,Minnes Kemp; Mor Mia,9996,0,9999,3
1746533944586,CSE 197,001,959846,Minnes Kemp; Mor Mia,9993,0,9999,6
1746533945612,CSS 201S,A01,892054,Mignozzetti; Umberto,26,0,30,4
1746533946643,CSS 202S,A01,892056,Mignozzetti; Umberto,26,0,30,4
1746533947672,DSC 197,001,956898,Eldridge; Justin Matthew,9998,0,9999,1
1746533948702,DSC 297,001,958000,Mazumdar; Arya,9998,0,9999,1
1746533948702,DSC 297,002,959862,Wang; Yusu,9999,0,9999,0
1746533949727,EAP 100,A00,905686,Staff,9778,0,9999,221
1746533950758,ECE 45,A01,892618,Staff,0,0,65,65
1746533952815,ECE 111,A01,892719,Staff,4,0,65,61
1746533953842,ECE 197,001,957920,Mercier; Patrick Philip,9991,0,9999,8
1746533954875,ECON 178,A01,907814,Zhu; Ying,26,0,35,9
1746533955901,EDS 115,A00,895312,Staff,36,0,45,9
1746533956931,EDS 117,A01,895337,Staff,24,0,30,6
1746533957956,EDS 125,A00,895341,Jones; Gabrielle Anastasia,37,0,45,8
1746533958981,EDS 128A,A01,895459,Fargason; Sharon Gayle,44,0,45,1
1746533960007,EDS 128B,A01,895543,Pappas; Elizabeth,44,0,45,1
1746533961032,EDS 139,A00,897203,Pappas; Elizabeth,44,0,45,1
1746533961032,EDS 139,B00,897209,Fargason; Sharon Gayle,41,0,45,4
1746533962059,EDS 201,A00,895545,Staff,23,0,45,22
1746533963085,EDS 203,A01,895581,Halter; Christopher P.,23,0,45,22
1746533964111,EDS 204R,A01,895625,Heinzman; Erica M.,39,0,45,6
1746533964111,EDS 204R,B01,895693,Halter; Christopher P.,10,0,45,35
1746533965137,EDS 206R,A00,895694,Fargason; Sharon Gayle,1,0,30,29
1746533965137,EDS 206R,B00,895695,Choi; Bailey Miyeon,16,0,30,14
1746533966164,EDS 250,A00,895697,Hemans; Patricia Ann Benitez,23,0,45,22
1746533967193,EDS 281,A00,895701,Meyerott; Theresa Ann,1,0,15,14
1746533968223,EDS 284,A00,895736,Meyerott; Theresa Ann,1,0,15,14
1746533969250,EDS 286,A00,897210,Fine; Sarah,0,0,15,15
1746533970281,EDS 289C,A01,895770,Daly; Alan J.,15,0,15,0
1746533971305,EDS 290,A00,897211,Hofstetter; Carolyn,0,0,15,15
1746533972333,LIGM 5A,A00,896162,Fischer-Grunski; Eva K,13,0,20,7
1746533973360,LIGM 5B,A00,896260,Fischer-Grunski; Eva K,17,0,20,3
1746533974385,LIGM 5C,A00,896308,Fischer-Grunski; Eva K,18,0,20,2
1746533975412,LIIT 5AS,A00,896313,Carnelos; Chiara,18,0,20,2
1746533976441,LIIT 5BS,A00,896416,Carnelos; Chiara,20,0,20,0
1746533977469,LIIT 5CS,A00,896564,Carnelos; Chiara,20,0,20,0
1746533978497,LISP 5A,A00,896588,Munoz Sanchez; Alicia,3,0,20,17
1746533979523,LISP 5B,A00,896653,Munoz Sanchez; Alicia,7,0,20,13
1746533980549,LISP 5C,A00,896655,Munoz Sanchez; Alicia,0,1,20,20
1746533981576,MAE 197,001,957918,Kleissl; Jan,9996,0,9999,3
1746533981576,MAE 197,002,959806,Boechler; Nicholas Sebastia,9998,0,9999,1
1746533981576,MAE 197,003,959852,Mullin; Jennifer S,9999,0,9999,0
1746533982604,MATH 2,A01,957937,Staff,33,0,35,2
1746533983633,MATH 197,001,957876,Kedlaya; Kiran S.,9993,0,9999,6
1746533984662,MCWP 40,A00,892729,Duru; Nur,10,0,20,10
1746533984662,MCWP 40,B00,893304,Montejo; Carolina,14,0,20,6
1746533985692,MCWP 40R,A00,893757,Redela; Pamela Morgan,0,5,20,20
1746533986718,MCWP 50,A00,893758,Morshed; Michael James,0,0,20,20
1746533986718,MCWP 50,B00,893761,Bartulis; Jason Michael,17,0,20,3
1746533987745,MCWP 50R,A00,893766,Compas; Sean Matthew,0,1,20,20
1746533987745,MCWP 50R,B00,893769,Carter; Jennifer A,0,1,20,20
1746533987745,MCWP 50R,C00,893771,Krone; Jarret,0,3,20,20
1746533987745,MCWP 50R,D00,893772,Miller; Elizabeth Deen,0,0,20,20
1746533987745,MCWP 50R,E00,893775,Carter; Andrea L,0,1,20,20
1746533988773,MMW 11R,A01,892721,Herbst; Matthew,11,0,27,16
1746533988773,MMW 11R,A02,892722,Herbst; Matthew,0,0,0,3
1746533989800,MMW 12R,A01,892724,Herbst; Matthew,0,11,16,16
1746533989800,MMW 12R,A02,892725,Herbst; Matthew,0,10,16,16
1746533990826,MMW 13R,A01,892727,Staff,0,4,16,16
1746533990826,MMW 13R,A02,892728,Staff,0,4,16,16
1746533990826,MMW 13R,A03,958032,Staff,0,4,16,16
1746533990826,MMW 13R,A04,958033,Staff,0,4,16,16
1746533990826,MMW 13R,A05,958034,Staff,0,4,16,16
1746533991856,SIO 295LS,A00,894015,Staff,5,0,25,20
1746533992880,SIO 295S,A00,894020,Staff,5,0,25,20
1746533993908,SIOC 290S,B01,958918,Merrifield; Mark A,14,0,30,16
1746533994935,SIOC 291S,B01,958922,Gabriel; Corey John,14,0,30,16
1746533995960,SOCI 117,A01,895339,Staff,3,0,5,2
1746533996986,WES 237B,A00,894149,Staff,11,0,20,9
1746533999061,AESE 279B,A00,891859,Staff,13,0,35,22
1746534000090,AIP 197,001,891854,Vespa; Emanuel Ignacio,9999,0,9999,0
1746534001117,ANTH 289S,A00,891856,Gagneux; Pascal,12,0,12,0
1746534002149,BENG 196,001,957946,Engler; Adam J.,9996,0,9999,3
1746534003179,BISP 197,001,959851,Wilhelm; James E.,9999,0,9999,0
1746534004205,CAT 124RS,A01,956906,Staff,6,0,25,19
1746534005236,CAT 125RS,A01,922013,Staff,6,0,25,19
1746534006267,CLRE 250,A00,891860,Morris; Sheldon,9995,0,9999,4
1746534008324,CLRE 251R,A00,907817,Mehta; Ravindra L.,9994,0,9999,5
1746534009351,CLRE 252,A00,891864,Cuomo; Raphael Eduardo,9993,0,9999,6
1746534010375,CLRE 253,A00,891867,Vaida; Florin,9994,0,9999,5
1746534010375,CLRE 253,B00,907819,Staff,9999,0,9999,0
1746534011401,CLRE 259,A00,891868,Patel; Hemal,9998,0,9999,1
1746534012426,CLRE 260,A00,891872,Cuomo; Raphael Eduardo,9999,0,9999,0
1746534013452,CLRE 297,001,891888,Cuomo; Raphael Eduardo,9999,0,9999,0
1746534014477,CSE 191,A00,958773,Minnes Kemp; Mor Mia,9996,0,9999,3
1746534015506,CSE 197,001,959846,Minnes Kemp; Mor Mia,9993,0,9999,6
1746534016537,CSS 201S,A01,892054,Mignozzetti; Umberto,26,0,30,4
1746534017565,CSS 202S,A01,892056,Mignozzetti; Umberto,26,0,30,4
1746534018591,DSC 197,001,956898,Eldridge; Justin Matthew,9998,0,9999,1
1746534019659,DSC 297,001,958000,Mazumdar; Arya,9998,0,9999,1
1746534019659,DSC 297,002,959862,Wang; Yusu,9999,0,9999,0
1746534020687,EAP 100,A00,905686,Staff,9778,0,9999,221
1746534021714,ECE 45,A01,892618,Staff,0,0,65,65
1746534023768,ECE 111,A01,892719,Staff,4,0,65,61
1746534024797,ECE 197,001,957920,Mercier; Patrick Philip,9991,0,9999,8
1746534025826,ECON 178,A01,907814,Zhu; Ying,26,0,35,9
1746534026853,EDS 115,A00,895312,Staff,36,0,45,9
1746534027878,EDS 117,A01,895337,Staff,24,0,30,6
1746534028909,EDS 125,A00,895341,Jones; Gabrielle Anastasia,37,0,45,8
1746534029936,EDS 128A,A01,895459,Fargason; Sharon Gayle,44,0,45,1
1746534030965,EDS 128B,A01,895543,Pappas; Elizabeth,44,0,45,1
1746534031992,EDS 139,A00,897203,Pappas; Elizabeth,44,0,45,1
1746534031992,EDS 139,B00,897209,Fargason; Sharon Gayle,41,0,45,4
1746534033018,EDS 201,A00,895545,Staff,23,0,45,22
1746534034046,EDS 203,A01,895581,Halter; Christopher P.,23,0,45,22
1746534035078,EDS 204R,A01,895625,Heinzman; Erica M.,39,0,45,6
1746534035078,EDS 204R,B01,895693,Halter; Christopher P.,10,0,45,35
1746534036106,EDS 206R,A00,895694,Fargason; Sharon Gayle,1,0,30,29
1746534036106,EDS 206R,B00,895695,Choi; Bailey Miyeon,16,0,30,14
1746534037138,EDS 250,A00,895697,Hemans; Patricia Ann Benitez,23,0,45,22
1746534038164,EDS 281,A00,895701,Meyerott; Theresa Ann,1,0,15,14
1746534039189,EDS 284,A00,895736,Meyerott; Theresa Ann,1,0,15,14
1746534040217,EDS 286,A00,897210,Fine; Sarah,0,0,15,15
1746534041246,EDS 289C,A01,895770,Daly; Alan J.,15,0,15,0
1746534042272,EDS 290,A00,897211,Hofstetter; Carolyn,0,0,15,15
1746534043296,LIGM 5A,A00,896162,Fischer-Grunski; Eva K,13,0,20,7
1746534044322,LIGM 5B,A00,896260,Fischer-Grunski; Eva K,17,0,20,3
1746534045353,LIGM 5C,A00,896308,Fischer-Grunski; Eva K,18,0,20,2
1746534046379,LIIT 5AS,A00,896313,Carnelos; Chiara,18,0,20,2
1746534047406,LIIT 5BS,A00,896416,Carnelos; Chiara,20,0,20,0
1746534048434,LIIT 5CS,A00,896564,Carnelos; Chiara,20,0,20,0
1746534049460,LISP 5A,A00,896588,Munoz Sanchez; Alicia,3,0,20,17
1746534050486,LISP 5B,A00,896653,Munoz Sanchez; Alicia,7,0,20,13
1746534051511,LISP 5C,A00,896655,Munoz Sanchez; Alicia,0,1,20,20
1746534052539,MAE 197,001,957918,Kleissl; Jan,9996,0,9999,3
1746534052539,MAE 197,002,959806,Boechler; Nicholas Sebastia,9998,0,9999,1
1746534052539,MAE 197,003,959852,Mullin; Jennifer S,9999,0,9999,0
1746534053567,MATH 2,A01,957937,Staff,33,0,35,2
1746534054597,MATH 197,001,957876,Kedlaya; Kiran S.,9993,0,9999,6
1746534055629,MCWP 40,A00,892729,Duru; Nur,10,0,20,10
1746534055629,MCWP 40,B00,893304,Montejo; Carolina,14,0,20,6
1746534056656,MCWP 40R,A00,893757,Redela; Pamela Morgan,0,5,20,20
1746534057684,MCWP 50,A00,893758,Morshed; Michael James,0,0,20,20
1746534057684,MCWP 50,B00,893761,Bartulis; Jason Michael,17,0,20,3
1746534058715,MCWP 50R,A00,893766,Compas; Sean Matthew,0,1,20,20
1746534058715,MCWP 50R,B00,893769,Carter; Jennifer A,0,1,20,20
1746534058715,MCWP 50R,C00,893771,Krone; Jarret,0,3,20,20
1746534058715,MCWP 50R,D00,893772,Miller; Elizabeth Deen,0,0,20,20
1746534058715,MCWP 50R,E00,893775,Carter; Andrea L,0,1,20,20
1746534059742,MMW 11R,A01,892721,Herbst; Matthew,11,0,27,16
1746534059742,MMW 11R,A02,892722,Herbst; Matthew,0,0,0,3
1746534060767,MMW 12R,A01,892724,Herbst; Matthew,0,11,16,16
1746534060767,MMW 12R,A02,892725,Herbst; Matthew,0,10,16,16
1746534061793,MMW 13R,A01,892727,Staff,0,4,16,16
1746534061793,MMW 13R,A02,892728,Staff,0,4,16,16
1746534061793,MMW 13R,A03,958032,Staff,0,4,16,16
1746534061793,MMW 13R,A04,958033,Staff,0,4,16,16
1746534061793,MMW 13R,A05,958034,Staff,0,4,16,16
1746534062821,SIO 295LS,A00,894015,Staff,5,0,25,20
1746534063846,SIO 295S,A00,894020,Staff,5,0,25,20
1746534064876,SIOC 290S,B01,958918,Merrifield; Mark A,14,0,30,16
1746534065909,SIOC 291S,B01,958922,Gabriel; Corey John,14,0,30,16
1746534066934,SOCI 117,A01,895339,Staff,3,0,5,2
1746534067961,WES 237B,A00,894149,Staff,11,0,20,9
1746534070041,AESE 279B,A00,891859,Staff,13,0,35,22
1746534071068,AIP 197,001,891854,Vespa; Emanuel Ignacio,9999,0,9999,0
1746534072099,ANTH 289S,A00,891856,Gagneux; Pascal,12,0,12,0
1746534073126,BENG 196,001,957946,Engler; Adam J.,9996,0,9999,3
1746534074151,BISP 197,001,959851,Wilhelm; James E.,9999,0,9999,0
1746534075175,CAT 124RS,A01,956906,Staff,6,0,25,19
1746534076200,CAT 125RS,A01,922013,Staff,6,0,25,19
1746534077229,CLRE 250,A00,891860,Morris; Sheldon,9995,0,9999,4
1746534079283,CLRE 251R,A00,907817,Mehta; Ravindra L.,9994,0,9999,5
1746534080309,CLRE 252,A00,891864,Cuomo; Raphael Eduardo,9993,0,9999,6
1746534081343,CLRE 253,A00,891867,Vaida; Florin,9994,0,9999,5
1746534081343,CLRE 253,B00,907819,Staff,9999,0,9999,0
1746534082368,CLRE 259,A00,891868,Patel; Hemal,9998,0,9999,1
1746534083395,CLRE 260,A00,891872,Cuomo; Raphael Eduardo,9999,0,9999,0
1746534084423,CLRE 297,001,891888,Cuomo; Raphael Eduardo,9999,0,9999,0
1746534085448,CSE 191,A00,958773,Minnes Kemp; Mor Mia,9996,0,9999,3
1746534086478,CSE 197,001,959846,Minnes Kemp; Mor Mia,9993,0,9999,6
1746534087507,CSS 201S,A01,892054,Mignozzetti; Umberto,26,0,30,4
1746534088538,CSS 202S,A01,892056,Mignozzetti; Umberto,26,0,30,4
1746534089564,DSC 197,001,956898,Eldridge; Justin Matthew,9998,0,9999,1
1746534090590,DSC 297,001,958000,Mazumdar; Arya,9998,0,9999,1
1746534090590,DSC 297,002,959862,Wang; Yusu,9999,0,9999,0
1746534091620,EAP 100,A00,905686,Staff,9778,0,9999,221
1746534092649,ECE 45,A01,892618,Staff,0,0,65,65
1746534094701,ECE 111,A01,892719,Staff,4,0,65,61
1746534095731,ECE 197,001,957920,Mercier; Patrick Philip,9991,0,9999,8
1746534096756,ECON 178,A01,907814,Zhu; Ying,26,0,35,9
1746534097792,EDS 115,A00,895312,Staff,36,0,45,9
1746534098821,EDS 117,A01,895337,Staff,24,0,30,6
1746534099852,EDS 125,A00,895341,Jones; Gabrielle Anastasia,37,0,45,8
1746534100877,EDS 128A,A01,895459,Fargason; Sharon Gayle,44,0,45,1
1746534101904,EDS 128B,A01,895543,Pappas; Elizabeth,44,0,45,1
1746534102931,EDS 139,A00,897203,Pappas; Elizabeth,44,0,45,1
1746534102931,EDS 139,B00,897209,Fargason; Sharon Gayle,41,0,45,4
1746534103955,EDS 201,A00,895545,Staff,23,0,45,22
1746534104983,EDS 203,A01,895581,Halter; Christopher P.,23,0,45,22
1746534106008,EDS 204R,A01,895625,Heinzman; Erica M.,39,0,45,6
1746534106008,EDS 204R,B01,895693,Halter; Christopher P.,10,0,45,35
1746534107035,EDS 206R,A00,895694,Fargason; Sharon Gayle,1,0,30,29
1746534107035,EDS 206R,B00,895695,Choi; Bailey Miyeon,16,0,30,14
1746534108061,EDS 250,A00,895697,Hemans; Patricia Ann Benitez,23,0,45,22
1746534109089,EDS 281,A00,895701,Meyerott; Theresa Ann,1,0,15,14
1746534110115,EDS 284,A00,895736,Meyerott; Theresa Ann,1,0,15,14
1746534111146,EDS 286,A00,897210,Fine; Sarah,0,0,15,15
1746534112174,EDS 289C,A01,895770,Daly; Alan J.,15,0,15,0
1746534113201,EDS 290,A00,897211,Hofstetter; Carolyn,0,0,15,15
1746534114233,LIGM 5A,A00,896162,Fischer-Grunski; Eva K,13,0,20,7
1746534115262,LIGM 5B,A00,896260,Fischer-Grunski; Eva K,17,0,20,3
1746534116288,LIGM 5C,A00,896308,Fischer-Grunski; Eva K,18,0,20,2
1746534117316,LIIT 5AS,A00,896313,Carnelos; Chiara,18,0,20,2
1746534118343,LIIT 5BS,A00,896416,Carnelos; Chiara,20,0,20,0
1746534119374,LIIT 5CS,A00,896564,Carnelos; Chiara,20,0,20,0
1746534120405,LISP 5A,A00,896588,Munoz Sanchez; Alicia,3,0,20,17
1746534121431,LISP 5B,A00,896653,Munoz Sanchez; Alicia,7,0,20,13
1746534122462,LISP 5C,A00,896655,Munoz Sanchez; Alicia,0,1,20,20
1746534123552,MAE 197,001,957918,Kleissl; Jan,9996,0,9999,3
1746534123552,MAE 197,002,959806,Boechler; Nicholas Sebastia,9998,0,9999,1
1746534123552,MAE 197,003,959852,Mullin; Jennifer S,9999,0,9999,0
1746534124581,MATH 2,A01,957937,Staff,33,0,35,2
1746534125611,MATH 197,001,957876,Kedlaya; Kiran S.,9993,0,9999,6
1746534126638,MCWP 40,A00,892729,Duru; Nur,10,0,20,10
1746534126638,MCWP 40,B00,893304,Montejo; Carolina,14,0,20,6
1746534127667,MCWP 40R,A00,893757,Redela; Pamela Morgan,0,5,20,20
1746534128696,MCWP 50,A00,893758,Morshed; Michael James,0,0,20,20
1746534128696,MCWP 50,B00,893761,Bartulis; Jason Michael,17,0,20,3
1746534129724,MCWP 50R,A00,893766,Compas; Sean Matthew,0,1,20,20
1746534129724,MCWP 50R,B00,893769,Carter; Jennifer A,0,1,20,20
1746534129724,MCWP 50R,C00,893771,Krone; Jarret,0,3,20,20
1746534129724,MCWP 50R,D00,893772,Miller; Elizabeth Deen,0,0,20,20
1746534129724,MCWP 50R,E00,893775,Carter; Andrea L,0,1,20,20
1746534130750,MMW 11R,A01,892721,Herbst; Matthew,11,0,27,16
1746534130750,MMW 11R,A02,892722,Herbst; Matthew,0,0,0,3
1746534131781,MMW 12R,A01,892724,Herbst; Matthew,0,11,16,16
1746534131781,MMW 12R,A02,892725,Herbst; Matthew,0,10,16,16
1746534132807,MMW 13R,A01,892727,Staff,0,4,16,16
1746534132807,MMW 13R,A02,892728,Staff,0,4,16,16
1746534132807,MMW 13R,A03,958032,Staff,0,4,16,16
1746534132807,MMW 13R,A04,958033,Staff,0,4,16,16
1746534132807,MMW 13R,A05,958034,Staff,0,4,16,16
1746534133839,SIO 295LS,A00,894015,Staff,5,0,25,20
1746534134867,SIO 295S,A00,894020,Staff,5,0,25,20
1746534135902,SIOC 290S,B01,958918,Merrifield; Mark A,14,0,30,16
1746534136935,SIOC 291S,B01,958922,Gabriel; Corey John,14,0,30,16
1746534137966,SOCI 117,A01,895339,Staff,3,0,5,2
1746534138994,WES 237B,A00,894149,Staff,11,0,20,9
1746534141089,AESE 279B,A00,891859,Staff,13,0,35,22
1746534142116,AIP 197,001,891854,Vespa; Emanuel Ignacio,9999,0,9999,0
1746534143144,ANTH 289S,A00,891856,Gagneux; Pascal,12,0,12,0
1746534144169,BENG 196,001,957946,Engler; Adam J.,9996,0,9999,3
1746534145198,BISP 197,001,959851,Wilhelm; James E.,9999,0,9999,0
1746534146224,CAT 124RS,A01,956906,Staff,6,0,25,19
1746534147252,CAT 125RS,A01,922013,Staff,6,0,25,19
1746534148281,CLRE 250,A00,891860,Morris; Sheldon,9995,0,9999,4
1746534150333,CLRE 251R,A00,907817,Mehta; Ravindra L.,9994,0,9999,5
1746534151359,CLRE 252,A00,891864,Cuomo; Raphael Eduardo,9993,0,9999,6
1746534152396,CLRE 253,A00,891867,Vaida; Florin,9994,0,9999,5
1746534152396,CLRE 253,B00,907819,Staff,9999,0,9999,0
1746534153422,CLRE 259,A00,891868,Patel; Hemal,9998,0,9999,1
1746534154447,CLRE 260,A00,891872,Cuomo; Raphael Eduardo,9999,0,9999,0
1746534155477,CLRE 297,001,891888,Cuomo; Raphael Eduardo,9999,0,9999,0
1746534156506,CSE 191,A00,958773,Minnes Kemp; Mor Mia,9996,0,9999,3
1746534157536,CSE 197,001,959846,Minnes Kemp; Mor Mia,9993,0,9999,6
1746534158566,CSS 201S,A01,892054,Mignozzetti; Umberto,26,0,30,4
1746534159597,CSS 202S,A01,892056,Mignozzetti; Umberto,26,0,30,4
1746534160624,DSC 197,001,956898,Eldridge; Justin Matthew,9998,0,9999,1
1746534161651,DSC 297,001,958000,Mazumdar; Arya,9998,0,9999,1
1746534161651,DSC 297,002,959862,Wang; Yusu,9999,0,9999,0
1746534162679,EAP 100,A00,905686,Staff,9778,0,9999,221
1746534163707,ECE 45,A01,892618,Staff,0,0,65,65
1746534165768,ECE 111,A01,892719,Staff,4,0,65,61
1746534166798,ECE 197,001,957920,Mercier; Patrick Philip,9991,0,9999,8
1746534167827,ECON 178,A01,907814,Zhu; Ying,26,0,35,9
1746534168854,EDS 115,A00,895312,Staff,36,0,45,9
1746534169881,EDS 117,A01,895337,Staff,24,0,30,6
1746534170910,EDS 125,A00,895341,Jones; Gabrielle Anastasia,37,0,45,8
1746534171936,EDS 128A,A01,895459,Fargason; Sharon Gayle,44,0,45,1
1746534172962,EDS 128B,A01,895543,Pappas; Elizabeth,44,0,45,1
1746534173991,EDS 139,A00,897203,Pappas; Elizabeth,44,0,45,1
1746534173991,EDS 139,B00,897209,Fargason; Sharon Gayle,41,0,45,4
1746534175017,EDS 201,A00,895545,Staff,23,0,45,22
1746534176043,EDS 203,A01,895581,Halter; Christopher P.,23,0,45,22
1746534177068,EDS 204R,A01,895625,Heinzman; Erica M.,39,0,45,6
1746534177068,EDS 204R,B01,895693,Halter; Christopher P.,10,0,45,35
1746534178100,EDS 206R,A00,895694,Fargason; Sharon Gayle,1,0,30,29
1746534178100,EDS 206R,B00,895695,Choi; Bailey Miyeon,16,0,30,14
1746534179131,EDS 250,A00,895697,Hemans; Patricia Ann Benitez,23,0,45,22
1746534180158,EDS 281,A00,895701,Meyerott; Theresa Ann,1,0,15,14
1746534181185,EDS 284,A00,895736,Meyerott; Theresa Ann,1,0,15,14
1746534182212,EDS 286,A00,897210,Fine; Sarah,0,0,15,15
1746534183237,EDS 289C,A01,895770,Daly; Alan J.,15,0,15,0
1746534184266,EDS 290,A00,897211,Hofstetter; Carolyn,0,0,15,15
1746534185298,LIGM 5A,A00,896162,Fischer-Grunski; Eva K,13,0,20,7
1746534186328,LIGM 5B,A00,896260,Fischer-Grunski; Eva K,17,0,20,3
1746534187354,LIGM 5C,A00,896308,Fischer-Grunski; Eva K,18,0,20,2
1746534188385,LIIT 5AS,A00,896313,Carnelos; Chiara,18,0,20,2
1746534189414,LIIT 5BS,A00,896416,Carnelos; Chiara,20,0,20,0
1746534190443,LIIT 5CS,A00,896564,Carnelos; Chiara,20,0,20,0
1746534191475,LISP 5A,A00,896588,Munoz Sanchez; Alicia,3,0,20,17
1746534192501,LISP 5B,A00,896653,Munoz Sanchez; Alicia,7,0,20,13
1746534193533,LISP 5C,A00,896655,Munoz Sanchez; Alicia,0,1,20,20
1746534194562,MAE 197,001,957918,Kleissl; Jan,9996,0,9999,3
1746534194562,MAE 197,002,959806,Boechler; Nicholas Sebastia,9998,0,9999,1
1746534194562,MAE 197,003,959852,Mullin; Jennifer S,9999,0,9999,0
1746534195587,MATH 2,A01,957937,Staff,33,0,35,2
1746534196616,MATH 197,001,957876,Kedlaya; Kiran S.,9993,0,9999,6
1746534197643,MCWP 40,A00,892729,Duru; Nur,10,0,20,10
1746534197643,MCWP 40,B00,893304,Montejo; Carolina,14,0,20,6
1746534198671,MCWP 40R,A00,893757,Redela; Pamela Morgan,0,5,20,20
1746534199696,MCWP 50,A00,893758,Morshed; Michael James,0,0,20,20
1746534199696,MCWP 50,B00,893761,Bartulis; Jason Michael,17,0,20,3
1746534200724,MCWP 50R,A00,893766,Compas; Sean Matthew,0,1,20,20
1746534200724,MCWP 50R,B00,893769,Carter; Jennifer A,0,1,20,20
1746534200724,MCWP 50R,C00,893771,Krone; Jarret,0,3,20,20
1746534200724,MCWP 50R,D00,893772,Miller; Elizabeth Deen,0,0,20,20
1746534200724,MCWP 50R,E00,893775,Carter; Andrea L,0,1,20,20
1746534201750,MMW 11R,A01,892721,Herbst; Matthew,11,0,27,16
1746534201750,MMW 11R,A02,892722,Herbst; Matthew,0,0,0,3
1746534202780,MMW 12R,A01,892724,Herbst; Matthew,0,11,16,16
1746534202780,MMW 12R,A02,892725,Herbst; Matthew,0,10,16,16
1746534203806,MMW 13R,A01,892727,Staff,0,4,16,16
1746534203806,MMW 13R,A02,892728,Staff,0,4,16,16
1746534203806,MMW 13R,A03,958032,Staff,0,4,16,16
1746534203806,MMW 13R,A04,958033,Staff,0,4,16,16
1746534203806,MMW 13R,A05,958034,Staff,0,4,16,16
1746534204833,SIO 295LS,A00,894015,Staff,5,0,25,20
1746534205859,SIO 295S,A00,894020,Staff,5,0,25,20
1746534206884,SIOC 290S,B01,958918,Merrifield; Mark A,14,0,30,16
1746534207910,SIOC 291S,B01,958922,Gabriel; Corey John,14,0,30,16
1746534208936,SOCI 117,A01,895339,Staff,3,0,5,2
1746534209962,WES 237B,A00,894149,Staff,11,0,20,9
1746534212055,AESE 279B,A00,891859,Staff,13,0,35,22
1746534213084,AIP 197,001,891854,Vespa; Emanuel Ignacio,9999,0,9999,0
1746534214113,ANTH 289S,A00,891856,Gagneux; Pascal,12,0,12,0
1746534215139,BENG 196,001,957946,Engler; Adam J.,9996,0,9999,3
1746534216166,BISP 197,001,959851,Wilhelm; James E.,9999,0,9999,0
1746534217191,CAT 124RS,A01,956906,Staff,6,0,25,19
1746534218218,CAT 125RS,A01,922013,Staff,6,0,25,19
1746534219247,CLRE 250,A00,891860,Morris; Sheldon,9995,0,9999,4
1746534221304,CLRE 251R,A00,907817,Mehta; Ravindra L.,9994,0,9999,5
1746534222335,CLRE 252,A00,891864,Cuomo; Raphael Eduardo,9993,0,9999,6
1746534223361,CLRE 253,A00,891867,Vaida; Florin,9994,0,9999,5
1746534223361,CLRE 253,B00,907819,Staff,9999,0,9999,0
1746534224391,CLRE 259,A00,891868,Patel; Hemal,9998,0,9999,1
1746534225417,CLRE 260,A00,891872,Cuomo; Raphael Eduardo,9999,0,9999,0
1746534226447,CLRE 297,001,891888,Cuomo; Raphael Eduardo,9999,0,9999,0
1746534227528,CSE 191,A00,958773,Minnes Kemp; Mor Mia,9996,0,9999,3
1746534228555,CSE 197,001,959846,Minnes Kemp; Mor Mia,9993,0,9999,6
1746534229585,CSS 201S,A01,892054,Mignozzetti; Umberto,26,0,30,4
1746534230611,CSS 202S,A01,892056,Mignozzetti; Umberto,26,0,30,4
1746534231641,DSC 197,001,956898,Eldridge; Justin Matthew,9998,0,9999,1
1746534232666,DSC 297,001,958000,Mazumdar; Arya,9998,0,9999,1
1746534232666,DSC 297,002,959862,Wang; Yusu,9999,0,9999,0
1746534233692,EAP 100,A00,905686,Staff,9778,0,9999,221
1746534234723,ECE 45,A01,892618,Staff,0,0,65,65
1746534236783,ECE 111,A01,892719,Staff,4,0,65,61
1746534237810,ECE 197,001,957920,Mercier; Patrick Philip,9991,0,9999,8
1746534238839,ECON 178,A01,907814,Zhu; Ying,26,0,35,9
1746534239866,EDS 115,A00,895312,Staff,36,0,45,9
1746534240894,EDS 117,A01,895337,Staff,24,0,30,6
1746534241925,EDS 125,A00,895341,Jones; Gabrielle Anastasia,37,0,45,8
1746534242954,EDS 128A,A01,895459,Fargason; Sharon Gayle,44,0,45,1
1746534243982,EDS 128B,A01,895543,Pappas; Elizabeth,44,0,45,1
1746534245011,EDS 139,A00,897203,Pappas; Elizabeth,44,0,45,1
1746534245011,EDS 139,B00,897209,Fargason; Sharon Gayle,41,0,45,4
1746534246039,EDS 201,A00,895545,Staff,23,0,45,22
1746534247070,EDS 203,A01,895581,Halter; Christopher P.,23,0,45,22
1746534248097,EDS 204R,A01,895625,Heinzman; Erica M.,39,0,45,6
1746534248097,EDS 204R,B01,895693,Halter; Christopher P.,10,0,45,35
1746534249129,EDS 206R,A00,895694,Fargason; Sharon Gayle,1,0,30,29
1746534249129,EDS 206R,B00,895695,Choi; Bailey Miyeon,16,0,30,14
1746534250157,EDS 250,A00,895697,Hemans; Patricia Ann Benitez,23,0,45,22
1746534251183,EDS 281,A00,895701,Meyerott; Theresa Ann,1,0,15,14
1746534252213,EDS 284,A00,895736,Meyerott; Theresa Ann,1,0,15,14
1746534253241,EDS 286,A00,897210,Fine; Sarah,0,0,15,15
1746534254267,EDS 289C,A01,895770,Daly; Alan J.,15,0,15,0
1746534255294,EDS 290,A00,897211,Hofstetter; Carolyn,0,0,15,15
1746534256321,LIGM 5A,A00,896162,Fischer-Grunski; Eva K,13,0,20,7
1746534257351,LIGM 5B,A00,896260,Fischer-Grunski; Eva K,17,0,20,3
1746534258383,LIGM 5C,A00,896308,Fischer-Grunski; Eva K,18,0,20,2
1746534259413,LIIT 5AS,A00,896313,Carnelos; Chiara,18,0,20,2
1746534260444,LIIT 5BS,A00,896416,Carnelos; Chiara,20,0,20,0
1746534261471,LIIT 5CS,A00,896564,Carnelos; Chiara,20,0,20,0
1746534262498,LISP 5A,A00,896588,Munoz Sanchez; Alicia,3,0,20,17
1746534263527,LISP 5B,A00,896653,Munoz Sanchez; Alicia,7,0,20,13
1746534264558,LISP 5C,A00,896655,Munoz Sanchez; Alicia,0,1,20,20
1746534265587,MAE 197,001,957918,Kleissl; Jan,9996,0,9999,3
1746534265587,MAE 197,002,959806,Boechler; Nicholas Sebastia,9998,0,9999,1
1746534265587,MAE 197,003,959852,Mullin; Jennifer S,9999,0,9999,0
1746534266611,MATH 2,A01,957937,Staff,33,0,35,2
1746534267640,MATH 197,001,957876,Kedlaya; Kiran S.,9993,0,9999,6
1746534268668,MCWP 40,A00,892729,Duru; Nur,10,0,20,10
1746534268668,MCWP 40,B00,893304,Montejo; Carolina,14,0,20,6
1746534269700,MCWP 40R,A00,893757,Redela; Pamela Morgan,0,5,20,20
1746534270733,MCWP 50,A00,893758,Morshed; Michael James,0,0,20,20
1746534270733,MCWP 50,B00,893761,Bartulis; Jason Michael,17,0,20,3
1746534271767,MCWP 50R,A00,893766,Compas; Sean Matthew,0,1,20,20
1746534271767,MCWP 50R,B00,893769,Carter; Jennifer A,0,1,20,20
1746534271767,MCWP 50R,C00,893771,Krone; Jarret,0,3,20,20
1746534271767,MCWP 50R,D00,893772,Miller; Elizabeth Deen,0,0,20,20
1746534271767,MCWP 50R,E00,893775,Carter; Andrea L,0,1,20,20
1746534272800,MMW 11R,A01,892721,Herbst; Matthew,11,0,27,16
1746534272800,MMW 11R,A02,892722,Herbst; Matthew,0,0,0,3
1746534273830,MMW 12R,A01,892724,Herbst; Matthew,0,11,16,16
1746534273830,MMW 12R,A02,892725,Herbst; Matthew,0,10,16,16
1746534274863,MMW 13R,A01,892727,Staff,0,4,16,16
1746534274863,MMW 13R,A02,892728,Staff,0,4,16,16
1746534274863,MMW 13R,A03,958032,Staff,0,4,16,16
1746534274863,MMW 13R,A04,958033,Staff,0,4,16,16
1746534274863,MMW 13R,A05,958034,Staff,0,4,16,16
1746534275891,SIO 295LS,A00,894015,Staff,5,0,25,20
1746534276922,SIO 295S,A00,894020,Staff,5,0,25,20
1746534277948,SIOC 290S,B01,958918,Merrifield; Mark A,14,0,30,16
1746534278975,SIOC 291S,B01,958922,Gabriel; Corey John,14,0,30,16
1746534280002,SOCI 117,A01,895339,Staff,3,0,5,2
1746534281030,WES 237B,A00,894149,Staff,11,0,20,9
1746534283114,AESE 279B,A00,891859,Staff,13,0,35,22
1746534284142,AIP 197,001,891854,Vespa; Emanuel Ignacio,9999,0,9999,0
1746534285168,ANTH 289S,A00,891856,Gagneux; Pascal,12,0,12,0
1746534286194,BENG 196,001,957946,Engler; Adam J.,9996,0,9999,3
1746534287222,BISP 197,001,959851,Wilhelm; James E.,9999,0,9999,0
1746534288249,CAT 124RS,A01,956906,Staff,6,0,25,19
1746534289275,CAT 125RS,A01,922013,Staff,6,0,25,19
1746534290304,CLRE 250,A00,891860,Morris; Sheldon,9995,0,9999,4
1746534292364,CLRE 251R,A00,907817,Mehta; Ravindra L.,9994,0,9999,5
1746534293392,CLRE 252,A00,891864,Cuomo; Raphael Eduardo,9993,0,9999,6
1746534294426,CLRE 253,A00,891867,Vaida; Florin,9994,0,9999,5
1746534294426,CLRE 253,B00,907819,Staff,9999,0,9999,0
1746534295457,CLRE 259,A00,891868,Patel; Hemal,9998,0,9999,1
1746534296484,CLRE 260,A00,891872,Cuomo; Raphael Eduardo,9999,0,9999,0
1746534297516,CLRE 297,001,891888,Cuomo; Raphael Eduardo,9999,0,9999,0
1746534298548,CSE 191,A00,958773,Minnes Kemp; Mor Mia,9996,0,9999,3
1746534299576,CSE 197,001,959846,Minnes Kemp; Mor Mia,9993,0,9999,6
1746534300603,CSS 201S,A01,892054,Mignozzetti; Umberto,26,0,30,4
1746534301633,CSS 202S,A01,892056,Mignozzetti; Umberto,26,0,30,4
1746534302661,DSC 197,001,956898,Eldridge; Justin Matthew,9998,0,9999,1
1746534303694,DSC 297,001,958000,Mazumdar; Arya,9998,0,9999,1
1746534303694,DSC 297,002,959862,Wang; Yusu,9999,0,9999,0
1746534304722,EAP 100,A00,905686,Staff,9778,0,9999,221
1746534305750,ECE 45,A01,892618,Staff,0,0,65,65
1746534307805,ECE 111,A01,892719,Staff,4,0,65,61
1746534308837,ECE 197,001,957920,Mercier; Patrick Philip,9991,0,9999,8
1746534309865,ECON 178,A01,907814,Zhu; Ying,26,0,35,9
1746534310893,EDS 115,A00,895312,Staff,36,0,45,9
1746534311922,EDS 117,A01,895337,Staff,24,0,30,6
1746534312953,EDS 125,A00,895341,Jones; Gabrielle Anastasia,37,0,45,8
1746534313981,EDS 128A,A01,895459,Fargason; Sharon Gayle,44,0,45,1
1746534315008,EDS 128B,A01,895543,Pappas; Elizabeth,44,0,45,1
1746534316036,EDS 139,A00,897203,Pappas; Elizabeth,44,0,45,1
1746534316036,EDS 139,B00,897209,Fargason; Sharon Gayle,41,0,45,4
1746534317066,EDS 201,A00,895545,Staff,23,0,45,22
1746534318099,EDS 203,A01,895581,Halter; Christopher P.,23,0,45,22
1746534319129,EDS 204R,A01,895625,Heinzman; Erica M.,39,0,45,6
1746534319129,EDS 204R,B01,895693,Halter; Christopher P.,10,0,45,35
1746534320156,EDS 206R,A00,895694,Fargason; Sharon Gayle,1,0,30,29
1746534320156,EDS 206R,B00,895695,Choi; Bailey Miyeon,16,0,30,14
1746534321186,EDS 250,A00,895697,Hemans; Patricia Ann Benitez,23,0,45,22
1746534322214,EDS 281,A00,895701,Meyerott; Theresa Ann,1,0,15,14
1746534323240,EDS 284,A00,895736,Meyerott; Theresa Ann,1,0,15,14
1746534324265,EDS 286,A00,897210,Fine; Sarah,0,0,15,15
1746534325291,EDS 289C,A01,895770,Daly; Alan J.,15,0,15,0
1746534326322,EDS 290,A00,897211,Hofstetter; Carolyn,0,0,15,15
1746534327350,LIGM 5A,A00,896162,Fischer-Grunski; Eva K,13,0,20,7
1746534328381,LIGM 5B,A00,896260,Fischer-Grunski; Eva K,17,0,20,3
1746534329408,LIGM 5C,A00,896308,Fischer-Grunski; Eva K,18,0,20,2
1746534330435,LIIT 5AS,A00,896313,Carnelos; Chiara,18,0,20,2
1746534331502,LIIT 5BS,A00,896416,Carnelos; Chiara,20,0,20,0
1746534332530,LIIT 5CS,A00,896564,Carnelos; Chiara,20,0,20,0
1746534333556,LISP 5A,A00,896588,Munoz Sanchez; Alicia,3,0,20,17
1746534334580,LISP 5B,A00,896653,Munoz Sanchez; Alicia,7,0,20,13
1746534335607,LISP 5C,A00,896655,Munoz Sanchez; Alicia,0,1,20,20
1746534336633,MAE 197,001,957918,Kleissl; Jan,9996,0,9999,3
1746534336633,MAE 197,002,959806,Boechler; Nicholas Sebastia,9998,0,9999,1
1746534336633,MAE 197,003,959852,Mullin; Jennifer S,9999,0,9999,0
1746534337659,MATH 2,A01,957937,Staff,33,0,35,2
1746534338686,MATH 197,001,957876,Kedlaya; Kiran S.,9993,0,9999,6
1746534339715,MCWP 40,A00,892729,Duru; Nur,10,0,20,10
1746534339715,MCWP 40,B00,893304,Montejo; Carolina,14,0,20,6
1746534340742,MCWP 40R,A00,893757,Redela; Pamela Morgan,0,5,20,20
1746534341769,MCWP 50,A00,893758,Morshed; Michael James,0,0,20,20
1746534341769,MCWP 50,B00,893761,Bartulis; Jason Michael,17,0,20,3
1746534342797,MCWP 50R,A00,893766,Compas; Sean Matthew,0,1,20,20
1746534342797,MCWP 50R,B00,893769,Carter; Jennifer A,0,1,20,20
1746534342797,MCWP 50R,C00,893771,Krone; Jarret,0,3,20,20
1746534342797,MCWP 50R,D00,893772,Miller; Elizabeth Deen,0,0,20,20
1746534342797,MCWP 50R,E00,893775,Carter; Andrea L,0,1,20,20
1746534343829,MMW 11R,A01,892721,Herbst; Matthew,11,0,27,16
1746534343829,MMW 11R,A02,892722,Herbst; Matthew,0,0,0,3
1746534344854,MMW 12R,A01,892724,Herbst; Matthew,0,11,16,16
1746534344854,MMW 12R,A02,892725,Herbst; Matthew,0,10,16,16
1746534345880,MMW 13R,A01,892727,Staff,0,4,16,16
1746534345880,MMW 13R,A02,892728,Staff,0,4,16,16
1746534345880,MMW 13R,A03,958032,Staff,0,4,16,16
1746534345880,MMW 13R,A04,958033,Staff,0,4,16,16
1746534345880,MMW 13R,A05,958034,Staff,0,4,16,16
1746534346906,SIO 295LS,A00,894015,Staff,5,0,25,20
1746534347934,SIO 295S,A00,894020,Staff,5,0,25,20
1746534348960,SIOC 290S,B01,958918,Merrifield; Mark A,14,0,30,16
1746534350011,SIOC 291S,B01,958922,Gabriel; Corey John,14,0,30,16
1746534351037,SOCI 117,A01,895339,Staff,3,0,5,2
1746534352064,WES 237B,A00,894149,Staff,11,0,20,9
1746534354174,AESE 279B,A00,891859,Staff,13,0,35,22
1746534355199,AIP 197,001,891854,Vespa; Emanuel Ignacio,9999,0,9999,0
1746534356226,ANTH 289S,A00,891856,Gagneux; Pascal,12,0,12,0
1746534357252,BENG 196,001,957946,Engler; Adam J.,9996,0,9999,3
1746534358280,BISP 197,001,959851,Wilhelm; James E.,9999,0,9999,0
1746534359306,CAT 124RS,A01,956906,Staff,6,0,25,19
1746534360336,CAT 125RS,A01,922013,Staff,6,0,25,19
1746534361365,CLRE 250,A00,891860,Morris; Sheldon,9995,0,9999,4
1746534363438,CLRE 251R,A00,907817,Mehta; Ravindra L.,9994,0,9999,5
1746534364463,CLRE 252,A00,891864,Cuomo; Raphael Eduardo,9993,0,9999,6
1746534365490,CLRE 253,A00,891867,Vaida; Florin,9994,0,9999,5
1746534365490,CLRE 253,B00,907819,Staff,9999,0,9999,0
1746534366520,CLRE 259,A00,891868,Patel; Hemal,9998,0,9999,1
1746534367548,CLRE 260,A00,891872,Cuomo; Raphael Eduardo,9999,0,9999,0
1746534368576,CLRE 297,001,891888,Cuomo; Raphael Eduardo,9999,0,9999,0
1746534369604,CSE 191,A00,958773,Minnes Kemp; Mor Mia,9996,0,9999,3
1746534370630,CSE 197,001,959846,Minnes Kemp; Mor Mia,9993,0,9999,6
1746534371658,CSS 201S,A01,892054,Mignozzetti; Umberto,26,0,30,4
1746534372687,CSS 202S,A01,892056,Mignozzetti; Umberto,26,0,30,4
1746534373713,DSC 197,001,956898,Eldridge; Justin Matthew,9998,0,9999,1
1746534374738,DSC 297,001,958000,Mazumdar; Arya,9998,0,9999,1
1746534374738,DSC 297,002,959862,Wang; Yusu,9999,0,9999,0
1746534375765,EAP 100,A00,905686,Staff,9778,0,9999,221
1746534376795,ECE 45,A01,892618,Staff,0,0,65,65
1746534378856,ECE 111,A01,892719,Staff,4,0,65,61
1746534379882,ECE 197,001,957920,Mercier; Patrick Philip,9991,0,9999,8
1746534380914,ECON 178,A01,907814,Zhu; Ying,26,0,35,9
1746534381942,EDS 115,A00,895312,Staff,36,0,45,9
1746534382966,EDS 117,A01,895337,Staff,24,0,30,6
1746534383997,EDS 125,A00,895341,Jones; Gabrielle Anastasia,37,0,45,8
1746534385024,EDS 128A,A01,895459,Fargason; Sharon Gayle,44,0,45,1
1746534386064,EDS 128B,A01,895543,Pappas; Elizabeth,44,0,45,1
1746534387092,EDS 139,A00,897203,Pappas; Elizabeth,44,0,45,1
1746534387092,EDS 139,B00,897209,Fargason; Sharon Gayle,41,0,45,4
1746534388118,EDS 201,A00,895545,Staff,23,0,45,22
1746534389143,EDS 203,A01,895581,Halter; Christopher P.,23,0,45,22
1746534390170,EDS 204R,A01,895625,Heinzman; Erica M.,39,0,45,6
1746534390170,EDS 204R,B01,895693,Halter; Christopher P.,10,0,45,35
1746534391196,EDS 206R,A00,895694,Fargason; Sharon Gayle,1,0,30,29
1746534391196,EDS 206R,B00,895695,Choi; Bailey Miyeon,16,0,30,14
1746534392227,EDS 250,A00,895697,Hemans; Patricia Ann Benitez,23,0,45,22
1746534393258,EDS 281,A00,895701,Meyerott; Theresa Ann,1,0,15,14
1746534394282,EDS 284,A00,895736,Meyerott; Theresa Ann,1,0,15,14
1746534395307,EDS 286,A00,897210,Fine; Sarah,0,0,15,15
1746534396332,EDS 289C,A01,895770,Daly; Alan J.,15,0,15,0
1746534397358,EDS 290,A00,897211,Hofstetter; Carolyn,0,0,15,15
1746534398389,LIGM 5A,A00,896162,Fischer-Grunski; Eva K,13,0,20,7
1746534399416,LIGM 5B,A00,896260,Fischer-Grunski; Eva K,17,0,20,3
1746534400444,LIGM 5C,A00,896308,Fischer-Grunski; Eva K,18,0,20,2
1746534401475,LIIT 5AS,A00,896313,Carnelos; Chiara,18,0,20,2
1746534402502,LIIT 5BS,A00,896416,Carnelos; Chiara,20,0,20,0
1746534403533,LIIT 5CS,A00,896564,Carnelos; Chiara,20,0,20,0
1746534404561,LISP 5A,A00,896588,Munoz Sanchez; Alicia,3,0,20,17
1746534405586,LISP 5B,A00,896653,Munoz Sanchez; Alicia,7,0,20,13
1746534406613,LISP 5C,A00,896655,Munoz Sanchez; Alicia,0,1,20,20
1746534407646,MAE 197,001,957918,Kleissl; Jan,9996,0,9999,3
1746534407646,MAE 197,002,959806,Boechler; Nicholas Sebastia,9998,0,9999,1
1746534407646,MAE 197,003,959852,Mullin; Jennifer S,9999,0,9999,0
1746534408672,MATH 2,A01,957937,Staff,33,0,35,2
1746534409701,MATH 197,001,957876,Kedlaya; Kiran S.,9993,0,9999,6
1746534410729,MCWP 40,A00,892729,Duru; Nur,10,0,20,10
1746534410729,MCWP 40,B00,893304,Montejo; Carolina,14,0,20,6
1746534411755,MCWP 40R,A00,893757,Redela; Pamela Morgan,0,5,20,20
1746534412784,MCWP 50,A00,893758,Morshed; Michael James,0,0,20,20
1746534412784,MCWP 50,B00,893761,Bartulis; Jason Michael,17,0,20,3
1746534413811,MCWP 50R,A00,893766,Compas; Sean Matthew,0,1,20,20
1746534413811,MCWP 50R,B00,893769,Carter; Jennifer A,0,1,20,20
1746534413811,MCWP 50R,C00,893771,Krone; Jarret,0,3,20,20
1746534413811,MCWP 50R,D00,893772,Miller; Elizabeth Deen,0,0,20,20
1746534413811,MCWP 50R,E00,893775,Carter; Andrea L,0,1,20,20
1746534414835,MMW 11R,A01,892721,Herbst; Matthew,11,0,27,16
1746534414835,MMW 11R,A02,892722,Herbst; Matthew,0,0,0,3
1746534415861,MMW 12R,A01,892724,Herbst; Matthew,0,11,16,16
1746534415861,MMW 12R,A02,892725,Herbst; Matthew,0,10,16,16
1746534416887,MMW 13R,A01,892727,Staff,0,4,16,16
1746534416887,MMW 13R,A02,892728,Staff,0,4,16,16
1746534416887,MMW 13R,A03,958032,Staff,0,4,16,16
1746534416887,MMW 13R,A04,958033,Staff,0,4,16,16
1746534416887,MMW 13R,A05,958034,Staff,0,4,16,16
1746534417912,SIO 295LS,A00,894015,Staff,5,0,25,20
1746534418940,SIO 295S,A00,894020,Staff,5,0,25,20
1746534419968,SIOC 290S,B01,958918,Merrifield; Mark A,14,0,30,16
1746534420996,SIOC 291S,B01,958922,Gabriel; Corey John,14,0,30,16
1746534422023,SOCI 117,A01,895339,Staff,3,0,5,2
1746534423054,WES 237B,A00,894149,Staff,11,0,20,9
1746534425133,AESE 279B,A00,891859,Staff,13,0,35,22
1746534426162,AIP 197,001,891854,Vespa; Emanuel Ignacio,9999,0,9999,0
1746534427189,ANTH 289S,A00,891856,Gagneux; Pascal,12,0,12,0
1746534428219,BENG 196,001,957946,Engler; Adam J.,9996,0,9999,3
1746534429246,BISP 197,001,959851,Wilhelm; James E.,9999,0,9999,0
1746534430274,CAT 124RS,A01,956906,Staff,6,0,25,19
1746534431302,CAT 125RS,A01,922013,Staff,6,0,25,19
1746534432328,CLRE 250,A00,891860,Morris; Sheldon,9995,0,9999,4
1746534434380,CLRE 251R,A00,907817,Mehta; Ravindra L.,9994,0,9999,5
1746534435666,CLRE 252,A00,891864,Cuomo; Raphael Eduardo,9993,0,9999,6
1746534436696,CLRE 253,A00,891867,Vaida; Florin,9994,0,9999,5
1746534436696,CLRE 253,B00,907819,Staff,9999,0,9999,0
1746534437726,CLRE 259,A00,891868,Patel; Hemal,9998,0,9999,1
1746534438758,CLRE 260,A00,891872,Cuomo; Raphael Eduardo,9999,0,9999,0
1746534439784,CLRE 297,001,891888,Cuomo; Raphael Eduardo,9999,0,9999,0
1746534440811,CSE 191,A00,958773,Minnes Kemp; Mor Mia,9996,0,9999,3
1746534441839,CSE 197,001,959846,Minnes Kemp; Mor Mia,9993,0,9999,6
1746534442871,CSS 201S,A01,892054,Mignozzetti; Umberto,26,0,30,4
1746534443900,CSS 202S,A01,892056,Mignozzetti; Umberto,26,0,30,4
1746534444924,DSC 197,001,956898,Eldridge; Justin Matthew,9998,0,9999,1
1746534445950,DSC 297,001,958000,Mazumdar; Arya,9998,0,9999,1
1746534445950,DSC 297,002,959862,Wang; Yusu,9999,0,9999,0
1746534446977,EAP 100,A00,905686,Staff,9778,0,9999,221
1746534448005,ECE 45,A01,892618,Staff,0,0,65,65
1746534450065,ECE 111,A01,892719,Staff,4,0,65,61
1746534451092,ECE 197,001,957920,Mercier; Patrick Philip,9991,0,9999,8
1746534452119,ECON 178,A01,907814,Zhu; Ying,26,0,35,9
1746534453149,EDS 115,A00,895312,Staff,36,0,45,9
1746534454175,EDS 117,A01,895337,Staff,24,0,30,6
1746534455201,EDS 125,A00,895341,Jones; Gabrielle Anastasia,37,0,45,8
1746534456226,EDS 128A,A01,895459,Fargason; Sharon Gayle,44,0,45,1
1746534457254,EDS 128B,A01,895543,Pappas; Elizabeth,44,0,45,1
1746534458282,EDS 139,A00,897203,Pappas; Elizabeth,44,0,45,1
1746534458282,EDS 139,B00,897209,Fargason; Sharon Gayle,41,0,45,4
1746534459308,EDS 201,A00,895545,Staff,23,0,45,22
1746534460335,EDS 203,A01,895581,Halter; Christopher P.,23,0,45,22
1746534461365,EDS 204R,A01,895625,Heinzman; Erica M.,39,0,45,6
1746534461365,EDS 204R,B01,895693,Halter; Christopher P.,10,0,45,35
1746534462404,EDS 206R,A00,895694,Fargason; Sharon Gayle,1,0,30,29
1746534462404,EDS 206R,B00,895695,Choi; Bailey Miyeon,16,0,30,14
1746534463431,EDS 250,A00,895697,Hemans; Patricia Ann Benitez,23,0,45,22
1746534464462,EDS 281,A00,895701,Meyerott; Theresa Ann,1,0,15,14
1746534465489,EDS 284,A00,895736,Meyerott; Theresa Ann,1,0,15,14
1746534466517,EDS 286,A00,897210,Fine; Sarah,0,0,15,15
1746534467547,EDS 289C,A01,895770,Daly; Alan J.,15,0,15,0
1746534468574,EDS 290,A00,897211,Hofstetter; Carolyn,0,0,15,15
1746534469603,LIGM 5A,A00,896162,Fischer-Grunski; Eva K,13,0,20,7
1746534470633,LIGM 5B,A00,896260,Fischer-Grunski; Eva K,17,0,20,3
1746534471660,LIGM 5C,A00,896308,Fischer-Grunski; Eva K,18,0,20,2
1746534472688,LIIT 5AS,A00,896313,Carnelos; Chiara,18,0,20,2
1746534473717,LIIT 5BS,A00,896416,Carnelos; Chiara,20,0,20,0
1746534474745,LIIT 5CS,A00,896564,Carnelos; Chiara,20,0,20,0
1746534475771,LISP 5A,A00,896588,Munoz Sanchez; Alicia,3,0,20,17
1746534476799,LISP 5B,A00,896653,Munoz Sanchez; Alicia,7,0,20,13
1746534477825,LISP 5C,A00,896655,Munoz Sanchez; Alicia,0,1,20,20
1746534478857,MAE 197,001,957918,Kleissl; Jan,9996,0,9999,3
1746534478857,MAE 197,002,959806,Boechler; Nicholas Sebastia,9998,0,9999,1
1746534478857,MAE 197,003,959852,Mullin; Jennifer S,9999,0,9999,0
1746534479884,MATH 2,A01,957937,Staff,33,0,35,2
1746534480914,MATH 197,001,957876,Kedlaya; Kiran S.,9993,0,9999,6
1746534481942,MCWP 40,A00,892729,Duru; Nur,10,0,20,10
1746534481942,MCWP 40,B00,893304,Montejo; Carolina,14,0,20,6
1746534482970,MCWP 40R,A00,893757,Redela; Pamela Morgan,0,5,20,20
1746534483999,MCWP 50,A00,893758,Morshed; Michael James,0,0,20,20
1746534483999,MCWP 50,B00,893761,Bartulis; Jason Michael,17,0,20,3
1746534485025,MCWP 50R,A00,893766,Compas; Sean Matthew,0,1,20,20
1746534485025,MCWP 50R,B00,893769,Carter; Jennifer A,0,1,20,20
1746534485025,MCWP 50R,C00,893771,Krone; Jarret,0,3,20,20
1746534485025,MCWP 50R,D00,893772,Miller; Elizabeth Deen,0,0,20,20
1746534485025,MCWP 50R,E00,893775,Carter; Andrea L,0,1,20,20
1746534486051,MMW 11R,A01,892721,Herbst; Matthew,11,0,27,16
1746534486051,MMW 11R,A02,892722,Herbst; Matthew,0,0,0,3
1746534487078,MMW 12R,A01,892724,Herbst; Matthew,0,11,16,16
1746534487078,MMW 12R,A02,892725,Herbst; Matthew,0,10,16,16
1746534488105,MMW 13R,A01,892727,Staff,0,4,16,16
1746534488105,MMW 13R,A02,892728,Staff,0,4,16,16
1746534488105,MMW 13R,A03,958032,Staff,0,4,16,16
1746534488105,MMW 13R,A04,958033,Staff,0,4,16,16
1746534488105,MMW 13R,A05,958034,Staff,0,4,16,16
1746534489130,SIO 295LS,A00,894015,Staff,5,0,25,20
1746534490157,SIO 295S,A00,894020,Staff,5,0,25,20
1746534491188,SIOC 290S,B01,958918,Merrifield; Mark A,14,0,30,16
1746534492221,SIOC 291S,B01,958922,Gabriel; Corey John,14,0,30,16
1746534493245,SOCI 117,A01,895339,Staff,3,0,5,2
1746534494272,WES 237B,A00,894149,Staff,11,0,20,9
1746534496339,AESE 279B,A00,891859,Staff,13,0,35,22
1746534497365,AIP 197,001,891854,Vespa; Emanuel Ignacio,9999,0,9999,0
1746534498392,ANTH 289S,A00,891856,Gagneux; Pascal,12,0,12,0
1746534499420,BENG 196,001,957946,Engler; Adam J.,9996,0,9999,3
1746534500447,BISP 197,001,959851,Wilhelm; James E.,9999,0,9999,0
1746534501477,CAT 124RS,A01,956906,Staff,6,0,25,19
1746534502511,CAT 125RS,A01,922013,Staff,6,0,25,19
1746534503538,CLRE 250,A00,891860,Morris; Sheldon,9995,0,9999,4
1746534505627,CLRE 251R,A00,907817,Mehta; Ravindra L.,9994,0,9999,5
1746534506652,CLRE 252,A00,891864,Cuomo; Raphael Eduardo,9993,0,9999,6
1746534507680,CLRE 253,A00,891867,Vaida; Florin,9994,0,9999,5
1746534507680,CLRE 253,B00,907819,Staff,9999,0,9999,0
1746534508706,CLRE 259,A00,891868,Patel; Hemal,9998,0,9999,1
1746534509733,CLRE 260,A00,891872,Cuomo; Raphael Eduardo,9999,0,9999,0
1746534510760,CLRE 297,001,891888,Cuomo; Raphael Eduardo,9999,0,9999,0
1746534511790,CSE 191,A00,958773,Minnes Kemp; Mor Mia,9996,0,9999,3
1746534512815,CSE 197,001,959846,Minnes Kemp; Mor Mia,9993,0,9999,6
1746534513855,CSS 201S,A01,892054,Mignozzetti; Umberto,26,0,30,4
1746534514880,CSS 202S,A01,892056,Mignozzetti; Umberto,26,0,30,4
1746534515905,DSC 197,001,956898,Eldridge; Justin Matthew,9998,0,9999,1
1746534516933,DSC 297,001,958000,Mazumdar; Arya,9998,0,9999,1
1746534516933,DSC 297,002,959862,Wang; Yusu,9999,0,9999,0
1746534517964,EAP 100,A00,905686,Staff,9778,0,9999,221
1746534518992,ECE 45,A01,892618,Staff,0,0,65,65
1746534521045,ECE 111,A01,892719,Staff,4,0,65,61
1746534522070,ECE 197,001,957920,Mercier; Patrick Philip,9991,0,9999,8
1746534523096,ECON 178,A01,907814,Zhu; Ying,26,0,35,9
1746534524124,EDS 115,A00,895312,Staff,36,0,45,9
1746534525155,EDS 117,A01,895337,Staff,24,0,30,6
1746534526184,EDS 125,A00,895341,Jones; Gabrielle Anastasia,37,0,45,8
1746534527210,EDS 128A,A01,895459,Fargason; Sharon Gayle,44,0,45,1
1746534528240,EDS 128B,A01,895543,Pappas; Elizabeth,44,0,45,1
1746534529266,EDS 139,A00,897203,Pappas; Elizabeth,44,0,45,1
1746534529266,EDS 139,B00,897209,Fargason; Sharon Gayle,41,0,45,4
1746534530298,EDS 201,A00,895545,Staff,23,0,45,22
1746534531325,EDS 203,A01,895581,Halter; Christopher P.,23,0,45,22
1746534532357,EDS 204R,A01,895625,Heinzman; Erica M.,39,0,45,6
1746534532357,EDS 204R,B01,895693,Halter; Christopher P.,10,0,45,35
1746534533385,EDS 206R,A00,895694,Fargason; Sharon Gayle,1,0,30,29
1746534533385,EDS 206R,B00,895695,Choi; Bailey Miyeon,16,0,30,14
1746534534410,EDS 250,A00,895697,Hemans; Patricia Ann Benitez,23,0,45,22
1746534535440,EDS 281,A00,895701,Meyerott; Theresa Ann,1,0,15,14
1746534536466,EDS 284,A00,895736,Meyerott; Theresa Ann,1,0,15,14
1746534537493,EDS 286,A00,897210,Fine; Sarah,0,0,15,15
1746534538520,EDS 289C,A01,895770,Daly; Alan J.,15,0,15,0
1746534539547,EDS 290,A00,897211,Hofstetter; Carolyn,0,0,15,15
1746534540574,LIGM 5A,A00,896162,Fischer-Grunski; Eva K,13,0,20,7
1746534541609,LIGM 5B,A00,896260,Fischer-Grunski; Eva K,17,0,20,3
1746534542636,LIGM 5C,A00,896308,Fischer-Grunski; Eva K,18,0,20,2
1746534543666,LIIT 5AS,A00,896313,Carnelos; Chiara,18,0,20,2
1746534544698,LIIT 5BS,A00,896416,Carnelos; Chiara,20,0,20,0
1746534545730,LIIT 5CS,A00,896564,Carnelos; Chiara,20,0,20,0
1746534546757,LISP 5A,A00,896588,Munoz Sanchez; Alicia,3,0,20,17
1746534547785,LISP 5B,A00,896653,Munoz Sanchez; Alicia,7,0,20,13
1746534548813,LISP 5C,A00,896655,Munoz Sanchez; Alicia,0,1,20,20
1746534549840,MAE 197,001,957918,Kleissl; Jan,9996,0,9999,3
1746534549840,MAE 197,002,959806,Boechler; Nicholas Sebastia,9998,0,9999,1
1746534549840,MAE 197,003,959852,Mullin; Jennifer S,9999,0,9999,0
1746534550868,MATH 2,A01,957937,Staff,33,0,35,2
1746534551899,MATH 197,001,957876,Kedlaya; Kiran S.,9993,0,9999,6
1746534552931,MCWP 40,A00,892729,Duru; Nur,10,0,20,10
1746534552931,MCWP 40,B00,893304,Montejo; Carolina,14,0,20,6
1746534553958,MCWP 40R,A00,893757,Redela; Pamela Morgan,0,5,20,20
1746534554987,MCWP 50,A00,893758,Morshed; Michael James,0,0,20,20
1746534554987,MCWP 50,B00,893761,Bartulis; Jason Michael,17,0,20,3
1746534556014,MCWP 50R,A00,893766,Compas; Sean Matthew,0,1,20,20
1746534556014,MCWP 50R,B00,893769,Carter; Jennifer A,0,1,20,20
1746534556014,MCWP 50R,C00,893771,Krone; Jarret,0,3,20,20
1746534556014,MCWP 50R,D00,893772,Miller; Elizabeth Deen,0,0,20,20
1746534556014,MCWP 50R,E00,893775,Carter; Andrea L,0,1,20,20
1746534557043,MMW 11R,A01,892721,Herbst; Matthew,11,0,27,16
1746534557043,MMW 11R,A02,892722,Herbst; Matthew,0,0,0,3
1746534558069,MMW 12R,A01,892724,Herbst; Matthew,0,11,16,16
1746534558069,MMW 12R,A02,892725,Herbst; Matthew,0,10,16,16
1746534559093,MMW 13R,A01,892727,Staff,0,4,16,16
1746534559093,MMW 13R,A02,892728,Staff,0,4,16,16
1746534559093,MMW 13R,A03,958032,Staff,0,4,16,16
1746534559093,MMW 13R,A04,958033,Staff,0,4,16,16
1746534559093,MMW 13R,A05,958034,Staff,0,4,16,16
1746534560122,SIO 295LS,A00,894015,Staff,5,0,25,20
1746534561151,SIO 295S,A00,894020,Staff,5,0,25,20
1746534562180,SIOC 290S,B01,958918,Merrifield; Mark A,14,0,30,16
1746534563209,SIOC 291S,B01,958922,Gabriel; Corey John,14,0,30,16
1746534564241,SOCI 117,A01,895339,Staff,3,0,5,2
1746534565265,WES 237B,A00,894149,Staff,11,0,20,9
1746534567351,AESE 279B,A00,891859,Staff,13,0,35,22
1746534568380,AIP 197,001,891854,Vespa; Emanuel Ignacio,9999,0,9999,0
1746534569407,ANTH 289S,A00,891856,Gagneux; Pascal,12,0,12,0
1746534570436,BENG 196,001,957946,Engler; Adam J.,9996,0,9999,3
1746534571464,BISP 197,001,959851,Wilhelm; James E.,9999,0,9999,0
1746534572493,CAT 124RS,A01,956906,Staff,6,0,25,19
1746534573519,CAT 125RS,A01,922013,Staff,6,0,25,19
1746534574545,CLRE 250,A00,891860,Morris; Sheldon,9995,0,9999,4
1746534576599,CLRE 251R,A00,907817,Mehta; Ravindra L.,9994,0,9999,5
1746534577625,CLRE 252,A00,891864,Cuomo; Raphael Eduardo,9993,0,9999,6
1746534578656,CLRE 253,A00,891867,Vaida; Florin,9994,0,9999,5
1746534578656,CLRE 253,B00,907819,Staff,9999,0,9999,0
1746534579683,CLRE 259,A00,891868,Patel; Hemal,9998,0,9999,1
1746534580712,CLRE 260,A00,891872,Cuomo; Raphael Eduardo,9999,0,9999,0
1746534581741,CLRE 297,001,891888,Cuomo; Raphael Eduardo,9999,0,9999,0
1746534582769,CSE 191,A00,958773,Minnes Kemp; Mor Mia,9996,0,9999,3
1746534583795,CSE 197,001,959846,Minnes Kemp; Mor Mia,9993,0,9999,6
1746534584825,CSS 201S,A01,892054,Mignozzetti; Umberto,26,0,30,4
1746534585858,CSS 202S,A01,892056,Mignozzetti; Umberto,26,0,30,4
1746534586888,DSC 197,001,956898,Eldridge; Justin Matthew,9998,0,9999,1
1746534587918,DSC 297,001,958000,Mazumdar; Arya,9998,0,9999,1
1746534587918,DSC 297,002,959862,Wang; Yusu,9999,0,9999,0
1746534588945,EAP 100,A00,905686,Staff,9778,0,9999,221
1746534589988,ECE 45,A01,892618,Staff,0,0,65,65
1746534592042,ECE 111,A01,892719,Staff,4,0,65,61
1746534593069,ECE 197,001,957920,Mercier; Patrick Philip,9991,0,9999,8
1746534594100,ECON 178,A01,907814,Zhu; Ying,26,0,35,9
1746534595127,EDS 115,A00,895312,Staff,36,0,45,9
1746534596154,EDS 117,A01,895337,Staff,24,0,30,6
1746534597181,EDS 125,A00,895341,Jones; Gabrielle Anastasia,37,0,45,8
1746534598210,EDS 128A,A01,895459,Fargason; Sharon Gayle,44,0,45,1
1746534599240,EDS 128B,A01,895543,Pappas; Elizabeth,44,0,45,1
1746534600270,EDS 139,A00,897203,Pappas; Elizabeth,44,0,45,1
1746534600270,EDS 139,B00,897209,Fargason; Sharon Gayle,41,0,45,4
1746534601297,EDS 201,A00,895545,Staff,23,0,45,22
1746534602327,EDS 203,A01,895581,Halter; Christopher P.,23,0,45,22
1746534603363,EDS 204R,A01,895625,Heinzman; Erica M.,39,0,45,6
1746534603363,EDS 204R,B01,895693,Halter; Christopher P.,10,0,45,35
1746534604393,EDS 206R,A00,895694,Fargason; Sharon Gayle,1,0,30,29
1746534604393,EDS 206R,B00,895695,Choi; Bailey Miyeon,16,0,30,14
1746534605418,EDS 250,A00,895697,Hemans; Patricia Ann Benitez,23,0,45,22
1746534606445,EDS 281,A00,895701,Meyerott; Theresa Ann,1,0,15,14
1746534607471,EDS 284,A00,895736,Meyerott; Theresa Ann,1,0,15,14
1746534608498,EDS 286,A00,897210,Fine; Sarah,0,0,15,15
1746534609566,EDS 289C,A01,895770,Daly; Alan J.,15,0,15,0
1746534610598,EDS 290,A00,897211,Hofstetter; Carolyn,0,0,15,15
1746534611625,LIGM 5A,A00,896162,Fischer-Grunski; Eva K,13,0,20,7
1746534612652,LIGM 5B,A00,896260,Fischer-Grunski; Eva K,17,0,20,3
1746534613678,LIGM 5C,A00,896308,Fischer-Grunski; Eva K,18,0,20,2
1746534614707,LIIT 5AS,A00,896313,Carnelos; Chiara,18,0,20,2
1746534615734,LIIT 5BS,A00,896416,Carnelos; Chiara,20,0,20,0
1746534616761,LIIT 5CS,A00,896564,Carnelos; Chiara,20,0,20,0
1746534617795,LISP 5A,A00,896588,Munoz Sanchez; Alicia,3,0,20,17
1746534618822,LISP 5B,A00,896653,Munoz Sanchez; Alicia,7,0,20,13
1746534619854,LISP 5C,A00,896655,Munoz Sanchez; Alicia,0,1,20,20
1746534620888,MAE 197,001,957918,Kleissl; Jan,9996,0,9999,3
1746534620888,MAE 197,002,959806,Boechler; Nicholas Sebastia,9998,0,9999,1
1746534620888,MAE 197,003,959852,Mullin; Jennifer S,9999,0,9999,0
1746534621918,MATH 2,A01,957937,Staff,33,0,35,2
1746534622943,MATH 197,001,957876,Kedlaya; Kiran S.,9993,0,9999,6
1746534623974,MCWP 40,A00,892729,Duru; Nur,10,0,20,10
1746534623974,MCWP 40,B00,893304,Montejo; Carolina,14,0,20,6
1746534625000,MCWP 40R,A00,893757,Redela; Pamela Morgan,0,5,20,20
1746534626031,MCWP 50,A00,893758,Morshed; Michael James,0,0,20,20
1746534626031,MCWP 50,B00,893761,Bartulis; Jason Michael,17,0,20,3
1746534627061,MCWP 50R,A00,893766,Compas; Sean Matthew,0,1,20,20
1746534627061,MCWP 50R,B00,893769,Carter; Jennifer A,0,1,20,20
1746534627061,MCWP 50R,C00,893771,Krone; Jarret,0,3,20,20
1746534627061,MCWP 50R,D00,893772,Miller; Elizabeth Deen,0,0,20,20
1746534627061,MCWP 50R,E00,893775,Carter; Andrea L,0,1,20,20
1746534628092,MMW 11R,A01,892721,Herbst; Matthew,11,0,27,16
1746534628092,MMW 11R,A02,892722,Herbst; Matthew,0,0,0,3
1746534629118,MMW 12R,A01,892724,Herbst; Matthew,0,11,16,16
1746534629118,MMW 12R,A02,892725,Herbst; Matthew,0,10,16,16
1746534630144,MMW 13R,A01,892727,Staff,0,4,16,16
1746534630144,MMW 13R,A02,892728,Staff,0,4,16,16
1746534630144,MMW 13R,A03,958032,Staff,0,4,16,16
1746534630144,MMW 13R,A04,958033,Staff,0,4,16,16
1746534630144,MMW 13R,A05,958034,Staff,0,4,16,16
1746534631180,SIO 295LS,A00,894015,Staff,5,0,25,20
1746534632209,SIO 295S,A00,894020,Staff,5,0,25,20
1746534633238,SIOC 290S,B01,958918,Merrifield; Mark A,14,0,30,16
1746534634273,SIOC 291S,B01,958922,Gabriel; Corey John,14,0,30,16
1746534635302,SOCI 117,A01,895339,Staff,3,0,5,2
1746534636327,WES 237B,A00,894149,Staff,11,0,20,9
1746534638410,AESE 279B,A00,891859,Staff,13,0,35,22
1746534639437,AIP 197,001,891854,Vespa; Emanuel Ignacio,9999,0,9999,0
1746534640468,ANTH 289S,A00,891856,Gagneux; Pascal,12,0,12,0
1746534641495,BENG 196,001,957946,Engler; Adam J.,9996,0,9999,3
1746534642527,BISP 197,001,959851,Wilhelm; James E.,9999,0,9999,0
1746534643554,CAT 124RS,A01,956906,Staff,6,0,25,19
1746534644581,CAT 125RS,A01,922013,Staff,6,0,25,19
1746534645610,CLRE 250,A00,891860,Morris; Sheldon,9995,0,9999,4
1746534647666,CLRE 251R,A00,907817,Mehta; Ravindra L.,9994,0,9999,5
1746534648692,CLRE 252,A00,891864,Cuomo; Raphael Eduardo,9993,0,9999,6
1746534649721,CLRE 253,A00,891867,Vaida; Florin,9994,0,9999,5
1746534649721,CLRE 253,B00,907819,Staff,9999,0,9999,0
1746534650747,CLRE 259,A00,891868,Patel; Hemal,9998,0,9999,1
1746534651774,CLRE 260,A00,891872,Cuomo; Raphael Eduardo,9999,0,9999,0
1746534652800,CLRE 297,001,891888,Cuomo; Raphael Eduardo,9999,0,9999,0
1746534653831,CSE 191,A00,958773,Minnes Kemp; Mor Mia,9996,0,9999,3
1746534654860,CSE 197,001,959846,Minnes Kemp; Mor Mia,9993,0,9999,6
1746534655890,CSS 201S,A01,892054,Mignozzetti; Umberto,26,0,30,4
1746534656924,CSS 202S,A01,892056,Mignozzetti; Umberto,26,0,30,4
1746534657950,DSC 197,001,956898,Eldridge; Justin Matthew,9998,0,9999,1
1746534658983,DSC 297,001,958000,Mazumdar; Arya,9998,0,9999,1
1746534658983,DSC 297,002,959862,Wang; Yusu,9999,0,9999,0
1746534660012,EAP 100,A00,905686,Staff,9778,0,9999,221
1746534661043,ECE 45,A01,892618,Staff,0,0,65,65
1746534663101,ECE 111,A01,892719,Staff,4,0,65,61
1746534664127,ECE 197,001,957920,Mercier; Patrick Philip,9991,0,9999,8
1746534665156,ECON 178,A01,907814,Zhu; Ying,26,0,35,9
1746534666188,EDS 115,A00,895312,Staff,36,0,45,9
1746534667216,EDS 117,A01,895337,Staff,24,0,30,6
1746534668248,EDS 125,A00,895341,Jones; Gabrielle Anastasia,37,0,45,8
1746534669276,EDS 128A,A01,895459,Fargason; Sharon Gayle,44,0,45,1
1746534670302,EDS 128B,A01,895543,Pappas; Elizabeth,44,0,45,1
1746534671327,EDS 139,A00,897203,Pappas; Elizabeth,44,0,45,1
1746534671327,EDS 139,B00,897209,Fargason; Sharon Gayle,41,0,45,4
1746534672355,EDS 201,A00,895545,Staff,23,0,45,22
1746534673386,EDS 203,A01,895581,Halter; Christopher P.,23,0,45,22
1746534674413,EDS 204R,A01,895625,Heinzman; Erica M.,39,0,45,6
1746534674413,EDS 204R,B01,895693,Halter; Christopher P.,10,0,45,35
1746534675440,EDS 206R,A00,895694,Fargason; Sharon Gayle,1,0,30,29
1746534675440,EDS 206R,B00,895695,Choi; Bailey Miyeon,16,0,30,14
1746534676469,EDS 250,A00,895697,Hemans; Patricia Ann Benitez,23,0,45,22
1746534677493,EDS 281,A00,895701,Meyerott; Theresa Ann,1,0,15,14
1746534678521,EDS 284,A00,895736,Meyerott; Theresa Ann,1,0,15,14
1746534679549,EDS 286,A00,897210,Fine; Sarah,0,0,15,15
1746534680577,EDS 289C,A01,895770,Daly; Alan J.,15,0,15,0
1746534681603,EDS 290,A00,897211,Hofstetter; Carolyn,0,0,15,15
1746534682629,LIGM 5A,A00,896162,Fischer-Grunski; Eva K,13,0,20,7
1746534683655,LIGM 5B,A00,896260,Fischer-Grunski; Eva K,17,0,20,3
1746534684682,LIGM 5C,A00,896308,Fischer-Grunski; Eva K,18,0,20,2
1746534685715,LIIT 5AS,A00,896313,Carnelos; Chiara,18,0,20,2
1746534686744,LIIT 5BS,A00,896416,Carnelos; Chiara,20,0,20,0
1746534687772,LIIT 5CS,A00,896564,Carnelos; Chiara,20,0,20,0
1746534688799,LISP 5A,A00,896588,Munoz Sanchez; Alicia,3,0,20,17
1746534689830,LISP 5B,A00,896653,Munoz Sanchez; Alicia,7,0,20,13
1746534690856,LISP 5C,A00,896655,Munoz Sanchez; Alicia,0,1,20,20
1746534691891,MAE 197,001,957918,Kleissl; Jan,9996,0,9999,3
1746534691891,MAE 197,002,959806,Boechler; Nicholas Sebastia,9998,0,9999,1
1746534691891,MAE 197,003,959852,Mullin; Jennifer S,9999,0,9999,0
1746534692917,MATH 2,A01,957937,Staff,33,0,35,2
1746534693956,MATH 197,001,957876,Kedlaya; Kiran S.,9993,0,9999,6
1746534694985,MCWP 40,A00,892729,Duru; Nur,10,0,20,10
1746534694985,MCWP 40,B00,893304,Montejo; Carolina,14,0,20,6
1746534696018,MCWP 40R,A00,893757,Redela; Pamela Morgan,0,5,20,20
1746534697048,MCWP 50,A00,893758,Morshed; Michael James,0,0,20,20
1746534697048,MCWP 50,B00,893761,Bartulis; Jason Michael,17,0,20,3
1746534698079,MCWP 50R,A00,893766,Compas; Sean Matthew,0,1,20,20
1746534698079,MCWP 50R,B00,893769,Carter; Jennifer A,0,1,20,20
1746534698079,MCWP 50R,C00,893771,Krone; Jarret,0,3,20,20
1746534698079,MCWP 50R,D00,893772,Miller; Elizabeth Deen,0,0,20,20
1746534698079,MCWP 50R,E00,893775,Carter; Andrea L,0,1,20,20
1746534699109,MMW 11R,A01,892721,Herbst; Matthew,11,0,27,16
1746534699109,MMW 11R,A02,892722,Herbst; Matthew,0,0,0,3
1746534700135,MMW 12R,A01,892724,Herbst; Matthew,0,11,16,16
1746534700135,MMW 12R,A02,892725,Herbst; Matthew,0,10,16,16
1746534701165,MMW 13R,A01,892727,Staff,0,4,16,16
1746534701165,MMW 13R,A02,892728,Staff,0,4,16,16
1746534701165,MMW 13R,A03,958032,Staff,0,4,16,16
1746534701165,MMW 13R,A04,958033,Staff,0,4,16,16
1746534701165,MMW 13R,A05,958034,Staff,0,4,16,16
1746534702191,SIO 295LS,A00,894015,Staff,5,0,25,20
1746534703218,SIO 295S,A00,894020,Staff,5,0,25,20
1746534704246,SIOC 290S,B01,958918,Merrifield; Mark A,14,0,30,16
1746534705277,SIOC 291S,B01,958922,Gabriel; Corey John,14,0,30,16
1746534706306,SOCI 117,A01,895339,Staff,3,0,5,2
1746534707335,WES 237B,A00,894149,Staff,11,0,20,9
1746534709426,AESE 279B,A00,891859,Staff,13,0,35,22
1746534710454,AIP 197,001,891854,Vespa; Emanuel Ignacio,9999,0,9999,0
1746534711482,ANTH 289S,A00,891856,Gagneux; Pascal,12,0,12,0
1746534712510,BENG 196,001,957946,Engler; Adam J.,9996,0,9999,3
1746534713537,BISP 197,001,959851,Wilhelm; James E.,9999,0,9999,0
1746534714565,CAT 124RS,A01,956906,Staff,6,0,25,19
1746534715590,CAT 125RS,A01,922013,Staff,6,0,25,19
1746534716619,CLRE 250,A00,891860,Morris; Sheldon,9995,0,9999,4
1746534718674,CLRE 251R,A00,907817,Mehta; Ravindra L.,9994,0,9999,5
1746534719705,CLRE 252,A00,891864,Cuomo; Raphael Eduardo,9993,0,9999,6
1746534720732,CLRE 253,A00,891867,Vaida; Florin,9994,0,9999,5
1746534720732,CLRE 253,B00,907819,Staff,9999,0,9999,0
1746534721758,CLRE 259,A00,891868,Patel; Hemal,9998,0,9999,1
1746534722787,CLRE 260,A00,891872,Cuomo; Raphael Eduardo,9999,0,9999,0
1746534723814,CLRE 297,001,891888,Cuomo; Raphael Eduardo,9999,0,9999,0
1746534724843,CSE 191,A00,958773,Minnes Kemp; Mor Mia,9996,0,9999,3
1746534725872,CSE 197,001,959846,Minnes Kemp; Mor Mia,9993,0,9999,6
1746534726900,CSS 201S,A01,892054,Mignozzetti; Umberto,26,0,30,4
1746534727928,CSS 202S,A01,892056,Mignozzetti; Umberto,26,0,30,4
1746534728953,DSC 197,001,956898,Eldridge; Justin Matthew,9998,0,9999,1
1746534729987,DSC 297,001,958000,Mazumdar; Arya,9998,0,9999,1
1746534729987,DSC 297,002,959862,Wang; Yusu,9999,0,9999,0
1746534731013,EAP 100,A00,905686,Staff,9778,0,9999,221
1746534732255,ECE 45,A01,892618,Staff,0,0,65,65
1746534734310,ECE 111,A01,892719,Staff,4,0,65,61
1746534735335,ECE 197,001,957920,Mercier; Patrick Philip,9991,0,9999,8
1746534736362,ECON 178,A01,907814,Zhu; Ying,26,0,35,9
1746534737388,EDS 115,A00,895312,Staff,36,0,45,9
1746534738419,EDS 117,A01,895337,Staff,24,0,30,6
1746534739448,EDS 125,A00,895341,Jones; Gabrielle Anastasia,37,0,45,8
1746534740475,EDS 128A,A01,895459,Fargason; Sharon Gayle,44,0,45,1
1746534741505,EDS 128B,A01,895543,Pappas; Elizabeth,44,0,45,1
1746534742536,EDS 139,A00,897203,Pappas; Elizabeth,44,0,45,1
1746534742536,EDS 139,B00,897209,Fargason; Sharon Gayle,41,0,45,4
1746534743566,EDS 201,A00,895545,Staff,23,0,45,22
1746534744595,EDS 203,A01,895581,Halter; Christopher P.,23,0,45,22
1746534745629,EDS 204R,A01,895625,Heinzman; Erica M.,39,0,45,6
1746534745629,EDS 204R,B01,895693,Halter; Christopher P.,10,0,45,35
1746534746660,EDS 206R,A00,895694,Fargason; Sharon Gayle,1,0,30,29
1746534746660,EDS 206R,B00,895695,Choi; Bailey Miyeon,16,0,30,14
1746534747687,EDS 250,A00,895697,Hemans; Patricia Ann Benitez,23,0,45,22
1746534748718,EDS 281,A00,895701,Meyerott; Theresa Ann,1,0,15,14
1746534749744,EDS 284,A00,895736,Meyerott; Theresa Ann,1,0,15,14
1746534750771,EDS 286,A00,897210,Fine; Sarah,0,0,15,15
1746534751800,EDS 289C,A01,895770,Daly; Alan J.,15,0,15,0
1746534752825,EDS 290,A00,897211,Hofstetter; Carolyn,0,0,15,15
1746534753857,LIGM 5A,A00,896162,Fischer-Grunski; Eva K,13,0,20,7
1746534754881,LIGM 5B,A00,896260,Fischer-Grunski; Eva K,17,0,20,3
1746534755907,LIGM 5C,A00,896308,Fischer-Grunski; Eva K,18,0,20,2
1746534756935,LIIT 5AS,A00,896313,Carnelos; Chiara,18,0,20,2
1746534757960,LIIT 5BS,A00,896416,Carnelos; Chiara,20,0,20,0
1746534758990,LIIT 5CS,A00,896564,Carnelos; Chiara,20,0,20,0
1746534760017,LISP 5A,A00,896588,Munoz Sanchez; Alicia,3,0,20,17
1746534761043,LISP 5B,A00,896653,Munoz Sanchez; Alicia,7,0,20,13
1746534762073,LISP 5C,A00,896655,Munoz Sanchez; Alicia,0,1,20,20
1746534763102,MAE 197,001,957918,Kleissl; Jan,9996,0,9999,3
1746534763102,MAE 197,002,959806,Boechler; Nicholas Sebastia,9998,0,9999,1
1746534763102,MAE 197,003,959852,Mullin; Jennifer S,9999,0,9999,0
1746534764129,MATH 2,A01,957937,Staff,33,0,35,2
1746534765160,MATH 197,001,957876,Kedlaya; Kiran S.,9993,0,9999,6
1746534766188,MCWP 40,A00,892729,Duru; Nur,10,0,20,10
1746534766188,MCWP 40,B00,893304,Montejo; Carolina,14,0,20,6
1746534767213,MCWP 40R,A00,893757,Redela; Pamela Morgan,0,5,20,20
1746534768240,MCWP 50,A00,893758,Morshed; Michael James,0,0,20,20
1746534768240,MCWP 50,B00,893761,Bartulis; Jason Michael,17,0,20,3
1746534769270,MCWP 50R,A00,893766,Compas; Sean Matthew,0,1,20,20
1746534769270,MCWP 50R,B00,893769,Carter; Jennifer A,0,1,20,20
1746534769270,MCWP 50R,C00,893771,Krone; Jarret,0,3,20,20
1746534769270,MCWP 50R,D00,893772,Miller; Elizabeth Deen,0,0,20,20
1746534769270,MCWP 50R,E00,893775,Carter; Andrea L,0,1,20,20
1746534770301,MMW 11R,A01,892721,Herbst; Matthew,11,0,27,16
1746534770301,MMW 11R,A02,892722,Herbst; Matthew,0,0,0,3
1746534771330,MMW 12R,A01,892724,Herbst; Matthew,0,11,16,16
1746534771330,MMW 12R,A02,892725,Herbst; Matthew,0,10,16,16
1746534772360,MMW 13R,A01,892727,Staff,0,4,16,16
1746534772360,MMW 13R,A02,892728,Staff,0,4,16,16
1746534772360,MMW 13R,A03,958032,Staff,0,4,16,16
1746534772360,MMW 13R,A04,958033,Staff,0,4,16,16
1746534772360,MMW 13R,A05,958034,Staff,0,4,16,16
1746534773387,SIO 295LS,A00,894015,Staff,5,0,25,20
1746534774413,SIO 295S,A00,894020,Staff,5,0,25,20
1746534775439,SIOC 290S,B01,958918,Merrifield; Mark A,14,0,30,16
1746534776468,SIOC 291S,B01,958922,Gabriel; Corey John,14,0,30,16
1746534777497,SOCI 117,A01,895339,Staff,3,0,5,2
1746534778523,WES 237B,A00,894149,Staff,11,0,20,9
1746534780597,AESE 279B,A00,891859,Staff,13,0,35,22
1746534781622,AIP 197,001,891854,Vespa; Emanuel Ignacio,9999,0,9999,0
1746534782652,ANTH 289S,A00,891856,Gagneux; Pascal,12,0,12,0
1746534783682,BENG 196,001,957946,Engler; Adam J.,9996,0,9999,3
1746534784708,BISP 197,001,959851,Wilhelm; James E.,9999,0,9999,0
1746534785737,CAT 124RS,A01,956906,Staff,6,0,25,19
1746534786769,CAT 125RS,A01,922013,Staff,6,0,25,19
1746534787796,CLRE 250,A00,891860,Morris; Sheldon,9995,0,9999,4
1746534789853,CLRE 251R,A00,907817,Mehta; Ravindra L.,9994,0,9999,5
1746534790883,CLRE 252,A00,891864,Cuomo; Raphael Eduardo,9993,0,9999,6
1746534791908,CLRE 253,A00,891867,Vaida; Florin,9994,0,9999,5
1746534791908,CLRE 253,B00,907819,Staff,9999,0,9999,0
1746534792934,CLRE 259,A00,891868,Patel; Hemal,9998,0,9999,1
1746534793961,CLRE 260,A00,891872,Cuomo; Raphael Eduardo,9999,0,9999,0
1746534794988,CLRE 297,001,891888,Cuomo; Raphael Eduardo,9999,0,9999,0
1746534796016,CSE 191,A00,958773,Minnes Kemp; Mor Mia,9996,0,9999,3
1746534797041,CSE 197,001,959846,Minnes Kemp; Mor Mia,9993,0,9999,6
1746534798075,CSS 201S,A01,892054,Mignozzetti; Umberto,26,0,30,4
1746534799109,CSS 202S,A01,892056,Mignozzetti; Umberto,26,0,30,4
1746534800135,DSC 197,001,956898,Eldridge; Justin Matthew,9998,0,9999,1
1746534801162,DSC 297,001,958000,Mazumdar; Arya,9998,0,9999,1
1746534801162,DSC 297,002,959862,Wang; Yusu,9999,0,9999,0
1746534802186,EAP 100,A00,905686,Staff,9778,0,9999,221
1746534803219,ECE 45,A01,892618,Staff,0,0,65,65
1746534805275,ECE 111,A01,892719,Staff,4,0,65,61
1746534806303,ECE 197,001,957920,Mercier; Patrick Philip,9991,0,9999,8
1746534807331,ECON 178,A01,907814,Zhu; Ying,26,0,35,9
1746534808357,EDS 115,A00,895312,Staff,36,0,45,9
1746534809385,EDS 117,A01,895337,Staff,24,0,30,6
1746534810412,EDS 125,A00,895341,Jones; Gabrielle Anastasia,37,0,45,8
1746534811441,EDS 128A,A01,895459,Fargason; Sharon Gayle,44,0,45,1
1746534812474,EDS 128B,A01,895543,Pappas; Elizabeth,44,0,45,1
1746534813504,EDS 139,A00,897203,Pappas; Elizabeth,44,0,45,1
1746534813504,EDS 139,B00,897209,Fargason; Sharon Gayle,41,0,45,4
1746534814531,EDS 201,A00,895545,Staff,23,0,45,22
1746534815558,EDS 203,A01,895581,Halter; Christopher P.,23,0,45,22
1746534816588,EDS 204R,A01,895625,Heinzman; Erica M.,39,0,45,6
1746534816588,EDS 204R,B01,895693,Halter; Christopher P.,10,0,45,35
1746534817619,EDS 206R,A00,895694,Fargason; Sharon Gayle,1,0,30,29
1746534817619,EDS 206R,B00,895695,Choi; Bailey Miyeon,16,0,30,14
1746534818646,EDS 250,A00,895697,Hemans; Patricia Ann Benitez,23,0,45,22
1746534819671,EDS 281,A00,895701,Meyerott; Theresa Ann,1,0,15,14
1746534820700,EDS 284,A00,895736,Meyerott; Theresa Ann,1,0,15,14
1746534821726,EDS 286,A00,897210,Fine; Sarah,0,0,15,15
1746534822756,EDS 289C,A01,895770,Daly; Alan J.,15,0,15,0
1746534823787,EDS 290,A00,897211,Hofstetter; Carolyn,0,0,15,15
1746534824819,LIGM 5A,A00,896162,Fischer-Grunski; Eva K,13,0,20,7
1746534825849,LIGM 5B,A00,896260,Fischer-Grunski; Eva K,17,0,20,3
1746534826874,LIGM 5C,A00,896308,Fischer-Grunski; Eva K,18,0,20,2
1746534827904,LIIT 5AS,A00,896313,Carnelos; Chiara,18,0,20,2
1746534828932,LIIT 5BS,A00,896416,Carnelos; Chiara,20,0,20,0
1746534829959,LIIT 5CS,A00,896564,Carnelos; Chiara,20,0,20,0
1746534830985,LISP 5A,A00,896588,Munoz Sanchez; Alicia,3,0,20,17
1746534832064,LISP 5B,A00,896653,Munoz Sanchez; Alicia,7,0,20,13
1746534833091,LISP 5C,A00,896655,Munoz Sanchez; Alicia,0,1,20,20
1746534834121,MAE 197,001,957918,Kleissl; Jan,9996,0,9999,3
1746534834121,MAE 197,002,959806,Boechler; Nicholas Sebastia,9998,0,9999,1
1746534834121,MAE 197,003,959852,Mullin; Jennifer S,9999,0,9999,0
1746534835156,MATH 2,A01,957937,Staff,33,0,35,2
1746534836185,MATH 197,001,957876,Kedlaya; Kiran S.,9993,0,9999,6
1746534837213,MCWP 40,A00,892729,Duru; Nur,10,0,20,10
1746534837213,MCWP 40,B00,893304,Montejo; Carolina,14,0,20,6
1746534838240,MCWP 40R,A00,893757,Redela; Pamela Morgan,0,5,20,20
1746534839272,MCWP 50,A00,893758,Morshed; Michael James,0,0,20,20
1746534839272,MCWP 50,B00,893761,Bartulis; Jason Michael,17,0,20,3
1746534840299,MCWP 50R,A00,893766,Compas; Sean Matthew,0,1,20,20
1746534840299,MCWP 50R,B00,893769,Carter; Jennifer A,0,1,20,20
1746534840299,MCWP 50R,C00,893771,Krone; Jarret,0,3,20,20
1746534840299,MCWP 50R,D00,893772,Miller; Elizabeth Deen,0,0,20,20
1746534840299,MCWP 50R,E00,893775,Carter; Andrea L,0,1,20,20
1746534841328,MMW 11R,A01,892721,Herbst; Matthew,11,0,27,16
1746534841328,MMW 11R,A02,892722,Herbst; Matthew,0,0,0,3
1746534842353,MMW 12R,A01,892724,Herbst; Matthew,0,11,16,16
1746534842353,MMW 12R,A02,892725,Herbst; Matthew,0,10,16,16
1746534843384,MMW 13R,A01,892727,Staff,0,4,16,16
1746534843384,MMW 13R,A02,892728,Staff,0,4,16,16
1746534843384,MMW 13R,A03,958032,Staff,0,4,16,16
1746534843384,MMW 13R,A04,958033,Staff,0,4,16,16
1746534843384,MMW 13R,A05,958034,Staff,0,4,16,16
1746534844412,SIO 295LS,A00,894015,Staff,5,0,25,20
1746534845440,SIO 295S,A00,894020,Staff,5,0,25,20
1746534846475,SIOC 290S,B01,958918,Merrifield; Mark A,14,0,30,16
1746534847503,SIOC 291S,B01,958922,Gabriel; Corey John,14,0,30,16
1746534848528,SOCI 117,A01,895339,Staff,3,0,5,2
1746534849557,WES 237B,A00,894149,Staff,11,0,20,9
1746534851632,AESE 279B,A00,891859,Staff,13,0,35,22
1746534852662,AIP 197,001,891854,Vespa; Emanuel Ignacio,9999,0,9999,0
1746534853694,ANTH 289S,A00,891856,Gagneux; Pascal,12,0,12,0
1746534854723,BENG 196,001,957946,Engler; Adam J.,9996,0,9999,3
1746534855754,BISP 197,001,959851,Wilhelm; James E.,9999,0,9999,0
1746534856781,CAT 124RS,A01,956906,Staff,6,0,25,19
1746534857807,CAT 125RS,A01,922013,Staff,6,0,25,19
1746534858833,CLRE 250,A00,891860,Morris; Sheldon,9995,0,9999,4
1746534860891,CLRE 251R,A00,907817,Mehta; Ravindra L.,9994,0,9999,5
1746534861920,CLRE 252,A00,891864,Cuomo; Raphael Eduardo,9993,0,9999,6
1746534862947,CLRE 253,A00,891867,Vaida; Florin,9994,0,9999,5
1746534862947,CLRE 253,B00,907819,Staff,9999,0,9999,0
1746534863975,CLRE 259,A00,891868,Patel; Hemal,9998,0,9999,1
1746534865002,CLRE 260,A00,891872,Cuomo; Raphael Eduardo,9999,0,9999,0
1746534866030,CLRE 297,001,891888,Cuomo; Raphael Eduardo,9999,0,9999,0
1746534867058,CSE 191,A00,958773,Minnes Kemp; Mor Mia,9996,0,9999,3
1746534868087,CSE 197,001,959846,Minnes Kemp; Mor Mia,9993,0,9999,6
1746534869115,CSS 201S,A01,892054,Mignozzetti; Umberto,26,0,30,4
1746534870146,CSS 202S,A01,892056,Mignozzetti; Umberto,26,0,30,4
1746534871176,DSC 197,001,956898,Eldridge; Justin Matthew,9998,0,9999,1
1746534872201,DSC 297,001,958000,Mazumdar; Arya,9998,0,9999,1
1746534872201,DSC 297,002,959862,Wang; Yusu,9999,0,9999,0
1746534873231,EAP 100,A00,905686,Staff,9778,0,9999,221
1746534874262,ECE 45,A01,892618,Staff,0,0,65,65
1746534876318,ECE 111,A01,892719,Staff,4,0,65,61
1746534877348,ECE 197,001,957920,Mercier; Patrick Philip,9991,0,9999,8
1746534878378,ECON 178,A01,907814,Zhu; Ying,26,0,35,9
1746534879404,EDS 115,A00,895312,Staff,36,0,45,9
1746534880432,EDS 117,A01,895337,Staff,24,0,30,6
1746534881461,EDS 125,A00,895341,Jones; Gabrielle Anastasia,37,0,45,8
1746534882488,EDS 128A,A01,895459,Fargason; Sharon Gayle,44,0,45,1
1746534883518,EDS 128B,A01,895543,Pappas; Elizabeth,44,0,45,1
1746534884544,EDS 139,A00,897203,Pappas; Elizabeth,44,0,45,1
1746534884544,EDS 139,B00,897209,Fargason; Sharon Gayle,41,0,45,4
1746534885575,EDS 201,A00,895545,Staff,23,0,45,22
1746534886601,EDS 203,A01,895581,Halter; Christopher P.,23,0,45,22
1746534887628,EDS 204R,A01,895625,Heinzman; Erica M.,39,0,45,6
1746534887628,EDS 204R,B01,895693,Halter; Christopher P.,10,0,45,35
1746534888661,EDS 206R,A00,895694,Fargason; Sharon Gayle,1,0,30,29
1746534888661,EDS 206R,B00,895695,Choi; Bailey Miyeon,16,0,30,14
1746534889692,EDS 250,A00,895697,Hemans; Patricia Ann Benitez,23,0,45,22
1746534890722,EDS 281,A00,895701,Meyerott; Theresa Ann,1,0,15,14
1746534891750,EDS 284,A00,895736,Meyerott; Theresa Ann,1,0,15,14
1746534892776,EDS 286,A00,897210,Fine; Sarah,0,0,15,15
1746534893809,EDS 289C,A01,895770,Daly; Alan J.,15,0,15,0
1746534894840,EDS 290,A00,897211,Hofstetter; Carolyn,0,0,15,15
1746534895873,LIGM 5A,A00,896162,Fischer-Grunski; Eva K,13,0,20,7
1746534896902,LIGM 5B,A00,896260,Fischer-Grunski; Eva K,17,0,20,3
1746534897932,LIGM 5C,A00,896308,Fischer-Grunski; Eva K,18,0,20,2
1746534898961,LIIT 5AS,A00,896313,Carnelos; Chiara,18,0,20,2
1746534899987,LIIT 5BS,A00,896416,Carnelos; Chiara,20,0,20,0
1746534901019,LIIT 5CS,A00,896564,Carnelos; Chiara,20,0,20,0
1746534902046,LISP 5A,A00,896588,Munoz Sanchez; Alicia,3,0,20,17
1746534903072,LISP 5B,A00,896653,Munoz Sanchez; Alicia,7,0,20,13
1746534904111,LISP 5C,A00,896655,Munoz Sanchez; Alicia,0,1,20,20
1746534905140,MAE 197,001,957918,Kleissl; Jan,9996,0,9999,3
1746534905140,MAE 197,002,959806,Boechler; Nicholas Sebastia,9998,0,9999,1
1746534905140,MAE 197,003,959852,Mullin; Jennifer S,9999,0,9999,0
1746534906169,MATH 2,A01,957937,Staff,33,0,35,2
1746534907198,MATH 197,001,957876,Kedlaya; Kiran S.,9993,0,9999,6
1746534908236,MCWP 40,A00,892729,Duru; Nur,10,0,20,10
1746534908236,MCWP 40,B00,893304,Montejo; Carolina,14,0,20,6
1746534909270,MCWP 40R,A00,893757,Redela; Pamela Morgan,0,5,20,20
1746534910296,MCWP 50,A00,893758,Morshed; Michael James,0,0,20,20
1746534910296,MCWP 50,B00,893761,Bartulis; Jason Michael,17,0,20,3
1746534911326,MCWP 50R,A00,893766,Compas; Sean Matthew,0,1,20,20
1746534911326,MCWP 50R,B00,893769,Carter; Jennifer A,0,1,20,20
1746534911326,MCWP 50R,C00,893771,Krone; Jarret,0,3,20,20
1746534911326,MCWP 50R,D00,893772,Miller; Elizabeth Deen,0,0,20,20
1746534911326,MCWP 50R,E00,893775,Carter; Andrea L,0,1,20,20
1746534912357,MMW 11R,A01,892721,Herbst; Matthew,11,0,27,16
1746534912357,MMW 11R,A02,892722,Herbst; Matthew,0,0,0,3
1746534913386,MMW 12R,A01,892724,Herbst; Matthew,0,11,16,16
1746534913386,MMW 12R,A02,892725,Herbst; Matthew,0,10,16,16
1746534914413,MMW 13R,A01,892727,Staff,0,4,16,16
1746534914413,MMW 13R,A02,892728,Staff,0,4,16,16
1746534914413,MMW 13R,A03,958032,Staff,0,4,16,16
1746534914413,MMW 13R,A04,958033,Staff,0,4,16,16
1746534914413,MMW 13R,A05,958034,Staff,0,4,16,16
1746534915439,SIO 295LS,A00,894015,Staff,5,0,25,20
1746534916466,SIO 295S,A00,894020,Staff,5,0,25,20
1746534917502,SIOC 290S,B01,958918,Merrifield; Mark A,14,0,30,16
1746534918530,SIOC 291S,B01,958922,Gabriel; Corey John,14,0,30,16
1746534919559,SOCI 117,A01,895339,Staff,3,0,5,2
1746534920585,WES 237B,A00,894149,Staff,11,0,20,9
1746534922675,AESE 279B,A00,891859,Staff,13,0,35,22
1746534923705,AIP 197,001,891854,Vespa; Emanuel Ignacio,9999,0,9999,0
1746534924735,ANTH 289S,A00,891856,Gagneux; Pascal,12,0,12,0
1746534925765,BENG 196,001,957946,Engler; Adam J.,9996,0,9999,3
1746534926795,BISP 197,001,959851,Wilhelm; James E.,9999,0,9999,0
1746534927822,CAT 124RS,A01,956906,Staff,6,0,25,19
1746534928849,CAT 125RS,A01,922013,Staff,6,0,25,19
1746534929879,CLRE 250,A00,891860,Morris; Sheldon,9995,0,9999,4
1746534931938,CLRE 251R,A00,907817,Mehta; Ravindra L.,9994,0,9999,5
1746534932965,CLRE 252,A00,891864,Cuomo; Raphael Eduardo,9993,0,9999,6
1746534934000,CLRE 253,A00,891867,Vaida; Florin,9994,0,9999,5
1746534934000,CLRE 253,B00,907819,Staff,9999,0,9999,0
1746534935033,CLRE 259,A00,891868,Patel; Hemal,9998,0,9999,1
1746534936062,CLRE 260,A00,891872,Cuomo; Raphael Eduardo,9999,0,9999,0
1746534937088,CLRE 297,001,891888,Cuomo; Raphael Eduardo,9999,0,9999,0
1746534938120,CSE 191,A00,958773,Minnes Kemp; Mor Mia,9996,0,9999,3
1746534939149,CSE 197,001,959846,Minnes Kemp; Mor Mia,9993,0,9999,6
1746534940173,CSS 201S,A01,892054,Mignozzetti; Umberto,26,0,30,4
1746534941202,CSS 202S,A01,892056,Mignozzetti; Umberto,26,0,30,4
1746534942228,DSC 197,001,956898,Eldridge; Justin Matthew,9998,0,9999,1
1746534943256,DSC 297,001,958000,Mazumdar; Arya,9998,0,9999,1
1746534943256,DSC 297,002,959862,Wang; Yusu,9999,0,9999,0
1746534944284,EAP 100,A00,905686,Staff,9778,0,9999,221
1746534945316,ECE 45,A01,892618,Staff,0,0,65,65
1746534947374,ECE 111,A01,892719,Staff,4,0,65,61
1746534948406,ECE 197,001,957920,Mercier; Patrick Philip,9991,0,9999,8
1746534949432,ECON 178,A01,907814,Zhu; Ying,26,0,35,9
1746534950463,EDS 115,A00,895312,Staff,36,0,45,9
1746534951491,EDS 117,A01,895337,Staff,24,0,30,6
1746534952518,EDS 125,A00,895341,Jones; Gabrielle Anastasia,37,0,45,8
1746534953549,EDS 128A,A01,895459,Fargason; Sharon Gayle,44,0,45,1
1746534954579,EDS 128B,A01,895543,Pappas; Elizabeth,44,0,45,1
1746534955606,EDS 139,A00,897203,Pappas; Elizabeth,44,0,45,1
1746534955606,EDS 139,B00,897209,Fargason; Sharon Gayle,41,0,45,4
1746534956634,EDS 201,A00,895545,Staff,23,0,45,22
1746534957660,EDS 203,A01,895581,Halter; Christopher P.,23,0,45,22
1746534958688,EDS 204R,A01,895625,Heinzman; Erica M.,39,0,45,6
1746534958688,EDS 204R,B01,895693,Halter; Christopher P.,10,0,45,35
1746534959721,EDS 206R,A00,895694,Fargason; Sharon Gayle,1,0,30,29
1746534959721,EDS 206R,B00,895695,Choi; Bailey Miyeon,16,0,30,14
1746534960749,EDS 250,A00,895697,Hemans; Patricia Ann Benitez,23,0,45,22
1746534961777,EDS 281,A00,895701,Meyerott; Theresa Ann,1,0,15,14
1746534962809,EDS 284,A00,895736,Meyerott; Theresa Ann,1,0,15,14
1746534963838,EDS 286,A00,897210,Fine; Sarah,0,0,15,15
1746534964865,EDS 289C,A01,895770,Daly; Alan J.,15,0,15,0
1746534965892,EDS 290,A00,897211,Hofstetter; Carolyn,0,0,15,15
1746534966927,LIGM 5A,A00,896162,Fischer-Grunski; Eva K,13,0,20,7
1746534967958,LIGM 5B,A00,896260,Fischer-Grunski; Eva K,17,0,20,3
1746534968984,LIGM 5C,A00,896308,Fischer-Grunski; Eva K,18,0,20,2
1746534970018,LIIT 5AS,A00,896313,Carnelos; Chiara,18,0,20,2
1746534971045,LIIT 5BS,A00,896416,Carnelos; Chiara,20,0,20,0
1746534972069,LIIT 5CS,A00,896564,Carnelos; Chiara,20,0,20,0
1746534973097,LISP 5A,A00,896588,Munoz Sanchez; Alicia,3,0,20,17
1746534974124,LISP 5B,A00,896653,Munoz Sanchez; Alicia,7,0,20,13
1746534975158,LISP 5C,A00,896655,Munoz Sanchez; Alicia,0,1,20,20
1746534976194,MAE 197,001,957918,Kleissl; Jan,9996,0,9999,3
1746534976194,MAE 197,002,959806,Boechler; Nicholas Sebastia,9998,0,9999,1
1746534976194,MAE 197,003,959852,Mullin; Jennifer S,9999,0,9999,0
1746534977223,MATH 2,A01,957937,Staff,33,0,35,2
1746534978253,MATH 197,001,957876,Kedlaya; Kiran S.,9993,0,9999,6
1746534979279,MCWP 40,A00,892729,Duru; Nur,10,0,20,10
1746534979279,MCWP 40,B00,893304,Montejo; Carolina,14,0,20,6
1746534980306,MCWP 40R,A00,893757,Redela; Pamela Morgan,0,5,20,20
1746534981342,MCWP 50,A00,893758,Morshed; Michael James,0,0,20,20
1746534981342,MCWP 50,B00,893761,Bartulis; Jason Michael,17,0,20,3
1746534982371,MCWP 50R,A00,893766,Compas; Sean Matthew,0,1,20,20
1746534982371,MCWP 50R,B00,893769,Carter; Jennifer A,0,1,20,20
1746534982371,MCWP 50R,C00,893771,Krone; Jarret,0,3,20,20
1746534982371,MCWP 50R,D00,893772,Miller; Elizabeth Deen,0,0,20,20
1746534982371,MCWP 50R,E00,893775,Carter; Andrea L,0,1,20,20
1746534983403,MMW 11R,A01,892721,Herbst; Matthew,11,0,27,16
1746534983403,MMW 11R,A02,892722,Herbst; Matthew,0,0,0,3
1746534984429,MMW 12R,A01,892724,Herbst; Matthew,0,11,16,16
1746534984429,MMW 12R,A02,892725,Herbst; Matthew,0,10,16,16
1746534985461,MMW 13R,A01,892727,Staff,0,4,16,16
1746534985461,MMW 13R,A02,892728,Staff,0,4,16,16
1746534985461,MMW 13R,A03,958032,Staff,0,4,16,16
1746534985461,MMW 13R,A04,958033,Staff,0,4,16,16
1746534985461,MMW 13R,A05,958034,Staff,0,4,16,16
1746534986488,SIO 295LS,A00,894015,Staff,5,0,25,20
1746534987517,SIO 295S,A00,894020,Staff,5,0,25,20
1746534988554,SIOC 290S,B01,958918,Merrifield; Mark A,14,0,30,16
1746534989581,SIOC 291S,B01,958922,Gabriel; Corey John,14,0,30,16
1746534990608,SOCI 117,A01,895339,Staff,3,0,5,2
1746534991635,WES 237B,A00,894149,Staff,11,0,20,9
1746534993718,AESE 279B,A00,891859,Staff,13,0,35,22
1746534994746,AIP 197,001,891854,Vespa; Emanuel Ignacio,9999,0,9999,0
1746534995772,ANTH 289S,A00,891856,Gagneux; Pascal,12,0,12,0
1746534996799,BENG 196,001,957946,Engler; Adam J.,9996,0,9999,3
1746534997826,BISP 197,001,959851,Wilhelm; James E.,9999,0,9999,0
1746534998856,CAT 124RS,A01,956906,Staff,6,0,25,19
1746534999884,CAT 125RS,A01,922013,Staff,6,0,25,19
1746535000911,CLRE 250,A00,891860,Morris; Sheldon,9995,0,9999,4
1746535002969,CLRE 251R,A00,907817,Mehta; Ravindra L.,9994,0,9999,5
1746535003995,CLRE 252,A00,891864,Cuomo; Raphael Eduardo,9993,0,9999,6
1746535005034,CLRE 253,A00,891867,Vaida; Florin,9994,0,9999,5
1746535005034,CLRE 253,B00,907819,Staff,9999,0,9999,0
1746535006061,CLRE 259,A00,891868,Patel; Hemal,9998,0,9999,1
1746535007091,CLRE 260,A00,891872,Cuomo; Raphael Eduardo,9999,0,9999,0
1746535008118,CLRE 297,001,891888,Cuomo; Raphael Eduardo,9999,0,9999,0
1746535009146,CSE 191,A00,958773,Minnes Kemp; Mor Mia,9996,0,9999,3
1746535010173,CSE 197,001,959846,Minnes Kemp; Mor Mia,9993,0,9999,6
1746535011206,CSS 201S,A01,892054,Mignozzetti; Umberto,26,0,30,4
1746535012232,CSS 202S,A01,892056,Mignozzetti; Umberto,26,0,30,4
1746535013262,DSC 197,001,956898,Eldridge; Justin Matthew,9998,0,9999,1
1746535014290,DSC 297,001,958000,Mazumdar; Arya,9998,0,9999,1
1746535014290,DSC 297,002,959862,Wang; Yusu,9999,0,9999,0
1746535015318,EAP 100,A00,905686,Staff,9778,0,9999,221
1746535016346,ECE 45,A01,892618,Staff,0,0,65,65
1746535018398,ECE 111,A01,892719,Staff,4,0,65,61
1746535019431,ECE 197,001,957920,Mercier; Patrick Philip,9991,0,9999,8
1746535020464,ECON 178,A01,907814,Zhu; Ying,26,0,35,9
1746535021489,EDS 115,A00,895312,Staff,36,0,45,9
1746535022519,EDS 117,A01,895337,Staff,24,0,30,6
1746535023552,EDS 125,A00,895341,Jones; Gabrielle Anastasia,37,0,45,8
1746535024578,EDS 128A,A01,895459,Fargason; Sharon Gayle,44,0,45,1
1746535025607,EDS 128B,A01,895543,Pappas; Elizabeth,44,0,45,1
1746535026635,EDS 139,A00,897203,Pappas; Elizabeth,44,0,45,1
1746535026635,EDS 139,B00,897209,Fargason; Sharon Gayle,41,0,45,4
1746535027665,EDS 201,A00,895545,Staff,23,0,45,22
1746535028696,EDS 203,A01,895581,Halter; Christopher P.,23,0,45,22
1746535029727,EDS 204R,A01,895625,Heinzman; Erica M.,39,0,45,6
1746535029727,EDS 204R,B01,895693,Halter; Christopher P.,10,0,45,35
1746535030756,EDS 206R,A00,895694,Fargason; Sharon Gayle,1,0,30,29
1746535030756,EDS 206R,B00,895695,Choi; Bailey Miyeon,16,0,30,14
1746535031784,EDS 250,A00,895697,Hemans; Patricia Ann Benitez,23,0,45,22
1746535032812,EDS 281,A00,895701,Meyerott; Theresa Ann,1,0,15,14
1746535033842,EDS 284,A00,895736,Meyerott; Theresa Ann,1,0,15,14
1746535034868,EDS 286,A00,897210,Fine; Sarah,0,0,15,15
1746535035899,EDS 289C,A01,895770,Daly; Alan J.,15,0,15,0
1746535036932,EDS 290,A00,897211,Hofstetter; Carolyn,0,0,15,15
1746535037964,LIGM 5A,A00,896162,Fischer-Grunski; Eva K,13,0,20,7
1746535038990,LIGM 5B,A00,896260,Fischer-Grunski; Eva K,17,0,20,3
1746535040016,LIGM 5C,A00,896308,Fischer-Grunski; Eva K,18,0,20,2
1746535041044,LIIT 5AS,A00,896313,Carnelos; Chiara,18,0,20,2
1746535042077,LIIT 5BS,A00,896416,Carnelos; Chiara,20,0,20,0
1746535043106,LIIT 5CS,A00,896564,Carnelos; Chiara,20,0,20,0
1746535044139,LISP 5A,A00,896588,Munoz Sanchez; Alicia,3,0,20,17
1746535045167,LISP 5B,A00,896653,Munoz Sanchez; Alicia,7,0,20,13
1746535046198,LISP 5C,A00,896655,Munoz Sanchez; Alicia,0,1,20,20
1746535047226,MAE 197,001,957918,Kleissl; Jan,9996,0,9999,3
1746535047226,MAE 197,002,959806,Boechler; Nicholas Sebastia,9998,0,9999,1
1746535047226,MAE 197,003,959852,Mullin; Jennifer S,9999,0,9999,0
1746535048253,MATH 2,A01,957937,Staff,33,0,35,2
1746535049288,MATH 197,001,957876,Kedlaya; Kiran S.,9993,0,9999,6
1746535050327,MCWP 40,A00,892729,Duru; Nur,10,0,20,10
1746535050327,MCWP 40,B00,893304,Montejo; Carolina,14,0,20,6
1746535051355,MCWP 40R,A00,893757,Redela; Pamela Morgan,0,5,20,20
1746535052383,MCWP 50,A00,893758,Morshed; Michael James,0,0,20,20
1746535052383,MCWP 50,B00,893761,Bartulis; Jason Michael,17,0,20,3
1746535053414,MCWP 50R,A00,893766,Compas; Sean Matthew,0,1,20,20
1746535053414,MCWP 50R,B00,893769,Carter; Jennifer A,0,1,20,20
1746535053414,MCWP 50R,C00,893771,Krone; Jarret,0,3,20,20
1746535053414,MCWP 50R,D00,893772,Miller; Elizabeth Deen,0,0,20,20
1746535053414,MCWP 50R,E00,893775,Carter; Andrea L,0,1,20,20
1746535054440,MMW 11R,A01,892721,Herbst; Matthew,11,0,27,16
1746535054440,MMW 11R,A02,892722,Herbst; Matthew,0,0,0,3
1746535055467,MMW 12R,A01,892724,Herbst; Matthew,0,11,16,16
1746535055467,MMW 12R,A02,892725,Herbst; Matthew,0,10,16,16
1746535056493,MMW 13R,A01,892727,Staff,0,4,16,16
1746535056493,MMW 13R,A02,892728,Staff,0,4,16,16
1746535056493,MMW 13R,A03,958032,Staff,0,4,16,16
1746535056493,MMW 13R,A04,958033,Staff,0,4,16,16
1746535056493,MMW 13R,A05,958034,Staff,0,4,16,16
1746535057520,SIO 295LS,A00,894015,Staff,5,0,25,20
1746535058550,SIO 295S,A00,894020,Staff,5,0,25,20
1746535059579,SIOC 290S,B01,958918,Merrifield; Mark A,14,0,30,16
1746535060607,SIOC 291S,B01,958922,Gabriel; Corey John,14,0,30,16
1746535061635,SOCI 117,A01,895339,Staff,3,0,5,2
1746535062661,WES 237B,A00,894149,Staff,11,0,20,9
1746535064743,AESE 279B,A00,891859,Staff,13,0,35,22
1746535065771,AIP 197,001,891854,Vespa; Emanuel Ignacio,9999,0,9999,0
1746535066796,ANTH 289S,A00,891856,Gagneux; Pascal,12,0,12,0
1746535067823,BENG 196,001,957946,Engler; Adam J.,9996,0,9999,3
1746535068855,BISP 197,001,959851,Wilhelm; James E.,9999,0,9999,0
1746535069888,CAT 124RS,A01,956906,Staff,6,0,25,19
1746535072555,CAT 125RS,A01,922013,Staff,6,0,25,19
1746535073589,CLRE 250,A00,891860,Morris; Sheldon,9995,0,9999,4
1746535075652,CLRE 251R,A00,907817,Mehta; Ravindra L.,9994,0,9999,5
1746535076683,CLRE 252,A00,891864,Cuomo; Raphael Eduardo,9993,0,9999,6
1746535077709,CLRE 253,A00,891867,Vaida; Florin,9994,0,9999,5
1746535077709,CLRE 253,B00,907819,Staff,9999,0,9999,0
1746535078737,CLRE 259,A00,891868,Patel; Hemal,9998,0,9999,1
1746535079773,CLRE 260,A00,891872,Cuomo; Raphael Eduardo,9999,0,9999,0
1746535080798,CLRE 297,001,891888,Cuomo; Raphael Eduardo,9999,0,9999,0
1746535081830,CSE 191,A00,958773,Minnes Kemp; Mor Mia,9996,0,9999,3
1746535082860,CSE 197,001,959846,Minnes Kemp; Mor Mia,9993,0,9999,6
1746535083886,CSS 201S,A01,892054,Mignozzetti; Umberto,26,0,30,4
1746535084919,CSS 202S,A01,892056,Mignozzetti; Umberto,26,0,30,4
1746535085945,DSC 197,001,956898,Eldridge; Justin Matthew,9998,0,9999,1
1746535086971,DSC 297,001,958000,Mazumdar; Arya,9998,0,9999,1
1746535086971,DSC 297,002,959862,Wang; Yusu,9999,0,9999,0
1746535088000,EAP 100,A00,905686,Staff,9778,0,9999,221
1746535089036,ECE 45,A01,892618,Staff,0,0,65,65
1746535091094,ECE 111,A01,892719,Staff,4,0,65,61
1746535092118,ECE 197,001,957920,Mercier; Patrick Philip,9991,0,9999,8
1746535093145,ECON 178,A01,907814,Zhu; Ying,26,0,35,9
1746535094171,EDS 115,A00,895312,Staff,36,0,45,9
1746535095197,EDS 117,A01,895337,Staff,24,0,30,6
1746535096224,EDS 125,A00,895341,Jones; Gabrielle Anastasia,37,0,45,8
1746535097250,EDS 128A,A01,895459,Fargason; Sharon Gayle,44,0,45,1
1746535098279,EDS 128B,A01,895543,Pappas; Elizabeth,44,0,45,1
1746535099304,EDS 139,A00,897203,Pappas; Elizabeth,44,0,45,1
1746535099304,EDS 139,B00,897209,Fargason; Sharon Gayle,41,0,45,4
1746535100337,EDS 201,A00,895545,Staff,23,0,45,22
1746535101372,EDS 203,A01,895581,Halter; Christopher P.,23,0,45,22
1746535102413,EDS 204R,A01,895625,Heinzman; Erica M.,39,0,45,6
1746535102413,EDS 204R,B01,895693,Halter; Christopher P.,10,0,45,35
1746535103444,EDS 206R,A00,895694,Fargason; Sharon Gayle,1,0,30,29
1746535103444,EDS 206R,B00,895695,Choi; Bailey Miyeon,16,0,30,14
1746535104471,EDS 250,A00,895697,Hemans; Patricia Ann Benitez,23,0,45,22
1746535105497,EDS 281,A00,895701,Meyerott; Theresa Ann,1,0,15,14
1746535106524,EDS 284,A00,895736,Meyerott; Theresa Ann,1,0,15,14
1746535107552,EDS 286,A00,897210,Fine; Sarah,0,0,15,15
1746535108581,EDS 289C,A01,895770,Daly; Alan J.,15,0,15,0
1746535109607,EDS 290,A00,897211,Hofstetter; Carolyn,0,0,15,15
1746535110642,LIGM 5A,A00,896162,Fischer-Grunski; Eva K,13,0,20,7
1746535111672,LIGM 5B,A00,896260,Fischer-Grunski; Eva K,17,0,20,3
1746535112699,LIGM 5C,A00,896308,Fischer-Grunski; Eva K,18,0,20,2
1746535113726,LIIT 5AS,A00,896313,Carnelos; Chiara,18,0,20,2
1746535114754,LIIT 5BS,A00,896416,Carnelos; Chiara,20,0,20,0
1746535115785,LIIT 5CS,A00,896564,Carnelos; Chiara,20,0,20,0
1746535116818,LISP 5A,A00,896588,Munoz Sanchez; Alicia,3,0,20,17
1746535117844,LISP 5B,A00,896653,Munoz Sanchez; Alicia,7,0,20,13
1746535118875,LISP 5C,A00,896655,Munoz Sanchez; Alicia,0,1,20,20
1746535119907,MAE 197,001,957918,Kleissl; Jan,9996,0,9999,3
1746535119907,MAE 197,002,959806,Boechler; Nicholas Sebastia,9998,0,9999,1
1746535119907,MAE 197,003,959852,Mullin; Jennifer S,9999,0,9999,0
1746535120938,MATH 2,A01,957937,Staff,33,0,35,2
1746535121972,MATH 197,001,957876,Kedlaya; Kiran S.,9993,0,9999,6
1746535123005,MCWP 40,A00,892729,Duru; Nur,10,0,20,10
1746535123005,MCWP 40,B00,893304,Montejo; Carolina,14,0,20,6
1746535124034,MCWP 40R,A00,893757,Redela; Pamela Morgan,0,5,20,20
1746535125061,MCWP 50,A00,893758,Morshed; Michael James,0,0,20,20
1746535125061,MCWP 50,B00,893761,Bartulis; Jason Michael,17,0,20,3
1746535126088,MCWP 50R,A00,893766,Compas; Sean Matthew,0,1,20,20
1746535126088,MCWP 50R,B00,893769,Carter; Jennifer A,0,1,20,20
1746535126088,MCWP 50R,C00,893771,Krone; Jarret,0,3,20,20
1746535126088,MCWP 50R,D00,893772,Miller; Elizabeth Deen,0,0,20,20
1746535126088,MCWP 50R,E00,893775,Carter; Andrea L,0,1,20,20
1746535127115,MMW 11R,A01,892721,Herbst; Matthew,11,0,27,16
1746535127115,MMW 11R,A02,892722,Herbst; Matthew,0,0,0,3
1746535128144,MMW 12R,A01,892724,Herbst; Matthew,0,11,16,16
1746535128144,MMW 12R,A02,892725,Herbst; Matthew,0,10,16,16
1746535129174,MMW 13R,A01,892727,Staff,0,4,16,16
1746535129174,MMW 13R,A02,892728,Staff,0,4,16,16
1746535129174,MMW 13R,A03,958032,Staff,0,4,16,16
1746535129174,MMW 13R,A04,958033,Staff,0,4,16,16
1746535129174,MMW 13R,A05,958034,Staff,0,4,16,16
1746535130205,SIO 295LS,A00,894015,Staff,5,0,25,20
1746535131235,SIO 295S,A00,894020,Staff,5,0,25,20
1746535132263,SIOC 290S,B01,958918,Merrifield; Mark A,14,0,30,16
1746535133297,SIOC 291S,B01,958922,Gabriel; Corey John,14,0,30,16
1746535134323,SOCI 117,A01,895339,Staff,3,0,5,2
1746535135348,WES 237B,A00,894149,Staff,11,0,20,9
1746535137424,AESE 279B,A00,891859,Staff,13,0,35,22
1746535138455,AIP 197,001,891854,Vespa; Emanuel Ignacio,9999,0,9999,0
1746535139486,ANTH 289S,A00,891856,Gagneux; Pascal,12,0,12,0
1746535140512,BENG 196,001,957946,Engler; Adam J.,9996,0,9999,3
1746535141544,BISP 197,001,959851,Wilhelm; James E.,9999,0,9999,0
1746535142572,CAT 124RS,A01,956906,Staff,6,0,25,19
1746535143602,CAT 125RS,A01,922013,Staff,6,0,25,19
1746535144632,CLRE 250,A00,891860,Morris; Sheldon,9995,0,9999,4
1746535146688,CLRE 251R,A00,907817,Mehta; Ravindra L.,9994,0,9999,5
1746535147713,CLRE 252,A00,891864,Cuomo; Raphael Eduardo,9993,0,9999,6
1746535148746,CLRE 253,A00,891867,Vaida; Florin,9994,0,9999,5
1746535148746,CLRE 253,B00,907819,Staff,9999,0,9999,0
1746535149775,CLRE 259,A00,891868,Patel; Hemal,9998,0,9999,1
1746535150801,CLRE 260,A00,891872,Cuomo; Raphael Eduardo,9999,0,9999,0
1746535151828,CLRE 297,001,891888,Cuomo; Raphael Eduardo,9999,0,9999,0
1746535152859,CSE 191,A00,958773,Minnes Kemp; Mor Mia,9996,0,9999,3
1746535153885,CSE 197,001,959846,Minnes Kemp; Mor Mia,9993,0,9999,6
1746535154912,CSS 201S,A01,892054,Mignozzetti; Umberto,26,0,30,4
1746535155939,CSS 202S,A01,892056,Mignozzetti; Umberto,26,0,30,4
1746535156966,DSC 197,001,956898,Eldridge; Justin Matthew,9998,0,9999,1
1746535157997,DSC 297,001,958000,Mazumdar; Arya,9998,0,9999,1
1746535157997,DSC 297,002,959862,Wang; Yusu,9999,0,9999,0
1746535159024,EAP 100,A00,905686,Staff,9778,0,9999,221
1746535160051,ECE 45,A01,892618,Staff,0,0,65,65
1746535162107,ECE 111,A01,892719,Staff,4,0,65,61
1746535163137,ECE 197,001,957920,Mercier; Patrick Philip,9991,0,9999,8
1746535164166,ECON 178,A01,907814,Zhu; Ying,26,0,35,9
1746535165195,EDS 115,A00,895312,Staff,36,0,45,9
1746535166225,EDS 117,A01,895337,Staff,24,0,30,6
1746535167252,EDS 125,A00,895341,Jones; Gabrielle Anastasia,37,0,45,8
1746535168281,EDS 128A,A01,895459,Fargason; Sharon Gayle,44,0,45,1
1746535169313,EDS 128B,A01,895543,Pappas; Elizabeth,44,0,45,1
1746535170340,EDS 139,A00,897203,Pappas; Elizabeth,44,0,45,1
1746535170340,EDS 139,B00,897209,Fargason; Sharon Gayle,41,0,45,4
1746535171369,EDS 201,A00,895545,Staff,23,0,45,22
1746535172406,EDS 203,A01,895581,Halter; Christopher P.,23,0,45,22
1746535173434,EDS 204R,A01,895625,Heinzman; Erica M.,39,0,45,6
1746535173434,EDS 204R,B01,895693,Halter; Christopher P.,10,0,45,35
1746535174459,EDS 206R,A00,895694,Fargason; Sharon Gayle,1,0,30,29
1746535174459,EDS 206R,B00,895695,Choi; Bailey Miyeon,16,0,30,14
1746535175490,EDS 250,A00,895697,Hemans; Patricia Ann Benitez,23,0,45,22
1746535176519,EDS 281,A00,895701,Meyerott; Theresa Ann,1,0,15,14
1746535177549,EDS 284,A00,895736,Meyerott; Theresa Ann,1,0,15,14
1746535178577,EDS 286,A00,897210,Fine; Sarah,0,0,15,15
1746535179608,EDS 289C,A01,895770,Daly; Alan J.,15,0,15,0
1746535180637,EDS 290,A00,897211,Hofstetter; Carolyn,0,0,15,15
1746535181662,LIGM 5A,A00,896162,Fischer-Grunski; Eva K,13,0,20,7
1746535182691,LIGM 5B,A00,896260,Fischer-Grunski; Eva K,17,0,20,3
1746535183719,LIGM 5C,A00,896308,Fischer-Grunski; Eva K,18,0,20,2
1746535184751,LIIT 5AS,A00,896313,Carnelos; Chiara,18,0,20,2
1746535185780,LIIT 5BS,A00,896416,Carnelos; Chiara,20,0,20,0
1746535186808,LIIT 5CS,A00,896564,Carnelos; Chiara,20,0,20,0
1746535187837,LISP 5A,A00,896588,Munoz Sanchez; Alicia,3,0,20,17
1746535188868,LISP 5B,A00,896653,Munoz Sanchez; Alicia,7,0,20,13
1746535189899,LISP 5C,A00,896655,Munoz Sanchez; Alicia,0,1,20,20
1746535190928,MAE 197,001,957918,Kleissl; Jan,9996,0,9999,3
1746535190928,MAE 197,002,959806,Boechler; Nicholas Sebastia,9998,0,9999,1
1746535190928,MAE 197,003,959852,Mullin; Jennifer S,9999,0,9999,0
1746535191954,MATH 2,A01,957937,Staff,33,0,35,2
1746535192985,MATH 197,001,957876,Kedlaya; Kiran S.,9993,0,9999,6
1746535194012,MCWP 40,A00,892729,Duru; Nur,10,0,20,10
1746535194012,MCWP 40,B00,893304,Montejo; Carolina,14,0,20,6
1746535195051,MCWP 40R,A00,893757,Redela; Pamela Morgan,0,5,20,20
1746535196078,MCWP 50,A00,893758,Morshed; Michael James,0,0,20,20
1746535196078,MCWP 50,B00,893761,Bartulis; Jason Michael,17,0,20,3
1746535197106,MCWP 50R,A00,893766,Compas; Sean Matthew,0,1,20,20
1746535197106,MCWP 50R,B00,893769,Carter; Jennifer A,0,1,20,20
1746535197106,MCWP 50R,C00,893771,Krone; Jarret,0,3,20,20
1746535197106,MCWP 50R,D00,893772,Miller; Elizabeth Deen,0,0,20,20
1746535197106,MCWP 50R,E00,893775,Carter; Andrea L,0,1,20,20
1746535198134,MMW 11R,A01,892721,Herbst; Matthew,11,0,27,16
1746535198134,MMW 11R,A02,892722,Herbst; Matthew,0,0,0,3
1746535199159,MMW 12R,A01,892724,Herbst; Matthew,0,11,16,16
1746535199159,MMW 12R,A02,892725,Herbst; Matthew,0,10,16,16
1746535200188,MMW 13R,A01,892727,Staff,0,4,16,16
1746535200188,MMW 13R,A02,892728,Staff,0,4,16,16
1746535200188,MMW 13R,A03,958032,Staff,0,4,16,16
1746535200188,MMW 13R,A04,958033,Staff,0,4,16,16
1746535200188,MMW 13R,A05,958034,Staff,0,4,16,16
1746535201217,SIO 295LS,A00,894015,Staff,5,0,25,20
1746535202248,SIO 295S,A00,894020,Staff,5,0,25,20
1746535203284,SIOC 290S,B01,958918,Merrifield; Mark A,14,0,30,16
1746535204313,SIOC 291S,B01,958922,Gabriel; Corey John,14,0,30,16
1746535205338,SOCI 117,A01,895339,Staff,3,0,5,2
1746535206370,WES 237B,A00,894149,Staff,11,0,20,9
1746535208441,AESE 279B,A00,891859,Staff,13,0,35,22
1746535209473,AIP 197,001,891854,Vespa; Emanuel Ignacio,9999,0,9999,0
1746535210505,ANTH 289S,A00,891856,Gagneux; Pascal,12,0,12,0
1746535211539,BENG 196,001,957946,Engler; Adam J.,9996,0,9999,3
1746535212569,BISP 197,001,959851,Wilhelm; James E.,9999,0,9999,0
1746535213595,CAT 124RS,A01,956906,Staff,6,0,25,19
1746535214623,CAT 125RS,A01,922013,Staff,6,0,25,19
1746535215650,CLRE 250,A00,891860,Morris; Sheldon,9995,0,9999,4
1746535217703,CLRE 251R,A00,907817,Mehta; Ravindra L.,9994,0,9999,5
1746535218732,CLRE 252,A00,891864,Cuomo; Raphael Eduardo,9993,0,9999,6
1746535219767,CLRE 253,A00,891867,Vaida; Florin,9994,0,9999,5
1746535219767,CLRE 253,B00,907819,Staff,9999,0,9999,0
1746535220795,CLRE 259,A00,891868,Patel; Hemal,9998,0,9999,1
1746535221821,CLRE 260,A00,891872,Cuomo; Raphael Eduardo,9999,0,9999,0
1746535222853,CLRE 297,001,891888,Cuomo; Raphael Eduardo,9999,0,9999,0
1746535223879,CSE 191,A00,958773,Minnes Kemp; Mor Mia,9996,0,9999,3
1746535224904,CSE 197,001,959846,Minnes Kemp; Mor Mia,9993,0,9999,6
1746535225931,CSS 201S,A01,892054,Mignozzetti; Umberto,26,0,30,4
1746535226964,CSS 202S,A01,892056,Mignozzetti; Umberto,26,0,30,4
1746535227990,DSC 197,001,956898,Eldridge; Justin Matthew,9998,0,9999,1
1746535229023,DSC 297,001,958000,Mazumdar; Arya,9998,0,9999,1
1746535229023,DSC 297,002,959862,Wang; Yusu,9999,0,9999,0
1746535230050,EAP 100,A00,905686,Staff,9778,0,9999,221
1746535231088,ECE 45,A01,892618,Staff,0,0,65,65
1746535233148,ECE 111,A01,892719,Staff,4,0,65,61
1746535234174,ECE 197,001,957920,Mercier; Patrick Philip,9991,0,9999,8
1746535235200,ECON 178,A01,907814,Zhu; Ying,26,0,35,9
1746535236231,EDS 115,A00,895312,Staff,36,0,45,9
1746535237262,EDS 117,A01,895337,Staff,24,0,30,6
1746535238295,EDS 125,A00,895341,Jones; Gabrielle Anastasia,37,0,45,8
1746535239326,EDS 128A,A01,895459,Fargason; Sharon Gayle,44,0,45,1
1746535240357,EDS 128B,A01,895543,Pappas; Elizabeth,44,0,45,1
1746535241385,EDS 139,A00,897203,Pappas; Elizabeth,44,0,45,1
1746535241385,EDS 139,B00,897209,Fargason; Sharon Gayle,41,0,45,4
1746535242424,EDS 201,A00,895545,Staff,23,0,45,22
1746535243451,EDS 203,A01,895581,Halter; Christopher P.,23,0,45,22
1746535244479,EDS 204R,A01,895625,Heinzman; Erica M.,39,0,45,6
1746535244479,EDS 204R,B01,895693,Halter; Christopher P.,10,0,45,35
1746535245509,EDS 206R,A00,895694,Fargason; Sharon Gayle,1,0,30,29
1746535245509,EDS 206R,B00,895695,Choi; Bailey Miyeon,16,0,30,14
1746535246537,EDS 250,A00,895697,Hemans; Patricia Ann Benitez,23,0,45,22
1746535247564,EDS 281,A00,895701,Meyerott; Theresa Ann,1,0,15,14
1746535248592,EDS 284,A00,895736,Meyerott; Theresa Ann,1,0,15,14
1746535249624,EDS 286,A00,897210,Fine; Sarah,0,0,15,15
1746535250652,EDS 289C,A01,895770,Daly; Alan J.,15,0,15,0
1746535251683,EDS 290,A00,897211,Hofstetter; Carolyn,0,0,15,15
1746535252711,LIGM 5A,A00,896162,Fischer-Grunski; Eva K,13,0,20,7
1746535253739,LIGM 5B,A00,896260,Fischer-Grunski; Eva K,17,0,20,3
1746535254769,LIGM 5C,A00,896308,Fischer-Grunski; Eva K,18,0,20,2
1746535255798,LIIT 5AS,A00,896313,Carnelos; Chiara,18,0,20,2
1746535256823,LIIT 5BS,A00,896416,Carnelos; Chiara,20,0,20,0
1746535257848,LIIT 5CS,A00,896564,Carnelos; Chiara,20,0,20,0
1746535258875,LISP 5A,A00,896588,Munoz Sanchez; Alicia,3,0,20,17
1746535259902,LISP 5B,A00,896653,Munoz Sanchez; Alicia,7,0,20,13
1746535260932,LISP 5C,A00,896655,Munoz Sanchez; Alicia,0,1,20,20
1746535261961,MAE 197,001,957918,Kleissl; Jan,9996,0,9999,3
1746535261961,MAE 197,002,959806,Boechler; Nicholas Sebastia,9998,0,9999,1
1746535261961,MAE 197,003,959852,Mullin; Jennifer S,9999,0,9999,0
1746535262989,MATH 2,A01,957937,Staff,33,0,35,2
1746535264025,MATH 197,001,957876,Kedlaya; Kiran S.,9993,0,9999,6
1746535265060,MCWP 40,A00,892729,Duru; Nur,10,0,20,10
1746535265060,MCWP 40,B00,893304,Montejo; Carolina,14,0,20,6
1746535266085,MCWP 40R,A00,893757,Redela; Pamela Morgan,0,5,20,20
1746535267115,MCWP 50,A00,893758,Morshed; Michael James,0,0,20,20
1746535267115,MCWP 50,B00,893761,Bartulis; Jason Michael,17,0,20,3
1746535268149,MCWP 50R,A00,893766,Compas; Sean Matthew,0,1,20,20
1746535268149,MCWP 50R,B00,893769,Carter; Jennifer A,0,1,20,20
1746535268149,MCWP 50R,C00,893771,Krone; Jarret,0,3,20,20
1746535268149,MCWP 50R,D00,893772,Miller; Elizabeth Deen,0,0,20,20
1746535268149,MCWP 50R,E00,893775,Carter; Andrea L,0,1,20,20
1746535269176,MMW 11R,A01,892721,Herbst; Matthew,11,0,27,16
1746535269176,MMW 11R,A02,892722,Herbst; Matthew,0,0,0,3
1746535270204,MMW 12R,A01,892724,Herbst; Matthew,0,11,16,16
1746535270204,MMW 12R,A02,892725,Herbst; Matthew,0,10,16,16
1746535271236,MMW 13R,A01,892727,Staff,0,4,16,16
1746535271236,MMW 13R,A02,892728,Staff,0,4,16,16
1746535271236,MMW 13R,A03,958032,Staff,0,4,16,16
1746535271236,MMW 13R,A04,958033,Staff,0,4,16,16
1746535271236,MMW 13R,A05,958034,Staff,0,4,16,16
1746535272268,SIO 295LS,A00,894015,Staff,5,0,25,20
1746535273297,SIO 295S,A00,894020,Staff,5,0,25,20
1746535274323,SIOC 290S,B01,958918,Merrifield; Mark A,14,0,30,16
1746535275356,SIOC 291S,B01,958922,Gabriel; Corey John,14,0,30,16
1746535276382,SOCI 117,A01,895339,Staff,3,0,5,2
1746535277409,WES 237B,A00,894149,Staff,11,0,20,9
1746535279499,AESE 279B,A00,891859,Staff,13,0,35,22
1746535280530,AIP 197,001,891854,Vespa; Emanuel Ignacio,9999,0,9999,0
1746535281560,ANTH 289S,A00,891856,Gagneux; Pascal,12,0,12,0
1746535282588,BENG 196,001,957946,Engler; Adam J.,9996,0,9999,3
1746535283614,BISP 197,001,959851,Wilhelm; James E.,9999,0,9999,0
1746535284646,CAT 124RS,A01,956906,Staff,6,0,25,19
1746535285672,CAT 125RS,A01,922013,Staff,6,0,25,19
1746535286706,CLRE 250,A00,891860,Morris; Sheldon,9995,0,9999,4
1746535288764,CLRE 251R,A00,907817,Mehta; Ravindra L.,9994,0,9999,5
1746535289793,CLRE 252,A00,891864,Cuomo; Raphael Eduardo,9993,0,9999,6
1746535290825,CLRE 253,A00,891867,Vaida; Florin,9994,0,9999,5
1746535290825,CLRE 253,B00,907819,Staff,9999,0,9999,0
1746535291851,CLRE 259,A00,891868,Patel; Hemal,9998,0,9999,1
1746535292876,CLRE 260,A00,891872,Cuomo; Raphael Eduardo,9999,0,9999,0
1746535293902,CLRE 297,001,891888,Cuomo; Raphael Eduardo,9999,0,9999,0
1746535294934,CSE 191,A00,958773,Minnes Kemp; Mor Mia,9996,0,9999,3
1746535295959,CSE 197,001,959846,Minnes Kemp; Mor Mia,9993,0,9999,6
1746535296987,CSS 201S,A01,892054,Mignozzetti; Umberto,26,0,30,4
1746535298015,CSS 202S,A01,892056,Mignozzetti; Umberto,26,0,30,4
1746535299041,DSC 197,001,956898,Eldridge; Justin Matthew,9998,0,9999,1
1746535300071,DSC 297,001,958000,Mazumdar; Arya,9998,0,9999,1
1746535300071,DSC 297,002,959862,Wang; Yusu,9999,0,9999,0
1746535301097,EAP 100,A00,905686,Staff,9778,0,9999,221
1746535302125,ECE 45,A01,892618,Staff,0,0,65,65
1746535304216,ECE 111,A01,892719,Staff,4,0,65,61
1746535305246,ECE 197,001,957920,Mercier; Patrick Philip,9991,0,9999,8
1746535306273,ECON 178,A01,907814,Zhu; Ying,26,0,35,9
1746535307299,EDS 115,A00,895312,Staff,36,0,45,9
1746535308326,EDS 117,A01,895337,Staff,24,0,30,6
1746535309356,EDS 125,A00,895341,Jones; Gabrielle Anastasia,37,0,45,8
1746535310386,EDS 128A,A01,895459,Fargason; Sharon Gayle,44,0,45,1
1746535311413,EDS 128B,A01,895543,Pappas; Elizabeth,44,0,45,1
1746535312440,EDS 139,A00,897203,Pappas; Elizabeth,44,0,45,1
1746535312440,EDS 139,B00,897209,Fargason; Sharon Gayle,41,0,45,4
1746535313469,EDS 201,A00,895545,Staff,23,0,45,22
1746535314544,EDS 203,A01,895581,Halter; Christopher P.,23,0,45,22
1746535315572,EDS 204R,A01,895625,Heinzman; Erica M.,39,0,45,6
1746535315572,EDS 204R,B01,895693,Halter; Christopher P.,10,0,45,35
1746535316598,EDS 206R,A00,895694,Fargason; Sharon Gayle,1,0,30,29
1746535316598,EDS 206R,B00,895695,Choi; Bailey Miyeon,16,0,30,14
1746535317626,EDS 250,A00,895697,Hemans; Patricia Ann Benitez,23,0,45,22
1746535318656,EDS 281,A00,895701,Meyerott; Theresa Ann,1,0,15,14
1746535319684,EDS 284,A00,895736,Meyerott; Theresa Ann,1,0,15,14
1746535320710,EDS 286,A00,897210,Fine; Sarah,0,0,15,15
1746535321756,EDS 289C,A01,895770,Daly; Alan J.,15,0,15,0
1746535322782,EDS 290,A00,897211,Hofstetter; Carolyn,0,0,15,15
1746535323808,LIGM 5A,A00,896162,Fischer-Grunski; Eva K,13,0,20,7
1746535324836,LIGM 5B,A00,896260,Fischer-Grunski; Eva K,17,0,20,3
1746535325861,LIGM 5C,A00,896308,Fischer-Grunski; Eva K,18,0,20,2
1746535326891,LIIT 5AS,A00,896313,Carnelos; Chiara,18,0,20,2
1746535327917,LIIT 5BS,A00,896416,Carnelos; Chiara,20,0,20,0
1746535328944,LIIT 5CS,A00,896564,Carnelos; Chiara,20,0,20,0
1746535329973,LISP 5A,A00,896588,Munoz Sanchez; Alicia,3,0,20,17
1746535331004,LISP 5B,A00,896653,Munoz Sanchez; Alicia,7,0,20,13
1746535332032,LISP 5C,A00,896655,Munoz Sanchez; Alicia,0,1,20,20
1746535333063,MAE 197,001,957918,Kleissl; Jan,9996,0,9999,3
1746535333063,MAE 197,002,959806,Boechler; Nicholas Sebastia,9998,0,9999,1
1746535333063,MAE 197,003,959852,Mullin; Jennifer S,9999,0,9999,0
1746535334094,MATH 2,A01,957937,Staff,33,0,35,2
1746535335122,MATH 197,001,957876,Kedlaya; Kiran S.,9993,0,9999,6
1746535336151,MCWP 40,A00,892729,Duru; Nur,10,0,20,10
1746535336151,MCWP 40,B00,893304,Montejo; Carolina,14,0,20,6
1746535337177,MCWP 40R,A00,893757,Redela; Pamela Morgan,0,5,20,20
1746535338205,MCWP 50,A00,893758,Morshed; Michael James,0,0,20,20
1746535338205,MCWP 50,B00,893761,Bartulis; Jason Michael,17,0,20,3
1746535339234,MCWP 50R,A00,893766,Compas; Sean Matthew,0,1,20,20
1746535339234,MCWP 50R,B00,893769,Carter; Jennifer A,0,1,20,20
1746535339234,MCWP 50R,C00,893771,Krone; Jarret,0,3,20,20
1746535339234,MCWP 50R,D00,893772,Miller; Elizabeth Deen,0,0,20,20
1746535339234,MCWP 50R,E00,893775,Carter; Andrea L,0,1,20,20
1746535340600,MMW 11R,A01,892721,Herbst; Matthew,11,0,27,16
1746535340600,MMW 11R,A02,892722,Herbst; Matthew,0,0,0,3
1746535341629,MMW 12R,A01,892724,Herbst; Matthew,0,11,16,16
1746535341629,MMW 12R,A02,892725,Herbst; Matthew,0,10,16,16
1746535342660,MMW 13R,A01,892727,Staff,0,4,16,16
1746535342660,MMW 13R,A02,892728,Staff,0,4,16,16
1746535342660,MMW 13R,A03,958032,Staff,0,4,16,16
1746535342660,MMW 13R,A04,958033,Staff,0,4,16,16
1746535342660,MMW 13R,A05,958034,Staff,0,4,16,16
1746535343690,SIO 295LS,A00,894015,Staff,5,0,25,20
1746535344721,SIO 295S,A00,894020,Staff,5,0,25,20
1746535345748,SIOC 290S,B01,958918,Merrifield; Mark A,14,0,30,16
1746535346777,SIOC 291S,B01,958922,Gabriel; Corey John,14,0,30,16
1746535347809,SOCI 117,A01,895339,Staff,3,0,5,2
1746535348834,WES 237B,A00,894149,Staff,11,0,20,9
1746535350926,AESE 279B,A00,891859,Staff,13,0,35,22
1746535351954,AIP 197,001,891854,Vespa; Emanuel Ignacio,9999,0,9999,0
1746535352979,ANTH 289S,A00,891856,Gagneux; Pascal,12,0,12,0
1746535354009,BENG 196,001,957946,Engler; Adam J.,9996,0,9999,3
1746535355040,BISP 197,001,959851,Wilhelm; James E.,9999,0,9999,0
1746535356068,CAT 124RS,A01,956906,Staff,6,0,25,19
1746535357094,CAT 125RS,A01,922013,Staff,6,0,25,19
1746535358123,CLRE 250,A00,891860,Morris; Sheldon,9995,0,9999,4
1746535360180,CLRE 251R,A00,907817,Mehta; Ravindra L.,9994,0,9999,5
1746535361204,CLRE 252,A00,891864,Cuomo; Raphael Eduardo,9993,0,9999,6
1746535362233,CLRE 253,A00,891867,Vaida; Florin,9994,0,9999,5
1746535362233,CLRE 253,B00,907819,Staff,9999,0,9999,0
1746535363259,CLRE 259,A00,891868,Patel; Hemal,9998,0,9999,1
1746535364287,CLRE 260,A00,891872,Cuomo; Raphael Eduardo,9999,0,9999,0
1746535365320,CLRE 297,001,891888,Cuomo; Raphael Eduardo,9999,0,9999,0
1746535366348,CSE 191,A00,958773,Minnes Kemp; Mor Mia,9996,0,9999,3
1746535367379,CSE 197,001,959846,Minnes Kemp; Mor Mia,9993,0,9999,6
1746535368412,CSS 201S,A01,892054,Mignozzetti; Umberto,26,0,30,4
1746535369438,CSS 202S,A01,892056,Mignozzetti; Umberto,26,0,30,4
1746535370468,DSC 197,001,956898,Eldridge; Justin Matthew,9998,0,9999,1
1746535371493,DSC 297,001,958000,Mazumdar; Arya,9998,0,9999,1
1746535371493,DSC 297,002,959862,Wang; Yusu,9999,0,9999,0
1746535372518,EAP 100,A00,905686,Staff,9778,0,9999,221
1746535373549,ECE 45,A01,892618,Staff,0,0,65,65
1746535375623,ECE 111,A01,892719,Staff,4,0,65,61
1746535376653,ECE 197,001,957920,Mercier; Patrick Philip,9991,0,9999,8
1746535377680,ECON 178,A01,907814,Zhu; Ying,26,0,35,9
1746535378712,EDS 115,A00,895312,Staff,36,0,45,9
1746535379739,EDS 117,A01,895337,Staff,24,0,30,6
1746535380769,EDS 125,A00,895341,Jones; Gabrielle Anastasia,37,0,45,8
1746535381798,EDS 128A,A01,895459,Fargason; Sharon Gayle,44,0,45,1
1746535382825,EDS 128B,A01,895543,Pappas; Elizabeth,44,0,45,1
1746535383857,EDS 139,A00,897203,Pappas; Elizabeth,44,0,45,1
1746535383857,EDS 139,B00,897209,Fargason; Sharon Gayle,41,0,45,4
1746535384882,EDS 201,A00,895545,Staff,23,0,45,22
1746535385909,EDS 203,A01,895581,Halter; Christopher P.,23,0,45,22
1746535386936,EDS 204R,A01,895625,Heinzman; Erica M.,39,0,45,6
1746535386936,EDS 204R,B01,895693,Halter; Christopher P.,10,0,45,35
1746535387964,EDS 206R,A00,895694,Fargason; Sharon Gayle,1,0,30,29
1746535387964,EDS 206R,B00,895695,Choi; Bailey Miyeon,16,0,30,14
1746535388992,EDS 250,A00,895697,Hemans; Patricia Ann Benitez,23,0,45,22
1746535390020,EDS 281,A00,895701,Meyerott; Theresa Ann,1,0,15,14
1746535391046,EDS 284,A00,895736,Meyerott; Theresa Ann,1,0,15,14
1746535392073,EDS 286,A00,897210,Fine; Sarah,0,0,15,15
1746535393105,EDS 289C,A01,895770,Daly; Alan J.,15,0,15,0
1746535394136,EDS 290,A00,897211,Hofstetter; Carolyn,0,0,15,15
1746535395162,LIGM 5A,A00,896162,Fischer-Grunski; Eva K,13,0,20,7
1746535396195,LIGM 5B,A00,896260,Fischer-Grunski; Eva K,17,0,20,3
1746535397223,LIGM 5C,A00,896308,Fischer-Grunski; Eva K,18,0,20,2
1746535398253,LIIT 5AS,A00,896313,Carnelos; Chiara,18,0,20,2
1746535399281,LIIT 5BS,A00,896416,Carnelos; Chiara,20,0,20,0
1746535400308,LIIT 5CS,A00,896564,Carnelos; Chiara,20,0,20,0
1746535401340,LISP 5A,A00,896588,Munoz Sanchez; Alicia,3,0,20,17
1746535402366,LISP 5B,A00,896653,Munoz Sanchez; Alicia,7,0,20,13
1746535403394,LISP 5C,A00,896655,Munoz Sanchez; Alicia,0,1,20,20
1746535404423,MAE 197,001,957918,Kleissl; Jan,9996,0,9999,3
1746535404423,MAE 197,002,959806,Boechler; Nicholas Sebastia,9998,0,9999,1
1746535404423,MAE 197,003,959852,Mullin; Jennifer S,9999,0,9999,0
1746535405455,MATH 2,A01,957937,Staff,33,0,35,2
1746535406482,MATH 197,001,957876,Kedlaya; Kiran S.,9993,0,9999,6
1746535407508,MCWP 40,A00,892729,Duru; Nur,10,0,20,10
1746535407508,MCWP 40,B00,893304,Montejo; Carolina,14,0,20,6
1746535408534,MCWP 40R,A00,893757,Redela; Pamela Morgan,0,5,20,20
1746535409566,MCWP 50,A00,893758,Morshed; Michael James,0,0,20,20
1746535409566,MCWP 50,B00,893761,Bartulis; Jason Michael,17,0,20,3
1746535410598,MCWP 50R,A00,893766,Compas; Sean Matthew,0,1,20,20
1746535410598,MCWP 50R,B00,893769,Carter; Jennifer A,0,1,20,20
1746535410598,MCWP 50R,C00,893771,Krone; Jarret,0,3,20,20
1746535410598,MCWP 50R,D00,893772,Miller; Elizabeth Deen,0,0,20,20
1746535410598,MCWP 50R,E00,893775,Carter; Andrea L,0,1,20,20
1746535411626,MMW 11R,A01,892721,Herbst; Matthew,11,0,27,16
1746535411626,MMW 11R,A02,892722,Herbst; Matthew,0,0,0,3
1746535412653,MMW 12R,A01,892724,Herbst; Matthew,0,11,16,16
1746535412653,MMW 12R,A02,892725,Herbst; Matthew,0,10,16,16
1746535413684,MMW 13R,A01,892727,Staff,0,4,16,16
1746535413684,MMW 13R,A02,892728,Staff,0,4,16,16
1746535413684,MMW 13R,A03,958032,Staff,0,4,16,16
1746535413684,MMW 13R,A04,958033,Staff,0,4,16,16
1746535413684,MMW 13R,A05,958034,Staff,0,4,16,16
1746535414710,SIO 295LS,A00,894015,Staff,5,0,25,20
1746535415739,SIO 295S,A00,894020,Staff,5,0,25,20
1746535416767,SIOC 290S,B01,958918,Merrifield; Mark A,14,0,30,16
1746535417796,SIOC 291S,B01,958922,Gabriel; Corey John,14,0,30,16
1746535418825,SOCI 117,A01,895339,Staff,3,0,5,2
1746535419852,WES 237B,A00,894149,Staff,11,0,20,9
1746535421929,AESE 279B,A00,891859,Staff,13,0,35,22
1746535422959,AIP 197,001,891854,Vespa; Emanuel Ignacio,9999,0,9999,0
1746535423986,ANTH 289S,A00,891856,Gagneux; Pascal,12,0,12,0
1746535425019,BENG 196,001,957946,Engler; Adam J.,9996,0,9999,3
1746535426046,BISP 197,001,959851,Wilhelm; James E.,9999,0,9999,0
1746535427075,CAT 124RS,A01,956906,Staff,6,0,25,19
1746535428101,CAT 125RS,A01,922013,Staff,6,0,25,19
1746535429134,CLRE 250,A00,891860,Morris; Sheldon,9995,0,9999,4
1746535431190,CLRE 251R,A00,907817,Mehta; Ravindra L.,9994,0,9999,5
1746535432218,CLRE 252,A00,891864,Cuomo; Raphael Eduardo,9993,0,9999,6
1746535433245,CLRE 253,A00,891867,Vaida; Florin,9994,0,9999,5
1746535433245,CLRE 253,B00,907819,Staff,9999,0,9999,0
1746535434268,CLRE 259,A00,891868,Patel; Hemal,9998,0,9999,1
1746535435296,CLRE 260,A00,891872,Cuomo; Raphael Eduardo,9999,0,9999,0
1746535436323,CLRE 297,001,891888,Cuomo; Raphael Eduardo,9999,0,9999,0
1746535437353,CSE 191,A00,958773,Minnes Kemp; Mor Mia,9996,0,9999,3
1746535438384,CSE 197,001,959846,Minnes Kemp; Mor Mia,9993,0,9999,6
1746535439414,CSS 201S,A01,892054,Mignozzetti; Umberto,26,0,30,4
1746535440441,CSS 202S,A01,892056,Mignozzetti; Umberto,26,0,30,4
1746535441472,DSC 197,001,956898,Eldridge; Justin Matthew,9998,0,9999,1
1746535442499,DSC 297,001,958000,Mazumdar; Arya,9998,0,9999,1
1746535442499,DSC 297,002,959862,Wang; Yusu,9999,0,9999,0
1746535443529,EAP 100,A00,905686,Staff,9778,0,9999,221
1746535444561,ECE 45,A01,892618,Staff,0,0,65,65
1746535446615,ECE 111,A01,892719,Staff,4,0,65,61
1746535447643,ECE 197,001,957920,Mercier; Patrick Philip,9991,0,9999,8
1746535448675,ECON 178,A01,907814,Zhu; Ying,26,0,35,9
1746535449703,EDS 115,A00,895312,Staff,36,0,45,9
1746535450734,EDS 117,A01,895337,Staff,24,0,30,6
1746535451761,EDS 125,A00,895341,Jones; Gabrielle Anastasia,37,0,45,8
1746535452792,EDS 128A,A01,895459,Fargason; Sharon Gayle,44,0,45,1
1746535453823,EDS 128B,A01,895543,Pappas; Elizabeth,44,0,45,1
1746535454851,EDS 139,A00,897203,Pappas; Elizabeth,44,0,45,1
1746535454851,EDS 139,B00,897209,Fargason; Sharon Gayle,41,0,45,4
1746535455879,EDS 201,A00,895545,Staff,23,0,45,22
1746535456911,EDS 203,A01,895581,Halter; Christopher P.,23,0,45,22
1746535457937,EDS 204R,A01,895625,Heinzman; Erica M.,39,0,45,6
1746535457937,EDS 204R,B01,895693,Halter; Christopher P.,10,0,45,35
1746535458969,EDS 206R,A00,895694,Fargason; Sharon Gayle,1,0,30,29
1746535458969,EDS 206R,B00,895695,Choi; Bailey Miyeon,16,0,30,14
1746535459997,EDS 250,A00,895697,Hemans; Patricia Ann Benitez,23,0,45,22
1746535461026,EDS 281,A00,895701,Meyerott; Theresa Ann,1,0,15,14
1746535462054,EDS 284,A00,895736,Meyerott; Theresa Ann,1,0,15,14
1746535463083,EDS 286,A00,897210,Fine; Sarah,0,0,15,15
1746535464111,EDS 289C,A01,895770,Daly; Alan J.,15,0,15,0
1746535465145,EDS 290,A00,897211,Hofstetter; Carolyn,0,0,15,15
1746535466173,LIGM 5A,A00,896162,Fischer-Grunski; Eva K,13,0,20,7
1746535467205,LIGM 5B,A00,896260,Fischer-Grunski; Eva K,17,0,20,3
1746535468234,LIGM 5C,A00,896308,Fischer-Grunski; Eva K,18,0,20,2
1746535469262,LIIT 5AS,A00,896313,Carnelos; Chiara,18,0,20,2
1746535470291,LIIT 5BS,A00,896416,Carnelos; Chiara,20,0,20,0
1746535471320,LIIT 5CS,A00,896564,Carnelos; Chiara,20,0,20,0
1746535472350,LISP 5A,A00,896588,Munoz Sanchez; Alicia,3,0,20,17
1746535473377,LISP 5B,A00,896653,Munoz Sanchez; Alicia,7,0,20,13
1746535474403,LISP 5C,A00,896655,Munoz Sanchez; Alicia,0,1,20,20
1746535475431,MAE 197,001,957918,Kleissl; Jan,9996,0,9999,3
1746535475431,MAE 197,002,959806,Boechler; Nicholas Sebastia,9998,0,9999,1
1746535475431,MAE 197,003,959852,Mullin; Jennifer S,9999,0,9999,0
1746535476517,MATH 2,A01,957937,Staff,33,0,35,2
1746535477545,MATH 197,001,957876,Kedlaya; Kiran S.,9993,0,9999,6
1746535478569,MCWP 40,A00,892729,Duru; Nur,10,0,20,10
1746535478569,MCWP 40,B00,893304,Montejo; Carolina,14,0,20,6
1746535479602,MCWP 40R,A00,893757,Redela; Pamela Morgan,0,5,20,20
1746535480632,MCWP 50,A00,893758,Morshed; Michael James,0,0,20,20
1746535480632,MCWP 50,B00,893761,Bartulis; Jason Michael,17,0,20,3
1746535481667,MCWP 50R,A00,893766,Compas; Sean Matthew,0,1,20,20
1746535481667,MCWP 50R,B00,893769,Carter; Jennifer A,0,1,20,20
1746535481667,MCWP 50R,C00,893771,Krone; Jarret,0,3,20,20
1746535481667,MCWP 50R,D00,893772,Miller; Elizabeth Deen,0,0,20,20
1746535481667,MCWP 50R,E00,893775,Carter; Andrea L,0,1,20,20
1746535482697,MMW 11R,A01,892721,Herbst; Matthew,11,0,27,16
1746535482697,MMW 11R,A02,892722,Herbst; Matthew,0,0,0,3
1746535483723,MMW 12R,A01,892724,Herbst; Matthew,0,11,16,16
1746535483723,MMW 12R,A02,892725,Herbst; Matthew,0,10,16,16
1746535484751,MMW 13R,A01,892727,Staff,0,4,16,16
1746535484751,MMW 13R,A02,892728,Staff,0,4,16,16
1746535484751,MMW 13R,A03,958032,Staff,0,4,16,16
1746535484751,MMW 13R,A04,958033,Staff,0,4,16,16
1746535484751,MMW 13R,A05,958034,Staff,0,4,16,16
1746535485776,SIO 295LS,A00,894015,Staff,5,0,25,20
1746535486803,SIO 295S,A00,894020,Staff,5,0,25,20
1746535487832,SIOC 290S,B01,958918,Merrifield; Mark A,14,0,30,16
1746535488860,SIOC 291S,B01,958922,Gabriel; Corey John,14,0,30,16
1746535489885,SOCI 117,A01,895339,Staff,3,0,5,2
1746535490912,WES 237B,A00,894149,Staff,11,0,20,9
1746535492987,AESE 279B,A00,891859,Staff,13,0,35,22
1746535494013,AIP 197,001,891854,Vespa; Emanuel Ignacio,9999,0,9999,0
1746535495040,ANTH 289S,A00,891856,Gagneux; Pascal,12,0,12,0
1746535496066,BENG 196,001,957946,Engler; Adam J.,9996,0,9999,3
1746535497096,BISP 197,001,959851,Wilhelm; James E.,9999,0,9999,0
1746535498125,CAT 124RS,A01,956906,Staff,6,0,25,19
1746535499160,CAT 125RS,A01,922013,Staff,6,0,25,19
1746535500186,CLRE 250,A00,891860,Morris; Sheldon,9995,0,9999,4
1746535502240,CLRE 251R,A00,907817,Mehta; Ravindra L.,9994,0,9999,5
1746535503269,CLRE 252,A00,891864,Cuomo; Raphael Eduardo,9993,0,9999,6
1746535504301,CLRE 253,A00,891867,Vaida; Florin,9994,0,9999,5
1746535504301,CLRE 253,B00,907819,Staff,9999,0,9999,0
1746535505328,CLRE 259,A00,891868,Patel; Hemal,9998,0,9999,1
1746535506353,CLRE 260,A00,891872,Cuomo; Raphael Eduardo,9999,0,9999,0
1746535507379,CLRE 297,001,891888,Cuomo; Raphael Eduardo,9999,0,9999,0
1746535508405,CSE 191,A00,958773,Minnes Kemp; Mor Mia,9996,0,9999,3
1746535509433,CSE 197,001,959846,Minnes Kemp; Mor Mia,9993,0,9999,6
1746535510459,CSS 201S,A01,892054,Mignozzetti; Umberto,26,0,30,4
1746535511500,CSS 202S,A01,892056,Mignozzetti; Umberto,26,0,30,4
1746535512529,DSC 197,001,956898,Eldridge; Justin Matthew,9998,0,9999,1
1746535513555,DSC 297,001,958000,Mazumdar; Arya,9998,0,9999,1
1746535513555,DSC 297,002,959862,Wang; Yusu,9999,0,9999,0
1746535514585,EAP 100,A00,905686,Staff,9778,0,9999,221
1746535515621,ECE 45,A01,892618,Staff,0,0,65,65
1746535517676,ECE 111,A01,892719,Staff,4,0,65,61
1746535518702,ECE 197,001,957920,Mercier; Patrick Philip,9991,0,9999,8
1746535519732,ECON 178,A01,907814,Zhu; Ying,26,0,35,9
1746535520759,EDS 115,A00,895312,Staff,36,0,45,9
1746535521785,EDS 117,A01,895337,Staff,24,0,30,6
1746535522812,EDS 125,A00,895341,Jones; Gabrielle Anastasia,37,0,45,8
1746535523838,EDS 128A,A01,895459,Fargason; Sharon Gayle,44,0,45,1
1746535524863,EDS 128B,A01,895543,Pappas; Elizabeth,44,0,45,1
1746535525888,EDS 139,A00,897203,Pappas; Elizabeth,44,0,45,1
1746535525888,EDS 139,B00,897209,Fargason; Sharon Gayle,41,0,45,4
1746535526913,EDS 201,A00,895545,Staff,23,0,45,22
1746535527944,EDS 203,A01,895581,Halter; Christopher P.,23,0,45,22
1746535528972,EDS 204R,A01,895625,Heinzman; Erica M.,39,0,45,6
1746535528972,EDS 204R,B01,895693,Halter; Christopher P.,10,0,45,35
1746535529997,EDS 206R,A00,895694,Fargason; Sharon Gayle,1,0,30,29
1746535529997,EDS 206R,B00,895695,Choi; Bailey Miyeon,16,0,30,14
1746535531024,EDS 250,A00,895697,Hemans; Patricia Ann Benitez,23,0,45,22
1746535532053,EDS 281,A00,895701,Meyerott; Theresa Ann,1,0,15,14
1746535533079,EDS 284,A00,895736,Meyerott; Theresa Ann,1,0,15,14
1746535534105,EDS 286,A00,897210,Fine; Sarah,0,0,15,15
1746535535135,EDS 289C,A01,895770,Daly; Alan J.,15,0,15,0
1746535536165,EDS 290,A00,897211,Hofstetter; Carolyn,0,0,15,15
1746535537191,LIGM 5A,A00,896162,Fischer-Grunski; Eva K,13,0,20,7
1746535538220,LIGM 5B,A00,896260,Fischer-Grunski; Eva K,17,0,20,3
1746535539252,LIGM 5C,A00,896308,Fischer-Grunski; Eva K,18,0,20,2
1746535540280,LIIT 5AS,A00,896313,Carnelos; Chiara,18,0,20,2
1746535541307,LIIT 5BS,A00,896416,Carnelos; Chiara,20,0,20,0
1746535542336,LIIT 5CS,A00,896564,Carnelos; Chiara,20,0,20,0
1746535543366,LISP 5A,A00,896588,Munoz Sanchez; Alicia,3,0,20,17
1746535544394,LISP 5B,A00,896653,Munoz Sanchez; Alicia,7,0,20,13
1746535545420,LISP 5C,A00,896655,Munoz Sanchez; Alicia,0,1,20,20
1746535546448,MAE 197,001,957918,Kleissl; Jan,9996,0,9999,3
1746535546448,MAE 197,002,959806,Boechler; Nicholas Sebastia,9998,0,9999,1
1746535546448,MAE 197,003,959852,Mullin; Jennifer S,9999,0,9999,0
1746535547475,MATH 2,A01,957937,Staff,33,0,35,2
1746535548501,MATH 197,001,957876,Kedlaya; Kiran S.,9993,0,9999,6
1746535549529,MCWP 40,A00,892729,Duru; Nur,10,0,20,10
1746535549529,MCWP 40,B00,893304,Montejo; Carolina,14,0,20,6
1746535550554,MCWP 40R,A00,893757,Redela; Pamela Morgan,0,5,20,20
1746535551580,MCWP 50,A00,893758,Morshed; Michael James,0,0,20,20
1746535551580,MCWP 50,B00,893761,Bartulis; Jason Michael,17,0,20,3
1746535552613,MCWP 50R,A00,893766,Compas; Sean Matthew,0,1,20,20
1746535552613,MCWP 50R,B00,893769,Carter; Jennifer A,0,1,20,20
1746535552613,MCWP 50R,C00,893771,Krone; Jarret,0,3,20,20
1746535552613,MCWP 50R,D00,893772,Miller; Elizabeth Deen,0,0,20,20
1746535552613,MCWP 50R,E00,893775,Carter; Andrea L,0,1,20,20
1746535553639,MMW 11R,A01,892721,Herbst; Matthew,11,0,27,16
1746535553639,MMW 11R,A02,892722,Herbst; Matthew,0,0,0,3
1746535554665,MMW 12R,A01,892724,Herbst; Matthew,0,11,16,16
1746535554665,MMW 12R,A02,892725,Herbst; Matthew,0,10,16,16
1746535555692,MMW 13R,A01,892727,Staff,0,4,16,16
1746535555692,MMW 13R,A02,892728,Staff,0,4,16,16
1746535555692,MMW 13R,A03,958032,Staff,0,4,16,16
1746535555692,MMW 13R,A04,958033,Staff,0,4,16,16
1746535555692,MMW 13R,A05,958034,Staff,0,4,16,16
1746535556721,SIO 295LS,A00,894015,Staff,5,0,25,20
1746535557746,SIO 295S,A00,894020,Staff,5,0,25,20
1746535558781,SIOC 290S,B01,958918,Merrifield; Mark A,14,0,30,16
1746535559809,SIOC 291S,B01,958922,Gabriel; Corey John,14,0,30,16
1746535560836,SOCI 117,A01,895339,Staff,3,0,5,2
1746535561862,WES 237B,A00,894149,Staff,11,0,20,9
1746535563928,AESE 279B,A00,891859,Staff,13,0,35,22
1746535564956,AIP 197,001,891854,Vespa; Emanuel Ignacio,9999,0,9999,0
1746535565982,ANTH 289S,A00,891856,Gagneux; Pascal,12,0,12,0
1746535567011,BENG 196,001,957946,Engler; Adam J.,9996,0,9999,3
1746535568039,BISP 197,001,959851,Wilhelm; James E.,9999,0,9999,0
1746535569065,CAT 124RS,A01,956906,Staff,6,0,25,19
1746535570090,CAT 125RS,A01,922013,Staff,6,0,25,19
1746535571118,CLRE 250,A00,891860,Morris; Sheldon,9995,0,9999,4
1746535573179,CLRE 251R,A00,907817,Mehta; Ravindra L.,9994,0,9999,5
1746535574210,CLRE 252,A00,891864,Cuomo; Raphael Eduardo,9993,0,9999,6
1746535575237,CLRE 253,A00,891867,Vaida; Florin,9994,0,9999,5
1746535575237,CLRE 253,B00,907819,Staff,9999,0,9999,0
1746535576287,CLRE 259,A00,891868,Patel; Hemal,9998,0,9999,1
1746535577316,CLRE 260,A00,891872,Cuomo; Raphael Eduardo,9999,0,9999,0
1746535578345,CLRE 297,001,891888,Cuomo; Raphael Eduardo,9999,0,9999,0
1746535579369,CSE 191,A00,958773,Minnes Kemp; Mor Mia,9996,0,9999,3
1746535580394,CSE 197,001,959846,Minnes Kemp; Mor Mia,9993,0,9999,6
1746535581421,CSS 201S,A01,892054,Mignozzetti; Umberto,26,0,30,4
1746535582450,CSS 202S,A01,892056,Mignozzetti; Umberto,26,0,30,4
1746535583476,DSC 197,001,956898,Eldridge; Justin Matthew,9998,0,9999,1
1746535584527,DSC 297,001,958000,Mazumdar; Arya,9998,0,9999,1
1746535584527,DSC 297,002,959862,Wang; Yusu,9999,0,9999,0
1746535585554,EAP 100,A00,905686,Staff,9778,0,9999,221
1746535586586,ECE 45,A01,892618,Staff,0,0,65,65
1746535588639,ECE 111,A01,892719,Staff,4,0,65,61
1746535589669,ECE 197,001,957920,Mercier; Patrick Philip,9991,0,9999,8
1746535590700,ECON 178,A01,907814,Zhu; Ying,26,0,35,9
1746535591726,EDS 115,A00,895312,Staff,36,0,45,9
1746535592756,EDS 117,A01,895337,Staff,24,0,30,6
1746535593783,EDS 125,A00,895341,Jones; Gabrielle Anastasia,37,0,45,8
1746535594811,EDS 128A,A01,895459,Fargason; Sharon Gayle,44,0,45,1
1746535595838,EDS 128B,A01,895543,Pappas; Elizabeth,44,0,45,1
1746535596869,EDS 139,A00,897203,Pappas; Elizabeth,44,0,45,1
1746535596869,EDS 139,B00,897209,Fargason; Sharon Gayle,41,0,45,4
1746535597893,EDS 201,A00,895545,Staff,23,0,45,22
1746535598918,EDS 203,A01,895581,Halter; Christopher P.,23,0,45,22
1746535599946,EDS 204R,A01,895625,Heinzman; Erica M.,39,0,45,6
1746535599946,EDS 204R,B01,895693,Halter; Christopher P.,10,0,45,35
1746535600978,EDS 206R,A00,895694,Fargason; Sharon Gayle,1,0,30,29
1746535600978,EDS 206R,B00,895695,Choi; Bailey Miyeon,16,0,30,14
1746535602005,EDS 250,A00,895697,Hemans; Patricia Ann Benitez,23,0,45,22
1746535603033,EDS 281,A00,895701,Meyerott; Theresa Ann,1,0,15,14
1746535604073,EDS 284,A00,895736,Meyerott; Theresa Ann,1,0,15,14
1746535605100,EDS 286,A00,897210,Fine; Sarah,0,0,15,15
1746535606127,EDS 289C,A01,895770,Daly; Alan J.,15,0,15,0
1746535607157,EDS 290,A00,897211,Hofstetter; Carolyn,0,0,15,15
1746535608189,LIGM 5A,A00,896162,Fischer-Grunski; Eva K,13,0,20,7
1746535609214,LIGM 5B,A00,896260,Fischer-Grunski; Eva K,17,0,20,3
1746535610244,LIGM 5C,A00,896308,Fischer-Grunski; Eva K,18,0,20,2
1746535611273,LIIT 5AS,A00,896313,Carnelos; Chiara,18,0,20,2
1746535612298,LIIT 5BS,A00,896416,Carnelos; Chiara,20,0,20,0
1746535613323,LIIT 5CS,A00,896564,Carnelos; Chiara,20,0,20,0
1746535614351,LISP 5A,A00,896588,Munoz Sanchez; Alicia,3,0,20,17
1746535615376,LISP 5B,A00,896653,Munoz Sanchez; Alicia,7,0,20,13
1746535616407,LISP 5C,A00,896655,Munoz Sanchez; Alicia,0,1,20,20
1746535617439,MAE 197,001,957918,Kleissl; Jan,9996,0,9999,3
1746535617439,MAE 197,002,959806,Boechler; Nicholas Sebastia,9998,0,9999,1
1746535617439,MAE 197,003,959852,Mullin; Jennifer S,9999,0,9999,0
1746535618466,MATH 2,A01,957937,Staff,33,0,35,2
1746535619494,MATH 197,001,957876,Kedlaya; Kiran S.,9993,0,9999,6
1746535620522,MCWP 40,A00,892729,Duru; Nur,10,0,20,10
1746535620522,MCWP 40,B00,893304,Montejo; Carolina,14,0,20,6
1746535621552,MCWP 40R,A00,893757,Redela; Pamela Morgan,0,5,20,20
1746535622581,MCWP 50,A00,893758,Morshed; Michael James,0,0,20,20
1746535622581,MCWP 50,B00,893761,Bartulis; Jason Michael,17,0,20,3
1746535623611,MCWP 50R,A00,893766,Compas; Sean Matthew,0,1,20,20
1746535623611,MCWP 50R,B00,893769,Carter; Jennifer A,0,1,20,20
1746535623611,MCWP 50R,C00,893771,Krone; Jarret,0,3,20,20
1746535623611,MCWP 50R,D00,893772,Miller; Elizabeth Deen,0,0,20,20
1746535623611,MCWP 50R,E00,893775,Carter; Andrea L,0,1,20,20
1746535624642,MMW 11R,A01,892721,Herbst; Matthew,11,0,27,16
1746535624642,MMW 11R,A02,892722,Herbst; Matthew,0,0,0,3
1746535625671,MMW 12R,A01,892724,Herbst; Matthew,0,11,16,16
1746535625671,MMW 12R,A02,892725,Herbst; Matthew,0,10,16,16
1746535626703,MMW 13R,A01,892727,Staff,0,4,16,16
1746535626703,MMW 13R,A02,892728,Staff,0,4,16,16
1746535626703,MMW 13R,A03,958032,Staff,0,4,16,16
1746535626703,MMW 13R,A04,958033,Staff,0,4,16,16
1746535626703,MMW 13R,A05,958034,Staff,0,4,16,16
1746535627730,SIO 295LS,A00,894015,Staff,5,0,25,20
1746535628759,SIO 295S,A00,894020,Staff,5,0,25,20
1746535629794,SIOC 290S,B01,958918,Merrifield; Mark A,14,0,30,16
1746535630827,SIOC 291S,B01,958922,Gabriel; Corey John,14,0,30,16
1746535631852,SOCI 117,A01,895339,Staff,3,0,5,2
1746535632877,WES 237B,A00,894149,Staff,11,0,20,9
1746535634957,AESE 279B,A00,891859,Staff,13,0,35,22
1746535635982,AIP 197,001,891854,Vespa; Emanuel Ignacio,9999,0,9999,0
1746535637006,ANTH 289S,A00,891856,Gagneux; Pascal,12,0,12,0
1746535638032,BENG 196,001,957946,Engler; Adam J.,9996,0,9999,3
1746535639063,BISP 197,001,959851,Wilhelm; James E.,9999,0,9999,0
1746535640096,CAT 124RS,A01,956906,Staff,6,0,25,19
1746535641122,CAT 125RS,A01,922013,Staff,6,0,25,19
1746535642150,CLRE 250,A00,891860,Morris; Sheldon,9995,0,9999,4
1746535644203,CLRE 251R,A00,907817,Mehta; Ravindra L.,9994,0,9999,5
1746535645231,CLRE 252,A00,891864,Cuomo; Raphael Eduardo,9993,0,9999,6
1746535646257,CLRE 253,A00,891867,Vaida; Florin,9994,0,9999,5
1746535646257,CLRE 253,B00,907819,Staff,9999,0,9999,0
1746535647283,CLRE 259,A00,891868,Patel; Hemal,9998,0,9999,1
1746535648313,CLRE 260,A00,891872,Cuomo; Raphael Eduardo,9999,0,9999,0
1746535649339,CLRE 297,001,891888,Cuomo; Raphael Eduardo,9999,0,9999,0
1746535650368,CSE 191,A00,958773,Minnes Kemp; Mor Mia,9996,0,9999,3
1746535651399,CSE 197,001,959846,Minnes Kemp; Mor Mia,9993,0,9999,6
1746535652426,CSS 201S,A01,892054,Mignozzetti; Umberto,26,0,30,4
1746535653459,CSS 202S,A01,892056,Mignozzetti; Umberto,26,0,30,4
1746535654485,DSC 197,001,956898,Eldridge; Justin Matthew,9998,0,9999,1
1746535655511,DSC 297,001,958000,Mazumdar; Arya,9998,0,9999,1
1746535655511,DSC 297,002,959862,Wang; Yusu,9999,0,9999,0
1746535656543,EAP 100,A00,905686,Staff,9778,0,9999,221
1746535657577,ECE 45,A01,892618,Staff,0,0,65,65
1746535659631,ECE 111,A01,892719,Staff,4,0,65,61
1746535660659,ECE 197,001,957920,Mercier; Patrick Philip,9991,0,9999,8
1746535661688,ECON 178,A01,907814,Zhu; Ying,26,0,35,9
1746535662716,EDS 115,A00,895312,Staff,36,0,45,9
1746535663744,EDS 117,A01,895337,Staff,24,0,30,6
1746535664770,EDS 125,A00,895341,Jones; Gabrielle Anastasia,37,0,45,8
1746535665803,EDS 128A,A01,895459,Fargason; Sharon Gayle,44,0,45,1
1746535666832,EDS 128B,A01,895543,Pappas; Elizabeth,44,0,45,1
1746535667861,EDS 139,A00,897203,Pappas; Elizabeth,44,0,45,1
1746535667861,EDS 139,B00,897209,Fargason; Sharon Gayle,41,0,45,4
1746535668887,EDS 201,A00,895545,Staff,23,0,45,22
1746535669917,EDS 203,A01,895581,Halter; Christopher P.,23,0,45,22
1746535670950,EDS 204R,A01,895625,Heinzman; Erica M.,39,0,45,6
1746535670950,EDS 204R,B01,895693,Halter; Christopher P.,10,0,45,35
1746535671975,EDS 206R,A00,895694,Fargason; Sharon Gayle,1,0,30,29
1746535671975,EDS 206R,B00,895695,Choi; Bailey Miyeon,16,0,30,14
1746535673007,EDS 250,A00,895697,Hemans; Patricia Ann Benitez,23,0,45,22
1746535674034,EDS 281,A00,895701,Meyerott; Theresa Ann,1,0,15,14
1746535675065,EDS 284,A00,895736,Meyerott; Theresa Ann,1,0,15,14
1746535676090,EDS 286,A00,897210,Fine; Sarah,0,0,15,15
1746535677117,EDS 289C,A01,895770,Daly; Alan J.,15,0,15,0
1746535678144,EDS 290,A00,897211,Hofstetter; Carolyn,0,0,15,15
1746535679175,LIGM 5A,A00,896162,Fischer-Grunski; Eva K,13,0,20,7
1746535680205,LIGM 5B,A00,896260,Fischer-Grunski; Eva K,17,0,20,3
1746535681231,LIGM 5C,A00,896308,Fischer-Grunski; Eva K,18,0,20,2
1746535682261,LIIT 5AS,A00,896313,Carnelos; Chiara,18,0,20,2
1746535683290,LIIT 5BS,A00,896416,Carnelos; Chiara,20,0,20,0
1746535684322,LIIT 5CS,A00,896564,Carnelos; Chiara,20,0,20,0
1746535685353,LISP 5A,A00,896588,Munoz Sanchez; Alicia,3,0,20,17
1746535686379,LISP 5B,A00,896653,Munoz Sanchez; Alicia,7,0,20,13
1746535687408,LISP 5C,A00,896655,Munoz Sanchez; Alicia,0,1,20,20
1746535688440,MAE 197,001,957918,Kleissl; Jan,9996,0,9999,3
1746535688440,MAE 197,002,959806,Boechler; Nicholas Sebastia,9998,0,9999,1
1746535688440,MAE 197,003,959852,Mullin; Jennifer S,9999,0,9999,0
1746535689468,MATH 2,A01,957937,Staff,33,0,35,2
1746535690496,MATH 197,001,957876,Kedlaya; Kiran S.,9993,0,9999,6
1746535691525,MCWP 40,A00,892729,Duru; Nur,10,0,20,10
1746535691525,MCWP 40,B00,893304,Montejo; Carolina,14,0,20,6
1746535692556,MCWP 40R,A00,893757,Redela; Pamela Morgan,0,5,20,20
1746535693588,MCWP 50,A00,893758,Morshed; Michael James,0,0,20,20
1746535693588,MCWP 50,B00,893761,Bartulis; Jason Michael,17,0,20,3
1746535694613,MCWP 50R,A00,893766,Compas; Sean Matthew,0,1,20,20
1746535694613,MCWP 50R,B00,893769,Carter; Jennifer A,0,1,20,20
1746535694613,MCWP 50R,C00,893771,Krone; Jarret,0,3,20,20
1746535694613,MCWP 50R,D00,893772,Miller; Elizabeth Deen,0,0,20,20
1746535694613,MCWP 50R,E00,893775,Carter; Andrea L,0,1,20,20
1746535695645,MMW 11R,A01,892721,Herbst; Matthew,11,0,27,16
1746535695645,MMW 11R,A02,892722,Herbst; Matthew,0,0,0,3
1746535696674,MMW 12R,A01,892724,Herbst; Matthew,0,11,16,16
1746535696674,MMW 12R,A02,892725,Herbst; Matthew,0,10,16,16
1746535697705,MMW 13R,A01,892727,Staff,0,4,16,16
1746535697705,MMW 13R,A02,892728,Staff,0,4,16,16
1746535697705,MMW 13R,A03,958032,Staff,0,4,16,16
1746535697705,MMW 13R,A04,958033,Staff,0,4,16,16
1746535697705,MMW 13R,A05,958034,Staff,0,4,16,16
1746535698733,SIO 295LS,A00,894015,Staff,5,0,25,20
1746535699759,SIO 295S,A00,894020,Staff,5,0,25,20
1746535700791,SIOC 290S,B01,958918,Merrifield; Mark A,14,0,30,16
1746535701819,SIOC 291S,B01,958922,Gabriel; Corey John,14,0,30,16
1746535702846,SOCI 117,A01,895339,Staff,3,0,5,2
1746535703875,WES 237B,A00,894149,Staff,11,0,20,9
1746535705955,AESE 279B,A00,891859,Staff,13,0,35,22
1746535706984,AIP 197,001,891854,Vespa; Emanuel Ignacio,9999,0,9999,0
1746535708012,ANTH 289S,A00,891856,Gagneux; Pascal,12,0,12,0
1746535709039,BENG 196,001,957946,Engler; Adam J.,9996,0,9999,3
1746535710065,BISP 197,001,959851,Wilhelm; James E.,9999,0,9999,0
1746535711095,CAT 124RS,A01,956906,Staff,6,0,25,19
1746535712124,CAT 125RS,A01,922013,Staff,6,0,25,19
1746535713150,CLRE 250,A00,891860,Morris; Sheldon,9995,0,9999,4
1746535715204,CLRE 251R,A00,907817,Mehta; Ravindra L.,9994,0,9999,5
1746535716230,CLRE 252,A00,891864,Cuomo; Raphael Eduardo,9993,0,9999,6
1746535717263,CLRE 253,A00,891867,Vaida; Florin,9994,0,9999,5
1746535717263,CLRE 253,B00,907819,Staff,9999,0,9999,0
1746535718291,CLRE 259,A00,891868,Patel; Hemal,9998,0,9999,1
1746535719372,CLRE 260,A00,891872,Cuomo; Raphael Eduardo,9999,0,9999,0
1746535720399,CLRE 297,001,891888,Cuomo; Raphael Eduardo,9999,0,9999,0
1746535721425,CSE 191,A00,958773,Minnes Kemp; Mor Mia,9996,0,9999,3
1746535722454,CSE 197,001,959846,Minnes Kemp; Mor Mia,9993,0,9999,6
1746535723482,CSS 201S,A01,892054,Mignozzetti; Umberto,26,0,30,4
1746535724509,CSS 202S,A01,892056,Mignozzetti; Umberto,26,0,30,4
1746535725534,DSC 197,001,956898,Eldridge; Justin Matthew,9998,0,9999,1
1746535726562,DSC 297,001,958000,Mazumdar; Arya,9998,0,9999,1
1746535726562,DSC 297,002,959862,Wang; Yusu,9999,0,9999,0
1746535727590,EAP 100,A00,905686,Staff,9778,0,9999,221
1746535728623,ECE 45,A01,892618,Staff,0,0,65,65
1746535730681,ECE 111,A01,892719,Staff,4,0,65,61
1746535731711,ECE 197,001,957920,Mercier; Patrick Philip,9991,0,9999,8
1746535732739,ECON 178,A01,907814,Zhu; Ying,26,0,35,9
1746535733764,EDS 115,A00,895312,Staff,36,0,45,9
1746535734790,EDS 117,A01,895337,Staff,24,0,30,6
1746535735819,EDS 125,A00,895341,Jones; Gabrielle Anastasia,37,0,45,8
1746535736849,EDS 128A,A01,895459,Fargason; Sharon Gayle,44,0,45,1
1746535737877,EDS 128B,A01,895543,Pappas; Elizabeth,44,0,45,1
1746535738903,EDS 139,A00,897203,Pappas; Elizabeth,44,0,45,1
1746535738903,EDS 139,B00,897209,Fargason; Sharon Gayle,41,0,45,4
1746535739931,EDS 201,A00,895545,Staff,23,0,45,22
1746535740962,EDS 203,A01,895581,Halter; Christopher P.,23,0,45,22
1746535741993,EDS 204R,A01,895625,Heinzman; Erica M.,39,0,45,6
1746535741993,EDS 204R,B01,895693,Halter; Christopher P.,10,0,45,35
1746535743020,EDS 206R,A00,895694,Fargason; Sharon Gayle,1,0,30,29
1746535743020,EDS 206R,B00,895695,Choi; Bailey Miyeon,16,0,30,14
1746535744048,EDS 250,A00,895697,Hemans; Patricia Ann Benitez,23,0,45,22
1746535745079,EDS 281,A00,895701,Meyerott; Theresa Ann,1,0,15,14
1746535746108,EDS 284,A00,895736,Meyerott; Theresa Ann,1,0,15,14
1746535747142,EDS 286,A00,897210,Fine; Sarah,0,0,15,15
1746535748171,EDS 289C,A01,895770,Daly; Alan J.,15,0,15,0
1746535749201,EDS 290,A00,897211,Hofstetter; Carolyn,0,0,15,15
1746535750228,LIGM 5A,A00,896162,Fischer-Grunski; Eva K,13,0,20,7
1746535751254,LIGM 5B,A00,896260,Fischer-Grunski; Eva K,17,0,20,3
1746535752284,LIGM 5C,A00,896308,Fischer-Grunski; Eva K,18,0,20,2
1746535753311,LIIT 5AS,A00,896313,Carnelos; Chiara,18,0,20,2
1746535754341,LIIT 5BS,A00,896416,Carnelos; Chiara,20,0,20,0
1746535755367,LIIT 5CS,A00,896564,Carnelos; Chiara,20,0,20,0
1746535756393,LISP 5A,A00,896588,Munoz Sanchez; Alicia,3,0,20,17
1746535757424,LISP 5B,A00,896653,Munoz Sanchez; Alicia,7,0,20,13
1746535758452,LISP 5C,A00,896655,Munoz Sanchez; Alicia,0,1,20,20
1746535759477,MAE 197,001,957918,Kleissl; Jan,9996,0,9999,3
1746535759477,MAE 197,002,959806,Boechler; Nicholas Sebastia,9998,0,9999,1
1746535759477,MAE 197,003,959852,Mullin; Jennifer S,9999,0,9999,0
1746535760503,MATH 2,A01,957937,Staff,33,0,35,2
1746535761529,MATH 197,001,957876,Kedlaya; Kiran S.,9993,0,9999,6
1746535762557,MCWP 40,A00,892729,Duru; Nur,10,0,20,10
1746535762557,MCWP 40,B00,893304,Montejo; Carolina,14,0,20,6
1746535763587,MCWP 40R,A00,893757,Redela; Pamela Morgan,0,5,20,20
1746535764617,MCWP 50,A00,893758,Morshed; Michael James,0,0,20,20
1746535764617,MCWP 50,B00,893761,Bartulis; Jason Michael,17,0,20,3
1746535765650,MCWP 50R,A00,893766,Compas; Sean Matthew,0,1,20,20
1746535765650,MCWP 50R,B00,893769,Carter; Jennifer A,0,1,20,20
1746535765650,MCWP 50R,C00,893771,Krone; Jarret,0,3,20,20
1746535765650,MCWP 50R,D00,893772,Miller; Elizabeth Deen,0,0,20,20
1746535765650,MCWP 50R,E00,893775,Carter; Andrea L,0,1,20,20
1746535766676,MMW 11R,A01,892721,Herbst; Matthew,11,0,27,16
1746535766676,MMW 11R,A02,892722,Herbst; Matthew,0,0,0,3
1746535767706,MMW 12R,A01,892724,Herbst; Matthew,0,11,16,16
1746535767706,MMW 12R,A02,892725,Herbst; Matthew,0,10,16,16
1746535768733,MMW 13R,A01,892727,Staff,0,4,16,16
1746535768733,MMW 13R,A02,892728,Staff,0,4,16,16
1746535768733,MMW 13R,A03,958032,Staff,0,4,16,16
1746535768733,MMW 13R,A04,958033,Staff,0,4,16,16
1746535768733,MMW 13R,A05,958034,Staff,0,4,16,16
1746535769758,SIO 295LS,A00,894015,Staff,5,0,25,20
1746535770785,SIO 295S,A00,894020,Staff,5,0,25,20
1746535771813,SIOC 290S,B01,958918,Merrifield; Mark A,14,0,30,16
1746535772847,SIOC 291S,B01,958922,Gabriel; Corey John,14,0,30,16
1746535773878,SOCI 117,A01,895339,Staff,3,0,5,2
1746535774906,WES 237B,A00,894149,Staff,11,0,20,9
1746535776994,AESE 279B,A00,891859,Staff,13,0,35,22
1746535778021,AIP 197,001,891854,Vespa; Emanuel Ignacio,9999,0,9999,0
1746535779051,ANTH 289S,A00,891856,Gagneux; Pascal,12,0,12,0
1746535780077,BENG 196,001,957946,Engler; Adam J.,9996,0,9999,3
1746535781106,BISP 197,001,959851,Wilhelm; James E.,9999,0,9999,0
1746535782131,CAT 124RS,A01,956906,Staff,6,0,25,19
1746535783160,CAT 125RS,A01,922013,Staff,6,0,25,19
1746535784186,CLRE 250,A00,891860,Morris; Sheldon,9995,0,9999,4
1746535786250,CLRE 251R,A00,907817,Mehta; Ravindra L.,9994,0,9999,5
1746535787275,CLRE 252,A00,891864,Cuomo; Raphael Eduardo,9993,0,9999,6
1746535788306,CLRE 253,A00,891867,Vaida; Florin,9994,0,9999,5
1746535788306,CLRE 253,B00,907819,Staff,9999,0,9999,0
1746535789332,CLRE 259,A00,891868,Patel; Hemal,9998,0,9999,1
1746535790361,CLRE 260,A00,891872,Cuomo; Raphael Eduardo,9999,0,9999,0
1746535791387,CLRE 297,001,891888,Cuomo; Raphael Eduardo,9999,0,9999,0
1746535792420,CSE 191,A00,958773,Minnes Kemp; Mor Mia,9996,0,9999,3
1746535793445,CSE 197,001,959846,Minnes Kemp; Mor Mia,9993,0,9999,6
1746535794472,CSS 201S,A01,892054,Mignozzetti; Umberto,26,0,30,4
1746535795502,CSS 202S,A01,892056,Mignozzetti; Umberto,26,0,30,4
1746535796527,DSC 197,001,956898,Eldridge; Justin Matthew,9998,0,9999,1
1746535797556,DSC 297,001,958000,Mazumdar; Arya,9998,0,9999,1
1746535797556,DSC 297,002,959862,Wang; Yusu,9999,0,9999,0
1746535798581,EAP 100,A00,905686,Staff,9778,0,9999,221
1746535799613,ECE 45,A01,892618,Staff,0,0,65,65
1746535801663,ECE 111,A01,892719,Staff,4,0,65,61
1746535802690,ECE 197,001,957920,Mercier; Patrick Philip,9991,0,9999,8
1746535803717,ECON 178,A01,907814,Zhu; Ying,26,0,35,9
1746535804744,EDS 115,A00,895312,Staff,36,0,45,9
1746535805770,EDS 117,A01,895337,Staff,24,0,30,6
1746535806801,EDS 125,A00,895341,Jones; Gabrielle Anastasia,37,0,45,8
1746535807826,EDS 128A,A01,895459,Fargason; Sharon Gayle,44,0,45,1
1746535808852,EDS 128B,A01,895543,Pappas; Elizabeth,44,0,45,1
1746535809879,EDS 139,A00,897203,Pappas; Elizabeth,44,0,45,1
1746535809879,EDS 139,B00,897209,Fargason; Sharon Gayle,41,0,45,4
1746535810904,EDS 201,A00,895545,Staff,23,0,45,22
1746535811931,EDS 203,A01,895581,Halter; Christopher P.,23,0,45,22
1746535812959,EDS 204R,A01,895625,Heinzman; Erica M.,39,0,45,6
1746535812959,EDS 204R,B01,895693,Halter; Christopher P.,10,0,45,35
1746535813985,EDS 206R,A00,895694,Fargason; Sharon Gayle,1,0,30,29
1746535813985,EDS 206R,B00,895695,Choi; Bailey Miyeon,16,0,30,14
1746535815015,EDS 250,A00,895697,Hemans; Patricia Ann Benitez,23,0,45,22
1746535816042,EDS 281,A00,895701,Meyerott; Theresa Ann,1,0,15,14
1746535817069,EDS 284,A00,895736,Meyerott; Theresa Ann,1,0,15,14
1746535818101,EDS 286,A00,897210,Fine; Sarah,0,0,15,15
1746535819132,EDS 289C,A01,895770,Daly; Alan J.,15,0,15,0
1746535820157,EDS 290,A00,897211,Hofstetter; Carolyn,0,0,15,15
1746535821182,LIGM 5A,A00,896162,Fischer-Grunski; Eva K,13,0,20,7
1746535822212,LIGM 5B,A00,896260,Fischer-Grunski; Eva K,17,0,20,3
1746535823281,LIGM 5C,A00,896308,Fischer-Grunski; Eva K,18,0,20,2
1746535824309,LIIT 5AS,A00,896313,Carnelos; Chiara,18,0,20,2
1746535825339,LIIT 5BS,A00,896416,Carnelos; Chiara,20,0,20,0
1746535826366,LIIT 5CS,A00,896564,Carnelos; Chiara,20,0,20,0
1746535827392,LISP 5A,A00,896588,Munoz Sanchez; Alicia,3,0,20,17
1746535828421,LISP 5B,A00,896653,Munoz Sanchez; Alicia,7,0,20,13
1746535829448,LISP 5C,A00,896655,Munoz Sanchez; Alicia,0,1,20,20
1746535830481,MAE 197,001,957918,Kleissl; Jan,9996,0,9999,3
1746535830481,MAE 197,002,959806,Boechler; Nicholas Sebastia,9998,0,9999,1
1746535830481,MAE 197,003,959852,Mullin; Jennifer S,9999,0,9999,0
1746535831505,MATH 2,A01,957937,Staff,33,0,35,2
1746535832535,MATH 197,001,957876,Kedlaya; Kiran S.,9993,0,9999,6
1746535833565,MCWP 40,A00,892729,Duru; Nur,10,0,20,10
1746535833565,MCWP 40,B00,893304,Montejo; Carolina,14,0,20,6
1746535834593,MCWP 40R,A00,893757,Redela; Pamela Morgan,0,5,20,20
1746535835617,MCWP 50,A00,893758,Morshed; Michael James,0,0,20,20
1746535835617,MCWP 50,B00,893761,Bartulis; Jason Michael,17,0,20,3
1746535836648,MCWP 50R,A00,893766,Compas; Sean Matthew,0,1,20,20
1746535836648,MCWP 50R,B00,893769,Carter; Jennifer A,0,1,20,20
1746535836648,MCWP 50R,C00,893771,Krone; Jarret,0,3,20,20
1746535836648,MCWP 50R,D00,893772,Miller; Elizabeth Deen,0,0,20,20
1746535836648,MCWP 50R,E00,893775,Carter; Andrea L,0,1,20,20
1746535837680,MMW 11R,A01,892721,Herbst; Matthew,11,0,27,16
1746535837680,MMW 11R,A02,892722,Herbst; Matthew,0,0,0,3
1746535838705,MMW 12R,A01,892724,Herbst; Matthew,0,11,16,16
1746535838705,MMW 12R,A02,892725,Herbst; Matthew,0,10,16,16
1746535839735,MMW 13R,A01,892727,Staff,0,4,16,16
1746535839735,MMW 13R,A02,892728,Staff,0,4,16,16
1746535839735,MMW 13R,A03,958032,Staff,0,4,16,16
1746535839735,MMW 13R,A04,958033,Staff,0,4,16,16
1746535839735,MMW 13R,A05,958034,Staff,0,4,16,16
1746535840763,SIO 295LS,A00,894015,Staff,5,0,25,20
1746535841793,SIO 295S,A00,894020,Staff,5,0,25,20
1746535842823,SIOC 290S,B01,958918,Merrifield; Mark A,14,0,30,16
1746535843855,SIOC 291S,B01,958922,Gabriel; Corey John,14,0,30,16
1746535844884,SOCI 117,A01,895339,Staff,3,0,5,2
1746535845909,WES 237B,A00,894149,Staff,11,0,20,9
1746535847975,AESE 279B,A00,891859,Staff,13,0,35,22
1746535849003,AIP 197,001,891854,Vespa; Emanuel Ignacio,9999,0,9999,0
1746535850031,ANTH 289S,A00,891856,Gagneux; Pascal,12,0,12,0
1746535851063,BENG 196,001,957946,Engler; Adam J.,9996,0,9999,3
1746535852089,BISP 197,001,959851,Wilhelm; James E.,9999,0,9999,0
1746535853116,CAT 124RS,A01,956906,Staff,6,0,25,19
1746535854142,CAT 125RS,A01,922013,Staff,6,0,25,19
1746535855167,CLRE 250,A00,891860,Morris; Sheldon,9995,0,9999,4
1746535857223,CLRE 251R,A00,907817,Mehta; Ravindra L.,9994,0,9999,5
1746535858249,CLRE 252,A00,891864,Cuomo; Raphael Eduardo,9993,0,9999,6
1746535859275,CLRE 253,A00,891867,Vaida; Florin,9994,0,9999,5
1746535859275,CLRE 253,B00,907819,Staff,9999,0,9999,0
1746535860301,CLRE 259,A00,891868,Patel; Hemal,9998,0,9999,1
1746535861325,CLRE 260,A00,891872,Cuomo; Raphael Eduardo,9999,0,9999,0
1746535862352,CLRE 297,001,891888,Cuomo; Raphael Eduardo,9999,0,9999,0
1746535863382,CSE 191,A00,958773,Minnes Kemp; Mor Mia,9996,0,9999,3
1746535864407,CSE 197,001,959846,Minnes Kemp; Mor Mia,9993,0,9999,6
1746535865438,CSS 201S,A01,892054,Mignozzetti; Umberto,26,0,30,4
1746535866465,CSS 202S,A01,892056,Mignozzetti; Umberto,26,0,30,4
1746535867496,DSC 197,001,956898,Eldridge; Justin Matthew,9998,0,9999,1
1746535868529,DSC 297,001,958000,Mazumdar; Arya,9998,0,9999,1
1746535868529,DSC 297,002,959862,Wang; Yusu,9999,0,9999,0
1746535869555,EAP 100,A00,905686,Staff,9778,0,9999,221
1746535870589,ECE 45,A01,892618,Staff,0,0,65,65
1746535872641,ECE 111,A01,892719,Staff,4,0,65,61
1746535873681,ECE 197,001,957920,Mercier; Patrick Philip,9991,0,9999,8
1746535874711,ECON 178,A01,907814,Zhu; Ying,26,0,35,9
1746535875736,EDS 115,A00,895312,Staff,36,0,45,9
1746535876762,EDS 117,A01,895337,Staff,24,0,30,6
1746535877786,EDS 125,A00,895341,Jones; Gabrielle Anastasia,37,0,45,8
1746535878813,EDS 128A,A01,895459,Fargason; Sharon Gayle,44,0,45,1
1746535879843,EDS 128B,A01,895543,Pappas; Elizabeth,44,0,45,1
1746535880869,EDS 139,A00,897203,Pappas; Elizabeth,44,0,45,1
1746535880869,EDS 139,B00,897209,Fargason; Sharon Gayle,41,0,45,4
1746535881896,EDS 201,A00,895545,Staff,23,0,45,22
1746535882921,EDS 203,A01,895581,Halter; Christopher P.,23,0,45,22
1746535883948,EDS 204R,A01,895625,Heinzman; Erica M.,39,0,45,6
1746535883948,EDS 204R,B01,895693,Halter; Christopher P.,10,0,45,35
1746535884978,EDS 206R,A00,895694,Fargason; Sharon Gayle,1,0,30,29
1746535884978,EDS 206R,B00,895695,Choi; Bailey Miyeon,16,0,30,14
1746535886008,EDS 250,A00,895697,Hemans; Patricia Ann Benitez,23,0,45,22
1746535887032,EDS 281,A00,895701,Meyerott; Theresa Ann,1,0,15,14
1746535888058,EDS 284,A00,895736,Meyerott; Theresa Ann,1,0,15,14
1746535889083,EDS 286,A00,897210,Fine; Sarah,0,0,15,15
1746535890108,EDS 289C,A01,895770,Daly; Alan J.,15,0,15,0
1746535891133,EDS 290,A00,897211,Hofstetter; Carolyn,0,0,15,15
1746535892159,LIGM 5A,A00,896162,Fischer-Grunski; Eva K,13,0,20,7
1746535893184,LIGM 5B,A00,896260,Fischer-Grunski; Eva K,17,0,20,3
1746535894209,LIGM 5C,A00,896308,Fischer-Grunski; Eva K,18,0,20,2
1746535895238,LIIT 5AS,A00,896313,Carnelos; Chiara,18,0,20,2
1746535896273,LIIT 5BS,A00,896416,Carnelos; Chiara,20,0,20,0
1746535897298,LIIT 5CS,A00,896564,Carnelos; Chiara,20,0,20,0
1746535898326,LISP 5A,A00,896588,Munoz Sanchez; Alicia,3,0,20,17
1746535899357,LISP 5B,A00,896653,Munoz Sanchez; Alicia,7,0,20,13
1746535900383,LISP 5C,A00,896655,Munoz Sanchez; Alicia,0,1,20,20
1746535901409,MAE 197,001,957918,Kleissl; Jan,9996,0,9999,3
1746535901409,MAE 197,002,959806,Boechler; Nicholas Sebastia,9998,0,9999,1
1746535901409,MAE 197,003,959852,Mullin; Jennifer S,9999,0,9999,0
1746535902438,MATH 2,A01,957937,Staff,33,0,35,2
1746535903468,MATH 197,001,957876,Kedlaya; Kiran S.,9993,0,9999,6
1746535904500,MCWP 40,A00,892729,Duru; Nur,10,0,20,10
1746535904500,MCWP 40,B00,893304,Montejo; Carolina,14,0,20,6
1746535905530,MCWP 40R,A00,893757,Redela; Pamela Morgan,0,5,20,20
1746535906560,MCWP 50,A00,893758,Morshed; Michael James,0,0,20,20
1746535906560,MCWP 50,B00,893761,Bartulis; Jason Michael,17,0,20,3
1746535907587,MCWP 50R,A00,893766,Compas; Sean Matthew,0,1,20,20
1746535907587,MCWP 50R,B00,893769,Carter; Jennifer A,0,1,20,20
1746535907587,MCWP 50R,C00,893771,Krone; Jarret,0,3,20,20
1746535907587,MCWP 50R,D00,893772,Miller; Elizabeth Deen,0,0,20,20
1746535907587,MCWP 50R,E00,893775,Carter; Andrea L,0,1,20,20
1746535908613,MMW 11R,A01,892721,Herbst; Matthew,11,0,27,16
1746535908613,MMW 11R,A02,892722,Herbst; Matthew,0,0,0,3
1746535909641,MMW 12R,A01,892724,Herbst; Matthew,0,11,16,16
1746535909641,MMW 12R,A02,892725,Herbst; Matthew,0,10,16,16
1746535910666,MMW 13R,A01,892727,Staff,0,4,16,16
1746535910666,MMW 13R,A02,892728,Staff,0,4,16,16
1746535910666,MMW 13R,A03,958032,Staff,0,4,16,16
1746535910666,MMW 13R,A04,958033,Staff,0,4,16,16
1746535910666,MMW 13R,A05,958034,Staff,0,4,16,16
1746535911696,SIO 295LS,A00,894015,Staff,5,0,25,20
1746535912721,SIO 295S,A00,894020,Staff,5,0,25,20
1746535913750,SIOC 290S,B01,958918,Merrifield; Mark A,14,0,30,16
1746535914779,SIOC 291S,B01,958922,Gabriel; Corey John,14,0,30,16
1746535915806,SOCI 117,A01,895339,Staff,3,0,5,2
1746535916835,WES 237B,A00,894149,Staff,11,0,20,9
1746535918908,AESE 279B,A00,891859,Staff,13,0,35,22
1746535919934,AIP 197,001,891854,Vespa; Emanuel Ignacio,9999,0,9999,0
1746535920965,ANTH 289S,A00,891856,Gagneux; Pascal,12,0,12,0
1746535921991,BENG 196,001,957946,Engler; Adam J.,9996,0,9999,3
1746535923018,BISP 197,001,959851,Wilhelm; James E.,9999,0,9999,0
1746535924043,CAT 124RS,A01,956906,Staff,6,0,25,19
1746535925070,CAT 125RS,A01,922013,Staff,6,0,25,19
1746535926103,CLRE 250,A00,891860,Morris; Sheldon,9995,0,9999,4
1746535928196,CLRE 251R,A00,907817,Mehta; Ravindra L.,9994,0,9999,5
1746535929225,CLRE 252,A00,891864,Cuomo; Raphael Eduardo,9993,0,9999,6
1746535930253,CLRE 253,A00,891867,Vaida; Florin,9994,0,9999,5
1746535930253,CLRE 253,B00,907819,Staff,9999,0,9999,0
1746535931279,CLRE 259,A00,891868,Patel; Hemal,9998,0,9999,1
1746535932305,CLRE 260,A00,891872,Cuomo; Raphael Eduardo,9999,0,9999,0
1746535933336,CLRE 297,001,891888,Cuomo; Raphael Eduardo,9999,0,9999,0
1746535934366,CSE 191,A00,958773,Minnes Kemp; Mor Mia,9996,0,9999,3
1746535935393,CSE 197,001,959846,Minnes Kemp; Mor Mia,9993,0,9999,6
1746535936424,CSS 201S,A01,892054,Mignozzetti; Umberto,26,0,30,4
1746535937453,CSS 202S,A01,892056,Mignozzetti; Umberto,26,0,30,4
1746535938481,DSC 197,001,956898,Eldridge; Justin Matthew,9998,0,9999,1
1746535939508,DSC 297,001,958000,Mazumdar; Arya,9998,0,9999,1
1746535939508,DSC 297,002,959862,Wang; Yusu,9999,0,9999,0
1746535940534,EAP 100,A00,905686,Staff,9778,0,9999,221
1746535941565,ECE 45,A01,892618,Staff,0,0,65,65
1746535943622,ECE 111,A01,892719,Staff,4,0,65,61
1746535944652,ECE 197,001,957920,Mercier; Patrick Philip,9991,0,9999,8
1746535945681,ECON 178,A01,907814,Zhu; Ying,26,0,35,9
1746535946709,EDS 115,A00,895312,Staff,36,0,45,9
1746535947736,EDS 117,A01,895337,Staff,24,0,30,6
1746535948764,EDS 125,A00,895341,Jones; Gabrielle Anastasia,37,0,45,8
1746535949791,EDS 128A,A01,895459,Fargason; Sharon Gayle,44,0,45,1
1746535950817,EDS 128B,A01,895543,Pappas; Elizabeth,44,0,45,1
1746535951843,EDS 139,A00,897203,Pappas; Elizabeth,44,0,45,1
1746535951843,EDS 139,B00,897209,Fargason; Sharon Gayle,41,0,45,4
1746535952868,EDS 201,A00,895545,Staff,23,0,45,22
1746535953899,EDS 203,A01,895581,Halter; Christopher P.,23,0,45,22
1746535954925,EDS 204R,A01,895625,Heinzman; Erica M.,39,0,45,6
1746535954925,EDS 204R,B01,895693,Halter; Christopher P.,10,0,45,35
1746535955956,EDS 206R,A00,895694,Fargason; Sharon Gayle,1,0,30,29
1746535955956,EDS 206R,B00,895695,Choi; Bailey Miyeon,16,0,30,14
1746535956984,EDS 250,A00,895697,Hemans; Patricia Ann Benitez,23,0,45,22
1746535958011,EDS 281,A00,895701,Meyerott; Theresa Ann,1,0,15,14
1746535959038,EDS 284,A00,895736,Meyerott; Theresa Ann,1,0,15,14
1746535960065,EDS 286,A00,897210,Fine; Sarah,0,0,15,15
1746535961094,EDS 289C,A01,895770,Daly; Alan J.,15,0,15,0
1746535962121,EDS 290,A00,897211,Hofstetter; Carolyn,0,0,15,15
1746535963150,LIGM 5A,A00,896162,Fischer-Grunski; Eva K,13,0,20,7
1746535964182,LIGM 5B,A00,896260,Fischer-Grunski; Eva K,17,0,20,3
1746535965213,LIGM 5C,A00,896308,Fischer-Grunski; Eva K,18,0,20,2
1746535966240,LIIT 5AS,A00,896313,Carnelos; Chiara,18,0,20,2
1746535967266,LIIT 5BS,A00,896416,Carnelos; Chiara,20,0,20,0
1746535968297,LIIT 5CS,A00,896564,Carnelos; Chiara,20,0,20,0
1746535969322,LISP 5A,A00,896588,Munoz Sanchez; Alicia,3,0,20,17
1746535970346,LISP 5B,A00,896653,Munoz Sanchez; Alicia,7,0,20,13
1746535971373,LISP 5C,A00,896655,Munoz Sanchez; Alicia,0,1,20,20
1746535972405,MAE 197,001,957918,Kleissl; Jan,9996,0,9999,3
1746535972405,MAE 197,002,959806,Boechler; Nicholas Sebastia,9998,0,9999,1
1746535972405,MAE 197,003,959852,Mullin; Jennifer S,9999,0,9999,0
1746535973433,MATH 2,A01,957937,Staff,33,0,35,2
1746535974459,MATH 197,001,957876,Kedlaya; Kiran S.,9993,0,9999,6
1746535975485,MCWP 40,A00,892729,Duru; Nur,10,0,20,10
1746535975485,MCWP 40,B00,893304,Montejo; Carolina,14,0,20,6
1746535976516,MCWP 40R,A00,893757,Redela; Pamela Morgan,0,5,20,20
1746535977544,MCWP 50,A00,893758,Morshed; Michael James,0,0,20,20
1746535977544,MCWP 50,B00,893761,Bartulis; Jason Michael,17,0,20,3
1746535978579,MCWP 50R,A00,893766,Compas; Sean Matthew,0,1,20,20
1746535978579,MCWP 50R,B00,893769,Carter; Jennifer A,0,1,20,20
1746535978579,MCWP 50R,C00,893771,Krone; Jarret,0,3,20,20
1746535978579,MCWP 50R,D00,893772,Miller; Elizabeth Deen,0,0,20,20
1746535978579,MCWP 50R,E00,893775,Carter; Andrea L,0,1,20,20
1746535979611,MMW 11R,A01,892721,Herbst; Matthew,11,0,27,16
1746535979611,MMW 11R,A02,892722,Herbst; Matthew,0,0,0,3
1746535980637,MMW 12R,A01,892724,Herbst; Matthew,0,11,16,16
1746535980637,MMW 12R,A02,892725,Herbst; Matthew,0,10,16,16
1746535981662,MMW 13R,A01,892727,Staff,0,4,16,16
1746535981662,MMW 13R,A02,892728,Staff,0,4,16,16
1746535981662,MMW 13R,A03,958032,Staff,0,4,16,16
1746535981662,MMW 13R,A04,958033,Staff,0,4,16,16
1746535981662,MMW 13R,A05,958034,Staff,0,4,16,16
1746535982688,SIO 295LS,A00,894015,Staff,5,0,25,20
1746535983716,SIO 295S,A00,894020,Staff,5,0,25,20
1746535984752,SIOC 290S,B01,958918,Merrifield; Mark A,14,0,30,16
1746535985779,SIOC 291S,B01,958922,Gabriel; Corey John,14,0,30,16
1746535986805,SOCI 117,A01,895339,Staff,3,0,5,2
1746535987831,WES 237B,A00,894149,Staff,11,0,20,9
1746535989899,AESE 279B,A00,891859,Staff,13,0,35,22
1746535990924,AIP 197,001,891854,Vespa; Emanuel Ignacio,9999,0,9999,0
1746535991952,ANTH 289S,A00,891856,Gagneux; Pascal,12,0,12,0
1746535992981,BENG 196,001,957946,Engler; Adam J.,9996,0,9999,3
1746535994006,BISP 197,001,959851,Wilhelm; James E.,9999,0,9999,0
1746535995034,CAT 124RS,A01,956906,Staff,6,0,25,19
1746535996064,CAT 125RS,A01,922013,Staff,6,0,25,19
1746535997091,CLRE 250,A00,891860,Morris; Sheldon,9995,0,9999,4
1746535999144,CLRE 251R,A00,907817,Mehta; Ravindra L.,9994,0,9999,5
1746536000171,CLRE 252,A00,891864,Cuomo; Raphael Eduardo,9993,0,9999,6
1746536001198,CLRE 253,A00,891867,Vaida; Florin,9994,0,9999,5
1746536001198,CLRE 253,B00,907819,Staff,9999,0,9999,0
1746536002224,CLRE 259,A00,891868,Patel; Hemal,9998,0,9999,1
1746536003250,CLRE 260,A00,891872,Cuomo; Raphael Eduardo,9999,0,9999,0
1746536004276,CLRE 297,001,891888,Cuomo; Raphael Eduardo,9999,0,9999,0
1746536005302,CSE 191,A00,958773,Minnes Kemp; Mor Mia,9996,0,9999,3
1746536006325,CSE 197,001,959846,Minnes Kemp; Mor Mia,9993,0,9999,6
1746536007358,CSS 201S,A01,892054,Mignozzetti; Umberto,26,0,30,4
1746536008390,CSS 202S,A01,892056,Mignozzetti; Umberto,26,0,30,4
1746536009418,DSC 197,001,956898,Eldridge; Justin Matthew,9998,0,9999,1
1746536010447,DSC 297,001,958000,Mazumdar; Arya,9998,0,9999,1
1746536010447,DSC 297,002,959862,Wang; Yusu,9999,0,9999,0
1746536011473,EAP 100,A00,905686,Staff,9778,0,9999,221
1746536012506,ECE 45,A01,892618,Staff,0,0,65,65
1746536014558,ECE 111,A01,892719,Staff,4,0,65,61
1746536015585,ECE 197,001,957920,Mercier; Patrick Philip,9991,0,9999,8
1746536016615,ECON 178,A01,907814,Zhu; Ying,26,0,35,9
1746536017641,EDS 115,A00,895312,Staff,36,0,45,9
1746536018666,EDS 117,A01,895337,Staff,24,0,30,6
1746536019694,EDS 125,A00,895341,Jones; Gabrielle Anastasia,37,0,45,8
1746536020722,EDS 128A,A01,895459,Fargason; Sharon Gayle,44,0,45,1
1746536021748,EDS 128B,A01,895543,Pappas; Elizabeth,44,0,45,1
1746536022776,EDS 139,A00,897203,Pappas; Elizabeth,44,0,45,1
1746536022776,EDS 139,B00,897209,Fargason; Sharon Gayle,41,0,45,4
1746536023806,EDS 201,A00,895545,Staff,23,0,45,22
1746536024838,EDS 203,A01,895581,Halter; Christopher P.,23,0,45,22
1746536025865,EDS 204R,A01,895625,Heinzman; Erica M.,39,0,45,6
1746536025865,EDS 204R,B01,895693,Halter; Christopher P.,10,0,45,35
1746536026894,EDS 206R,A00,895694,Fargason; Sharon Gayle,1,0,30,29
1746536026894,EDS 206R,B00,895695,Choi; Bailey Miyeon,16,0,30,14
1746536027918,EDS 250,A00,895697,Hemans; Patricia Ann Benitez,23,0,45,22
1746536028945,EDS 281,A00,895701,Meyerott; Theresa Ann,1,0,15,14
1746536029984,EDS 284,A00,895736,Meyerott; Theresa Ann,1,0,15,14
1746536031067,EDS 286,A00,897210,Fine; Sarah,0,0,15,15
1746536032096,EDS 289C,A01,895770,Daly; Alan J.,15,0,15,0
1746536033120,EDS 290,A00,897211,Hofstetter; Carolyn,0,0,15,15
1746536034147,LIGM 5A,A00,896162,Fischer-Grunski; Eva K,13,0,20,7
1746536035214,LIGM 5B,A00,896260,Fischer-Grunski; Eva K,17,0,20,3
1746536036245,LIGM 5C,A00,896308,Fischer-Grunski; Eva K,18,0,20,2
1746536037274,LIIT 5AS,A00,896313,Carnelos; Chiara,18,0,20,2
1746536038302,LIIT 5BS,A00,896416,Carnelos; Chiara,20,0,20,0
1746536039329,LIIT 5CS,A00,896564,Carnelos; Chiara,20,0,20,0
1746536040357,LISP 5A,A00,896588,Munoz Sanchez; Alicia,3,0,20,17
1746536041386,LISP 5B,A00,896653,Munoz Sanchez; Alicia,7,0,20,13
1746536042425,LISP 5C,A00,896655,Munoz Sanchez; Alicia,0,1,20,20
1746536043453,MAE 197,001,957918,Kleissl; Jan,9996,0,9999,3
1746536043453,MAE 197,002,959806,Boechler; Nicholas Sebastia,9998,0,9999,1
1746536043453,MAE 197,003,959852,Mullin; Jennifer S,9999,0,9999,0
1746536044479,MATH 2,A01,957937,Staff,33,0,35,2
1746536045508,MATH 197,001,957876,Kedlaya; Kiran S.,9993,0,9999,6
1746536046535,MCWP 40,A00,892729,Duru; Nur,10,0,20,10
1746536046535,MCWP 40,B00,893304,Montejo; Carolina,14,0,20,6
1746536047562,MCWP 40R,A00,893757,Redela; Pamela Morgan,0,5,20,20
1746536048589,MCWP 50,A00,893758,Morshed; Michael James,0,0,20,20
1746536048589,MCWP 50,B00,893761,Bartulis; Jason Michael,17,0,20,3
1746536049623,MCWP 50R,A00,893766,Compas; Sean Matthew,0,1,20,20
1746536049623,MCWP 50R,B00,893769,Carter; Jennifer A,0,1,20,20
1746536049623,MCWP 50R,C00,893771,Krone; Jarret,0,3,20,20
1746536049623,MCWP 50R,D00,893772,Miller; Elizabeth Deen,0,0,20,20
1746536049623,MCWP 50R,E00,893775,Carter; Andrea L,0,1,20,20
1746536050653,MMW 11R,A01,892721,Herbst; Matthew,11,0,27,16
1746536050653,MMW 11R,A02,892722,Herbst; Matthew,0,0,0,3
1746536051679,MMW 12R,A01,892724,Herbst; Matthew,0,11,16,16
1746536051679,MMW 12R,A02,892725,Herbst; Matthew,0,10,16,16
1746536052710,MMW 13R,A01,892727,Staff,0,4,16,16
1746536052710,MMW 13R,A02,892728,Staff,0,4,16,16
1746536052710,MMW 13R,A03,958032,Staff,0,4,16,16
1746536052710,MMW 13R,A04,958033,Staff,0,4,16,16
1746536052710,MMW 13R,A05,958034,Staff,0,4,16,16
1746536053735,SIO 295LS,A00,894015,Staff,5,0,25,20
1746536054766,SIO 295S,A00,894020,Staff,5,0,25,20
1746536055793,SIOC 290S,B01,958918,Merrifield; Mark A,14,0,30,16
1746536056823,SIOC 291S,B01,958922,Gabriel; Corey John,14,0,30,16
1746536057849,SOCI 117,A01,895339,Staff,3,0,5,2
1746536058880,WES 237B,A00,894149,Staff,11,0,20,9
1746536060968,AESE 279B,A00,891859,Staff,13,0,35,22
1746536061996,AIP 197,001,891854,Vespa; Emanuel Ignacio,9999,0,9999,0
1746536063023,ANTH 289S,A00,891856,Gagneux; Pascal,12,0,12,0
1746536064049,BENG 196,001,957946,Engler; Adam J.,9996,0,9999,3
1746536065078,BISP 197,001,959851,Wilhelm; James E.,9999,0,9999,0
1746536066104,CAT 124RS,A01,956906,Staff,6,0,25,19
1746536067135,CAT 125RS,A01,922013,Staff,6,0,25,19
1746536068162,CLRE 250,A00,891860,Morris; Sheldon,9995,0,9999,4
1746536070217,CLRE 251R,A00,907817,Mehta; Ravindra L.,9994,0,9999,5
1746536071242,CLRE 252,A00,891864,Cuomo; Raphael Eduardo,9993,0,9999,6
1746536072269,CLRE 253,A00,891867,Vaida; Florin,9994,0,9999,5
1746536072269,CLRE 253,B00,907819,Staff,9999,0,9999,0
1746536073294,CLRE 259,A00,891868,Patel; Hemal,9998,0,9999,1
1746536074319,CLRE 260,A00,891872,Cuomo; Raphael Eduardo,9999,0,9999,0
1746536075346,CLRE 297,001,891888,Cuomo; Raphael Eduardo,9999,0,9999,0
1746536076374,CSE 191,A00,958773,Minnes Kemp; Mor Mia,9996,0,9999,3
1746536077400,CSE 197,001,959846,Minnes Kemp; Mor Mia,9993,0,9999,6
1746536078427,CSS 201S,A01,892054,Mignozzetti; Umberto,26,0,30,4
1746536079457,CSS 202S,A01,892056,Mignozzetti; Umberto,26,0,30,4
1746536080487,DSC 197,001,956898,Eldridge; Justin Matthew,9998,0,9999,1
1746536081516,DSC 297,001,958000,Mazumdar; Arya,9998,0,9999,1
1746536081516,DSC 297,002,959862,Wang; Yusu,9999,0,9999,0
1746536082542,EAP 100,A00,905686,Staff,9778,0,9999,221
1746536083574,ECE 45,A01,892618,Staff,0,0,65,65
1746536085629,ECE 111,A01,892719,Staff,4,0,65,61
1746536086658,ECE 197,001,957920,Mercier; Patrick Philip,9991,0,9999,8
1746536087687,ECON 178,A01,907814,Zhu; Ying,26,0,35,9
1746536088713,EDS 115,A00,895312,Staff,36,0,45,9
1746536089739,EDS 117,A01,895337,Staff,24,0,30,6
1746536090768,EDS 125,A00,895341,Jones; Gabrielle Anastasia,37,0,45,8
1746536091798,EDS 128A,A01,895459,Fargason; Sharon Gayle,44,0,45,1
1746536092828,EDS 128B,A01,895543,Pappas; Elizabeth,44,0,45,1
1746536093856,EDS 139,A00,897203,Pappas; Elizabeth,44,0,45,1
1746536093856,EDS 139,B00,897209,Fargason; Sharon Gayle,41,0,45,4
1746536094883,EDS 201,A00,895545,Staff,23,0,45,22
1746536095913,EDS 203,A01,895581,Halter; Christopher P.,23,0,45,22
1746536096941,EDS 204R,A01,895625,Heinzman; Erica M.,39,0,45,6
1746536096941,EDS 204R,B01,895693,Halter; Christopher P.,10,0,45,35
1746536097971,EDS 206R,A00,895694,Fargason; Sharon Gayle,1,0,30,29
1746536097971,EDS 206R,B00,895695,Choi; Bailey Miyeon,16,0,30,14
1746536098999,EDS 250,A00,895697,Hemans; Patricia Ann Benitez,23,0,45,22
1746536100033,EDS 281,A00,895701,Meyerott; Theresa Ann,1,0,15,14
1746536101061,EDS 284,A00,895736,Meyerott; Theresa Ann,1,0,15,14
1746536102088,EDS 286,A00,897210,Fine; Sarah,0,0,15,15
1746536103120,EDS 289C,A01,895770,Daly; Alan J.,15,0,15,0
1746536104146,EDS 290,A00,897211,Hofstetter; Carolyn,0,0,15,15
1746536105173,LIGM 5A,A00,896162,Fischer-Grunski; Eva K,13,0,20,7
1746536106203,LIGM 5B,A00,896260,Fischer-Grunski; Eva K,17,0,20,3
1746536107231,LIGM 5C,A00,896308,Fischer-Grunski; Eva K,18,0,20,2
1746536108261,LIIT 5AS,A00,896313,Carnelos; Chiara,18,0,20,2
1746536109289,LIIT 5BS,A00,896416,Carnelos; Chiara,20,0,20,0
1746536110319,LIIT 5CS,A00,896564,Carnelos; Chiara,20,0,20,0
1746536111347,LISP 5A,A00,896588,Munoz Sanchez; Alicia,3,0,20,17
1746536112376,LISP 5B,A00,896653,Munoz Sanchez; Alicia,7,0,20,13
1746536113402,LISP 5C,A00,896655,Munoz Sanchez; Alicia,0,1,20,20
1746536114434,MAE 197,001,957918,Kleissl; Jan,9996,0,9999,3
1746536114434,MAE 197,002,959806,Boechler; Nicholas Sebastia,9998,0,9999,1
1746536114434,MAE 197,003,959852,Mullin; Jennifer S,9999,0,9999,0
1746536115465,MATH 2,A01,957937,Staff,33,0,35,2
1746536116490,MATH 197,001,957876,Kedlaya; Kiran S.,9993,0,9999,6
1746536117519,MCWP 40,A00,892729,Duru; Nur,10,0,20,10
1746536117519,MCWP 40,B00,893304,Montejo; Carolina,14,0,20,6
1746536118546,MCWP 40R,A00,893757,Redela; Pamela Morgan,0,5,20,20
1746536119572,MCWP 50,A00,893758,Morshed; Michael James,0,0,20,20
1746536119572,MCWP 50,B00,893761,Bartulis; Jason Michael,17,0,20,3
1746536120599,MCWP 50R,A00,893766,Compas; Sean Matthew,0,1,20,20
1746536120599,MCWP 50R,B00,893769,Carter; Jennifer A,0,1,20,20
1746536120599,MCWP 50R,C00,893771,Krone; Jarret,0,3,20,20
1746536120599,MCWP 50R,D00,893772,Miller; Elizabeth Deen,0,0,20,20
1746536120599,MCWP 50R,E00,893775,Carter; Andrea L,0,1,20,20
1746536121627,MMW 11R,A01,892721,Herbst; Matthew,11,0,27,16
1746536121627,MMW 11R,A02,892722,Herbst; Matthew,0,0,0,3
1746536122657,MMW 12R,A01,892724,Herbst; Matthew,0,11,16,16
1746536122657,MMW 12R,A02,892725,Herbst; Matthew,0,10,16,16
1746536123683,MMW 13R,A01,892727,Staff,0,4,16,16
1746536123683,MMW 13R,A02,892728,Staff,0,4,16,16
1746536123683,MMW 13R,A03,958032,Staff,0,4,16,16
1746536123683,MMW 13R,A04,958033,Staff,0,4,16,16
1746536123683,MMW 13R,A05,958034,Staff,0,4,16,16
1746536124709,SIO 295LS,A00,894015,Staff,5,0,25,20
1746536125735,SIO 295S,A00,894020,Staff,5,0,25,20
1746536126769,SIOC 290S,B01,958918,Merrifield; Mark A,14,0,30,16
1746536127796,SIOC 291S,B01,958922,Gabriel; Corey John,14,0,30,16
1746536128824,SOCI 117,A01,895339,Staff,3,0,5,2
1746536129852,WES 237B,A00,894149,Staff,11,0,20,9
1746536131939,AESE 279B,A00,891859,Staff,13,0,35,22
1746536132965,AIP 197,001,891854,Vespa; Emanuel Ignacio,9999,0,9999,0
1746536133996,ANTH 289S,A00,891856,Gagneux; Pascal,12,0,12,0
1746536135064,BENG 196,001,957946,Engler; Adam J.,9996,0,9999,3
1746536136107,BISP 197,001,959851,Wilhelm; James E.,9999,0,9999,0
1746536137133,CAT 124RS,A01,956906,Staff,6,0,25,19
1746536138162,CAT 125RS,A01,922013,Staff,6,0,25,19
1746536139189,CLRE 250,A00,891860,Morris; Sheldon,9995,0,9999,4
1746536141243,CLRE 251R,A00,907817,Mehta; Ravindra L.,9994,0,9999,5
1746536142275,CLRE 252,A00,891864,Cuomo; Raphael Eduardo,9993,0,9999,6
1746536143306,CLRE 253,A00,891867,Vaida; Florin,9994,0,9999,5
1746536143306,CLRE 253,B00,907819,Staff,9999,0,9999,0
1746536144333,CLRE 259,A00,891868,Patel; Hemal,9998,0,9999,1
1746536145358,CLRE 260,A00,891872,Cuomo; Raphael Eduardo,9999,0,9999,0
1746536146387,CLRE 297,001,891888,Cuomo; Raphael Eduardo,9999,0,9999,0
1746536147418,CSE 191,A00,958773,Minnes Kemp; Mor Mia,9996,0,9999,3
1746536148446,CSE 197,001,959846,Minnes Kemp; Mor Mia,9993,0,9999,6
1746536149479,CSS 201S,A01,892054,Mignozzetti; Umberto,26,0,30,4
1746536150508,CSS 202S,A01,892056,Mignozzetti; Umberto,26,0,30,4
1746536151535,DSC 197,001,956898,Eldridge; Justin Matthew,9998,0,9999,1
1746536152563,DSC 297,001,958000,Mazumdar; Arya,9998,0,9999,1
1746536152563,DSC 297,002,959862,Wang; Yusu,9999,0,9999,0
1746536153589,EAP 100,A00,905686,Staff,9778,0,9999,221
1746536154617,ECE 45,A01,892618,Staff,0,0,65,65
1746536156671,ECE 111,A01,892719,Staff,4,0,65,61
1746536157697,ECE 197,001,957920,Mercier; Patrick Philip,9991,0,9999,8
1746536158725,ECON 178,A01,907814,Zhu; Ying,26,0,35,9
1746536159750,EDS 115,A00,895312,Staff,36,0,45,9
1746536160777,EDS 117,A01,895337,Staff,24,0,30,6
1746536161805,EDS 125,A00,895341,Jones; Gabrielle Anastasia,37,0,45,8
1746536162835,EDS 128A,A01,895459,Fargason; Sharon Gayle,44,0,45,1
1746536163861,EDS 128B,A01,895543,Pappas; Elizabeth,44,0,45,1
1746536164887,EDS 139,A00,897203,Pappas; Elizabeth,44,0,45,1
1746536164887,EDS 139,B00,897209,Fargason; Sharon Gayle,41,0,45,4
1746536165915,EDS 201,A00,895545,Staff,23,0,45,22
1746536166940,EDS 203,A01,895581,Halter; Christopher P.,23,0,45,22
1746536167967,EDS 204R,A01,895625,Heinzman; Erica M.,39,0,45,6
1746536167967,EDS 204R,B01,895693,Halter; Christopher P.,10,0,45,35
1746536168999,EDS 206R,A00,895694,Fargason; Sharon Gayle,1,0,30,29
1746536168999,EDS 206R,B00,895695,Choi; Bailey Miyeon,16,0,30,14
1746536170029,EDS 250,A00,895697,Hemans; Patricia Ann Benitez,23,0,45,22
1746536171055,EDS 281,A00,895701,Meyerott; Theresa Ann,1,0,15,14
1746536172085,EDS 284,A00,895736,Meyerott; Theresa Ann,1,0,15,14
1746536173112,EDS 286,A00,897210,Fine; Sarah,0,0,15,15
1746536174139,EDS 289C,A01,895770,Daly; Alan J.,15,0,15,0
1746536175164,EDS 290,A00,897211,Hofstetter; Carolyn,0,0,15,15
1746536176192,LIGM 5A,A00,896162,Fischer-Grunski; Eva K,13,0,20,7
1746536177220,LIGM 5B,A00,896260,Fischer-Grunski; Eva K,17,0,20,3
1746536178253,LIGM 5C,A00,896308,Fischer-Grunski; Eva K,18,0,20,2
1746536179278,LIIT 5AS,A00,896313,Carnelos; Chiara,18,0,20,2
1746536180306,LIIT 5BS,A00,896416,Carnelos; Chiara,20,0,20,0
1746536181335,LIIT 5CS,A00,896564,Carnelos; Chiara,20,0,20,0
1746536182367,LISP 5A,A00,896588,Munoz Sanchez; Alicia,3,0,20,17
1746536183394,LISP 5B,A00,896653,Munoz Sanchez; Alicia,7,0,20,13
1746536184422,LISP 5C,A00,896655,Munoz Sanchez; Alicia,0,1,20,20
1746536185449,MAE 197,001,957918,Kleissl; Jan,9996,0,9999,3
1746536185449,MAE 197,002,959806,Boechler; Nicholas Sebastia,9998,0,9999,1
1746536185449,MAE 197,003,959852,Mullin; Jennifer S,9999,0,9999,0
1746536186476,MATH 2,A01,957937,Staff,33,0,35,2
1746536187502,MATH 197,001,957876,Kedlaya; Kiran S.,9993,0,9999,6
1746536188533,MCWP 40,A00,892729,Duru; Nur,10,0,20,10
1746536188533,MCWP 40,B00,893304,Montejo; Carolina,14,0,20,6
1746536189561,MCWP 40R,A00,893757,Redela; Pamela Morgan,0,5,20,20
1746536190587,MCWP 50,A00,893758,Morshed; Michael James,0,0,20,20
1746536190587,MCWP 50,B00,893761,Bartulis; Jason Michael,17,0,20,3
1746536191619,MCWP 50R,A00,893766,Compas; Sean Matthew,0,1,20,20
1746536191619,MCWP 50R,B00,893769,Carter; Jennifer A,0,1,20,20
1746536191619,MCWP 50R,C00,893771,Krone; Jarret,0,3,20,20
1746536191619,MCWP 50R,D00,893772,Miller; Elizabeth Deen,0,0,20,20
1746536191619,MCWP 50R,E00,893775,Carter; Andrea L,0,1,20,20
1746536192650,MMW 11R,A01,892721,Herbst; Matthew,11,0,27,16
1746536192650,MMW 11R,A02,892722,Herbst; Matthew,0,0,0,3
1746536193676,MMW 12R,A01,892724,Herbst; Matthew,0,11,16,16
1746536193676,MMW 12R,A02,892725,Herbst; Matthew,0,10,16,16
1746536194702,MMW 13R,A01,892727,Staff,0,4,16,16
1746536194702,MMW 13R,A02,892728,Staff,0,4,16,16
1746536194702,MMW 13R,A03,958032,Staff,0,4,16,16
1746536194702,MMW 13R,A04,958033,Staff,0,4,16,16
1746536194702,MMW 13R,A05,958034,Staff,0,4,16,16
1746536195730,SIO 295LS,A00,894015,Staff,5,0,25,20
1746536196754,SIO 295S,A00,894020,Staff,5,0,25,20
1746536197788,SIOC 290S,B01,958918,Merrifield; Mark A,14,0,30,16
1746536198819,SIOC 291S,B01,958922,Gabriel; Corey John,14,0,30,16
1746536199849,SOCI 117,A01,895339,Staff,3,0,5,2
1746536200877,WES 237B,A00,894149,Staff,11,0,20,9
1746536202939,AESE 279B,A00,891859,Staff,13,0,35,22
1746536203965,AIP 197,001,891854,Vespa; Emanuel Ignacio,9999,0,9999,0
1746536204992,ANTH 289S,A00,891856,Gagneux; Pascal,12,0,12,0
1746536206018,BENG 196,001,957946,Engler; Adam J.,9996,0,9999,3
1746536207045,BISP 197,001,959851,Wilhelm; James E.,9999,0,9999,0
1746536208072,CAT 124RS,A01,956906,Staff,6,0,25,19
1746536209098,CAT 125RS,A01,922013,Staff,6,0,25,19
1746536210125,CLRE 250,A00,891860,Morris; Sheldon,9995,0,9999,4
1746536212178,CLRE 251R,A00,907817,Mehta; Ravindra L.,9994,0,9999,5
1746536213205,CLRE 252,A00,891864,Cuomo; Raphael Eduardo,9993,0,9999,6
1746536214232,CLRE 253,A00,891867,Vaida; Florin,9994,0,9999,5
1746536214232,CLRE 253,B00,907819,Staff,9999,0,9999,0
1746536215260,CLRE 259,A00,891868,Patel; Hemal,9998,0,9999,1
1746536216286,CLRE 260,A00,891872,Cuomo; Raphael Eduardo,9999,0,9999,0
1746536217311,CLRE 297,001,891888,Cuomo; Raphael Eduardo,9999,0,9999,0
1746536218338,CSE 191,A00,958773,Minnes Kemp; Mor Mia,9996,0,9999,3
1746536219369,CSE 197,001,959846,Minnes Kemp; Mor Mia,9993,0,9999,6
1746536220402,CSS 201S,A01,892054,Mignozzetti; Umberto,26,0,30,4
1746536221433,CSS 202S,A01,892056,Mignozzetti; Umberto,26,0,30,4
1746536222457,DSC 197,001,956898,Eldridge; Justin Matthew,9998,0,9999,1
1746536223488,DSC 297,001,958000,Mazumdar; Arya,9998,0,9999,1
1746536223488,DSC 297,002,959862,Wang; Yusu,9999,0,9999,0
1746536224517,EAP 100,A00,905686,Staff,9778,0,9999,221
1746536225544,ECE 45,A01,892618,Staff,0,0,65,65
1746536227600,ECE 111,A01,892719,Staff,4,0,65,61
1746536228629,ECE 197,001,957920,Mercier; Patrick Philip,9991,0,9999,8
1746536229661,ECON 178,A01,907814,Zhu; Ying,26,0,35,9
1746536230688,EDS 115,A00,895312,Staff,36,0,45,9
1746536231719,EDS 117,A01,895337,Staff,24,0,30,6
1746536232746,EDS 125,A00,895341,Jones; Gabrielle Anastasia,37,0,45,8
1746536233776,EDS 128A,A01,895459,Fargason; Sharon Gayle,44,0,45,1
1746536234806,EDS 128B,A01,895543,Pappas; Elizabeth,44,0,45,1
1746536235833,EDS 139,A00,897203,Pappas; Elizabeth,44,0,45,1
1746536235833,EDS 139,B00,897209,Fargason; Sharon Gayle,41,0,45,4
1746536236859,EDS 201,A00,895545,Staff,23,0,45,22
1746536237886,EDS 203,A01,895581,Halter; Christopher P.,23,0,45,22
1746536238967,EDS 204R,A01,895625,Heinzman; Erica M.,39,0,45,6
1746536238967,EDS 204R,B01,895693,Halter; Christopher P.,10,0,45,35
1746536239995,EDS 206R,A00,895694,Fargason; Sharon Gayle,1,0,30,29
1746536239995,EDS 206R,B00,895695,Choi; Bailey Miyeon,16,0,30,14
1746536241021,EDS 250,A00,895697,Hemans; Patricia Ann Benitez,23,0,45,22
1746536242051,EDS 281,A00,895701,Meyerott; Theresa Ann,1,0,15,14
1746536243076,EDS 284,A00,895736,Meyerott; Theresa Ann,1,0,15,14
1746536244103,EDS 286,A00,897210,Fine; Sarah,0,0,15,15
1746536245129,EDS 289C,A01,895770,Daly; Alan J.,15,0,15,0
1746536246158,EDS 290,A00,897211,Hofstetter; Carolyn,0,0,15,15
1746536247185,LIGM 5A,A00,896162,Fischer-Grunski; Eva K,13,0,20,7
1746536248214,LIGM 5B,A00,896260,Fischer-Grunski; Eva K,17,0,20,3
1746536249245,LIGM 5C,A00,896308,Fischer-Grunski; Eva K,18,0,20,2
1746536250276,LIIT 5AS,A00,896313,Carnelos; Chiara,18,0,20,2
1746536251306,LIIT 5BS,A00,896416,Carnelos; Chiara,20,0,20,0
1746536252331,LIIT 5CS,A00,896564,Carnelos; Chiara,20,0,20,0
1746536253359,LISP 5A,A00,896588,Munoz Sanchez; Alicia,3,0,20,17
1746536254388,LISP 5B,A00,896653,Munoz Sanchez; Alicia,7,0,20,13
1746536255413,LISP 5C,A00,896655,Munoz Sanchez; Alicia,0,1,20,20
1746536256441,MAE 197,001,957918,Kleissl; Jan,9996,0,9999,3
1746536256441,MAE 197,002,959806,Boechler; Nicholas Sebastia,9998,0,9999,1
1746536256441,MAE 197,003,959852,Mullin; Jennifer S,9999,0,9999,0
1746536257468,MATH 2,A01,957937,Staff,33,0,35,2
1746536258497,MATH 197,001,957876,Kedlaya; Kiran S.,9993,0,9999,6
1746536259530,MCWP 40,A00,892729,Duru; Nur,10,0,20,10
1746536259530,MCWP 40,B00,893304,Montejo; Carolina,14,0,20,6
1746536260560,MCWP 40R,A00,893757,Redela; Pamela Morgan,0,5,20,20
1746536261590,MCWP 50,A00,893758,Morshed; Michael James,0,0,20,20
1746536261590,MCWP 50,B00,893761,Bartulis; Jason Michael,17,0,20,3
1746536262618,MCWP 50R,A00,893766,Compas; Sean Matthew,0,1,20,20
1746536262618,MCWP 50R,B00,893769,Carter; Jennifer A,0,1,20,20
1746536262618,MCWP 50R,C00,893771,Krone; Jarret,0,3,20,20
1746536262618,MCWP 50R,D00,893772,Miller; Elizabeth Deen,0,0,20,20
1746536262618,MCWP 50R,E00,893775,Carter; Andrea L,0,1,20,20
1746536263645,MMW 11R,A01,892721,Herbst; Matthew,11,0,27,16
1746536263645,MMW 11R,A02,892722,Herbst; Matthew,0,0,0,3
1746536264672,MMW 12R,A01,892724,Herbst; Matthew,0,11,16,16
1746536264672,MMW 12R,A02,892725,Herbst; Matthew,0,10,16,16
1746536265700,MMW 13R,A01,892727,Staff,0,4,16,16
1746536265700,MMW 13R,A02,892728,Staff,0,4,16,16
1746536265700,MMW 13R,A03,958032,Staff,0,4,16,16
1746536265700,MMW 13R,A04,958033,Staff,0,4,16,16
1746536265700,MMW 13R,A05,958034,Staff,0,4,16,16
1746536266730,SIO 295LS,A00,894015,Staff,5,0,25,20
1746536267756,SIO 295S,A00,894020,Staff,5,0,25,20
1746536268784,SIOC 290S,B01,958918,Merrifield; Mark A,14,0,30,16
1746536269809,SIOC 291S,B01,958922,Gabriel; Corey John,14,0,30,16
1746536270838,SOCI 117,A01,895339,Staff,3,0,5,2
1746536271864,WES 237B,A00,894149,Staff,11,0,20,9
1746536273939,AESE 279B,A00,891859,Staff,13,0,35,22
1746536274964,AIP 197,001,891854,Vespa; Emanuel Ignacio,9999,0,9999,0
1746536275990,ANTH 289S,A00,891856,Gagneux; Pascal,12,0,12,0
1746536277017,BENG 196,001,957946,Engler; Adam J.,9996,0,9999,3
1746536278043,BISP 197,001,959851,Wilhelm; James E.,9999,0,9999,0
1746536279072,CAT 124RS,A01,956906,Staff,6,0,25,19
1746536280103,CAT 125RS,A01,922013,Staff,6,0,25,19
1746536281132,CLRE 250,A00,891860,Morris; Sheldon,9995,0,9999,4
1746536283187,CLRE 251R,A00,907817,Mehta; Ravindra L.,9994,0,9999,5
1746536284213,CLRE 252,A00,891864,Cuomo; Raphael Eduardo,9993,0,9999,6
1746536285240,CLRE 253,A00,891867,Vaida; Florin,9994,0,9999,5
1746536285240,CLRE 253,B00,907819,Staff,9999,0,9999,0
1746536286265,CLRE 259,A00,891868,Patel; Hemal,9998,0,9999,1
1746536287294,CLRE 260,A00,891872,Cuomo; Raphael Eduardo,9999,0,9999,0
1746536288323,CLRE 297,001,891888,Cuomo; Raphael Eduardo,9999,0,9999,0
1746536289352,CSE 191,A00,958773,Minnes Kemp; Mor Mia,9996,0,9999,3
1746536290378,CSE 197,001,959846,Minnes Kemp; Mor Mia,9993,0,9999,6
1746536291405,CSS 201S,A01,892054,Mignozzetti; Umberto,26,0,30,4
1746536292434,CSS 202S,A01,892056,Mignozzetti; Umberto,26,0,30,4
1746536293462,DSC 197,001,956898,Eldridge; Justin Matthew,9998,0,9999,1
1746536294489,DSC 297,001,958000,Mazumdar; Arya,9998,0,9999,1
1746536294489,DSC 297,002,959862,Wang; Yusu,9999,0,9999,0
1746536295516,EAP 100,A00,905686,Staff,9778,0,9999,221
1746536296550,ECE 45,A01,892618,Staff,0,0,65,65
1746536298601,ECE 111,A01,892719,Staff,4,0,65,61
1746536299630,ECE 197,001,957920,Mercier; Patrick Philip,9991,0,9999,8
1746536300664,ECON 178,A01,907814,Zhu; Ying,26,0,35,9
1746536301693,EDS 115,A00,895312,Staff,36,0,45,9
1746536302720,EDS 117,A01,895337,Staff,24,0,30,6
1746536303746,EDS 125,A00,895341,Jones; Gabrielle Anastasia,37,0,45,8
1746536304771,EDS 128A,A01,895459,Fargason; Sharon Gayle,44,0,45,1
1746536305797,EDS 128B,A01,895543,Pappas; Elizabeth,44,0,45,1
1746536306824,EDS 139,A00,897203,Pappas; Elizabeth,44,0,45,1
1746536306824,EDS 139,B00,897209,Fargason; Sharon Gayle,41,0,45,4
1746536307853,EDS 201,A00,895545,Staff,23,0,45,22
1746536308879,EDS 203,A01,895581,Halter; Christopher P.,23,0,45,22
1746536309910,EDS 204R,A01,895625,Heinzman; Erica M.,39,0,45,6
1746536309910,EDS 204R,B01,895693,Halter; Christopher P.,10,0,45,35
1746536310935,EDS 206R,A00,895694,Fargason; Sharon Gayle,1,0,30,29
1746536310935,EDS 206R,B00,895695,Choi; Bailey Miyeon,16,0,30,14
1746536311960,EDS 250,A00,895697,Hemans; Patricia Ann Benitez,23,0,45,22
1746536312988,EDS 281,A00,895701,Meyerott; Theresa Ann,1,0,15,14
1746536314013,EDS 284,A00,895736,Meyerott; Theresa Ann,1,0,15,14
1746536315040,EDS 286,A00,897210,Fine; Sarah,0,0,15,15
1746536316067,EDS 289C,A01,895770,Daly; Alan J.,15,0,15,0
1746536317098,EDS 290,A00,897211,Hofstetter; Carolyn,0,0,15,15
1746536318125,LIGM 5A,A00,896162,Fischer-Grunski; Eva K,13,0,20,7
1746536319158,LIGM 5B,A00,896260,Fischer-Grunski; Eva K,17,0,20,3
1746536320183,LIGM 5C,A00,896308,Fischer-Grunski; Eva K,18,0,20,2
1746536321208,LIIT 5AS,A00,896313,Carnelos; Chiara,18,0,20,2
1746536322237,LIIT 5BS,A00,896416,Carnelos; Chiara,20,0,20,0
1746536323264,LIIT 5CS,A00,896564,Carnelos; Chiara,20,0,20,0
1746536324294,LISP 5A,A00,896588,Munoz Sanchez; Alicia,3,0,20,17
1746536325322,LISP 5B,A00,896653,Munoz Sanchez; Alicia,7,0,20,13
1746536326354,LISP 5C,A00,896655,Munoz Sanchez; Alicia,0,1,20,20
1746536327381,MAE 197,001,957918,Kleissl; Jan,9996,0,9999,3
1746536327381,MAE 197,002,959806,Boechler; Nicholas Sebastia,9998,0,9999,1
1746536327381,MAE 197,003,959852,Mullin; Jennifer S,9999,0,9999,0
1746536328407,MATH 2,A01,957937,Staff,33,0,35,2
1746536329433,MATH 197,001,957876,Kedlaya; Kiran S.,9993,0,9999,6
1746536330459,MCWP 40,A00,892729,Duru; Nur,10,0,20,10
1746536330459,MCWP 40,B00,893304,Montejo; Carolina,14,0,20,6
1746536331488,MCWP 40R,A00,893757,Redela; Pamela Morgan,0,5,20,20
1746536332515,MCWP 50,A00,893758,Morshed; Michael James,0,0,20,20
1746536332515,MCWP 50,B00,893761,Bartulis; Jason Michael,17,0,20,3
1746536333544,MCWP 50R,A00,893766,Compas; Sean Matthew,0,1,20,20
1746536333544,MCWP 50R,B00,893769,Carter; Jennifer A,0,1,20,20
1746536333544,MCWP 50R,C00,893771,Krone; Jarret,0,3,20,20
1746536333544,MCWP 50R,D00,893772,Miller; Elizabeth Deen,0,0,20,20
1746536333544,MCWP 50R,E00,893775,Carter; Andrea L,0,1,20,20
1746536334569,MMW 11R,A01,892721,Herbst; Matthew,11,0,27,16
1746536334569,MMW 11R,A02,892722,Herbst; Matthew,0,0,0,3
1746536335594,MMW 12R,A01,892724,Herbst; Matthew,0,11,16,16
1746536335594,MMW 12R,A02,892725,Herbst; Matthew,0,10,16,16
1746536336621,MMW 13R,A01,892727,Staff,0,4,16,16
1746536336621,MMW 13R,A02,892728,Staff,0,4,16,16
1746536336621,MMW 13R,A03,958032,Staff,0,4,16,16
1746536336621,MMW 13R,A04,958033,Staff,0,4,16,16
1746536336621,MMW 13R,A05,958034,Staff,0,4,16,16
1746536337646,SIO 295LS,A00,894015,Staff,5,0,25,20
1746536338674,SIO 295S,A00,894020,Staff,5,0,25,20
1746536339709,SIOC 290S,B01,958918,Merrifield; Mark A,14,0,30,16
1746536340737,SIOC 291S,B01,958922,Gabriel; Corey John,14,0,30,16
1746536341767,SOCI 117,A01,895339,Staff,3,0,5,2
1746536342848,WES 237B,A00,894149,Staff,11,0,20,9
1746536344920,AESE 279B,A00,891859,Staff,13,0,35,22
1746536345948,AIP 197,001,891854,Vespa; Emanuel Ignacio,9999,0,9999,0
1746536346975,ANTH 289S,A00,891856,Gagneux; Pascal,12,0,12,0
1746536348018,BENG 196,001,957946,Engler; Adam J.,9996,0,9999,3
1746536349050,BISP 197,001,959851,Wilhelm; James E.,9999,0,9999,0
1746536350075,CAT 124RS,A01,956906,Staff,6,0,25,19
1746536351102,CAT 125RS,A01,922013,Staff,6,0,25,19
1746536352133,CLRE 250,A00,891860,Morris; Sheldon,9995,0,9999,4
1746536354192,CLRE 251R,A00,907817,Mehta; Ravindra L.,9994,0,9999,5
1746536355222,CLRE 252,A00,891864,Cuomo; Raphael Eduardo,9993,0,9999,6
1746536356247,CLRE 253,A00,891867,Vaida; Florin,9994,0,9999,5
1746536356247,CLRE 253,B00,907819,Staff,9999,0,9999,0
1746536357276,CLRE 259,A00,891868,Patel; Hemal,9998,0,9999,1
1746536358303,CLRE 260,A00,891872,Cuomo; Raphael Eduardo,9999,0,9999,0
1746536359330,CLRE 297,001,891888,Cuomo; Raphael Eduardo,9999,0,9999,0
1746536360355,CSE 191,A00,958773,Minnes Kemp; Mor Mia,9996,0,9999,3
1746536361381,CSE 197,001,959846,Minnes Kemp; Mor Mia,9993,0,9999,6
1746536362425,CSS 201S,A01,892054,Mignozzetti; Umberto,26,0,30,4
1746536363457,CSS 202S,A01,892056,Mignozzetti; Umberto,26,0,30,4
1746536364483,DSC 197,001,956898,Eldridge; Justin Matthew,9998,0,9999,1
1746536365509,DSC 297,001,958000,Mazumdar; Arya,9998,0,9999,1
1746536365509,DSC 297,002,959862,Wang; Yusu,9999,0,9999,0
1746536366538,EAP 100,A00,905686,Staff,9778,0,9999,221
1746536367566,ECE 45,A01,892618,Staff,0,0,65,65
1746536369621,ECE 111,A01,892719,Staff,4,0,65,61
1746536370652,ECE 197,001,957920,Mercier; Patrick Philip,9991,0,9999,8
1746536371679,ECON 178,A01,907814,Zhu; Ying,26,0,35,9
1746536372708,EDS 115,A00,895312,Staff,36,0,45,9
1746536373736,EDS 117,A01,895337,Staff,24,0,30,6
1746536374763,EDS 125,A00,895341,Jones; Gabrielle Anastasia,37,0,45,8
1746536375792,EDS 128A,A01,895459,Fargason; Sharon Gayle,44,0,45,1
1746536376819,EDS 128B,A01,895543,Pappas; Elizabeth,44,0,45,1
1746536377851,EDS 139,A00,897203,Pappas; Elizabeth,44,0,45,1
1746536377851,EDS 139,B00,897209,Fargason; Sharon Gayle,41,0,45,4
1746536378881,EDS 201,A00,895545,Staff,23,0,45,22
1746536379906,EDS 203,A01,895581,Halter; Christopher P.,23,0,45,22
1746536380934,EDS 204R,A01,895625,Heinzman; Erica M.,39,0,45,6
1746536380934,EDS 204R,B01,895693,Halter; Christopher P.,10,0,45,35
1746536381965,EDS 206R,A00,895694,Fargason; Sharon Gayle,1,0,30,29
1746536381965,EDS 206R,B00,895695,Choi; Bailey Miyeon,16,0,30,14
1746536382991,EDS 250,A00,895697,Hemans; Patricia Ann Benitez,23,0,45,22
1746536384021,EDS 281,A00,895701,Meyerott; Theresa Ann,1,0,15,14
1746536385053,EDS 284,A00,895736,Meyerott; Theresa Ann,1,0,15,14
1746536386081,EDS 286,A00,897210,Fine; Sarah,0,0,15,15
1746536387106,EDS 289C,A01,895770,Daly; Alan J.,15,0,15,0
1746536388132,EDS 290,A00,897211,Hofstetter; Carolyn,0,0,15,15
1746536389160,LIGM 5A,A00,896162,Fischer-Grunski; Eva K,13,0,20,7
1746536390189,LIGM 5B,A00,896260,Fischer-Grunski; Eva K,17,0,20,3
1746536391217,LIGM 5C,A00,896308,Fischer-Grunski; Eva K,18,0,20,2
1746536392245,LIIT 5AS,A00,896313,Carnelos; Chiara,18,0,20,2
1746536393276,LIIT 5BS,A00,896416,Carnelos; Chiara,20,0,20,0
1746536394304,LIIT 5CS,A00,896564,Carnelos; Chiara,20,0,20,0
1746536395336,LISP 5A,A00,896588,Munoz Sanchez; Alicia,3,0,20,17
1746536396367,LISP 5B,A00,896653,Munoz Sanchez; Alicia,7,0,20,13
1746536397395,LISP 5C,A00,896655,Munoz Sanchez; Alicia,0,1,20,20
1746536398421,MAE 197,001,957918,Kleissl; Jan,9996,0,9999,3
1746536398421,MAE 197,002,959806,Boechler; Nicholas Sebastia,9998,0,9999,1
1746536398421,MAE 197,003,959852,Mullin; Jennifer S,9999,0,9999,0
1746536399445,MATH 2,A01,957937,Staff,33,0,35,2
1746536400471,MATH 197,001,957876,Kedlaya; Kiran S.,9993,0,9999,6
1746536401500,MCWP 40,A00,892729,Duru; Nur,10,0,20,10
1746536401500,MCWP 40,B00,893304,Montejo; Carolina,14,0,20,6
1746536402528,MCWP 40R,A00,893757,Redela; Pamela Morgan,0,5,20,20
1746536403556,MCWP 50,A00,893758,Morshed; Michael James,0,0,20,20
1746536403556,MCWP 50,B00,893761,Bartulis; Jason Michael,17,0,20,3
1746536404583,MCWP 50R,A00,893766,Compas; Sean Matthew,0,1,20,20
1746536404583,MCWP 50R,B00,893769,Carter; Jennifer A,0,1,20,20
1746536404583,MCWP 50R,C00,893771,Krone; Jarret,0,3,20,20
1746536404583,MCWP 50R,D00,893772,Miller; Elizabeth Deen,0,0,20,20
1746536404583,MCWP 50R,E00,893775,Carter; Andrea L,0,1,20,20
1746536405650,MMW 11R,A01,892721,Herbst; Matthew,11,0,27,16
1746536405650,MMW 11R,A02,892722,Herbst; Matthew,0,0,0,3
1746536406674,MMW 12R,A01,892724,Herbst; Matthew,0,11,16,16
1746536406674,MMW 12R,A02,892725,Herbst; Matthew,0,10,16,16
1746536407704,MMW 13R,A01,892727,Staff,0,4,16,16
1746536407704,MMW 13R,A02,892728,Staff,0,4,16,16
1746536407704,MMW 13R,A03,958032,Staff,0,4,16,16
1746536407704,MMW 13R,A04,958033,Staff,0,4,16,16
1746536407704,MMW 13R,A05,958034,Staff,0,4,16,16
1746536408731,SIO 295LS,A00,894015,Staff,5,0,25,20
1746536409759,SIO 295S,A00,894020,Staff,5,0,25,20
1746536410788,SIOC 290S,B01,958918,Merrifield; Mark A,14,0,30,16
1746536411816,SIOC 291S,B01,958922,Gabriel; Corey John,14,0,30,16
1746536412844,SOCI 117,A01,895339,Staff,3,0,5,2
1746536413880,WES 237B,A00,894149,Staff,11,0,20,9
1746536415959,AESE 279B,A00,891859,Staff,13,0,35,22
1746536416988,AIP 197,001,891854,Vespa; Emanuel Ignacio,9999,0,9999,0
1746536418017,ANTH 289S,A00,891856,Gagneux; Pascal,12,0,12,0
1746536419042,BENG 196,001,957946,Engler; Adam J.,9996,0,9999,3
1746536420069,BISP 197,001,959851,Wilhelm; James E.,9999,0,9999,0
1746536421097,CAT 124RS,A01,956906,Staff,6,0,25,19
1746536422127,CAT 125RS,A01,922013,Staff,6,0,25,19
1746536423152,CLRE 250,A00,891860,Morris; Sheldon,9995,0,9999,4
1746536425208,CLRE 251R,A00,907817,Mehta; Ravindra L.,9994,0,9999,5
1746536426239,CLRE 252,A00,891864,Cuomo; Raphael Eduardo,9993,0,9999,6
1746536427266,CLRE 253,A00,891867,Vaida; Florin,9994,0,9999,5
1746536427266,CLRE 253,B00,907819,Staff,9999,0,9999,0
1746536428290,CLRE 259,A00,891868,Patel; Hemal,9998,0,9999,1
1746536429319,CLRE 260,A00,891872,Cuomo; Raphael Eduardo,9999,0,9999,0
1746536430344,CLRE 297,001,891888,Cuomo; Raphael Eduardo,9999,0,9999,0
1746536431373,CSE 191,A00,958773,Minnes Kemp; Mor Mia,9996,0,9999,3
1746536432408,CSE 197,001,959846,Minnes Kemp; Mor Mia,9993,0,9999,6
1746536433436,CSS 201S,A01,892054,Mignozzetti; Umberto,26,0,30,4
1746536434461,CSS 202S,A01,892056,Mignozzetti; Umberto,26,0,30,4
1746536435485,DSC 197,001,956898,Eldridge; Justin Matthew,9998,0,9999,1
1746536436511,DSC 297,001,958000,Mazumdar; Arya,9998,0,9999,1
1746536436511,DSC 297,002,959862,Wang; Yusu,9999,0,9999,0
1746536437536,EAP 100,A00,905686,Staff,9778,0,9999,221
1746536438566,ECE 45,A01,892618,Staff,0,0,65,65
1746536440622,ECE 111,A01,892719,Staff,4,0,65,61
1746536441649,ECE 197,001,957920,Mercier; Patrick Philip,9991,0,9999,8
1746536442680,ECON 178,A01,907814,Zhu; Ying,26,0,35,9
1746536443707,EDS 115,A00,895312,Staff,36,0,45,9
1746536444732,EDS 117,A01,895337,Staff,24,0,30,6
1746536445758,EDS 125,A00,895341,Jones; Gabrielle Anastasia,37,0,45,8
1746536446788,EDS 128A,A01,895459,Fargason; Sharon Gayle,44,0,45,1
1746536447815,EDS 128B,A01,895543,Pappas; Elizabeth,44,0,45,1
1746536448840,EDS 139,A00,897203,Pappas; Elizabeth,44,0,45,1
1746536448840,EDS 139,B00,897209,Fargason; Sharon Gayle,41,0,45,4
1746536449871,EDS 201,A00,895545,Staff,23,0,45,22
1746536450897,EDS 203,A01,895581,Halter; Christopher P.,23,0,45,22
1746536451925,EDS 204R,A01,895625,Heinzman; Erica M.,39,0,45,6
1746536451925,EDS 204R,B01,895693,Halter; Christopher P.,10,0,45,35
1746536452956,EDS 206R,A00,895694,Fargason; Sharon Gayle,1,0,30,29
1746536452956,EDS 206R,B00,895695,Choi; Bailey Miyeon,16,0,30,14
1746536453982,EDS 250,A00,895697,Hemans; Patricia Ann Benitez,23,0,45,22
1746536455014,EDS 281,A00,895701,Meyerott; Theresa Ann,1,0,15,14
1746536456044,EDS 284,A00,895736,Meyerott; Theresa Ann,1,0,15,14
1746536457073,EDS 286,A00,897210,Fine; Sarah,0,0,15,15
1746536458100,EDS 289C,A01,895770,Daly; Alan J.,15,0,15,0
1746536459500,EDS 290,A00,897211,Hofstetter; Carolyn,0,0,15,15
1746536460526,LIGM 5A,A00,896162,Fischer-Grunski; Eva K,13,0,20,7
1746536461551,LIGM 5B,A00,896260,Fischer-Grunski; Eva K,17,0,20,3
1746536462583,LIGM 5C,A00,896308,Fischer-Grunski; Eva K,18,0,20,2
1746536463611,LIIT 5AS,A00,896313,Carnelos; Chiara,18,0,20,2
1746536464644,LIIT 5BS,A00,896416,Carnelos; Chiara,20,0,20,0
1746536465674,LIIT 5CS,A00,896564,Carnelos; Chiara,20,0,20,0
1746536466706,LISP 5A,A00,896588,Munoz Sanchez; Alicia,3,0,20,17
1746536467735,LISP 5B,A00,896653,Munoz Sanchez; Alicia,7,0,20,13
1746536468761,LISP 5C,A00,896655,Munoz Sanchez; Alicia,0,1,20,20
1746536469788,MAE 197,001,957918,Kleissl; Jan,9996,0,9999,3
1746536469788,MAE 197,002,959806,Boechler; Nicholas Sebastia,9998,0,9999,1
1746536469788,MAE 197,003,959852,Mullin; Jennifer S,9999,0,9999,0
1746536470815,MATH 2,A01,957937,Staff,33,0,35,2
1746536471841,MATH 197,001,957876,Kedlaya; Kiran S.,9993,0,9999,6
1746536472869,MCWP 40,A00,892729,Duru; Nur,10,0,20,10
1746536472869,MCWP 40,B00,893304,Montejo; Carolina,14,0,20,6
1746536473900,MCWP 40R,A00,893757,Redela; Pamela Morgan,0,5,20,20
1746536474930,MCWP 50,A00,893758,Morshed; Michael James,0,0,20,20
1746536474930,MCWP 50,B00,893761,Bartulis; Jason Michael,17,0,20,3
1746536475957,MCWP 50R,A00,893766,Compas; Sean Matthew,0,1,20,20
1746536475957,MCWP 50R,B00,893769,Carter; Jennifer A,0,1,20,20
1746536475957,MCWP 50R,C00,893771,Krone; Jarret,0,3,20,20
1746536475957,MCWP 50R,D00,893772,Miller; Elizabeth Deen,0,0,20,20
1746536475957,MCWP 50R,E00,893775,Carter; Andrea L,0,1,20,20
1746536476986,MMW 11R,A01,892721,Herbst; Matthew,11,0,27,16
1746536476986,MMW 11R,A02,892722,Herbst; Matthew,0,0,0,3
1746536478015,MMW 12R,A01,892724,Herbst; Matthew,0,11,16,16
1746536478015,MMW 12R,A02,892725,Herbst; Matthew,0,10,16,16
1746536479041,MMW 13R,A01,892727,Staff,0,4,16,16
1746536479041,MMW 13R,A02,892728,Staff,0,4,16,16
1746536479041,MMW 13R,A03,958032,Staff,0,4,16,16
1746536479041,MMW 13R,A04,958033,Staff,0,4,16,16
1746536479041,MMW 13R,A05,958034,Staff,0,4,16,16
1746536480069,SIO 295LS,A00,894015,Staff,5,0,25,20
1746536481096,SIO 295S,A00,894020,Staff,5,0,25,20
1746536482164,SIOC 290S,B01,958918,Merrifield; Mark A,14,0,30,16
1746536483192,SIOC 291S,B01,958922,Gabriel; Corey John,14,0,30,16
1746536484222,SOCI 117,A01,895339,Staff,3,0,5,2
1746536485249,WES 237B,A00,894149,Staff,11,0,20,9
1746536487319,AESE 279B,A00,891859,Staff,13,0,35,22
1746536488345,AIP 197,001,891854,Vespa; Emanuel Ignacio,9999,0,9999,0
1746536489375,ANTH 289S,A00,891856,Gagneux; Pascal,12,0,12,0
1746536490410,BENG 196,001,957946,Engler; Adam J.,9996,0,9999,3
1746536491440,BISP 197,001,959851,Wilhelm; James E.,9999,0,9999,0
1746536492463,CAT 124RS,A01,956906,Staff,6,0,25,19
1746536493493,CAT 125RS,A01,922013,Staff,6,0,25,19
1746536494518,CLRE 250,A00,891860,Morris; Sheldon,9995,0,9999,4
1746536496574,CLRE 251R,A00,907817,Mehta; Ravindra L.,9994,0,9999,5
1746536497601,CLRE 252,A00,891864,Cuomo; Raphael Eduardo,9993,0,9999,6
1746536498628,CLRE 253,A00,891867,Vaida; Florin,9994,0,9999,5
1746536498628,CLRE 253,B00,907819,Staff,9999,0,9999,0
1746536499660,CLRE 259,A00,891868,Patel; Hemal,9998,0,9999,1
1746536500688,CLRE 260,A00,891872,Cuomo; Raphael Eduardo,9999,0,9999,0
1746536501714,CLRE 297,001,891888,Cuomo; Raphael Eduardo,9999,0,9999,0
1746536502744,CSE 191,A00,958773,Minnes Kemp; Mor Mia,9996,0,9999,3
1746536503772,CSE 197,001,959846,Minnes Kemp; Mor Mia,9993,0,9999,6
1746536504798,CSS 201S,A01,892054,Mignozzetti; Umberto,26,0,30,4
1746536505830,CSS 202S,A01,892056,Mignozzetti; Umberto,26,0,30,4
1746536506860,DSC 197,001,956898,Eldridge; Justin Matthew,9998,0,9999,1
1746536507889,DSC 297,001,958000,Mazumdar; Arya,9998,0,9999,1
1746536507889,DSC 297,002,959862,Wang; Yusu,9999,0,9999,0
1746536508914,EAP 100,A00,905686,Staff,9778,0,9999,221
1746536509945,ECE 45,A01,892618,Staff,0,0,65,65
1746536512003,ECE 111,A01,892719,Staff,4,0,65,61
1746536513027,ECE 197,001,957920,Mercier; Patrick Philip,9991,0,9999,8
1746536514055,ECON 178,A01,907814,Zhu; Ying,26,0,35,9
1746536515081,EDS 115,A00,895312,Staff,36,0,45,9
1746536516106,EDS 117,A01,895337,Staff,24,0,30,6
1746536517132,EDS 125,A00,895341,Jones; Gabrielle Anastasia,37,0,45,8
1746536518160,EDS 128A,A01,895459,Fargason; Sharon Gayle,44,0,45,1
1746536519187,EDS 128B,A01,895543,Pappas; Elizabeth,44,0,45,1
1746536520214,EDS 139,A00,897203,Pappas; Elizabeth,44,0,45,1
1746536520214,EDS 139,B00,897209,Fargason; Sharon Gayle,41,0,45,4
1746536521241,EDS 201,A00,895545,Staff,23,0,45,22
1746536522269,EDS 203,A01,895581,Halter; Christopher P.,23,0,45,22
1746536523296,EDS 204R,A01,895625,Heinzman; Erica M.,39,0,45,6
1746536523296,EDS 204R,B01,895693,Halter; Christopher P.,10,0,45,35
1746536524326,EDS 206R,A00,895694,Fargason; Sharon Gayle,1,0,30,29
1746536524326,EDS 206R,B00,895695,Choi; Bailey Miyeon,16,0,30,14
1746536525355,EDS 250,A00,895697,Hemans; Patricia Ann Benitez,23,0,45,22
1746536526382,EDS 281,A00,895701,Meyerott; Theresa Ann,1,0,15,14
1746536527410,EDS 284,A00,895736,Meyerott; Theresa Ann,1,0,15,14
1746536528440,EDS 286,A00,897210,Fine; Sarah,0,0,15,15
1746536529469,EDS 289C,A01,895770,Daly; Alan J.,15,0,15,0
1746536530500,EDS 290,A00,897211,Hofstetter; Carolyn,0,0,15,15
1746536531525,LIGM 5A,A00,896162,Fischer-Grunski; Eva K,13,0,20,7
1746536532551,LIGM 5B,A00,896260,Fischer-Grunski; Eva K,17,0,20,3
1746536533578,LIGM 5C,A00,896308,Fischer-Grunski; Eva K,18,0,20,2
1746536534603,LIIT 5AS,A00,896313,Carnelos; Chiara,18,0,20,2
1746536535631,LIIT 5BS,A00,896416,Carnelos; Chiara,20,0,20,0
1746536536657,LIIT 5CS,A00,896564,Carnelos; Chiara,20,0,20,0
1746536537684,LISP 5A,A00,896588,Munoz Sanchez; Alicia,3,0,20,17
1746536538713,LISP 5B,A00,896653,Munoz Sanchez; Alicia,7,0,20,13
1746536539745,LISP 5C,A00,896655,Munoz Sanchez; Alicia,0,1,20,20
1746536540772,MAE 197,001,957918,Kleissl; Jan,9996,0,9999,3
1746536540772,MAE 197,002,959806,Boechler; Nicholas Sebastia,9998,0,9999,1
1746536540772,MAE 197,003,959852,Mullin; Jennifer S,9999,0,9999,0
1746536541796,MATH 2,A01,957937,Staff,33,0,35,2
1746536542827,MATH 197,001,957876,Kedlaya; Kiran S.,9993,0,9999,6
1746536543856,MCWP 40,A00,892729,Duru; Nur,10,0,20,10
1746536543856,MCWP 40,B00,893304,Montejo; Carolina,14,0,20,6
1746536544883,MCWP 40R,A00,893757,Redela; Pamela Morgan,0,5,20,20
1746536545909,MCWP 50,A00,893758,Morshed; Michael James,0,0,20,20
1746536545909,MCWP 50,B00,893761,Bartulis; Jason Michael,17,0,20,3
1746536546934,MCWP 50R,A00,893766,Compas; Sean Matthew,0,1,20,20
1746536546934,MCWP 50R,B00,893769,Carter; Jennifer A,0,1,20,20
1746536546934,MCWP 50R,C00,893771,Krone; Jarret,0,3,20,20
1746536546934,MCWP 50R,D00,893772,Miller; Elizabeth Deen,0,0,20,20
1746536546934,MCWP 50R,E00,893775,Carter; Andrea L,0,1,20,20
1746536547965,MMW 11R,A01,892721,Herbst; Matthew,11,0,27,16
1746536547965,MMW 11R,A02,892722,Herbst; Matthew,0,0,0,3
1746536548990,MMW 12R,A01,892724,Herbst; Matthew,0,11,16,16
1746536548990,MMW 12R,A02,892725,Herbst; Matthew,0,10,16,16
1746536550018,MMW 13R,A01,892727,Staff,0,4,16,16
1746536550018,MMW 13R,A02,892728,Staff,0,4,16,16
1746536550018,MMW 13R,A03,958032,Staff,0,4,16,16
1746536550018,MMW 13R,A04,958033,Staff,0,4,16,16
1746536550018,MMW 13R,A05,958034,Staff,0,4,16,16
1746536551046,SIO 295LS,A00,894015,Staff,5,0,25,20
1746536552072,SIO 295S,A00,894020,Staff,5,0,25,20
1746536553104,SIOC 290S,B01,958918,Merrifield; Mark A,14,0,30,16
1746536554135,SIOC 291S,B01,958922,Gabriel; Corey John,14,0,30,16
1746536555161,SOCI 117,A01,895339,Staff,3,0,5,2
1746536556187,WES 237B,A00,894149,Staff,11,0,20,9
1746536558268,AESE 279B,A00,891859,Staff,13,0,35,22
1746536559297,AIP 197,001,891854,Vespa; Emanuel Ignacio,9999,0,9999,0
1746536560322,ANTH 289S,A00,891856,Gagneux; Pascal,12,0,12,0
1746536561348,BENG 196,001,957946,Engler; Adam J.,9996,0,9999,3
1746536562376,BISP 197,001,959851,Wilhelm; James E.,9999,0,9999,0
1746536563400,CAT 124RS,A01,956906,Staff,6,0,25,19
1746536564428,CAT 125RS,A01,922013,Staff,6,0,25,19
1746536565458,CLRE 250,A00,891860,Morris; Sheldon,9995,0,9999,4
1746536567511,CLRE 251R,A00,907817,Mehta; Ravindra L.,9994,0,9999,5
1746536568540,CLRE 252,A00,891864,Cuomo; Raphael Eduardo,9993,0,9999,6
1746536569569,CLRE 253,A00,891867,Vaida; Florin,9994,0,9999,5
1746536569569,CLRE 253,B00,907819,Staff,9999,0,9999,0
1746536570598,CLRE 259,A00,891868,Patel; Hemal,9998,0,9999,1
1746536571623,CLRE 260,A00,891872,Cuomo; Raphael Eduardo,9999,0,9999,0
1746536572652,CLRE 297,001,891888,Cuomo; Raphael Eduardo,9999,0,9999,0
1746536573680,CSE 191,A00,958773,Minnes Kemp; Mor Mia,9996,0,9999,3
1746536574705,CSE 197,001,959846,Minnes Kemp; Mor Mia,9993,0,9999,6
1746536575733,CSS 201S,A01,892054,Mignozzetti; Umberto,26,0,30,4
1746536576759,CSS 202S,A01,892056,Mignozzetti; Umberto,26,0,30,4
1746536577788,DSC 197,001,956898,Eldridge; Justin Matthew,9998,0,9999,1
1746536578816,DSC 297,001,958000,Mazumdar; Arya,9998,0,9999,1
1746536578816,DSC 297,002,959862,Wang; Yusu,9999,0,9999,0
1746536579841,EAP 100,A00,905686,Staff,9778,0,9999,221
1746536580868,ECE 45,A01,892618,Staff,0,0,65,65
1746536582922,ECE 111,A01,892719,Staff,4,0,65,61
1746536583950,ECE 197,001,957920,Mercier; Patrick Philip,9991,0,9999,8
1746536584983,ECON 178,A01,907814,Zhu; Ying,26,0,35,9
1746536586010,EDS 115,A00,895312,Staff,36,0,45,9
1746536587037,EDS 117,A01,895337,Staff,24,0,30,6
1746536588062,EDS 125,A00,895341,Jones; Gabrielle Anastasia,37,0,45,8
1746536589091,EDS 128A,A01,895459,Fargason; Sharon Gayle,44,0,45,1
1746536590121,EDS 128B,A01,895543,Pappas; Elizabeth,44,0,45,1
1746536591147,EDS 139,A00,897203,Pappas; Elizabeth,44,0,45,1
1746536591147,EDS 139,B00,897209,Fargason; Sharon Gayle,41,0,45,4
1746536592176,EDS 201,A00,895545,Staff,23,0,45,22
1746536593204,EDS 203,A01,895581,Halter; Christopher P.,23,0,45,22
1746536594231,EDS 204R,A01,895625,Heinzman; Erica M.,39,0,45,6
1746536594231,EDS 204R,B01,895693,Halter; Christopher P.,10,0,45,35
1746536595258,EDS 206R,A00,895694,Fargason; Sharon Gayle,1,0,30,29
1746536595258,EDS 206R,B00,895695,Choi; Bailey Miyeon,16,0,30,14
1746536596284,EDS 250,A00,895697,Hemans; Patricia Ann Benitez,23,0,45,22
1746536597310,EDS 281,A00,895701,Meyerott; Theresa Ann,1,0,15,14
1746536598340,EDS 284,A00,895736,Meyerott; Theresa Ann,1,0,15,14
1746536599365,EDS 286,A00,897210,Fine; Sarah,0,0,15,15
1746536600397,EDS 289C,A01,895770,Daly; Alan J.,15,0,15,0
1746536601427,EDS 290,A00,897211,Hofstetter; Carolyn,0,0,15,15
1746536602457,LIGM 5A,A00,896162,Fischer-Grunski; Eva K,13,0,20,7
1746536603487,LIGM 5B,A00,896260,Fischer-Grunski; Eva K,17,0,20,3
1746536604517,LIGM 5C,A00,896308,Fischer-Grunski; Eva K,18,0,20,2
1746536605543,LIIT 5AS,A00,896313,Carnelos; Chiara,18,0,20,2
1746536606570,LIIT 5BS,A00,896416,Carnelos; Chiara,20,0,20,0
1746536607601,LIIT 5CS,A00,896564,Carnelos; Chiara,20,0,20,0
1746536608631,LISP 5A,A00,896588,Munoz Sanchez; Alicia,3,0,20,17
1746536609657,LISP 5B,A00,896653,Munoz Sanchez; Alicia,7,0,20,13
1746536610683,LISP 5C,A00,896655,Munoz Sanchez; Alicia,0,1,20,20
1746536611713,MAE 197,001,957918,Kleissl; Jan,9996,0,9999,3
1746536611713,MAE 197,002,959806,Boechler; Nicholas Sebastia,9998,0,9999,1
1746536611713,MAE 197,003,959852,Mullin; Jennifer S,9999,0,9999,0
1746536612739,MATH 2,A01,957937,Staff,33,0,35,2
1746536613764,MATH 197,001,957876,Kedlaya; Kiran S.,9993,0,9999,6
1746536614792,MCWP 40,A00,892729,Duru; Nur,10,0,20,10
1746536614792,MCWP 40,B00,893304,Montejo; Carolina,14,0,20,6
1746536615820,MCWP 40R,A00,893757,Redela; Pamela Morgan,0,5,20,20
1746536616853,MCWP 50,A00,893758,Morshed; Michael James,0,0,20,20
1746536616853,MCWP 50,B00,893761,Bartulis; Jason Michael,17,0,20,3
1746536617883,MCWP 50R,A00,893766,Compas; Sean Matthew,0,1,20,20
1746536617883,MCWP 50R,B00,893769,Carter; Jennifer A,0,1,20,20
1746536617883,MCWP 50R,C00,893771,Krone; Jarret,0,3,20,20
1746536617883,MCWP 50R,D00,893772,Miller; Elizabeth Deen,0,0,20,20
1746536617883,MCWP 50R,E00,893775,Carter; Andrea L,0,1,20,20
1746536618909,MMW 11R,A01,892721,Herbst; Matthew,11,0,27,16
1746536618909,MMW 11R,A02,892722,Herbst; Matthew,0,0,0,3
1746536619937,MMW 12R,A01,892724,Herbst; Matthew,0,11,16,16
1746536619937,MMW 12R,A02,892725,Herbst; Matthew,0,10,16,16
1746536620968,MMW 13R,A01,892727,Staff,0,4,16,16
1746536620968,MMW 13R,A02,892728,Staff,0,4,16,16
1746536620968,MMW 13R,A03,958032,Staff,0,4,16,16
1746536620968,MMW 13R,A04,958033,Staff,0,4,16,16
1746536620968,MMW 13R,A05,958034,Staff,0,4,16,16
1746536621996,SIO 295LS,A00,894015,Staff,5,0,25,20
1746536623022,SIO 295S,A00,894020,Staff,5,0,25,20
1746536624049,SIOC 290S,B01,958918,Merrifield; Mark A,14,0,30,16
1746536625080,SIOC 291S,B01,958922,Gabriel; Corey John,14,0,30,16
1746536626108,SOCI 117,A01,895339,Staff,3,0,5,2
1746536627134,WES 237B,A00,894149,Staff,11,0,20,9
1746536629220,AESE 279B,A00,891859,Staff,13,0,35,22
1746536630249,AIP 197,001,891854,Vespa; Emanuel Ignacio,9999,0,9999,0
1746536631275,ANTH 289S,A00,891856,Gagneux; Pascal,12,0,12,0
1746536632299,BENG 196,001,957946,Engler; Adam J.,9996,0,9999,3
1746536633326,BISP 197,001,959851,Wilhelm; James E.,9999,0,9999,0
1746536634354,CAT 124RS,A01,956906,Staff,6,0,25,19
1746536635380,CAT 125RS,A01,922013,Staff,6,0,25,19
1746536636410,CLRE 250,A00,891860,Morris; Sheldon,9995,0,9999,4
1746536638464,CLRE 251R,A00,907817,Mehta; Ravindra L.,9994,0,9999,5
1746536639490,CLRE 252,A00,891864,Cuomo; Raphael Eduardo,9993,0,9999,6
1746536640518,CLRE 253,A00,891867,Vaida; Florin,9994,0,9999,5
1746536640518,CLRE 253,B00,907819,Staff,9999,0,9999,0
1746536641546,CLRE 259,A00,891868,Patel; Hemal,9998,0,9999,1
1746536642573,CLRE 260,A00,891872,Cuomo; Raphael Eduardo,9999,0,9999,0
1746536643600,CLRE 297,001,891888,Cuomo; Raphael Eduardo,9999,0,9999,0
1746536644631,CSE 191,A00,958773,Minnes Kemp; Mor Mia,9996,0,9999,3
1746536645657,CSE 197,001,959846,Minnes Kemp; Mor Mia,9993,0,9999,6
1746536646682,CSS 201S,A01,892054,Mignozzetti; Umberto,26,0,30,4
1746536647712,CSS 202S,A01,892056,Mignozzetti; Umberto,26,0,30,4
1746536648740,DSC 197,001,956898,Eldridge; Justin Matthew,9998,0,9999,1
1746536649769,DSC 297,001,958000,Mazumdar; Arya,9998,0,9999,1
1746536649769,DSC 297,002,959862,Wang; Yusu,9999,0,9999,0
1746536650794,EAP 100,A00,905686,Staff,9778,0,9999,221
1746536651826,ECE 45,A01,892618,Staff,0,0,65,65
1746536653882,ECE 111,A01,892719,Staff,4,0,65,61
1746536654908,ECE 197,001,957920,Mercier; Patrick Philip,9991,0,9999,8
1746536655939,ECON 178,A01,907814,Zhu; Ying,26,0,35,9
1746536656967,EDS 115,A00,895312,Staff,36,0,45,9
1746536657992,EDS 117,A01,895337,Staff,24,0,30,6
1746536659020,EDS 125,A00,895341,Jones; Gabrielle Anastasia,37,0,45,8
1746536660052,EDS 128A,A01,895459,Fargason; Sharon Gayle,44,0,45,1
1746536661078,EDS 128B,A01,895543,Pappas; Elizabeth,44,0,45,1
1746536662105,EDS 139,A00,897203,Pappas; Elizabeth,44,0,45,1
1746536662105,EDS 139,B00,897209,Fargason; Sharon Gayle,41,0,45,4
1746536663134,EDS 201,A00,895545,Staff,23,0,45,22
1746536664161,EDS 203,A01,895581,Halter; Christopher P.,23,0,45,22
1746536665189,EDS 204R,A01,895625,Heinzman; Erica M.,39,0,45,6
1746536665189,EDS 204R,B01,895693,Halter; Christopher P.,10,0,45,35
1746536666215,EDS 206R,A00,895694,Fargason; Sharon Gayle,1,0,30,29
1746536666215,EDS 206R,B00,895695,Choi; Bailey Miyeon,16,0,30,14
1746536667242,EDS 250,A00,895697,Hemans; Patricia Ann Benitez,23,0,45,22
1746536668272,EDS 281,A00,895701,Meyerott; Theresa Ann,1,0,15,14
1746536669300,EDS 284,A00,895736,Meyerott; Theresa Ann,1,0,15,14
1746536670331,EDS 286,A00,897210,Fine; Sarah,0,0,15,15
1746536671358,EDS 289C,A01,895770,Daly; Alan J.,15,0,15,0
1746536672384,EDS 290,A00,897211,Hofstetter; Carolyn,0,0,15,15
1746536673409,LIGM 5A,A00,896162,Fischer-Grunski; Eva K,13,0,20,7
1746536674433,LIGM 5B,A00,896260,Fischer-Grunski; Eva K,17,0,20,3
1746536675462,LIGM 5C,A00,896308,Fischer-Grunski; Eva K,18,0,20,2
1746536676488,LIIT 5AS,A00,896313,Carnelos; Chiara,18,0,20,2
1746536677520,LIIT 5BS,A00,896416,Carnelos; Chiara,20,0,20,0
1746536678550,LIIT 5CS,A00,896564,Carnelos; Chiara,20,0,20,0
1746536679578,LISP 5A,A00,896588,Munoz Sanchez; Alicia,3,0,20,17
1746536680606,LISP 5B,A00,896653,Munoz Sanchez; Alicia,7,0,20,13
1746536681635,LISP 5C,A00,896655,Munoz Sanchez; Alicia,0,1,20,20
1746536682665,MAE 197,001,957918,Kleissl; Jan,9996,0,9999,3
1746536682665,MAE 197,002,959806,Boechler; Nicholas Sebastia,9998,0,9999,1
1746536682665,MAE 197,003,959852,Mullin; Jennifer S,9999,0,9999,0
1746536683691,MATH 2,A01,957937,Staff,33,0,35,2
1746536684725,MATH 197,001,957876,Kedlaya; Kiran S.,9993,0,9999,6
1746536685756,MCWP 40,A00,892729,Duru; Nur,10,0,20,10
1746536685756,MCWP 40,B00,893304,Montejo; Carolina,14,0,20,6
1746536686786,MCWP 40R,A00,893757,Redela; Pamela Morgan,0,5,20,20
1746536687813,MCWP 50,A00,893758,Morshed; Michael James,0,0,20,20
1746536687813,MCWP 50,B00,893761,Bartulis; Jason Michael,17,0,20,3
1746536688846,MCWP 50R,A00,893766,Compas; Sean Matthew,0,1,20,20
1746536688846,MCWP 50R,B00,893769,Carter; Jennifer A,0,1,20,20
1746536688846,MCWP 50R,C00,893771,Krone; Jarret,0,3,20,20
1746536688846,MCWP 50R,D00,893772,Miller; Elizabeth Deen,0,0,20,20
1746536688846,MCWP 50R,E00,893775,Carter; Andrea L,0,1,20,20
1746536689872,MMW 11R,A01,892721,Herbst; Matthew,11,0,27,16
1746536689872,MMW 11R,A02,892722,Herbst; Matthew,0,0,0,3
1746536690898,MMW 12R,A01,892724,Herbst; Matthew,0,11,16,16
1746536690898,MMW 12R,A02,892725,Herbst; Matthew,0,10,16,16
1746536691923,MMW 13R,A01,892727,Staff,0,4,16,16
1746536691923,MMW 13R,A02,892728,Staff,0,4,16,16
1746536691923,MMW 13R,A03,958032,Staff,0,4,16,16
1746536691923,MMW 13R,A04,958033,Staff,0,4,16,16
1746536691923,MMW 13R,A05,958034,Staff,0,4,16,16
1746536692954,SIO 295LS,A00,894015,Staff,5,0,25,20
1746536693983,SIO 295S,A00,894020,Staff,5,0,25,20
1746536695014,SIOC 290S,B01,958918,Merrifield; Mark A,14,0,30,16
1746536696041,SIOC 291S,B01,958922,Gabriel; Corey John,14,0,30,16
1746536697072,SOCI 117,A01,895339,Staff,3,0,5,2
1746536698099,WES 237B,A00,894149,Staff,11,0,20,9
1746536700180,AESE 279B,A00,891859,Staff,13,0,35,22
1746536701252,AIP 197,001,891854,Vespa; Emanuel Ignacio,9999,0,9999,0
1746536702280,ANTH 289S,A00,891856,Gagneux; Pascal,12,0,12,0
1746536703314,BENG 196,001,957946,Engler; Adam J.,9996,0,9999,3
1746536704342,BISP 197,001,959851,Wilhelm; James E.,9999,0,9999,0
1746536705370,CAT 124RS,A01,956906,Staff,6,0,25,19
1746536706399,CAT 125RS,A01,922013,Staff,6,0,25,19
1746536707427,CLRE 250,A00,891860,Morris; Sheldon,9995,0,9999,4
1746536709482,CLRE 251R,A00,907817,Mehta; Ravindra L.,9994,0,9999,5
1746536710510,CLRE 252,A00,891864,Cuomo; Raphael Eduardo,9993,0,9999,6
1746536711541,CLRE 253,A00,891867,Vaida; Florin,9994,0,9999,5
1746536711541,CLRE 253,B00,907819,Staff,9999,0,9999,0
1746536712568,CLRE 259,A00,891868,Patel; Hemal,9998,0,9999,1
1746536713599,CLRE 260,A00,891872,Cuomo; Raphael Eduardo,9999,0,9999,0
1746536714627,CLRE 297,001,891888,Cuomo; Raphael Eduardo,9999,0,9999,0
1746536715658,CSE 191,A00,958773,Minnes Kemp; Mor Mia,9996,0,9999,3
1746536716688,CSE 197,001,959846,Minnes Kemp; Mor Mia,9993,0,9999,6
1746536717720,CSS 201S,A01,892054,Mignozzetti; Umberto,26,0,30,4
1746536718748,CSS 202S,A01,892056,Mignozzetti; Umberto,26,0,30,4
1746536719781,DSC 197,001,956898,Eldridge; Justin Matthew,9998,0,9999,1
1746536720809,DSC 297,001,958000,Mazumdar; Arya,9998,0,9999,1
1746536720809,DSC 297,002,959862,Wang; Yusu,9999,0,9999,0
1746536721837,EAP 100,A00,905686,Staff,9778,0,9999,221
1746536722864,ECE 45,A01,892618,Staff,0,0,65,65
1746536724921,ECE 111,A01,892719,Staff,4,0,65,61
1746536725951,ECE 197,001,957920,Mercier; Patrick Philip,9991,0,9999,8
1746536726979,ECON 178,A01,907814,Zhu; Ying,26,0,35,9
1746536728006,EDS 115,A00,895312,Staff,36,0,45,9
1746536729035,EDS 117,A01,895337,Staff,24,0,30,6
1746536730074,EDS 125,A00,895341,Jones; Gabrielle Anastasia,37,0,45,8
1746536731101,EDS 128A,A01,895459,Fargason; Sharon Gayle,44,0,45,1
1746536732134,EDS 128B,A01,895543,Pappas; Elizabeth,44,0,45,1
1746536733164,EDS 139,A00,897203,Pappas; Elizabeth,44,0,45,1
1746536733164,EDS 139,B00,897209,Fargason; Sharon Gayle,41,0,45,4
1746536734194,EDS 201,A00,895545,Staff,23,0,45,22
1746536735226,EDS 203,A01,895581,Halter; Christopher P.,23,0,45,22
1746536736252,EDS 204R,A01,895625,Heinzman; Erica M.,39,0,45,6
1746536736252,EDS 204R,B01,895693,Halter; Christopher P.,10,0,45,35
1746536737279,EDS 206R,A00,895694,Fargason; Sharon Gayle,1,0,30,29
1746536737279,EDS 206R,B00,895695,Choi; Bailey Miyeon,16,0,30,14
1746536738308,EDS 250,A00,895697,Hemans; Patricia Ann Benitez,23,0,45,22
1746536739336,EDS 281,A00,895701,Meyerott; Theresa Ann,1,0,15,14
1746536740362,EDS 284,A00,895736,Meyerott; Theresa Ann,1,0,15,14
1746536741389,EDS 286,A00,897210,Fine; Sarah,0,0,15,15
1746536742425,EDS 289C,A01,895770,Daly; Alan J.,15,0,15,0
1746536743453,EDS 290,A00,897211,Hofstetter; Carolyn,0,0,15,15
1746536744478,LIGM 5A,A00,896162,Fischer-Grunski; Eva K,13,0,20,7
1746536745506,LIGM 5B,A00,896260,Fischer-Grunski; Eva K,17,0,20,3
1746536746538,LIGM 5C,A00,896308,Fischer-Grunski; Eva K,18,0,20,2
1746536747570,LIIT 5AS,A00,896313,Carnelos; Chiara,18,0,20,2
1746536748597,LIIT 5BS,A00,896416,Carnelos; Chiara,20,0,20,0
1746536749625,LIIT 5CS,A00,896564,Carnelos; Chiara,20,0,20,0
1746536750656,LISP 5A,A00,896588,Munoz Sanchez; Alicia,3,0,20,17
1746536751681,LISP 5B,A00,896653,Munoz Sanchez; Alicia,7,0,20,13
1746536752732,LISP 5C,A00,896655,Munoz Sanchez; Alicia,0,1,20,20
1746536753765,MAE 197,001,957918,Kleissl; Jan,9996,0,9999,3
1746536753765,MAE 197,002,959806,Boechler; Nicholas Sebastia,9998,0,9999,1
1746536753765,MAE 197,003,959852,Mullin; Jennifer S,9999,0,9999,0
1746536754795,MATH 2,A01,957937,Staff,33,0,35,2
1746536755821,MATH 197,001,957876,Kedlaya; Kiran S.,9993,0,9999,6
1746536756855,MCWP 40,A00,892729,Duru; Nur,10,0,20,10
1746536756855,MCWP 40,B00,893304,Montejo; Carolina,14,0,20,6
1746536757884,MCWP 40R,A00,893757,Redela; Pamela Morgan,0,5,20,20
1746536758913,MCWP 50,A00,893758,Morshed; Michael James,0,0,20,20
1746536758913,MCWP 50,B00,893761,Bartulis; Jason Michael,17,0,20,3
1746536759939,MCWP 50R,A00,893766,Compas; Sean Matthew,0,1,20,20
1746536759939,MCWP 50R,B00,893769,Carter; Jennifer A,0,1,20,20
1746536759939,MCWP 50R,C00,893771,Krone; Jarret,0,3,20,20
1746536759939,MCWP 50R,D00,893772,Miller; Elizabeth Deen,0,0,20,20
1746536759939,MCWP 50R,E00,893775,Carter; Andrea L,0,1,20,20
1746536760981,MMW 11R,A01,892721,Herbst; Matthew,11,0,27,16
1746536760981,MMW 11R,A02,892722,Herbst; Matthew,0,0,0,3
1746536762008,MMW 12R,A01,892724,Herbst; Matthew,0,11,16,16
1746536762008,MMW 12R,A02,892725,Herbst; Matthew,0,10,16,16
1746536763032,MMW 13R,A01,892727,Staff,0,4,16,16
1746536763032,MMW 13R,A02,892728,Staff,0,4,16,16
1746536763032,MMW 13R,A03,958032,Staff,0,4,16,16
1746536763032,MMW 13R,A04,958033,Staff,0,4,16,16
1746536763032,MMW 13R,A05,958034,Staff,0,4,16,16
1746536764056,SIO 295LS,A00,894015,Staff,5,0,25,20
1746536765084,SIO 295S,A00,894020,Staff,5,0,25,20
1746536766111,SIOC 290S,B01,958918,Merrifield; Mark A,14,0,30,16
1746536767136,SIOC 291S,B01,958922,Gabriel; Corey John,14,0,30,16
1746536768163,SOCI 117,A01,895339,Staff,3,0,5,2
1746536769191,WES 237B,A00,894149,Staff,11,0,20,9
1746536771261,AESE 279B,A00,891859,Staff,13,0,35,22
1746536772290,AIP 197,001,891854,Vespa; Emanuel Ignacio,9999,0,9999,0
1746536773322,ANTH 289S,A00,891856,Gagneux; Pascal,12,0,12,0
1746536774349,BENG 196,001,957946,Engler; Adam J.,9996,0,9999,3
1746536775377,BISP 197,001,959851,Wilhelm; James E.,9999,0,9999,0
1746536776404,CAT 124RS,A01,956906,Staff,6,0,25,19
1746536777432,CAT 125RS,A01,922013,Staff,6,0,25,19
1746536778457,CLRE 250,A00,891860,Morris; Sheldon,9995,0,9999,4
1746536780511,CLRE 251R,A00,907817,Mehta; Ravindra L.,9994,0,9999,5
1746536781540,CLRE 252,A00,891864,Cuomo; Raphael Eduardo,9993,0,9999,6
1746536782565,CLRE 253,A00,891867,Vaida; Florin,9994,0,9999,5
1746536782565,CLRE 253,B00,907819,Staff,9999,0,9999,0
1746536783594,CLRE 259,A00,891868,Patel; Hemal,9998,0,9999,1
1746536784621,CLRE 260,A00,891872,Cuomo; Raphael Eduardo,9999,0,9999,0
1746536785650,CLRE 297,001,891888,Cuomo; Raphael Eduardo,9999,0,9999,0
1746536786676,CSE 191,A00,958773,Minnes Kemp; Mor Mia,9996,0,9999,3
1746536787705,CSE 197,001,959846,Minnes Kemp; Mor Mia,9993,0,9999,6
1746536788732,CSS 201S,A01,892054,Mignozzetti; Umberto,26,0,30,4
1746536789759,CSS 202S,A01,892056,Mignozzetti; Umberto,26,0,30,4
1746536790788,DSC 197,001,956898,Eldridge; Justin Matthew,9998,0,9999,1
1746536791813,DSC 297,001,958000,Mazumdar; Arya,9998,0,9999,1
1746536791813,DSC 297,002,959862,Wang; Yusu,9999,0,9999,0
1746536792840,EAP 100,A00,905686,Staff,9778,0,9999,221
1746536793872,ECE 45,A01,892618,Staff,0,0,65,65
1746536795921,ECE 111,A01,892719,Staff,4,0,65,61
1746536796951,ECE 197,001,957920,Mercier; Patrick Philip,9991,0,9999,8
1746536797976,ECON 178,A01,907814,Zhu; Ying,26,0,35,9
1746536799003,EDS 115,A00,895312,Staff,36,0,45,9
1746536800032,EDS 117,A01,895337,Staff,24,0,30,6
1746536801058,EDS 125,A00,895341,Jones; Gabrielle Anastasia,37,0,45,8
1746536802086,EDS 128A,A01,895459,Fargason; Sharon Gayle,44,0,45,1
1746536803115,EDS 128B,A01,895543,Pappas; Elizabeth,44,0,45,1
1746536804140,EDS 139,A00,897203,Pappas; Elizabeth,44,0,45,1
1746536804140,EDS 139,B00,897209,Fargason; Sharon Gayle,41,0,45,4
1746536805166,EDS 201,A00,895545,Staff,23,0,45,22
1746536806194,EDS 203,A01,895581,Halter; Christopher P.,23,0,45,22
1746536807225,EDS 204R,A01,895625,Heinzman; Erica M.,39,0,45,6
1746536807225,EDS 204R,B01,895693,Halter; Christopher P.,10,0,45,35
1746536808254,EDS 206R,A00,895694,Fargason; Sharon Gayle,1,0,30,29
1746536808254,EDS 206R,B00,895695,Choi; Bailey Miyeon,16,0,30,14
1746536809281,EDS 250,A00,895697,Hemans; Patricia Ann Benitez,23,0,45,22
1746536810308,EDS 281,A00,895701,Meyerott; Theresa Ann,1,0,15,14
1746536811335,EDS 284,A00,895736,Meyerott; Theresa Ann,1,0,15,14
1746536812366,EDS 286,A00,897210,Fine; Sarah,0,0,15,15
1746536813394,EDS 289C,A01,895770,Daly; Alan J.,15,0,15,0
1746536814421,EDS 290,A00,897211,Hofstetter; Carolyn,0,0,15,15
1746536815447,LIGM 5A,A00,896162,Fischer-Grunski; Eva K,13,0,20,7
1746536816478,LIGM 5B,A00,896260,Fischer-Grunski; Eva K,17,0,20,3
1746536817505,LIGM 5C,A00,896308,Fischer-Grunski; Eva K,18,0,20,2
1746536818531,LIIT 5AS,A00,896313,Carnelos; Chiara,18,0,20,2
1746536819557,LIIT 5BS,A00,896416,Carnelos; Chiara,20,0,20,0
1746536820586,LIIT 5CS,A00,896564,Carnelos; Chiara,20,0,20,0
1746536821615,LISP 5A,A00,896588,Munoz Sanchez; Alicia,3,0,20,17
1746536822641,LISP 5B,A00,896653,Munoz Sanchez; Alicia,7,0,20,13
1746536823670,LISP 5C,A00,896655,Munoz Sanchez; Alicia,0,1,20,20
1746536824697,MAE 197,001,957918,Kleissl; Jan,9996,0,9999,3
1746536824697,MAE 197,002,959806,Boechler; Nicholas Sebastia,9998,0,9999,1
1746536824697,MAE 197,003,959852,Mullin; Jennifer S,9999,0,9999,0
1746536825725,MATH 2,A01,957937,Staff,33,0,35,2
1746536826753,MATH 197,001,957876,Kedlaya; Kiran S.,9993,0,9999,6
1746536827780,MCWP 40,A00,892729,Duru; Nur,10,0,20,10
1746536827780,MCWP 40,B00,893304,Montejo; Carolina,14,0,20,6
1746536828811,MCWP 40R,A00,893757,Redela; Pamela Morgan,0,5,20,20
1746536829838,MCWP 50,A00,893758,Morshed; Michael James,0,0,20,20
1746536829838,MCWP 50,B00,893761,Bartulis; Jason Michael,17,0,20,3
1746536830866,MCWP 50R,A00,893766,Compas; Sean Matthew,0,1,20,20
1746536830866,MCWP 50R,B00,893769,Carter; Jennifer A,0,1,20,20
1746536830866,MCWP 50R,C00,893771,Krone; Jarret,0,3,20,20
1746536830866,MCWP 50R,D00,893772,Miller; Elizabeth Deen,0,0,20,20
1746536830866,MCWP 50R,E00,893775,Carter; Andrea L,0,1,20,20
1746536831896,MMW 11R,A01,892721,Herbst; Matthew,11,0,27,16
1746536831896,MMW 11R,A02,892722,Herbst; Matthew,0,0,0,3
1746536832925,MMW 12R,A01,892724,Herbst; Matthew,0,11,16,16
1746536832925,MMW 12R,A02,892725,Herbst; Matthew,0,10,16,16
1746536833954,MMW 13R,A01,892727,Staff,0,4,16,16
1746536833954,MMW 13R,A02,892728,Staff,0,4,16,16
1746536833954,MMW 13R,A03,958032,Staff,0,4,16,16
1746536833954,MMW 13R,A04,958033,Staff,0,4,16,16
1746536833954,MMW 13R,A05,958034,Staff,0,4,16,16
1746536834986,SIO 295LS,A00,894015,Staff,5,0,25,20
1746536836012,SIO 295S,A00,894020,Staff,5,0,25,20
1746536837037,SIOC 290S,B01,958918,Merrifield; Mark A,14,0,30,16
1746536838065,SIOC 291S,B01,958922,Gabriel; Corey John,14,0,30,16
1746536839091,SOCI 117,A01,895339,Staff,3,0,5,2
1746536840119,WES 237B,A00,894149,Staff,11,0,20,9
1746536842186,AESE 279B,A00,891859,Staff,13,0,35,22
1746536843215,AIP 197,001,891854,Vespa; Emanuel Ignacio,9999,0,9999,0
1746536844242,ANTH 289S,A00,891856,Gagneux; Pascal,12,0,12,0
1746536845272,BENG 196,001,957946,Engler; Adam J.,9996,0,9999,3
1746536846303,BISP 197,001,959851,Wilhelm; James E.,9999,0,9999,0
1746536847331,CAT 124RS,A01,956906,Staff,6,0,25,19
1746536848357,CAT 125RS,A01,922013,Staff,6,0,25,19
1746536849385,CLRE 250,A00,891860,Morris; Sheldon,9995,0,9999,4
1746536851439,CLRE 251R,A00,907817,Mehta; Ravindra L.,9994,0,9999,5
1746536852465,CLRE 252,A00,891864,Cuomo; Raphael Eduardo,9993,0,9999,6
1746536853492,CLRE 253,A00,891867,Vaida; Florin,9994,0,9999,5
1746536853492,CLRE 253,B00,907819,Staff,9999,0,9999,0
1746536854522,CLRE 259,A00,891868,Patel; Hemal,9998,0,9999,1
1746536855548,CLRE 260,A00,891872,Cuomo; Raphael Eduardo,9999,0,9999,0
1746536856574,CLRE 297,001,891888,Cuomo; Raphael Eduardo,9999,0,9999,0
1746536857603,CSE 191,A00,958773,Minnes Kemp; Mor Mia,9996,0,9999,3
1746536858632,CSE 197,001,959846,Minnes Kemp; Mor Mia,9993,0,9999,6
1746536859659,CSS 201S,A01,892054,Mignozzetti; Umberto,26,0,30,4
1746536860711,CSS 202S,A01,892056,Mignozzetti; Umberto,26,0,30,4
1746536861737,DSC 197,001,956898,Eldridge; Justin Matthew,9998,0,9999,1
1746536862767,DSC 297,001,958000,Mazumdar; Arya,9998,0,9999,1
1746536862767,DSC 297,002,959862,Wang; Yusu,9999,0,9999,0
1746536863795,EAP 100,A00,905686,Staff,9778,0,9999,221
1746536864822,ECE 45,A01,892618,Staff,0,0,65,65
1746536866879,ECE 111,A01,892719,Staff,4,0,65,61
1746536867908,ECE 197,001,957920,Mercier; Patrick Philip,9991,0,9999,8
1746536868933,ECON 178,A01,907814,Zhu; Ying,26,0,35,9
1746536869958,EDS 115,A00,895312,Staff,36,0,45,9
1746536870984,EDS 117,A01,895337,Staff,24,0,30,6
1746536872009,EDS 125,A00,895341,Jones; Gabrielle Anastasia,37,0,45,8
1746536873035,EDS 128A,A01,895459,Fargason; Sharon Gayle,44,0,45,1
1746536874063,EDS 128B,A01,895543,Pappas; Elizabeth,44,0,45,1
1746536875091,EDS 139,A00,897203,Pappas; Elizabeth,44,0,45,1
1746536875091,EDS 139,B00,897209,Fargason; Sharon Gayle,41,0,45,4
1746536876117,EDS 201,A00,895545,Staff,23,0,45,22
1746536877142,EDS 203,A01,895581,Halter; Christopher P.,23,0,45,22
1746536878167,EDS 204R,A01,895625,Heinzman; Erica M.,39,0,45,6
1746536878167,EDS 204R,B01,895693,Halter; Christopher P.,10,0,45,35
1746536879192,EDS 206R,A00,895694,Fargason; Sharon Gayle,1,0,30,29
1746536879192,EDS 206R,B00,895695,Choi; Bailey Miyeon,16,0,30,14
1746536880216,EDS 250,A00,895697,Hemans; Patricia Ann Benitez,23,0,45,22
1746536881241,EDS 281,A00,895701,Meyerott; Theresa Ann,1,0,15,14
1746536882273,EDS 284,A00,895736,Meyerott; Theresa Ann,1,0,15,14
1746536883299,EDS 286,A00,897210,Fine; Sarah,0,0,15,15
1746536884324,EDS 289C,A01,895770,Daly; Alan J.,15,0,15,0
1746536885354,EDS 290,A00,897211,Hofstetter; Carolyn,0,0,15,15
1746536886383,LIGM 5A,A00,896162,Fischer-Grunski; Eva K,13,0,20,7
1746536887412,LIGM 5B,A00,896260,Fischer-Grunski; Eva K,17,0,20,3
1746536888439,LIGM 5C,A00,896308,Fischer-Grunski; Eva K,18,0,20,2
1746536889469,LIIT 5AS,A00,896313,Carnelos; Chiara,18,0,20,2
1746536890494,LIIT 5BS,A00,896416,Carnelos; Chiara,20,0,20,0
1746536891519,LIIT 5CS,A00,896564,Carnelos; Chiara,20,0,20,0
1746536892545,LISP 5A,A00,896588,Munoz Sanchez; Alicia,3,0,20,17
1746536893573,LISP 5B,A00,896653,Munoz Sanchez; Alicia,7,0,20,13
1746536894601,LISP 5C,A00,896655,Munoz Sanchez; Alicia,0,1,20,20
1746536895627,MAE 197,001,957918,Kleissl; Jan,9996,0,9999,3
1746536895627,MAE 197,002,959806,Boechler; Nicholas Sebastia,9998,0,9999,1
1746536895627,MAE 197,003,959852,Mullin; Jennifer S,9999,0,9999,0
1746536896653,MATH 2,A01,957937,Staff,33,0,35,2
1746536897683,MATH 197,001,957876,Kedlaya; Kiran S.,9993,0,9999,6
1746536898710,MCWP 40,A00,892729,Duru; Nur,10,0,20,10
1746536898710,MCWP 40,B00,893304,Montejo; Carolina,14,0,20,6
1746536899740,MCWP 40R,A00,893757,Redela; Pamela Morgan,0,5,20,20
1746536900772,MCWP 50,A00,893758,Morshed; Michael James,0,0,20,20
1746536900772,MCWP 50,B00,893761,Bartulis; Jason Michael,17,0,20,3
1746536901799,MCWP 50R,A00,893766,Compas; Sean Matthew,0,1,20,20
1746536901799,MCWP 50R,B00,893769,Carter; Jennifer A,0,1,20,20
1746536901799,MCWP 50R,C00,893771,Krone; Jarret,0,3,20,20
1746536901799,MCWP 50R,D00,893772,Miller; Elizabeth Deen,0,0,20,20
1746536901799,MCWP 50R,E00,893775,Carter; Andrea L,0,1,20,20
1746536902828,MMW 11R,A01,892721,Herbst; Matthew,11,0,27,16
1746536902828,MMW 11R,A02,892722,Herbst; Matthew,0,0,0,3
1746536903855,MMW 12R,A01,892724,Herbst; Matthew,0,11,16,16
1746536903855,MMW 12R,A02,892725,Herbst; Matthew,0,10,16,16
1746536904881,MMW 13R,A01,892727,Staff,0,4,16,16
1746536904881,MMW 13R,A02,892728,Staff,0,4,16,16
1746536904881,MMW 13R,A03,958032,Staff,0,4,16,16
1746536904881,MMW 13R,A04,958033,Staff,0,4,16,16
1746536904881,MMW 13R,A05,958034,Staff,0,4,16,16
1746536905958,SIO 295LS,A00,894015,Staff,5,0,25,20
1746536906985,SIO 295S,A00,894020,Staff,5,0,25,20
1746536908018,SIOC 290S,B01,958918,Merrifield; Mark A,14,0,30,16
1746536909047,SIOC 291S,B01,958922,Gabriel; Corey John,14,0,30,16
1746536910073,SOCI 117,A01,895339,Staff,3,0,5,2
1746536911103,WES 237B,A00,894149,Staff,11,0,20,9
1746536913174,AESE 279B,A00,891859,Staff,13,0,35,22
1746536914199,AIP 197,001,891854,Vespa; Emanuel Ignacio,9999,0,9999,0
1746536915228,ANTH 289S,A00,891856,Gagneux; Pascal,12,0,12,0
1746536916259,BENG 196,001,957946,Engler; Adam J.,9996,0,9999,3
1746536917284,BISP 197,001,959851,Wilhelm; James E.,9999,0,9999,0
1746536918312,CAT 124RS,A01,956906,Staff,6,0,25,19
1746536919339,CAT 125RS,A01,922013,Staff,6,0,25,19
1746536920370,CLRE 250,A00,891860,Morris; Sheldon,9995,0,9999,4
1746536922429,CLRE 251R,A00,907817,Mehta; Ravindra L.,9994,0,9999,5
1746536923456,CLRE 252,A00,891864,Cuomo; Raphael Eduardo,9993,0,9999,6
1746536924484,CLRE 253,A00,891867,Vaida; Florin,9994,0,9999,5
1746536924484,CLRE 253,B00,907819,Staff,9999,0,9999,0
1746536925509,CLRE 259,A00,891868,Patel; Hemal,9998,0,9999,1
1746536926535,CLRE 260,A00,891872,Cuomo; Raphael Eduardo,9999,0,9999,0
1746536927562,CLRE 297,001,891888,Cuomo; Raphael Eduardo,9999,0,9999,0
1746536928591,CSE 191,A00,958773,Minnes Kemp; Mor Mia,9996,0,9999,3
1746536929620,CSE 197,001,959846,Minnes Kemp; Mor Mia,9993,0,9999,6
1746536930648,CSS 201S,A01,892054,Mignozzetti; Umberto,26,0,30,4
1746536931674,CSS 202S,A01,892056,Mignozzetti; Umberto,26,0,30,4
1746536932701,DSC 197,001,956898,Eldridge; Justin Matthew,9998,0,9999,1
1746536933732,DSC 297,001,958000,Mazumdar; Arya,9998,0,9999,1
1746536933732,DSC 297,002,959862,Wang; Yusu,9999,0,9999,0
1746536934757,EAP 100,A00,905686,Staff,9778,0,9999,221
1746536935790,ECE 45,A01,892618,Staff,0,0,65,65
1746536937842,ECE 111,A01,892719,Staff,4,0,65,61
1746536938871,ECE 197,001,957920,Mercier; Patrick Philip,9991,0,9999,8
1746536939900,ECON 178,A01,907814,Zhu; Ying,26,0,35,9
1746536940927,EDS 115,A00,895312,Staff,36,0,45,9
1746536941951,EDS 117,A01,895337,Staff,24,0,30,6
1746536942981,EDS 125,A00,895341,Jones; Gabrielle Anastasia,37,0,45,8
1746536944014,EDS 128A,A01,895459,Fargason; Sharon Gayle,44,0,45,1
1746536945044,EDS 128B,A01,895543,Pappas; Elizabeth,44,0,45,1
1746536946070,EDS 139,A00,897203,Pappas; Elizabeth,44,0,45,1
1746536946070,EDS 139,B00,897209,Fargason; Sharon Gayle,41,0,45,4
1746536947096,EDS 201,A00,895545,Staff,23,0,45,22
1746536948122,EDS 203,A01,895581,Halter; Christopher P.,23,0,45,22
1746536949153,EDS 204R,A01,895625,Heinzman; Erica M.,39,0,45,6
1746536949153,EDS 204R,B01,895693,Halter; Christopher P.,10,0,45,35
1746536950179,EDS 206R,A00,895694,Fargason; Sharon Gayle,1,0,30,29
1746536950179,EDS 206R,B00,895695,Choi; Bailey Miyeon,16,0,30,14
1746536951203,EDS 250,A00,895697,Hemans; Patricia Ann Benitez,23,0,45,22
1746536952230,EDS 281,A00,895701,Meyerott; Theresa Ann,1,0,15,14
1746536953255,EDS 284,A00,895736,Meyerott; Theresa Ann,1,0,15,14
1746536954283,EDS 286,A00,897210,Fine; Sarah,0,0,15,15
1746536955310,EDS 289C,A01,895770,Daly; Alan J.,15,0,15,0
1746536956335,EDS 290,A00,897211,Hofstetter; Carolyn,0,0,15,15
1746536957368,LIGM 5A,A00,896162,Fischer-Grunski; Eva K,13,0,20,7
1746536958399,LIGM 5B,A00,896260,Fischer-Grunski; Eva K,17,0,20,3
1746536959426,LIGM 5C,A00,896308,Fischer-Grunski; Eva K,18,0,20,2
1746536960454,LIIT 5AS,A00,896313,Carnelos; Chiara,18,0,20,2
1746536961479,LIIT 5BS,A00,896416,Carnelos; Chiara,20,0,20,0
1746536962509,LIIT 5CS,A00,896564,Carnelos; Chiara,20,0,20,0
1746536963536,LISP 5A,A00,896588,Munoz Sanchez; Alicia,3,0,20,17
1746536964565,LISP 5B,A00,896653,Munoz Sanchez; Alicia,7,0,20,13
1746536965596,LISP 5C,A00,896655,Munoz Sanchez; Alicia,0,1,20,20
1746536966624,MAE 197,001,957918,Kleissl; Jan,9996,0,9999,3
1746536966624,MAE 197,002,959806,Boechler; Nicholas Sebastia,9998,0,9999,1
1746536966624,MAE 197,003,959852,Mullin; Jennifer S,9999,0,9999,0
1746536967650,MATH 2,A01,957937,Staff,33,0,35,2
1746536968676,MATH 197,001,957876,Kedlaya; Kiran S.,9993,0,9999,6
1746536969702,MCWP 40,A00,892729,Duru; Nur,10,0,20,10
1746536969702,MCWP 40,B00,893304,Montejo; Carolina,14,0,20,6
1746536970730,MCWP 40R,A00,893757,Redela; Pamela Morgan,0,5,20,20
1746536971757,MCWP 50,A00,893758,Morshed; Michael James,0,0,20,20
1746536971757,MCWP 50,B00,893761,Bartulis; Jason Michael,17,0,20,3
1746536972790,MCWP 50R,A00,893766,Compas; Sean Matthew,0,1,20,20
1746536972790,MCWP 50R,B00,893769,Carter; Jennifer A,0,1,20,20
1746536972790,MCWP 50R,C00,893771,Krone; Jarret,0,3,20,20
1746536972790,MCWP 50R,D00,893772,Miller; Elizabeth Deen,0,0,20,20
1746536972790,MCWP 50R,E00,893775,Carter; Andrea L,0,1,20,20
1746536973818,MMW 11R,A01,892721,Herbst; Matthew,11,0,27,16
1746536973818,MMW 11R,A02,892722,Herbst; Matthew,0,0,0,3
1746536974847,MMW 12R,A01,892724,Herbst; Matthew,0,11,16,16
1746536974847,MMW 12R,A02,892725,Herbst; Matthew,0,10,16,16
1746536975874,MMW 13R,A01,892727,Staff,0,4,16,16
1746536975874,MMW 13R,A02,892728,Staff,0,4,16,16
1746536975874,MMW 13R,A03,958032,Staff,0,4,16,16
1746536975874,MMW 13R,A04,958033,Staff,0,4,16,16
1746536975874,MMW 13R,A05,958034,Staff,0,4,16,16
1746536976903,SIO 295LS,A00,894015,Staff,5,0,25,20
1746536977930,SIO 295S,A00,894020,Staff,5,0,25,20
1746536978958,SIOC 290S,B01,958918,Merrifield; Mark A,14,0,30,16
1746536979984,SIOC 291S,B01,958922,Gabriel; Corey John,14,0,30,16
1746536981010,SOCI 117,A01,895339,Staff,3,0,5,2
1746536982036,WES 237B,A00,894149,Staff,11,0,20,9
1746536984105,AESE 279B,A00,891859,Staff,13,0,35,22
1746536985134,AIP 197,001,891854,Vespa; Emanuel Ignacio,9999,0,9999,0
1746536986161,ANTH 289S,A00,891856,Gagneux; Pascal,12,0,12,0
1746536987194,BENG 196,001,957946,Engler; Adam J.,9996,0,9999,3
1746536988221,BISP 197,001,959851,Wilhelm; James E.,9999,0,9999,0
1746536989251,CAT 124RS,A01,956906,Staff,6,0,25,19
1746536990277,CAT 125RS,A01,922013,Staff,6,0,25,19
1746536991308,CLRE 250,A00,891860,Morris; Sheldon,9995,0,9999,4
1746536993361,CLRE 251R,A00,907817,Mehta; Ravindra L.,9994,0,9999,5
1746536994387,CLRE 252,A00,891864,Cuomo; Raphael Eduardo,9993,0,9999,6
1746536995414,CLRE 253,A00,891867,Vaida; Florin,9994,0,9999,5
1746536995414,CLRE 253,B00,907819,Staff,9999,0,9999,0
1746536996440,CLRE 259,A00,891868,Patel; Hemal,9998,0,9999,1
1746536997469,CLRE 260,A00,891872,Cuomo; Raphael Eduardo,9999,0,9999,0
1746536998495,CLRE 297,001,891888,Cuomo; Raphael Eduardo,9999,0,9999,0
1746536999523,CSE 191,A00,958773,Minnes Kemp; Mor Mia,9996,0,9999,3
1746537000548,CSE 197,001,959846,Minnes Kemp; Mor Mia,9993,0,9999,6
1746537001576,CSS 201S,A01,892054,Mignozzetti; Umberto,26,0,30,4
1746537002607,CSS 202S,A01,892056,Mignozzetti; Umberto,26,0,30,4
1746537003632,DSC 197,001,956898,Eldridge; Justin Matthew,9998,0,9999,1
1746537004665,DSC 297,001,958000,Mazumdar; Arya,9998,0,9999,1
1746537004665,DSC 297,002,959862,Wang; Yusu,9999,0,9999,0
1746537005691,EAP 100,A00,905686,Staff,9778,0,9999,221
1746537006717,ECE 45,A01,892618,Staff,0,0,65,65
1746537008768,ECE 111,A01,892719,Staff,4,0,65,61
1746537009796,ECE 197,001,957920,Mercier; Patrick Philip,9991,0,9999,8
1746537010823,ECON 178,A01,907814,Zhu; Ying,26,0,35,9
1746537011848,EDS 115,A00,895312,Staff,36,0,45,9
1746537012873,EDS 117,A01,895337,Staff,24,0,30,6
1746537013904,EDS 125,A00,895341,Jones; Gabrielle Anastasia,37,0,45,8
1746537014935,EDS 128A,A01,895459,Fargason; Sharon Gayle,44,0,45,1
1746537015961,EDS 128B,A01,895543,Pappas; Elizabeth,44,0,45,1
1746537016989,EDS 139,A00,897203,Pappas; Elizabeth,44,0,45,1
1746537016989,EDS 139,B00,897209,Fargason; Sharon Gayle,41,0,45,4
1746537018017,EDS 201,A00,895545,Staff,23,0,45,22
1746537019049,EDS 203,A01,895581,Halter; Christopher P.,23,0,45,22
1746537020077,EDS 204R,A01,895625,Heinzman; Erica M.,39,0,45,6
1746537020077,EDS 204R,B01,895693,Halter; Christopher P.,10,0,45,35
1746537021105,EDS 206R,A00,895694,Fargason; Sharon Gayle,1,0,30,29
1746537021105,EDS 206R,B00,895695,Choi; Bailey Miyeon,16,0,30,14
1746537022132,EDS 250,A00,895697,Hemans; Patricia Ann Benitez,23,0,45,22
1746537023160,EDS 281,A00,895701,Meyerott; Theresa Ann,1,0,15,14
1746537024187,EDS 284,A00,895736,Meyerott; Theresa Ann,1,0,15,14
1746537025215,EDS 286,A00,897210,Fine; Sarah,0,0,15,15
1746537026246,EDS 289C,A01,895770,Daly; Alan J.,15,0,15,0
1746537027275,EDS 290,A00,897211,Hofstetter; Carolyn,0,0,15,15
1746537028302,LIGM 5A,A00,896162,Fischer-Grunski; Eva K,13,0,20,7
1746537029335,LIGM 5B,A00,896260,Fischer-Grunski; Eva K,17,0,20,3
1746537030362,LIGM 5C,A00,896308,Fischer-Grunski; Eva K,18,0,20,2
1746537031389,LIIT 5AS,A00,896313,Carnelos; Chiara,18,0,20,2
1746537032415,LIIT 5BS,A00,896416,Carnelos; Chiara,20,0,20,0
1746537033447,LIIT 5CS,A00,896564,Carnelos; Chiara,20,0,20,0
1746537034472,LISP 5A,A00,896588,Munoz Sanchez; Alicia,3,0,20,17
1746537035499,LISP 5B,A00,896653,Munoz Sanchez; Alicia,7,0,20,13
1746537036525,LISP 5C,A00,896655,Munoz Sanchez; Alicia,0,1,20,20
1746537037554,MAE 197,001,957918,Kleissl; Jan,9996,0,9999,3
1746537037554,MAE 197,002,959806,Boechler; Nicholas Sebastia,9998,0,9999,1
1746537037554,MAE 197,003,959852,Mullin; Jennifer S,9999,0,9999,0
1746537038581,MATH 2,A01,957937,Staff,33,0,35,2
1746537039610,MATH 197,001,957876,Kedlaya; Kiran S.,9993,0,9999,6
1746537040641,MCWP 40,A00,892729,Duru; Nur,10,0,20,10
1746537040641,MCWP 40,B00,893304,Montejo; Carolina,14,0,20,6
1746537041667,MCWP 40R,A00,893757,Redela; Pamela Morgan,0,5,20,20
1746537042696,MCWP 50,A00,893758,Morshed; Michael James,0,0,20,20
1746537042696,MCWP 50,B00,893761,Bartulis; Jason Michael,17,0,20,3
1746537043728,MCWP 50R,A00,893766,Compas; Sean Matthew,0,1,20,20
1746537043728,MCWP 50R,B00,893769,Carter; Jennifer A,0,1,20,20
1746537043728,MCWP 50R,C00,893771,Krone; Jarret,0,3,20,20
1746537043728,MCWP 50R,D00,893772,Miller; Elizabeth Deen,0,0,20,20
1746537043728,MCWP 50R,E00,893775,Carter; Andrea L,0,1,20,20
1746537044758,MMW 11R,A01,892721,Herbst; Matthew,11,0,27,16
1746537044758,MMW 11R,A02,892722,Herbst; Matthew,0,0,0,3
1746537045786,MMW 12R,A01,892724,Herbst; Matthew,0,11,16,16
1746537045786,MMW 12R,A02,892725,Herbst; Matthew,0,10,16,16
1746537046817,MMW 13R,A01,892727,Staff,0,4,16,16
1746537046817,MMW 13R,A02,892728,Staff,0,4,16,16
1746537046817,MMW 13R,A03,958032,Staff,0,4,16,16
1746537046817,MMW 13R,A04,958033,Staff,0,4,16,16
1746537046817,MMW 13R,A05,958034,Staff,0,4,16,16
1746537047843,SIO 295LS,A00,894015,Staff,5,0,25,20
1746537048870,SIO 295S,A00,894020,Staff,5,0,25,20
1746537049903,SIOC 290S,B01,958918,Merrifield; Mark A,14,0,30,16
1746537050931,SIOC 291S,B01,958922,Gabriel; Corey John,14,0,30,16
1746537051961,SOCI 117,A01,895339,Staff,3,0,5,2
1746537052989,WES 237B,A00,894149,Staff,11,0,20,9
1746537055066,AESE 279B,A00,891859,Staff,13,0,35,22
1746537056092,AIP 197,001,891854,Vespa; Emanuel Ignacio,9999,0,9999,0
1746537057117,ANTH 289S,A00,891856,Gagneux; Pascal,12,0,12,0
1746537058145,BENG 196,001,957946,Engler; Adam J.,9996,0,9999,3
1746537059173,BISP 197,001,959851,Wilhelm; James E.,9999,0,9999,0
1746537060200,CAT 124RS,A01,956906,Staff,6,0,25,19
1746537061228,CAT 125RS,A01,922013,Staff,6,0,25,19
1746537062258,CLRE 250,A00,891860,Morris; Sheldon,9995,0,9999,4
1746537064313,CLRE 251R,A00,907817,Mehta; Ravindra L.,9994,0,9999,5
1746537065339,CLRE 252,A00,891864,Cuomo; Raphael Eduardo,9993,0,9999,6
1746537066366,CLRE 253,A00,891867,Vaida; Florin,9994,0,9999,5
1746537066366,CLRE 253,B00,907819,Staff,9999,0,9999,0
1746537067392,CLRE 259,A00,891868,Patel; Hemal,9998,0,9999,1
1746537068419,CLRE 260,A00,891872,Cuomo; Raphael Eduardo,9999,0,9999,0
1746537069446,CLRE 297,001,891888,Cuomo; Raphael Eduardo,9999,0,9999,0
1746537070475,CSE 191,A00,958773,Minnes Kemp; Mor Mia,9996,0,9999,3
1746537071504,CSE 197,001,959846,Minnes Kemp; Mor Mia,9993,0,9999,6
1746537072535,CSS 201S,A01,892054,Mignozzetti; Umberto,26,0,30,4
1746537073567,CSS 202S,A01,892056,Mignozzetti; Umberto,26,0,30,4
1746537074594,DSC 197,001,956898,Eldridge; Justin Matthew,9998,0,9999,1
1746537075622,DSC 297,001,958000,Mazumdar; Arya,9998,0,9999,1
1746537075622,DSC 297,002,959862,Wang; Yusu,9999,0,9999,0
1746537076647,EAP 100,A00,905686,Staff,9778,0,9999,221
1746537077679,ECE 45,A01,892618,Staff,0,0,65,65
1746537079730,ECE 111,A01,892719,Staff,4,0,65,61
1746537080758,ECE 197,001,957920,Mercier; Patrick Philip,9991,0,9999,8
1746537081785,ECON 178,A01,907814,Zhu; Ying,26,0,35,9
1746537082813,EDS 115,A00,895312,Staff,36,0,45,9
1746537083840,EDS 117,A01,895337,Staff,24,0,30,6
1746537084866,EDS 125,A00,895341,Jones; Gabrielle Anastasia,37,0,45,8
1746537085896,EDS 128A,A01,895459,Fargason; Sharon Gayle,44,0,45,1
1746537086922,EDS 128B,A01,895543,Pappas; Elizabeth,44,0,45,1
1746537087946,EDS 139,A00,897203,Pappas; Elizabeth,44,0,45,1
1746537087946,EDS 139,B00,897209,Fargason; Sharon Gayle,41,0,45,4
1746537088971,EDS 201,A00,895545,Staff,23,0,45,22
1746537090004,EDS 203,A01,895581,Halter; Christopher P.,23,0,45,22
1746537091034,EDS 204R,A01,895625,Heinzman; Erica M.,39,0,45,6
1746537091034,EDS 204R,B01,895693,Halter; Christopher P.,10,0,45,35
1746537092061,EDS 206R,A00,895694,Fargason; Sharon Gayle,1,0,30,29
1746537092061,EDS 206R,B00,895695,Choi; Bailey Miyeon,16,0,30,14
1746537093088,EDS 250,A00,895697,Hemans; Patricia Ann Benitez,23,0,45,22
1746537094118,EDS 281,A00,895701,Meyerott; Theresa Ann,1,0,15,14
1746537095142,EDS 284,A00,895736,Meyerott; Theresa Ann,1,0,15,14
1746537096169,EDS 286,A00,897210,Fine; Sarah,0,0,15,15
1746537097194,EDS 289C,A01,895770,Daly; Alan J.,15,0,15,0
1746537098220,EDS 290,A00,897211,Hofstetter; Carolyn,0,0,15,15
1746537099247,LIGM 5A,A00,896162,Fischer-Grunski; Eva K,13,0,20,7
1746537100277,LIGM 5B,A00,896260,Fischer-Grunski; Eva K,17,0,20,3
1746537101303,LIGM 5C,A00,896308,Fischer-Grunski; Eva K,18,0,20,2
1746537102334,LIIT 5AS,A00,896313,Carnelos; Chiara,18,0,20,2
1746537103366,LIIT 5BS,A00,896416,Carnelos; Chiara,20,0,20,0
1746537104396,LIIT 5CS,A00,896564,Carnelos; Chiara,20,0,20,0
1746537105426,LISP 5A,A00,896588,Munoz Sanchez; Alicia,3,0,20,17
1746537106455,LISP 5B,A00,896653,Munoz Sanchez; Alicia,7,0,20,13
1746537107485,LISP 5C,A00,896655,Munoz Sanchez; Alicia,0,1,20,20
1746537108516,MAE 197,001,957918,Kleissl; Jan,9996,0,9999,3
1746537108516,MAE 197,002,959806,Boechler; Nicholas Sebastia,9998,0,9999,1
1746537108516,MAE 197,003,959852,Mullin; Jennifer S,9999,0,9999,0
1746537109546,MATH 2,A01,957937,Staff,33,0,35,2
1746537110575,MATH 197,001,957876,Kedlaya; Kiran S.,9993,0,9999,6
1746537111603,MCWP 40,A00,892729,Duru; Nur,10,0,20,10
1746537111603,MCWP 40,B00,893304,Montejo; Carolina,14,0,20,6
1746537112633,MCWP 40R,A00,893757,Redela; Pamela Morgan,0,5,20,20
1746537113661,MCWP 50,A00,893758,Morshed; Michael James,0,0,20,20
1746537113661,MCWP 50,B00,893761,Bartulis; Jason Michael,17,0,20,3
1746537114687,MCWP 50R,A00,893766,Compas; Sean Matthew,0,1,20,20
1746537114687,MCWP 50R,B00,893769,Carter; Jennifer A,0,1,20,20
1746537114687,MCWP 50R,C00,893771,Krone; Jarret,0,3,20,20
1746537114687,MCWP 50R,D00,893772,Miller; Elizabeth Deen,0,0,20,20
1746537114687,MCWP 50R,E00,893775,Carter; Andrea L,0,1,20,20
1746537115714,MMW 11R,A01,892721,Herbst; Matthew,11,0,27,16
1746537115714,MMW 11R,A02,892722,Herbst; Matthew,0,0,0,3
1746537116739,MMW 12R,A01,892724,Herbst; Matthew,0,11,16,16
1746537116739,MMW 12R,A02,892725,Herbst; Matthew,0,10,16,16
1746537117770,MMW 13R,A01,892727,Staff,0,4,16,16
1746537117770,MMW 13R,A02,892728,Staff,0,4,16,16
1746537117770,MMW 13R,A03,958032,Staff,0,4,16,16
1746537117770,MMW 13R,A04,958033,Staff,0,4,16,16
1746537117770,MMW 13R,A05,958034,Staff,0,4,16,16
1746537118801,SIO 295LS,A00,894015,Staff,5,0,25,20
1746537119827,SIO 295S,A00,894020,Staff,5,0,25,20
1746537120860,SIOC 290S,B01,958918,Merrifield; Mark A,14,0,30,16
1746537121888,SIOC 291S,B01,958922,Gabriel; Corey John,14,0,30,16
1746537122914,SOCI 117,A01,895339,Staff,3,0,5,2
1746537123939,WES 237B,A00,894149,Staff,11,0,20,9
1746537126012,AESE 279B,A00,891859,Staff,13,0,35,22
1746537127039,AIP 197,001,891854,Vespa; Emanuel Ignacio,9999,0,9999,0
1746537128124,ANTH 289S,A00,891856,Gagneux; Pascal,12,0,12,0
1746537129152,BENG 196,001,957946,Engler; Adam J.,9996,0,9999,3
1746537130181,BISP 197,001,959851,Wilhelm; James E.,9999,0,9999,0
1746537131205,CAT 124RS,A01,956906,Staff,6,0,25,19
1746537132231,CAT 125RS,A01,922013,Staff,6,0,25,19
1746537133255,CLRE 250,A00,891860,Morris; Sheldon,9995,0,9999,4
1746537135313,CLRE 251R,A00,907817,Mehta; Ravindra L.,9994,0,9999,5
1746537136341,CLRE 252,A00,891864,Cuomo; Raphael Eduardo,9993,0,9999,6
1746537137368,CLRE 253,A00,891867,Vaida; Florin,9994,0,9999,5
1746537137368,CLRE 253,B00,907819,Staff,9999,0,9999,0
1746537138395,CLRE 259,A00,891868,Patel; Hemal,9998,0,9999,1
1746537139426,CLRE 260,A00,891872,Cuomo; Raphael Eduardo,9999,0,9999,0
1746537140453,CLRE 297,001,891888,Cuomo; Raphael Eduardo,9999,0,9999,0
1746537141478,CSE 191,A00,958773,Minnes Kemp; Mor Mia,9996,0,9999,3
1746537142508,CSE 197,001,959846,Minnes Kemp; Mor Mia,9993,0,9999,6
1746537143533,CSS 201S,A01,892054,Mignozzetti; Umberto,26,0,30,4
1746537144560,CSS 202S,A01,892056,Mignozzetti; Umberto,26,0,30,4
1746537145586,DSC 197,001,956898,Eldridge; Justin Matthew,9998,0,9999,1
1746537146612,DSC 297,001,958000,Mazumdar; Arya,9998,0,9999,1
1746537146612,DSC 297,002,959862,Wang; Yusu,9999,0,9999,0
1746537147636,EAP 100,A00,905686,Staff,9778,0,9999,221
1746537148664,ECE 45,A01,892618,Staff,0,0,65,65
1746537150721,ECE 111,A01,892719,Staff,4,0,65,61
1746537151746,ECE 197,001,957920,Mercier; Patrick Philip,9991,0,9999,8
1746537152773,ECON 178,A01,907814,Zhu; Ying,26,0,35,9
1746537153799,EDS 115,A00,895312,Staff,36,0,45,9
1746537154825,EDS 117,A01,895337,Staff,24,0,30,6
1746537155851,EDS 125,A00,895341,Jones; Gabrielle Anastasia,37,0,45,8
1746537156877,EDS 128A,A01,895459,Fargason; Sharon Gayle,44,0,45,1
1746537157905,EDS 128B,A01,895543,Pappas; Elizabeth,44,0,45,1
1746537158931,EDS 139,A00,897203,Pappas; Elizabeth,44,0,45,1
1746537158931,EDS 139,B00,897209,Fargason; Sharon Gayle,41,0,45,4
1746537159957,EDS 201,A00,895545,Staff,23,0,45,22
1746537160984,EDS 203,A01,895581,Halter; Christopher P.,23,0,45,22
1746537162016,EDS 204R,A01,895625,Heinzman; Erica M.,39,0,45,6
1746537162016,EDS 204R,B01,895693,Halter; Christopher P.,10,0,45,35
1746537163044,EDS 206R,A00,895694,Fargason; Sharon Gayle,1,0,30,29
1746537163044,EDS 206R,B00,895695,Choi; Bailey Miyeon,16,0,30,14
1746537164068,EDS 250,A00,895697,Hemans; Patricia Ann Benitez,23,0,45,22
1746537165099,EDS 281,A00,895701,Meyerott; Theresa Ann,1,0,15,14
1746537166123,EDS 284,A00,895736,Meyerott; Theresa Ann,1,0,15,14
1746537167148,EDS 286,A00,897210,Fine; Sarah,0,0,15,15
1746537168176,EDS 289C,A01,895770,Daly; Alan J.,15,0,15,0
1746537169202,EDS 290,A00,897211,Hofstetter; Carolyn,0,0,15,15
1746537170228,LIGM 5A,A00,896162,Fischer-Grunski; Eva K,13,0,20,7
1746537171255,LIGM 5B,A00,896260,Fischer-Grunski; Eva K,17,0,20,3
1746537172279,LIGM 5C,A00,896308,Fischer-Grunski; Eva K,18,0,20,2
1746537173306,LIIT 5AS,A00,896313,Carnelos; Chiara,18,0,20,2
1746537174337,LIIT 5BS,A00,896416,Carnelos; Chiara,20,0,20,0
1746537175364,LIIT 5CS,A00,896564,Carnelos; Chiara,20,0,20,0
1746537176392,LISP 5A,A00,896588,Munoz Sanchez; Alicia,3,0,20,17
1746537177418,LISP 5B,A00,896653,Munoz Sanchez; Alicia,7,0,20,13
1746537178446,LISP 5C,A00,896655,Munoz Sanchez; Alicia,0,1,20,20
1746537179478,MAE 197,001,957918,Kleissl; Jan,9996,0,9999,3
1746537179478,MAE 197,002,959806,Boechler; Nicholas Sebastia,9998,0,9999,1
1746537179478,MAE 197,003,959852,Mullin; Jennifer S,9999,0,9999,0
1746537180508,MATH 2,A01,957937,Staff,33,0,35,2
1746537181533,MATH 197,001,957876,Kedlaya; Kiran S.,9993,0,9999,6
1746537182561,MCWP 40,A00,892729,Duru; Nur,10,0,20,10
1746537182561,MCWP 40,B00,893304,Montejo; Carolina,14,0,20,6
1746537183588,MCWP 40R,A00,893757,Redela; Pamela Morgan,0,5,20,20
1746537184620,MCWP 50,A00,893758,Morshed; Michael James,0,0,20,20
1746537184620,MCWP 50,B00,893761,Bartulis; Jason Michael,17,0,20,3
1746537185652,MCWP 50R,A00,893766,Compas; Sean Matthew,0,1,20,20
1746537185652,MCWP 50R,B00,893769,Carter; Jennifer A,0,1,20,20
1746537185652,MCWP 50R,C00,893771,Krone; Jarret,0,3,20,20
1746537185652,MCWP 50R,D00,893772,Miller; Elizabeth Deen,0,0,20,20
1746537185652,MCWP 50R,E00,893775,Carter; Andrea L,0,1,20,20
1746537186679,MMW 11R,A01,892721,Herbst; Matthew,11,0,27,16
1746537186679,MMW 11R,A02,892722,Herbst; Matthew,0,0,0,3
1746537187708,MMW 12R,A01,892724,Herbst; Matthew,0,11,16,16
1746537187708,MMW 12R,A02,892725,Herbst; Matthew,0,10,16,16
1746537188734,MMW 13R,A01,892727,Staff,0,4,16,16
1746537188734,MMW 13R,A02,892728,Staff,0,4,16,16
1746537188734,MMW 13R,A03,958032,Staff,0,4,16,16
1746537188734,MMW 13R,A04,958033,Staff,0,4,16,16
1746537188734,MMW 13R,A05,958034,Staff,0,4,16,16
1746537189767,SIO 295LS,A00,894015,Staff,5,0,25,20
1746537190795,SIO 295S,A00,894020,Staff,5,0,25,20
1746537191821,SIOC 290S,B01,958918,Merrifield; Mark A,14,0,30,16
1746537192852,SIOC 291S,B01,958922,Gabriel; Corey John,14,0,30,16
1746537193884,SOCI 117,A01,895339,Staff,3,0,5,2
1746537194913,WES 237B,A00,894149,Staff,11,0,20,9
1746537196994,AESE 279B,A00,891859,Staff,13,0,35,22
1746537198021,AIP 197,001,891854,Vespa; Emanuel Ignacio,9999,0,9999,0
1746537199049,ANTH 289S,A00,891856,Gagneux; Pascal,12,0,12,0
1746537200075,BENG 196,001,957946,Engler; Adam J.,9996,0,9999,3
1746537201102,BISP 197,001,959851,Wilhelm; James E.,9999,0,9999,0
1746537202127,CAT 124RS,A01,956906,Staff,6,0,25,19
1746537203154,CAT 125RS,A01,922013,Staff,6,0,25,19
1746537204181,CLRE 250,A00,891860,Morris; Sheldon,9995,0,9999,4
1746537206237,CLRE 251R,A00,907817,Mehta; Ravindra L.,9994,0,9999,5
1746537207263,CLRE 252,A00,891864,Cuomo; Raphael Eduardo,9993,0,9999,6
1746537208289,CLRE 253,A00,891867,Vaida; Florin,9994,0,9999,5
1746537208289,CLRE 253,B00,907819,Staff,9999,0,9999,0
1746537209316,CLRE 259,A00,891868,Patel; Hemal,9998,0,9999,1
1746537210345,CLRE 260,A00,891872,Cuomo; Raphael Eduardo,9999,0,9999,0
1746537211375,CLRE 297,001,891888,Cuomo; Raphael Eduardo,9999,0,9999,0
1746537212406,CSE 191,A00,958773,Minnes Kemp; Mor Mia,9996,0,9999,3
1746537213431,CSE 197,001,959846,Minnes Kemp; Mor Mia,9993,0,9999,6
1746537214460,CSS 201S,A01,892054,Mignozzetti; Umberto,26,0,30,4
1746537215487,CSS 202S,A01,892056,Mignozzetti; Umberto,26,0,30,4
1746537216514,DSC 197,001,956898,Eldridge; Justin Matthew,9998,0,9999,1
1746537217545,DSC 297,001,958000,Mazumdar; Arya,9998,0,9999,1
1746537217545,DSC 297,002,959862,Wang; Yusu,9999,0,9999,0
1746537218570,EAP 100,A00,905686,Staff,9778,0,9999,221
1746537219599,ECE 45,A01,892618,Staff,0,0,65,65
1746537221652,ECE 111,A01,892719,Staff,4,0,65,61
1746537222677,ECE 197,001,957920,Mercier; Patrick Philip,9991,0,9999,8
1746537223707,ECON 178,A01,907814,Zhu; Ying,26,0,35,9
1746537224733,EDS 115,A00,895312,Staff,36,0,45,9
1746537225763,EDS 117,A01,895337,Staff,24,0,30,6
1746537226792,EDS 125,A00,895341,Jones; Gabrielle Anastasia,37,0,45,8
1746537227822,EDS 128A,A01,895459,Fargason; Sharon Gayle,44,0,45,1
1746537228848,EDS 128B,A01,895543,Pappas; Elizabeth,44,0,45,1
1746537229874,EDS 139,A00,897203,Pappas; Elizabeth,44,0,45,1
1746537229874,EDS 139,B00,897209,Fargason; Sharon Gayle,41,0,45,4
1746537230905,EDS 201,A00,895545,Staff,23,0,45,22
1746537231974,EDS 203,A01,895581,Halter; Christopher P.,23,0,45,22
1746537233004,EDS 204R,A01,895625,Heinzman; Erica M.,39,0,45,6
1746537233004,EDS 204R,B01,895693,Halter; Christopher P.,10,0,45,35
1746537234034,EDS 206R,A00,895694,Fargason; Sharon Gayle,1,0,30,29
1746537234034,EDS 206R,B00,895695,Choi; Bailey Miyeon,16,0,30,14
1746537235062,EDS 250,A00,895697,Hemans; Patricia Ann Benitez,23,0,45,22
1746537236090,EDS 281,A00,895701,Meyerott; Theresa Ann,1,0,15,14
1746537237115,EDS 284,A00,895736,Meyerott; Theresa Ann,1,0,15,14
1746537238143,EDS 286,A00,897210,Fine; Sarah,0,0,15,15
1746537239174,EDS 289C,A01,895770,Daly; Alan J.,15,0,15,0
1746537240208,EDS 290,A00,897211,Hofstetter; Carolyn,0,0,15,15
1746537241238,LIGM 5A,A00,896162,Fischer-Grunski; Eva K,13,0,20,7
1746537242265,LIGM 5B,A00,896260,Fischer-Grunski; Eva K,17,0,20,3
1746537243294,LIGM 5C,A00,896308,Fischer-Grunski; Eva K,18,0,20,2
1746537244321,LIIT 5AS,A00,896313,Carnelos; Chiara,18,0,20,2
1746537245351,LIIT 5BS,A00,896416,Carnelos; Chiara,20,0,20,0
1746537246379,LIIT 5CS,A00,896564,Carnelos; Chiara,20,0,20,0
1746537247405,LISP 5A,A00,896588,Munoz Sanchez; Alicia,3,0,20,17
1746537248434,LISP 5B,A00,896653,Munoz Sanchez; Alicia,7,0,20,13
1746537249463,LISP 5C,A00,896655,Munoz Sanchez; Alicia,0,1,20,20
1746537250492,MAE 197,001,957918,Kleissl; Jan,9996,0,9999,3
1746537250492,MAE 197,002,959806,Boechler; Nicholas Sebastia,9998,0,9999,1
1746537250492,MAE 197,003,959852,Mullin; Jennifer S,9999,0,9999,0
1746537251519,MATH 2,A01,957937,Staff,33,0,35,2
1746537252543,MATH 197,001,957876,Kedlaya; Kiran S.,9993,0,9999,6
1746537253576,MCWP 40,A00,892729,Duru; Nur,10,0,20,10
1746537253576,MCWP 40,B00,893304,Montejo; Carolina,14,0,20,6
1746537254601,MCWP 40R,A00,893757,Redela; Pamela Morgan,0,5,20,20
1746537255629,MCWP 50,A00,893758,Morshed; Michael James,0,0,20,20
1746537255629,MCWP 50,B00,893761,Bartulis; Jason Michael,17,0,20,3
1746537256662,MCWP 50R,A00,893766,Compas; Sean Matthew,0,1,20,20
1746537256662,MCWP 50R,B00,893769,Carter; Jennifer A,0,1,20,20
1746537256662,MCWP 50R,C00,893771,Krone; Jarret,0,3,20,20
1746537256662,MCWP 50R,D00,893772,Miller; Elizabeth Deen,0,0,20,20
1746537256662,MCWP 50R,E00,893775,Carter; Andrea L,0,1,20,20
1746537257693,MMW 11R,A01,892721,Herbst; Matthew,11,0,27,16
1746537257693,MMW 11R,A02,892722,Herbst; Matthew,0,0,0,3
1746537258719,MMW 12R,A01,892724,Herbst; Matthew,0,11,16,16
1746537258719,MMW 12R,A02,892725,Herbst; Matthew,0,10,16,16
1746537259747,MMW 13R,A01,892727,Staff,0,4,16,16
1746537259747,MMW 13R,A02,892728,Staff,0,4,16,16
1746537259747,MMW 13R,A03,958032,Staff,0,4,16,16
1746537259747,MMW 13R,A04,958033,Staff,0,4,16,16
1746537259747,MMW 13R,A05,958034,Staff,0,4,16,16
1746537260772,SIO 295LS,A00,894015,Staff,5,0,25,20
1746537261798,SIO 295S,A00,894020,Staff,5,0,25,20
1746537262824,SIOC 290S,B01,958918,Merrifield; Mark A,14,0,30,16
1746537263855,SIOC 291S,B01,958922,Gabriel; Corey John,14,0,30,16
1746537264880,SOCI 117,A01,895339,Staff,3,0,5,2
1746537265906,WES 237B,A00,894149,Staff,11,0,20,9
1746537267980,AESE 279B,A00,891859,Staff,13,0,35,22
1746537269008,AIP 197,001,891854,Vespa; Emanuel Ignacio,9999,0,9999,0
1746537270038,ANTH 289S,A00,891856,Gagneux; Pascal,12,0,12,0
1746537271070,BENG 196,001,957946,Engler; Adam J.,9996,0,9999,3
1746537272094,BISP 197,001,959851,Wilhelm; James E.,9999,0,9999,0
1746537273120,CAT 124RS,A01,956906,Staff,6,0,25,19
1746537274146,CAT 125RS,A01,922013,Staff,6,0,25,19
1746537275170,CLRE 250,A00,891860,Morris; Sheldon,9995,0,9999,4
1746537277227,CLRE 251R,A00,907817,Mehta; Ravindra L.,9994,0,9999,5
1746537278251,CLRE 252,A00,891864,Cuomo; Raphael Eduardo,9993,0,9999,6
1746537279279,CLRE 253,A00,891867,Vaida; Florin,9994,0,9999,5
1746537279279,CLRE 253,B00,907819,Staff,9999,0,9999,0
1746537280306,CLRE 259,A00,891868,Patel; Hemal,9998,0,9999,1
1746537281334,CLRE 260,A00,891872,Cuomo; Raphael Eduardo,9999,0,9999,0
1746537282362,CLRE 297,001,891888,Cuomo; Raphael Eduardo,9999,0,9999,0
1746537283388,CSE 191,A00,958773,Minnes Kemp; Mor Mia,9996,0,9999,3
1746537284415,CSE 197,001,959846,Minnes Kemp; Mor Mia,9993,0,9999,6
1746537285446,CSS 201S,A01,892054,Mignozzetti; Umberto,26,0,30,4
1746537286477,CSS 202S,A01,892056,Mignozzetti; Umberto,26,0,30,4
1746537287504,DSC 197,001,956898,Eldridge; Justin Matthew,9998,0,9999,1
1746537288532,DSC 297,001,958000,Mazumdar; Arya,9998,0,9999,1
1746537288532,DSC 297,002,959862,Wang; Yusu,9999,0,9999,0
1746537289559,EAP 100,A00,905686,Staff,9778,0,9999,221
1746537290592,ECE 45,A01,892618,Staff,0,0,65,65
1746537292648,ECE 111,A01,892719,Staff,4,0,65,61
1746537293676,ECE 197,001,957920,Mercier; Patrick Philip,9991,0,9999,8
1746537294706,ECON 178,A01,907814,Zhu; Ying,26,0,35,9
1746537295732,EDS 115,A00,895312,Staff,36,0,45,9
1746537296761,EDS 117,A01,895337,Staff,24,0,30,6
1746537297787,EDS 125,A00,895341,Jones; Gabrielle Anastasia,37,0,45,8
1746537298813,EDS 128A,A01,895459,Fargason; Sharon Gayle,44,0,45,1
1746537299840,EDS 128B,A01,895543,Pappas; Elizabeth,44,0,45,1
1746537300867,EDS 139,A00,897203,Pappas; Elizabeth,44,0,45,1
1746537300867,EDS 139,B00,897209,Fargason; Sharon Gayle,41,0,45,4
1746537301894,EDS 201,A00,895545,Staff,23,0,45,22
1746537302919,EDS 203,A01,895581,Halter; Christopher P.,23,0,45,22
1746537303951,EDS 204R,A01,895625,Heinzman; Erica M.,39,0,45,6
1746537303951,EDS 204R,B01,895693,Halter; Christopher P.,10,0,45,35
1746537304978,EDS 206R,A00,895694,Fargason; Sharon Gayle,1,0,30,29
1746537304978,EDS 206R,B00,895695,Choi; Bailey Miyeon,16,0,30,14
1746537306020,EDS 250,A00,895697,Hemans; Patricia Ann Benitez,23,0,45,22
1746537307048,EDS 281,A00,895701,Meyerott; Theresa Ann,1,0,15,14
1746537308087,EDS 284,A00,895736,Meyerott; Theresa Ann,1,0,15,14
1746537309116,EDS 286,A00,897210,Fine; Sarah,0,0,15,15
1746537310142,EDS 289C,A01,895770,Daly; Alan J.,15,0,15,0
1746537311171,EDS 290,A00,897211,Hofstetter; Carolyn,0,0,15,15
1746537312198,LIGM 5A,A00,896162,Fischer-Grunski; Eva K,13,0,20,7
1746537313229,LIGM 5B,A00,896260,Fischer-Grunski; Eva K,17,0,20,3
1746537314257,LIGM 5C,A00,896308,Fischer-Grunski; Eva K,18,0,20,2
1746537315289,LIIT 5AS,A00,896313,Carnelos; Chiara,18,0,20,2
1746537316314,LIIT 5BS,A00,896416,Carnelos; Chiara,20,0,20,0
1746537317341,LIIT 5CS,A00,896564,Carnelos; Chiara,20,0,20,0
1746537318373,LISP 5A,A00,896588,Munoz Sanchez; Alicia,3,0,20,17
1746537319403,LISP 5B,A00,896653,Munoz Sanchez; Alicia,7,0,20,13
1746537320431,LISP 5C,A00,896655,Munoz Sanchez; Alicia,0,1,20,20
1746537321460,MAE 197,001,957918,Kleissl; Jan,9996,0,9999,3
1746537321460,MAE 197,002,959806,Boechler; Nicholas Sebastia,9998,0,9999,1
1746537321460,MAE 197,003,959852,Mullin; Jennifer S,9999,0,9999,0
1746537322486,MATH 2,A01,957937,Staff,33,0,35,2
1746537323515,MATH 197,001,957876,Kedlaya; Kiran S.,9993,0,9999,6
1746537324541,MCWP 40,A00,892729,Duru; Nur,10,0,20,10
1746537324541,MCWP 40,B00,893304,Montejo; Carolina,14,0,20,6
1746537325568,MCWP 40R,A00,893757,Redela; Pamela Morgan,0,5,20,20
1746537326596,MCWP 50,A00,893758,Morshed; Michael James,0,0,20,20
1746537326596,MCWP 50,B00,893761,Bartulis; Jason Michael,17,0,20,3
1746537327623,MCWP 50R,A00,893766,Compas; Sean Matthew,0,1,20,20
1746537327623,MCWP 50R,B00,893769,Carter; Jennifer A,0,1,20,20
1746537327623,MCWP 50R,C00,893771,Krone; Jarret,0,3,20,20
1746537327623,MCWP 50R,D00,893772,Miller; Elizabeth Deen,0,0,20,20
1746537327623,MCWP 50R,E00,893775,Carter; Andrea L,0,1,20,20
1746537328651,MMW 11R,A01,892721,Herbst; Matthew,11,0,27,16
1746537328651,MMW 11R,A02,892722,Herbst; Matthew,0,0,0,3
1746537329678,MMW 12R,A01,892724,Herbst; Matthew,0,11,16,16
1746537329678,MMW 12R,A02,892725,Herbst; Matthew,0,10,16,16
1746537330709,MMW 13R,A01,892727,Staff,0,4,16,16
1746537330709,MMW 13R,A02,892728,Staff,0,4,16,16
1746537330709,MMW 13R,A03,958032,Staff,0,4,16,16
1746537330709,MMW 13R,A04,958033,Staff,0,4,16,16
1746537330709,MMW 13R,A05,958034,Staff,0,4,16,16
1746537331736,SIO 295LS,A00,894015,Staff,5,0,25,20
1746537332761,SIO 295S,A00,894020,Staff,5,0,25,20
1746537333789,SIOC 290S,B01,958918,Merrifield; Mark A,14,0,30,16
1746537334816,SIOC 291S,B01,958922,Gabriel; Corey John,14,0,30,16
1746537335884,SOCI 117,A01,895339,Staff,3,0,5,2
1746537336912,WES 237B,A00,894149,Staff,11,0,20,9
1746537338998,AESE 279B,A00,891859,Staff,13,0,35,22
1746537340025,AIP 197,001,891854,Vespa; Emanuel Ignacio,9999,0,9999,0
1746537341054,ANTH 289S,A00,891856,Gagneux; Pascal,12,0,12,0
1746537342080,BENG 196,001,957946,Engler; Adam J.,9996,0,9999,3
1746537343107,BISP 197,001,959851,Wilhelm; James E.,9999,0,9999,0
1746537344137,CAT 124RS,A01,956906,Staff,6,0,25,19
1746537345169,CAT 125RS,A01,922013,Staff,6,0,25,19
1746537346196,CLRE 250,A00,891860,Morris; Sheldon,9995,0,9999,4
1746537348254,CLRE 251R,A00,907817,Mehta; Ravindra L.,9994,0,9999,5
1746537349280,CLRE 252,A00,891864,Cuomo; Raphael Eduardo,9993,0,9999,6
1746537350307,CLRE 253,A00,891867,Vaida; Florin,9994,0,9999,5
1746537350307,CLRE 253,B00,907819,Staff,9999,0,9999,0
1746537351336,CLRE 259,A00,891868,Patel; Hemal,9998,0,9999,1
1746537352361,CLRE 260,A00,891872,Cuomo; Raphael Eduardo,9999,0,9999,0
1746537353388,CLRE 297,001,891888,Cuomo; Raphael Eduardo,9999,0,9999,0
1746537354416,CSE 191,A00,958773,Minnes Kemp; Mor Mia,9996,0,9999,3
1746537355442,CSE 197,001,959846,Minnes Kemp; Mor Mia,9993,0,9999,6
1746537356469,CSS 201S,A01,892054,Mignozzetti; Umberto,26,0,30,4
1746537357496,CSS 202S,A01,892056,Mignozzetti; Umberto,26,0,30,4
1746537358524,DSC 197,001,956898,Eldridge; Justin Matthew,9998,0,9999,1
1746537359551,DSC 297,001,958000,Mazumdar; Arya,9998,0,9999,1
1746537359551,DSC 297,002,959862,Wang; Yusu,9999,0,9999,0
1746537360581,EAP 100,A00,905686,Staff,9778,0,9999,221
1746537361608,ECE 45,A01,892618,Staff,0,0,65,65
1746537363663,ECE 111,A01,892719,Staff,4,0,65,61
1746537364692,ECE 197,001,957920,Mercier; Patrick Philip,9991,0,9999,8
1746537365722,ECON 178,A01,907814,Zhu; Ying,26,0,35,9
1746537366748,EDS 115,A00,895312,Staff,36,0,45,9
1746537367775,EDS 117,A01,895337,Staff,24,0,30,6
1746537368803,EDS 125,A00,895341,Jones; Gabrielle Anastasia,37,0,45,8
1746537369831,EDS 128A,A01,895459,Fargason; Sharon Gayle,44,0,45,1
1746537370857,EDS 128B,A01,895543,Pappas; Elizabeth,44,0,45,1
1746537371883,EDS 139,A00,897203,Pappas; Elizabeth,44,0,45,1
1746537371883,EDS 139,B00,897209,Fargason; Sharon Gayle,41,0,45,4
1746537372910,EDS 201,A00,895545,Staff,23,0,45,22
1746537373939,EDS 203,A01,895581,Halter; Christopher P.,23,0,45,22
1746537374967,EDS 204R,A01,895625,Heinzman; Erica M.,39,0,45,6
1746537374967,EDS 204R,B01,895693,Halter; Christopher P.,10,0,45,35
1746537375993,EDS 206R,A00,895694,Fargason; Sharon Gayle,1,0,30,29
1746537375993,EDS 206R,B00,895695,Choi; Bailey Miyeon,16,0,30,14
1746537377019,EDS 250,A00,895697,Hemans; Patricia Ann Benitez,23,0,45,22
1746537378049,EDS 281,A00,895701,Meyerott; Theresa Ann,1,0,15,14
1746537379076,EDS 284,A00,895736,Meyerott; Theresa Ann,1,0,15,14
1746537380105,EDS 286,A00,897210,Fine; Sarah,0,0,15,15
1746537381135,EDS 289C,A01,895770,Daly; Alan J.,15,0,15,0
1746537382165,EDS 290,A00,897211,Hofstetter; Carolyn,0,0,15,15
1746537383196,LIGM 5A,A00,896162,Fischer-Grunski; Eva K,13,0,20,7
1746537384224,LIGM 5B,A00,896260,Fischer-Grunski; Eva K,17,0,20,3
1746537385251,LIGM 5C,A00,896308,Fischer-Grunski; Eva K,18,0,20,2
1746537386282,LIIT 5AS,A00,896313,Carnelos; Chiara,18,0,20,2
1746537387312,LIIT 5BS,A00,896416,Carnelos; Chiara,20,0,20,0
1746537388337,LIIT 5CS,A00,896564,Carnelos; Chiara,20,0,20,0
1746537389370,LISP 5A,A00,896588,Munoz Sanchez; Alicia,3,0,20,17
1746537390395,LISP 5B,A00,896653,Munoz Sanchez; Alicia,7,0,20,13
1746537391631,LISP 5C,A00,896655,Munoz Sanchez; Alicia,0,1,20,20
1746537392660,MAE 197,001,957918,Kleissl; Jan,9996,0,9999,3
1746537392660,MAE 197,002,959806,Boechler; Nicholas Sebastia,9998,0,9999,1
1746537392660,MAE 197,003,959852,Mullin; Jennifer S,9999,0,9999,0
1746537393686,MATH 2,A01,957937,Staff,33,0,35,2
1746537394712,MATH 197,001,957876,Kedlaya; Kiran S.,9993,0,9999,6
1746537395740,MCWP 40,A00,892729,Duru; Nur,10,0,20,10
1746537395740,MCWP 40,B00,893304,Montejo; Carolina,14,0,20,6
1746537396767,MCWP 40R,A00,893757,Redela; Pamela Morgan,0,5,20,20
1746537397794,MCWP 50,A00,893758,Morshed; Michael James,0,0,20,20
1746537397794,MCWP 50,B00,893761,Bartulis; Jason Michael,17,0,20,3
1746537398821,MCWP 50R,A00,893766,Compas; Sean Matthew,0,1,20,20
1746537398821,MCWP 50R,B00,893769,Carter; Jennifer A,0,1,20,20
1746537398821,MCWP 50R,C00,893771,Krone; Jarret,0,3,20,20
1746537398821,MCWP 50R,D00,893772,Miller; Elizabeth Deen,0,0,20,20
1746537398821,MCWP 50R,E00,893775,Carter; Andrea L,0,1,20,20
1746537399853,MMW 11R,A01,892721,Herbst; Matthew,11,0,27,16
1746537399853,MMW 11R,A02,892722,Herbst; Matthew,0,0,0,3
1746537400879,MMW 12R,A01,892724,Herbst; Matthew,0,11,16,16
1746537400879,MMW 12R,A02,892725,Herbst; Matthew,0,10,16,16
1746537401908,MMW 13R,A01,892727,Staff,0,4,16,16
1746537401908,MMW 13R,A02,892728,Staff,0,4,16,16
1746537401908,MMW 13R,A03,958032,Staff,0,4,16,16
1746537401908,MMW 13R,A04,958033,Staff,0,4,16,16
1746537401908,MMW 13R,A05,958034,Staff,0,4,16,16
1746537402935,SIO 295LS,A00,894015,Staff,5,0,25,20
1746537403962,SIO 295S,A00,894020,Staff,5,0,25,20
1746537404995,SIOC 290S,B01,958918,Merrifield; Mark A,14,0,30,16
1746537406027,SIOC 291S,B01,958922,Gabriel; Corey John,14,0,30,16
1746537407053,SOCI 117,A01,895339,Staff,3,0,5,2
1746537408081,WES 237B,A00,894149,Staff,11,0,20,9
1746537410160,AESE 279B,A00,891859,Staff,13,0,35,22
1746537411189,AIP 197,001,891854,Vespa; Emanuel Ignacio,9999,0,9999,0
1746537412218,ANTH 289S,A00,891856,Gagneux; Pascal,12,0,12,0
1746537413243,BENG 196,001,957946,Engler; Adam J.,9996,0,9999,3
1746537414270,BISP 197,001,959851,Wilhelm; James E.,9999,0,9999,0
1746537415297,CAT 124RS,A01,956906,Staff,6,0,25,19
1746537416323,CAT 125RS,A01,922013,Staff,6,0,25,19
1746537417349,CLRE 250,A00,891860,Morris; Sheldon,9995,0,9999,4
1746537419411,CLRE 251R,A00,907817,Mehta; Ravindra L.,9994,0,9999,5
1746537420440,CLRE 252,A00,891864,Cuomo; Raphael Eduardo,9993,0,9999,6
1746537421472,CLRE 253,A00,891867,Vaida; Florin,9994,0,9999,5
1746537421472,CLRE 253,B00,907819,Staff,9999,0,9999,0
1746537422501,CLRE 259,A00,891868,Patel; Hemal,9998,0,9999,1
1746537423525,CLRE 260,A00,891872,Cuomo; Raphael Eduardo,9999,0,9999,0
1746537424551,CLRE 297,001,891888,Cuomo; Raphael Eduardo,9999,0,9999,0
1746537425578,CSE 191,A00,958773,Minnes Kemp; Mor Mia,9996,0,9999,3
1746537426608,CSE 197,001,959846,Minnes Kemp; Mor Mia,9993,0,9999,6
1746537427637,CSS 201S,A01,892054,Mignozzetti; Umberto,26,0,30,4
1746537428665,CSS 202S,A01,892056,Mignozzetti; Umberto,26,0,30,4
1746537429690,DSC 197,001,956898,Eldridge; Justin Matthew,9998,0,9999,1
1746537430716,DSC 297,001,958000,Mazumdar; Arya,9998,0,9999,1
1746537430716,DSC 297,002,959862,Wang; Yusu,9999,0,9999,0
1746537431744,EAP 100,A00,905686,Staff,9778,0,9999,221
1746537432778,ECE 45,A01,892618,Staff,0,0,65,65
1746537434833,ECE 111,A01,892719,Staff,4,0,65,61
1746537435859,ECE 197,001,957920,Mercier; Patrick Philip,9991,0,9999,8
1746537436885,ECON 178,A01,907814,Zhu; Ying,26,0,35,9
1746537437910,EDS 115,A00,895312,Staff,36,0,45,9
1746537438937,EDS 117,A01,895337,Staff,24,0,30,6
1746537439964,EDS 125,A00,895341,Jones; Gabrielle Anastasia,37,0,45,8
1746537440991,EDS 128A,A01,895459,Fargason; Sharon Gayle,44,0,45,1
1746537442018,EDS 128B,A01,895543,Pappas; Elizabeth,44,0,45,1
1746537443043,EDS 139,A00,897203,Pappas; Elizabeth,44,0,45,1
1746537443043,EDS 139,B00,897209,Fargason; Sharon Gayle,41,0,45,4
1746537444068,EDS 201,A00,895545,Staff,23,0,45,22
1746537445095,EDS 203,A01,895581,Halter; Christopher P.,23,0,45,22
1746537446121,EDS 204R,A01,895625,Heinzman; Erica M.,39,0,45,6
1746537446121,EDS 204R,B01,895693,Halter; Christopher P.,10,0,45,35
1746537447147,EDS 206R,A00,895694,Fargason; Sharon Gayle,1,0,30,29
1746537447147,EDS 206R,B00,895695,Choi; Bailey Miyeon,16,0,30,14
1746537448174,EDS 250,A00,895697,Hemans; Patricia Ann Benitez,23,0,45,22
1746537449205,EDS 281,A00,895701,Meyerott; Theresa Ann,1,0,15,14
1746537450233,EDS 284,A00,895736,Meyerott; Theresa Ann,1,0,15,14
1746537451259,EDS 286,A00,897210,Fine; Sarah,0,0,15,15
1746537452284,EDS 289C,A01,895770,Daly; Alan J.,15,0,15,0
1746537453312,EDS 290,A00,897211,Hofstetter; Carolyn,0,0,15,15
1746537454339,LIGM 5A,A00,896162,Fischer-Grunski; Eva K,13,0,20,7
1746537455367,LIGM 5B,A00,896260,Fischer-Grunski; Eva K,17,0,20,3
1746537456394,LIGM 5C,A00,896308,Fischer-Grunski; Eva K,18,0,20,2
1746537457420,LIIT 5AS,A00,896313,Carnelos; Chiara,18,0,20,2
1746537458447,LIIT 5BS,A00,896416,Carnelos; Chiara,20,0,20,0
1746537459477,LIIT 5CS,A00,896564,Carnelos; Chiara,20,0,20,0
1746537460504,LISP 5A,A00,896588,Munoz Sanchez; Alicia,3,0,20,17
1746537461531,LISP 5B,A00,896653,Munoz Sanchez; Alicia,7,0,20,13
1746537462560,LISP 5C,A00,896655,Munoz Sanchez; Alicia,0,1,20,20
1746537463592,MAE 197,001,957918,Kleissl; Jan,9996,0,9999,3
1746537463592,MAE 197,002,959806,Boechler; Nicholas Sebastia,9998,0,9999,1
1746537463592,MAE 197,003,959852,Mullin; Jennifer S,9999,0,9999,0
1746537464619,MATH 2,A01,957937,Staff,33,0,35,2
1746537465646,MATH 197,001,957876,Kedlaya; Kiran S.,9993,0,9999,6
1746537466673,MCWP 40,A00,892729,Duru; Nur,10,0,20,10
1746537466673,MCWP 40,B00,893304,Montejo; Carolina,14,0,20,6
1746537467700,MCWP 40R,A00,893757,Redela; Pamela Morgan,0,5,20,20
1746537468730,MCWP 50,A00,893758,Morshed; Michael James,0,0,20,20
1746537468730,MCWP 50,B00,893761,Bartulis; Jason Michael,17,0,20,3
1746537469765,MCWP 50R,A00,893766,Compas; Sean Matthew,0,1,20,20
1746537469765,MCWP 50R,B00,893769,Carter; Jennifer A,0,1,20,20
1746537469765,MCWP 50R,C00,893771,Krone; Jarret,0,3,20,20
1746537469765,MCWP 50R,D00,893772,Miller; Elizabeth Deen,0,0,20,20
1746537469765,MCWP 50R,E00,893775,Carter; Andrea L,0,1,20,20
1746537470795,MMW 11R,A01,892721,Herbst; Matthew,11,0,27,16
1746537470795,MMW 11R,A02,892722,Herbst; Matthew,0,0,0,3
1746537471821,MMW 12R,A01,892724,Herbst; Matthew,0,11,16,16
1746537471821,MMW 12R,A02,892725,Herbst; Matthew,0,10,16,16
1746537472848,MMW 13R,A01,892727,Staff,0,4,16,16
1746537472848,MMW 13R,A02,892728,Staff,0,4,16,16
1746537472848,MMW 13R,A03,958032,Staff,0,4,16,16
1746537472848,MMW 13R,A04,958033,Staff,0,4,16,16
1746537472848,MMW 13R,A05,958034,Staff,0,4,16,16
1746537473872,SIO 295LS,A00,894015,Staff,5,0,25,20
1746537474900,SIO 295S,A00,894020,Staff,5,0,25,20
1746537475932,SIOC 290S,B01,958918,Merrifield; Mark A,14,0,30,16
1746537476960,SIOC 291S,B01,958922,Gabriel; Corey John,14,0,30,16
1746537477986,SOCI 117,A01,895339,Staff,3,0,5,2
1746537479013,WES 237B,A00,894149,Staff,11,0,20,9
1746537481098,AESE 279B,A00,891859,Staff,13,0,35,22
1746537482123,AIP 197,001,891854,Vespa; Emanuel Ignacio,9999,0,9999,0
1746537483151,ANTH 289S,A00,891856,Gagneux; Pascal,12,0,12,0
1746537484190,BENG 196,001,957946,Engler; Adam J.,9996,0,9999,3
1746537485216,BISP 197,001,959851,Wilhelm; James E.,9999,0,9999,0
1746537486241,CAT 124RS,A01,956906,Staff,6,0,25,19
1746537487270,CAT 125RS,A01,922013,Staff,6,0,25,19
1746537488295,CLRE 250,A00,891860,Morris; Sheldon,9995,0,9999,4
1746537490356,CLRE 251R,A00,907817,Mehta; Ravindra L.,9994,0,9999,5
1746537491381,CLRE 252,A00,891864,Cuomo; Raphael Eduardo,9993,0,9999,6
1746537492407,CLRE 253,A00,891867,Vaida; Florin,9994,0,9999,5
1746537492407,CLRE 253,B00,907819,Staff,9999,0,9999,0
1746537493432,CLRE 259,A00,891868,Patel; Hemal,9998,0,9999,1
1746537494457,CLRE 260,A00,891872,Cuomo; Raphael Eduardo,9999,0,9999,0
1746537495486,CLRE 297,001,891888,Cuomo; Raphael Eduardo,9999,0,9999,0
1746537496516,CSE 191,A00,958773,Minnes Kemp; Mor Mia,9996,0,9999,3
1746537497544,CSE 197,001,959846,Minnes Kemp; Mor Mia,9993,0,9999,6
1746537498572,CSS 201S,A01,892054,Mignozzetti; Umberto,26,0,30,4
1746537499600,CSS 202S,A01,892056,Mignozzetti; Umberto,26,0,30,4
1746537500625,DSC 197,001,956898,Eldridge; Justin Matthew,9998,0,9999,1
1746537501651,DSC 297,001,958000,Mazumdar; Arya,9998,0,9999,1
1746537501651,DSC 297,002,959862,Wang; Yusu,9999,0,9999,0
1746537502677,EAP 100,A00,905686,Staff,9778,0,9999,221
1746537503703,ECE 45,A01,892618,Staff,0,0,65,65
1746537505759,ECE 111,A01,892719,Staff,4,0,65,61
1746537506784,ECE 197,001,957920,Mercier; Patrick Philip,9991,0,9999,8
1746537507816,ECON 178,A01,907814,Zhu; Ying,26,0,35,9
1746537508844,EDS 115,A00,895312,Staff,36,0,45,9
1746537509870,EDS 117,A01,895337,Staff,24,0,30,6
1746537510895,EDS 125,A00,895341,Jones; Gabrielle Anastasia,37,0,45,8
1746537511921,EDS 128A,A01,895459,Fargason; Sharon Gayle,44,0,45,1
1746537512947,EDS 128B,A01,895543,Pappas; Elizabeth,44,0,45,1
1746537513975,EDS 139,A00,897203,Pappas; Elizabeth,44,0,45,1
1746537513975,EDS 139,B00,897209,Fargason; Sharon Gayle,41,0,45,4
1746537515005,EDS 201,A00,895545,Staff,23,0,45,22
1746537516034,EDS 203,A01,895581,Halter; Christopher P.,23,0,45,22
1746537517065,EDS 204R,A01,895625,Heinzman; Erica M.,39,0,45,6
1746537517065,EDS 204R,B01,895693,Halter; Christopher P.,10,0,45,35
1746537518092,EDS 206R,A00,895694,Fargason; Sharon Gayle,1,0,30,29
1746537518092,EDS 206R,B00,895695,Choi; Bailey Miyeon,16,0,30,14
1746537519120,EDS 250,A00,895697,Hemans; Patricia Ann Benitez,23,0,45,22
1746537520150,EDS 281,A00,895701,Meyerott; Theresa Ann,1,0,15,14
1746537521175,EDS 284,A00,895736,Meyerott; Theresa Ann,1,0,15,14
1746537522201,EDS 286,A00,897210,Fine; Sarah,0,0,15,15
1746537523227,EDS 289C,A01,895770,Daly; Alan J.,15,0,15,0
1746537524254,EDS 290,A00,897211,Hofstetter; Carolyn,0,0,15,15
1746537525280,LIGM 5A,A00,896162,Fischer-Grunski; Eva K,13,0,20,7
1746537526311,LIGM 5B,A00,896260,Fischer-Grunski; Eva K,17,0,20,3
1746537527335,LIGM 5C,A00,896308,Fischer-Grunski; Eva K,18,0,20,2
1746537528362,LIIT 5AS,A00,896313,Carnelos; Chiara,18,0,20,2
1746537529387,LIIT 5BS,A00,896416,Carnelos; Chiara,20,0,20,0
1746537530414,LIIT 5CS,A00,896564,Carnelos; Chiara,20,0,20,0
1746537531442,LISP 5A,A00,896588,Munoz Sanchez; Alicia,3,0,20,17
1746537532471,LISP 5B,A00,896653,Munoz Sanchez; Alicia,7,0,20,13
1746537533499,LISP 5C,A00,896655,Munoz Sanchez; Alicia,0,1,20,20
1746537534527,MAE 197,001,957918,Kleissl; Jan,9996,0,9999,3
1746537534527,MAE 197,002,959806,Boechler; Nicholas Sebastia,9998,0,9999,1
1746537534527,MAE 197,003,959852,Mullin; Jennifer S,9999,0,9999,0
1746537535552,MATH 2,A01,957937,Staff,33,0,35,2
1746537536581,MATH 197,001,957876,Kedlaya; Kiran S.,9993,0,9999,6
1746537537607,MCWP 40,A00,892729,Duru; Nur,10,0,20,10
1746537537607,MCWP 40,B00,893304,Montejo; Carolina,14,0,20,6
1746537538632,MCWP 40R,A00,893757,Redela; Pamela Morgan,0,5,20,20
1746537539658,MCWP 50,A00,893758,Morshed; Michael James,0,0,20,20
1746537539658,MCWP 50,B00,893761,Bartulis; Jason Michael,17,0,20,3
1746537540689,MCWP 50R,A00,893766,Compas; Sean Matthew,0,1,20,20
1746537540689,MCWP 50R,B00,893769,Carter; Jennifer A,0,1,20,20
1746537540689,MCWP 50R,C00,893771,Krone; Jarret,0,3,20,20
1746537540689,MCWP 50R,D00,893772,Miller; Elizabeth Deen,0,0,20,20
1746537540689,MCWP 50R,E00,893775,Carter; Andrea L,0,1,20,20
1746537541716,MMW 11R,A01,892721,Herbst; Matthew,11,0,27,16
1746537541716,MMW 11R,A02,892722,Herbst; Matthew,0,0,0,3
1746537542744,MMW 12R,A01,892724,Herbst; Matthew,0,11,16,16
1746537542744,MMW 12R,A02,892725,Herbst; Matthew,0,10,16,16
1746537543774,MMW 13R,A01,892727,Staff,0,4,16,16
1746537543774,MMW 13R,A02,892728,Staff,0,4,16,16
1746537543774,MMW 13R,A03,958032,Staff,0,4,16,16
1746537543774,MMW 13R,A04,958033,Staff,0,4,16,16
1746537543774,MMW 13R,A05,958034,Staff,0,4,16,16
1746537544823,SIO 295LS,A00,894015,Staff,5,0,25,20
1746537545849,SIO 295S,A00,894020,Staff,5,0,25,20
1746537546881,SIOC 290S,B01,958918,Merrifield; Mark A,14,0,30,16
1746537547908,SIOC 291S,B01,958922,Gabriel; Corey John,14,0,30,16
1746537548934,SOCI 117,A01,895339,Staff,3,0,5,2
1746537549962,WES 237B,A00,894149,Staff,11,0,20,9
1746537552052,AESE 279B,A00,891859,Staff,13,0,35,22
1746537553080,AIP 197,001,891854,Vespa; Emanuel Ignacio,9999,0,9999,0
1746537554105,ANTH 289S,A00,891856,Gagneux; Pascal,12,0,12,0
1746537555131,BENG 196,001,957946,Engler; Adam J.,9996,0,9999,3
1746537556169,BISP 197,001,959851,Wilhelm; James E.,9999,0,9999,0
1746537557198,CAT 124RS,A01,956906,Staff,6,0,25,19
1746537558227,CAT 125RS,A01,922013,Staff,6,0,25,19
1746537559253,CLRE 250,A00,891860,Morris; Sheldon,9995,0,9999,4
1746537561309,CLRE 251R,A00,907817,Mehta; Ravindra L.,9994,0,9999,5
1746537562334,CLRE 252,A00,891864,Cuomo; Raphael Eduardo,9993,0,9999,6
1746537563361,CLRE 253,A00,891867,Vaida; Florin,9994,0,9999,5
1746537563361,CLRE 253,B00,907819,Staff,9999,0,9999,0
1746537564388,CLRE 259,A00,891868,Patel; Hemal,9998,0,9999,1
1746537565412,CLRE 260,A00,891872,Cuomo; Raphael Eduardo,9999,0,9999,0
1746537566438,CLRE 297,001,891888,Cuomo; Raphael Eduardo,9999,0,9999,0
1746537567463,CSE 191,A00,958773,Minnes Kemp; Mor Mia,9996,0,9999,3
1746537568488,CSE 197,001,959846,Minnes Kemp; Mor Mia,9993,0,9999,6
1746537569522,CSS 201S,A01,892054,Mignozzetti; Umberto,26,0,30,4
1746537570553,CSS 202S,A01,892056,Mignozzetti; Umberto,26,0,30,4
1746537571582,DSC 197,001,956898,Eldridge; Justin Matthew,9998,0,9999,1
1746537572606,DSC 297,001,958000,Mazumdar; Arya,9998,0,9999,1
1746537572606,DSC 297,002,959862,Wang; Yusu,9999,0,9999,0
1746537573632,EAP 100,A00,905686,Staff,9778,0,9999,221
1746537574661,ECE 45,A01,892618,Staff,0,0,65,65
1746537576716,ECE 111,A01,892719,Staff,4,0,65,61
1746537577739,ECE 197,001,957920,Mercier; Patrick Philip,9991,0,9999,8
1746537578765,ECON 178,A01,907814,Zhu; Ying,26,0,35,9
1746537579795,EDS 115,A00,895312,Staff,36,0,45,9
1746537580824,EDS 117,A01,895337,Staff,24,0,30,6
1746537581853,EDS 125,A00,895341,Jones; Gabrielle Anastasia,37,0,45,8
1746537582877,EDS 128A,A01,895459,Fargason; Sharon Gayle,44,0,45,1
1746537583906,EDS 128B,A01,895543,Pappas; Elizabeth,44,0,45,1
1746537584931,EDS 139,A00,897203,Pappas; Elizabeth,44,0,45,1
1746537584931,EDS 139,B00,897209,Fargason; Sharon Gayle,41,0,45,4
1746537585957,EDS 201,A00,895545,Staff,23,0,45,22
1746537586982,EDS 203,A01,895581,Halter; Christopher P.,23,0,45,22
1746537588014,EDS 204R,A01,895625,Heinzman; Erica M.,39,0,45,6
1746537588014,EDS 204R,B01,895693,Halter; Christopher P.,10,0,45,35
1746537589040,EDS 206R,A00,895694,Fargason; Sharon Gayle,1,0,30,29
1746537589040,EDS 206R,B00,895695,Choi; Bailey Miyeon,16,0,30,14
1746537590067,EDS 250,A00,895697,Hemans; Patricia Ann Benitez,23,0,45,22
1746537591094,EDS 281,A00,895701,Meyerott; Theresa Ann,1,0,15,14
1746537592123,EDS 284,A00,895736,Meyerott; Theresa Ann,1,0,15,14
1746537593154,EDS 286,A00,897210,Fine; Sarah,0,0,15,15
1746537594180,EDS 289C,A01,895770,Daly; Alan J.,15,0,15,0
1746537595205,EDS 290,A00,897211,Hofstetter; Carolyn,0,0,15,15
1746537596233,LIGM 5A,A00,896162,Fischer-Grunski; Eva K,13,0,20,7
1746537597260,LIGM 5B,A00,896260,Fischer-Grunski; Eva K,17,0,20,3
1746537598291,LIGM 5C,A00,896308,Fischer-Grunski; Eva K,18,0,20,2
1746537599316,LIIT 5AS,A00,896313,Carnelos; Chiara,18,0,20,2
1746537600342,LIIT 5BS,A00,896416,Carnelos; Chiara,20,0,20,0
1746537601372,LIIT 5CS,A00,896564,Carnelos; Chiara,20,0,20,0
1746537602409,LISP 5A,A00,896588,Munoz Sanchez; Alicia,3,0,20,17
1746537603434,LISP 5B,A00,896653,Munoz Sanchez; Alicia,7,0,20,13
1746537604460,LISP 5C,A00,896655,Munoz Sanchez; Alicia,0,1,20,20
1746537605490,MAE 197,001,957918,Kleissl; Jan,9996,0,9999,3
1746537605490,MAE 197,002,959806,Boechler; Nicholas Sebastia,9998,0,9999,1
1746537605490,MAE 197,003,959852,Mullin; Jennifer S,9999,0,9999,0
1746537606516,MATH 2,A01,957937,Staff,33,0,35,2
1746537607545,MATH 197,001,957876,Kedlaya; Kiran S.,9993,0,9999,6
1746537608577,MCWP 40,A00,892729,Duru; Nur,10,0,20,10
1746537608577,MCWP 40,B00,893304,Montejo; Carolina,14,0,20,6
1746537609602,MCWP 40R,A00,893757,Redela; Pamela Morgan,0,5,20,20
1746537610631,MCWP 50,A00,893758,Morshed; Michael James,0,0,20,20
1746537610631,MCWP 50,B00,893761,Bartulis; Jason Michael,17,0,20,3
1746537611665,MCWP 50R,A00,893766,Compas; Sean Matthew,0,1,20,20
1746537611665,MCWP 50R,B00,893769,Carter; Jennifer A,0,1,20,20
1746537611665,MCWP 50R,C00,893771,Krone; Jarret,0,3,20,20
1746537611665,MCWP 50R,D00,893772,Miller; Elizabeth Deen,0,0,20,20
1746537611665,MCWP 50R,E00,893775,Carter; Andrea L,0,1,20,20
1746537612691,MMW 11R,A01,892721,Herbst; Matthew,11,0,27,16
1746537612691,MMW 11R,A02,892722,Herbst; Matthew,0,0,0,3
1746537613718,MMW 12R,A01,892724,Herbst; Matthew,0,11,16,16
1746537613718,MMW 12R,A02,892725,Herbst; Matthew,0,10,16,16
1746537614746,MMW 13R,A01,892727,Staff,0,4,16,16
1746537614746,MMW 13R,A02,892728,Staff,0,4,16,16
1746537614746,MMW 13R,A03,958032,Staff,0,4,16,16
1746537614746,MMW 13R,A04,958033,Staff,0,4,16,16
1746537614746,MMW 13R,A05,958034,Staff,0,4,16,16
1746537615772,SIO 295LS,A00,894015,Staff,5,0,25,20
1746537616799,SIO 295S,A00,894020,Staff,5,0,25,20
1746537617828,SIOC 290S,B01,958918,Merrifield; Mark A,14,0,30,16
1746537618855,SIOC 291S,B01,958922,Gabriel; Corey John,14,0,30,16
1746537619880,SOCI 117,A01,895339,Staff,3,0,5,2
1746537620910,WES 237B,A00,894149,Staff,11,0,20,9
1746537622973,AESE 279B,A00,891859,Staff,13,0,35,22
1746537624000,AIP 197,001,891854,Vespa; Emanuel Ignacio,9999,0,9999,0
1746537625030,ANTH 289S,A00,891856,Gagneux; Pascal,12,0,12,0
1746537626057,BENG 196,001,957946,Engler; Adam J.,9996,0,9999,3
1746537627082,BISP 197,001,959851,Wilhelm; James E.,9999,0,9999,0
1746537628110,CAT 124RS,A01,956906,Staff,6,0,25,19
1746537629140,CAT 125RS,A01,922013,Staff,6,0,25,19
1746537630167,CLRE 250,A00,891860,Morris; Sheldon,9995,0,9999,4
1746537632217,CLRE 251R,A00,907817,Mehta; Ravindra L.,9994,0,9999,5
1746537633245,CLRE 252,A00,891864,Cuomo; Raphael Eduardo,9993,0,9999,6
1746537634276,CLRE 253,A00,891867,Vaida; Florin,9994,0,9999,5
1746537634276,CLRE 253,B00,907819,Staff,9999,0,9999,0
1746537635304,CLRE 259,A00,891868,Patel; Hemal,9998,0,9999,1
1746537636332,CLRE 260,A00,891872,Cuomo; Raphael Eduardo,9999,0,9999,0
1746537637358,CLRE 297,001,891888,Cuomo; Raphael Eduardo,9999,0,9999,0
1746537638387,CSE 191,A00,958773,Minnes Kemp; Mor Mia,9996,0,9999,3
1746537639412,CSE 197,001,959846,Minnes Kemp; Mor Mia,9993,0,9999,6
1746537640443,CSS 201S,A01,892054,Mignozzetti; Umberto,26,0,30,4
1746537641470,CSS 202S,A01,892056,Mignozzetti; Umberto,26,0,30,4
1746537642500,DSC 197,001,956898,Eldridge; Justin Matthew,9998,0,9999,1
1746537643531,DSC 297,001,958000,Mazumdar; Arya,9998,0,9999,1
1746537643531,DSC 297,002,959862,Wang; Yusu,9999,0,9999,0
1746537644557,EAP 100,A00,905686,Staff,9778,0,9999,221
1746537645589,ECE 45,A01,892618,Staff,0,0,65,65
1746537647644,ECE 111,A01,892719,Staff,4,0,65,61
1746537648674,ECE 197,001,957920,Mercier; Patrick Philip,9991,0,9999,8
1746537649700,ECON 178,A01,907814,Zhu; Ying,26,0,35,9
1746537650731,EDS 115,A00,895312,Staff,36,0,45,9
1746537651760,EDS 117,A01,895337,Staff,24,0,30,6
1746537652786,EDS 125,A00,895341,Jones; Gabrielle Anastasia,37,0,45,8
1746537653811,EDS 128A,A01,895459,Fargason; Sharon Gayle,44,0,45,1
1746537654838,EDS 128B,A01,895543,Pappas; Elizabeth,44,0,45,1
1746537655870,EDS 139,A00,897203,Pappas; Elizabeth,44,0,45,1
1746537655870,EDS 139,B00,897209,Fargason; Sharon Gayle,41,0,45,4
1746537656898,EDS 201,A00,895545,Staff,23,0,45,22
1746537657925,EDS 203,A01,895581,Halter; Christopher P.,23,0,45,22
1746537658954,EDS 204R,A01,895625,Heinzman; Erica M.,39,0,45,6
1746537658954,EDS 204R,B01,895693,Halter; Christopher P.,10,0,45,35
1746537659982,EDS 206R,A00,895694,Fargason; Sharon Gayle,1,0,30,29
1746537659982,EDS 206R,B00,895695,Choi; Bailey Miyeon,16,0,30,14
1746537661010,EDS 250,A00,895697,Hemans; Patricia Ann Benitez,23,0,45,22
1746537662037,EDS 281,A00,895701,Meyerott; Theresa Ann,1,0,15,14
1746537663064,EDS 284,A00,895736,Meyerott; Theresa Ann,1,0,15,14
1746537664090,EDS 286,A00,897210,Fine; Sarah,0,0,15,15
1746537665117,EDS 289C,A01,895770,Daly; Alan J.,15,0,15,0
1746537666147,EDS 290,A00,897211,Hofstetter; Carolyn,0,0,15,15
1746537667173,LIGM 5A,A00,896162,Fischer-Grunski; Eva K,13,0,20,7
1746537668203,LIGM 5B,A00,896260,Fischer-Grunski; Eva K,17,0,20,3
1746537669233,LIGM 5C,A00,896308,Fischer-Grunski; Eva K,18,0,20,2
1746537670264,LIIT 5AS,A00,896313,Carnelos; Chiara,18,0,20,2
1746537671292,LIIT 5BS,A00,896416,Carnelos; Chiara,20,0,20,0
1746537672321,LIIT 5CS,A00,896564,Carnelos; Chiara,20,0,20,0
1746537673350,LISP 5A,A00,896588,Munoz Sanchez; Alicia,3,0,20,17
1746537674380,LISP 5B,A00,896653,Munoz Sanchez; Alicia,7,0,20,13
1746537675406,LISP 5C,A00,896655,Munoz Sanchez; Alicia,0,1,20,20
1746537676438,MAE 197,001,957918,Kleissl; Jan,9996,0,9999,3
1746537676438,MAE 197,002,959806,Boechler; Nicholas Sebastia,9998,0,9999,1
1746537676438,MAE 197,003,959852,Mullin; Jennifer S,9999,0,9999,0
1746537677465,MATH 2,A01,957937,Staff,33,0,35,2
1746537678490,MATH 197,001,957876,Kedlaya; Kiran S.,9993,0,9999,6
1746537679516,MCWP 40,A00,892729,Duru; Nur,10,0,20,10
1746537679516,MCWP 40,B00,893304,Montejo; Carolina,14,0,20,6
1746537680543,MCWP 40R,A00,893757,Redela; Pamela Morgan,0,5,20,20
1746537681570,MCWP 50,A00,893758,Morshed; Michael James,0,0,20,20
1746537681570,MCWP 50,B00,893761,Bartulis; Jason Michael,17,0,20,3
1746537682600,MCWP 50R,A00,893766,Compas; Sean Matthew,0,1,20,20
1746537682600,MCWP 50R,B00,893769,Carter; Jennifer A,0,1,20,20
1746537682600,MCWP 50R,C00,893771,Krone; Jarret,0,3,20,20
1746537682600,MCWP 50R,D00,893772,Miller; Elizabeth Deen,0,0,20,20
1746537682600,MCWP 50R,E00,893775,Carter; Andrea L,0,1,20,20
1746537683627,MMW 11R,A01,892721,Herbst; Matthew,11,0,27,16
1746537683627,MMW 11R,A02,892722,Herbst; Matthew,0,0,0,3
1746537684652,MMW 12R,A01,892724,Herbst; Matthew,0,11,16,16
1746537684652,MMW 12R,A02,892725,Herbst; Matthew,0,10,16,16
1746537685682,MMW 13R,A01,892727,Staff,0,4,16,16
1746537685682,MMW 13R,A02,892728,Staff,0,4,16,16
1746537685682,MMW 13R,A03,958032,Staff,0,4,16,16
1746537685682,MMW 13R,A04,958033,Staff,0,4,16,16
1746537685682,MMW 13R,A05,958034,Staff,0,4,16,16
1746537686708,SIO 295LS,A00,894015,Staff,5,0,25,20
1746537687738,SIO 295S,A00,894020,Staff,5,0,25,20
1746537688766,SIOC 290S,B01,958918,Merrifield; Mark A,14,0,30,16
1746537689795,SIOC 291S,B01,958922,Gabriel; Corey John,14,0,30,16
1746537690826,SOCI 117,A01,895339,Staff,3,0,5,2
1746537691851,WES 237B,A00,894149,Staff,11,0,20,9
1746537693924,AESE 279B,A00,891859,Staff,13,0,35,22
1746537694953,AIP 197,001,891854,Vespa; Emanuel Ignacio,9999,0,9999,0
1746537695979,ANTH 289S,A00,891856,Gagneux; Pascal,12,0,12,0
1746537697007,BENG 196,001,957946,Engler; Adam J.,9996,0,9999,3
1746537698034,BISP 197,001,959851,Wilhelm; James E.,9999,0,9999,0
1746537699062,CAT 124RS,A01,956906,Staff,6,0,25,19
1746537700088,CAT 125RS,A01,922013,Staff,6,0,25,19
1746537701116,CLRE 250,A00,891860,Morris; Sheldon,9995,0,9999,4
1746537703168,CLRE 251R,A00,907817,Mehta; Ravindra L.,9994,0,9999,5
1746537704196,CLRE 252,A00,891864,Cuomo; Raphael Eduardo,9993,0,9999,6
1746537705283,CLRE 253,A00,891867,Vaida; Florin,9994,0,9999,5
1746537705283,CLRE 253,B00,907819,Staff,9999,0,9999,0
1746537706307,CLRE 259,A00,891868,Patel; Hemal,9998,0,9999,1
1746537707334,CLRE 260,A00,891872,Cuomo; Raphael Eduardo,9999,0,9999,0
1746537708359,CLRE 297,001,891888,Cuomo; Raphael Eduardo,9999,0,9999,0
1746537709388,CSE 191,A00,958773,Minnes Kemp; Mor Mia,9996,0,9999,3
1746537710418,CSE 197,001,959846,Minnes Kemp; Mor Mia,9993,0,9999,6
1746537711442,CSS 201S,A01,892054,Mignozzetti; Umberto,26,0,30,4
1746537712472,CSS 202S,A01,892056,Mignozzetti; Umberto,26,0,30,4
1746537713501,DSC 197,001,956898,Eldridge; Justin Matthew,9998,0,9999,1
1746537714536,DSC 297,001,958000,Mazumdar; Arya,9998,0,9999,1
1746537714536,DSC 297,002,959862,Wang; Yusu,9999,0,9999,0
1746537715567,EAP 100,A00,905686,Staff,9778,0,9999,221
1746537716595,ECE 45,A01,892618,Staff,0,0,65,65
1746537718650,ECE 111,A01,892719,Staff,4,0,65,61
1746537719676,ECE 197,001,957920,Mercier; Patrick Philip,9991,0,9999,8
1746537720703,ECON 178,A01,907814,Zhu; Ying,26,0,35,9
1746537721728,EDS 115,A00,895312,Staff,36,0,45,9
1746537722758,EDS 117,A01,895337,Staff,24,0,30,6
1746537723782,EDS 125,A00,895341,Jones; Gabrielle Anastasia,37,0,45,8
1746537724809,EDS 128A,A01,895459,Fargason; Sharon Gayle,44,0,45,1
1746537725839,EDS 128B,A01,895543,Pappas; Elizabeth,44,0,45,1
1746537726870,EDS 139,A00,897203,Pappas; Elizabeth,44,0,45,1
1746537726870,EDS 139,B00,897209,Fargason; Sharon Gayle,41,0,45,4
1746537727895,EDS 201,A00,895545,Staff,23,0,45,22
1746537728919,EDS 203,A01,895581,Halter; Christopher P.,23,0,45,22
1746537729950,EDS 204R,A01,895625,Heinzman; Erica M.,39,0,45,6
1746537729950,EDS 204R,B01,895693,Halter; Christopher P.,10,0,45,35
1746537730988,EDS 206R,A00,895694,Fargason; Sharon Gayle,1,0,30,29
1746537730988,EDS 206R,B00,895695,Choi; Bailey Miyeon,16,0,30,14
1746537732018,EDS 250,A00,895697,Hemans; Patricia Ann Benitez,23,0,45,22
1746537733048,EDS 281,A00,895701,Meyerott; Theresa Ann,1,0,15,14
1746537734071,EDS 284,A00,895736,Meyerott; Theresa Ann,1,0,15,14
1746537735096,EDS 286,A00,897210,Fine; Sarah,0,0,15,15
1746537736122,EDS 289C,A01,895770,Daly; Alan J.,15,0,15,0
1746537737147,EDS 290,A00,897211,Hofstetter; Carolyn,0,0,15,15
1746537738174,LIGM 5A,A00,896162,Fischer-Grunski; Eva K,13,0,20,7
1746537739198,LIGM 5B,A00,896260,Fischer-Grunski; Eva K,17,0,20,3
1746537740223,LIGM 5C,A00,896308,Fischer-Grunski; Eva K,18,0,20,2
1746537741251,LIIT 5AS,A00,896313,Carnelos; Chiara,18,0,20,2
1746537742278,LIIT 5BS,A00,896416,Carnelos; Chiara,20,0,20,0
1746537743304,LIIT 5CS,A00,896564,Carnelos; Chiara,20,0,20,0
1746537744329,LISP 5A,A00,896588,Munoz Sanchez; Alicia,3,0,20,17
1746537745354,LISP 5B,A00,896653,Munoz Sanchez; Alicia,7,0,20,13
1746537746380,LISP 5C,A00,896655,Munoz Sanchez; Alicia,0,1,20,20
1746537747414,MAE 197,001,957918,Kleissl; Jan,9996,0,9999,3
1746537747414,MAE 197,002,959806,Boechler; Nicholas Sebastia,9998,0,9999,1
1746537747414,MAE 197,003,959852,Mullin; Jennifer S,9999,0,9999,0
1746537748444,MATH 2,A01,957937,Staff,33,0,35,2
1746537749468,MATH 197,001,957876,Kedlaya; Kiran S.,9993,0,9999,6
1746537750503,MCWP 40,A00,892729,Duru; Nur,10,0,20,10
1746537750503,MCWP 40,B00,893304,Montejo; Carolina,14,0,20,6
1746537751534,MCWP 40R,A00,893757,Redela; Pamela Morgan,0,5,20,20
1746537752560,MCWP 50,A00,893758,Morshed; Michael James,0,0,20,20
1746537752560,MCWP 50,B00,893761,Bartulis; Jason Michael,17,0,20,3
1746537753587,MCWP 50R,A00,893766,Compas; Sean Matthew,0,1,20,20
1746537753587,MCWP 50R,B00,893769,Carter; Jennifer A,0,1,20,20
1746537753587,MCWP 50R,C00,893771,Krone; Jarret,0,3,20,20
1746537753587,MCWP 50R,D00,893772,Miller; Elizabeth Deen,0,0,20,20
1746537753587,MCWP 50R,E00,893775,Carter; Andrea L,0,1,20,20
1746537754614,MMW 11R,A01,892721,Herbst; Matthew,11,0,27,16
1746537754614,MMW 11R,A02,892722,Herbst; Matthew,0,0,0,3
1746537755643,MMW 12R,A01,892724,Herbst; Matthew,0,11,16,16
1746537755643,MMW 12R,A02,892725,Herbst; Matthew,0,10,16,16
1746537756671,MMW 13R,A01,892727,Staff,0,4,16,16
1746537756671,MMW 13R,A02,892728,Staff,0,4,16,16
1746537756671,MMW 13R,A03,958032,Staff,0,4,16,16
1746537756671,MMW 13R,A04,958033,Staff,0,4,16,16
1746537756671,MMW 13R,A05,958034,Staff,0,4,16,16
1746537757702,SIO 295LS,A00,894015,Staff,5,0,25,20
1746537758733,SIO 295S,A00,894020,Staff,5,0,25,20
1746537759760,SIOC 290S,B01,958918,Merrifield; Mark A,14,0,30,16
1746537760804,SIOC 291S,B01,958922,Gabriel; Corey John,14,0,30,16
1746537761831,SOCI 117,A01,895339,Staff,3,0,5,2
1746537762858,WES 237B,A00,894149,Staff,11,0,20,9
1746537764924,AESE 279B,A00,891859,Staff,13,0,35,22
1746537765952,AIP 197,001,891854,Vespa; Emanuel Ignacio,9999,0,9999,0
1746537766982,ANTH 289S,A00,891856,Gagneux; Pascal,12,0,12,0
1746537768009,BENG 196,001,957946,Engler; Adam J.,9996,0,9999,3
1746537769034,BISP 197,001,959851,Wilhelm; James E.,9999,0,9999,0
1746537770063,CAT 124RS,A01,956906,Staff,6,0,25,19
1746537771088,CAT 125RS,A01,922013,Staff,6,0,25,19
1746537772114,CLRE 250,A00,891860,Morris; Sheldon,9995,0,9999,4
1746537774171,CLRE 251R,A00,907817,Mehta; Ravindra L.,9994,0,9999,5
1746537775197,CLRE 252,A00,891864,Cuomo; Raphael Eduardo,9993,0,9999,6
1746537776222,CLRE 253,A00,891867,Vaida; Florin,9994,0,9999,5
1746537776222,CLRE 253,B00,907819,Staff,9999,0,9999,0
1746537777247,CLRE 259,A00,891868,Patel; Hemal,9998,0,9999,1
1746537778276,CLRE 260,A00,891872,Cuomo; Raphael Eduardo,9999,0,9999,0
1746537779307,CLRE 297,001,891888,Cuomo; Raphael Eduardo,9999,0,9999,0
1746537780338,CSE 191,A00,958773,Minnes Kemp; Mor Mia,9996,0,9999,3
1746537781363,CSE 197,001,959846,Minnes Kemp; Mor Mia,9993,0,9999,6
1746537782391,CSS 201S,A01,892054,Mignozzetti; Umberto,26,0,30,4
1746537783420,CSS 202S,A01,892056,Mignozzetti; Umberto,26,0,30,4
1746537784444,DSC 197,001,956898,Eldridge; Justin Matthew,9998,0,9999,1
1746537785475,DSC 297,001,958000,Mazumdar; Arya,9998,0,9999,1
1746537785475,DSC 297,002,959862,Wang; Yusu,9999,0,9999,0
1746537786501,EAP 100,A00,905686,Staff,9778,0,9999,221
1746537787533,ECE 45,A01,892618,Staff,0,0,65,65
1746537789588,ECE 111,A01,892719,Staff,4,0,65,61
1746537790612,ECE 197,001,957920,Mercier; Patrick Philip,9991,0,9999,8
1746537791645,ECON 178,A01,907814,Zhu; Ying,26,0,35,9
1746537792670,EDS 115,A00,895312,Staff,36,0,45,9
1746537793698,EDS 117,A01,895337,Staff,24,0,30,6
1746537794726,EDS 125,A00,895341,Jones; Gabrielle Anastasia,37,0,45,8
1746537795754,EDS 128A,A01,895459,Fargason; Sharon Gayle,44,0,45,1
1746537796781,EDS 128B,A01,895543,Pappas; Elizabeth,44,0,45,1
1746537797808,EDS 139,A00,897203,Pappas; Elizabeth,44,0,45,1
1746537797808,EDS 139,B00,897209,Fargason; Sharon Gayle,41,0,45,4
1746537798834,EDS 201,A00,895545,Staff,23,0,45,22
1746537799860,EDS 203,A01,895581,Halter; Christopher P.,23,0,45,22
1746537800894,EDS 204R,A01,895625,Heinzman; Erica M.,39,0,45,6
1746537800894,EDS 204R,B01,895693,Halter; Christopher P.,10,0,45,35
1746537801923,EDS 206R,A00,895694,Fargason; Sharon Gayle,1,0,30,29
1746537801923,EDS 206R,B00,895695,Choi; Bailey Miyeon,16,0,30,14
1746537802948,EDS 250,A00,895697,Hemans; Patricia Ann Benitez,23,0,45,22
1746537803975,EDS 281,A00,895701,Meyerott; Theresa Ann,1,0,15,14
1746537805002,EDS 284,A00,895736,Meyerott; Theresa Ann,1,0,15,14
1746537806030,EDS 286,A00,897210,Fine; Sarah,0,0,15,15
1746537807055,EDS 289C,A01,895770,Daly; Alan J.,15,0,15,0
1746537808082,EDS 290,A00,897211,Hofstetter; Carolyn,0,0,15,15
1746537809146,LIGM 5A,A00,896162,Fischer-Grunski; Eva K,13,0,20,7
1746537810179,LIGM 5B,A00,896260,Fischer-Grunski; Eva K,17,0,20,3
1746537811208,LIGM 5C,A00,896308,Fischer-Grunski; Eva K,18,0,20,2
1746537812236,LIIT 5AS,A00,896313,Carnelos; Chiara,18,0,20,2
1746537813264,LIIT 5BS,A00,896416,Carnelos; Chiara,20,0,20,0
1746537814292,LIIT 5CS,A00,896564,Carnelos; Chiara,20,0,20,0
1746537815321,LISP 5A,A00,896588,Munoz Sanchez; Alicia,3,0,20,17
1746537816385,LISP 5B,A00,896653,Munoz Sanchez; Alicia,7,0,20,13
1746537817411,LISP 5C,A00,896655,Munoz Sanchez; Alicia,0,1,20,20
1746537818439,MAE 197,001,957918,Kleissl; Jan,9996,0,9999,3
1746537818439,MAE 197,002,959806,Boechler; Nicholas Sebastia,9998,0,9999,1
1746537818439,MAE 197,003,959852,Mullin; Jennifer S,9999,0,9999,0
1746537819467,MATH 2,A01,957937,Staff,33,0,35,2
1746537820497,MATH 197,001,957876,Kedlaya; Kiran S.,9993,0,9999,6
1746537821524,MCWP 40,A00,892729,Duru; Nur,10,0,20,10
1746537821524,MCWP 40,B00,893304,Montejo; Carolina,14,0,20,6
1746537822553,MCWP 40R,A00,893757,Redela; Pamela Morgan,0,5,20,20
1746537823580,MCWP 50,A00,893758,Morshed; Michael James,0,0,20,20
1746537823580,MCWP 50,B00,893761,Bartulis; Jason Michael,17,0,20,3
1746537824609,MCWP 50R,A00,893766,Compas; Sean Matthew,0,1,20,20
1746537824609,MCWP 50R,B00,893769,Carter; Jennifer A,0,1,20,20
1746537824609,MCWP 50R,C00,893771,Krone; Jarret,0,3,20,20
1746537824609,MCWP 50R,D00,893772,Miller; Elizabeth Deen,0,0,20,20
1746537824609,MCWP 50R,E00,893775,Carter; Andrea L,0,1,20,20
1746537825636,MMW 11R,A01,892721,Herbst; Matthew,11,0,27,16
1746537825636,MMW 11R,A02,892722,Herbst; Matthew,0,0,0,3
1746537826664,MMW 12R,A01,892724,Herbst; Matthew,0,11,16,16
1746537826664,MMW 12R,A02,892725,Herbst; Matthew,0,10,16,16
1746537827694,MMW 13R,A01,892727,Staff,0,4,16,16
1746537827694,MMW 13R,A02,892728,Staff,0,4,16,16
1746537827694,MMW 13R,A03,958032,Staff,0,4,16,16
1746537827694,MMW 13R,A04,958033,Staff,0,4,16,16
1746537827694,MMW 13R,A05,958034,Staff,0,4,16,16
1746537828719,SIO 295LS,A00,894015,Staff,5,0,25,20
1746537829746,SIO 295S,A00,894020,Staff,5,0,25,20
1746537830774,SIOC 290S,B01,958918,Merrifield; Mark A,14,0,30,16
1746537831805,SIOC 291S,B01,958922,Gabriel; Corey John,14,0,30,16
1746537832831,SOCI 117,A01,895339,Staff,3,0,5,2
1746537833858,WES 237B,A00,894149,Staff,11,0,20,9
1746537835941,AESE 279B,A00,891859,Staff,13,0,35,22
1746537836966,AIP 197,001,891854,Vespa; Emanuel Ignacio,9999,0,9999,0
1746537837992,ANTH 289S,A00,891856,Gagneux; Pascal,12,0,12,0
1746537839023,BENG 196,001,957946,Engler; Adam J.,9996,0,9999,3
1746537840054,BISP 197,001,959851,Wilhelm; James E.,9999,0,9999,0
1746537841083,CAT 124RS,A01,956906,Staff,6,0,25,19
1746537842113,CAT 125RS,A01,922013,Staff,6,0,25,19
1746537843142,CLRE 250,A00,891860,Morris; Sheldon,9995,0,9999,4
1746537845196,CLRE 251R,A00,907817,Mehta; Ravindra L.,9994,0,9999,5
1746537846222,CLRE 252,A00,891864,Cuomo; Raphael Eduardo,9993,0,9999,6
1746537847246,CLRE 253,A00,891867,Vaida; Florin,9994,0,9999,5
1746537847246,CLRE 253,B00,907819,Staff,9999,0,9999,0
1746537848272,CLRE 259,A00,891868,Patel; Hemal,9998,0,9999,1
1746537849303,CLRE 260,A00,891872,Cuomo; Raphael Eduardo,9999,0,9999,0
1746537850327,CLRE 297,001,891888,Cuomo; Raphael Eduardo,9999,0,9999,0
1746537851356,CSE 191,A00,958773,Minnes Kemp; Mor Mia,9996,0,9999,3
1746537852398,CSE 197,001,959846,Minnes Kemp; Mor Mia,9993,0,9999,6
1746537853430,CSS 201S,A01,892054,Mignozzetti; Umberto,26,0,30,4
1746537854456,CSS 202S,A01,892056,Mignozzetti; Umberto,26,0,30,4
1746537855486,DSC 197,001,956898,Eldridge; Justin Matthew,9998,0,9999,1
1746537856515,DSC 297,001,958000,Mazumdar; Arya,9998,0,9999,1
1746537856515,DSC 297,002,959862,Wang; Yusu,9999,0,9999,0
1746537857542,EAP 100,A00,905686,Staff,9778,0,9999,221
1746537858572,ECE 45,A01,892618,Staff,0,0,65,65
1746537860627,ECE 111,A01,892719,Staff,4,0,65,61
1746537861652,ECE 197,001,957920,Mercier; Patrick Philip,9991,0,9999,8
1746537862679,ECON 178,A01,907814,Zhu; Ying,26,0,35,9
1746537863708,EDS 115,A00,895312,Staff,36,0,45,9
1746537864737,EDS 117,A01,895337,Staff,24,0,30,6
1746537865768,EDS 125,A00,895341,Jones; Gabrielle Anastasia,37,0,45,8
1746537866795,EDS 128A,A01,895459,Fargason; Sharon Gayle,44,0,45,1
1746537867825,EDS 128B,A01,895543,Pappas; Elizabeth,44,0,45,1
1746537868851,EDS 139,A00,897203,Pappas; Elizabeth,44,0,45,1
1746537868851,EDS 139,B00,897209,Fargason; Sharon Gayle,41,0,45,4
1746537869881,EDS 201,A00,895545,Staff,23,0,45,22
1746537870907,EDS 203,A01,895581,Halter; Christopher P.,23,0,45,22
1746537871931,EDS 204R,A01,895625,Heinzman; Erica M.,39,0,45,6
1746537871931,EDS 204R,B01,895693,Halter; Christopher P.,10,0,45,35
1746537872957,EDS 206R,A00,895694,Fargason; Sharon Gayle,1,0,30,29
1746537872957,EDS 206R,B00,895695,Choi; Bailey Miyeon,16,0,30,14
1746537873984,EDS 250,A00,895697,Hemans; Patricia Ann Benitez,23,0,45,22
1746537875010,EDS 281,A00,895701,Meyerott; Theresa Ann,1,0,15,14
1746537876036,EDS 284,A00,895736,Meyerott; Theresa Ann,1,0,15,14
1746537877064,EDS 286,A00,897210,Fine; Sarah,0,0,15,15
1746537878094,EDS 289C,A01,895770,Daly; Alan J.,15,0,15,0
1746537879120,EDS 290,A00,897211,Hofstetter; Carolyn,0,0,15,15
1746537880145,LIGM 5A,A00,896162,Fischer-Grunski; Eva K,13,0,20,7
1746537881176,LIGM 5B,A00,896260,Fischer-Grunski; Eva K,17,0,20,3
1746537882201,LIGM 5C,A00,896308,Fischer-Grunski; Eva K,18,0,20,2
1746537883231,LIIT 5AS,A00,896313,Carnelos; Chiara,18,0,20,2
1746537884257,LIIT 5BS,A00,896416,Carnelos; Chiara,20,0,20,0
1746537885283,LIIT 5CS,A00,896564,Carnelos; Chiara,20,0,20,0
1746537886311,LISP 5A,A00,896588,Munoz Sanchez; Alicia,3,0,20,17
1746537887343,LISP 5B,A00,896653,Munoz Sanchez; Alicia,7,0,20,13
1746537888371,LISP 5C,A00,896655,Munoz Sanchez; Alicia,0,1,20,20
1746537889396,MAE 197,001,957918,Kleissl; Jan,9996,0,9999,3
1746537889396,MAE 197,002,959806,Boechler; Nicholas Sebastia,9998,0,9999,1
1746537889396,MAE 197,003,959852,Mullin; Jennifer S,9999,0,9999,0
1746537890422,MATH 2,A01,957937,Staff,33,0,35,2
1746537891449,MATH 197,001,957876,Kedlaya; Kiran S.,9993,0,9999,6
1746537892478,MCWP 40,A00,892729,Duru; Nur,10,0,20,10
1746537892478,MCWP 40,B00,893304,Montejo; Carolina,14,0,20,6
1746537893506,MCWP 40R,A00,893757,Redela; Pamela Morgan,0,5,20,20
1746537894532,MCWP 50,A00,893758,Morshed; Michael James,0,0,20,20
1746537894532,MCWP 50,B00,893761,Bartulis; Jason Michael,17,0,20,3
1746537895561,MCWP 50R,A00,893766,Compas; Sean Matthew,0,1,20,20
1746537895561,MCWP 50R,B00,893769,Carter; Jennifer A,0,1,20,20
1746537895561,MCWP 50R,C00,893771,Krone; Jarret,0,3,20,20
1746537895561,MCWP 50R,D00,893772,Miller; Elizabeth Deen,0,0,20,20
1746537895561,MCWP 50R,E00,893775,Carter; Andrea L,0,1,20,20
1746537896593,MMW 11R,A01,892721,Herbst; Matthew,11,0,27,16
1746537896593,MMW 11R,A02,892722,Herbst; Matthew,0,0,0,3
1746537897619,MMW 12R,A01,892724,Herbst; Matthew,0,11,16,16
1746537897619,MMW 12R,A02,892725,Herbst; Matthew,0,10,16,16
1746537898643,MMW 13R,A01,892727,Staff,0,4,16,16
1746537898643,MMW 13R,A02,892728,Staff,0,4,16,16
1746537898643,MMW 13R,A03,958032,Staff,0,4,16,16
1746537898643,MMW 13R,A04,958033,Staff,0,4,16,16
1746537898643,MMW 13R,A05,958034,Staff,0,4,16,16
1746537899673,SIO 295LS,A00,894015,Staff,5,0,25,20
1746537900702,SIO 295S,A00,894020,Staff,5,0,25,20
1746537901732,SIOC 290S,B01,958918,Merrifield; Mark A,14,0,30,16
1746537902760,SIOC 291S,B01,958922,Gabriel; Corey John,14,0,30,16
1746537903790,SOCI 117,A01,895339,Staff,3,0,5,2
1746537904815,WES 237B,A00,894149,Staff,11,0,20,9
1746537906888,AESE 279B,A00,891859,Staff,13,0,35,22
1746537907915,AIP 197,001,891854,Vespa; Emanuel Ignacio,9999,0,9999,0
1746537908945,ANTH 289S,A00,891856,Gagneux; Pascal,12,0,12,0
1746537910032,BENG 196,001,957946,Engler; Adam J.,9996,0,9999,3
1746537911063,BISP 197,001,959851,Wilhelm; James E.,9999,0,9999,0
1746537912093,CAT 124RS,A01,956906,Staff,6,0,25,19
1746537913122,CAT 125RS,A01,922013,Staff,6,0,25,19
1746537914147,CLRE 250,A00,891860,Morris; Sheldon,9995,0,9999,4
1746537916203,CLRE 251R,A00,907817,Mehta; Ravindra L.,9994,0,9999,5
1746537917233,CLRE 252,A00,891864,Cuomo; Raphael Eduardo,9993,0,9999,6
1746537918263,CLRE 253,A00,891867,Vaida; Florin,9994,0,9999,5
1746537918263,CLRE 253,B00,907819,Staff,9999,0,9999,0
1746537919290,CLRE 259,A00,891868,Patel; Hemal,9998,0,9999,1
1746537920316,CLRE 260,A00,891872,Cuomo; Raphael Eduardo,9999,0,9999,0
1746537921344,CLRE 297,001,891888,Cuomo; Raphael Eduardo,9999,0,9999,0
1746537922374,CSE 191,A00,958773,Minnes Kemp; Mor Mia,9996,0,9999,3
1746537923400,CSE 197,001,959846,Minnes Kemp; Mor Mia,9993,0,9999,6
1746537924426,CSS 201S,A01,892054,Mignozzetti; Umberto,26,0,30,4
1746537925458,CSS 202S,A01,892056,Mignozzetti; Umberto,26,0,30,4
1746537926484,DSC 197,001,956898,Eldridge; Justin Matthew,9998,0,9999,1
1746537927511,DSC 297,001,958000,Mazumdar; Arya,9998,0,9999,1
1746537927511,DSC 297,002,959862,Wang; Yusu,9999,0,9999,0
1746537928536,EAP 100,A00,905686,Staff,9778,0,9999,221
1746537929564,ECE 45,A01,892618,Staff,0,0,65,65
1746537931621,ECE 111,A01,892719,Staff,4,0,65,61
1746537932651,ECE 197,001,957920,Mercier; Patrick Philip,9991,0,9999,8
1746537933678,ECON 178,A01,907814,Zhu; Ying,26,0,35,9
1746537934704,EDS 115,A00,895312,Staff,36,0,45,9
1746537935734,EDS 117,A01,895337,Staff,24,0,30,6
1746537936766,EDS 125,A00,895341,Jones; Gabrielle Anastasia,37,0,45,8
1746537937795,EDS 128A,A01,895459,Fargason; Sharon Gayle,44,0,45,1
1746537938823,EDS 128B,A01,895543,Pappas; Elizabeth,44,0,45,1
1746537939855,EDS 139,A00,897203,Pappas; Elizabeth,44,0,45,1
1746537939855,EDS 139,B00,897209,Fargason; Sharon Gayle,41,0,45,4
1746537940884,EDS 201,A00,895545,Staff,23,0,45,22
1746537941912,EDS 203,A01,895581,Halter; Christopher P.,23,0,45,22
1746537942939,EDS 204R,A01,895625,Heinzman; Erica M.,39,0,45,6
1746537942939,EDS 204R,B01,895693,Halter; Christopher P.,10,0,45,35
1746537943967,EDS 206R,A00,895694,Fargason; Sharon Gayle,1,0,30,29
1746537943967,EDS 206R,B00,895695,Choi; Bailey Miyeon,16,0,30,14
1746537944995,EDS 250,A00,895697,Hemans; Patricia Ann Benitez,23,0,45,22
1746537946024,EDS 281,A00,895701,Meyerott; Theresa Ann,1,0,15,14
1746537947049,EDS 284,A00,895736,Meyerott; Theresa Ann,1,0,15,14
1746537948077,EDS 286,A00,897210,Fine; Sarah,0,0,15,15
1746537949112,EDS 289C,A01,895770,Daly; Alan J.,15,0,15,0
1746537950139,EDS 290,A00,897211,Hofstetter; Carolyn,0,0,15,15
1746537951166,LIGM 5A,A00,896162,Fischer-Grunski; Eva K,13,0,20,7
1746537952191,LIGM 5B,A00,896260,Fischer-Grunski; Eva K,17,0,20,3
1746537953216,LIGM 5C,A00,896308,Fischer-Grunski; Eva K,18,0,20,2
1746537954244,LIIT 5AS,A00,896313,Carnelos; Chiara,18,0,20,2
1746537955272,LIIT 5BS,A00,896416,Carnelos; Chiara,20,0,20,0
1746537956301,LIIT 5CS,A00,896564,Carnelos; Chiara,20,0,20,0
1746537957327,LISP 5A,A00,896588,Munoz Sanchez; Alicia,3,0,20,17
1746537958356,LISP 5B,A00,896653,Munoz Sanchez; Alicia,7,0,20,13
1746537959382,LISP 5C,A00,896655,Munoz Sanchez; Alicia,0,1,20,20
1746537960409,MAE 197,001,957918,Kleissl; Jan,9996,0,9999,3
1746537960409,MAE 197,002,959806,Boechler; Nicholas Sebastia,9998,0,9999,1
1746537960409,MAE 197,003,959852,Mullin; Jennifer S,9999,0,9999,0
1746537961433,MATH 2,A01,957937,Staff,33,0,35,2
1746537962459,MATH 197,001,957876,Kedlaya; Kiran S.,9993,0,9999,6
1746537963484,MCWP 40,A00,892729,Duru; Nur,10,0,20,10
1746537963484,MCWP 40,B00,893304,Montejo; Carolina,14,0,20,6
1746537964509,MCWP 40R,A00,893757,Redela; Pamela Morgan,0,5,20,20
1746537965538,MCWP 50,A00,893758,Morshed; Michael James,0,0,20,20
1746537965538,MCWP 50,B00,893761,Bartulis; Jason Michael,17,0,20,3
1746537966570,MCWP 50R,A00,893766,Compas; Sean Matthew,0,1,20,20
1746537966570,MCWP 50R,B00,893769,Carter; Jennifer A,0,1,20,20
1746537966570,MCWP 50R,C00,893771,Krone; Jarret,0,3,20,20
1746537966570,MCWP 50R,D00,893772,Miller; Elizabeth Deen,0,0,20,20
1746537966570,MCWP 50R,E00,893775,Carter; Andrea L,0,1,20,20
1746537967598,MMW 11R,A01,892721,Herbst; Matthew,11,0,27,16
1746537967598,MMW 11R,A02,892722,Herbst; Matthew,0,0,0,3
1746537968624,MMW 12R,A01,892724,Herbst; Matthew,0,11,16,16
1746537968624,MMW 12R,A02,892725,Herbst; Matthew,0,10,16,16
1746537969650,MMW 13R,A01,892727,Staff,0,4,16,16
1746537969650,MMW 13R,A02,892728,Staff,0,4,16,16
1746537969650,MMW 13R,A03,958032,Staff,0,4,16,16
1746537969650,MMW 13R,A04,958033,Staff,0,4,16,16
1746537969650,MMW 13R,A05,958034,Staff,0,4,16,16
1746537970676,SIO 295LS,A00,894015,Staff,5,0,25,20
1746537971704,SIO 295S,A00,894020,Staff,5,0,25,20
1746537972734,SIOC 290S,B01,958918,Merrifield; Mark A,14,0,30,16
1746537973761,SIOC 291S,B01,958922,Gabriel; Corey John,14,0,30,16
1746537974791,SOCI 117,A01,895339,Staff,3,0,5,2
1746537975819,WES 237B,A00,894149,Staff,11,0,20,9
1746537977886,AESE 279B,A00,891859,Staff,13,0,35,22
1746537978911,AIP 197,001,891854,Vespa; Emanuel Ignacio,9999,0,9999,0
1746537979936,ANTH 289S,A00,891856,Gagneux; Pascal,12,0,12,0
1746537980963,BENG 196,001,957946,Engler; Adam J.,9996,0,9999,3
1746537982029,BISP 197,001,959851,Wilhelm; James E.,9999,0,9999,0
1746537983054,CAT 124RS,A01,956906,Staff,6,0,25,19
1746537984079,CAT 125RS,A01,922013,Staff,6,0,25,19
1746537985109,CLRE 250,A00,891860,Morris; Sheldon,9995,0,9999,4
1746537987166,CLRE 251R,A00,907817,Mehta; Ravindra L.,9994,0,9999,5
1746537988191,CLRE 252,A00,891864,Cuomo; Raphael Eduardo,9993,0,9999,6
1746537989219,CLRE 253,A00,891867,Vaida; Florin,9994,0,9999,5
1746537989219,CLRE 253,B00,907819,Staff,9999,0,9999,0
1746537990245,CLRE 259,A00,891868,Patel; Hemal,9998,0,9999,1
1746537991272,CLRE 260,A00,891872,Cuomo; Raphael Eduardo,9999,0,9999,0
1746537992302,CLRE 297,001,891888,Cuomo; Raphael Eduardo,9999,0,9999,0
1746537993331,CSE 191,A00,958773,Minnes Kemp; Mor Mia,9996,0,9999,3
1746537994355,CSE 197,001,959846,Minnes Kemp; Mor Mia,9993,0,9999,6
1746537995381,CSS 201S,A01,892054,Mignozzetti; Umberto,26,0,30,4
1746537996409,CSS 202S,A01,892056,Mignozzetti; Umberto,26,0,30,4
1746537997438,DSC 197,001,956898,Eldridge; Justin Matthew,9998,0,9999,1
1746537998462,DSC 297,001,958000,Mazumdar; Arya,9998,0,9999,1
1746537998462,DSC 297,002,959862,Wang; Yusu,9999,0,9999,0
1746537999487,EAP 100,A00,905686,Staff,9778,0,9999,221
1746538000520,ECE 45,A01,892618,Staff,0,0,65,65
1746538002578,ECE 111,A01,892719,Staff,4,0,65,61
1746538003605,ECE 197,001,957920,Mercier; Patrick Philip,9991,0,9999,8
1746538004632,ECON 178,A01,907814,Zhu; Ying,26,0,35,9
1746538005658,EDS 115,A00,895312,Staff,36,0,45,9
1746538006684,EDS 117,A01,895337,Staff,24,0,30,6
1746538007713,EDS 125,A00,895341,Jones; Gabrielle Anastasia,37,0,45,8
1746538008743,EDS 128A,A01,895459,Fargason; Sharon Gayle,44,0,45,1
1746538009769,EDS 128B,A01,895543,Pappas; Elizabeth,44,0,45,1
1746538010795,EDS 139,A00,897203,Pappas; Elizabeth,44,0,45,1
1746538010795,EDS 139,B00,897209,Fargason; Sharon Gayle,41,0,45,4
1746538011823,EDS 201,A00,895545,Staff,23,0,45,22
1746538012850,EDS 203,A01,895581,Halter; Christopher P.,23,0,45,22
1746538013875,EDS 204R,A01,895625,Heinzman; Erica M.,39,0,45,6
1746538013875,EDS 204R,B01,895693,Halter; Christopher P.,10,0,45,35
1746538014902,EDS 206R,A00,895694,Fargason; Sharon Gayle,1,0,30,29
1746538014902,EDS 206R,B00,895695,Choi; Bailey Miyeon,16,0,30,14
1746538015929,EDS 250,A00,895697,Hemans; Patricia Ann Benitez,23,0,45,22
1746538016988,EDS 281,A00,895701,Meyerott; Theresa Ann,1,0,15,14
1746538018015,EDS 284,A00,895736,Meyerott; Theresa Ann,1,0,15,14
1746538019041,EDS 286,A00,897210,Fine; Sarah,0,0,15,15
1746538020068,EDS 289C,A01,895770,Daly; Alan J.,15,0,15,0
1746538021097,EDS 290,A00,897211,Hofstetter; Carolyn,0,0,15,15
1746538022139,LIGM 5A,A00,896162,Fischer-Grunski; Eva K,13,0,20,7
1746538023170,LIGM 5B,A00,896260,Fischer-Grunski; Eva K,17,0,20,3
1746538024195,LIGM 5C,A00,896308,Fischer-Grunski; Eva K,18,0,20,2
1746538025222,LIIT 5AS,A00,896313,Carnelos; Chiara,18,0,20,2
1746538026247,LIIT 5BS,A00,896416,Carnelos; Chiara,20,0,20,0
1746538027273,LIIT 5CS,A00,896564,Carnelos; Chiara,20,0,20,0
1746538028302,LISP 5A,A00,896588,Munoz Sanchez; Alicia,3,0,20,17
1746538029329,LISP 5B,A00,896653,Munoz Sanchez; Alicia,7,0,20,13
1746538030354,LISP 5C,A00,896655,Munoz Sanchez; Alicia,0,1,20,20
1746538031380,MAE 197,001,957918,Kleissl; Jan,9996,0,9999,3
1746538031380,MAE 197,002,959806,Boechler; Nicholas Sebastia,9998,0,9999,1
1746538031380,MAE 197,003,959852,Mullin; Jennifer S,9999,0,9999,0
1746538032407,MATH 2,A01,957937,Staff,33,0,35,2
1746538033435,MATH 197,001,957876,Kedlaya; Kiran S.,9993,0,9999,6
1746538034461,MCWP 40,A00,892729,Duru; Nur,10,0,20,10
1746538034461,MCWP 40,B00,893304,Montejo; Carolina,14,0,20,6
1746538035488,MCWP 40R,A00,893757,Redela; Pamela Morgan,0,5,20,20
1746538036517,MCWP 50,A00,893758,Morshed; Michael James,0,0,20,20
1746538036517,MCWP 50,B00,893761,Bartulis; Jason Michael,17,0,20,3
1746538037544,MCWP 50R,A00,893766,Compas; Sean Matthew,0,1,20,20
1746538037544,MCWP 50R,B00,893769,Carter; Jennifer A,0,1,20,20
1746538037544,MCWP 50R,C00,893771,Krone; Jarret,0,3,20,20
1746538037544,MCWP 50R,D00,893772,Miller; Elizabeth Deen,0,0,20,20
1746538037544,MCWP 50R,E00,893775,Carter; Andrea L,0,1,20,20
1746538038571,MMW 11R,A01,892721,Herbst; Matthew,11,0,27,16
1746538038571,MMW 11R,A02,892722,Herbst; Matthew,0,0,0,3
1746538039599,MMW 12R,A01,892724,Herbst; Matthew,0,11,16,16
1746538039599,MMW 12R,A02,892725,Herbst; Matthew,0,10,16,16
1746538040627,MMW 13R,A01,892727,Staff,0,4,16,16
1746538040627,MMW 13R,A02,892728,Staff,0,4,16,16
1746538040627,MMW 13R,A03,958032,Staff,0,4,16,16
1746538040627,MMW 13R,A04,958033,Staff,0,4,16,16
1746538040627,MMW 13R,A05,958034,Staff,0,4,16,16
1746538041654,SIO 295LS,A00,894015,Staff,5,0,25,20
1746538042684,SIO 295S,A00,894020,Staff,5,0,25,20
1746538043710,SIOC 290S,B01,958918,Merrifield; Mark A,14,0,30,16
1746538044742,SIOC 291S,B01,958922,Gabriel; Corey John,14,0,30,16
1746538045771,SOCI 117,A01,895339,Staff,3,0,5,2
1746538046800,WES 237B,A00,894149,Staff,11,0,20,9
1746538048883,AESE 279B,A00,891859,Staff,13,0,35,22
1746538049912,AIP 197,001,891854,Vespa; Emanuel Ignacio,9999,0,9999,0
1746538050938,ANTH 289S,A00,891856,Gagneux; Pascal,12,0,12,0
1746538051966,BENG 196,001,957946,Engler; Adam J.,9996,0,9999,3
1746538052993,BISP 197,001,959851,Wilhelm; James E.,9999,0,9999,0
1746538054018,CAT 124RS,A01,956906,Staff,6,0,25,19
1746538055047,CAT 125RS,A01,922013,Staff,6,0,25,19
1746538056072,CLRE 250,A00,891860,Morris; Sheldon,9995,0,9999,4
1746538058129,CLRE 251R,A00,907817,Mehta; Ravindra L.,9994,0,9999,5
1746538059156,CLRE 252,A00,891864,Cuomo; Raphael Eduardo,9993,0,9999,6
1746538060185,CLRE 253,A00,891867,Vaida; Florin,9994,0,9999,5
1746538060185,CLRE 253,B00,907819,Staff,9999,0,9999,0
1746538061211,CLRE 259,A00,891868,Patel; Hemal,9998,0,9999,1
1746538062237,CLRE 260,A00,891872,Cuomo; Raphael Eduardo,9999,0,9999,0
1746538063263,CLRE 297,001,891888,Cuomo; Raphael Eduardo,9999,0,9999,0
1746538064297,CSE 191,A00,958773,Minnes Kemp; Mor Mia,9996,0,9999,3
1746538065322,CSE 197,001,959846,Minnes Kemp; Mor Mia,9993,0,9999,6
1746538066347,CSS 201S,A01,892054,Mignozzetti; Umberto,26,0,30,4
1746538067373,CSS 202S,A01,892056,Mignozzetti; Umberto,26,0,30,4
1746538068402,DSC 197,001,956898,Eldridge; Justin Matthew,9998,0,9999,1
1746538069432,DSC 297,001,958000,Mazumdar; Arya,9998,0,9999,1
1746538069432,DSC 297,002,959862,Wang; Yusu,9999,0,9999,0
1746538070460,EAP 100,A00,905686,Staff,9778,0,9999,221
1746538071486,ECE 45,A01,892618,Staff,0,0,65,65
1746538073540,ECE 111,A01,892719,Staff,4,0,65,61
1746538074566,ECE 197,001,957920,Mercier; Patrick Philip,9991,0,9999,8
1746538075596,ECON 178,A01,907814,Zhu; Ying,26,0,35,9
1746538076622,EDS 115,A00,895312,Staff,36,0,45,9
1746538077646,EDS 117,A01,895337,Staff,24,0,30,6
1746538078672,EDS 125,A00,895341,Jones; Gabrielle Anastasia,37,0,45,8
1746538079697,EDS 128A,A01,895459,Fargason; Sharon Gayle,44,0,45,1
1746538080721,EDS 128B,A01,895543,Pappas; Elizabeth,44,0,45,1
1746538081750,EDS 139,A00,897203,Pappas; Elizabeth,44,0,45,1
1746538081750,EDS 139,B00,897209,Fargason; Sharon Gayle,41,0,45,4
1746538082777,EDS 201,A00,895545,Staff,23,0,45,22
1746538083803,EDS 203,A01,895581,Halter; Christopher P.,23,0,45,22
1746538084833,EDS 204R,A01,895625,Heinzman; Erica M.,39,0,45,6
1746538084833,EDS 204R,B01,895693,Halter; Christopher P.,10,0,45,35
1746538085859,EDS 206R,A00,895694,Fargason; Sharon Gayle,1,0,30,29
1746538085859,EDS 206R,B00,895695,Choi; Bailey Miyeon,16,0,30,14
1746538086888,EDS 250,A00,895697,Hemans; Patricia Ann Benitez,23,0,45,22
1746538087916,EDS 281,A00,895701,Meyerott; Theresa Ann,1,0,15,14
1746538088946,EDS 284,A00,895736,Meyerott; Theresa Ann,1,0,15,14
1746538089972,EDS 286,A00,897210,Fine; Sarah,0,0,15,15
1746538090997,EDS 289C,A01,895770,Daly; Alan J.,15,0,15,0
1746538092023,EDS 290,A00,897211,Hofstetter; Carolyn,0,0,15,15
1746538093052,LIGM 5A,A00,896162,Fischer-Grunski; Eva K,13,0,20,7
1746538094082,LIGM 5B,A00,896260,Fischer-Grunski; Eva K,17,0,20,3
1746538095113,LIGM 5C,A00,896308,Fischer-Grunski; Eva K,18,0,20,2
1746538096143,LIIT 5AS,A00,896313,Carnelos; Chiara,18,0,20,2
1746538097169,LIIT 5BS,A00,896416,Carnelos; Chiara,20,0,20,0
1746538098193,LIIT 5CS,A00,896564,Carnelos; Chiara,20,0,20,0
1746538099223,LISP 5A,A00,896588,Munoz Sanchez; Alicia,3,0,20,17
1746538100250,LISP 5B,A00,896653,Munoz Sanchez; Alicia,7,0,20,13
1746538101280,LISP 5C,A00,896655,Munoz Sanchez; Alicia,0,1,20,20
1746538102307,MAE 197,001,957918,Kleissl; Jan,9996,0,9999,3
1746538102307,MAE 197,002,959806,Boechler; Nicholas Sebastia,9998,0,9999,1
1746538102307,MAE 197,003,959852,Mullin; Jennifer S,9999,0,9999,0
1746538103334,MATH 2,A01,957937,Staff,33,0,35,2
1746538104363,MATH 197,001,957876,Kedlaya; Kiran S.,9993,0,9999,6
1746538105390,MCWP 40,A00,892729,Duru; Nur,10,0,20,10
1746538105390,MCWP 40,B00,893304,Montejo; Carolina,14,0,20,6
1746538106416,MCWP 40R,A00,893757,Redela; Pamela Morgan,0,5,20,20
1746538107446,MCWP 50,A00,893758,Morshed; Michael James,0,0,20,20
1746538107446,MCWP 50,B00,893761,Bartulis; Jason Michael,17,0,20,3
1746538108478,MCWP 50R,A00,893766,Compas; Sean Matthew,0,1,20,20
1746538108478,MCWP 50R,B00,893769,Carter; Jennifer A,0,1,20,20
1746538108478,MCWP 50R,C00,893771,Krone; Jarret,0,3,20,20
1746538108478,MCWP 50R,D00,893772,Miller; Elizabeth Deen,0,0,20,20
1746538108478,MCWP 50R,E00,893775,Carter; Andrea L,0,1,20,20
1746538109506,MMW 11R,A01,892721,Herbst; Matthew,11,0,27,16
1746538109506,MMW 11R,A02,892722,Herbst; Matthew,0,0,0,3
1746538110534,MMW 12R,A01,892724,Herbst; Matthew,0,11,16,16
1746538110534,MMW 12R,A02,892725,Herbst; Matthew,0,10,16,16
1746538111563,MMW 13R,A01,892727,Staff,0,4,16,16
1746538111563,MMW 13R,A02,892728,Staff,0,4,16,16
1746538111563,MMW 13R,A03,958032,Staff,0,4,16,16
1746538111563,MMW 13R,A04,958033,Staff,0,4,16,16
1746538111563,MMW 13R,A05,958034,Staff,0,4,16,16
1746538112593,SIO 295LS,A00,894015,Staff,5,0,25,20
1746538113676,SIO 295S,A00,894020,Staff,5,0,25,20
1746538114704,SIOC 290S,B01,958918,Merrifield; Mark A,14,0,30,16
1746538115735,SIOC 291S,B01,958922,Gabriel; Corey John,14,0,30,16
1746538116762,SOCI 117,A01,895339,Staff,3,0,5,2
1746538117786,WES 237B,A00,894149,Staff,11,0,20,9
1746538119850,AESE 279B,A00,891859,Staff,13,0,35,22
1746538120877,AIP 197,001,891854,Vespa; Emanuel Ignacio,9999,0,9999,0
1746538121904,ANTH 289S,A00,891856,Gagneux; Pascal,12,0,12,0
1746538122931,BENG 196,001,957946,Engler; Adam J.,9996,0,9999,3
1746538123957,BISP 197,001,959851,Wilhelm; James E.,9999,0,9999,0
1746538124982,CAT 124RS,A01,956906,Staff,6,0,25,19
1746538126009,CAT 125RS,A01,922013,Staff,6,0,25,19
1746538127038,CLRE 250,A00,891860,Morris; Sheldon,9995,0,9999,4
1746538129092,CLRE 251R,A00,907817,Mehta; Ravindra L.,9994,0,9999,5
1746538130118,CLRE 252,A00,891864,Cuomo; Raphael Eduardo,9993,0,9999,6
1746538131146,CLRE 253,A00,891867,Vaida; Florin,9994,0,9999,5
1746538131146,CLRE 253,B00,907819,Staff,9999,0,9999,0
1746538132176,CLRE 259,A00,891868,Patel; Hemal,9998,0,9999,1
1746538133202,CLRE 260,A00,891872,Cuomo; Raphael Eduardo,9999,0,9999,0
1746538134229,CLRE 297,001,891888,Cuomo; Raphael Eduardo,9999,0,9999,0
1746538135262,CSE 191,A00,958773,Minnes Kemp; Mor Mia,9996,0,9999,3
1746538136292,CSE 197,001,959846,Minnes Kemp; Mor Mia,9993,0,9999,6
1746538137318,CSS 201S,A01,892054,Mignozzetti; Umberto,26,0,30,4
1746538138344,CSS 202S,A01,892056,Mignozzetti; Umberto,26,0,30,4
1746538139372,DSC 197,001,956898,Eldridge; Justin Matthew,9998,0,9999,1
1746538140398,DSC 297,001,958000,Mazumdar; Arya,9998,0,9999,1
1746538140398,DSC 297,002,959862,Wang; Yusu,9999,0,9999,0
1746538141422,EAP 100,A00,905686,Staff,9778,0,9999,221
1746538142454,ECE 45,A01,892618,Staff,0,0,65,65
1746538144504,ECE 111,A01,892719,Staff,4,0,65,61
1746538145531,ECE 197,001,957920,Mercier; Patrick Philip,9991,0,9999,8
1746538146583,ECON 178,A01,907814,Zhu; Ying,26,0,35,9
1746538147607,EDS 115,A00,895312,Staff,36,0,45,9
1746538148636,EDS 117,A01,895337,Staff,24,0,30,6
1746538149666,EDS 125,A00,895341,Jones; Gabrielle Anastasia,37,0,45,8
1746538150691,EDS 128A,A01,895459,Fargason; Sharon Gayle,44,0,45,1
1746538151719,EDS 128B,A01,895543,Pappas; Elizabeth,44,0,45,1
1746538152749,EDS 139,A00,897203,Pappas; Elizabeth,44,0,45,1
1746538152749,EDS 139,B00,897209,Fargason; Sharon Gayle,41,0,45,4
1746538153777,EDS 201,A00,895545,Staff,23,0,45,22
1746538154804,EDS 203,A01,895581,Halter; Christopher P.,23,0,45,22
1746538155834,EDS 204R,A01,895625,Heinzman; Erica M.,39,0,45,6
1746538155834,EDS 204R,B01,895693,Halter; Christopher P.,10,0,45,35
1746538156859,EDS 206R,A00,895694,Fargason; Sharon Gayle,1,0,30,29
1746538156859,EDS 206R,B00,895695,Choi; Bailey Miyeon,16,0,30,14
1746538157887,EDS 250,A00,895697,Hemans; Patricia Ann Benitez,23,0,45,22
1746538158916,EDS 281,A00,895701,Meyerott; Theresa Ann,1,0,15,14
1746538159941,EDS 284,A00,895736,Meyerott; Theresa Ann,1,0,15,14
1746538160969,EDS 286,A00,897210,Fine; Sarah,0,0,15,15
1746538161996,EDS 289C,A01,895770,Daly; Alan J.,15,0,15,0
1746538163021,EDS 290,A00,897211,Hofstetter; Carolyn,0,0,15,15
1746538164048,LIGM 5A,A00,896162,Fischer-Grunski; Eva K,13,0,20,7
1746538165078,LIGM 5B,A00,896260,Fischer-Grunski; Eva K,17,0,20,3
1746538166103,LIGM 5C,A00,896308,Fischer-Grunski; Eva K,18,0,20,2
1746538167134,LIIT 5AS,A00,896313,Carnelos; Chiara,18,0,20,2
1746538168163,LIIT 5BS,A00,896416,Carnelos; Chiara,20,0,20,0
1746538169193,LIIT 5CS,A00,896564,Carnelos; Chiara,20,0,20,0
1746538170219,LISP 5A,A00,896588,Munoz Sanchez; Alicia,3,0,20,17
1746538171248,LISP 5B,A00,896653,Munoz Sanchez; Alicia,7,0,20,13
1746538172275,LISP 5C,A00,896655,Munoz Sanchez; Alicia,0,1,20,20
1746538173306,MAE 197,001,957918,Kleissl; Jan,9996,0,9999,3
1746538173306,MAE 197,002,959806,Boechler; Nicholas Sebastia,9998,0,9999,1
1746538173306,MAE 197,003,959852,Mullin; Jennifer S,9999,0,9999,0
1746538174330,MATH 2,A01,957937,Staff,33,0,35,2
1746538175356,MATH 197,001,957876,Kedlaya; Kiran S.,9993,0,9999,6
1746538176392,MCWP 40,A00,892729,Duru; Nur,10,0,20,10
1746538176392,MCWP 40,B00,893304,Montejo; Carolina,14,0,20,6
1746538177419,MCWP 40R,A00,893757,Redela; Pamela Morgan,0,5,20,20
1746538178446,MCWP 50,A00,893758,Morshed; Michael James,0,0,20,20
1746538178446,MCWP 50,B00,893761,Bartulis; Jason Michael,17,0,20,3
1746538179478,MCWP 50R,A00,893766,Compas; Sean Matthew,0,1,20,20
1746538179478,MCWP 50R,B00,893769,Carter; Jennifer A,0,1,20,20
1746538179478,MCWP 50R,C00,893771,Krone; Jarret,0,3,20,20
1746538179478,MCWP 50R,D00,893772,Miller; Elizabeth Deen,0,0,20,20
1746538179478,MCWP 50R,E00,893775,Carter; Andrea L,0,1,20,20
1746538180505,MMW 11R,A01,892721,Herbst; Matthew,11,0,27,16
1746538180505,MMW 11R,A02,892722,Herbst; Matthew,0,0,0,3
1746538181532,MMW 12R,A01,892724,Herbst; Matthew,0,11,16,16
1746538181532,MMW 12R,A02,892725,Herbst; Matthew,0,10,16,16
1746538182559,MMW 13R,A01,892727,Staff,0,4,16,16
1746538182559,MMW 13R,A02,892728,Staff,0,4,16,16
1746538182559,MMW 13R,A03,958032,Staff,0,4,16,16
1746538182559,MMW 13R,A04,958033,Staff,0,4,16,16
1746538182559,MMW 13R,A05,958034,Staff,0,4,16,16
1746538183588,SIO 295LS,A00,894015,Staff,5,0,25,20
1746538184614,SIO 295S,A00,894020,Staff,5,0,25,20
1746538185651,SIOC 290S,B01,958918,Merrifield; Mark A,14,0,30,16
1746538186677,SIOC 291S,B01,958922,Gabriel; Corey John,14,0,30,16
1746538187705,SOCI 117,A01,895339,Staff,3,0,5,2
1746538188731,WES 237B,A00,894149,Staff,11,0,20,9
1746538190814,AESE 279B,A00,891859,Staff,13,0,35,22
1746538191839,AIP 197,001,891854,Vespa; Emanuel Ignacio,9999,0,9999,0
1746538192870,ANTH 289S,A00,891856,Gagneux; Pascal,12,0,12,0
1746538193897,BENG 196,001,957946,Engler; Adam J.,9996,0,9999,3
1746538194924,BISP 197,001,959851,Wilhelm; James E.,9999,0,9999,0
1746538195950,CAT 124RS,A01,956906,Staff,6,0,25,19
1746538196978,CAT 125RS,A01,922013,Staff,6,0,25,19
1746538198006,CLRE 250,A00,891860,Morris; Sheldon,9995,0,9999,4
1746538200060,CLRE 251R,A00,907817,Mehta; Ravindra L.,9994,0,9999,5
1746538201088,CLRE 252,A00,891864,Cuomo; Raphael Eduardo,9993,0,9999,6
1746538202115,CLRE 253,A00,891867,Vaida; Florin,9994,0,9999,5
1746538202115,CLRE 253,B00,907819,Staff,9999,0,9999,0
1746538203144,CLRE 259,A00,891868,Patel; Hemal,9998,0,9999,1
1746538204173,CLRE 260,A00,891872,Cuomo; Raphael Eduardo,9999,0,9999,0
1746538205198,CLRE 297,001,891888,Cuomo; Raphael Eduardo,9999,0,9999,0
1746538206227,CSE 191,A00,958773,Minnes Kemp; Mor Mia,9996,0,9999,3
1746538207254,CSE 197,001,959846,Minnes Kemp; Mor Mia,9993,0,9999,6
1746538208282,CSS 201S,A01,892054,Mignozzetti; Umberto,26,0,30,4
1746538209310,CSS 202S,A01,892056,Mignozzetti; Umberto,26,0,30,4
1746538210339,DSC 197,001,956898,Eldridge; Justin Matthew,9998,0,9999,1
1746538211372,DSC 297,001,958000,Mazumdar; Arya,9998,0,9999,1
1746538211372,DSC 297,002,959862,Wang; Yusu,9999,0,9999,0
1746538212408,EAP 100,A00,905686,Staff,9778,0,9999,221
1746538213438,ECE 45,A01,892618,Staff,0,0,65,65
1746538215495,ECE 111,A01,892719,Staff,4,0,65,61
1746538216527,ECE 197,001,957920,Mercier; Patrick Philip,9991,0,9999,8
1746538217599,ECON 178,A01,907814,Zhu; Ying,26,0,35,9
1746538218627,EDS 115,A00,895312,Staff,36,0,45,9
1746538219653,EDS 117,A01,895337,Staff,24,0,30,6
1746538220684,EDS 125,A00,895341,Jones; Gabrielle Anastasia,37,0,45,8
1746538221711,EDS 128A,A01,895459,Fargason; Sharon Gayle,44,0,45,1
1746538222740,EDS 128B,A01,895543,Pappas; Elizabeth,44,0,45,1
1746538223767,EDS 139,A00,897203,Pappas; Elizabeth,44,0,45,1
1746538223767,EDS 139,B00,897209,Fargason; Sharon Gayle,41,0,45,4
1746538224794,EDS 201,A00,895545,Staff,23,0,45,22
1746538225819,EDS 203,A01,895581,Halter; Christopher P.,23,0,45,22
1746538226852,EDS 204R,A01,895625,Heinzman; Erica M.,39,0,45,6
1746538226852,EDS 204R,B01,895693,Halter; Christopher P.,10,0,45,35
1746538227882,EDS 206R,A00,895694,Fargason; Sharon Gayle,1,0,30,29
1746538227882,EDS 206R,B00,895695,Choi; Bailey Miyeon,16,0,30,14
1746538228908,EDS 250,A00,895697,Hemans; Patricia Ann Benitez,23,0,45,22
1746538229938,EDS 281,A00,895701,Meyerott; Theresa Ann,1,0,15,14
1746538230964,EDS 284,A00,895736,Meyerott; Theresa Ann,1,0,15,14
1746538231994,EDS 286,A00,897210,Fine; Sarah,0,0,15,15
1746538233024,EDS 289C,A01,895770,Daly; Alan J.,15,0,15,0
1746538234051,EDS 290,A00,897211,Hofstetter; Carolyn,0,0,15,15
1746538235085,LIGM 5A,A00,896162,Fischer-Grunski; Eva K,13,0,20,7
1746538236115,LIGM 5B,A00,896260,Fischer-Grunski; Eva K,17,0,20,3
1746538237142,LIGM 5C,A00,896308,Fischer-Grunski; Eva K,18,0,20,2
1746538238169,LIIT 5AS,A00,896313,Carnelos; Chiara,18,0,20,2
1746538239197,LIIT 5BS,A00,896416,Carnelos; Chiara,20,0,20,0
1746538240222,LIIT 5CS,A00,896564,Carnelos; Chiara,20,0,20,0
1746538241257,LISP 5A,A00,896588,Munoz Sanchez; Alicia,3,0,20,17
1746538242282,LISP 5B,A00,896653,Munoz Sanchez; Alicia,7,0,20,13
1746538243306,LISP 5C,A00,896655,Munoz Sanchez; Alicia,0,1,20,20
1746538244334,MAE 197,001,957918,Kleissl; Jan,9996,0,9999,3
1746538244334,MAE 197,002,959806,Boechler; Nicholas Sebastia,9998,0,9999,1
1746538244334,MAE 197,003,959852,Mullin; Jennifer S,9999,0,9999,0
1746538245366,MATH 2,A01,957937,Staff,33,0,35,2
1746538246397,MATH 197,001,957876,Kedlaya; Kiran S.,9993,0,9999,6
1746538247425,MCWP 40,A00,892729,Duru; Nur,10,0,20,10
1746538247425,MCWP 40,B00,893304,Montejo; Carolina,14,0,20,6
1746538248452,MCWP 40R,A00,893757,Redela; Pamela Morgan,0,5,20,20
1746538249481,MCWP 50,A00,893758,Morshed; Michael James,0,0,20,20
1746538249481,MCWP 50,B00,893761,Bartulis; Jason Michael,17,0,20,3
1746538250510,MCWP 50R,A00,893766,Compas; Sean Matthew,0,1,20,20
1746538250510,MCWP 50R,B00,893769,Carter; Jennifer A,0,1,20,20
1746538250510,MCWP 50R,C00,893771,Krone; Jarret,0,3,20,20
1746538250510,MCWP 50R,D00,893772,Miller; Elizabeth Deen,0,0,20,20
1746538250510,MCWP 50R,E00,893775,Carter; Andrea L,0,1,20,20
1746538251537,MMW 11R,A01,892721,Herbst; Matthew,11,0,27,16
1746538251537,MMW 11R,A02,892722,Herbst; Matthew,0,0,0,3
1746538252565,MMW 12R,A01,892724,Herbst; Matthew,0,11,16,16
1746538252565,MMW 12R,A02,892725,Herbst; Matthew,0,10,16,16
1746538253591,MMW 13R,A01,892727,Staff,0,4,16,16
1746538253591,MMW 13R,A02,892728,Staff,0,4,16,16
1746538253591,MMW 13R,A03,958032,Staff,0,4,16,16
1746538253591,MMW 13R,A04,958033,Staff,0,4,16,16
1746538253591,MMW 13R,A05,958034,Staff,0,4,16,16
1746538254619,SIO 295LS,A00,894015,Staff,5,0,25,20
1746538255644,SIO 295S,A00,894020,Staff,5,0,25,20
1746538256670,SIOC 290S,B01,958918,Merrifield; Mark A,14,0,30,16
1746538257700,SIOC 291S,B01,958922,Gabriel; Corey John,14,0,30,16
1746538258726,SOCI 117,A01,895339,Staff,3,0,5,2
1746538259756,WES 237B,A00,894149,Staff,11,0,20,9
1746538261878,AESE 279B,A00,891859,Staff,13,0,35,22
1746538262907,AIP 197,001,891854,Vespa; Emanuel Ignacio,9999,0,9999,0
1746538263940,ANTH 289S,A00,891856,Gagneux; Pascal,12,0,12,0
1746538264968,BENG 196,001,957946,Engler; Adam J.,9996,0,9999,3
1746538265995,BISP 197,001,959851,Wilhelm; James E.,9999,0,9999,0
1746538267020,CAT 124RS,A01,956906,Staff,6,0,25,19
1746538268051,CAT 125RS,A01,922013,Staff,6,0,25,19
1746538269078,CLRE 250,A00,891860,Morris; Sheldon,9995,0,9999,4
1746538271128,CLRE 251R,A00,907817,Mehta; Ravindra L.,9994,0,9999,5
1746538272154,CLRE 252,A00,891864,Cuomo; Raphael Eduardo,9993,0,9999,6
1746538273184,CLRE 253,A00,891867,Vaida; Florin,9994,0,9999,5
1746538273184,CLRE 253,B00,907819,Staff,9999,0,9999,0
1746538274211,CLRE 259,A00,891868,Patel; Hemal,9998,0,9999,1
1746538275239,CLRE 260,A00,891872,Cuomo; Raphael Eduardo,9999,0,9999,0
1746538276266,CLRE 297,001,891888,Cuomo; Raphael Eduardo,9999,0,9999,0
1746538277293,CSE 191,A00,958773,Minnes Kemp; Mor Mia,9996,0,9999,3
1746538278323,CSE 197,001,959846,Minnes Kemp; Mor Mia,9993,0,9999,6
1746538279350,CSS 201S,A01,892054,Mignozzetti; Umberto,26,0,30,4
1746538280383,CSS 202S,A01,892056,Mignozzetti; Umberto,26,0,30,4
1746538281410,DSC 197,001,956898,Eldridge; Justin Matthew,9998,0,9999,1
1746538282441,DSC 297,001,958000,Mazumdar; Arya,9998,0,9999,1
1746538282441,DSC 297,002,959862,Wang; Yusu,9999,0,9999,0
1746538283468,EAP 100,A00,905686,Staff,9778,0,9999,221
1746538284495,ECE 45,A01,892618,Staff,0,0,65,65
1746538286548,ECE 111,A01,892719,Staff,4,0,65,61
1746538287574,ECE 197,001,957920,Mercier; Patrick Philip,9991,0,9999,8
1746538288606,ECON 178,A01,907814,Zhu; Ying,26,0,35,9
1746538289632,EDS 115,A00,895312,Staff,36,0,45,9
1746538290662,EDS 117,A01,895337,Staff,24,0,30,6
1746538291688,EDS 125,A00,895341,Jones; Gabrielle Anastasia,37,0,45,8
1746538292714,EDS 128A,A01,895459,Fargason; Sharon Gayle,44,0,45,1
1746538293745,EDS 128B,A01,895543,Pappas; Elizabeth,44,0,45,1
1746538294778,EDS 139,A00,897203,Pappas; Elizabeth,44,0,45,1
1746538294778,EDS 139,B00,897209,Fargason; Sharon Gayle,41,0,45,4
1746538295804,EDS 201,A00,895545,Staff,23,0,45,22
1746538296831,EDS 203,A01,895581,Halter; Christopher P.,23,0,45,22
1746538297864,EDS 204R,A01,895625,Heinzman; Erica M.,39,0,45,6
1746538297864,EDS 204R,B01,895693,Halter; Christopher P.,10,0,45,35
1746538298895,EDS 206R,A00,895694,Fargason; Sharon Gayle,1,0,30,29
1746538298895,EDS 206R,B00,895695,Choi; Bailey Miyeon,16,0,30,14
1746538299927,EDS 250,A00,895697,Hemans; Patricia Ann Benitez,23,0,45,22
1746538300954,EDS 281,A00,895701,Meyerott; Theresa Ann,1,0,15,14
1746538301980,EDS 284,A00,895736,Meyerott; Theresa Ann,1,0,15,14
1746538303013,EDS 286,A00,897210,Fine; Sarah,0,0,15,15
1746538304078,EDS 289C,A01,895770,Daly; Alan J.,15,0,15,0
1746538305106,EDS 290,A00,897211,Hofstetter; Carolyn,0,0,15,15
1746538306132,LIGM 5A,A00,896162,Fischer-Grunski; Eva K,13,0,20,7
1746538307165,LIGM 5B,A00,896260,Fischer-Grunski; Eva K,17,0,20,3
1746538308191,LIGM 5C,A00,896308,Fischer-Grunski; Eva K,18,0,20,2
1746538309221,LIIT 5AS,A00,896313,Carnelos; Chiara,18,0,20,2
1746538310252,LIIT 5BS,A00,896416,Carnelos; Chiara,20,0,20,0
1746538311279,LIIT 5CS,A00,896564,Carnelos; Chiara,20,0,20,0
1746538312310,LISP 5A,A00,896588,Munoz Sanchez; Alicia,3,0,20,17
1746538313336,LISP 5B,A00,896653,Munoz Sanchez; Alicia,7,0,20,13
1746538314367,LISP 5C,A00,896655,Munoz Sanchez; Alicia,0,1,20,20
1746538315393,MAE 197,001,957918,Kleissl; Jan,9996,0,9999,3
1746538315393,MAE 197,002,959806,Boechler; Nicholas Sebastia,9998,0,9999,1
1746538315393,MAE 197,003,959852,Mullin; Jennifer S,9999,0,9999,0
1746538316420,MATH 2,A01,957937,Staff,33,0,35,2
1746538317452,MATH 197,001,957876,Kedlaya; Kiran S.,9993,0,9999,6
1746538318487,MCWP 40,A00,892729,Duru; Nur,10,0,20,10
1746538318487,MCWP 40,B00,893304,Montejo; Carolina,14,0,20,6
1746538319519,MCWP 40R,A00,893757,Redela; Pamela Morgan,0,5,20,20
1746538320550,MCWP 50,A00,893758,Morshed; Michael James,0,0,20,20
1746538320550,MCWP 50,B00,893761,Bartulis; Jason Michael,17,0,20,3
1746538321586,MCWP 50R,A00,893766,Compas; Sean Matthew,0,1,20,20
1746538321586,MCWP 50R,B00,893769,Carter; Jennifer A,0,1,20,20
1746538321586,MCWP 50R,C00,893771,Krone; Jarret,0,3,20,20
1746538321586,MCWP 50R,D00,893772,Miller; Elizabeth Deen,0,0,20,20
1746538321586,MCWP 50R,E00,893775,Carter; Andrea L,0,1,20,20
1746538322613,MMW 11R,A01,892721,Herbst; Matthew,11,0,27,16
1746538322613,MMW 11R,A02,892722,Herbst; Matthew,0,0,0,3
1746538323643,MMW 12R,A01,892724,Herbst; Matthew,0,11,16,16
1746538323643,MMW 12R,A02,892725,Herbst; Matthew,0,10,16,16
1746538324672,MMW 13R,A01,892727,Staff,0,4,16,16
1746538324672,MMW 13R,A02,892728,Staff,0,4,16,16
1746538324672,MMW 13R,A03,958032,Staff,0,4,16,16
1746538324672,MMW 13R,A04,958033,Staff,0,4,16,16
1746538324672,MMW 13R,A05,958034,Staff,0,4,16,16
1746538325702,SIO 295LS,A00,894015,Staff,5,0,25,20
1746538326728,SIO 295S,A00,894020,Staff,5,0,25,20
1746538327757,SIOC 290S,B01,958918,Merrifield; Mark A,14,0,30,16
1746538328788,SIOC 291S,B01,958922,Gabriel; Corey John,14,0,30,16
1746538329819,SOCI 117,A01,895339,Staff,3,0,5,2
1746538330846,WES 237B,A00,894149,Staff,11,0,20,9
1746538332968,AESE 279B,A00,891859,Staff,13,0,35,22
1746538333994,AIP 197,001,891854,Vespa; Emanuel Ignacio,9999,0,9999,0
1746538335032,ANTH 289S,A00,891856,Gagneux; Pascal,12,0,12,0
1746538336058,BENG 196,001,957946,Engler; Adam J.,9996,0,9999,3
1746538337086,BISP 197,001,959851,Wilhelm; James E.,9999,0,9999,0
1746538338115,CAT 124RS,A01,956906,Staff,6,0,25,19
1746538339166,CAT 125RS,A01,922013,Staff,6,0,25,19
1746538340196,CLRE 250,A00,891860,Morris; Sheldon,9995,0,9999,4
1746538342249,CLRE 251R,A00,907817,Mehta; Ravindra L.,9994,0,9999,5
1746538343276,CLRE 252,A00,891864,Cuomo; Raphael Eduardo,9993,0,9999,6
1746538344301,CLRE 253,A00,891867,Vaida; Florin,9994,0,9999,5
1746538344301,CLRE 253,B00,907819,Staff,9999,0,9999,0
1746538345327,CLRE 259,A00,891868,Patel; Hemal,9998,0,9999,1
1746538346358,CLRE 260,A00,891872,Cuomo; Raphael Eduardo,9999,0,9999,0
1746538347386,CLRE 297,001,891888,Cuomo; Raphael Eduardo,9999,0,9999,0
1746538348410,CSE 191,A00,958773,Minnes Kemp; Mor Mia,9996,0,9999,3
1746538349436,CSE 197,001,959846,Minnes Kemp; Mor Mia,9993,0,9999,6
1746538350468,CSS 201S,A01,892054,Mignozzetti; Umberto,26,0,30,4
1746538351493,CSS 202S,A01,892056,Mignozzetti; Umberto,26,0,30,4
1746538352518,DSC 197,001,956898,Eldridge; Justin Matthew,9998,0,9999,1
1746538353545,DSC 297,001,958000,Mazumdar; Arya,9998,0,9999,1
1746538353545,DSC 297,002,959862,Wang; Yusu,9999,0,9999,0
1746538354572,EAP 100,A00,905686,Staff,9778,0,9999,221
1746538355605,ECE 45,A01,892618,Staff,0,0,65,65
1746538357663,ECE 111,A01,892719,Staff,4,0,65,61
1746538358688,ECE 197,001,957920,Mercier; Patrick Philip,9991,0,9999,8
1746538359716,ECON 178,A01,907814,Zhu; Ying,26,0,35,9
1746538360746,EDS 115,A00,895312,Staff,36,0,45,9
1746538361772,EDS 117,A01,895337,Staff,24,0,30,6
1746538362800,EDS 125,A00,895341,Jones; Gabrielle Anastasia,37,0,45,8
1746538363828,EDS 128A,A01,895459,Fargason; Sharon Gayle,44,0,45,1
1746538364859,EDS 128B,A01,895543,Pappas; Elizabeth,44,0,45,1
1746538365889,EDS 139,A00,897203,Pappas; Elizabeth,44,0,45,1
1746538365889,EDS 139,B00,897209,Fargason; Sharon Gayle,41,0,45,4
1746538366914,EDS 201,A00,895545,Staff,23,0,45,22
1746538367943,EDS 203,A01,895581,Halter; Christopher P.,23,0,45,22
1746538368972,EDS 204R,A01,895625,Heinzman; Erica M.,39,0,45,6
1746538368972,EDS 204R,B01,895693,Halter; Christopher P.,10,0,45,35
1746538370005,EDS 206R,A00,895694,Fargason; Sharon Gayle,1,0,30,29
1746538370005,EDS 206R,B00,895695,Choi; Bailey Miyeon,16,0,30,14
1746538371031,EDS 250,A00,895697,Hemans; Patricia Ann Benitez,23,0,45,22
1746538372059,EDS 281,A00,895701,Meyerott; Theresa Ann,1,0,15,14
1746538373084,EDS 284,A00,895736,Meyerott; Theresa Ann,1,0,15,14
1746538374113,EDS 286,A00,897210,Fine; Sarah,0,0,15,15
1746538375140,EDS 289C,A01,895770,Daly; Alan J.,15,0,15,0
1746538376166,EDS 290,A00,897211,Hofstetter; Carolyn,0,0,15,15
1746538377200,LIGM 5A,A00,896162,Fischer-Grunski; Eva K,13,0,20,7
1746538378227,LIGM 5B,A00,896260,Fischer-Grunski; Eva K,17,0,20,3
1746538379252,LIGM 5C,A00,896308,Fischer-Grunski; Eva K,18,0,20,2
1746538380281,LIIT 5AS,A00,896313,Carnelos; Chiara,18,0,20,2
1746538381306,LIIT 5BS,A00,896416,Carnelos; Chiara,20,0,20,0
1746538382331,LIIT 5CS,A00,896564,Carnelos; Chiara,20,0,20,0
1746538383357,LISP 5A,A00,896588,Munoz Sanchez; Alicia,3,0,20,17
1746538384382,LISP 5B,A00,896653,Munoz Sanchez; Alicia,7,0,20,13
1746538385412,LISP 5C,A00,896655,Munoz Sanchez; Alicia,0,1,20,20
1746538386446,MAE 197,001,957918,Kleissl; Jan,9996,0,9999,3
1746538386446,MAE 197,002,959806,Boechler; Nicholas Sebastia,9998,0,9999,1
1746538386446,MAE 197,003,959852,Mullin; Jennifer S,9999,0,9999,0
1746538387511,MATH 2,A01,957937,Staff,33,0,35,2
1746538388537,MATH 197,001,957876,Kedlaya; Kiran S.,9993,0,9999,6
1746538389564,MCWP 40,A00,892729,Duru; Nur,10,0,20,10
1746538389564,MCWP 40,B00,893304,Montejo; Carolina,14,0,20,6
1746538390597,MCWP 40R,A00,893757,Redela; Pamela Morgan,0,5,20,20
1746538391623,MCWP 50,A00,893758,Morshed; Michael James,0,0,20,20
1746538391623,MCWP 50,B00,893761,Bartulis; Jason Michael,17,0,20,3
1746538392654,MCWP 50R,A00,893766,Compas; Sean Matthew,0,1,20,20
1746538392654,MCWP 50R,B00,893769,Carter; Jennifer A,0,1,20,20
1746538392654,MCWP 50R,C00,893771,Krone; Jarret,0,3,20,20
1746538392654,MCWP 50R,D00,893772,Miller; Elizabeth Deen,0,0,20,20
1746538392654,MCWP 50R,E00,893775,Carter; Andrea L,0,1,20,20
1746538393681,MMW 11R,A01,892721,Herbst; Matthew,11,0,27,16
1746538393681,MMW 11R,A02,892722,Herbst; Matthew,0,0,0,3
1746538394706,MMW 12R,A01,892724,Herbst; Matthew,0,11,16,16
1746538394706,MMW 12R,A02,892725,Herbst; Matthew,0,10,16,16
1746538395732,MMW 13R,A01,892727,Staff,0,4,16,16
1746538395732,MMW 13R,A02,892728,Staff,0,4,16,16
1746538395732,MMW 13R,A03,958032,Staff,0,4,16,16
1746538395732,MMW 13R,A04,958033,Staff,0,4,16,16
1746538395732,MMW 13R,A05,958034,Staff,0,4,16,16
1746538396759,SIO 295LS,A00,894015,Staff,5,0,25,20
1746538397783,SIO 295S,A00,894020,Staff,5,0,25,20
1746538398817,SIOC 290S,B01,958918,Merrifield; Mark A,14,0,30,16
1746538399845,SIOC 291S,B01,958922,Gabriel; Corey John,14,0,30,16
1746538400871,SOCI 117,A01,895339,Staff,3,0,5,2
1746538401898,WES 237B,A00,894149,Staff,11,0,20,9
1746538404013,AESE 279B,A00,891859,Staff,13,0,35,22
1746538405043,AIP 197,001,891854,Vespa; Emanuel Ignacio,9999,0,9999,0
1746538406073,ANTH 289S,A00,891856,Gagneux; Pascal,12,0,12,0
1746538407102,BENG 196,001,957946,Engler; Adam J.,9996,0,9999,3
1746538408134,BISP 197,001,959851,Wilhelm; James E.,9999,0,9999,0
1746538409160,CAT 124RS,A01,956906,Staff,6,0,25,19
1746538410189,CAT 125RS,A01,922013,Staff,6,0,25,19
1746538411213,CLRE 250,A00,891860,Morris; Sheldon,9995,0,9999,4
1746538413271,CLRE 251R,A00,907817,Mehta; Ravindra L.,9994,0,9999,5
1746538414297,CLRE 252,A00,891864,Cuomo; Raphael Eduardo,9993,0,9999,6
1746538415326,CLRE 253,A00,891867,Vaida; Florin,9994,0,9999,5
1746538415326,CLRE 253,B00,907819,Staff,9999,0,9999,0
1746538416352,CLRE 259,A00,891868,Patel; Hemal,9998,0,9999,1
1746538417380,CLRE 260,A00,891872,Cuomo; Raphael Eduardo,9999,0,9999,0
1746538418408,CLRE 297,001,891888,Cuomo; Raphael Eduardo,9999,0,9999,0
1746538419438,CSE 191,A00,958773,Minnes Kemp; Mor Mia,9996,0,9999,3
1746538420466,CSE 197,001,959846,Minnes Kemp; Mor Mia,9993,0,9999,6
1746538421492,CSS 201S,A01,892054,Mignozzetti; Umberto,26,0,30,4
1746538422521,CSS 202S,A01,892056,Mignozzetti; Umberto,26,0,30,4
1746538423547,DSC 197,001,956898,Eldridge; Justin Matthew,9998,0,9999,1
1746538424575,DSC 297,001,958000,Mazumdar; Arya,9998,0,9999,1
1746538424575,DSC 297,002,959862,Wang; Yusu,9999,0,9999,0
1746538425602,EAP 100,A00,905686,Staff,9778,0,9999,221
1746538426634,ECE 45,A01,892618,Staff,0,0,65,65
1746538428689,ECE 111,A01,892719,Staff,4,0,65,61
1746538429719,ECE 197,001,957920,Mercier; Patrick Philip,9991,0,9999,8
1746538430749,ECON 178,A01,907814,Zhu; Ying,26,0,35,9
1746538431779,EDS 115,A00,895312,Staff,36,0,45,9
1746538432805,EDS 117,A01,895337,Staff,24,0,30,6
1746538433832,EDS 125,A00,895341,Jones; Gabrielle Anastasia,37,0,45,8
1746538434858,EDS 128A,A01,895459,Fargason; Sharon Gayle,44,0,45,1
1746538435886,EDS 128B,A01,895543,Pappas; Elizabeth,44,0,45,1
1746538436912,EDS 139,A00,897203,Pappas; Elizabeth,44,0,45,1
1746538436912,EDS 139,B00,897209,Fargason; Sharon Gayle,41,0,45,4
1746538437940,EDS 201,A00,895545,Staff,23,0,45,22
1746538438967,EDS 203,A01,895581,Halter; Christopher P.,23,0,45,22
1746538439994,EDS 204R,A01,895625,Heinzman; Erica M.,39,0,45,6
1746538439994,EDS 204R,B01,895693,Halter; Christopher P.,10,0,45,35
1746538441025,EDS 206R,A00,895694,Fargason; Sharon Gayle,1,0,30,29
1746538441025,EDS 206R,B00,895695,Choi; Bailey Miyeon,16,0,30,14
1746538442051,EDS 250,A00,895697,Hemans; Patricia Ann Benitez,23,0,45,22
1746538443078,EDS 281,A00,895701,Meyerott; Theresa Ann,1,0,15,14
1746538444106,EDS 284,A00,895736,Meyerott; Theresa Ann,1,0,15,14
1746538445132,EDS 286,A00,897210,Fine; Sarah,0,0,15,15
1746538446165,EDS 289C,A01,895770,Daly; Alan J.,15,0,15,0
1746538447190,EDS 290,A00,897211,Hofstetter; Carolyn,0,0,15,15
1746538448223,LIGM 5A,A00,896162,Fischer-Grunski; Eva K,13,0,20,7
1746538449249,LIGM 5B,A00,896260,Fischer-Grunski; Eva K,17,0,20,3
1746538450278,LIGM 5C,A00,896308,Fischer-Grunski; Eva K,18,0,20,2
1746538451304,LIIT 5AS,A00,896313,Carnelos; Chiara,18,0,20,2
1746538452333,LIIT 5BS,A00,896416,Carnelos; Chiara,20,0,20,0
1746538453364,LIIT 5CS,A00,896564,Carnelos; Chiara,20,0,20,0
1746538454391,LISP 5A,A00,896588,Munoz Sanchez; Alicia,3,0,20,17
1746538455421,LISP 5B,A00,896653,Munoz Sanchez; Alicia,7,0,20,13
1746538456446,LISP 5C,A00,896655,Munoz Sanchez; Alicia,0,1,20,20
1746538457478,MAE 197,001,957918,Kleissl; Jan,9996,0,9999,3
1746538457478,MAE 197,002,959806,Boechler; Nicholas Sebastia,9998,0,9999,1
1746538457478,MAE 197,003,959852,Mullin; Jennifer S,9999,0,9999,0
1746538458503,MATH 2,A01,957937,Staff,33,0,35,2
1746538459529,MATH 197,001,957876,Kedlaya; Kiran S.,9993,0,9999,6
1746538460557,MCWP 40,A00,892729,Duru; Nur,10,0,20,10
1746538460557,MCWP 40,B00,893304,Montejo; Carolina,14,0,20,6
1746538461585,MCWP 40R,A00,893757,Redela; Pamela Morgan,0,5,20,20
1746538462611,MCWP 50,A00,893758,Morshed; Michael James,0,0,20,20
1746538462611,MCWP 50,B00,893761,Bartulis; Jason Michael,17,0,20,3
1746538463642,MCWP 50R,A00,893766,Compas; Sean Matthew,0,1,20,20
1746538463642,MCWP 50R,B00,893769,Carter; Jennifer A,0,1,20,20
1746538463642,MCWP 50R,C00,893771,Krone; Jarret,0,3,20,20
1746538463642,MCWP 50R,D00,893772,Miller; Elizabeth Deen,0,0,20,20
1746538463642,MCWP 50R,E00,893775,Carter; Andrea L,0,1,20,20
1746538464671,MMW 11R,A01,892721,Herbst; Matthew,11,0,27,16
1746538464671,MMW 11R,A02,892722,Herbst; Matthew,0,0,0,3
1746538465695,MMW 12R,A01,892724,Herbst; Matthew,0,11,16,16
1746538465695,MMW 12R,A02,892725,Herbst; Matthew,0,10,16,16
1746538466721,MMW 13R,A01,892727,Staff,0,4,16,16
1746538466721,MMW 13R,A02,892728,Staff,0,4,16,16
1746538466721,MMW 13R,A03,958032,Staff,0,4,16,16
1746538466721,MMW 13R,A04,958033,Staff,0,4,16,16
1746538466721,MMW 13R,A05,958034,Staff,0,4,16,16
1746538467750,SIO 295LS,A00,894015,Staff,5,0,25,20
1746538468776,SIO 295S,A00,894020,Staff,5,0,25,20
1746538469810,SIOC 290S,B01,958918,Merrifield; Mark A,14,0,30,16
1746538470843,SIOC 291S,B01,958922,Gabriel; Corey John,14,0,30,16
1746538471867,SOCI 117,A01,895339,Staff,3,0,5,2
1746538472892,WES 237B,A00,894149,Staff,11,0,20,9
1746538474988,AESE 279B,A00,891859,Staff,13,0,35,22
1746538476014,AIP 197,001,891854,Vespa; Emanuel Ignacio,9999,0,9999,0
1746538477045,ANTH 289S,A00,891856,Gagneux; Pascal,12,0,12,0
1746538478071,BENG 196,001,957946,Engler; Adam J.,9996,0,9999,3
1746538479097,BISP 197,001,959851,Wilhelm; James E.,9999,0,9999,0
1746538480127,CAT 124RS,A01,956906,Staff,6,0,25,19
1746538481153,CAT 125RS,A01,922013,Staff,6,0,25,19
1746538482180,CLRE 250,A00,891860,Morris; Sheldon,9995,0,9999,4
1746538484233,CLRE 251R,A00,907817,Mehta; Ravindra L.,9994,0,9999,5
1746538485262,CLRE 252,A00,891864,Cuomo; Raphael Eduardo,9993,0,9999,6
1746538486321,CLRE 253,A00,891867,Vaida; Florin,9994,0,9999,5
1746538486321,CLRE 253,B00,907819,Staff,9999,0,9999,0
1746538487346,CLRE 259,A00,891868,Patel; Hemal,9998,0,9999,1
1746538488375,CLRE 260,A00,891872,Cuomo; Raphael Eduardo,9999,0,9999,0
1746538489401,CLRE 297,001,891888,Cuomo; Raphael Eduardo,9999,0,9999,0
1746538490429,CSE 191,A00,958773,Minnes Kemp; Mor Mia,9996,0,9999,3
1746538491456,CSE 197,001,959846,Minnes Kemp; Mor Mia,9993,0,9999,6
1746538492482,CSS 201S,A01,892054,Mignozzetti; Umberto,26,0,30,4
1746538493509,CSS 202S,A01,892056,Mignozzetti; Umberto,26,0,30,4
1746538494535,DSC 197,001,956898,Eldridge; Justin Matthew,9998,0,9999,1
1746538495561,DSC 297,001,958000,Mazumdar; Arya,9998,0,9999,1
1746538495561,DSC 297,002,959862,Wang; Yusu,9999,0,9999,0
1746538496588,EAP 100,A00,905686,Staff,9778,0,9999,221
1746538497620,ECE 45,A01,892618,Staff,0,0,65,65
1746538499677,ECE 111,A01,892719,Staff,4,0,65,61
1746538500703,ECE 197,001,957920,Mercier; Patrick Philip,9991,0,9999,8
1746538501730,ECON 178,A01,907814,Zhu; Ying,26,0,35,9
1746538502753,EDS 115,A00,895312,Staff,36,0,45,9
1746538503778,EDS 117,A01,895337,Staff,24,0,30,6
1746538504810,EDS 125,A00,895341,Jones; Gabrielle Anastasia,37,0,45,8
1746538505840,EDS 128A,A01,895459,Fargason; Sharon Gayle,44,0,45,1
1746538506864,EDS 128B,A01,895543,Pappas; Elizabeth,44,0,45,1
1746538507892,EDS 139,A00,897203,Pappas; Elizabeth,44,0,45,1
1746538507892,EDS 139,B00,897209,Fargason; Sharon Gayle,41,0,45,4
1746538508920,EDS 201,A00,895545,Staff,23,0,45,22
1746538509949,EDS 203,A01,895581,Halter; Christopher P.,23,0,45,22
1746538510981,EDS 204R,A01,895625,Heinzman; Erica M.,39,0,45,6
1746538510981,EDS 204R,B01,895693,Halter; Christopher P.,10,0,45,35
1746538512011,EDS 206R,A00,895694,Fargason; Sharon Gayle,1,0,30,29
1746538512011,EDS 206R,B00,895695,Choi; Bailey Miyeon,16,0,30,14
1746538513041,EDS 250,A00,895697,Hemans; Patricia Ann Benitez,23,0,45,22
1746538514069,EDS 281,A00,895701,Meyerott; Theresa Ann,1,0,15,14
1746538515097,EDS 284,A00,895736,Meyerott; Theresa Ann,1,0,15,14
1746538516124,EDS 286,A00,897210,Fine; Sarah,0,0,15,15
1746538517148,EDS 289C,A01,895770,Daly; Alan J.,15,0,15,0
1746538518173,EDS 290,A00,897211,Hofstetter; Carolyn,0,0,15,15
1746538519204,LIGM 5A,A00,896162,Fischer-Grunski; Eva K,13,0,20,7
1746538520232,LIGM 5B,A00,896260,Fischer-Grunski; Eva K,17,0,20,3
1746538521260,LIGM 5C,A00,896308,Fischer-Grunski; Eva K,18,0,20,2
1746538522292,LIIT 5AS,A00,896313,Carnelos; Chiara,18,0,20,2
1746538523322,LIIT 5BS,A00,896416,Carnelos; Chiara,20,0,20,0
1746538524348,LIIT 5CS,A00,896564,Carnelos; Chiara,20,0,20,0
1746538525375,LISP 5A,A00,896588,Munoz Sanchez; Alicia,3,0,20,17
1746538526401,LISP 5B,A00,896653,Munoz Sanchez; Alicia,7,0,20,13
1746538527428,LISP 5C,A00,896655,Munoz Sanchez; Alicia,0,1,20,20
1746538528467,MAE 197,001,957918,Kleissl; Jan,9996,0,9999,3
1746538528467,MAE 197,002,959806,Boechler; Nicholas Sebastia,9998,0,9999,1
1746538528467,MAE 197,003,959852,Mullin; Jennifer S,9999,0,9999,0
1746538529494,MATH 2,A01,957937,Staff,33,0,35,2
1746538530522,MATH 197,001,957876,Kedlaya; Kiran S.,9993,0,9999,6
1746538531555,MCWP 40,A00,892729,Duru; Nur,10,0,20,10
1746538531555,MCWP 40,B00,893304,Montejo; Carolina,14,0,20,6
1746538532586,MCWP 40R,A00,893757,Redela; Pamela Morgan,0,5,20,20
1746538533616,MCWP 50,A00,893758,Morshed; Michael James,0,0,20,20
1746538533616,MCWP 50,B00,893761,Bartulis; Jason Michael,17,0,20,3
1746538534646,MCWP 50R,A00,893766,Compas; Sean Matthew,0,1,20,20
1746538534646,MCWP 50R,B00,893769,Carter; Jennifer A,0,1,20,20
1746538534646,MCWP 50R,C00,893771,Krone; Jarret,0,3,20,20
1746538534646,MCWP 50R,D00,893772,Miller; Elizabeth Deen,0,0,20,20
1746538534646,MCWP 50R,E00,893775,Carter; Andrea L,0,1,20,20
1746538535673,MMW 11R,A01,892721,Herbst; Matthew,11,0,27,16
1746538535673,MMW 11R,A02,892722,Herbst; Matthew,0,0,0,3
1746538536702,MMW 12R,A01,892724,Herbst; Matthew,0,11,16,16
1746538536702,MMW 12R,A02,892725,Herbst; Matthew,0,10,16,16
1746538537729,MMW 13R,A01,892727,Staff,0,4,16,16
1746538537729,MMW 13R,A02,892728,Staff,0,4,16,16
1746538537729,MMW 13R,A03,958032,Staff,0,4,16,16
1746538537729,MMW 13R,A04,958033,Staff,0,4,16,16
1746538537729,MMW 13R,A05,958034,Staff,0,4,16,16
1746538538756,SIO 295LS,A00,894015,Staff,5,0,25,20
1746538539782,SIO 295S,A00,894020,Staff,5,0,25,20
1746538540814,SIOC 290S,B01,958918,Merrifield; Mark A,14,0,30,16
1746538541842,SIOC 291S,B01,958922,Gabriel; Corey John,14,0,30,16
1746538542867,SOCI 117,A01,895339,Staff,3,0,5,2
1746538543892,WES 237B,A00,894149,Staff,11,0,20,9
1746538545969,AESE 279B,A00,891859,Staff,13,0,35,22
1746538546994,AIP 197,001,891854,Vespa; Emanuel Ignacio,9999,0,9999,0
1746538548020,ANTH 289S,A00,891856,Gagneux; Pascal,12,0,12,0
1746538549046,BENG 196,001,957946,Engler; Adam J.,9996,0,9999,3
1746538550070,BISP 197,001,959851,Wilhelm; James E.,9999,0,9999,0
1746538551100,CAT 124RS,A01,956906,Staff,6,0,25,19
1746538552125,CAT 125RS,A01,922013,Staff,6,0,25,19
1746538553148,CLRE 250,A00,891860,Morris; Sheldon,9995,0,9999,4
1746538555318,CLRE 251R,A00,907817,Mehta; Ravindra L.,9994,0,9999,5
1746538556344,CLRE 252,A00,891864,Cuomo; Raphael Eduardo,9993,0,9999,6
1746538557373,CLRE 253,A00,891867,Vaida; Florin,9994,0,9999,5
1746538557373,CLRE 253,B00,907819,Staff,9999,0,9999,0
1746538558402,CLRE 259,A00,891868,Patel; Hemal,9998,0,9999,1
1746538559427,CLRE 260,A00,891872,Cuomo; Raphael Eduardo,9999,0,9999,0
1746538560451,CLRE 297,001,891888,Cuomo; Raphael Eduardo,9999,0,9999,0
1746538561478,CSE 191,A00,958773,Minnes Kemp; Mor Mia,9996,0,9999,3
1746538562504,CSE 197,001,959846,Minnes Kemp; Mor Mia,9993,0,9999,6
1746538563535,CSS 201S,A01,892054,Mignozzetti; Umberto,26,0,30,4
1746538564565,CSS 202S,A01,892056,Mignozzetti; Umberto,26,0,30,4
1746538565596,DSC 197,001,956898,Eldridge; Justin Matthew,9998,0,9999,1
1746538566623,DSC 297,001,958000,Mazumdar; Arya,9998,0,9999,1
1746538566623,DSC 297,002,959862,Wang; Yusu,9999,0,9999,0
1746538567655,EAP 100,A00,905686,Staff,9778,0,9999,221
1746538568684,ECE 45,A01,892618,Staff,0,0,65,65
1746538570740,ECE 111,A01,892719,Staff,4,0,65,61
1746538571764,ECE 197,001,957920,Mercier; Patrick Philip,9991,0,9999,8
1746538572793,ECON 178,A01,907814,Zhu; Ying,26,0,35,9
1746538573819,EDS 115,A00,895312,Staff,36,0,45,9
1746538574848,EDS 117,A01,895337,Staff,24,0,30,6
1746538575876,EDS 125,A00,895341,Jones; Gabrielle Anastasia,37,0,45,8
1746538576919,EDS 128A,A01,895459,Fargason; Sharon Gayle,44,0,45,1
1746538577945,EDS 128B,A01,895543,Pappas; Elizabeth,44,0,45,1
1746538578974,EDS 139,A00,897203,Pappas; Elizabeth,44,0,45,1
1746538578974,EDS 139,B00,897209,Fargason; Sharon Gayle,41,0,45,4
1746538580000,EDS 201,A00,895545,Staff,23,0,45,22
1746538581028,EDS 203,A01,895581,Halter; Christopher P.,23,0,45,22
1746538582061,EDS 204R,A01,895625,Heinzman; Erica M.,39,0,45,6
1746538582061,EDS 204R,B01,895693,Halter; Christopher P.,10,0,45,35
1746538583090,EDS 206R,A00,895694,Fargason; Sharon Gayle,1,0,30,29
1746538583090,EDS 206R,B00,895695,Choi; Bailey Miyeon,16,0,30,14
1746538584117,EDS 250,A00,895697,Hemans; Patricia Ann Benitez,23,0,45,22
1746538585146,EDS 281,A00,895701,Meyerott; Theresa Ann,1,0,15,14
1746538586174,EDS 284,A00,895736,Meyerott; Theresa Ann,1,0,15,14
1746538587200,EDS 286,A00,897210,Fine; Sarah,0,0,15,15
1746538588246,EDS 289C,A01,895770,Daly; Alan J.,15,0,15,0
1746538589272,EDS 290,A00,897211,Hofstetter; Carolyn,0,0,15,15
1746538590300,LIGM 5A,A00,896162,Fischer-Grunski; Eva K,13,0,20,7
1746538591332,LIGM 5B,A00,896260,Fischer-Grunski; Eva K,17,0,20,3
1746538592361,LIGM 5C,A00,896308,Fischer-Grunski; Eva K,18,0,20,2
1746538593390,LIIT 5AS,A00,896313,Carnelos; Chiara,18,0,20,2
1746538594422,LIIT 5BS,A00,896416,Carnelos; Chiara,20,0,20,0
1746538595452,LIIT 5CS,A00,896564,Carnelos; Chiara,20,0,20,0
1746538596478,LISP 5A,A00,896588,Munoz Sanchez; Alicia,3,0,20,17
1746538597506,LISP 5B,A00,896653,Munoz Sanchez; Alicia,7,0,20,13
1746538598567,LISP 5C,A00,896655,Munoz Sanchez; Alicia,0,1,20,20
1746538599610,MAE 197,001,957918,Kleissl; Jan,9996,0,9999,3
1746538599610,MAE 197,002,959806,Boechler; Nicholas Sebastia,9998,0,9999,1
1746538599610,MAE 197,003,959852,Mullin; Jennifer S,9999,0,9999,0
1746538600639,MATH 2,A01,957937,Staff,33,0,35,2
1746538601671,MATH 197,001,957876,Kedlaya; Kiran S.,9993,0,9999,6
1746538602706,MCWP 40,A00,892729,Duru; Nur,10,0,20,10
1746538602706,MCWP 40,B00,893304,Montejo; Carolina,14,0,20,6
1746538603735,MCWP 40R,A00,893757,Redela; Pamela Morgan,0,5,20,20
1746538604762,MCWP 50,A00,893758,Morshed; Michael James,0,0,20,20
1746538604762,MCWP 50,B00,893761,Bartulis; Jason Michael,17,0,20,3
1746538605791,MCWP 50R,A00,893766,Compas; Sean Matthew,0,1,20,20
1746538605791,MCWP 50R,B00,893769,Carter; Jennifer A,0,1,20,20
1746538605791,MCWP 50R,C00,893771,Krone; Jarret,0,3,20,20
1746538605791,MCWP 50R,D00,893772,Miller; Elizabeth Deen,0,0,20,20
1746538605791,MCWP 50R,E00,893775,Carter; Andrea L,0,1,20,20
1746538606824,MMW 11R,A01,892721,Herbst; Matthew,11,0,27,16
1746538606824,MMW 11R,A02,892722,Herbst; Matthew,0,0,0,3
1746538607850,MMW 12R,A01,892724,Herbst; Matthew,0,11,16,16
1746538607850,MMW 12R,A02,892725,Herbst; Matthew,0,10,16,16
1746538608875,MMW 13R,A01,892727,Staff,0,4,16,16
1746538608875,MMW 13R,A02,892728,Staff,0,4,16,16
1746538608875,MMW 13R,A03,958032,Staff,0,4,16,16
1746538608875,MMW 13R,A04,958033,Staff,0,4,16,16
1746538608875,MMW 13R,A05,958034,Staff,0,4,16,16
1746538609905,SIO 295LS,A00,894015,Staff,5,0,25,20
1746538611004,SIO 295S,A00,894020,Staff,5,0,25,20
1746538612084,SIOC 290S,B01,958918,Merrifield; Mark A,14,0,30,16
1746538613118,SIOC 291S,B01,958922,Gabriel; Corey John,14,0,30,16
1746538614141,SOCI 117,A01,895339,Staff,3,0,5,2
1746538615169,WES 237B,A00,894149,Staff,11,0,20,9
1746538617250,AESE 279B,A00,891859,Staff,13,0,35,22
1746538618277,AIP 197,001,891854,Vespa; Emanuel Ignacio,9999,0,9999,0
1746538619305,ANTH 289S,A00,891856,Gagneux; Pascal,12,0,12,0
1746538620335,BENG 196,001,957946,Engler; Adam J.,9996,0,9999,3
1746538621365,BISP 197,001,959851,Wilhelm; James E.,9999,0,9999,0
1746538622404,CAT 124RS,A01,956906,Staff,6,0,25,19
1746538623430,CAT 125RS,A01,922013,Staff,6,0,25,19
1746538624468,CLRE 250,A00,891860,Morris; Sheldon,9995,0,9999,4
1746538626525,CLRE 251R,A00,907817,Mehta; Ravindra L.,9994,0,9999,5
1746538627553,CLRE 252,A00,891864,Cuomo; Raphael Eduardo,9993,0,9999,6
1746538628583,CLRE 253,A00,891867,Vaida; Florin,9994,0,9999,5
1746538628583,CLRE 253,B00,907819,Staff,9999,0,9999,0
1746538629610,CLRE 259,A00,891868,Patel; Hemal,9998,0,9999,1
1746538630638,CLRE 260,A00,891872,Cuomo; Raphael Eduardo,9999,0,9999,0
1746538631673,CLRE 297,001,891888,Cuomo; Raphael Eduardo,9999,0,9999,0
1746538632705,CSE 191,A00,958773,Minnes Kemp; Mor Mia,9996,0,9999,3
1746538633790,CSE 197,001,959846,Minnes Kemp; Mor Mia,9993,0,9999,6
1746538634816,CSS 201S,A01,892054,Mignozzetti; Umberto,26,0,30,4
1746538635842,CSS 202S,A01,892056,Mignozzetti; Umberto,26,0,30,4
1746538636865,DSC 197,001,956898,Eldridge; Justin Matthew,9998,0,9999,1
1746538637890,DSC 297,001,958000,Mazumdar; Arya,9998,0,9999,1
1746538637890,DSC 297,002,959862,Wang; Yusu,9999,0,9999,0
1746538638918,EAP 100,A00,905686,Staff,9778,0,9999,221
1746538639951,ECE 45,A01,892618,Staff,0,0,65,65
1746538642001,ECE 111,A01,892719,Staff,4,0,65,61
1746538643030,ECE 197,001,957920,Mercier; Patrick Philip,9991,0,9999,8
1746538644058,ECON 178,A01,907814,Zhu; Ying,26,0,35,9
1746538645084,EDS 115,A00,895312,Staff,36,0,45,9
1746538646114,EDS 117,A01,895337,Staff,24,0,30,6
1746538647148,EDS 125,A00,895341,Jones; Gabrielle Anastasia,37,0,45,8
1746538648179,EDS 128A,A01,895459,Fargason; Sharon Gayle,44,0,45,1
1746538649206,EDS 128B,A01,895543,Pappas; Elizabeth,44,0,45,1
1746538650231,EDS 139,A00,897203,Pappas; Elizabeth,44,0,45,1
1746538650231,EDS 139,B00,897209,Fargason; Sharon Gayle,41,0,45,4
1746538651259,EDS 201,A00,895545,Staff,23,0,45,22
1746538652286,EDS 203,A01,895581,Halter; Christopher P.,23,0,45,22
1746538653319,EDS 204R,A01,895625,Heinzman; Erica M.,39,0,45,6
1746538653319,EDS 204R,B01,895693,Halter; Christopher P.,10,0,45,35
1746538654345,EDS 206R,A00,895694,Fargason; Sharon Gayle,1,0,30,29
1746538654345,EDS 206R,B00,895695,Choi; Bailey Miyeon,16,0,30,14
1746538655371,EDS 250,A00,895697,Hemans; Patricia Ann Benitez,23,0,45,22
1746538656396,EDS 281,A00,895701,Meyerott; Theresa Ann,1,0,15,14
1746538657420,EDS 284,A00,895736,Meyerott; Theresa Ann,1,0,15,14
1746538658449,EDS 286,A00,897210,Fine; Sarah,0,0,15,15
1746538659474,EDS 289C,A01,895770,Daly; Alan J.,15,0,15,0
1746538660503,EDS 290,A00,897211,Hofstetter; Carolyn,0,0,15,15
1746538661531,LIGM 5A,A00,896162,Fischer-Grunski; Eva K,13,0,20,7
1746538662560,LIGM 5B,A00,896260,Fischer-Grunski; Eva K,17,0,20,3
1746538663588,LIGM 5C,A00,896308,Fischer-Grunski; Eva K,18,0,20,2
1746538664620,LIIT 5AS,A00,896313,Carnelos; Chiara,18,0,20,2
1746538665646,LIIT 5BS,A00,896416,Carnelos; Chiara,20,0,20,0
1746538666672,LIIT 5CS,A00,896564,Carnelos; Chiara,20,0,20,0
1746538667709,LISP 5A,A00,896588,Munoz Sanchez; Alicia,3,0,20,17
1746538668743,LISP 5B,A00,896653,Munoz Sanchez; Alicia,7,0,20,13
1746538669773,LISP 5C,A00,896655,Munoz Sanchez; Alicia,0,1,20,20
1746538670807,MAE 197,001,957918,Kleissl; Jan,9996,0,9999,3
1746538670807,MAE 197,002,959806,Boechler; Nicholas Sebastia,9998,0,9999,1
1746538670807,MAE 197,003,959852,Mullin; Jennifer S,9999,0,9999,0
1746538671832,MATH 2,A01,957937,Staff,33,0,35,2
1746538672857,MATH 197,001,957876,Kedlaya; Kiran S.,9993,0,9999,6
1746538673890,MCWP 40,A00,892729,Duru; Nur,10,0,20,10
1746538673890,MCWP 40,B00,893304,Montejo; Carolina,14,0,20,6
1746538674923,MCWP 40R,A00,893757,Redela; Pamela Morgan,0,5,20,20
1746538675952,MCWP 50,A00,893758,Morshed; Michael James,0,0,20,20
1746538675952,MCWP 50,B00,893761,Bartulis; Jason Michael,17,0,20,3
1746538679756,MCWP 50R,A00,893766,Compas; Sean Matthew,0,1,20,20
1746538679756,MCWP 50R,B00,893769,Carter; Jennifer A,0,1,20,20
1746538679756,MCWP 50R,C00,893771,Krone; Jarret,0,3,20,20
1746538679756,MCWP 50R,D00,893772,Miller; Elizabeth Deen,0,0,20,20
1746538679756,MCWP 50R,E00,893775,Carter; Andrea L,0,1,20,20
1746538680779,MMW 11R,A01,892721,Herbst; Matthew,11,0,27,16
1746538680779,MMW 11R,A02,892722,Herbst; Matthew,0,0,0,3
1746538681811,MMW 12R,A01,892724,Herbst; Matthew,0,11,16,16
1746538681811,MMW 12R,A02,892725,Herbst; Matthew,0,10,16,16
1746538682840,MMW 13R,A01,892727,Staff,0,4,16,16
1746538682840,MMW 13R,A02,892728,Staff,0,4,16,16
1746538682840,MMW 13R,A03,958032,Staff,0,4,16,16
1746538682840,MMW 13R,A04,958033,Staff,0,4,16,16
1746538682840,MMW 13R,A05,958034,Staff,0,4,16,16
1746538683870,SIO 295LS,A00,894015,Staff,5,0,25,20
1746538684894,SIO 295S,A00,894020,Staff,5,0,25,20
1746538685923,SIOC 290S,B01,958918,Merrifield; Mark A,14,0,30,16
1746538686957,SIOC 291S,B01,958922,Gabriel; Corey John,14,0,30,16
1746538687986,SOCI 117,A01,895339,Staff,3,0,5,2
1746538689011,WES 237B,A00,894149,Staff,11,0,20,9
1746538691086,AESE 279B,A00,891859,Staff,13,0,35,22
1746538692113,AIP 197,001,891854,Vespa; Emanuel Ignacio,9999,0,9999,0
1746538693141,ANTH 289S,A00,891856,Gagneux; Pascal,12,0,12,0
1746538694170,BENG 196,001,957946,Engler; Adam J.,9996,0,9999,3
1746538695197,BISP 197,001,959851,Wilhelm; James E.,9999,0,9999,0
1746538696225,CAT 124RS,A01,956906,Staff,6,0,25,19
1746538697256,CAT 125RS,A01,922013,Staff,6,0,25,19
1746538698281,CLRE 250,A00,891860,Morris; Sheldon,9995,0,9999,4
1746538700335,CLRE 251R,A00,907817,Mehta; Ravindra L.,9994,0,9999,5
1746538701360,CLRE 252,A00,891864,Cuomo; Raphael Eduardo,9993,0,9999,6
1746538702388,CLRE 253,A00,891867,Vaida; Florin,9994,0,9999,5
1746538702388,CLRE 253,B00,907819,Staff,9999,0,9999,0
1746538703411,CLRE 259,A00,891868,Patel; Hemal,9998,0,9999,1
1746538704436,CLRE 260,A00,891872,Cuomo; Raphael Eduardo,9999,0,9999,0
1746538705460,CLRE 297,001,891888,Cuomo; Raphael Eduardo,9999,0,9999,0
1746538706487,CSE 191,A00,958773,Minnes Kemp; Mor Mia,9996,0,9999,3
1746538707512,CSE 197,001,959846,Minnes Kemp; Mor Mia,9993,0,9999,6
1746538708538,CSS 201S,A01,892054,Mignozzetti; Umberto,26,0,30,4
1746538709564,CSS 202S,A01,892056,Mignozzetti; Umberto,26,0,30,4
1746538710591,DSC 197,001,956898,Eldridge; Justin Matthew,9998,0,9999,1
1746538711618,DSC 297,001,958000,Mazumdar; Arya,9998,0,9999,1
1746538711618,DSC 297,002,959862,Wang; Yusu,9999,0,9999,0
1746538712645,EAP 100,A00,905686,Staff,9778,0,9999,221
1746538713673,ECE 45,A01,892618,Staff,0,0,65,65
1746538715724,ECE 111,A01,892719,Staff,4,0,65,61
1746538716749,ECE 197,001,957920,Mercier; Patrick Philip,9991,0,9999,8
1746538717777,ECON 178,A01,907814,Zhu; Ying,26,0,35,9
1746538718806,EDS 115,A00,895312,Staff,36,0,45,9
1746538719834,EDS 117,A01,895337,Staff,24,0,30,6
1746538720863,EDS 125,A00,895341,Jones; Gabrielle Anastasia,37,0,45,8
1746538721898,EDS 128A,A01,895459,Fargason; Sharon Gayle,44,0,45,1
1746538722923,EDS 128B,A01,895543,Pappas; Elizabeth,44,0,45,1
1746538723949,EDS 139,A00,897203,Pappas; Elizabeth,44,0,45,1
1746538723949,EDS 139,B00,897209,Fargason; Sharon Gayle,41,0,45,4
1746538724979,EDS 201,A00,895545,Staff,23,0,45,22
1746538726006,EDS 203,A01,895581,Halter; Christopher P.,23,0,45,22
1746538727033,EDS 204R,A01,895625,Heinzman; Erica M.,39,0,45,6
1746538727033,EDS 204R,B01,895693,Halter; Christopher P.,10,0,45,35
1746538728059,EDS 206R,A00,895694,Fargason; Sharon Gayle,1,0,30,29
1746538728059,EDS 206R,B00,895695,Choi; Bailey Miyeon,16,0,30,14
1746538729082,EDS 250,A00,895697,Hemans; Patricia Ann Benitez,23,0,45,22
1746538730112,EDS 281,A00,895701,Meyerott; Theresa Ann,1,0,15,14
1746538731144,EDS 284,A00,895736,Meyerott; Theresa Ann,1,0,15,14
1746538732170,EDS 286,A00,897210,Fine; Sarah,0,0,15,15
1746538733195,EDS 289C,A01,895770,Daly; Alan J.,15,0,15,0
1746538734220,EDS 290,A00,897211,Hofstetter; Carolyn,0,0,15,15
1746538735245,LIGM 5A,A00,896162,Fischer-Grunski; Eva K,13,0,20,7
1746538736271,LIGM 5B,A00,896260,Fischer-Grunski; Eva K,17,0,20,3
1746538737297,LIGM 5C,A00,896308,Fischer-Grunski; Eva K,18,0,20,2
1746538738321,LIIT 5AS,A00,896313,Carnelos; Chiara,18,0,20,2
1746538739349,LIIT 5BS,A00,896416,Carnelos; Chiara,20,0,20,0
1746538740376,LIIT 5CS,A00,896564,Carnelos; Chiara,20,0,20,0
1746538741406,LISP 5A,A00,896588,Munoz Sanchez; Alicia,3,0,20,17
1746538742433,LISP 5B,A00,896653,Munoz Sanchez; Alicia,7,0,20,13
1746538743467,LISP 5C,A00,896655,Munoz Sanchez; Alicia,0,1,20,20
1746538744502,MAE 197,001,957918,Kleissl; Jan,9996,0,9999,3
1746538744502,MAE 197,002,959806,Boechler; Nicholas Sebastia,9998,0,9999,1
1746538744502,MAE 197,003,959852,Mullin; Jennifer S,9999,0,9999,0
1746538745530,MATH 2,A01,957937,Staff,33,0,35,2
1746538746557,MATH 197,001,957876,Kedlaya; Kiran S.,9993,0,9999,6
1746538747587,MCWP 40,A00,892729,Duru; Nur,10,0,20,10
1746538747587,MCWP 40,B00,893304,Montejo; Carolina,14,0,20,6
1746538748614,MCWP 40R,A00,893757,Redela; Pamela Morgan,0,5,20,20
1746538749647,MCWP 50,A00,893758,Morshed; Michael James,0,0,20,20
1746538749647,MCWP 50,B00,893761,Bartulis; Jason Michael,17,0,20,3
1746538750676,MCWP 50R,A00,893766,Compas; Sean Matthew,0,1,20,20
1746538750676,MCWP 50R,B00,893769,Carter; Jennifer A,0,1,20,20
1746538750676,MCWP 50R,C00,893771,Krone; Jarret,0,3,20,20
1746538750676,MCWP 50R,D00,893772,Miller; Elizabeth Deen,0,0,20,20
1746538750676,MCWP 50R,E00,893775,Carter; Andrea L,0,1,20,20
1746538751705,MMW 11R,A01,892721,Herbst; Matthew,11,0,27,16
1746538751705,MMW 11R,A02,892722,Herbst; Matthew,0,0,0,3
1746538752734,MMW 12R,A01,892724,Herbst; Matthew,0,11,16,16
1746538752734,MMW 12R,A02,892725,Herbst; Matthew,0,10,16,16
1746538753764,MMW 13R,A01,892727,Staff,0,4,16,16
1746538753764,MMW 13R,A02,892728,Staff,0,4,16,16
1746538753764,MMW 13R,A03,958032,Staff,0,4,16,16
1746538753764,MMW 13R,A04,958033,Staff,0,4,16,16
1746538753764,MMW 13R,A05,958034,Staff,0,4,16,16
1746538754789,SIO 295LS,A00,894015,Staff,5,0,25,20
1746538755815,SIO 295S,A00,894020,Staff,5,0,25,20
1746538756843,SIOC 290S,B01,958918,Merrifield; Mark A,14,0,30,16
1746538757870,SIOC 291S,B01,958922,Gabriel; Corey John,14,0,30,16
1746538758896,SOCI 117,A01,895339,Staff,3,0,5,2
1746538759922,WES 237B,A00,894149,Staff,11,0,20,9
1746538762007,AESE 279B,A00,891859,Staff,13,0,35,22
1746538763034,AIP 197,001,891854,Vespa; Emanuel Ignacio,9999,0,9999,0
1746538764064,ANTH 289S,A00,891856,Gagneux; Pascal,12,0,12,0
1746538765093,BENG 196,001,957946,Engler; Adam J.,9996,0,9999,3
1746538766121,BISP 197,001,959851,Wilhelm; James E.,9999,0,9999,0
1746538767149,CAT 124RS,A01,956906,Staff,6,0,25,19
1746538768177,CAT 125RS,A01,922013,Staff,6,0,25,19
1746538769207,CLRE 250,A00,891860,Morris; Sheldon,9995,0,9999,4
1746538771263,CLRE 251R,A00,907817,Mehta; Ravindra L.,9994,0,9999,5
1746538772290,CLRE 252,A00,891864,Cuomo; Raphael Eduardo,9993,0,9999,6
1746538773316,CLRE 253,A00,891867,Vaida; Florin,9994,0,9999,5
1746538773316,CLRE 253,B00,907819,Staff,9999,0,9999,0
1746538774341,CLRE 259,A00,891868,Patel; Hemal,9998,0,9999,1
1746538775367,CLRE 260,A00,891872,Cuomo; Raphael Eduardo,9999,0,9999,0
1746538776396,CLRE 297,001,891888,Cuomo; Raphael Eduardo,9999,0,9999,0
1746538777421,CSE 191,A00,958773,Minnes Kemp; Mor Mia,9996,0,9999,3
1746538778449,CSE 197,001,959846,Minnes Kemp; Mor Mia,9993,0,9999,6
1746538779476,CSS 201S,A01,892054,Mignozzetti; Umberto,26,0,30,4
1746538780508,CSS 202S,A01,892056,Mignozzetti; Umberto,26,0,30,4
1746538781535,DSC 197,001,956898,Eldridge; Justin Matthew,9998,0,9999,1
1746538782562,DSC 297,001,958000,Mazumdar; Arya,9998,0,9999,1
1746538782562,DSC 297,002,959862,Wang; Yusu,9999,0,9999,0
1746538783589,EAP 100,A00,905686,Staff,9778,0,9999,221
1746538784622,ECE 45,A01,892618,Staff,0,0,65,65
1746538786683,ECE 111,A01,892719,Staff,4,0,65,61
1746538787717,ECE 197,001,957920,Mercier; Patrick Philip,9991,0,9999,8
1746538788750,ECON 178,A01,907814,Zhu; Ying,26,0,35,9
1746538789778,EDS 115,A00,895312,Staff,36,0,45,9
1746538790806,EDS 117,A01,895337,Staff,24,0,30,6
1746538791833,EDS 125,A00,895341,Jones; Gabrielle Anastasia,37,0,45,8
1746538792863,EDS 128A,A01,895459,Fargason; Sharon Gayle,44,0,45,1
1746538793895,EDS 128B,A01,895543,Pappas; Elizabeth,44,0,45,1
1746538794922,EDS 139,A00,897203,Pappas; Elizabeth,44,0,45,1
1746538794922,EDS 139,B00,897209,Fargason; Sharon Gayle,41,0,45,4
1746538795949,EDS 201,A00,895545,Staff,23,0,45,22
1746538796975,EDS 203,A01,895581,Halter; Christopher P.,23,0,45,22
1746538798001,EDS 204R,A01,895625,Heinzman; Erica M.,39,0,45,6
1746538798001,EDS 204R,B01,895693,Halter; Christopher P.,10,0,45,35
1746538799027,EDS 206R,A00,895694,Fargason; Sharon Gayle,1,0,30,29
1746538799027,EDS 206R,B00,895695,Choi; Bailey Miyeon,16,0,30,14
1746538800053,EDS 250,A00,895697,Hemans; Patricia Ann Benitez,23,0,45,22
1746538801078,EDS 281,A00,895701,Meyerott; Theresa Ann,1,0,15,14
1746538802103,EDS 284,A00,895736,Meyerott; Theresa Ann,1,0,15,14
1746538803129,EDS 286,A00,897210,Fine; Sarah,0,0,15,15
1746538804157,EDS 289C,A01,895770,Daly; Alan J.,15,0,15,0
1746538805183,EDS 290,A00,897211,Hofstetter; Carolyn,0,0,15,15
1746538806214,LIGM 5A,A00,896162,Fischer-Grunski; Eva K,13,0,20,7
1746538807245,LIGM 5B,A00,896260,Fischer-Grunski; Eva K,17,0,20,3
1746538808274,LIGM 5C,A00,896308,Fischer-Grunski; Eva K,18,0,20,2
1746538809301,LIIT 5AS,A00,896313,Carnelos; Chiara,18,0,20,2
1746538810327,LIIT 5BS,A00,896416,Carnelos; Chiara,20,0,20,0
1746538811353,LIIT 5CS,A00,896564,Carnelos; Chiara,20,0,20,0
1746538812380,LISP 5A,A00,896588,Munoz Sanchez; Alicia,3,0,20,17
1746538813404,LISP 5B,A00,896653,Munoz Sanchez; Alicia,7,0,20,13
1746538814431,LISP 5C,A00,896655,Munoz Sanchez; Alicia,0,1,20,20
1746538815463,MAE 197,001,957918,Kleissl; Jan,9996,0,9999,3
1746538815463,MAE 197,002,959806,Boechler; Nicholas Sebastia,9998,0,9999,1
1746538815463,MAE 197,003,959852,Mullin; Jennifer S,9999,0,9999,0
1746538816489,MATH 2,A01,957937,Staff,33,0,35,2
1746538817518,MATH 197,001,957876,Kedlaya; Kiran S.,9993,0,9999,6
1746538818546,MCWP 40,A00,892729,Duru; Nur,10,0,20,10
1746538818546,MCWP 40,B00,893304,Montejo; Carolina,14,0,20,6
1746538819573,MCWP 40R,A00,893757,Redela; Pamela Morgan,0,5,20,20
1746538820605,MCWP 50,A00,893758,Morshed; Michael James,0,0,20,20
1746538820605,MCWP 50,B00,893761,Bartulis; Jason Michael,17,0,20,3
1746538821639,MCWP 50R,A00,893766,Compas; Sean Matthew,0,1,20,20
1746538821639,MCWP 50R,B00,893769,Carter; Jennifer A,0,1,20,20
1746538821639,MCWP 50R,C00,893771,Krone; Jarret,0,3,20,20
1746538821639,MCWP 50R,D00,893772,Miller; Elizabeth Deen,0,0,20,20
1746538821639,MCWP 50R,E00,893775,Carter; Andrea L,0,1,20,20
1746538822673,MMW 11R,A01,892721,Herbst; Matthew,11,0,27,16
1746538822673,MMW 11R,A02,892722,Herbst; Matthew,0,0,0,3
1746538823703,MMW 12R,A01,892724,Herbst; Matthew,0,11,16,16
1746538823703,MMW 12R,A02,892725,Herbst; Matthew,0,10,16,16
1746538824736,MMW 13R,A01,892727,Staff,0,4,16,16
1746538824736,MMW 13R,A02,892728,Staff,0,4,16,16
1746538824736,MMW 13R,A03,958032,Staff,0,4,16,16
1746538824736,MMW 13R,A04,958033,Staff,0,4,16,16
1746538824736,MMW 13R,A05,958034,Staff,0,4,16,16
1746538825763,SIO 295LS,A00,894015,Staff,5,0,25,20
1746538826790,SIO 295S,A00,894020,Staff,5,0,25,20
1746538827826,SIOC 290S,B01,958918,Merrifield; Mark A,14,0,30,16
1746538828852,SIOC 291S,B01,958922,Gabriel; Corey John,14,0,30,16
1746538829879,SOCI 117,A01,895339,Staff,3,0,5,2
1746538830904,WES 237B,A00,894149,Staff,11,0,20,9
1746538832977,AESE 279B,A00,891859,Staff,13,0,35,22
1746538834008,AIP 197,001,891854,Vespa; Emanuel Ignacio,9999,0,9999,0
1746538835039,ANTH 289S,A00,891856,Gagneux; Pascal,12,0,12,0
1746538836065,BENG 196,001,957946,Engler; Adam J.,9996,0,9999,3
1746538837107,BISP 197,001,959851,Wilhelm; James E.,9999,0,9999,0
1746538838132,CAT 124RS,A01,956906,Staff,6,0,25,19
1746538839161,CAT 125RS,A01,922013,Staff,6,0,25,19
1746538840187,CLRE 250,A00,891860,Morris; Sheldon,9995,0,9999,4
1746538842242,CLRE 251R,A00,907817,Mehta; Ravindra L.,9994,0,9999,5
1746538843267,CLRE 252,A00,891864,Cuomo; Raphael Eduardo,9993,0,9999,6
1746538844292,CLRE 253,A00,891867,Vaida; Florin,9994,0,9999,5
1746538844292,CLRE 253,B00,907819,Staff,9999,0,9999,0
1746538845323,CLRE 259,A00,891868,Patel; Hemal,9998,0,9999,1
1746538846349,CLRE 260,A00,891872,Cuomo; Raphael Eduardo,9999,0,9999,0
1746538847375,CLRE 297,001,891888,Cuomo; Raphael Eduardo,9999,0,9999,0
1746538848401,CSE 191,A00,958773,Minnes Kemp; Mor Mia,9996,0,9999,3
1746538849425,CSE 197,001,959846,Minnes Kemp; Mor Mia,9993,0,9999,6
1746538850453,CSS 201S,A01,892054,Mignozzetti; Umberto,26,0,30,4
1746538851482,CSS 202S,A01,892056,Mignozzetti; Umberto,26,0,30,4
1746538852507,DSC 197,001,956898,Eldridge; Justin Matthew,9998,0,9999,1
1746538853535,DSC 297,001,958000,Mazumdar; Arya,9998,0,9999,1
1746538853535,DSC 297,002,959862,Wang; Yusu,9999,0,9999,0
1746538854563,EAP 100,A00,905686,Staff,9778,0,9999,221
1746538855592,ECE 45,A01,892618,Staff,0,0,65,65
1746538857650,ECE 111,A01,892719,Staff,4,0,65,61
1746538858679,ECE 197,001,957920,Mercier; Patrick Philip,9991,0,9999,8
1746538859706,ECON 178,A01,907814,Zhu; Ying,26,0,35,9
1746538860732,EDS 115,A00,895312,Staff,36,0,45,9
1746538861761,EDS 117,A01,895337,Staff,24,0,30,6
1746538862787,EDS 125,A00,895341,Jones; Gabrielle Anastasia,37,0,45,8
1746538863815,EDS 128A,A01,895459,Fargason; Sharon Gayle,44,0,45,1
1746538864844,EDS 128B,A01,895543,Pappas; Elizabeth,44,0,45,1
1746538865872,EDS 139,A00,897203,Pappas; Elizabeth,44,0,45,1
1746538865872,EDS 139,B00,897209,Fargason; Sharon Gayle,41,0,45,4
1746538866899,EDS 201,A00,895545,Staff,23,0,45,22
1746538867929,EDS 203,A01,895581,Halter; Christopher P.,23,0,45,22
1746538868962,EDS 204R,A01,895625,Heinzman; Erica M.,39,0,45,6
1746538868962,EDS 204R,B01,895693,Halter; Christopher P.,10,0,45,35
1746538869996,EDS 206R,A00,895694,Fargason; Sharon Gayle,1,0,30,29
1746538869996,EDS 206R,B00,895695,Choi; Bailey Miyeon,16,0,30,14
1746538871022,EDS 250,A00,895697,Hemans; Patricia Ann Benitez,23,0,45,22
1746538872047,EDS 281,A00,895701,Meyerott; Theresa Ann,1,0,15,14
1746538873074,EDS 284,A00,895736,Meyerott; Theresa Ann,1,0,15,14
1746538874104,EDS 286,A00,897210,Fine; Sarah,0,0,15,15
1746538875131,EDS 289C,A01,895770,Daly; Alan J.,15,0,15,0
1746538876164,EDS 290,A00,897211,Hofstetter; Carolyn,0,0,15,15
1746538877197,LIGM 5A,A00,896162,Fischer-Grunski; Eva K,13,0,20,7
1746538878225,LIGM 5B,A00,896260,Fischer-Grunski; Eva K,17,0,20,3
1746538879254,LIGM 5C,A00,896308,Fischer-Grunski; Eva K,18,0,20,2
1746538880281,LIIT 5AS,A00,896313,Carnelos; Chiara,18,0,20,2
1746538881312,LIIT 5BS,A00,896416,Carnelos; Chiara,20,0,20,0
1746538882342,LIIT 5CS,A00,896564,Carnelos; Chiara,20,0,20,0
1746538883373,LISP 5A,A00,896588,Munoz Sanchez; Alicia,3,0,20,17
1746538884397,LISP 5B,A00,896653,Munoz Sanchez; Alicia,7,0,20,13
1746538885426,LISP 5C,A00,896655,Munoz Sanchez; Alicia,0,1,20,20
1746538886455,MAE 197,001,957918,Kleissl; Jan,9996,0,9999,3
1746538886455,MAE 197,002,959806,Boechler; Nicholas Sebastia,9998,0,9999,1
1746538886455,MAE 197,003,959852,Mullin; Jennifer S,9999,0,9999,0
1746538887485,MATH 2,A01,957937,Staff,33,0,35,2
1746538888518,MATH 197,001,957876,Kedlaya; Kiran S.,9993,0,9999,6
1746538889551,MCWP 40,A00,892729,Duru; Nur,10,0,20,10
1746538889551,MCWP 40,B00,893304,Montejo; Carolina,14,0,20,6
1746538890579,MCWP 40R,A00,893757,Redela; Pamela Morgan,0,5,20,20
1746538891615,MCWP 50,A00,893758,Morshed; Michael James,0,0,20,20
1746538891615,MCWP 50,B00,893761,Bartulis; Jason Michael,17,0,20,3
1746538892651,MCWP 50R,A00,893766,Compas; Sean Matthew,0,1,20,20
1746538892651,MCWP 50R,B00,893769,Carter; Jennifer A,0,1,20,20
1746538892651,MCWP 50R,C00,893771,Krone; Jarret,0,3,20,20
1746538892651,MCWP 50R,D00,893772,Miller; Elizabeth Deen,0,0,20,20
1746538892651,MCWP 50R,E00,893775,Carter; Andrea L,0,1,20,20
1746538893680,MMW 11R,A01,892721,Herbst; Matthew,11,0,27,16
1746538893680,MMW 11R,A02,892722,Herbst; Matthew,0,0,0,3
1746538894711,MMW 12R,A01,892724,Herbst; Matthew,0,11,16,16
1746538894711,MMW 12R,A02,892725,Herbst; Matthew,0,10,16,16
1746538895739,MMW 13R,A01,892727,Staff,0,4,16,16
1746538895739,MMW 13R,A02,892728,Staff,0,4,16,16
1746538895739,MMW 13R,A03,958032,Staff,0,4,16,16
1746538895739,MMW 13R,A04,958033,Staff,0,4,16,16
1746538895739,MMW 13R,A05,958034,Staff,0,4,16,16
1746538896765,SIO 295LS,A00,894015,Staff,5,0,25,20
1746538897792,SIO 295S,A00,894020,Staff,5,0,25,20
1746538898824,SIOC 290S,B01,958918,Merrifield; Mark A,14,0,30,16
1746538899851,SIOC 291S,B01,958922,Gabriel; Corey John,14,0,30,16
1746538900877,SOCI 117,A01,895339,Staff,3,0,5,2
1746538901904,WES 237B,A00,894149,Staff,11,0,20,9
1746538903982,AESE 279B,A00,891859,Staff,13,0,35,22
1746538905011,AIP 197,001,891854,Vespa; Emanuel Ignacio,9999,0,9999,0
1746538906042,ANTH 289S,A00,891856,Gagneux; Pascal,12,0,12,0
1746538907068,BENG 196,001,957946,Engler; Adam J.,9996,0,9999,3
1746538908097,BISP 197,001,959851,Wilhelm; James E.,9999,0,9999,0
1746538909124,CAT 124RS,A01,956906,Staff,6,0,25,19
1746538910155,CAT 125RS,A01,922013,Staff,6,0,25,19
1746538911180,CLRE 250,A00,891860,Morris; Sheldon,9995,0,9999,4
1746538913237,CLRE 251R,A00,907817,Mehta; Ravindra L.,9994,0,9999,5
1746538914263,CLRE 252,A00,891864,Cuomo; Raphael Eduardo,9993,0,9999,6
1746538915290,CLRE 253,A00,891867,Vaida; Florin,9994,0,9999,5
1746538915290,CLRE 253,B00,907819,Staff,9999,0,9999,0
1746538916317,CLRE 259,A00,891868,Patel; Hemal,9998,0,9999,1
1746538917347,CLRE 260,A00,891872,Cuomo; Raphael Eduardo,9999,0,9999,0
1746538918370,CLRE 297,001,891888,Cuomo; Raphael Eduardo,9999,0,9999,0
1746538919395,CSE 191,A00,958773,Minnes Kemp; Mor Mia,9996,0,9999,3
1746538920421,CSE 197,001,959846,Minnes Kemp; Mor Mia,9993,0,9999,6
1746538921454,CSS 201S,A01,892054,Mignozzetti; Umberto,26,0,30,4
1746538922483,CSS 202S,A01,892056,Mignozzetti; Umberto,26,0,30,4
1746538923513,DSC 197,001,956898,Eldridge; Justin Matthew,9998,0,9999,1
1746538924538,DSC 297,001,958000,Mazumdar; Arya,9998,0,9999,1
1746538924538,DSC 297,002,959862,Wang; Yusu,9999,0,9999,0
1746538925567,EAP 100,A00,905686,Staff,9778,0,9999,221
1746538926598,ECE 45,A01,892618,Staff,0,0,65,65
1746538928652,ECE 111,A01,892719,Staff,4,0,65,61
1746538929681,ECE 197,001,957920,Mercier; Patrick Philip,9991,0,9999,8
1746538930708,ECON 178,A01,907814,Zhu; Ying,26,0,35,9
1746538931732,EDS 115,A00,895312,Staff,36,0,45,9
1746538932763,EDS 117,A01,895337,Staff,24,0,30,6
1746538933789,EDS 125,A00,895341,Jones; Gabrielle Anastasia,37,0,45,8
1746538934816,EDS 128A,A01,895459,Fargason; Sharon Gayle,44,0,45,1
1746538935843,EDS 128B,A01,895543,Pappas; Elizabeth,44,0,45,1
1746538936870,EDS 139,A00,897203,Pappas; Elizabeth,44,0,45,1
1746538936870,EDS 139,B00,897209,Fargason; Sharon Gayle,41,0,45,4
1746538937894,EDS 201,A00,895545,Staff,23,0,45,22
1746538938923,EDS 203,A01,895581,Halter; Christopher P.,23,0,45,22
1746538939950,EDS 204R,A01,895625,Heinzman; Erica M.,39,0,45,6
1746538939950,EDS 204R,B01,895693,Halter; Christopher P.,10,0,45,35
1746538940976,EDS 206R,A00,895694,Fargason; Sharon Gayle,1,0,30,29
1746538940976,EDS 206R,B00,895695,Choi; Bailey Miyeon,16,0,30,14
1746538942003,EDS 250,A00,895697,Hemans; Patricia Ann Benitez,23,0,45,22
1746538943029,EDS 281,A00,895701,Meyerott; Theresa Ann,1,0,15,14
1746538944056,EDS 284,A00,895736,Meyerott; Theresa Ann,1,0,15,14
1746538945083,EDS 286,A00,897210,Fine; Sarah,0,0,15,15
1746538946110,EDS 289C,A01,895770,Daly; Alan J.,15,0,15,0
1746538947147,EDS 290,A00,897211,Hofstetter; Carolyn,0,0,15,15
1746538948173,LIGM 5A,A00,896162,Fischer-Grunski; Eva K,13,0,20,7
1746538949203,LIGM 5B,A00,896260,Fischer-Grunski; Eva K,17,0,20,3
1746538950230,LIGM 5C,A00,896308,Fischer-Grunski; Eva K,18,0,20,2
1746538951256,LIIT 5AS,A00,896313,Carnelos; Chiara,18,0,20,2
1746538952283,LIIT 5BS,A00,896416,Carnelos; Chiara,20,0,20,0
1746538953309,LIIT 5CS,A00,896564,Carnelos; Chiara,20,0,20,0
1746538954334,LISP 5A,A00,896588,Munoz Sanchez; Alicia,3,0,20,17
1746538955361,LISP 5B,A00,896653,Munoz Sanchez; Alicia,7,0,20,13
1746538956389,LISP 5C,A00,896655,Munoz Sanchez; Alicia,0,1,20,20
1746538957417,MAE 197,001,957918,Kleissl; Jan,9996,0,9999,3
1746538957417,MAE 197,002,959806,Boechler; Nicholas Sebastia,9998,0,9999,1
1746538957417,MAE 197,003,959852,Mullin; Jennifer S,9999,0,9999,0
1746538958448,MATH 2,A01,957937,Staff,33,0,35,2
1746538959476,MATH 197,001,957876,Kedlaya; Kiran S.,9993,0,9999,6
1746538960505,MCWP 40,A00,892729,Duru; Nur,10,0,20,10
1746538960505,MCWP 40,B00,893304,Montejo; Carolina,14,0,20,6
1746538961532,MCWP 40R,A00,893757,Redela; Pamela Morgan,0,5,20,20
1746538962562,MCWP 50,A00,893758,Morshed; Michael James,0,0,20,20
1746538962562,MCWP 50,B00,893761,Bartulis; Jason Michael,17,0,20,3
1746538963590,MCWP 50R,A00,893766,Compas; Sean Matthew,0,1,20,20
1746538963590,MCWP 50R,B00,893769,Carter; Jennifer A,0,1,20,20
1746538963590,MCWP 50R,C00,893771,Krone; Jarret,0,3,20,20
1746538963590,MCWP 50R,D00,893772,Miller; Elizabeth Deen,0,0,20,20
1746538963590,MCWP 50R,E00,893775,Carter; Andrea L,0,1,20,20
1746538964618,MMW 11R,A01,892721,Herbst; Matthew,11,0,27,16
1746538964618,MMW 11R,A02,892722,Herbst; Matthew,0,0,0,3
1746538965643,MMW 12R,A01,892724,Herbst; Matthew,0,11,16,16
1746538965643,MMW 12R,A02,892725,Herbst; Matthew,0,10,16,16
1746538966674,MMW 13R,A01,892727,Staff,0,4,16,16
1746538966674,MMW 13R,A02,892728,Staff,0,4,16,16
1746538966674,MMW 13R,A03,958032,Staff,0,4,16,16
1746538966674,MMW 13R,A04,958033,Staff,0,4,16,16
1746538966674,MMW 13R,A05,958034,Staff,0,4,16,16
1746538967701,SIO 295LS,A00,894015,Staff,5,0,25,20
1746538968727,SIO 295S,A00,894020,Staff,5,0,25,20
1746538969764,SIOC 290S,B01,958918,Merrifield; Mark A,14,0,30,16
1746538970797,SIOC 291S,B01,958922,Gabriel; Corey John,14,0,30,16
1746538971824,SOCI 117,A01,895339,Staff,3,0,5,2
1746538972851,WES 237B,A00,894149,Staff,11,0,20,9
1746538974984,AESE 279B,A00,891859,Staff,13,0,35,22
1746538976011,AIP 197,001,891854,Vespa; Emanuel Ignacio,9999,0,9999,0
1746538977038,ANTH 289S,A00,891856,Gagneux; Pascal,12,0,12,0
1746538978069,BENG 196,001,957946,Engler; Adam J.,9996,0,9999,3
1746538979095,BISP 197,001,959851,Wilhelm; James E.,9999,0,9999,0
1746538980126,CAT 124RS,A01,956906,Staff,6,0,25,19
1746538981151,CAT 125RS,A01,922013,Staff,6,0,25,19
1746538982184,CLRE 250,A00,891860,Morris; Sheldon,9995,0,9999,4
1746538984242,CLRE 251R,A00,907817,Mehta; Ravindra L.,9994,0,9999,5
1746538985272,CLRE 252,A00,891864,Cuomo; Raphael Eduardo,9993,0,9999,6
1746538986304,CLRE 253,A00,891867,Vaida; Florin,9994,0,9999,5
1746538986304,CLRE 253,B00,907819,Staff,9999,0,9999,0
1746538987329,CLRE 259,A00,891868,Patel; Hemal,9998,0,9999,1
1746538988357,CLRE 260,A00,891872,Cuomo; Raphael Eduardo,9999,0,9999,0
1746538989389,CLRE 297,001,891888,Cuomo; Raphael Eduardo,9999,0,9999,0
1746538990420,CSE 191,A00,958773,Minnes Kemp; Mor Mia,9996,0,9999,3
1746538991447,CSE 197,001,959846,Minnes Kemp; Mor Mia,9993,0,9999,6
1746538992473,CSS 201S,A01,892054,Mignozzetti; Umberto,26,0,30,4
1746538993506,CSS 202S,A01,892056,Mignozzetti; Umberto,26,0,30,4
1746538994536,DSC 197,001,956898,Eldridge; Justin Matthew,9998,0,9999,1
1746538995566,DSC 297,001,958000,Mazumdar; Arya,9998,0,9999,1
1746538995566,DSC 297,002,959862,Wang; Yusu,9999,0,9999,0
1746538996590,EAP 100,A00,905686,Staff,9778,0,9999,221
1746538997624,ECE 45,A01,892618,Staff,0,0,65,65
1746538999677,ECE 111,A01,892719,Staff,4,0,65,61
1746539000709,ECE 197,001,957920,Mercier; Patrick Philip,9991,0,9999,8
1746539001740,ECON 178,A01,907814,Zhu; Ying,26,0,35,9
1746539002788,EDS 115,A00,895312,Staff,36,0,45,9
1746539003813,EDS 117,A01,895337,Staff,24,0,30,6
1746539004850,EDS 125,A00,895341,Jones; Gabrielle Anastasia,37,0,45,8
1746539005879,EDS 128A,A01,895459,Fargason; Sharon Gayle,44,0,45,1
1746539006903,EDS 128B,A01,895543,Pappas; Elizabeth,44,0,45,1
1746539007930,EDS 139,A00,897203,Pappas; Elizabeth,44,0,45,1
1746539007930,EDS 139,B00,897209,Fargason; Sharon Gayle,41,0,45,4
1746539008959,EDS 201,A00,895545,Staff,23,0,45,22
1746539009999,EDS 203,A01,895581,Halter; Christopher P.,23,0,45,22
1746539011026,EDS 204R,A01,895625,Heinzman; Erica M.,39,0,45,6
1746539011026,EDS 204R,B01,895693,Halter; Christopher P.,10,0,45,35
1746539012050,EDS 206R,A00,895694,Fargason; Sharon Gayle,1,0,30,29
1746539012050,EDS 206R,B00,895695,Choi; Bailey Miyeon,16,0,30,14
1746539013076,EDS 250,A00,895697,Hemans; Patricia Ann Benitez,23,0,45,22
1746539014104,EDS 281,A00,895701,Meyerott; Theresa Ann,1,0,15,14
1746539015130,EDS 284,A00,895736,Meyerott; Theresa Ann,1,0,15,14
1746539016161,EDS 286,A00,897210,Fine; Sarah,0,0,15,15
1746539017237,EDS 289C,A01,895770,Daly; Alan J.,15,0,15,0
1746539018263,EDS 290,A00,897211,Hofstetter; Carolyn,0,0,15,15
1746539019289,LIGM 5A,A00,896162,Fischer-Grunski; Eva K,13,0,20,7
1746539020321,LIGM 5B,A00,896260,Fischer-Grunski; Eva K,17,0,20,3
1746539021348,LIGM 5C,A00,896308,Fischer-Grunski; Eva K,18,0,20,2
1746539022375,LIIT 5AS,A00,896313,Carnelos; Chiara,18,0,20,2
1746539023403,LIIT 5BS,A00,896416,Carnelos; Chiara,20,0,20,0
1746539024429,LIIT 5CS,A00,896564,Carnelos; Chiara,20,0,20,0
1746539025462,LISP 5A,A00,896588,Munoz Sanchez; Alicia,3,0,20,17
1746539026488,LISP 5B,A00,896653,Munoz Sanchez; Alicia,7,0,20,13
1746539027517,LISP 5C,A00,896655,Munoz Sanchez; Alicia,0,1,20,20
1746539028543,MAE 197,001,957918,Kleissl; Jan,9996,0,9999,3
1746539028543,MAE 197,002,959806,Boechler; Nicholas Sebastia,9998,0,9999,1
1746539028543,MAE 197,003,959852,Mullin; Jennifer S,9999,0,9999,0
1746539029572,MATH 2,A01,957937,Staff,33,0,35,2
1746539030601,MATH 197,001,957876,Kedlaya; Kiran S.,9993,0,9999,6
1746539031627,MCWP 40,A00,892729,Duru; Nur,10,0,20,10
1746539031627,MCWP 40,B00,893304,Montejo; Carolina,14,0,20,6
1746539032654,MCWP 40R,A00,893757,Redela; Pamela Morgan,0,5,20,20
1746539033685,MCWP 50,A00,893758,Morshed; Michael James,0,0,20,20
1746539033685,MCWP 50,B00,893761,Bartulis; Jason Michael,17,0,20,3
1746539034713,MCWP 50R,A00,893766,Compas; Sean Matthew,0,1,20,20
1746539034713,MCWP 50R,B00,893769,Carter; Jennifer A,0,1,20,20
1746539034713,MCWP 50R,C00,893771,Krone; Jarret,0,3,20,20
1746539034713,MCWP 50R,D00,893772,Miller; Elizabeth Deen,0,0,20,20
1746539034713,MCWP 50R,E00,893775,Carter; Andrea L,0,1,20,20
1746539035738,MMW 11R,A01,892721,Herbst; Matthew,11,0,27,16
1746539035738,MMW 11R,A02,892722,Herbst; Matthew,0,0,0,3
1746539036764,MMW 12R,A01,892724,Herbst; Matthew,0,11,16,16
1746539036764,MMW 12R,A02,892725,Herbst; Matthew,0,10,16,16
1746539037788,MMW 13R,A01,892727,Staff,0,4,16,16
1746539037788,MMW 13R,A02,892728,Staff,0,4,16,16
1746539037788,MMW 13R,A03,958032,Staff,0,4,16,16
1746539037788,MMW 13R,A04,958033,Staff,0,4,16,16
1746539037788,MMW 13R,A05,958034,Staff,0,4,16,16
1746539038819,SIO 295LS,A00,894015,Staff,5,0,25,20
1746539039842,SIO 295S,A00,894020,Staff,5,0,25,20
1746539040867,SIOC 290S,B01,958918,Merrifield; Mark A,14,0,30,16
1746539041894,SIOC 291S,B01,958922,Gabriel; Corey John,14,0,30,16
1746539042977,SOCI 117,A01,895339,Staff,3,0,5,2
1746539044005,WES 237B,A00,894149,Staff,11,0,20,9
1746539046080,AESE 279B,A00,891859,Staff,13,0,35,22
1746539047106,AIP 197,001,891854,Vespa; Emanuel Ignacio,9999,0,9999,0
1746539048135,ANTH 289S,A00,891856,Gagneux; Pascal,12,0,12,0
1746539049163,BENG 196,001,957946,Engler; Adam J.,9996,0,9999,3
1746539050191,BISP 197,001,959851,Wilhelm; James E.,9999,0,9999,0
1746539051215,CAT 124RS,A01,956906,Staff,6,0,25,19
1746539052242,CAT 125RS,A01,922013,Staff,6,0,25,19
1746539053270,CLRE 250,A00,891860,Morris; Sheldon,9995,0,9999,4
1746539055331,CLRE 251R,A00,907817,Mehta; Ravindra L.,9994,0,9999,5
1746539056357,CLRE 252,A00,891864,Cuomo; Raphael Eduardo,9993,0,9999,6
1746539057385,CLRE 253,A00,891867,Vaida; Florin,9994,0,9999,5
1746539057385,CLRE 253,B00,907819,Staff,9999,0,9999,0
1746539058415,CLRE 259,A00,891868,Patel; Hemal,9998,0,9999,1
1746539059440,CLRE 260,A00,891872,Cuomo; Raphael Eduardo,9999,0,9999,0
1746539060467,CLRE 297,001,891888,Cuomo; Raphael Eduardo,9999,0,9999,0
1746539061497,CSE 191,A00,958773,Minnes Kemp; Mor Mia,9996,0,9999,3
1746539062528,CSE 197,001,959846,Minnes Kemp; Mor Mia,9993,0,9999,6
1746539063560,CSS 201S,A01,892054,Mignozzetti; Umberto,26,0,30,4
1746539064590,CSS 202S,A01,892056,Mignozzetti; Umberto,26,0,30,4
1746539065622,DSC 197,001,956898,Eldridge; Justin Matthew,9998,0,9999,1
1746539066647,DSC 297,001,958000,Mazumdar; Arya,9998,0,9999,1
1746539066647,DSC 297,002,959862,Wang; Yusu,9999,0,9999,0
1746539067672,EAP 100,A00,905686,Staff,9778,0,9999,221
1746539068700,ECE 45,A01,892618,Staff,0,0,65,65
1746539070758,ECE 111,A01,892719,Staff,4,0,65,61
1746539071783,ECE 197,001,957920,Mercier; Patrick Philip,9991,0,9999,8
1746539072812,ECON 178,A01,907814,Zhu; Ying,26,0,35,9
1746539073841,EDS 115,A00,895312,Staff,36,0,45,9
1746539074868,EDS 117,A01,895337,Staff,24,0,30,6
1746539075899,EDS 125,A00,895341,Jones; Gabrielle Anastasia,37,0,45,8
1746539076924,EDS 128A,A01,895459,Fargason; Sharon Gayle,44,0,45,1
1746539077950,EDS 128B,A01,895543,Pappas; Elizabeth,44,0,45,1
1746539078977,EDS 139,A00,897203,Pappas; Elizabeth,44,0,45,1
1746539078977,EDS 139,B00,897209,Fargason; Sharon Gayle,41,0,45,4
1746539080007,EDS 201,A00,895545,Staff,23,0,45,22
1746539081035,EDS 203,A01,895581,Halter; Christopher P.,23,0,45,22
1746539082064,EDS 204R,A01,895625,Heinzman; Erica M.,39,0,45,6
1746539082064,EDS 204R,B01,895693,Halter; Christopher P.,10,0,45,35
1746539083098,EDS 206R,A00,895694,Fargason; Sharon Gayle,1,0,30,29
1746539083098,EDS 206R,B00,895695,Choi; Bailey Miyeon,16,0,30,14
1746539084128,EDS 250,A00,895697,Hemans; Patricia Ann Benitez,23,0,45,22
1746539085161,EDS 281,A00,895701,Meyerott; Theresa Ann,1,0,15,14
1746539086188,EDS 284,A00,895736,Meyerott; Theresa Ann,1,0,15,14
1746539087216,EDS 286,A00,897210,Fine; Sarah,0,0,15,15
1746539088240,EDS 289C,A01,895770,Daly; Alan J.,15,0,15,0
1746539089266,EDS 290,A00,897211,Hofstetter; Carolyn,0,0,15,15
1746539090296,LIGM 5A,A00,896162,Fischer-Grunski; Eva K,13,0,20,7
1746539091327,LIGM 5B,A00,896260,Fischer-Grunski; Eva K,17,0,20,3
1746539092352,LIGM 5C,A00,896308,Fischer-Grunski; Eva K,18,0,20,2
1746539093383,LIIT 5AS,A00,896313,Carnelos; Chiara,18,0,20,2
1746539094409,LIIT 5BS,A00,896416,Carnelos; Chiara,20,0,20,0
1746539095438,LIIT 5CS,A00,896564,Carnelos; Chiara,20,0,20,0
1746539096466,LISP 5A,A00,896588,Munoz Sanchez; Alicia,3,0,20,17
1746539097498,LISP 5B,A00,896653,Munoz Sanchez; Alicia,7,0,20,13
1746539098525,LISP 5C,A00,896655,Munoz Sanchez; Alicia,0,1,20,20
1746539099551,MAE 197,001,957918,Kleissl; Jan,9996,0,9999,3
1746539099551,MAE 197,002,959806,Boechler; Nicholas Sebastia,9998,0,9999,1
1746539099551,MAE 197,003,959852,Mullin; Jennifer S,9999,0,9999,0
1746539100579,MATH 2,A01,957937,Staff,33,0,35,2
1746539101608,MATH 197,001,957876,Kedlaya; Kiran S.,9993,0,9999,6
1746539102637,MCWP 40,A00,892729,Duru; Nur,10,0,20,10
1746539102637,MCWP 40,B00,893304,Montejo; Carolina,14,0,20,6
1746539103664,MCWP 40R,A00,893757,Redela; Pamela Morgan,0,5,20,20
1746539104693,MCWP 50,A00,893758,Morshed; Michael James,0,0,20,20
1746539104693,MCWP 50,B00,893761,Bartulis; Jason Michael,17,0,20,3
1746539105721,MCWP 50R,A00,893766,Compas; Sean Matthew,0,1,20,20
1746539105721,MCWP 50R,B00,893769,Carter; Jennifer A,0,1,20,20
1746539105721,MCWP 50R,C00,893771,Krone; Jarret,0,3,20,20
1746539105721,MCWP 50R,D00,893772,Miller; Elizabeth Deen,0,0,20,20
1746539105721,MCWP 50R,E00,893775,Carter; Andrea L,0,1,20,20
1746539106750,MMW 11R,A01,892721,Herbst; Matthew,11,0,27,16
1746539106750,MMW 11R,A02,892722,Herbst; Matthew,0,0,0,3
1746539107778,MMW 12R,A01,892724,Herbst; Matthew,0,11,16,16
1746539107778,MMW 12R,A02,892725,Herbst; Matthew,0,10,16,16
1746539108806,MMW 13R,A01,892727,Staff,0,4,16,16
1746539108806,MMW 13R,A02,892728,Staff,0,4,16,16
1746539108806,MMW 13R,A03,958032,Staff,0,4,16,16
1746539108806,MMW 13R,A04,958033,Staff,0,4,16,16
1746539108806,MMW 13R,A05,958034,Staff,0,4,16,16
1746539109832,SIO 295LS,A00,894015,Staff,5,0,25,20
1746539110859,SIO 295S,A00,894020,Staff,5,0,25,20
1746539111887,SIOC 290S,B01,958918,Merrifield; Mark A,14,0,30,16
1746539112919,SIOC 291S,B01,958922,Gabriel; Corey John,14,0,30,16
1746539113946,SOCI 117,A01,895339,Staff,3,0,5,2
1746539114972,WES 237B,A00,894149,Staff,11,0,20,9
1746539117046,AESE 279B,A00,891859,Staff,13,0,35,22
1746539118073,AIP 197,001,891854,Vespa; Emanuel Ignacio,9999,0,9999,0
1746539119102,ANTH 289S,A00,891856,Gagneux; Pascal,12,0,12,0
1746539120128,BENG 196,001,957946,Engler; Adam J.,9996,0,9999,3
1746539121158,BISP 197,001,959851,Wilhelm; James E.,9999,0,9999,0
1746539122184,CAT 124RS,A01,956906,Staff,6,0,25,19
1746539123210,CAT 125RS,A01,922013,Staff,6,0,25,19
1746539124237,CLRE 250,A00,891860,Morris; Sheldon,9995,0,9999,4
1746539126297,CLRE 251R,A00,907817,Mehta; Ravindra L.,9994,0,9999,5
1746539127325,CLRE 252,A00,891864,Cuomo; Raphael Eduardo,9993,0,9999,6
1746539128349,CLRE 253,A00,891867,Vaida; Florin,9994,0,9999,5
1746539128349,CLRE 253,B00,907819,Staff,9999,0,9999,0
1746539129375,CLRE 259,A00,891868,Patel; Hemal,9998,0,9999,1
1746539130401,CLRE 260,A00,891872,Cuomo; Raphael Eduardo,9999,0,9999,0
1746539131425,CLRE 297,001,891888,Cuomo; Raphael Eduardo,9999,0,9999,0
1746539132451,CSE 191,A00,958773,Minnes Kemp; Mor Mia,9996,0,9999,3
1746539133480,CSE 197,001,959846,Minnes Kemp; Mor Mia,9993,0,9999,6
1746539134511,CSS 201S,A01,892054,Mignozzetti; Umberto,26,0,30,4
1746539135538,CSS 202S,A01,892056,Mignozzetti; Umberto,26,0,30,4
1746539136567,DSC 197,001,956898,Eldridge; Justin Matthew,9998,0,9999,1
1746539137595,DSC 297,001,958000,Mazumdar; Arya,9998,0,9999,1
1746539137595,DSC 297,002,959862,Wang; Yusu,9999,0,9999,0
1746539138620,EAP 100,A00,905686,Staff,9778,0,9999,221
1746539139651,ECE 45,A01,892618,Staff,0,0,65,65
1746539141705,ECE 111,A01,892719,Staff,4,0,65,61
1746539142732,ECE 197,001,957920,Mercier; Patrick Philip,9991,0,9999,8
1746539143759,ECON 178,A01,907814,Zhu; Ying,26,0,35,9
1746539144784,EDS 115,A00,895312,Staff,36,0,45,9
1746539145812,EDS 117,A01,895337,Staff,24,0,30,6
1746539146841,EDS 125,A00,895341,Jones; Gabrielle Anastasia,37,0,45,8
1746539147871,EDS 128A,A01,895459,Fargason; Sharon Gayle,44,0,45,1
1746539148903,EDS 128B,A01,895543,Pappas; Elizabeth,44,0,45,1
1746539149931,EDS 139,A00,897203,Pappas; Elizabeth,44,0,45,1
1746539149931,EDS 139,B00,897209,Fargason; Sharon Gayle,41,0,45,4
1746539150958,EDS 201,A00,895545,Staff,23,0,45,22
1746539151985,EDS 203,A01,895581,Halter; Christopher P.,23,0,45,22
1746539153010,EDS 204R,A01,895625,Heinzman; Erica M.,39,0,45,6
1746539153010,EDS 204R,B01,895693,Halter; Christopher P.,10,0,45,35
1746539154039,EDS 206R,A00,895694,Fargason; Sharon Gayle,1,0,30,29
1746539154039,EDS 206R,B00,895695,Choi; Bailey Miyeon,16,0,30,14
1746539155074,EDS 250,A00,895697,Hemans; Patricia Ann Benitez,23,0,45,22
1746539156103,EDS 281,A00,895701,Meyerott; Theresa Ann,1,0,15,14
1746539157131,EDS 284,A00,895736,Meyerott; Theresa Ann,1,0,15,14
1746539158162,EDS 286,A00,897210,Fine; Sarah,0,0,15,15
1746539159196,EDS 289C,A01,895770,Daly; Alan J.,15,0,15,0
1746539160225,EDS 290,A00,897211,Hofstetter; Carolyn,0,0,15,15
1746539161256,LIGM 5A,A00,896162,Fischer-Grunski; Eva K,13,0,20,7
1746539162286,LIGM 5B,A00,896260,Fischer-Grunski; Eva K,17,0,20,3
1746539163317,LIGM 5C,A00,896308,Fischer-Grunski; Eva K,18,0,20,2
1746539164343,LIIT 5AS,A00,896313,Carnelos; Chiara,18,0,20,2
1746539165371,LIIT 5BS,A00,896416,Carnelos; Chiara,20,0,20,0
1746539166401,LIIT 5CS,A00,896564,Carnelos; Chiara,20,0,20,0
1746539167427,LISP 5A,A00,896588,Munoz Sanchez; Alicia,3,0,20,17
1746539168457,LISP 5B,A00,896653,Munoz Sanchez; Alicia,7,0,20,13
1746539169483,LISP 5C,A00,896655,Munoz Sanchez; Alicia,0,1,20,20
1746539170522,MAE 197,001,957918,Kleissl; Jan,9996,0,9999,3
1746539170522,MAE 197,002,959806,Boechler; Nicholas Sebastia,9998,0,9999,1
1746539170522,MAE 197,003,959852,Mullin; Jennifer S,9999,0,9999,0
1746539171565,MATH 2,A01,957937,Staff,33,0,35,2
1746539172591,MATH 197,001,957876,Kedlaya; Kiran S.,9993,0,9999,6
1746539173627,MCWP 40,A00,892729,Duru; Nur,10,0,20,10
1746539173627,MCWP 40,B00,893304,Montejo; Carolina,14,0,20,6
1746539174655,MCWP 40R,A00,893757,Redela; Pamela Morgan,0,5,20,20
1746539175682,MCWP 50,A00,893758,Morshed; Michael James,0,0,20,20
1746539175682,MCWP 50,B00,893761,Bartulis; Jason Michael,17,0,20,3
1746539176716,MCWP 50R,A00,893766,Compas; Sean Matthew,0,1,20,20
1746539176716,MCWP 50R,B00,893769,Carter; Jennifer A,0,1,20,20
1746539176716,MCWP 50R,C00,893771,Krone; Jarret,0,3,20,20
1746539176716,MCWP 50R,D00,893772,Miller; Elizabeth Deen,0,0,20,20
1746539176716,MCWP 50R,E00,893775,Carter; Andrea L,0,1,20,20
1746539177745,MMW 11R,A01,892721,Herbst; Matthew,11,0,27,16
1746539177745,MMW 11R,A02,892722,Herbst; Matthew,0,0,0,3
1746539178772,MMW 12R,A01,892724,Herbst; Matthew,0,11,16,16
1746539178772,MMW 12R,A02,892725,Herbst; Matthew,0,10,16,16
1746539179797,MMW 13R,A01,892727,Staff,0,4,16,16
1746539179797,MMW 13R,A02,892728,Staff,0,4,16,16
1746539179797,MMW 13R,A03,958032,Staff,0,4,16,16
1746539179797,MMW 13R,A04,958033,Staff,0,4,16,16
1746539179797,MMW 13R,A05,958034,Staff,0,4,16,16
1746539180823,SIO 295LS,A00,894015,Staff,5,0,25,20
1746539181850,SIO 295S,A00,894020,Staff,5,0,25,20
1746539182879,SIOC 290S,B01,958918,Merrifield; Mark A,14,0,30,16
1746539183911,SIOC 291S,B01,958922,Gabriel; Corey John,14,0,30,16
1746539184937,SOCI 117,A01,895339,Staff,3,0,5,2
1746539185963,WES 237B,A00,894149,Staff,11,0,20,9
1746539188061,AESE 279B,A00,891859,Staff,13,0,35,22
1746539189090,AIP 197,001,891854,Vespa; Emanuel Ignacio,9999,0,9999,0
1746539190116,ANTH 289S,A00,891856,Gagneux; Pascal,12,0,12,0
1746539191142,BENG 196,001,957946,Engler; Adam J.,9996,0,9999,3
1746539192169,BISP 197,001,959851,Wilhelm; James E.,9999,0,9999,0
1746539193197,CAT 124RS,A01,956906,Staff,6,0,25,19
1746539194221,CAT 125RS,A01,922013,Staff,6,0,25,19
1746539195246,CLRE 250,A00,891860,Morris; Sheldon,9995,0,9999,4
1746539197297,CLRE 251R,A00,907817,Mehta; Ravindra L.,9994,0,9999,5
1746539198322,CLRE 252,A00,891864,Cuomo; Raphael Eduardo,9993,0,9999,6
1746539199348,CLRE 253,A00,891867,Vaida; Florin,9994,0,9999,5
1746539199348,CLRE 253,B00,907819,Staff,9999,0,9999,0
1746539200373,CLRE 259,A00,891868,Patel; Hemal,9998,0,9999,1
1746539201400,CLRE 260,A00,891872,Cuomo; Raphael Eduardo,9999,0,9999,0
1746539202429,CLRE 297,001,891888,Cuomo; Raphael Eduardo,9999,0,9999,0
1746539203457,CSE 191,A00,958773,Minnes Kemp; Mor Mia,9996,0,9999,3
1746539204487,CSE 197,001,959846,Minnes Kemp; Mor Mia,9993,0,9999,6
1746539205519,CSS 201S,A01,892054,Mignozzetti; Umberto,26,0,30,4
1746539206554,CSS 202S,A01,892056,Mignozzetti; Umberto,26,0,30,4
1746539207582,DSC 197,001,956898,Eldridge; Justin Matthew,9998,0,9999,1
1746539208610,DSC 297,001,958000,Mazumdar; Arya,9998,0,9999,1
1746539208610,DSC 297,002,959862,Wang; Yusu,9999,0,9999,0
1746539209638,EAP 100,A00,905686,Staff,9778,0,9999,221
1746539210670,ECE 45,A01,892618,Staff,0,0,65,65
1746539212726,ECE 111,A01,892719,Staff,4,0,65,61
1746539213760,ECE 197,001,957920,Mercier; Patrick Philip,9991,0,9999,8
1746539214793,ECON 178,A01,907814,Zhu; Ying,26,0,35,9
1746539215819,EDS 115,A00,895312,Staff,36,0,45,9
1746539216847,EDS 117,A01,895337,Staff,24,0,30,6
1746539217875,EDS 125,A00,895341,Jones; Gabrielle Anastasia,37,0,45,8
1746539218904,EDS 128A,A01,895459,Fargason; Sharon Gayle,44,0,45,1
1746539219935,EDS 128B,A01,895543,Pappas; Elizabeth,44,0,45,1
1746539220961,EDS 139,A00,897203,Pappas; Elizabeth,44,0,45,1
1746539220961,EDS 139,B00,897209,Fargason; Sharon Gayle,41,0,45,4
1746539221986,EDS 201,A00,895545,Staff,23,0,45,22
1746539223018,EDS 203,A01,895581,Halter; Christopher P.,23,0,45,22
1746539224045,EDS 204R,A01,895625,Heinzman; Erica M.,39,0,45,6
1746539224045,EDS 204R,B01,895693,Halter; Christopher P.,10,0,45,35
1746539225077,EDS 206R,A00,895694,Fargason; Sharon Gayle,1,0,30,29
1746539225077,EDS 206R,B00,895695,Choi; Bailey Miyeon,16,0,30,14
1746539226108,EDS 250,A00,895697,Hemans; Patricia Ann Benitez,23,0,45,22
1746539227138,EDS 281,A00,895701,Meyerott; Theresa Ann,1,0,15,14
1746539228163,EDS 284,A00,895736,Meyerott; Theresa Ann,1,0,15,14
1746539229189,EDS 286,A00,897210,Fine; Sarah,0,0,15,15
1746539230213,EDS 289C,A01,895770,Daly; Alan J.,15,0,15,0
1746539231238,EDS 290,A00,897211,Hofstetter; Carolyn,0,0,15,15
1746539232265,LIGM 5A,A00,896162,Fischer-Grunski; Eva K,13,0,20,7
1746539233294,LIGM 5B,A00,896260,Fischer-Grunski; Eva K,17,0,20,3
1746539234324,LIGM 5C,A00,896308,Fischer-Grunski; Eva K,18,0,20,2
1746539235352,LIIT 5AS,A00,896313,Carnelos; Chiara,18,0,20,2
1746539236379,LIIT 5BS,A00,896416,Carnelos; Chiara,20,0,20,0
1746539237404,LIIT 5CS,A00,896564,Carnelos; Chiara,20,0,20,0
1746539238431,LISP 5A,A00,896588,Munoz Sanchez; Alicia,3,0,20,17
1746539239457,LISP 5B,A00,896653,Munoz Sanchez; Alicia,7,0,20,13
1746539240481,LISP 5C,A00,896655,Munoz Sanchez; Alicia,0,1,20,20
1746539241514,MAE 197,001,957918,Kleissl; Jan,9996,0,9999,3
1746539241514,MAE 197,002,959806,Boechler; Nicholas Sebastia,9998,0,9999,1
1746539241514,MAE 197,003,959852,Mullin; Jennifer S,9999,0,9999,0
1746539242539,MATH 2,A01,957937,Staff,33,0,35,2
1746539243568,MATH 197,001,957876,Kedlaya; Kiran S.,9993,0,9999,6
1746539244596,MCWP 40,A00,892729,Duru; Nur,10,0,20,10
1746539244596,MCWP 40,B00,893304,Montejo; Carolina,14,0,20,6
1746539245624,MCWP 40R,A00,893757,Redela; Pamela Morgan,0,5,20,20
1746539246655,MCWP 50,A00,893758,Morshed; Michael James,0,0,20,20
1746539246655,MCWP 50,B00,893761,Bartulis; Jason Michael,17,0,20,3
1746539247692,MCWP 50R,A00,893766,Compas; Sean Matthew,0,1,20,20
1746539247692,MCWP 50R,B00,893769,Carter; Jennifer A,0,1,20,20
1746539247692,MCWP 50R,C00,893771,Krone; Jarret,0,3,20,20
1746539247692,MCWP 50R,D00,893772,Miller; Elizabeth Deen,0,0,20,20
1746539247692,MCWP 50R,E00,893775,Carter; Andrea L,0,1,20,20
1746539248718,MMW 11R,A01,892721,Herbst; Matthew,11,0,27,16
1746539248718,MMW 11R,A02,892722,Herbst; Matthew,0,0,0,3
1746539249743,MMW 12R,A01,892724,Herbst; Matthew,0,11,16,16
1746539249743,MMW 12R,A02,892725,Herbst; Matthew,0,10,16,16
1746539250774,MMW 13R,A01,892727,Staff,0,4,16,16
1746539250774,MMW 13R,A02,892728,Staff,0,4,16,16
1746539250774,MMW 13R,A03,958032,Staff,0,4,16,16
1746539250774,MMW 13R,A04,958033,Staff,0,4,16,16
1746539250774,MMW 13R,A05,958034,Staff,0,4,16,16
1746539251799,SIO 295LS,A00,894015,Staff,5,0,25,20
1746539252825,SIO 295S,A00,894020,Staff,5,0,25,20
1746539253858,SIOC 290S,B01,958918,Merrifield; Mark A,14,0,30,16
1746539254885,SIOC 291S,B01,958922,Gabriel; Corey John,14,0,30,16
1746539255913,SOCI 117,A01,895339,Staff,3,0,5,2
1746539256937,WES 237B,A00,894149,Staff,11,0,20,9
1746539259000,AESE 279B,A00,891859,Staff,13,0,35,22
1746539260029,AIP 197,001,891854,Vespa; Emanuel Ignacio,9999,0,9999,0
1746539261053,ANTH 289S,A00,891856,Gagneux; Pascal,12,0,12,0
1746539262081,BENG 196,001,957946,Engler; Adam J.,9996,0,9999,3
1746539263109,BISP 197,001,959851,Wilhelm; James E.,9999,0,9999,0
1746539264134,CAT 124RS,A01,956906,Staff,6,0,25,19
1746539265160,CAT 125RS,A01,922013,Staff,6,0,25,19
1746539266188,CLRE 250,A00,891860,Morris; Sheldon,9995,0,9999,4
1746539268241,CLRE 251R,A00,907817,Mehta; Ravindra L.,9994,0,9999,5
1746539269268,CLRE 252,A00,891864,Cuomo; Raphael Eduardo,9993,0,9999,6
1746539270295,CLRE 253,A00,891867,Vaida; Florin,9994,0,9999,5
1746539270295,CLRE 253,B00,907819,Staff,9999,0,9999,0
1746539271320,CLRE 259,A00,891868,Patel; Hemal,9998,0,9999,1
1746539272350,CLRE 260,A00,891872,Cuomo; Raphael Eduardo,9999,0,9999,0
1746539273376,CLRE 297,001,891888,Cuomo; Raphael Eduardo,9999,0,9999,0
1746539274405,CSE 191,A00,958773,Minnes Kemp; Mor Mia,9996,0,9999,3
1746539275433,CSE 197,001,959846,Minnes Kemp; Mor Mia,9993,0,9999,6
1746539276460,CSS 201S,A01,892054,Mignozzetti; Umberto,26,0,30,4
1746539277487,CSS 202S,A01,892056,Mignozzetti; Umberto,26,0,30,4
1746539278513,DSC 197,001,956898,Eldridge; Justin Matthew,9998,0,9999,1
1746539279538,DSC 297,001,958000,Mazumdar; Arya,9998,0,9999,1
1746539279538,DSC 297,002,959862,Wang; Yusu,9999,0,9999,0
1746539280564,EAP 100,A00,905686,Staff,9778,0,9999,221
1746539281593,ECE 45,A01,892618,Staff,0,0,65,65
1746539283649,ECE 111,A01,892719,Staff,4,0,65,61
1746539284676,ECE 197,001,957920,Mercier; Patrick Philip,9991,0,9999,8
1746539285703,ECON 178,A01,907814,Zhu; Ying,26,0,35,9
1746539286732,EDS 115,A00,895312,Staff,36,0,45,9
1746539287762,EDS 117,A01,895337,Staff,24,0,30,6
1746539288794,EDS 125,A00,895341,Jones; Gabrielle Anastasia,37,0,45,8
1746539289824,EDS 128A,A01,895459,Fargason; Sharon Gayle,44,0,45,1
1746539290850,EDS 128B,A01,895543,Pappas; Elizabeth,44,0,45,1
1746539291874,EDS 139,A00,897203,Pappas; Elizabeth,44,0,45,1
1746539291874,EDS 139,B00,897209,Fargason; Sharon Gayle,41,0,45,4
1746539292900,EDS 201,A00,895545,Staff,23,0,45,22
1746539293925,EDS 203,A01,895581,Halter; Christopher P.,23,0,45,22
1746539294957,EDS 204R,A01,895625,Heinzman; Erica M.,39,0,45,6
1746539294957,EDS 204R,B01,895693,Halter; Christopher P.,10,0,45,35
1746539295984,EDS 206R,A00,895694,Fargason; Sharon Gayle,1,0,30,29
1746539295984,EDS 206R,B00,895695,Choi; Bailey Miyeon,16,0,30,14
1746539297015,EDS 250,A00,895697,Hemans; Patricia Ann Benitez,23,0,45,22
1746539298041,EDS 281,A00,895701,Meyerott; Theresa Ann,1,0,15,14
1746539299065,EDS 284,A00,895736,Meyerott; Theresa Ann,1,0,15,14
1746539300091,EDS 286,A00,897210,Fine; Sarah,0,0,15,15
1746539301118,EDS 289C,A01,895770,Daly; Alan J.,15,0,15,0
1746539302147,EDS 290,A00,897211,Hofstetter; Carolyn,0,0,15,15
1746539303176,LIGM 5A,A00,896162,Fischer-Grunski; Eva K,13,0,20,7
1746539304205,LIGM 5B,A00,896260,Fischer-Grunski; Eva K,17,0,20,3
1746539305229,LIGM 5C,A00,896308,Fischer-Grunski; Eva K,18,0,20,2
1746539306261,LIIT 5AS,A00,896313,Carnelos; Chiara,18,0,20,2
1746539307287,LIIT 5BS,A00,896416,Carnelos; Chiara,20,0,20,0
1746539308316,LIIT 5CS,A00,896564,Carnelos; Chiara,20,0,20,0
1746539309344,LISP 5A,A00,896588,Munoz Sanchez; Alicia,3,0,20,17
1746539310372,LISP 5B,A00,896653,Munoz Sanchez; Alicia,7,0,20,13
1746539311396,LISP 5C,A00,896655,Munoz Sanchez; Alicia,0,1,20,20
1746539312422,MAE 197,001,957918,Kleissl; Jan,9996,0,9999,3
1746539312422,MAE 197,002,959806,Boechler; Nicholas Sebastia,9998,0,9999,1
1746539312422,MAE 197,003,959852,Mullin; Jennifer S,9999,0,9999,0
1746539313449,MATH 2,A01,957937,Staff,33,0,35,2
1746539314475,MATH 197,001,957876,Kedlaya; Kiran S.,9993,0,9999,6
1746539315505,MCWP 40,A00,892729,Duru; Nur,10,0,20,10
1746539315505,MCWP 40,B00,893304,Montejo; Carolina,14,0,20,6
1746539316539,MCWP 40R,A00,893757,Redela; Pamela Morgan,0,5,20,20
1746539317572,MCWP 50,A00,893758,Morshed; Michael James,0,0,20,20
1746539317572,MCWP 50,B00,893761,Bartulis; Jason Michael,17,0,20,3
1746539318602,MCWP 50R,A00,893766,Compas; Sean Matthew,0,1,20,20
1746539318602,MCWP 50R,B00,893769,Carter; Jennifer A,0,1,20,20
1746539318602,MCWP 50R,C00,893771,Krone; Jarret,0,3,20,20
1746539318602,MCWP 50R,D00,893772,Miller; Elizabeth Deen,0,0,20,20
1746539318602,MCWP 50R,E00,893775,Carter; Andrea L,0,1,20,20
1746539319630,MMW 11R,A01,892721,Herbst; Matthew,11,0,27,16
1746539319630,MMW 11R,A02,892722,Herbst; Matthew,0,0,0,3
1746539320657,MMW 12R,A01,892724,Herbst; Matthew,0,11,16,16
1746539320657,MMW 12R,A02,892725,Herbst; Matthew,0,10,16,16
1746539321684,MMW 13R,A01,892727,Staff,0,4,16,16
1746539321684,MMW 13R,A02,892728,Staff,0,4,16,16
1746539321684,MMW 13R,A03,958032,Staff,0,4,16,16
1746539321684,MMW 13R,A04,958033,Staff,0,4,16,16
1746539321684,MMW 13R,A05,958034,Staff,0,4,16,16
1746539322710,SIO 295LS,A00,894015,Staff,5,0,25,20
1746539323736,SIO 295S,A00,894020,Staff,5,0,25,20
1746539324769,SIOC 290S,B01,958918,Merrifield; Mark A,14,0,30,16
1746539325801,SIOC 291S,B01,958922,Gabriel; Corey John,14,0,30,16
1746539326827,SOCI 117,A01,895339,Staff,3,0,5,2
1746539327855,WES 237B,A00,894149,Staff,11,0,20,9
1746539329946,AESE 279B,A00,891859,Staff,13,0,35,22
1746539330973,AIP 197,001,891854,Vespa; Emanuel Ignacio,9999,0,9999,0
1746539332005,ANTH 289S,A00,891856,Gagneux; Pascal,12,0,12,0
1746539333032,BENG 196,001,957946,Engler; Adam J.,9996,0,9999,3
1746539334058,BISP 197,001,959851,Wilhelm; James E.,9999,0,9999,0
1746539335085,CAT 124RS,A01,956906,Staff,6,0,25,19
1746539336112,CAT 125RS,A01,922013,Staff,6,0,25,19
1746539337142,CLRE 250,A00,891860,Morris; Sheldon,9995,0,9999,4
1746539339198,CLRE 251R,A00,907817,Mehta; Ravindra L.,9994,0,9999,5
1746539340226,CLRE 252,A00,891864,Cuomo; Raphael Eduardo,9993,0,9999,6
1746539341257,CLRE 253,A00,891867,Vaida; Florin,9994,0,9999,5
1746539341257,CLRE 253,B00,907819,Staff,9999,0,9999,0
1746539342284,CLRE 259,A00,891868,Patel; Hemal,9998,0,9999,1
1746539343312,CLRE 260,A00,891872,Cuomo; Raphael Eduardo,9999,0,9999,0
1746539344344,CLRE 297,001,891888,Cuomo; Raphael Eduardo,9999,0,9999,0
1746539345375,CSE 191,A00,958773,Minnes Kemp; Mor Mia,9996,0,9999,3
1746539346406,CSE 197,001,959846,Minnes Kemp; Mor Mia,9993,0,9999,6
1746539347433,CSS 201S,A01,892054,Mignozzetti; Umberto,26,0,30,4
1746539348463,CSS 202S,A01,892056,Mignozzetti; Umberto,26,0,30,4
1746539349492,DSC 197,001,956898,Eldridge; Justin Matthew,9998,0,9999,1
1746539350518,DSC 297,001,958000,Mazumdar; Arya,9998,0,9999,1
1746539350518,DSC 297,002,959862,Wang; Yusu,9999,0,9999,0
1746539351550,EAP 100,A00,905686,Staff,9778,0,9999,221
1746539352582,ECE 45,A01,892618,Staff,0,0,65,65
1746539354632,ECE 111,A01,892719,Staff,4,0,65,61
1746539355657,ECE 197,001,957920,Mercier; Patrick Philip,9991,0,9999,8
1746539356685,ECON 178,A01,907814,Zhu; Ying,26,0,35,9
1746539357713,EDS 115,A00,895312,Staff,36,0,45,9
1746539359050,EDS 117,A01,895337,Staff,24,0,30,6
1746539360076,EDS 125,A00,895341,Jones; Gabrielle Anastasia,37,0,45,8
1746539361103,EDS 128A,A01,895459,Fargason; Sharon Gayle,44,0,45,1
1746539362129,EDS 128B,A01,895543,Pappas; Elizabeth,44,0,45,1
1746539363153,EDS 139,A00,897203,Pappas; Elizabeth,44,0,45,1
1746539363153,EDS 139,B00,897209,Fargason; Sharon Gayle,41,0,45,4
1746539364178,EDS 201,A00,895545,Staff,23,0,45,22
1746539365203,EDS 203,A01,895581,Halter; Christopher P.,23,0,45,22
1746539366233,EDS 204R,A01,895625,Heinzman; Erica M.,39,0,45,6
1746539366233,EDS 204R,B01,895693,Halter; Christopher P.,10,0,45,35
1746539367264,EDS 206R,A00,895694,Fargason; Sharon Gayle,1,0,30,29
1746539367264,EDS 206R,B00,895695,Choi; Bailey Miyeon,16,0,30,14
1746539368290,EDS 250,A00,895697,Hemans; Patricia Ann Benitez,23,0,45,22
1746539369317,EDS 281,A00,895701,Meyerott; Theresa Ann,1,0,15,14
1746539370345,EDS 284,A00,895736,Meyerott; Theresa Ann,1,0,15,14
1746539371373,EDS 286,A00,897210,Fine; Sarah,0,0,15,15
1746539372403,EDS 289C,A01,895770,Daly; Alan J.,15,0,15,0
1746539373432,EDS 290,A00,897211,Hofstetter; Carolyn,0,0,15,15
1746539374460,LIGM 5A,A00,896162,Fischer-Grunski; Eva K,13,0,20,7
1746539375489,LIGM 5B,A00,896260,Fischer-Grunski; Eva K,17,0,20,3
1746539376517,LIGM 5C,A00,896308,Fischer-Grunski; Eva K,18,0,20,2
1746539377546,LIIT 5AS,A00,896313,Carnelos; Chiara,18,0,20,2
1746539378571,LIIT 5BS,A00,896416,Carnelos; Chiara,20,0,20,0
1746539379603,LIIT 5CS,A00,896564,Carnelos; Chiara,20,0,20,0
1746539380629,LISP 5A,A00,896588,Munoz Sanchez; Alicia,3,0,20,17
1746539381656,LISP 5B,A00,896653,Munoz Sanchez; Alicia,7,0,20,13
1746539382683,LISP 5C,A00,896655,Munoz Sanchez; Alicia,0,1,20,20
1746539383712,MAE 197,001,957918,Kleissl; Jan,9996,0,9999,3
1746539383712,MAE 197,002,959806,Boechler; Nicholas Sebastia,9998,0,9999,1
1746539383712,MAE 197,003,959852,Mullin; Jennifer S,9999,0,9999,0
1746539384740,MATH 2,A01,957937,Staff,33,0,35,2
1746539385769,MATH 197,001,957876,Kedlaya; Kiran S.,9993,0,9999,6
1746539386800,MCWP 40,A00,892729,Duru; Nur,10,0,20,10
1746539386800,MCWP 40,B00,893304,Montejo; Carolina,14,0,20,6
1746539387826,MCWP 40R,A00,893757,Redela; Pamela Morgan,0,5,20,20
1746539388853,MCWP 50,A00,893758,Morshed; Michael James,0,0,20,20
1746539388853,MCWP 50,B00,893761,Bartulis; Jason Michael,17,0,20,3
1746539389885,MCWP 50R,A00,893766,Compas; Sean Matthew,0,1,20,20
1746539389885,MCWP 50R,B00,893769,Carter; Jennifer A,0,1,20,20
1746539389885,MCWP 50R,C00,893771,Krone; Jarret,0,3,20,20
1746539389885,MCWP 50R,D00,893772,Miller; Elizabeth Deen,0,0,20,20
1746539389885,MCWP 50R,E00,893775,Carter; Andrea L,0,1,20,20
1746539390914,MMW 11R,A01,892721,Herbst; Matthew,11,0,27,16
1746539390914,MMW 11R,A02,892722,Herbst; Matthew,0,0,0,3
1746539391939,MMW 12R,A01,892724,Herbst; Matthew,0,11,16,16
1746539391939,MMW 12R,A02,892725,Herbst; Matthew,0,10,16,16
1746539392969,MMW 13R,A01,892727,Staff,0,4,16,16
1746539392969,MMW 13R,A02,892728,Staff,0,4,16,16
1746539392969,MMW 13R,A03,958032,Staff,0,4,16,16
1746539392969,MMW 13R,A04,958033,Staff,0,4,16,16
1746539392969,MMW 13R,A05,958034,Staff,0,4,16,16
1746539393996,SIO 295LS,A00,894015,Staff,5,0,25,20
1746539395022,SIO 295S,A00,894020,Staff,5,0,25,20
1746539396056,SIOC 290S,B01,958918,Merrifield; Mark A,14,0,30,16
1746539397103,SIOC 291S,B01,958922,Gabriel; Corey John,14,0,30,16
1746539398132,SOCI 117,A01,895339,Staff,3,0,5,2
1746539399157,WES 237B,A00,894149,Staff,11,0,20,9
1746539401227,AESE 279B,A00,891859,Staff,13,0,35,22
1746539402251,AIP 197,001,891854,Vespa; Emanuel Ignacio,9999,0,9999,0
1746539403288,ANTH 289S,A00,891856,Gagneux; Pascal,12,0,12,0
1746539404313,BENG 196,001,957946,Engler; Adam J.,9996,0,9999,3
1746539405341,BISP 197,001,959851,Wilhelm; James E.,9999,0,9999,0
1746539406366,CAT 124RS,A01,956906,Staff,6,0,25,19
1746539407391,CAT 125RS,A01,922013,Staff,6,0,25,19
1746539408419,CLRE 250,A00,891860,Morris; Sheldon,9995,0,9999,4
1746539410474,CLRE 251R,A00,907817,Mehta; Ravindra L.,9994,0,9999,5
1746539411501,CLRE 252,A00,891864,Cuomo; Raphael Eduardo,9993,0,9999,6
1746539412526,CLRE 253,A00,891867,Vaida; Florin,9994,0,9999,5
1746539412526,CLRE 253,B00,907819,Staff,9999,0,9999,0
1746539413552,CLRE 259,A00,891868,Patel; Hemal,9998,0,9999,1
1746539414580,CLRE 260,A00,891872,Cuomo; Raphael Eduardo,9999,0,9999,0
1746539415608,CLRE 297,001,891888,Cuomo; Raphael Eduardo,9999,0,9999,0
1746539416636,CSE 191,A00,958773,Minnes Kemp; Mor Mia,9996,0,9999,3
1746539417662,CSE 197,001,959846,Minnes Kemp; Mor Mia,9993,0,9999,6
1746539418691,CSS 201S,A01,892054,Mignozzetti; Umberto,26,0,30,4
1746539419724,CSS 202S,A01,892056,Mignozzetti; Umberto,26,0,30,4
1746539420753,DSC 197,001,956898,Eldridge; Justin Matthew,9998,0,9999,1
1746539421781,DSC 297,001,958000,Mazumdar; Arya,9998,0,9999,1
1746539421781,DSC 297,002,959862,Wang; Yusu,9999,0,9999,0
1746539422807,EAP 100,A00,905686,Staff,9778,0,9999,221
1746539423840,ECE 45,A01,892618,Staff,0,0,65,65
1746539425893,ECE 111,A01,892719,Staff,4,0,65,61
1746539426921,ECE 197,001,957920,Mercier; Patrick Philip,9991,0,9999,8
1746539427950,ECON 178,A01,907814,Zhu; Ying,26,0,35,9
1746539428976,EDS 115,A00,895312,Staff,36,0,45,9
1746539430001,EDS 117,A01,895337,Staff,24,0,30,6
1746539431030,EDS 125,A00,895341,Jones; Gabrielle Anastasia,37,0,45,8
1746539432063,EDS 128A,A01,895459,Fargason; Sharon Gayle,44,0,45,1
1746539433091,EDS 128B,A01,895543,Pappas; Elizabeth,44,0,45,1
1746539434120,EDS 139,A00,897203,Pappas; Elizabeth,44,0,45,1
1746539434120,EDS 139,B00,897209,Fargason; Sharon Gayle,41,0,45,4
1746539435149,EDS 201,A00,895545,Staff,23,0,45,22
1746539436177,EDS 203,A01,895581,Halter; Christopher P.,23,0,45,22
1746539437210,EDS 204R,A01,895625,Heinzman; Erica M.,39,0,45,6
1746539437210,EDS 204R,B01,895693,Halter; Christopher P.,10,0,45,35
1746539438241,EDS 206R,A00,895694,Fargason; Sharon Gayle,1,0,30,29
1746539438241,EDS 206R,B00,895695,Choi; Bailey Miyeon,16,0,30,14
1746539439267,EDS 250,A00,895697,Hemans; Patricia Ann Benitez,23,0,45,22
1746539440295,EDS 281,A00,895701,Meyerott; Theresa Ann,1,0,15,14
1746539441320,EDS 284,A00,895736,Meyerott; Theresa Ann,1,0,15,14
1746539442351,EDS 286,A00,897210,Fine; Sarah,0,0,15,15
1746539443378,EDS 289C,A01,895770,Daly; Alan J.,15,0,15,0
1746539444404,EDS 290,A00,897211,Hofstetter; Carolyn,0,0,15,15
1746539445429,LIGM 5A,A00,896162,Fischer-Grunski; Eva K,13,0,20,7
1746539446459,LIGM 5B,A00,896260,Fischer-Grunski; Eva K,17,0,20,3
1746539447499,LIGM 5C,A00,896308,Fischer-Grunski; Eva K,18,0,20,2
1746539448527,LIIT 5AS,A00,896313,Carnelos; Chiara,18,0,20,2
1746539449560,LIIT 5BS,A00,896416,Carnelos; Chiara,20,0,20,0
1746539450586,LIIT 5CS,A00,896564,Carnelos; Chiara,20,0,20,0
1746539451619,LISP 5A,A00,896588,Munoz Sanchez; Alicia,3,0,20,17
1746539452645,LISP 5B,A00,896653,Munoz Sanchez; Alicia,7,0,20,13
1746539453673,LISP 5C,A00,896655,Munoz Sanchez; Alicia,0,1,20,20
1746539454705,MAE 197,001,957918,Kleissl; Jan,9996,0,9999,3
1746539454705,MAE 197,002,959806,Boechler; Nicholas Sebastia,9998,0,9999,1
1746539454705,MAE 197,003,959852,Mullin; Jennifer S,9999,0,9999,0
1746539455732,MATH 2,A01,957937,Staff,33,0,35,2
1746539456759,MATH 197,001,957876,Kedlaya; Kiran S.,9993,0,9999,6
1746539457785,MCWP 40,A00,892729,Duru; Nur,10,0,20,10
1746539457785,MCWP 40,B00,893304,Montejo; Carolina,14,0,20,6
1746539458818,MCWP 40R,A00,893757,Redela; Pamela Morgan,0,5,20,20
1746539459846,MCWP 50,A00,893758,Morshed; Michael James,0,0,20,20
1746539459846,MCWP 50,B00,893761,Bartulis; Jason Michael,17,0,20,3
1746539460874,MCWP 50R,A00,893766,Compas; Sean Matthew,0,1,20,20
1746539460874,MCWP 50R,B00,893769,Carter; Jennifer A,0,1,20,20
1746539460874,MCWP 50R,C00,893771,Krone; Jarret,0,3,20,20
1746539460874,MCWP 50R,D00,893772,Miller; Elizabeth Deen,0,0,20,20
1746539460874,MCWP 50R,E00,893775,Carter; Andrea L,0,1,20,20
1746539461903,MMW 11R,A01,892721,Herbst; Matthew,11,0,27,16
1746539461903,MMW 11R,A02,892722,Herbst; Matthew,0,0,0,3
1746539462932,MMW 12R,A01,892724,Herbst; Matthew,0,11,16,16
1746539462932,MMW 12R,A02,892725,Herbst; Matthew,0,10,16,16
1746539463960,MMW 13R,A01,892727,Staff,0,4,16,16
1746539463960,MMW 13R,A02,892728,Staff,0,4,16,16
1746539463960,MMW 13R,A03,958032,Staff,0,4,16,16
1746539463960,MMW 13R,A04,958033,Staff,0,4,16,16
1746539463960,MMW 13R,A05,958034,Staff,0,4,16,16
1746539464989,SIO 295LS,A00,894015,Staff,5,0,25,20
1746539466017,SIO 295S,A00,894020,Staff,5,0,25,20
1746539467046,SIOC 290S,B01,958918,Merrifield; Mark A,14,0,30,16
1746539468076,SIOC 291S,B01,958922,Gabriel; Corey John,14,0,30,16
1746539469102,SOCI 117,A01,895339,Staff,3,0,5,2
1746539470127,WES 237B,A00,894149,Staff,11,0,20,9
1746539472207,AESE 279B,A00,891859,Staff,13,0,35,22
1746539473238,AIP 197,001,891854,Vespa; Emanuel Ignacio,9999,0,9999,0
1746539474262,ANTH 289S,A00,891856,Gagneux; Pascal,12,0,12,0
1746539475293,BENG 196,001,957946,Engler; Adam J.,9996,0,9999,3
1746539476323,BISP 197,001,959851,Wilhelm; James E.,9999,0,9999,0
1746539477350,CAT 124RS,A01,956906,Staff,6,0,25,19
1746539478378,CAT 125RS,A01,922013,Staff,6,0,25,19
1746539479408,CLRE 250,A00,891860,Morris; Sheldon,9995,0,9999,4
1746539481467,CLRE 251R,A00,907817,Mehta; Ravindra L.,9994,0,9999,5
1746539482493,CLRE 252,A00,891864,Cuomo; Raphael Eduardo,9993,0,9999,6
1746539483519,CLRE 253,A00,891867,Vaida; Florin,9994,0,9999,5
1746539483519,CLRE 253,B00,907819,Staff,9999,0,9999,0
1746539484545,CLRE 259,A00,891868,Patel; Hemal,9998,0,9999,1
1746539485572,CLRE 260,A00,891872,Cuomo; Raphael Eduardo,9999,0,9999,0
1746539486599,CLRE 297,001,891888,Cuomo; Raphael Eduardo,9999,0,9999,0
1746539487626,CSE 191,A00,958773,Minnes Kemp; Mor Mia,9996,0,9999,3
1746539488654,CSE 197,001,959846,Minnes Kemp; Mor Mia,9993,0,9999,6
1746539489687,CSS 201S,A01,892054,Mignozzetti; Umberto,26,0,30,4
1746539490714,CSS 202S,A01,892056,Mignozzetti; Umberto,26,0,30,4
1746539491739,DSC 197,001,956898,Eldridge; Justin Matthew,9998,0,9999,1
1746539492763,DSC 297,001,958000,Mazumdar; Arya,9998,0,9999,1
1746539492763,DSC 297,002,959862,Wang; Yusu,9999,0,9999,0
1746539493790,EAP 100,A00,905686,Staff,9778,0,9999,221
1746539494816,ECE 45,A01,892618,Staff,0,0,65,65
1746539496869,ECE 111,A01,892719,Staff,4,0,65,61
1746539497896,ECE 197,001,957920,Mercier; Patrick Philip,9991,0,9999,8
1746539498923,ECON 178,A01,907814,Zhu; Ying,26,0,35,9
1746539499950,EDS 115,A00,895312,Staff,36,0,45,9
1746539500976,EDS 117,A01,895337,Staff,24,0,30,6
1746539502002,EDS 125,A00,895341,Jones; Gabrielle Anastasia,37,0,45,8
1746539503034,EDS 128A,A01,895459,Fargason; Sharon Gayle,44,0,45,1
1746539504061,EDS 128B,A01,895543,Pappas; Elizabeth,44,0,45,1
1746539505089,EDS 139,A00,897203,Pappas; Elizabeth,44,0,45,1
1746539505089,EDS 139,B00,897209,Fargason; Sharon Gayle,41,0,45,4
1746539506116,EDS 201,A00,895545,Staff,23,0,45,22
1746539507147,EDS 203,A01,895581,Halter; Christopher P.,23,0,45,22
1746539508172,EDS 204R,A01,895625,Heinzman; Erica M.,39,0,45,6
1746539508172,EDS 204R,B01,895693,Halter; Christopher P.,10,0,45,35
1746539509201,EDS 206R,A00,895694,Fargason; Sharon Gayle,1,0,30,29
1746539509201,EDS 206R,B00,895695,Choi; Bailey Miyeon,16,0,30,14
1746539510237,EDS 250,A00,895697,Hemans; Patricia Ann Benitez,23,0,45,22
1746539511263,EDS 281,A00,895701,Meyerott; Theresa Ann,1,0,15,14
1746539512288,EDS 284,A00,895736,Meyerott; Theresa Ann,1,0,15,14
1746539513832,EDS 286,A00,897210,Fine; Sarah,0,0,15,15
1746539514863,EDS 289C,A01,895770,Daly; Alan J.,15,0,15,0
1746539515888,EDS 290,A00,897211,Hofstetter; Carolyn,0,0,15,15
1746539516916,LIGM 5A,A00,896162,Fischer-Grunski; Eva K,13,0,20,7
1746539517941,LIGM 5B,A00,896260,Fischer-Grunski; Eva K,17,0,20,3
1746539518967,LIGM 5C,A00,896308,Fischer-Grunski; Eva K,18,0,20,2
1746539520125,LIIT 5AS,A00,896313,Carnelos; Chiara,18,0,20,2
1746539521152,LIIT 5BS,A00,896416,Carnelos; Chiara,20,0,20,0
1746539522184,LIIT 5CS,A00,896564,Carnelos; Chiara,20,0,20,0
1746539523211,LISP 5A,A00,896588,Munoz Sanchez; Alicia,3,0,20,17
1746539524238,LISP 5B,A00,896653,Munoz Sanchez; Alicia,7,0,20,13
1746539525265,LISP 5C,A00,896655,Munoz Sanchez; Alicia,0,1,20,20
1746539526296,MAE 197,001,957918,Kleissl; Jan,9996,0,9999,3
1746539526296,MAE 197,002,959806,Boechler; Nicholas Sebastia,9998,0,9999,1
1746539526296,MAE 197,003,959852,Mullin; Jennifer S,9999,0,9999,0
1746539527321,MATH 2,A01,957937,Staff,33,0,35,2
1746539528348,MATH 197,001,957876,Kedlaya; Kiran S.,9993,0,9999,6
1746539529377,MCWP 40,A00,892729,Duru; Nur,10,0,20,10
1746539529377,MCWP 40,B00,893304,Montejo; Carolina,14,0,20,6
1746539530402,MCWP 40R,A00,893757,Redela; Pamela Morgan,0,5,20,20
1746539531434,MCWP 50,A00,893758,Morshed; Michael James,0,0,20,20
1746539531434,MCWP 50,B00,893761,Bartulis; Jason Michael,17,0,20,3
1746539532461,MCWP 50R,A00,893766,Compas; Sean Matthew,0,1,20,20
1746539532461,MCWP 50R,B00,893769,Carter; Jennifer A,0,1,20,20
1746539532461,MCWP 50R,C00,893771,Krone; Jarret,0,3,20,20
1746539532461,MCWP 50R,D00,893772,Miller; Elizabeth Deen,0,0,20,20
1746539532461,MCWP 50R,E00,893775,Carter; Andrea L,0,1,20,20
1746539533487,MMW 11R,A01,892721,Herbst; Matthew,11,0,27,16
1746539533487,MMW 11R,A02,892722,Herbst; Matthew,0,0,0,3
1746539534518,MMW 12R,A01,892724,Herbst; Matthew,0,11,16,16
1746539534518,MMW 12R,A02,892725,Herbst; Matthew,0,10,16,16
1746539535546,MMW 13R,A01,892727,Staff,0,4,16,16
1746539535546,MMW 13R,A02,892728,Staff,0,4,16,16
1746539535546,MMW 13R,A03,958032,Staff,0,4,16,16
1746539535546,MMW 13R,A04,958033,Staff,0,4,16,16
1746539535546,MMW 13R,A05,958034,Staff,0,4,16,16
1746539536577,SIO 295LS,A00,894015,Staff,5,0,25,20
1746539537614,SIO 295S,A00,894020,Staff,5,0,25,20
1746539538641,SIOC 290S,B01,958918,Merrifield; Mark A,14,0,30,16
1746539539667,SIOC 291S,B01,958922,Gabriel; Corey John,14,0,30,16
1746539540696,SOCI 117,A01,895339,Staff,3,0,5,2
1746539541724,WES 237B,A00,894149,Staff,11,0,20,9
1746539543835,AESE 279B,A00,891859,Staff,13,0,35,22
1746539544862,AIP 197,001,891854,Vespa; Emanuel Ignacio,9999,0,9999,0
1746539545890,ANTH 289S,A00,891856,Gagneux; Pascal,12,0,12,0
1746539546916,BENG 196,001,957946,Engler; Adam J.,9996,0,9999,3
1746539547944,BISP 197,001,959851,Wilhelm; James E.,9999,0,9999,0
1746539548969,CAT 124RS,A01,956906,Staff,6,0,25,19
1746539550000,CAT 125RS,A01,922013,Staff,6,0,25,19
1746539551027,CLRE 250,A00,891860,Morris; Sheldon,9995,0,9999,4
1746539553080,CLRE 251R,A00,907817,Mehta; Ravindra L.,9994,0,9999,5
1746539554107,CLRE 252,A00,891864,Cuomo; Raphael Eduardo,9993,0,9999,6
1746539555133,CLRE 253,A00,891867,Vaida; Florin,9994,0,9999,5
1746539555133,CLRE 253,B00,907819,Staff,9999,0,9999,0
1746539556160,CLRE 259,A00,891868,Patel; Hemal,9998,0,9999,1
1746539557185,CLRE 260,A00,891872,Cuomo; Raphael Eduardo,9999,0,9999,0
1746539558211,CLRE 297,001,891888,Cuomo; Raphael Eduardo,9999,0,9999,0
1746539559238,CSE 191,A00,958773,Minnes Kemp; Mor Mia,9996,0,9999,3
1746539560265,CSE 197,001,959846,Minnes Kemp; Mor Mia,9993,0,9999,6
1746539561297,CSS 201S,A01,892054,Mignozzetti; Umberto,26,0,30,4
1746539562326,CSS 202S,A01,892056,Mignozzetti; Umberto,26,0,30,4
1746539563351,DSC 197,001,956898,Eldridge; Justin Matthew,9998,0,9999,1
1746539564380,DSC 297,001,958000,Mazumdar; Arya,9998,0,9999,1
1746539564380,DSC 297,002,959862,Wang; Yusu,9999,0,9999,0
1746539565404,EAP 100,A00,905686,Staff,9778,0,9999,221
1746539566429,ECE 45,A01,892618,Staff,0,0,65,65
1746539568480,ECE 111,A01,892719,Staff,4,0,65,61
1746539569506,ECE 197,001,957920,Mercier; Patrick Philip,9991,0,9999,8
1746539570538,ECON 178,A01,907814,Zhu; Ying,26,0,35,9
1746539571565,EDS 115,A00,895312,Staff,36,0,45,9
1746539572594,EDS 117,A01,895337,Staff,24,0,30,6
1746539573622,EDS 125,A00,895341,Jones; Gabrielle Anastasia,37,0,45,8
1746539574647,EDS 128A,A01,895459,Fargason; Sharon Gayle,44,0,45,1
1746539575678,EDS 128B,A01,895543,Pappas; Elizabeth,44,0,45,1
1746539576703,EDS 139,A00,897203,Pappas; Elizabeth,44,0,45,1
1746539576703,EDS 139,B00,897209,Fargason; Sharon Gayle,41,0,45,4
1746539577728,EDS 201,A00,895545,Staff,23,0,45,22
1746539578759,EDS 203,A01,895581,Halter; Christopher P.,23,0,45,22
1746539579785,EDS 204R,A01,895625,Heinzman; Erica M.,39,0,45,6
1746539579785,EDS 204R,B01,895693,Halter; Christopher P.,10,0,45,35
1746539580814,EDS 206R,A00,895694,Fargason; Sharon Gayle,1,0,30,29
1746539580814,EDS 206R,B00,895695,Choi; Bailey Miyeon,16,0,30,14
1746539581838,EDS 250,A00,895697,Hemans; Patricia Ann Benitez,23,0,45,22
1746539582864,EDS 281,A00,895701,Meyerott; Theresa Ann,1,0,15,14
1746539583892,EDS 284,A00,895736,Meyerott; Theresa Ann,1,0,15,14
1746539584923,EDS 286,A00,897210,Fine; Sarah,0,0,15,15
1746539585950,EDS 289C,A01,895770,Daly; Alan J.,15,0,15,0
1746539586977,EDS 290,A00,897211,Hofstetter; Carolyn,0,0,15,15
1746539588006,LIGM 5A,A00,896162,Fischer-Grunski; Eva K,13,0,20,7
1746539589034,LIGM 5B,A00,896260,Fischer-Grunski; Eva K,17,0,20,3
1746539590065,LIGM 5C,A00,896308,Fischer-Grunski; Eva K,18,0,20,2
1746539591091,LIIT 5AS,A00,896313,Carnelos; Chiara,18,0,20,2
1746539592116,LIIT 5BS,A00,896416,Carnelos; Chiara,20,0,20,0
1746539593143,LIIT 5CS,A00,896564,Carnelos; Chiara,20,0,20,0
1746539594171,LISP 5A,A00,896588,Munoz Sanchez; Alicia,3,0,20,17
1746539595202,LISP 5B,A00,896653,Munoz Sanchez; Alicia,7,0,20,13
1746539596232,LISP 5C,A00,896655,Munoz Sanchez; Alicia,0,1,20,20
1746539597259,MAE 197,001,957918,Kleissl; Jan,9996,0,9999,3
1746539597259,MAE 197,002,959806,Boechler; Nicholas Sebastia,9998,0,9999,1
1746539597259,MAE 197,003,959852,Mullin; Jennifer S,9999,0,9999,0
1746539598284,MATH 2,A01,957937,Staff,33,0,35,2
1746539599310,MATH 197,001,957876,Kedlaya; Kiran S.,9993,0,9999,6
1746539600337,MCWP 40,A00,892729,Duru; Nur,10,0,20,10
1746539600337,MCWP 40,B00,893304,Montejo; Carolina,14,0,20,6
1746539601365,MCWP 40R,A00,893757,Redela; Pamela Morgan,0,5,20,20
1746539602395,MCWP 50,A00,893758,Morshed; Michael James,0,0,20,20
1746539602395,MCWP 50,B00,893761,Bartulis; Jason Michael,17,0,20,3
1746539603428,MCWP 50R,A00,893766,Compas; Sean Matthew,0,1,20,20
1746539603428,MCWP 50R,B00,893769,Carter; Jennifer A,0,1,20,20
1746539603428,MCWP 50R,C00,893771,Krone; Jarret,0,3,20,20
1746539603428,MCWP 50R,D00,893772,Miller; Elizabeth Deen,0,0,20,20
1746539603428,MCWP 50R,E00,893775,Carter; Andrea L,0,1,20,20
1746539604457,MMW 11R,A01,892721,Herbst; Matthew,11,0,27,16
1746539604457,MMW 11R,A02,892722,Herbst; Matthew,0,0,0,3
1746539605485,MMW 12R,A01,892724,Herbst; Matthew,0,11,16,16
1746539605485,MMW 12R,A02,892725,Herbst; Matthew,0,10,16,16
1746539606510,MMW 13R,A01,892727,Staff,0,4,16,16
1746539606510,MMW 13R,A02,892728,Staff,0,4,16,16
1746539606510,MMW 13R,A03,958032,Staff,0,4,16,16
1746539606510,MMW 13R,A04,958033,Staff,0,4,16,16
1746539606510,MMW 13R,A05,958034,Staff,0,4,16,16
1746539607540,SIO 295LS,A00,894015,Staff,5,0,25,20
1746539608570,SIO 295S,A00,894020,Staff,5,0,25,20
1746539609604,SIOC 290S,B01,958918,Merrifield; Mark A,14,0,30,16
1746539610638,SIOC 291S,B01,958922,Gabriel; Corey John,14,0,30,16
1746539611664,SOCI 117,A01,895339,Staff,3,0,5,2
1746539612694,WES 237B,A00,894149,Staff,11,0,20,9
1746539614778,AESE 279B,A00,891859,Staff,13,0,35,22
1746539615806,AIP 197,001,891854,Vespa; Emanuel Ignacio,9999,0,9999,0
1746539616835,ANTH 289S,A00,891856,Gagneux; Pascal,12,0,12,0
1746539617864,BENG 196,001,957946,Engler; Adam J.,9996,0,9999,3
1746539618890,BISP 197,001,959851,Wilhelm; James E.,9999,0,9999,0
1746539619915,CAT 124RS,A01,956906,Staff,6,0,25,19
1746539620944,CAT 125RS,A01,922013,Staff,6,0,25,19
1746539621971,CLRE 250,A00,891860,Morris; Sheldon,9995,0,9999,4
1746539624032,CLRE 251R,A00,907817,Mehta; Ravindra L.,9994,0,9999,5
1746539625065,CLRE 252,A00,891864,Cuomo; Raphael Eduardo,9993,0,9999,6
1746539626097,CLRE 253,A00,891867,Vaida; Florin,9994,0,9999,5
1746539626097,CLRE 253,B00,907819,Staff,9999,0,9999,0
1746539627122,CLRE 259,A00,891868,Patel; Hemal,9998,0,9999,1
1746539628148,CLRE 260,A00,891872,Cuomo; Raphael Eduardo,9999,0,9999,0
1746539629174,CLRE 297,001,891888,Cuomo; Raphael Eduardo,9999,0,9999,0
1746539630201,CSE 191,A00,958773,Minnes Kemp; Mor Mia,9996,0,9999,3
1746539631230,CSE 197,001,959846,Minnes Kemp; Mor Mia,9993,0,9999,6
1746539632253,CSS 201S,A01,892054,Mignozzetti; Umberto,26,0,30,4
1746539633284,CSS 202S,A01,892056,Mignozzetti; Umberto,26,0,30,4
1746539634320,DSC 197,001,956898,Eldridge; Justin Matthew,9998,0,9999,1
1746539635345,DSC 297,001,958000,Mazumdar; Arya,9998,0,9999,1
1746539635345,DSC 297,002,959862,Wang; Yusu,9999,0,9999,0
1746539636371,EAP 100,A00,905686,Staff,9778,0,9999,221
1746539637397,ECE 45,A01,892618,Staff,0,0,65,65
1746539639456,ECE 111,A01,892719,Staff,4,0,65,61
1746539640481,ECE 197,001,957920,Mercier; Patrick Philip,9991,0,9999,8
1746539641511,ECON 178,A01,907814,Zhu; Ying,26,0,35,9
1746539642537,EDS 115,A00,895312,Staff,36,0,45,9
1746539643565,EDS 117,A01,895337,Staff,24,0,30,6
1746539644591,EDS 125,A00,895341,Jones; Gabrielle Anastasia,37,0,45,8
1746539645619,EDS 128A,A01,895459,Fargason; Sharon Gayle,44,0,45,1
1746539646685,EDS 128B,A01,895543,Pappas; Elizabeth,44,0,45,1
1746539647713,EDS 139,A00,897203,Pappas; Elizabeth,44,0,45,1
1746539647713,EDS 139,B00,897209,Fargason; Sharon Gayle,41,0,45,4
1746539648738,EDS 201,A00,895545,Staff,23,0,45,22
1746539649770,EDS 203,A01,895581,Halter; Christopher P.,23,0,45,22
1746539650799,EDS 204R,A01,895625,Heinzman; Erica M.,39,0,45,6
1746539650799,EDS 204R,B01,895693,Halter; Christopher P.,10,0,45,35
1746539651831,EDS 206R,A00,895694,Fargason; Sharon Gayle,1,0,30,29
1746539651831,EDS 206R,B00,895695,Choi; Bailey Miyeon,16,0,30,14
1746539652856,EDS 250,A00,895697,Hemans; Patricia Ann Benitez,23,0,45,22
1746539653882,EDS 281,A00,895701,Meyerott; Theresa Ann,1,0,15,14
1746539654911,EDS 284,A00,895736,Meyerott; Theresa Ann,1,0,15,14
1746539655935,EDS 286,A00,897210,Fine; Sarah,0,0,15,15
1746539656960,EDS 289C,A01,895770,Daly; Alan J.,15,0,15,0
1746539657990,EDS 290,A00,897211,Hofstetter; Carolyn,0,0,15,15
1746539659021,LIGM 5A,A00,896162,Fischer-Grunski; Eva K,13,0,20,7
1746539660048,LIGM 5B,A00,896260,Fischer-Grunski; Eva K,17,0,20,3
1746539661077,LIGM 5C,A00,896308,Fischer-Grunski; Eva K,18,0,20,2
1746539662102,LIIT 5AS,A00,896313,Carnelos; Chiara,18,0,20,2
1746539663128,LIIT 5BS,A00,896416,Carnelos; Chiara,20,0,20,0
1746539664153,LIIT 5CS,A00,896564,Carnelos; Chiara,20,0,20,0
1746539665184,LISP 5A,A00,896588,Munoz Sanchez; Alicia,3,0,20,17
1746539666213,LISP 5B,A00,896653,Munoz Sanchez; Alicia,7,0,20,13
1746539667238,LISP 5C,A00,896655,Munoz Sanchez; Alicia,0,1,20,20
1746539668271,MAE 197,001,957918,Kleissl; Jan,9996,0,9999,3
1746539668271,MAE 197,002,959806,Boechler; Nicholas Sebastia,9998,0,9999,1
1746539668271,MAE 197,003,959852,Mullin; Jennifer S,9999,0,9999,0
1746539669301,MATH 2,A01,957937,Staff,33,0,35,2
1746539670329,MATH 197,001,957876,Kedlaya; Kiran S.,9993,0,9999,6
1746539671359,MCWP 40,A00,892729,Duru; Nur,10,0,20,10
1746539671359,MCWP 40,B00,893304,Montejo; Carolina,14,0,20,6
1746539672390,MCWP 40R,A00,893757,Redela; Pamela Morgan,0,5,20,20
1746539673419,MCWP 50,A00,893758,Morshed; Michael James,0,0,20,20
1746539673419,MCWP 50,B00,893761,Bartulis; Jason Michael,17,0,20,3
1746539674446,MCWP 50R,A00,893766,Compas; Sean Matthew,0,1,20,20
1746539674446,MCWP 50R,B00,893769,Carter; Jennifer A,0,1,20,20
1746539674446,MCWP 50R,C00,893771,Krone; Jarret,0,3,20,20
1746539674446,MCWP 50R,D00,893772,Miller; Elizabeth Deen,0,0,20,20
1746539674446,MCWP 50R,E00,893775,Carter; Andrea L,0,1,20,20
1746539675472,MMW 11R,A01,892721,Herbst; Matthew,11,0,27,16
1746539675472,MMW 11R,A02,892722,Herbst; Matthew,0,0,0,3
1746539676502,MMW 12R,A01,892724,Herbst; Matthew,0,11,16,16
1746539676502,MMW 12R,A02,892725,Herbst; Matthew,0,10,16,16
1746539677528,MMW 13R,A01,892727,Staff,0,4,16,16
1746539677528,MMW 13R,A02,892728,Staff,0,4,16,16
1746539677528,MMW 13R,A03,958032,Staff,0,4,16,16
1746539677528,MMW 13R,A04,958033,Staff,0,4,16,16
1746539677528,MMW 13R,A05,958034,Staff,0,4,16,16
1746539678558,SIO 295LS,A00,894015,Staff,5,0,25,20
1746539679586,SIO 295S,A00,894020,Staff,5,0,25,20
1746539680616,SIOC 290S,B01,958918,Merrifield; Mark A,14,0,30,16
1746539681646,SIOC 291S,B01,958922,Gabriel; Corey John,14,0,30,16
1746539682672,SOCI 117,A01,895339,Staff,3,0,5,2
1746539683698,WES 237B,A00,894149,Staff,11,0,20,9
1746539685787,AESE 279B,A00,891859,Staff,13,0,35,22
1746539686815,AIP 197,001,891854,Vespa; Emanuel Ignacio,9999,0,9999,0
1746539687844,ANTH 289S,A00,891856,Gagneux; Pascal,12,0,12,0
1746539688870,BENG 196,001,957946,Engler; Adam J.,9996,0,9999,3
1746539689895,BISP 197,001,959851,Wilhelm; James E.,9999,0,9999,0
1746539690924,CAT 124RS,A01,956906,Staff,6,0,25,19
1746539691949,CAT 125RS,A01,922013,Staff,6,0,25,19
1746539692979,CLRE 250,A00,891860,Morris; Sheldon,9995,0,9999,4
1746539695036,CLRE 251R,A00,907817,Mehta; Ravindra L.,9994,0,9999,5
1746539696062,CLRE 252,A00,891864,Cuomo; Raphael Eduardo,9993,0,9999,6
1746539697091,CLRE 253,A00,891867,Vaida; Florin,9994,0,9999,5
1746539697091,CLRE 253,B00,907819,Staff,9999,0,9999,0
1746539698121,CLRE 259,A00,891868,Patel; Hemal,9998,0,9999,1
1746539699152,CLRE 260,A00,891872,Cuomo; Raphael Eduardo,9999,0,9999,0
1746539700179,CLRE 297,001,891888,Cuomo; Raphael Eduardo,9999,0,9999,0
1746539701209,CSE 191,A00,958773,Minnes Kemp; Mor Mia,9996,0,9999,3
1746539702241,CSE 197,001,959846,Minnes Kemp; Mor Mia,9993,0,9999,6
1746539703266,CSS 201S,A01,892054,Mignozzetti; Umberto,26,0,30,4
1746539704291,CSS 202S,A01,892056,Mignozzetti; Umberto,26,0,30,4
1746539705316,DSC 197,001,956898,Eldridge; Justin Matthew,9998,0,9999,1
1746539706344,DSC 297,001,958000,Mazumdar; Arya,9998,0,9999,1
1746539706344,DSC 297,002,959862,Wang; Yusu,9999,0,9999,0
1746539707370,EAP 100,A00,905686,Staff,9778,0,9999,221
1746539708398,ECE 45,A01,892618,Staff,0,0,65,65
1746539710452,ECE 111,A01,892719,Staff,4,0,65,61
1746539711480,ECE 197,001,957920,Mercier; Patrick Philip,9991,0,9999,8
1746539712507,ECON 178,A01,907814,Zhu; Ying,26,0,35,9
1746539713534,EDS 115,A00,895312,Staff,36,0,45,9
1746539714560,EDS 117,A01,895337,Staff,24,0,30,6
1746539715591,EDS 125,A00,895341,Jones; Gabrielle Anastasia,37,0,45,8
1746539716617,EDS 128A,A01,895459,Fargason; Sharon Gayle,44,0,45,1
1746539717643,EDS 128B,A01,895543,Pappas; Elizabeth,44,0,45,1
1746539718669,EDS 139,A00,897203,Pappas; Elizabeth,44,0,45,1
1746539718669,EDS 139,B00,897209,Fargason; Sharon Gayle,41,0,45,4
1746539719695,EDS 201,A00,895545,Staff,23,0,45,22
1746539720725,EDS 203,A01,895581,Halter; Christopher P.,23,0,45,22
1746539721752,EDS 204R,A01,895625,Heinzman; Erica M.,39,0,45,6
1746539721752,EDS 204R,B01,895693,Halter; Christopher P.,10,0,45,35
1746539722778,EDS 206R,A00,895694,Fargason; Sharon Gayle,1,0,30,29
1746539722778,EDS 206R,B00,895695,Choi; Bailey Miyeon,16,0,30,14
1746539723808,EDS 250,A00,895697,Hemans; Patricia Ann Benitez,23,0,45,22
1746539724835,EDS 281,A00,895701,Meyerott; Theresa Ann,1,0,15,14
1746539725862,EDS 284,A00,895736,Meyerott; Theresa Ann,1,0,15,14
1746539726889,EDS 286,A00,897210,Fine; Sarah,0,0,15,15
1746539727920,EDS 289C,A01,895770,Daly; Alan J.,15,0,15,0
1746539728948,EDS 290,A00,897211,Hofstetter; Carolyn,0,0,15,15
1746539729975,LIGM 5A,A00,896162,Fischer-Grunski; Eva K,13,0,20,7
1746539731004,LIGM 5B,A00,896260,Fischer-Grunski; Eva K,17,0,20,3
1746539732034,LIGM 5C,A00,896308,Fischer-Grunski; Eva K,18,0,20,2
1746539733065,LIIT 5AS,A00,896313,Carnelos; Chiara,18,0,20,2
1746539734090,LIIT 5BS,A00,896416,Carnelos; Chiara,20,0,20,0
1746539735117,LIIT 5CS,A00,896564,Carnelos; Chiara,20,0,20,0
1746539736142,LISP 5A,A00,896588,Munoz Sanchez; Alicia,3,0,20,17
1746539737171,LISP 5B,A00,896653,Munoz Sanchez; Alicia,7,0,20,13
1746539738197,LISP 5C,A00,896655,Munoz Sanchez; Alicia,0,1,20,20
1746539739224,MAE 197,001,957918,Kleissl; Jan,9996,0,9999,3
1746539739224,MAE 197,002,959806,Boechler; Nicholas Sebastia,9998,0,9999,1
1746539739224,MAE 197,003,959852,Mullin; Jennifer S,9999,0,9999,0
1746539740250,MATH 2,A01,957937,Staff,33,0,35,2
1746539741278,MATH 197,001,957876,Kedlaya; Kiran S.,9993,0,9999,6
1746539742308,MCWP 40,A00,892729,Duru; Nur,10,0,20,10
1746539742308,MCWP 40,B00,893304,Montejo; Carolina,14,0,20,6
1746539743336,MCWP 40R,A00,893757,Redela; Pamela Morgan,0,5,20,20
1746539744363,MCWP 50,A00,893758,Morshed; Michael James,0,0,20,20
1746539744363,MCWP 50,B00,893761,Bartulis; Jason Michael,17,0,20,3
1746539745390,MCWP 50R,A00,893766,Compas; Sean Matthew,0,1,20,20
1746539745390,MCWP 50R,B00,893769,Carter; Jennifer A,0,1,20,20
1746539745390,MCWP 50R,C00,893771,Krone; Jarret,0,3,20,20
1746539745390,MCWP 50R,D00,893772,Miller; Elizabeth Deen,0,0,20,20
1746539745390,MCWP 50R,E00,893775,Carter; Andrea L,0,1,20,20
1746539746416,MMW 11R,A01,892721,Herbst; Matthew,11,0,27,16
1746539746416,MMW 11R,A02,892722,Herbst; Matthew,0,0,0,3
1746539747446,MMW 12R,A01,892724,Herbst; Matthew,0,11,16,16
1746539747446,MMW 12R,A02,892725,Herbst; Matthew,0,10,16,16
1746539748471,MMW 13R,A01,892727,Staff,0,4,16,16
1746539748471,MMW 13R,A02,892728,Staff,0,4,16,16
1746539748471,MMW 13R,A03,958032,Staff,0,4,16,16
1746539748471,MMW 13R,A04,958033,Staff,0,4,16,16
1746539748471,MMW 13R,A05,958034,Staff,0,4,16,16
1746539749498,SIO 295LS,A00,894015,Staff,5,0,25,20
1746539750564,SIO 295S,A00,894020,Staff,5,0,25,20
1746539751592,SIOC 290S,B01,958918,Merrifield; Mark A,14,0,30,16
1746539752617,SIOC 291S,B01,958922,Gabriel; Corey John,14,0,30,16
1746539753646,SOCI 117,A01,895339,Staff,3,0,5,2
1746539754673,WES 237B,A00,894149,Staff,11,0,20,9
1746539756750,AESE 279B,A00,891859,Staff,13,0,35,22
1746539757780,AIP 197,001,891854,Vespa; Emanuel Ignacio,9999,0,9999,0
1746539758809,ANTH 289S,A00,891856,Gagneux; Pascal,12,0,12,0
1746539759838,BENG 196,001,957946,Engler; Adam J.,9996,0,9999,3
1746539760867,BISP 197,001,959851,Wilhelm; James E.,9999,0,9999,0
1746539761894,CAT 124RS,A01,956906,Staff,6,0,25,19
1746539762923,CAT 125RS,A01,922013,Staff,6,0,25,19
1746539763953,CLRE 250,A00,891860,Morris; Sheldon,9995,0,9999,4
1746539766008,CLRE 251R,A00,907817,Mehta; Ravindra L.,9994,0,9999,5
1746539767035,CLRE 252,A00,891864,Cuomo; Raphael Eduardo,9993,0,9999,6
1746539768061,CLRE 253,A00,891867,Vaida; Florin,9994,0,9999,5
1746539768061,CLRE 253,B00,907819,Staff,9999,0,9999,0
1746539769088,CLRE 259,A00,891868,Patel; Hemal,9998,0,9999,1
1746539770114,CLRE 260,A00,891872,Cuomo; Raphael Eduardo,9999,0,9999,0
1746539771142,CLRE 297,001,891888,Cuomo; Raphael Eduardo,9999,0,9999,0
1746539772169,CSE 191,A00,958773,Minnes Kemp; Mor Mia,9996,0,9999,3
1746539773197,CSE 197,001,959846,Minnes Kemp; Mor Mia,9993,0,9999,6
1746539774222,CSS 201S,A01,892054,Mignozzetti; Umberto,26,0,30,4
1746539775252,CSS 202S,A01,892056,Mignozzetti; Umberto,26,0,30,4
1746539776278,DSC 197,001,956898,Eldridge; Justin Matthew,9998,0,9999,1
1746539777307,DSC 297,001,958000,Mazumdar; Arya,9998,0,9999,1
1746539777307,DSC 297,002,959862,Wang; Yusu,9999,0,9999,0
1746539778332,EAP 100,A00,905686,Staff,9778,0,9999,221
1746539779358,ECE 45,A01,892618,Staff,0,0,65,65
1746539781413,ECE 111,A01,892719,Staff,4,0,65,61
1746539782439,ECE 197,001,957920,Mercier; Patrick Philip,9991,0,9999,8
1746539783470,ECON 178,A01,907814,Zhu; Ying,26,0,35,9
1746539784501,EDS 115,A00,895312,Staff,36,0,45,9
1746539785526,EDS 117,A01,895337,Staff,24,0,30,6
1746539786553,EDS 125,A00,895341,Jones; Gabrielle Anastasia,37,0,45,8
1746539787582,EDS 128A,A01,895459,Fargason; Sharon Gayle,44,0,45,1
1746539788612,EDS 128B,A01,895543,Pappas; Elizabeth,44,0,45,1
1746539789638,EDS 139,A00,897203,Pappas; Elizabeth,44,0,45,1
1746539789638,EDS 139,B00,897209,Fargason; Sharon Gayle,41,0,45,4
1746539790666,EDS 201,A00,895545,Staff,23,0,45,22
1746539791693,EDS 203,A01,895581,Halter; Christopher P.,23,0,45,22
1746539792718,EDS 204R,A01,895625,Heinzman; Erica M.,39,0,45,6
1746539792718,EDS 204R,B01,895693,Halter; Christopher P.,10,0,45,35
1746539793745,EDS 206R,A00,895694,Fargason; Sharon Gayle,1,0,30,29
1746539793745,EDS 206R,B00,895695,Choi; Bailey Miyeon,16,0,30,14
1746539794773,EDS 250,A00,895697,Hemans; Patricia Ann Benitez,23,0,45,22
1746539795803,EDS 281,A00,895701,Meyerott; Theresa Ann,1,0,15,14
1746539796829,EDS 284,A00,895736,Meyerott; Theresa Ann,1,0,15,14
1746539797856,EDS 286,A00,897210,Fine; Sarah,0,0,15,15
1746539798883,EDS 289C,A01,895770,Daly; Alan J.,15,0,15,0
1746539799910,EDS 290,A00,897211,Hofstetter; Carolyn,0,0,15,15
1746539800943,LIGM 5A,A00,896162,Fischer-Grunski; Eva K,13,0,20,7
1746539801968,LIGM 5B,A00,896260,Fischer-Grunski; Eva K,17,0,20,3
1746539802994,LIGM 5C,A00,896308,Fischer-Grunski; Eva K,18,0,20,2
1746539804025,LIIT 5AS,A00,896313,Carnelos; Chiara,18,0,20,2
1746539805051,LIIT 5BS,A00,896416,Carnelos; Chiara,20,0,20,0
1746539806078,LIIT 5CS,A00,896564,Carnelos; Chiara,20,0,20,0
1746539807104,LISP 5A,A00,896588,Munoz Sanchez; Alicia,3,0,20,17
1746539808132,LISP 5B,A00,896653,Munoz Sanchez; Alicia,7,0,20,13
1746539809156,LISP 5C,A00,896655,Munoz Sanchez; Alicia,0,1,20,20
1746539810183,MAE 197,001,957918,Kleissl; Jan,9996,0,9999,3
1746539810183,MAE 197,002,959806,Boechler; Nicholas Sebastia,9998,0,9999,1
1746539810183,MAE 197,003,959852,Mullin; Jennifer S,9999,0,9999,0
1746539811211,MATH 2,A01,957937,Staff,33,0,35,2
1746539812236,MATH 197,001,957876,Kedlaya; Kiran S.,9993,0,9999,6
1746539813263,MCWP 40,A00,892729,Duru; Nur,10,0,20,10
1746539813263,MCWP 40,B00,893304,Montejo; Carolina,14,0,20,6
1746539814289,MCWP 40R,A00,893757,Redela; Pamela Morgan,0,5,20,20
1746539815314,MCWP 50,A00,893758,Morshed; Michael James,0,0,20,20
1746539815314,MCWP 50,B00,893761,Bartulis; Jason Michael,17,0,20,3
1746539816351,MCWP 50R,A00,893766,Compas; Sean Matthew,0,1,20,20
1746539816351,MCWP 50R,B00,893769,Carter; Jennifer A,0,1,20,20
1746539816351,MCWP 50R,C00,893771,Krone; Jarret,0,3,20,20
1746539816351,MCWP 50R,D00,893772,Miller; Elizabeth Deen,0,0,20,20
1746539816351,MCWP 50R,E00,893775,Carter; Andrea L,0,1,20,20
1746539817377,MMW 11R,A01,892721,Herbst; Matthew,11,0,27,16
1746539817377,MMW 11R,A02,892722,Herbst; Matthew,0,0,0,3
1746539818401,MMW 12R,A01,892724,Herbst; Matthew,0,11,16,16
1746539818401,MMW 12R,A02,892725,Herbst; Matthew,0,10,16,16
1746539819427,MMW 13R,A01,892727,Staff,0,4,16,16
1746539819427,MMW 13R,A02,892728,Staff,0,4,16,16
1746539819427,MMW 13R,A03,958032,Staff,0,4,16,16
1746539819427,MMW 13R,A04,958033,Staff,0,4,16,16
1746539819427,MMW 13R,A05,958034,Staff,0,4,16,16
1746539820452,SIO 295LS,A00,894015,Staff,5,0,25,20
1746539821480,SIO 295S,A00,894020,Staff,5,0,25,20
1746539822512,SIOC 290S,B01,958918,Merrifield; Mark A,14,0,30,16
1746539823542,SIOC 291S,B01,958922,Gabriel; Corey John,14,0,30,16
1746539824571,SOCI 117,A01,895339,Staff,3,0,5,2
1746539825600,WES 237B,A00,894149,Staff,11,0,20,9
1746539827688,AESE 279B,A00,891859,Staff,13,0,35,22
1746539828714,AIP 197,001,891854,Vespa; Emanuel Ignacio,9999,0,9999,0
1746539829740,ANTH 289S,A00,891856,Gagneux; Pascal,12,0,12,0
1746539830764,BENG 196,001,957946,Engler; Adam J.,9996,0,9999,3
1746539831793,BISP 197,001,959851,Wilhelm; James E.,9999,0,9999,0
1746539832818,CAT 124RS,A01,956906,Staff,6,0,25,19
1746539833847,CAT 125RS,A01,922013,Staff,6,0,25,19
1746539834876,CLRE 250,A00,891860,Morris; Sheldon,9995,0,9999,4
1746539836934,CLRE 251R,A00,907817,Mehta; Ravindra L.,9994,0,9999,5
1746539837960,CLRE 252,A00,891864,Cuomo; Raphael Eduardo,9993,0,9999,6
1746539838985,CLRE 253,A00,891867,Vaida; Florin,9994,0,9999,5
1746539838985,CLRE 253,B00,907819,Staff,9999,0,9999,0
1746539840011,CLRE 259,A00,891868,Patel; Hemal,9998,0,9999,1
1746539841037,CLRE 260,A00,891872,Cuomo; Raphael Eduardo,9999,0,9999,0
1746539842063,CLRE 297,001,891888,Cuomo; Raphael Eduardo,9999,0,9999,0
1746539843089,CSE 191,A00,958773,Minnes Kemp; Mor Mia,9996,0,9999,3
1746539844114,CSE 197,001,959846,Minnes Kemp; Mor Mia,9993,0,9999,6
1746539845146,CSS 201S,A01,892054,Mignozzetti; Umberto,26,0,30,4
1746539846172,CSS 202S,A01,892056,Mignozzetti; Umberto,26,0,30,4
1746539847198,DSC 197,001,956898,Eldridge; Justin Matthew,9998,0,9999,1
1746539848224,DSC 297,001,958000,Mazumdar; Arya,9998,0,9999,1
1746539848224,DSC 297,002,959862,Wang; Yusu,9999,0,9999,0
1746539849252,EAP 100,A00,905686,Staff,9778,0,9999,221
1746539850278,ECE 45,A01,892618,Staff,0,0,65,65
1746539852329,ECE 111,A01,892719,Staff,4,0,65,61
1746539853357,ECE 197,001,957920,Mercier; Patrick Philip,9991,0,9999,8
1746539854420,ECON 178,A01,907814,Zhu; Ying,26,0,35,9
1746539855445,EDS 115,A00,895312,Staff,36,0,45,9
1746539856470,EDS 117,A01,895337,Staff,24,0,30,6
1746539857497,EDS 125,A00,895341,Jones; Gabrielle Anastasia,37,0,45,8
1746539858526,EDS 128A,A01,895459,Fargason; Sharon Gayle,44,0,45,1
1746539859555,EDS 128B,A01,895543,Pappas; Elizabeth,44,0,45,1
1746539860585,EDS 139,A00,897203,Pappas; Elizabeth,44,0,45,1
1746539860585,EDS 139,B00,897209,Fargason; Sharon Gayle,41,0,45,4
1746539861614,EDS 201,A00,895545,Staff,23,0,45,22
1746539862645,EDS 203,A01,895581,Halter; Christopher P.,23,0,45,22
1746539863671,EDS 204R,A01,895625,Heinzman; Erica M.,39,0,45,6
1746539863671,EDS 204R,B01,895693,Halter; Christopher P.,10,0,45,35
1746539864701,EDS 206R,A00,895694,Fargason; Sharon Gayle,1,0,30,29
1746539864701,EDS 206R,B00,895695,Choi; Bailey Miyeon,16,0,30,14
1746539865725,EDS 250,A00,895697,Hemans; Patricia Ann Benitez,23,0,45,22
1746539866754,EDS 281,A00,895701,Meyerott; Theresa Ann,1,0,15,14
1746539867781,EDS 284,A00,895736,Meyerott; Theresa Ann,1,0,15,14
1746539868806,EDS 286,A00,897210,Fine; Sarah,0,0,15,15
1746539869833,EDS 289C,A01,895770,Daly; Alan J.,15,0,15,0
1746539870860,EDS 290,A00,897211,Hofstetter; Carolyn,0,0,15,15
1746539871887,LIGM 5A,A00,896162,Fischer-Grunski; Eva K,13,0,20,7
1746539872914,LIGM 5B,A00,896260,Fischer-Grunski; Eva K,17,0,20,3
1746539873939,LIGM 5C,A00,896308,Fischer-Grunski; Eva K,18,0,20,2
1746539874963,LIIT 5AS,A00,896313,Carnelos; Chiara,18,0,20,2
1746539875992,LIIT 5BS,A00,896416,Carnelos; Chiara,20,0,20,0
1746539877048,LIIT 5CS,A00,896564,Carnelos; Chiara,20,0,20,0
1746539878073,LISP 5A,A00,896588,Munoz Sanchez; Alicia,3,0,20,17
1746539879107,LISP 5B,A00,896653,Munoz Sanchez; Alicia,7,0,20,13
1746539880137,LISP 5C,A00,896655,Munoz Sanchez; Alicia,0,1,20,20
1746539881161,MAE 197,001,957918,Kleissl; Jan,9996,0,9999,3
1746539881161,MAE 197,002,959806,Boechler; Nicholas Sebastia,9998,0,9999,1
1746539881161,MAE 197,003,959852,Mullin; Jennifer S,9999,0,9999,0
1746539882186,MATH 2,A01,957937,Staff,33,0,35,2
1746539883212,MATH 197,001,957876,Kedlaya; Kiran S.,9993,0,9999,6
1746539884241,MCWP 40,A00,892729,Duru; Nur,10,0,20,10
1746539884241,MCWP 40,B00,893304,Montejo; Carolina,14,0,20,6
1746539885271,MCWP 40R,A00,893757,Redela; Pamela Morgan,0,5,20,20
1746539886296,MCWP 50,A00,893758,Morshed; Michael James,0,0,20,20
1746539886296,MCWP 50,B00,893761,Bartulis; Jason Michael,17,0,20,3
1746539887321,MCWP 50R,A00,893766,Compas; Sean Matthew,0,1,20,20
1746539887321,MCWP 50R,B00,893769,Carter; Jennifer A,0,1,20,20
1746539887321,MCWP 50R,C00,893771,Krone; Jarret,0,3,20,20
1746539887321,MCWP 50R,D00,893772,Miller; Elizabeth Deen,0,0,20,20
1746539887321,MCWP 50R,E00,893775,Carter; Andrea L,0,1,20,20
1746539888344,MMW 11R,A01,892721,Herbst; Matthew,11,0,27,16
1746539888344,MMW 11R,A02,892722,Herbst; Matthew,0,0,0,3
1746539889369,MMW 12R,A01,892724,Herbst; Matthew,0,11,16,16
1746539889369,MMW 12R,A02,892725,Herbst; Matthew,0,10,16,16
1746539890398,MMW 13R,A01,892727,Staff,0,4,16,16
1746539890398,MMW 13R,A02,892728,Staff,0,4,16,16
1746539890398,MMW 13R,A03,958032,Staff,0,4,16,16
1746539890398,MMW 13R,A04,958033,Staff,0,4,16,16
1746539890398,MMW 13R,A05,958034,Staff,0,4,16,16
1746539891426,SIO 295LS,A00,894015,Staff,5,0,25,20
1746539892454,SIO 295S,A00,894020,Staff,5,0,25,20
1746539893485,SIOC 290S,B01,958918,Merrifield; Mark A,14,0,30,16
1746539894510,SIOC 291S,B01,958922,Gabriel; Corey John,14,0,30,16
1746539895538,SOCI 117,A01,895339,Staff,3,0,5,2
1746539896564,WES 237B,A00,894149,Staff,11,0,20,9
1746539898635,AESE 279B,A00,891859,Staff,13,0,35,22
1746539899661,AIP 197,001,891854,Vespa; Emanuel Ignacio,9999,0,9999,0
1746539900691,ANTH 289S,A00,891856,Gagneux; Pascal,12,0,12,0
1746539901716,BENG 196,001,957946,Engler; Adam J.,9996,0,9999,3
1746539902742,BISP 197,001,959851,Wilhelm; James E.,9999,0,9999,0
1746539903770,CAT 124RS,A01,956906,Staff,6,0,25,19
1746539904793,CAT 125RS,A01,922013,Staff,6,0,25,19
1746539905821,CLRE 250,A00,891860,Morris; Sheldon,9995,0,9999,4
1746539907879,CLRE 251R,A00,907817,Mehta; Ravindra L.,9994,0,9999,5
1746539908904,CLRE 252,A00,891864,Cuomo; Raphael Eduardo,9993,0,9999,6
1746539909934,CLRE 253,A00,891867,Vaida; Florin,9994,0,9999,5
1746539909934,CLRE 253,B00,907819,Staff,9999,0,9999,0
1746539910962,CLRE 259,A00,891868,Patel; Hemal,9998,0,9999,1
1746539911988,CLRE 260,A00,891872,Cuomo; Raphael Eduardo,9999,0,9999,0
1746539913016,CLRE 297,001,891888,Cuomo; Raphael Eduardo,9999,0,9999,0
1746539914043,CSE 191,A00,958773,Minnes Kemp; Mor Mia,9996,0,9999,3
1746539915072,CSE 197,001,959846,Minnes Kemp; Mor Mia,9993,0,9999,6
1746539916104,CSS 201S,A01,892054,Mignozzetti; Umberto,26,0,30,4
1746539917128,CSS 202S,A01,892056,Mignozzetti; Umberto,26,0,30,4
1746539918154,DSC 197,001,956898,Eldridge; Justin Matthew,9998,0,9999,1
1746539919189,DSC 297,001,958000,Mazumdar; Arya,9998,0,9999,1
1746539919189,DSC 297,002,959862,Wang; Yusu,9999,0,9999,0
1746539920214,EAP 100,A00,905686,Staff,9778,0,9999,221
1746539921242,ECE 45,A01,892618,Staff,0,0,65,65
1746539923299,ECE 111,A01,892719,Staff,4,0,65,61
1746539924325,ECE 197,001,957920,Mercier; Patrick Philip,9991,0,9999,8
1746539925355,ECON 178,A01,907814,Zhu; Ying,26,0,35,9
1746539926380,EDS 115,A00,895312,Staff,36,0,45,9
1746539927406,EDS 117,A01,895337,Staff,24,0,30,6
1746539928433,EDS 125,A00,895341,Jones; Gabrielle Anastasia,37,0,45,8
1746539929459,EDS 128A,A01,895459,Fargason; Sharon Gayle,44,0,45,1
1746539930487,EDS 128B,A01,895543,Pappas; Elizabeth,44,0,45,1
1746539931515,EDS 139,A00,897203,Pappas; Elizabeth,44,0,45,1
1746539931515,EDS 139,B00,897209,Fargason; Sharon Gayle,41,0,45,4
1746539932543,EDS 201,A00,895545,Staff,23,0,45,22
1746539933575,EDS 203,A01,895581,Halter; Christopher P.,23,0,45,22
1746539934601,EDS 204R,A01,895625,Heinzman; Erica M.,39,0,45,6
1746539934601,EDS 204R,B01,895693,Halter; Christopher P.,10,0,45,35
1746539935632,EDS 206R,A00,895694,Fargason; Sharon Gayle,1,0,30,29
1746539935632,EDS 206R,B00,895695,Choi; Bailey Miyeon,16,0,30,14
1746539936661,EDS 250,A00,895697,Hemans; Patricia Ann Benitez,23,0,45,22
1746539937691,EDS 281,A00,895701,Meyerott; Theresa Ann,1,0,15,14
1746539938718,EDS 284,A00,895736,Meyerott; Theresa Ann,1,0,15,14
1746539939745,EDS 286,A00,897210,Fine; Sarah,0,0,15,15
1746539940770,EDS 289C,A01,895770,Daly; Alan J.,15,0,15,0
1746539941797,EDS 290,A00,897211,Hofstetter; Carolyn,0,0,15,15
1746539942827,LIGM 5A,A00,896162,Fischer-Grunski; Eva K,13,0,20,7
1746539943853,LIGM 5B,A00,896260,Fischer-Grunski; Eva K,17,0,20,3
1746539944883,LIGM 5C,A00,896308,Fischer-Grunski; Eva K,18,0,20,2
1746539945910,LIIT 5AS,A00,896313,Carnelos; Chiara,18,0,20,2
1746539946939,LIIT 5BS,A00,896416,Carnelos; Chiara,20,0,20,0
1746539947969,LIIT 5CS,A00,896564,Carnelos; Chiara,20,0,20,0
1746539948993,LISP 5A,A00,896588,Munoz Sanchez; Alicia,3,0,20,17
1746539950024,LISP 5B,A00,896653,Munoz Sanchez; Alicia,7,0,20,13
1746539951049,LISP 5C,A00,896655,Munoz Sanchez; Alicia,0,1,20,20
1746539952081,MAE 197,001,957918,Kleissl; Jan,9996,0,9999,3
1746539952081,MAE 197,002,959806,Boechler; Nicholas Sebastia,9998,0,9999,1
1746539952081,MAE 197,003,959852,Mullin; Jennifer S,9999,0,9999,0
1746539953108,MATH 2,A01,957937,Staff,33,0,35,2
1746539954136,MATH 197,001,957876,Kedlaya; Kiran S.,9993,0,9999,6
1746539955166,MCWP 40,A00,892729,Duru; Nur,10,0,20,10
1746539955166,MCWP 40,B00,893304,Montejo; Carolina,14,0,20,6
1746539956192,MCWP 40R,A00,893757,Redela; Pamela Morgan,0,5,20,20
1746539957219,MCWP 50,A00,893758,Morshed; Michael James,0,0,20,20
1746539957219,MCWP 50,B00,893761,Bartulis; Jason Michael,17,0,20,3
1746539958288,MCWP 50R,A00,893766,Compas; Sean Matthew,0,1,20,20
1746539958288,MCWP 50R,B00,893769,Carter; Jennifer A,0,1,20,20
1746539958288,MCWP 50R,C00,893771,Krone; Jarret,0,3,20,20
1746539958288,MCWP 50R,D00,893772,Miller; Elizabeth Deen,0,0,20,20
1746539958288,MCWP 50R,E00,893775,Carter; Andrea L,0,1,20,20
1746539959316,MMW 11R,A01,892721,Herbst; Matthew,11,0,27,16
1746539959316,MMW 11R,A02,892722,Herbst; Matthew,0,0,0,3
1746539960342,MMW 12R,A01,892724,Herbst; Matthew,0,11,16,16
1746539960342,MMW 12R,A02,892725,Herbst; Matthew,0,10,16,16
1746539961371,MMW 13R,A01,892727,Staff,0,4,16,16
1746539961371,MMW 13R,A02,892728,Staff,0,4,16,16
1746539961371,MMW 13R,A03,958032,Staff,0,4,16,16
1746539961371,MMW 13R,A04,958033,Staff,0,4,16,16
1746539961371,MMW 13R,A05,958034,Staff,0,4,16,16
1746539962414,SIO 295LS,A00,894015,Staff,5,0,25,20
1746539963442,SIO 295S,A00,894020,Staff,5,0,25,20
1746539964470,SIOC 290S,B01,958918,Merrifield; Mark A,14,0,30,16
1746539965500,SIOC 291S,B01,958922,Gabriel; Corey John,14,0,30,16
1746539966526,SOCI 117,A01,895339,Staff,3,0,5,2
1746539967555,WES 237B,A00,894149,Staff,11,0,20,9
1746539969634,AESE 279B,A00,891859,Staff,13,0,35,22
1746539970660,AIP 197,001,891854,Vespa; Emanuel Ignacio,9999,0,9999,0
1746539971690,ANTH 289S,A00,891856,Gagneux; Pascal,12,0,12,0
1746539972721,BENG 196,001,957946,Engler; Adam J.,9996,0,9999,3
1746539973747,BISP 197,001,959851,Wilhelm; James E.,9999,0,9999,0
1746539974774,CAT 124RS,A01,956906,Staff,6,0,25,19
1746539975804,CAT 125RS,A01,922013,Staff,6,0,25,19
1746539976833,CLRE 250,A00,891860,Morris; Sheldon,9995,0,9999,4
1746539978890,CLRE 251R,A00,907817,Mehta; Ravindra L.,9994,0,9999,5
1746539979916,CLRE 252,A00,891864,Cuomo; Raphael Eduardo,9993,0,9999,6
1746539980943,CLRE 253,A00,891867,Vaida; Florin,9994,0,9999,5
1746539980943,CLRE 253,B00,907819,Staff,9999,0,9999,0
1746539981969,CLRE 259,A00,891868,Patel; Hemal,9998,0,9999,1
1746539982994,CLRE 260,A00,891872,Cuomo; Raphael Eduardo,9999,0,9999,0
1746539984025,CLRE 297,001,891888,Cuomo; Raphael Eduardo,9999,0,9999,0
1746539985049,CSE 191,A00,958773,Minnes Kemp; Mor Mia,9996,0,9999,3
1746539986077,CSE 197,001,959846,Minnes Kemp; Mor Mia,9993,0,9999,6
1746539987104,CSS 201S,A01,892054,Mignozzetti; Umberto,26,0,30,4
1746539988135,CSS 202S,A01,892056,Mignozzetti; Umberto,26,0,30,4
1746539989161,DSC 197,001,956898,Eldridge; Justin Matthew,9998,0,9999,1
1746539990188,DSC 297,001,958000,Mazumdar; Arya,9998,0,9999,1
1746539990188,DSC 297,002,959862,Wang; Yusu,9999,0,9999,0
1746539991213,EAP 100,A00,905686,Staff,9778,0,9999,221
1746539992240,ECE 45,A01,892618,Staff,0,0,65,65
1746539994292,ECE 111,A01,892719,Staff,4,0,65,61
1746539995317,ECE 197,001,957920,Mercier; Patrick Philip,9991,0,9999,8
1746539996349,ECON 178,A01,907814,Zhu; Ying,26,0,35,9
1746539997375,EDS 115,A00,895312,Staff,36,0,45,9
1746539998400,EDS 117,A01,895337,Staff,24,0,30,6
1746539999434,EDS 125,A00,895341,Jones; Gabrielle Anastasia,37,0,45,8
1746540000464,EDS 128A,A01,895459,Fargason; Sharon Gayle,44,0,45,1
1746540001499,EDS 128B,A01,895543,Pappas; Elizabeth,44,0,45,1
1746540002526,EDS 139,A00,897203,Pappas; Elizabeth,44,0,45,1
1746540002526,EDS 139,B00,897209,Fargason; Sharon Gayle,41,0,45,4
1746540003552,EDS 201,A00,895545,Staff,23,0,45,22
1746540004578,EDS 203,A01,895581,Halter; Christopher P.,23,0,45,22
1746540005605,EDS 204R,A01,895625,Heinzman; Erica M.,39,0,45,6
1746540005605,EDS 204R,B01,895693,Halter; Christopher P.,10,0,45,35
1746540006633,EDS 206R,A00,895694,Fargason; Sharon Gayle,1,0,30,29
1746540006633,EDS 206R,B00,895695,Choi; Bailey Miyeon,16,0,30,14
1746540007660,EDS 250,A00,895697,Hemans; Patricia Ann Benitez,23,0,45,22
1746540008686,EDS 281,A00,895701,Meyerott; Theresa Ann,1,0,15,14
1746540009715,EDS 284,A00,895736,Meyerott; Theresa Ann,1,0,15,14
1746540010740,EDS 286,A00,897210,Fine; Sarah,0,0,15,15
1746540011767,EDS 289C,A01,895770,Daly; Alan J.,15,0,15,0
1746540012795,EDS 290,A00,897211,Hofstetter; Carolyn,0,0,15,15
1746540013826,LIGM 5A,A00,896162,Fischer-Grunski; Eva K,13,0,20,7
1746540014853,LIGM 5B,A00,896260,Fischer-Grunski; Eva K,17,0,20,3
1746540015877,LIGM 5C,A00,896308,Fischer-Grunski; Eva K,18,0,20,2
1746540016903,LIIT 5AS,A00,896313,Carnelos; Chiara,18,0,20,2
1746540017931,LIIT 5BS,A00,896416,Carnelos; Chiara,20,0,20,0
1746540018960,LIIT 5CS,A00,896564,Carnelos; Chiara,20,0,20,0
1746540019995,LISP 5A,A00,896588,Munoz Sanchez; Alicia,3,0,20,17
1746540021027,LISP 5B,A00,896653,Munoz Sanchez; Alicia,7,0,20,13
1746540022054,LISP 5C,A00,896655,Munoz Sanchez; Alicia,0,1,20,20
1746540023086,MAE 197,001,957918,Kleissl; Jan,9996,0,9999,3
1746540023086,MAE 197,002,959806,Boechler; Nicholas Sebastia,9998,0,9999,1
1746540023086,MAE 197,003,959852,Mullin; Jennifer S,9999,0,9999,0
1746540024114,MATH 2,A01,957937,Staff,33,0,35,2
1746540025141,MATH 197,001,957876,Kedlaya; Kiran S.,9993,0,9999,6
1746540026171,MCWP 40,A00,892729,Duru; Nur,10,0,20,10
1746540026171,MCWP 40,B00,893304,Montejo; Carolina,14,0,20,6
1746540027199,MCWP 40R,A00,893757,Redela; Pamela Morgan,0,5,20,20
1746540028227,MCWP 50,A00,893758,Morshed; Michael James,0,0,20,20
1746540028227,MCWP 50,B00,893761,Bartulis; Jason Michael,17,0,20,3
1746540029255,MCWP 50R,A00,893766,Compas; Sean Matthew,0,1,20,20
1746540029255,MCWP 50R,B00,893769,Carter; Jennifer A,0,1,20,20
1746540029255,MCWP 50R,C00,893771,Krone; Jarret,0,3,20,20
1746540029255,MCWP 50R,D00,893772,Miller; Elizabeth Deen,0,0,20,20
1746540029255,MCWP 50R,E00,893775,Carter; Andrea L,0,1,20,20
1746540030286,MMW 11R,A01,892721,Herbst; Matthew,11,0,27,16
1746540030286,MMW 11R,A02,892722,Herbst; Matthew,0,0,0,3
1746540031313,MMW 12R,A01,892724,Herbst; Matthew,0,11,16,16
1746540031313,MMW 12R,A02,892725,Herbst; Matthew,0,10,16,16
1746540032339,MMW 13R,A01,892727,Staff,0,4,16,16
1746540032339,MMW 13R,A02,892728,Staff,0,4,16,16
1746540032339,MMW 13R,A03,958032,Staff,0,4,16,16
1746540032339,MMW 13R,A04,958033,Staff,0,4,16,16
1746540032339,MMW 13R,A05,958034,Staff,0,4,16,16
1746540033365,SIO 295LS,A00,894015,Staff,5,0,25,20
1746540034389,SIO 295S,A00,894020,Staff,5,0,25,20
1746540035417,SIOC 290S,B01,958918,Merrifield; Mark A,14,0,30,16
1746540036448,SIOC 291S,B01,958922,Gabriel; Corey John,14,0,30,16
1746540037477,SOCI 117,A01,895339,Staff,3,0,5,2
1746540038503,WES 237B,A00,894149,Staff,11,0,20,9
1746540040580,AESE 279B,A00,891859,Staff,13,0,35,22
1746540041607,AIP 197,001,891854,Vespa; Emanuel Ignacio,9999,0,9999,0
1746540042634,ANTH 289S,A00,891856,Gagneux; Pascal,12,0,12,0
1746540043662,BENG 196,001,957946,Engler; Adam J.,9996,0,9999,3
1746540044688,BISP 197,001,959851,Wilhelm; James E.,9999,0,9999,0
1746540045718,CAT 124RS,A01,956906,Staff,6,0,25,19
1746540046742,CAT 125RS,A01,922013,Staff,6,0,25,19
1746540047770,CLRE 250,A00,891860,Morris; Sheldon,9995,0,9999,4
1746540049825,CLRE 251R,A00,907817,Mehta; Ravindra L.,9994,0,9999,5
1746540050853,CLRE 252,A00,891864,Cuomo; Raphael Eduardo,9993,0,9999,6
1746540051879,CLRE 253,A00,891867,Vaida; Florin,9994,0,9999,5
1746540051879,CLRE 253,B00,907819,Staff,9999,0,9999,0
1746540052906,CLRE 259,A00,891868,Patel; Hemal,9998,0,9999,1
1746540053934,CLRE 260,A00,891872,Cuomo; Raphael Eduardo,9999,0,9999,0
1746540054959,CLRE 297,001,891888,Cuomo; Raphael Eduardo,9999,0,9999,0
1746540055988,CSE 191,A00,958773,Minnes Kemp; Mor Mia,9996,0,9999,3
1746540057015,CSE 197,001,959846,Minnes Kemp; Mor Mia,9993,0,9999,6
1746540058043,CSS 201S,A01,892054,Mignozzetti; Umberto,26,0,30,4
1746540059068,CSS 202S,A01,892056,Mignozzetti; Umberto,26,0,30,4
1746540060100,DSC 197,001,956898,Eldridge; Justin Matthew,9998,0,9999,1
1746540061126,DSC 297,001,958000,Mazumdar; Arya,9998,0,9999,1
1746540061126,DSC 297,002,959862,Wang; Yusu,9999,0,9999,0
1746540062198,EAP 100,A00,905686,Staff,9778,0,9999,221
1746540063230,ECE 45,A01,892618,Staff,0,0,65,65
1746540065287,ECE 111,A01,892719,Staff,4,0,65,61
1746540066315,ECE 197,001,957920,Mercier; Patrick Philip,9991,0,9999,8
1746540067341,ECON 178,A01,907814,Zhu; Ying,26,0,35,9
1746540068368,EDS 115,A00,895312,Staff,36,0,45,9
1746540069395,EDS 117,A01,895337,Staff,24,0,30,6
1746540070421,EDS 125,A00,895341,Jones; Gabrielle Anastasia,37,0,45,8
1746540071449,EDS 128A,A01,895459,Fargason; Sharon Gayle,44,0,45,1
1746540072476,EDS 128B,A01,895543,Pappas; Elizabeth,44,0,45,1
1746540073503,EDS 139,A00,897203,Pappas; Elizabeth,44,0,45,1
1746540073503,EDS 139,B00,897209,Fargason; Sharon Gayle,41,0,45,4
1746540074532,EDS 201,A00,895545,Staff,23,0,45,22
1746540075563,EDS 203,A01,895581,Halter; Christopher P.,23,0,45,22
1746540076588,EDS 204R,A01,895625,Heinzman; Erica M.,39,0,45,6
1746540076588,EDS 204R,B01,895693,Halter; Christopher P.,10,0,45,35
1746540077618,EDS 206R,A00,895694,Fargason; Sharon Gayle,1,0,30,29
1746540077618,EDS 206R,B00,895695,Choi; Bailey Miyeon,16,0,30,14
1746540078645,EDS 250,A00,895697,Hemans; Patricia Ann Benitez,23,0,45,22
1746540079669,EDS 281,A00,895701,Meyerott; Theresa Ann,1,0,15,14
1746540080695,EDS 284,A00,895736,Meyerott; Theresa Ann,1,0,15,14
1746540081721,EDS 286,A00,897210,Fine; Sarah,0,0,15,15
1746540082748,EDS 289C,A01,895770,Daly; Alan J.,15,0,15,0
1746540083774,EDS 290,A00,897211,Hofstetter; Carolyn,0,0,15,15
1746540084801,LIGM 5A,A00,896162,Fischer-Grunski; Eva K,13,0,20,7
1746540085826,LIGM 5B,A00,896260,Fischer-Grunski; Eva K,17,0,20,3
1746540086855,LIGM 5C,A00,896308,Fischer-Grunski; Eva K,18,0,20,2
1746540087885,LIIT 5AS,A00,896313,Carnelos; Chiara,18,0,20,2
1746540088913,LIIT 5BS,A00,896416,Carnelos; Chiara,20,0,20,0
1746540089941,LIIT 5CS,A00,896564,Carnelos; Chiara,20,0,20,0
1746540090967,LISP 5A,A00,896588,Munoz Sanchez; Alicia,3,0,20,17
1746540091994,LISP 5B,A00,896653,Munoz Sanchez; Alicia,7,0,20,13
1746540093020,LISP 5C,A00,896655,Munoz Sanchez; Alicia,0,1,20,20
1746540094047,MAE 197,001,957918,Kleissl; Jan,9996,0,9999,3
1746540094047,MAE 197,002,959806,Boechler; Nicholas Sebastia,9998,0,9999,1
1746540094047,MAE 197,003,959852,Mullin; Jennifer S,9999,0,9999,0
1746540095073,MATH 2,A01,957937,Staff,33,0,35,2
1746540096101,MATH 197,001,957876,Kedlaya; Kiran S.,9993,0,9999,6
1746540097128,MCWP 40,A00,892729,Duru; Nur,10,0,20,10
1746540097128,MCWP 40,B00,893304,Montejo; Carolina,14,0,20,6
1746540098153,MCWP 40R,A00,893757,Redela; Pamela Morgan,0,5,20,20
1746540099181,MCWP 50,A00,893758,Morshed; Michael James,0,0,20,20
1746540099181,MCWP 50,B00,893761,Bartulis; Jason Michael,17,0,20,3
1746540100206,MCWP 50R,A00,893766,Compas; Sean Matthew,0,1,20,20
1746540100206,MCWP 50R,B00,893769,Carter; Jennifer A,0,1,20,20
1746540100206,MCWP 50R,C00,893771,Krone; Jarret,0,3,20,20
1746540100206,MCWP 50R,D00,893772,Miller; Elizabeth Deen,0,0,20,20
1746540100206,MCWP 50R,E00,893775,Carter; Andrea L,0,1,20,20
1746540101236,MMW 11R,A01,892721,Herbst; Matthew,11,0,27,16
1746540101236,MMW 11R,A02,892722,Herbst; Matthew,0,0,0,3
1746540102262,MMW 12R,A01,892724,Herbst; Matthew,0,11,16,16
1746540102262,MMW 12R,A02,892725,Herbst; Matthew,0,10,16,16
1746540103289,MMW 13R,A01,892727,Staff,0,4,16,16
1746540103289,MMW 13R,A02,892728,Staff,0,4,16,16
1746540103289,MMW 13R,A03,958032,Staff,0,4,16,16
1746540103289,MMW 13R,A04,958033,Staff,0,4,16,16
1746540103289,MMW 13R,A05,958034,Staff,0,4,16,16
1746540104316,SIO 295LS,A00,894015,Staff,5,0,25,20
1746540105345,SIO 295S,A00,894020,Staff,5,0,25,20
1746540106376,SIOC 290S,B01,958918,Merrifield; Mark A,14,0,30,16
1746540107401,SIOC 291S,B01,958922,Gabriel; Corey John,14,0,30,16
1746540108425,SOCI 117,A01,895339,Staff,3,0,5,2
1746540109454,WES 237B,A00,894149,Staff,11,0,20,9
1746540111512,AESE 279B,A00,891859,Staff,13,0,35,22
1746540112537,AIP 197,001,891854,Vespa; Emanuel Ignacio,9999,0,9999,0
1746540113566,ANTH 289S,A00,891856,Gagneux; Pascal,12,0,12,0
1746540114591,BENG 196,001,957946,Engler; Adam J.,9996,0,9999,3
1746540115620,BISP 197,001,959851,Wilhelm; James E.,9999,0,9999,0
1746540116644,CAT 124RS,A01,956906,Staff,6,0,25,19
1746540117671,CAT 125RS,A01,922013,Staff,6,0,25,19
1746540118696,CLRE 250,A00,891860,Morris; Sheldon,9995,0,9999,4
1746540120749,CLRE 251R,A00,907817,Mehta; Ravindra L.,9994,0,9999,5
1746540121778,CLRE 252,A00,891864,Cuomo; Raphael Eduardo,9993,0,9999,6
1746540122806,CLRE 253,A00,891867,Vaida; Florin,9994,0,9999,5
1746540122806,CLRE 253,B00,907819,Staff,9999,0,9999,0
1746540123834,CLRE 259,A00,891868,Patel; Hemal,9998,0,9999,1
1746540124860,CLRE 260,A00,891872,Cuomo; Raphael Eduardo,9999,0,9999,0
1746540125887,CLRE 297,001,891888,Cuomo; Raphael Eduardo,9999,0,9999,0
1746540126918,CSE 191,A00,958773,Minnes Kemp; Mor Mia,9996,0,9999,3
1746540127944,CSE 197,001,959846,Minnes Kemp; Mor Mia,9993,0,9999,6
1746540128971,CSS 201S,A01,892054,Mignozzetti; Umberto,26,0,30,4
1746540130010,CSS 202S,A01,892056,Mignozzetti; Umberto,26,0,30,4
1746540131035,DSC 197,001,956898,Eldridge; Justin Matthew,9998,0,9999,1
1746540132060,DSC 297,001,958000,Mazumdar; Arya,9998,0,9999,1
1746540132060,DSC 297,002,959862,Wang; Yusu,9999,0,9999,0
1746540133083,EAP 100,A00,905686,Staff,9778,0,9999,221
1746540134114,ECE 45,A01,892618,Staff,0,0,65,65
1746540136167,ECE 111,A01,892719,Staff,4,0,65,61
1746540137195,ECE 197,001,957920,Mercier; Patrick Philip,9991,0,9999,8
1746540138222,ECON 178,A01,907814,Zhu; Ying,26,0,35,9
1746540139245,EDS 115,A00,895312,Staff,36,0,45,9
1746540140275,EDS 117,A01,895337,Staff,24,0,30,6
1746540141305,EDS 125,A00,895341,Jones; Gabrielle Anastasia,37,0,45,8
1746540142329,EDS 128A,A01,895459,Fargason; Sharon Gayle,44,0,45,1
1746540143358,EDS 128B,A01,895543,Pappas; Elizabeth,44,0,45,1
1746540144383,EDS 139,A00,897203,Pappas; Elizabeth,44,0,45,1
1746540144383,EDS 139,B00,897209,Fargason; Sharon Gayle,41,0,45,4
1746540145409,EDS 201,A00,895545,Staff,23,0,45,22
1746540146439,EDS 203,A01,895581,Halter; Christopher P.,23,0,45,22
1746540147468,EDS 204R,A01,895625,Heinzman; Erica M.,39,0,45,6
1746540147468,EDS 204R,B01,895693,Halter; Christopher P.,10,0,45,35
1746540148498,EDS 206R,A00,895694,Fargason; Sharon Gayle,1,0,30,29
1746540148498,EDS 206R,B00,895695,Choi; Bailey Miyeon,16,0,30,14
1746540149524,EDS 250,A00,895697,Hemans; Patricia Ann Benitez,23,0,45,22
1746540150550,EDS 281,A00,895701,Meyerott; Theresa Ann,1,0,15,14
1746540151575,EDS 284,A00,895736,Meyerott; Theresa Ann,1,0,15,14
1746540152599,EDS 286,A00,897210,Fine; Sarah,0,0,15,15
1746540153626,EDS 289C,A01,895770,Daly; Alan J.,15,0,15,0
1746540154652,EDS 290,A00,897211,Hofstetter; Carolyn,0,0,15,15
1746540155678,LIGM 5A,A00,896162,Fischer-Grunski; Eva K,13,0,20,7
1746540156707,LIGM 5B,A00,896260,Fischer-Grunski; Eva K,17,0,20,3
1746540157733,LIGM 5C,A00,896308,Fischer-Grunski; Eva K,18,0,20,2
1746540158760,LIIT 5AS,A00,896313,Carnelos; Chiara,18,0,20,2
1746540159787,LIIT 5BS,A00,896416,Carnelos; Chiara,20,0,20,0
1746540160811,LIIT 5CS,A00,896564,Carnelos; Chiara,20,0,20,0
1746540161837,LISP 5A,A00,896588,Munoz Sanchez; Alicia,3,0,20,17
1746540162865,LISP 5B,A00,896653,Munoz Sanchez; Alicia,7,0,20,13
1746540163890,LISP 5C,A00,896655,Munoz Sanchez; Alicia,0,1,20,20
1746540164918,MAE 197,001,957918,Kleissl; Jan,9996,0,9999,3
1746540164918,MAE 197,002,959806,Boechler; Nicholas Sebastia,9998,0,9999,1
1746540164918,MAE 197,003,959852,Mullin; Jennifer S,9999,0,9999,0
1746540165999,MATH 2,A01,957937,Staff,33,0,35,2
1746540167027,MATH 197,001,957876,Kedlaya; Kiran S.,9993,0,9999,6
1746540168054,MCWP 40,A00,892729,Duru; Nur,10,0,20,10
1746540168054,MCWP 40,B00,893304,Montejo; Carolina,14,0,20,6
1746540169079,MCWP 40R,A00,893757,Redela; Pamela Morgan,0,5,20,20
1746540170109,MCWP 50,A00,893758,Morshed; Michael James,0,0,20,20
1746540170109,MCWP 50,B00,893761,Bartulis; Jason Michael,17,0,20,3
1746540171135,MCWP 50R,A00,893766,Compas; Sean Matthew,0,1,20,20
1746540171135,MCWP 50R,B00,893769,Carter; Jennifer A,0,1,20,20
1746540171135,MCWP 50R,C00,893771,Krone; Jarret,0,3,20,20
1746540171135,MCWP 50R,D00,893772,Miller; Elizabeth Deen,0,0,20,20
1746540171135,MCWP 50R,E00,893775,Carter; Andrea L,0,1,20,20
1746540172160,MMW 11R,A01,892721,Herbst; Matthew,11,0,27,16
1746540172160,MMW 11R,A02,892722,Herbst; Matthew,0,0,0,3
1746540173190,MMW 12R,A01,892724,Herbst; Matthew,0,11,16,16
1746540173190,MMW 12R,A02,892725,Herbst; Matthew,0,10,16,16
1746540174217,MMW 13R,A01,892727,Staff,0,4,16,16
1746540174217,MMW 13R,A02,892728,Staff,0,4,16,16
1746540174217,MMW 13R,A03,958032,Staff,0,4,16,16
1746540174217,MMW 13R,A04,958033,Staff,0,4,16,16
1746540174217,MMW 13R,A05,958034,Staff,0,4,16,16
1746540175241,SIO 295LS,A00,894015,Staff,5,0,25,20
1746540176267,SIO 295S,A00,894020,Staff,5,0,25,20
1746540177294,SIOC 290S,B01,958918,Merrifield; Mark A,14,0,30,16
1746540178325,SIOC 291S,B01,958922,Gabriel; Corey John,14,0,30,16
1746540179351,SOCI 117,A01,895339,Staff,3,0,5,2
1746540180377,WES 237B,A00,894149,Staff,11,0,20,9
1746540182440,AESE 279B,A00,891859,Staff,13,0,35,22
1746540183466,AIP 197,001,891854,Vespa; Emanuel Ignacio,9999,0,9999,0
1746540184490,ANTH 289S,A00,891856,Gagneux; Pascal,12,0,12,0
1746540185518,BENG 196,001,957946,Engler; Adam J.,9996,0,9999,3
1746540186542,BISP 197,001,959851,Wilhelm; James E.,9999,0,9999,0
1746540187568,CAT 124RS,A01,956906,Staff,6,0,25,19
1746540188593,CAT 125RS,A01,922013,Staff,6,0,25,19
1746540189623,CLRE 250,A00,891860,Morris; Sheldon,9995,0,9999,4
1746540191677,CLRE 251R,A00,907817,Mehta; Ravindra L.,9994,0,9999,5
1746540192701,CLRE 252,A00,891864,Cuomo; Raphael Eduardo,9993,0,9999,6
1746540193726,CLRE 253,A00,891867,Vaida; Florin,9994,0,9999,5
1746540193726,CLRE 253,B00,907819,Staff,9999,0,9999,0
1746540194756,CLRE 259,A00,891868,Patel; Hemal,9998,0,9999,1
1746540195780,CLRE 260,A00,891872,Cuomo; Raphael Eduardo,9999,0,9999,0
1746540196809,CLRE 297,001,891888,Cuomo; Raphael Eduardo,9999,0,9999,0
1746540197836,CSE 191,A00,958773,Minnes Kemp; Mor Mia,9996,0,9999,3
1746540198861,CSE 197,001,959846,Minnes Kemp; Mor Mia,9993,0,9999,6
1746540199896,CSS 201S,A01,892054,Mignozzetti; Umberto,26,0,30,4
1746540200921,CSS 202S,A01,892056,Mignozzetti; Umberto,26,0,30,4
1746540201948,DSC 197,001,956898,Eldridge; Justin Matthew,9998,0,9999,1
1746540202973,DSC 297,001,958000,Mazumdar; Arya,9998,0,9999,1
1746540202973,DSC 297,002,959862,Wang; Yusu,9999,0,9999,0
1746540204002,EAP 100,A00,905686,Staff,9778,0,9999,221
1746540205032,ECE 45,A01,892618,Staff,0,0,65,65
1746540207082,ECE 111,A01,892719,Staff,4,0,65,61
1746540208108,ECE 197,001,957920,Mercier; Patrick Philip,9991,0,9999,8
1746540209138,ECON 178,A01,907814,Zhu; Ying,26,0,35,9
1746540210166,EDS 115,A00,895312,Staff,36,0,45,9
1746540211193,EDS 117,A01,895337,Staff,24,0,30,6
1746540212220,EDS 125,A00,895341,Jones; Gabrielle Anastasia,37,0,45,8
1746540213247,EDS 128A,A01,895459,Fargason; Sharon Gayle,44,0,45,1
1746540214271,EDS 128B,A01,895543,Pappas; Elizabeth,44,0,45,1
1746540215295,EDS 139,A00,897203,Pappas; Elizabeth,44,0,45,1
1746540215295,EDS 139,B00,897209,Fargason; Sharon Gayle,41,0,45,4
1746540216322,EDS 201,A00,895545,Staff,23,0,45,22
1746540217351,EDS 203,A01,895581,Halter; Christopher P.,23,0,45,22
1746540218379,EDS 204R,A01,895625,Heinzman; Erica M.,39,0,45,6
1746540218379,EDS 204R,B01,895693,Halter; Christopher P.,10,0,45,35
1746540219403,EDS 206R,A00,895694,Fargason; Sharon Gayle,1,0,30,29
1746540219403,EDS 206R,B00,895695,Choi; Bailey Miyeon,16,0,30,14
1746540220428,EDS 250,A00,895697,Hemans; Patricia Ann Benitez,23,0,45,22
1746540221457,EDS 281,A00,895701,Meyerott; Theresa Ann,1,0,15,14
1746540222482,EDS 284,A00,895736,Meyerott; Theresa Ann,1,0,15,14
1746540223507,EDS 286,A00,897210,Fine; Sarah,0,0,15,15
1746540224532,EDS 289C,A01,895770,Daly; Alan J.,15,0,15,0
1746540225558,EDS 290,A00,897211,Hofstetter; Carolyn,0,0,15,15
1746540226587,LIGM 5A,A00,896162,Fischer-Grunski; Eva K,13,0,20,7
1746540227612,LIGM 5B,A00,896260,Fischer-Grunski; Eva K,17,0,20,3
1746540228640,LIGM 5C,A00,896308,Fischer-Grunski; Eva K,18,0,20,2
1746540229666,LIIT 5AS,A00,896313,Carnelos; Chiara,18,0,20,2
1746540230700,LIIT 5BS,A00,896416,Carnelos; Chiara,20,0,20,0
1746540231729,LIIT 5CS,A00,896564,Carnelos; Chiara,20,0,20,0
1746540232755,LISP 5A,A00,896588,Munoz Sanchez; Alicia,3,0,20,17
1746540233784,LISP 5B,A00,896653,Munoz Sanchez; Alicia,7,0,20,13
1746540234815,LISP 5C,A00,896655,Munoz Sanchez; Alicia,0,1,20,20
1746540235844,MAE 197,001,957918,Kleissl; Jan,9996,0,9999,3
1746540235844,MAE 197,002,959806,Boechler; Nicholas Sebastia,9998,0,9999,1
1746540235844,MAE 197,003,959852,Mullin; Jennifer S,9999,0,9999,0
1746540236875,MATH 2,A01,957937,Staff,33,0,35,2
1746540237903,MATH 197,001,957876,Kedlaya; Kiran S.,9993,0,9999,6
1746540238928,MCWP 40,A00,892729,Duru; Nur,10,0,20,10
1746540238928,MCWP 40,B00,893304,Montejo; Carolina,14,0,20,6
1746540239954,MCWP 40R,A00,893757,Redela; Pamela Morgan,0,5,20,20
1746540240981,MCWP 50,A00,893758,Morshed; Michael James,0,0,20,20
1746540240981,MCWP 50,B00,893761,Bartulis; Jason Michael,17,0,20,3
1746540242009,MCWP 50R,A00,893766,Compas; Sean Matthew,0,1,20,20
1746540242009,MCWP 50R,B00,893769,Carter; Jennifer A,0,1,20,20
1746540242009,MCWP 50R,C00,893771,Krone; Jarret,0,3,20,20
1746540242009,MCWP 50R,D00,893772,Miller; Elizabeth Deen,0,0,20,20
1746540242009,MCWP 50R,E00,893775,Carter; Andrea L,0,1,20,20
1746540243038,MMW 11R,A01,892721,Herbst; Matthew,11,0,27,16
1746540243038,MMW 11R,A02,892722,Herbst; Matthew,0,0,0,3
1746540244062,MMW 12R,A01,892724,Herbst; Matthew,0,11,16,16
1746540244062,MMW 12R,A02,892725,Herbst; Matthew,0,10,16,16
1746540245091,MMW 13R,A01,892727,Staff,0,4,16,16
1746540245091,MMW 13R,A02,892728,Staff,0,4,16,16
1746540245091,MMW 13R,A03,958032,Staff,0,4,16,16
1746540245091,MMW 13R,A04,958033,Staff,0,4,16,16
1746540245091,MMW 13R,A05,958034,Staff,0,4,16,16
1746540246120,SIO 295LS,A00,894015,Staff,5,0,25,20
1746540247150,SIO 295S,A00,894020,Staff,5,0,25,20
1746540248180,SIOC 290S,B01,958918,Merrifield; Mark A,14,0,30,16
1746540249205,SIOC 291S,B01,958922,Gabriel; Corey John,14,0,30,16
1746540250234,SOCI 117,A01,895339,Staff,3,0,5,2
1746540251261,WES 237B,A00,894149,Staff,11,0,20,9
1746540253324,AESE 279B,A00,891859,Staff,13,0,35,22
1746540254352,AIP 197,001,891854,Vespa; Emanuel Ignacio,9999,0,9999,0
1746540255378,ANTH 289S,A00,891856,Gagneux; Pascal,12,0,12,0
1746540256407,BENG 196,001,957946,Engler; Adam J.,9996,0,9999,3
1746540257434,BISP 197,001,959851,Wilhelm; James E.,9999,0,9999,0
1746540258460,CAT 124RS,A01,956906,Staff,6,0,25,19
1746540259487,CAT 125RS,A01,922013,Staff,6,0,25,19
1746540260512,CLRE 250,A00,891860,Morris; Sheldon,9995,0,9999,4
1746540262568,CLRE 251R,A00,907817,Mehta; Ravindra L.,9994,0,9999,5
1746540263603,CLRE 252,A00,891864,Cuomo; Raphael Eduardo,9993,0,9999,6
1746540264631,CLRE 253,A00,891867,Vaida; Florin,9994,0,9999,5
1746540264631,CLRE 253,B00,907819,Staff,9999,0,9999,0
1746540265657,CLRE 259,A00,891868,Patel; Hemal,9998,0,9999,1
1746540266683,CLRE 260,A00,891872,Cuomo; Raphael Eduardo,9999,0,9999,0
1746540267709,CLRE 297,001,891888,Cuomo; Raphael Eduardo,9999,0,9999,0
1746540268737,CSE 191,A00,958773,Minnes Kemp; Mor Mia,9996,0,9999,3
1746540269801,CSE 197,001,959846,Minnes Kemp; Mor Mia,9993,0,9999,6
1746540270831,CSS 201S,A01,892054,Mignozzetti; Umberto,26,0,30,4
1746540271858,CSS 202S,A01,892056,Mignozzetti; Umberto,26,0,30,4
1746540272885,DSC 197,001,956898,Eldridge; Justin Matthew,9998,0,9999,1
1746540273911,DSC 297,001,958000,Mazumdar; Arya,9998,0,9999,1
1746540273911,DSC 297,002,959862,Wang; Yusu,9999,0,9999,0
1746540274938,EAP 100,A00,905686,Staff,9778,0,9999,221
1746540275965,ECE 45,A01,892618,Staff,0,0,65,65
1746540278016,ECE 111,A01,892719,Staff,4,0,65,61
1746540279041,ECE 197,001,957920,Mercier; Patrick Philip,9991,0,9999,8
1746540280070,ECON 178,A01,907814,Zhu; Ying,26,0,35,9
1746540281098,EDS 115,A00,895312,Staff,36,0,45,9
1746540282126,EDS 117,A01,895337,Staff,24,0,30,6
1746540283152,EDS 125,A00,895341,Jones; Gabrielle Anastasia,37,0,45,8
1746540284178,EDS 128A,A01,895459,Fargason; Sharon Gayle,44,0,45,1
1746540285204,EDS 128B,A01,895543,Pappas; Elizabeth,44,0,45,1
1746540286229,EDS 139,A00,897203,Pappas; Elizabeth,44,0,45,1
1746540286229,EDS 139,B00,897209,Fargason; Sharon Gayle,41,0,45,4
1746540287255,EDS 201,A00,895545,Staff,23,0,45,22
1746540288283,EDS 203,A01,895581,Halter; Christopher P.,23,0,45,22
1746540289308,EDS 204R,A01,895625,Heinzman; Erica M.,39,0,45,6
1746540289308,EDS 204R,B01,895693,Halter; Christopher P.,10,0,45,35
1746540290336,EDS 206R,A00,895694,Fargason; Sharon Gayle,1,0,30,29
1746540290336,EDS 206R,B00,895695,Choi; Bailey Miyeon,16,0,30,14
1746540291360,EDS 250,A00,895697,Hemans; Patricia Ann Benitez,23,0,45,22
1746540292398,EDS 281,A00,895701,Meyerott; Theresa Ann,1,0,15,14
1746540293423,EDS 284,A00,895736,Meyerott; Theresa Ann,1,0,15,14
1746540294451,EDS 286,A00,897210,Fine; Sarah,0,0,15,15
1746540295478,EDS 289C,A01,895770,Daly; Alan J.,15,0,15,0
1746540296508,EDS 290,A00,897211,Hofstetter; Carolyn,0,0,15,15
1746540297536,LIGM 5A,A00,896162,Fischer-Grunski; Eva K,13,0,20,7
1746540298562,LIGM 5B,A00,896260,Fischer-Grunski; Eva K,17,0,20,3
1746540299588,LIGM 5C,A00,896308,Fischer-Grunski; Eva K,18,0,20,2
1746540300617,LIIT 5AS,A00,896313,Carnelos; Chiara,18,0,20,2
1746540301641,LIIT 5BS,A00,896416,Carnelos; Chiara,20,0,20,0
1746540302667,LIIT 5CS,A00,896564,Carnelos; Chiara,20,0,20,0
1746540303693,LISP 5A,A00,896588,Munoz Sanchez; Alicia,3,0,20,17
1746540304721,LISP 5B,A00,896653,Munoz Sanchez; Alicia,7,0,20,13
1746540305748,LISP 5C,A00,896655,Munoz Sanchez; Alicia,0,1,20,20
1746540306776,MAE 197,001,957918,Kleissl; Jan,9996,0,9999,3
1746540306776,MAE 197,002,959806,Boechler; Nicholas Sebastia,9998,0,9999,1
1746540306776,MAE 197,003,959852,Mullin; Jennifer S,9999,0,9999,0
1746540307807,MATH 2,A01,957937,Staff,33,0,35,2
1746540308832,MATH 197,001,957876,Kedlaya; Kiran S.,9993,0,9999,6
1746540309860,MCWP 40,A00,892729,Duru; Nur,10,0,20,10
1746540309860,MCWP 40,B00,893304,Montejo; Carolina,14,0,20,6
1746540310886,MCWP 40R,A00,893757,Redela; Pamela Morgan,0,5,20,20
1746540311913,MCWP 50,A00,893758,Morshed; Michael James,0,0,20,20
1746540311913,MCWP 50,B00,893761,Bartulis; Jason Michael,17,0,20,3
1746540312938,MCWP 50R,A00,893766,Compas; Sean Matthew,0,1,20,20
1746540312938,MCWP 50R,B00,893769,Carter; Jennifer A,0,1,20,20
1746540312938,MCWP 50R,C00,893771,Krone; Jarret,0,3,20,20
1746540312938,MCWP 50R,D00,893772,Miller; Elizabeth Deen,0,0,20,20
1746540312938,MCWP 50R,E00,893775,Carter; Andrea L,0,1,20,20
1746540313968,MMW 11R,A01,892721,Herbst; Matthew,11,0,27,16
1746540313968,MMW 11R,A02,892722,Herbst; Matthew,0,0,0,3
1746540315029,MMW 12R,A01,892724,Herbst; Matthew,0,11,16,16
1746540315029,MMW 12R,A02,892725,Herbst; Matthew,0,10,16,16
1746540316055,MMW 13R,A01,892727,Staff,0,4,16,16
1746540316055,MMW 13R,A02,892728,Staff,0,4,16,16
1746540316055,MMW 13R,A03,958032,Staff,0,4,16,16
1746540316055,MMW 13R,A04,958033,Staff,0,4,16,16
1746540316055,MMW 13R,A05,958034,Staff,0,4,16,16
1746540317083,SIO 295LS,A00,894015,Staff,5,0,25,20
1746540318109,SIO 295S,A00,894020,Staff,5,0,25,20
1746540319136,SIOC 290S,B01,958918,Merrifield; Mark A,14,0,30,16
1746540320163,SIOC 291S,B01,958922,Gabriel; Corey John,14,0,30,16
1746540321203,SOCI 117,A01,895339,Staff,3,0,5,2
1746540322230,WES 237B,A00,894149,Staff,11,0,20,9
1746540324298,AESE 279B,A00,891859,Staff,13,0,35,22
1746540325326,AIP 197,001,891854,Vespa; Emanuel Ignacio,9999,0,9999,0
1746540326360,ANTH 289S,A00,891856,Gagneux; Pascal,12,0,12,0
1746540327386,BENG 196,001,957946,Engler; Adam J.,9996,0,9999,3
1746540328416,BISP 197,001,959851,Wilhelm; James E.,9999,0,9999,0
1746540329445,CAT 124RS,A01,956906,Staff,6,0,25,19
1746540330477,CAT 125RS,A01,922013,Staff,6,0,25,19
1746540331503,CLRE 250,A00,891860,Morris; Sheldon,9995,0,9999,4
1746540333556,CLRE 251R,A00,907817,Mehta; Ravindra L.,9994,0,9999,5
1746540334581,CLRE 252,A00,891864,Cuomo; Raphael Eduardo,9993,0,9999,6
1746540335606,CLRE 253,A00,891867,Vaida; Florin,9994,0,9999,5
1746540335606,CLRE 253,B00,907819,Staff,9999,0,9999,0
1746540336632,CLRE 259,A00,891868,Patel; Hemal,9998,0,9999,1
1746540337660,CLRE 260,A00,891872,Cuomo; Raphael Eduardo,9999,0,9999,0
1746540338686,CLRE 297,001,891888,Cuomo; Raphael Eduardo,9999,0,9999,0
1746540339710,CSE 191,A00,958773,Minnes Kemp; Mor Mia,9996,0,9999,3
1746540340736,CSE 197,001,959846,Minnes Kemp; Mor Mia,9993,0,9999,6
1746540341764,CSS 201S,A01,892054,Mignozzetti; Umberto,26,0,30,4
1746540342793,CSS 202S,A01,892056,Mignozzetti; Umberto,26,0,30,4
1746540343820,DSC 197,001,956898,Eldridge; Justin Matthew,9998,0,9999,1
1746540344846,DSC 297,001,958000,Mazumdar; Arya,9998,0,9999,1
1746540344846,DSC 297,002,959862,Wang; Yusu,9999,0,9999,0
1746540345871,EAP 100,A00,905686,Staff,9778,0,9999,221
1746540346897,ECE 45,A01,892618,Staff,0,0,65,65
1746540348951,ECE 111,A01,892719,Staff,4,0,65,61
1746540349979,ECE 197,001,957920,Mercier; Patrick Philip,9991,0,9999,8
1746540351006,ECON 178,A01,907814,Zhu; Ying,26,0,35,9
1746540352036,EDS 115,A00,895312,Staff,36,0,45,9
1746540353063,EDS 117,A01,895337,Staff,24,0,30,6
1746540354089,EDS 125,A00,895341,Jones; Gabrielle Anastasia,37,0,45,8
1746540355132,EDS 128A,A01,895459,Fargason; Sharon Gayle,44,0,45,1
1746540356158,EDS 128B,A01,895543,Pappas; Elizabeth,44,0,45,1
1746540357184,EDS 139,A00,897203,Pappas; Elizabeth,44,0,45,1
1746540357184,EDS 139,B00,897209,Fargason; Sharon Gayle,41,0,45,4
1746540358210,EDS 201,A00,895545,Staff,23,0,45,22
1746540359238,EDS 203,A01,895581,Halter; Christopher P.,23,0,45,22
1746540360268,EDS 204R,A01,895625,Heinzman; Erica M.,39,0,45,6
1746540360268,EDS 204R,B01,895693,Halter; Christopher P.,10,0,45,35
1746540361299,EDS 206R,A00,895694,Fargason; Sharon Gayle,1,0,30,29
1746540361299,EDS 206R,B00,895695,Choi; Bailey Miyeon,16,0,30,14
1746540362330,EDS 250,A00,895697,Hemans; Patricia Ann Benitez,23,0,45,22
1746540363355,EDS 281,A00,895701,Meyerott; Theresa Ann,1,0,15,14
1746540364380,EDS 284,A00,895736,Meyerott; Theresa Ann,1,0,15,14
1746540365405,EDS 286,A00,897210,Fine; Sarah,0,0,15,15
1746540366433,EDS 289C,A01,895770,Daly; Alan J.,15,0,15,0
1746540367459,EDS 290,A00,897211,Hofstetter; Carolyn,0,0,15,15
1746540368490,LIGM 5A,A00,896162,Fischer-Grunski; Eva K,13,0,20,7
1746540369522,LIGM 5B,A00,896260,Fischer-Grunski; Eva K,17,0,20,3
1746540370548,LIGM 5C,A00,896308,Fischer-Grunski; Eva K,18,0,20,2
1746540371576,LIIT 5AS,A00,896313,Carnelos; Chiara,18,0,20,2
1746540372606,LIIT 5BS,A00,896416,Carnelos; Chiara,20,0,20,0
1746540373672,LIIT 5CS,A00,896564,Carnelos; Chiara,20,0,20,0
1746540374699,LISP 5A,A00,896588,Munoz Sanchez; Alicia,3,0,20,17
1746540375727,LISP 5B,A00,896653,Munoz Sanchez; Alicia,7,0,20,13
1746540376757,LISP 5C,A00,896655,Munoz Sanchez; Alicia,0,1,20,20
1746540377788,MAE 197,001,957918,Kleissl; Jan,9996,0,9999,3
1746540377788,MAE 197,002,959806,Boechler; Nicholas Sebastia,9998,0,9999,1
1746540377788,MAE 197,003,959852,Mullin; Jennifer S,9999,0,9999,0
1746540378814,MATH 2,A01,957937,Staff,33,0,35,2
1746540379839,MATH 197,001,957876,Kedlaya; Kiran S.,9993,0,9999,6
1746540380865,MCWP 40,A00,892729,Duru; Nur,10,0,20,10
1746540380865,MCWP 40,B00,893304,Montejo; Carolina,14,0,20,6
1746540381893,MCWP 40R,A00,893757,Redela; Pamela Morgan,0,5,20,20
1746540382918,MCWP 50,A00,893758,Morshed; Michael James,0,0,20,20
1746540382918,MCWP 50,B00,893761,Bartulis; Jason Michael,17,0,20,3
1746540383948,MCWP 50R,A00,893766,Compas; Sean Matthew,0,1,20,20
1746540383948,MCWP 50R,B00,893769,Carter; Jennifer A,0,1,20,20
1746540383948,MCWP 50R,C00,893771,Krone; Jarret,0,3,20,20
1746540383948,MCWP 50R,D00,893772,Miller; Elizabeth Deen,0,0,20,20
1746540383948,MCWP 50R,E00,893775,Carter; Andrea L,0,1,20,20
1746540384975,MMW 11R,A01,892721,Herbst; Matthew,11,0,27,16
1746540384975,MMW 11R,A02,892722,Herbst; Matthew,0,0,0,3
1746540386005,MMW 12R,A01,892724,Herbst; Matthew,0,11,16,16
1746540386005,MMW 12R,A02,892725,Herbst; Matthew,0,10,16,16
1746540387029,MMW 13R,A01,892727,Staff,0,4,16,16
1746540387029,MMW 13R,A02,892728,Staff,0,4,16,16
1746540387029,MMW 13R,A03,958032,Staff,0,4,16,16
1746540387029,MMW 13R,A04,958033,Staff,0,4,16,16
1746540387029,MMW 13R,A05,958034,Staff,0,4,16,16
1746540388056,SIO 295LS,A00,894015,Staff,5,0,25,20
1746540389083,SIO 295S,A00,894020,Staff,5,0,25,20
1746540390110,SIOC 290S,B01,958918,Merrifield; Mark A,14,0,30,16
1746540391137,SIOC 291S,B01,958922,Gabriel; Corey John,14,0,30,16
1746540392162,SOCI 117,A01,895339,Staff,3,0,5,2
1746540393188,WES 237B,A00,894149,Staff,11,0,20,9
1746540395260,AESE 279B,A00,891859,Staff,13,0,35,22
1746540396288,AIP 197,001,891854,Vespa; Emanuel Ignacio,9999,0,9999,0
1746540397318,ANTH 289S,A00,891856,Gagneux; Pascal,12,0,12,0
1746540398347,BENG 196,001,957946,Engler; Adam J.,9996,0,9999,3
1746540399374,BISP 197,001,959851,Wilhelm; James E.,9999,0,9999,0
1746540400400,CAT 124RS,A01,956906,Staff,6,0,25,19
1746540401428,CAT 125RS,A01,922013,Staff,6,0,25,19
1746540402454,CLRE 250,A00,891860,Morris; Sheldon,9995,0,9999,4
1746540404508,CLRE 251R,A00,907817,Mehta; Ravindra L.,9994,0,9999,5
1746540405534,CLRE 252,A00,891864,Cuomo; Raphael Eduardo,9993,0,9999,6
1746540406559,CLRE 253,A00,891867,Vaida; Florin,9994,0,9999,5
1746540406559,CLRE 253,B00,907819,Staff,9999,0,9999,0
1746540407588,CLRE 259,A00,891868,Patel; Hemal,9998,0,9999,1
1746540408612,CLRE 260,A00,891872,Cuomo; Raphael Eduardo,9999,0,9999,0
1746540409635,CLRE 297,001,891888,Cuomo; Raphael Eduardo,9999,0,9999,0
1746540410665,CSE 191,A00,958773,Minnes Kemp; Mor Mia,9996,0,9999,3
1746540411692,CSE 197,001,959846,Minnes Kemp; Mor Mia,9993,0,9999,6
1746540412718,CSS 201S,A01,892054,Mignozzetti; Umberto,26,0,30,4
1746540413744,CSS 202S,A01,892056,Mignozzetti; Umberto,26,0,30,4
1746540414770,DSC 197,001,956898,Eldridge; Justin Matthew,9998,0,9999,1
1746540415797,DSC 297,001,958000,Mazumdar; Arya,9998,0,9999,1
1746540415797,DSC 297,002,959862,Wang; Yusu,9999,0,9999,0
1746540416825,EAP 100,A00,905686,Staff,9778,0,9999,221
1746540417853,ECE 45,A01,892618,Staff,0,0,65,65
1746540419905,ECE 111,A01,892719,Staff,4,0,65,61
1746540420933,ECE 197,001,957920,Mercier; Patrick Philip,9991,0,9999,8
1746540421965,ECON 178,A01,907814,Zhu; Ying,26,0,35,9
1746540422991,EDS 115,A00,895312,Staff,36,0,45,9
1746540424016,EDS 117,A01,895337,Staff,24,0,30,6
1746540425041,EDS 125,A00,895341,Jones; Gabrielle Anastasia,37,0,45,8
1746540426070,EDS 128A,A01,895459,Fargason; Sharon Gayle,44,0,45,1
1746540427098,EDS 128B,A01,895543,Pappas; Elizabeth,44,0,45,1
1746540428123,EDS 139,A00,897203,Pappas; Elizabeth,44,0,45,1
1746540428123,EDS 139,B00,897209,Fargason; Sharon Gayle,41,0,45,4
1746540429150,EDS 201,A00,895545,Staff,23,0,45,22
1746540430179,EDS 203,A01,895581,Halter; Christopher P.,23,0,45,22
1746540431205,EDS 204R,A01,895625,Heinzman; Erica M.,39,0,45,6
1746540431205,EDS 204R,B01,895693,Halter; Christopher P.,10,0,45,35
1746540432229,EDS 206R,A00,895694,Fargason; Sharon Gayle,1,0,30,29
1746540432229,EDS 206R,B00,895695,Choi; Bailey Miyeon,16,0,30,14
1746540433255,EDS 250,A00,895697,Hemans; Patricia Ann Benitez,23,0,45,22
1746540434489,EDS 281,A00,895701,Meyerott; Theresa Ann,1,0,15,14
1746540435515,EDS 284,A00,895736,Meyerott; Theresa Ann,1,0,15,14
1746540436540,EDS 286,A00,897210,Fine; Sarah,0,0,15,15
1746540437565,EDS 289C,A01,895770,Daly; Alan J.,15,0,15,0
1746540438590,EDS 290,A00,897211,Hofstetter; Carolyn,0,0,15,15
1746540439621,LIGM 5A,A00,896162,Fischer-Grunski; Eva K,13,0,20,7
1746540440647,LIGM 5B,A00,896260,Fischer-Grunski; Eva K,17,0,20,3
1746540441676,LIGM 5C,A00,896308,Fischer-Grunski; Eva K,18,0,20,2
1746540442702,LIIT 5AS,A00,896313,Carnelos; Chiara,18,0,20,2
1746540443729,LIIT 5BS,A00,896416,Carnelos; Chiara,20,0,20,0
1746540444758,LIIT 5CS,A00,896564,Carnelos; Chiara,20,0,20,0
1746540445786,LISP 5A,A00,896588,Munoz Sanchez; Alicia,3,0,20,17
1746540446816,LISP 5B,A00,896653,Munoz Sanchez; Alicia,7,0,20,13
1746540447844,LISP 5C,A00,896655,Munoz Sanchez; Alicia,0,1,20,20
1746540448871,MAE 197,001,957918,Kleissl; Jan,9996,0,9999,3
1746540448871,MAE 197,002,959806,Boechler; Nicholas Sebastia,9998,0,9999,1
1746540448871,MAE 197,003,959852,Mullin; Jennifer S,9999,0,9999,0
1746540449897,MATH 2,A01,957937,Staff,33,0,35,2
1746540450927,MATH 197,001,957876,Kedlaya; Kiran S.,9993,0,9999,6
1746540451954,MCWP 40,A00,892729,Duru; Nur,10,0,20,10
1746540451954,MCWP 40,B00,893304,Montejo; Carolina,14,0,20,6
1746540452983,MCWP 40R,A00,893757,Redela; Pamela Morgan,0,5,20,20
1746540454009,MCWP 50,A00,893758,Morshed; Michael James,0,0,20,20
1746540454009,MCWP 50,B00,893761,Bartulis; Jason Michael,17,0,20,3
1746540455040,MCWP 50R,A00,893766,Compas; Sean Matthew,0,1,20,20
1746540455040,MCWP 50R,B00,893769,Carter; Jennifer A,0,1,20,20
1746540455040,MCWP 50R,C00,893771,Krone; Jarret,0,3,20,20
1746540455040,MCWP 50R,D00,893772,Miller; Elizabeth Deen,0,0,20,20
1746540455040,MCWP 50R,E00,893775,Carter; Andrea L,0,1,20,20
1746540456065,MMW 11R,A01,892721,Herbst; Matthew,11,0,27,16
1746540456065,MMW 11R,A02,892722,Herbst; Matthew,0,0,0,3
1746540457091,MMW 12R,A01,892724,Herbst; Matthew,0,11,16,16
1746540457091,MMW 12R,A02,892725,Herbst; Matthew,0,10,16,16
1746540458118,MMW 13R,A01,892727,Staff,0,4,16,16
1746540458118,MMW 13R,A02,892728,Staff,0,4,16,16
1746540458118,MMW 13R,A03,958032,Staff,0,4,16,16
1746540458118,MMW 13R,A04,958033,Staff,0,4,16,16
1746540458118,MMW 13R,A05,958034,Staff,0,4,16,16
1746540459142,SIO 295LS,A00,894015,Staff,5,0,25,20
1746540460169,SIO 295S,A00,894020,Staff,5,0,25,20
1746540461195,SIOC 290S,B01,958918,Merrifield; Mark A,14,0,30,16
1746540462222,SIOC 291S,B01,958922,Gabriel; Corey John,14,0,30,16
1746540463245,SOCI 117,A01,895339,Staff,3,0,5,2
1746540464272,WES 237B,A00,894149,Staff,11,0,20,9
1746540466351,AESE 279B,A00,891859,Staff,13,0,35,22
1746540467378,AIP 197,001,891854,Vespa; Emanuel Ignacio,9999,0,9999,0
1746540468403,ANTH 289S,A00,891856,Gagneux; Pascal,12,0,12,0
1746540469428,BENG 196,001,957946,Engler; Adam J.,9996,0,9999,3
1746540470457,BISP 197,001,959851,Wilhelm; James E.,9999,0,9999,0
1746540471485,CAT 124RS,A01,956906,Staff,6,0,25,19
1746540472511,CAT 125RS,A01,922013,Staff,6,0,25,19
1746540473543,CLRE 250,A00,891860,Morris; Sheldon,9995,0,9999,4
1746540475597,CLRE 251R,A00,907817,Mehta; Ravindra L.,9994,0,9999,5
1746540476626,CLRE 252,A00,891864,Cuomo; Raphael Eduardo,9993,0,9999,6
1746540477692,CLRE 253,A00,891867,Vaida; Florin,9994,0,9999,5
1746540477692,CLRE 253,B00,907819,Staff,9999,0,9999,0
1746540478718,CLRE 259,A00,891868,Patel; Hemal,9998,0,9999,1
1746540479746,CLRE 260,A00,891872,Cuomo; Raphael Eduardo,9999,0,9999,0
1746540480775,CLRE 297,001,891888,Cuomo; Raphael Eduardo,9999,0,9999,0
1746540481803,CSE 191,A00,958773,Minnes Kemp; Mor Mia,9996,0,9999,3
1746540482827,CSE 197,001,959846,Minnes Kemp; Mor Mia,9993,0,9999,6
1746540483853,CSS 201S,A01,892054,Mignozzetti; Umberto,26,0,30,4
1746540484882,CSS 202S,A01,892056,Mignozzetti; Umberto,26,0,30,4
1746540485908,DSC 197,001,956898,Eldridge; Justin Matthew,9998,0,9999,1
1746540486937,DSC 297,001,958000,Mazumdar; Arya,9998,0,9999,1
1746540486937,DSC 297,002,959862,Wang; Yusu,9999,0,9999,0
1746540487963,EAP 100,A00,905686,Staff,9778,0,9999,221
1746540488988,ECE 45,A01,892618,Staff,0,0,65,65
1746540491064,ECE 111,A01,892719,Staff,4,0,65,61
1746540492088,ECE 197,001,957920,Mercier; Patrick Philip,9991,0,9999,8
1746540493114,ECON 178,A01,907814,Zhu; Ying,26,0,35,9
1746540494140,EDS 115,A00,895312,Staff,36,0,45,9
1746540495169,EDS 117,A01,895337,Staff,24,0,30,6
1746540496194,EDS 125,A00,895341,Jones; Gabrielle Anastasia,37,0,45,8
1746540497221,EDS 128A,A01,895459,Fargason; Sharon Gayle,44,0,45,1
1746540498249,EDS 128B,A01,895543,Pappas; Elizabeth,44,0,45,1
1746540499279,EDS 139,A00,897203,Pappas; Elizabeth,44,0,45,1
1746540499279,EDS 139,B00,897209,Fargason; Sharon Gayle,41,0,45,4
1746540500307,EDS 201,A00,895545,Staff,23,0,45,22
1746540501335,EDS 203,A01,895581,Halter; Christopher P.,23,0,45,22
1746540502362,EDS 204R,A01,895625,Heinzman; Erica M.,39,0,45,6
1746540502362,EDS 204R,B01,895693,Halter; Christopher P.,10,0,45,35
1746540503594,EDS 206R,A00,895694,Fargason; Sharon Gayle,1,0,30,29
1746540503594,EDS 206R,B00,895695,Choi; Bailey Miyeon,16,0,30,14
1746540504619,EDS 250,A00,895697,Hemans; Patricia Ann Benitez,23,0,45,22
1746540505645,EDS 281,A00,895701,Meyerott; Theresa Ann,1,0,15,14
1746540506669,EDS 284,A00,895736,Meyerott; Theresa Ann,1,0,15,14
1746540507696,EDS 286,A00,897210,Fine; Sarah,0,0,15,15
1746540508725,EDS 289C,A01,895770,Daly; Alan J.,15,0,15,0
1746540509753,EDS 290,A00,897211,Hofstetter; Carolyn,0,0,15,15
1746540510788,LIGM 5A,A00,896162,Fischer-Grunski; Eva K,13,0,20,7
1746540511812,LIGM 5B,A00,896260,Fischer-Grunski; Eva K,17,0,20,3
1746540512840,LIGM 5C,A00,896308,Fischer-Grunski; Eva K,18,0,20,2
1746540513871,LIIT 5AS,A00,896313,Carnelos; Chiara,18,0,20,2
1746540514899,LIIT 5BS,A00,896416,Carnelos; Chiara,20,0,20,0
1746540515929,LIIT 5CS,A00,896564,Carnelos; Chiara,20,0,20,0
1746540516956,LISP 5A,A00,896588,Munoz Sanchez; Alicia,3,0,20,17
1746540517984,LISP 5B,A00,896653,Munoz Sanchez; Alicia,7,0,20,13
1746540519011,LISP 5C,A00,896655,Munoz Sanchez; Alicia,0,1,20,20
1746540520039,MAE 197,001,957918,Kleissl; Jan,9996,0,9999,3
1746540520039,MAE 197,002,959806,Boechler; Nicholas Sebastia,9998,0,9999,1
1746540520039,MAE 197,003,959852,Mullin; Jennifer S,9999,0,9999,0
1746540521066,MATH 2,A01,957937,Staff,33,0,35,2
1746540522093,MATH 197,001,957876,Kedlaya; Kiran S.,9993,0,9999,6
1746540523122,MCWP 40,A00,892729,Duru; Nur,10,0,20,10
1746540523122,MCWP 40,B00,893304,Montejo; Carolina,14,0,20,6
1746540524148,MCWP 40R,A00,893757,Redela; Pamela Morgan,0,5,20,20
1746540525175,MCWP 50,A00,893758,Morshed; Michael James,0,0,20,20
1746540525175,MCWP 50,B00,893761,Bartulis; Jason Michael,17,0,20,3
1746540526200,MCWP 50R,A00,893766,Compas; Sean Matthew,0,1,20,20
1746540526200,MCWP 50R,B00,893769,Carter; Jennifer A,0,1,20,20
1746540526200,MCWP 50R,C00,893771,Krone; Jarret,0,3,20,20
1746540526200,MCWP 50R,D00,893772,Miller; Elizabeth Deen,0,0,20,20
1746540526200,MCWP 50R,E00,893775,Carter; Andrea L,0,1,20,20
1746540527225,MMW 11R,A01,892721,Herbst; Matthew,11,0,27,16
1746540527225,MMW 11R,A02,892722,Herbst; Matthew,0,0,0,3
1746540528255,MMW 12R,A01,892724,Herbst; Matthew,0,11,16,16
1746540528255,MMW 12R,A02,892725,Herbst; Matthew,0,10,16,16
1746540529280,MMW 13R,A01,892727,Staff,0,4,16,16
1746540529280,MMW 13R,A02,892728,Staff,0,4,16,16
1746540529280,MMW 13R,A03,958032,Staff,0,4,16,16
1746540529280,MMW 13R,A04,958033,Staff,0,4,16,16
1746540529280,MMW 13R,A05,958034,Staff,0,4,16,16
1746540530308,SIO 295LS,A00,894015,Staff,5,0,25,20
1746540531334,SIO 295S,A00,894020,Staff,5,0,25,20
1746540532363,SIOC 290S,B01,958918,Merrifield; Mark A,14,0,30,16
1746540533389,SIOC 291S,B01,958922,Gabriel; Corey John,14,0,30,16
1746540534415,SOCI 117,A01,895339,Staff,3,0,5,2
1746540535440,WES 237B,A00,894149,Staff,11,0,20,9
1746540537518,AESE 279B,A00,891859,Staff,13,0,35,22
1746540538547,AIP 197,001,891854,Vespa; Emanuel Ignacio,9999,0,9999,0
1746540539571,ANTH 289S,A00,891856,Gagneux; Pascal,12,0,12,0
1746540540599,BENG 196,001,957946,Engler; Adam J.,9996,0,9999,3
1746540541631,BISP 197,001,959851,Wilhelm; James E.,9999,0,9999,0
1746540542657,CAT 124RS,A01,956906,Staff,6,0,25,19
1746540543684,CAT 125RS,A01,922013,Staff,6,0,25,19
1746540544708,CLRE 250,A00,891860,Morris; Sheldon,9995,0,9999,4
1746540546760,CLRE 251R,A00,907817,Mehta; Ravindra L.,9994,0,9999,5
1746540547786,CLRE 252,A00,891864,Cuomo; Raphael Eduardo,9993,0,9999,6
1746540548812,CLRE 253,A00,891867,Vaida; Florin,9994,0,9999,5
1746540548812,CLRE 253,B00,907819,Staff,9999,0,9999,0
1746540549839,CLRE 259,A00,891868,Patel; Hemal,9998,0,9999,1
1746540550865,CLRE 260,A00,891872,Cuomo; Raphael Eduardo,9999,0,9999,0
1746540551892,CLRE 297,001,891888,Cuomo; Raphael Eduardo,9999,0,9999,0
1746540552919,CSE 191,A00,958773,Minnes Kemp; Mor Mia,9996,0,9999,3
1746540553947,CSE 197,001,959846,Minnes Kemp; Mor Mia,9993,0,9999,6
1746540554974,CSS 201S,A01,892054,Mignozzetti; Umberto,26,0,30,4
1746540556001,CSS 202S,A01,892056,Mignozzetti; Umberto,26,0,30,4
1746540557028,DSC 197,001,956898,Eldridge; Justin Matthew,9998,0,9999,1
1746540558053,DSC 297,001,958000,Mazumdar; Arya,9998,0,9999,1
1746540558053,DSC 297,002,959862,Wang; Yusu,9999,0,9999,0
1746540559080,EAP 100,A00,905686,Staff,9778,0,9999,221
1746540560109,ECE 45,A01,892618,Staff,0,0,65,65
1746540562161,ECE 111,A01,892719,Staff,4,0,65,61
1746540563188,ECE 197,001,957920,Mercier; Patrick Philip,9991,0,9999,8
1746540564213,ECON 178,A01,907814,Zhu; Ying,26,0,35,9
1746540565238,EDS 115,A00,895312,Staff,36,0,45,9
1746540566265,EDS 117,A01,895337,Staff,24,0,30,6
1746540567290,EDS 125,A00,895341,Jones; Gabrielle Anastasia,37,0,45,8
1746540568315,EDS 128A,A01,895459,Fargason; Sharon Gayle,44,0,45,1
1746540569340,EDS 128B,A01,895543,Pappas; Elizabeth,44,0,45,1
1746540570366,EDS 139,A00,897203,Pappas; Elizabeth,44,0,45,1
1746540570366,EDS 139,B00,897209,Fargason; Sharon Gayle,41,0,45,4
1746540571394,EDS 201,A00,895545,Staff,23,0,45,22
1746540572421,EDS 203,A01,895581,Halter; Christopher P.,23,0,45,22
1746540573451,EDS 204R,A01,895625,Heinzman; Erica M.,39,0,45,6
1746540573451,EDS 204R,B01,895693,Halter; Christopher P.,10,0,45,35
1746540574476,EDS 206R,A00,895694,Fargason; Sharon Gayle,1,0,30,29
1746540574476,EDS 206R,B00,895695,Choi; Bailey Miyeon,16,0,30,14
1746540575500,EDS 250,A00,895697,Hemans; Patricia Ann Benitez,23,0,45,22
1746540576526,EDS 281,A00,895701,Meyerott; Theresa Ann,1,0,15,14
1746540577553,EDS 284,A00,895736,Meyerott; Theresa Ann,1,0,15,14
1746540578582,EDS 286,A00,897210,Fine; Sarah,0,0,15,15
1746540579611,EDS 289C,A01,895770,Daly; Alan J.,15,0,15,0
1746540580639,EDS 290,A00,897211,Hofstetter; Carolyn,0,0,15,15
1746540581705,LIGM 5A,A00,896162,Fischer-Grunski; Eva K,13,0,20,7
1746540582732,LIGM 5B,A00,896260,Fischer-Grunski; Eva K,17,0,20,3
1746540583757,LIGM 5C,A00,896308,Fischer-Grunski; Eva K,18,0,20,2
1746540584783,LIIT 5AS,A00,896313,Carnelos; Chiara,18,0,20,2
1746540585808,LIIT 5BS,A00,896416,Carnelos; Chiara,20,0,20,0
1746540586838,LIIT 5CS,A00,896564,Carnelos; Chiara,20,0,20,0
1746540587867,LISP 5A,A00,896588,Munoz Sanchez; Alicia,3,0,20,17
1746540588893,LISP 5B,A00,896653,Munoz Sanchez; Alicia,7,0,20,13
1746540589920,LISP 5C,A00,896655,Munoz Sanchez; Alicia,0,1,20,20
1746540590947,MAE 197,001,957918,Kleissl; Jan,9996,0,9999,3
1746540590947,MAE 197,002,959806,Boechler; Nicholas Sebastia,9998,0,9999,1
1746540590947,MAE 197,003,959852,Mullin; Jennifer S,9999,0,9999,0
1746540591974,MATH 2,A01,957937,Staff,33,0,35,2
1746540592999,MATH 197,001,957876,Kedlaya; Kiran S.,9993,0,9999,6
1746540594028,MCWP 40,A00,892729,Duru; Nur,10,0,20,10
1746540594028,MCWP 40,B00,893304,Montejo; Carolina,14,0,20,6
1746540595053,MCWP 40R,A00,893757,Redela; Pamela Morgan,0,5,20,20
1746540596080,MCWP 50,A00,893758,Morshed; Michael James,0,0,20,20
1746540596080,MCWP 50,B00,893761,Bartulis; Jason Michael,17,0,20,3
1746540597108,MCWP 50R,A00,893766,Compas; Sean Matthew,0,1,20,20
1746540597108,MCWP 50R,B00,893769,Carter; Jennifer A,0,1,20,20
1746540597108,MCWP 50R,C00,893771,Krone; Jarret,0,3,20,20
1746540597108,MCWP 50R,D00,893772,Miller; Elizabeth Deen,0,0,20,20
1746540597108,MCWP 50R,E00,893775,Carter; Andrea L,0,1,20,20
1746540598135,MMW 11R,A01,892721,Herbst; Matthew,11,0,27,16
1746540598135,MMW 11R,A02,892722,Herbst; Matthew,0,0,0,3
1746540599160,MMW 12R,A01,892724,Herbst; Matthew,0,11,16,16
1746540599160,MMW 12R,A02,892725,Herbst; Matthew,0,10,16,16
1746540600186,MMW 13R,A01,892727,Staff,0,4,16,16
1746540600186,MMW 13R,A02,892728,Staff,0,4,16,16
1746540600186,MMW 13R,A03,958032,Staff,0,4,16,16
1746540600186,MMW 13R,A04,958033,Staff,0,4,16,16
1746540600186,MMW 13R,A05,958034,Staff,0,4,16,16
1746540601213,SIO 295LS,A00,894015,Staff,5,0,25,20
1746540602241,SIO 295S,A00,894020,Staff,5,0,25,20
1746540603267,SIOC 290S,B01,958918,Merrifield; Mark A,14,0,30,16
1746540604291,SIOC 291S,B01,958922,Gabriel; Corey John,14,0,30,16
1746540605318,SOCI 117,A01,895339,Staff,3,0,5,2
1746540606342,WES 237B,A00,894149,Staff,11,0,20,9
1746540608421,AESE 279B,A00,891859,Staff,13,0,35,22
1746540609450,AIP 197,001,891854,Vespa; Emanuel Ignacio,9999,0,9999,0
1746540610477,ANTH 289S,A00,891856,Gagneux; Pascal,12,0,12,0
1746540611505,BENG 196,001,957946,Engler; Adam J.,9996,0,9999,3
1746540612531,BISP 197,001,959851,Wilhelm; James E.,9999,0,9999,0
1746540613559,CAT 124RS,A01,956906,Staff,6,0,25,19
1746540614586,CAT 125RS,A01,922013,Staff,6,0,25,19
1746540615617,CLRE 250,A00,891860,Morris; Sheldon,9995,0,9999,4
1746540617671,CLRE 251R,A00,907817,Mehta; Ravindra L.,9994,0,9999,5
1746540618699,CLRE 252,A00,891864,Cuomo; Raphael Eduardo,9993,0,9999,6
1746540619726,CLRE 253,A00,891867,Vaida; Florin,9994,0,9999,5
1746540619726,CLRE 253,B00,907819,Staff,9999,0,9999,0
1746540620754,CLRE 259,A00,891868,Patel; Hemal,9998,0,9999,1
1746540621783,CLRE 260,A00,891872,Cuomo; Raphael Eduardo,9999,0,9999,0
1746540622813,CLRE 297,001,891888,Cuomo; Raphael Eduardo,9999,0,9999,0
1746540623839,CSE 191,A00,958773,Minnes Kemp; Mor Mia,9996,0,9999,3
1746540624868,CSE 197,001,959846,Minnes Kemp; Mor Mia,9993,0,9999,6
1746540625908,CSS 201S,A01,892054,Mignozzetti; Umberto,26,0,30,4
1746540626934,CSS 202S,A01,892056,Mignozzetti; Umberto,26,0,30,4
1746540627960,DSC 197,001,956898,Eldridge; Justin Matthew,9998,0,9999,1
1746540628987,DSC 297,001,958000,Mazumdar; Arya,9998,0,9999,1
1746540628987,DSC 297,002,959862,Wang; Yusu,9999,0,9999,0
1746540630033,EAP 100,A00,905686,Staff,9778,0,9999,221
1746540631059,ECE 45,A01,892618,Staff,0,0,65,65
1746540633109,ECE 111,A01,892719,Staff,4,0,65,61
1746540634137,ECE 197,001,957920,Mercier; Patrick Philip,9991,0,9999,8
1746540635166,ECON 178,A01,907814,Zhu; Ying,26,0,35,9
1746540636193,EDS 115,A00,895312,Staff,36,0,45,9
1746540637220,EDS 117,A01,895337,Staff,24,0,30,6
1746540638246,EDS 125,A00,895341,Jones; Gabrielle Anastasia,37,0,45,8
1746540639277,EDS 128A,A01,895459,Fargason; Sharon Gayle,44,0,45,1
1746540640307,EDS 128B,A01,895543,Pappas; Elizabeth,44,0,45,1
1746540641335,EDS 139,A00,897203,Pappas; Elizabeth,44,0,45,1
1746540641335,EDS 139,B00,897209,Fargason; Sharon Gayle,41,0,45,4
1746540642361,EDS 201,A00,895545,Staff,23,0,45,22
1746540643386,EDS 203,A01,895581,Halter; Christopher P.,23,0,45,22
1746540644413,EDS 204R,A01,895625,Heinzman; Erica M.,39,0,45,6
1746540644413,EDS 204R,B01,895693,Halter; Christopher P.,10,0,45,35
1746540645441,EDS 206R,A00,895694,Fargason; Sharon Gayle,1,0,30,29
1746540645441,EDS 206R,B00,895695,Choi; Bailey Miyeon,16,0,30,14
1746540646466,EDS 250,A00,895697,Hemans; Patricia Ann Benitez,23,0,45,22
1746540647493,EDS 281,A00,895701,Meyerott; Theresa Ann,1,0,15,14
1746540648521,EDS 284,A00,895736,Meyerott; Theresa Ann,1,0,15,14
1746540649546,EDS 286,A00,897210,Fine; Sarah,0,0,15,15
1746540650573,EDS 289C,A01,895770,Daly; Alan J.,15,0,15,0
1746540651598,EDS 290,A00,897211,Hofstetter; Carolyn,0,0,15,15
1746540652628,LIGM 5A,A00,896162,Fischer-Grunski; Eva K,13,0,20,7
1746540653654,LIGM 5B,A00,896260,Fischer-Grunski; Eva K,17,0,20,3
1746540654679,LIGM 5C,A00,896308,Fischer-Grunski; Eva K,18,0,20,2
1746540655707,LIIT 5AS,A00,896313,Carnelos; Chiara,18,0,20,2
1746540656738,LIIT 5BS,A00,896416,Carnelos; Chiara,20,0,20,0
1746540657765,LIIT 5CS,A00,896564,Carnelos; Chiara,20,0,20,0
1746540658793,LISP 5A,A00,896588,Munoz Sanchez; Alicia,3,0,20,17
1746540659822,LISP 5B,A00,896653,Munoz Sanchez; Alicia,7,0,20,13
1746540660848,LISP 5C,A00,896655,Munoz Sanchez; Alicia,0,1,20,20
1746540661874,MAE 197,001,957918,Kleissl; Jan,9996,0,9999,3
1746540661874,MAE 197,002,959806,Boechler; Nicholas Sebastia,9998,0,9999,1
1746540661874,MAE 197,003,959852,Mullin; Jennifer S,9999,0,9999,0
1746540662901,MATH 2,A01,957937,Staff,33,0,35,2
1746540663932,MATH 197,001,957876,Kedlaya; Kiran S.,9993,0,9999,6
1746540664966,MCWP 40,A00,892729,Duru; Nur,10,0,20,10
1746540664966,MCWP 40,B00,893304,Montejo; Carolina,14,0,20,6
1746540665995,MCWP 40R,A00,893757,Redela; Pamela Morgan,0,5,20,20
1746540667022,MCWP 50,A00,893758,Morshed; Michael James,0,0,20,20
1746540667022,MCWP 50,B00,893761,Bartulis; Jason Michael,17,0,20,3
1746540668052,MCWP 50R,A00,893766,Compas; Sean Matthew,0,1,20,20
1746540668052,MCWP 50R,B00,893769,Carter; Jennifer A,0,1,20,20
1746540668052,MCWP 50R,C00,893771,Krone; Jarret,0,3,20,20
1746540668052,MCWP 50R,D00,893772,Miller; Elizabeth Deen,0,0,20,20
1746540668052,MCWP 50R,E00,893775,Carter; Andrea L,0,1,20,20
1746540669078,MMW 11R,A01,892721,Herbst; Matthew,11,0,27,16
1746540669078,MMW 11R,A02,892722,Herbst; Matthew,0,0,0,3
1746540670107,MMW 12R,A01,892724,Herbst; Matthew,0,11,16,16
1746540670107,MMW 12R,A02,892725,Herbst; Matthew,0,10,16,16
1746540671134,MMW 13R,A01,892727,Staff,0,4,16,16
1746540671134,MMW 13R,A02,892728,Staff,0,4,16,16
1746540671134,MMW 13R,A03,958032,Staff,0,4,16,16
1746540671134,MMW 13R,A04,958033,Staff,0,4,16,16
1746540671134,MMW 13R,A05,958034,Staff,0,4,16,16
1746540672159,SIO 295LS,A00,894015,Staff,5,0,25,20
1746540673185,SIO 295S,A00,894020,Staff,5,0,25,20
1746540674212,SIOC 290S,B01,958918,Merrifield; Mark A,14,0,30,16
1746540675244,SIOC 291S,B01,958922,Gabriel; Corey John,14,0,30,16
1746540676271,SOCI 117,A01,895339,Staff,3,0,5,2
1746540677298,WES 237B,A00,894149,Staff,11,0,20,9
1746540679368,AESE 279B,A00,891859,Staff,13,0,35,22
1746540680394,AIP 197,001,891854,Vespa; Emanuel Ignacio,9999,0,9999,0
1746540681425,ANTH 289S,A00,891856,Gagneux; Pascal,12,0,12,0
1746540682450,BENG 196,001,957946,Engler; Adam J.,9996,0,9999,3
1746540683475,BISP 197,001,959851,Wilhelm; James E.,9999,0,9999,0
1746540684503,CAT 124RS,A01,956906,Staff,6,0,25,19
1746540685569,CAT 125RS,A01,922013,Staff,6,0,25,19
1746540686596,CLRE 250,A00,891860,Morris; Sheldon,9995,0,9999,4
1746540688650,CLRE 251R,A00,907817,Mehta; Ravindra L.,9994,0,9999,5
1746540689678,CLRE 252,A00,891864,Cuomo; Raphael Eduardo,9993,0,9999,6
1746540690704,CLRE 253,A00,891867,Vaida; Florin,9994,0,9999,5
1746540690704,CLRE 253,B00,907819,Staff,9999,0,9999,0
1746540691731,CLRE 259,A00,891868,Patel; Hemal,9998,0,9999,1
1746540692756,CLRE 260,A00,891872,Cuomo; Raphael Eduardo,9999,0,9999,0
1746540693786,CLRE 297,001,891888,Cuomo; Raphael Eduardo,9999,0,9999,0
1746540694812,CSE 191,A00,958773,Minnes Kemp; Mor Mia,9996,0,9999,3
1746540695839,CSE 197,001,959846,Minnes Kemp; Mor Mia,9993,0,9999,6
1746540696865,CSS 201S,A01,892054,Mignozzetti; Umberto,26,0,30,4
1746540697890,CSS 202S,A01,892056,Mignozzetti; Umberto,26,0,30,4
1746540698921,DSC 197,001,956898,Eldridge; Justin Matthew,9998,0,9999,1
1746540699947,DSC 297,001,958000,Mazumdar; Arya,9998,0,9999,1
1746540699947,DSC 297,002,959862,Wang; Yusu,9999,0,9999,0
1746540700974,EAP 100,A00,905686,Staff,9778,0,9999,221
1746540702002,ECE 45,A01,892618,Staff,0,0,65,65
1746540704060,ECE 111,A01,892719,Staff,4,0,65,61
1746540705089,ECE 197,001,957920,Mercier; Patrick Philip,9991,0,9999,8
1746540706116,ECON 178,A01,907814,Zhu; Ying,26,0,35,9
1746540707141,EDS 115,A00,895312,Staff,36,0,45,9
1746540708169,EDS 117,A01,895337,Staff,24,0,30,6
1746540709194,EDS 125,A00,895341,Jones; Gabrielle Anastasia,37,0,45,8
1746540710223,EDS 128A,A01,895459,Fargason; Sharon Gayle,44,0,45,1
1746540711249,EDS 128B,A01,895543,Pappas; Elizabeth,44,0,45,1
1746540712274,EDS 139,A00,897203,Pappas; Elizabeth,44,0,45,1
1746540712274,EDS 139,B00,897209,Fargason; Sharon Gayle,41,0,45,4
1746540713302,EDS 201,A00,895545,Staff,23,0,45,22
1746540714327,EDS 203,A01,895581,Halter; Christopher P.,23,0,45,22
1746540715355,EDS 204R,A01,895625,Heinzman; Erica M.,39,0,45,6
1746540715355,EDS 204R,B01,895693,Halter; Christopher P.,10,0,45,35
1746540716384,EDS 206R,A00,895694,Fargason; Sharon Gayle,1,0,30,29
1746540716384,EDS 206R,B00,895695,Choi; Bailey Miyeon,16,0,30,14
1746540717410,EDS 250,A00,895697,Hemans; Patricia Ann Benitez,23,0,45,22
1746540718437,EDS 281,A00,895701,Meyerott; Theresa Ann,1,0,15,14
1746540719461,EDS 284,A00,895736,Meyerott; Theresa Ann,1,0,15,14
1746540720490,EDS 286,A00,897210,Fine; Sarah,0,0,15,15
1746540721515,EDS 289C,A01,895770,Daly; Alan J.,15,0,15,0
1746540722543,EDS 290,A00,897211,Hofstetter; Carolyn,0,0,15,15
1746540723573,LIGM 5A,A00,896162,Fischer-Grunski; Eva K,13,0,20,7
1746540724597,LIGM 5B,A00,896260,Fischer-Grunski; Eva K,17,0,20,3
1746540725625,LIGM 5C,A00,896308,Fischer-Grunski; Eva K,18,0,20,2
1746540726656,LIIT 5AS,A00,896313,Carnelos; Chiara,18,0,20,2
1746540727681,LIIT 5BS,A00,896416,Carnelos; Chiara,20,0,20,0
1746540728708,LIIT 5CS,A00,896564,Carnelos; Chiara,20,0,20,0
1746540729733,LISP 5A,A00,896588,Munoz Sanchez; Alicia,3,0,20,17
1746540730761,LISP 5B,A00,896653,Munoz Sanchez; Alicia,7,0,20,13
1746540731790,LISP 5C,A00,896655,Munoz Sanchez; Alicia,0,1,20,20
1746540732814,MAE 197,001,957918,Kleissl; Jan,9996,0,9999,3
1746540732814,MAE 197,002,959806,Boechler; Nicholas Sebastia,9998,0,9999,1
1746540732814,MAE 197,003,959852,Mullin; Jennifer S,9999,0,9999,0
1746540733841,MATH 2,A01,957937,Staff,33,0,35,2
1746540734866,MATH 197,001,957876,Kedlaya; Kiran S.,9993,0,9999,6
1746540735895,MCWP 40,A00,892729,Duru; Nur,10,0,20,10
1746540735895,MCWP 40,B00,893304,Montejo; Carolina,14,0,20,6
1746540736918,MCWP 40R,A00,893757,Redela; Pamela Morgan,0,5,20,20
1746540737943,MCWP 50,A00,893758,Morshed; Michael James,0,0,20,20
1746540737943,MCWP 50,B00,893761,Bartulis; Jason Michael,17,0,20,3
1746540738974,MCWP 50R,A00,893766,Compas; Sean Matthew,0,1,20,20
1746540738974,MCWP 50R,B00,893769,Carter; Jennifer A,0,1,20,20
1746540738974,MCWP 50R,C00,893771,Krone; Jarret,0,3,20,20
1746540738974,MCWP 50R,D00,893772,Miller; Elizabeth Deen,0,0,20,20
1746540738974,MCWP 50R,E00,893775,Carter; Andrea L,0,1,20,20
1746540740000,MMW 11R,A01,892721,Herbst; Matthew,11,0,27,16
1746540740000,MMW 11R,A02,892722,Herbst; Matthew,0,0,0,3
1746540741026,MMW 12R,A01,892724,Herbst; Matthew,0,11,16,16
1746540741026,MMW 12R,A02,892725,Herbst; Matthew,0,10,16,16
1746540742052,MMW 13R,A01,892727,Staff,0,4,16,16
1746540742052,MMW 13R,A02,892728,Staff,0,4,16,16
1746540742052,MMW 13R,A03,958032,Staff,0,4,16,16
1746540742052,MMW 13R,A04,958033,Staff,0,4,16,16
1746540742052,MMW 13R,A05,958034,Staff,0,4,16,16
1746540743081,SIO 295LS,A00,894015,Staff,5,0,25,20
1746540744108,SIO 295S,A00,894020,Staff,5,0,25,20
1746540745135,SIOC 290S,B01,958918,Merrifield; Mark A,14,0,30,16
1746540746172,SIOC 291S,B01,958922,Gabriel; Corey John,14,0,30,16
1746540747198,SOCI 117,A01,895339,Staff,3,0,5,2
1746540748222,WES 237B,A00,894149,Staff,11,0,20,9
1746540750293,AESE 279B,A00,891859,Staff,13,0,35,22
1746540751318,AIP 197,001,891854,Vespa; Emanuel Ignacio,9999,0,9999,0
1746540752343,ANTH 289S,A00,891856,Gagneux; Pascal,12,0,12,0
1746540753368,BENG 196,001,957946,Engler; Adam J.,9996,0,9999,3
1746540754392,BISP 197,001,959851,Wilhelm; James E.,9999,0,9999,0
1746540755418,CAT 124RS,A01,956906,Staff,6,0,25,19
1746540756441,CAT 125RS,A01,922013,Staff,6,0,25,19
1746540757468,CLRE 250,A00,891860,Morris; Sheldon,9995,0,9999,4
1746540759520,CLRE 251R,A00,907817,Mehta; Ravindra L.,9994,0,9999,5
1746540760545,CLRE 252,A00,891864,Cuomo; Raphael Eduardo,9993,0,9999,6
1746540761574,CLRE 253,A00,891867,Vaida; Florin,9994,0,9999,5
1746540761574,CLRE 253,B00,907819,Staff,9999,0,9999,0
1746540762605,CLRE 259,A00,891868,Patel; Hemal,9998,0,9999,1
1746540763633,CLRE 260,A00,891872,Cuomo; Raphael Eduardo,9999,0,9999,0
1746540764660,CLRE 297,001,891888,Cuomo; Raphael Eduardo,9999,0,9999,0
1746540765684,CSE 191,A00,958773,Minnes Kemp; Mor Mia,9996,0,9999,3
1746540766710,CSE 197,001,959846,Minnes Kemp; Mor Mia,9993,0,9999,6
1746540767737,CSS 201S,A01,892054,Mignozzetti; Umberto,26,0,30,4
1746540768765,CSS 202S,A01,892056,Mignozzetti; Umberto,26,0,30,4
1746540769795,DSC 197,001,956898,Eldridge; Justin Matthew,9998,0,9999,1
1746540770821,DSC 297,001,958000,Mazumdar; Arya,9998,0,9999,1
1746540770821,DSC 297,002,959862,Wang; Yusu,9999,0,9999,0
1746540771849,EAP 100,A00,905686,Staff,9778,0,9999,221
1746540772875,ECE 45,A01,892618,Staff,0,0,65,65
1746540774932,ECE 111,A01,892719,Staff,4,0,65,61
1746540775959,ECE 197,001,957920,Mercier; Patrick Philip,9991,0,9999,8
1746540776984,ECON 178,A01,907814,Zhu; Ying,26,0,35,9
1746540778012,EDS 115,A00,895312,Staff,36,0,45,9
1746540779038,EDS 117,A01,895337,Staff,24,0,30,6
1746540780069,EDS 125,A00,895341,Jones; Gabrielle Anastasia,37,0,45,8
1746540781095,EDS 128A,A01,895459,Fargason; Sharon Gayle,44,0,45,1
1746540782122,EDS 128B,A01,895543,Pappas; Elizabeth,44,0,45,1
1746540783148,EDS 139,A00,897203,Pappas; Elizabeth,44,0,45,1
1746540783148,EDS 139,B00,897209,Fargason; Sharon Gayle,41,0,45,4
1746540784176,EDS 201,A00,895545,Staff,23,0,45,22
1746540785203,EDS 203,A01,895581,Halter; Christopher P.,23,0,45,22
1746540786232,EDS 204R,A01,895625,Heinzman; Erica M.,39,0,45,6
1746540786232,EDS 204R,B01,895693,Halter; Christopher P.,10,0,45,35
1746540787258,EDS 206R,A00,895694,Fargason; Sharon Gayle,1,0,30,29
1746540787258,EDS 206R,B00,895695,Choi; Bailey Miyeon,16,0,30,14
1746540788286,EDS 250,A00,895697,Hemans; Patricia Ann Benitez,23,0,45,22
1746540789370,EDS 281,A00,895701,Meyerott; Theresa Ann,1,0,15,14
1746540790394,EDS 284,A00,895736,Meyerott; Theresa Ann,1,0,15,14
1746540791420,EDS 286,A00,897210,Fine; Sarah,0,0,15,15
1746540792450,EDS 289C,A01,895770,Daly; Alan J.,15,0,15,0
1746540793479,EDS 290,A00,897211,Hofstetter; Carolyn,0,0,15,15
1746540794506,LIGM 5A,A00,896162,Fischer-Grunski; Eva K,13,0,20,7
1746540795533,LIGM 5B,A00,896260,Fischer-Grunski; Eva K,17,0,20,3
1746540796559,LIGM 5C,A00,896308,Fischer-Grunski; Eva K,18,0,20,2
1746540797589,LIIT 5AS,A00,896313,Carnelos; Chiara,18,0,20,2
1746540798614,LIIT 5BS,A00,896416,Carnelos; Chiara,20,0,20,0
1746540799639,LIIT 5CS,A00,896564,Carnelos; Chiara,20,0,20,0
1746540800666,LISP 5A,A00,896588,Munoz Sanchez; Alicia,3,0,20,17
1746540801691,LISP 5B,A00,896653,Munoz Sanchez; Alicia,7,0,20,13
1746540802716,LISP 5C,A00,896655,Munoz Sanchez; Alicia,0,1,20,20
1746540803743,MAE 197,001,957918,Kleissl; Jan,9996,0,9999,3
1746540803743,MAE 197,002,959806,Boechler; Nicholas Sebastia,9998,0,9999,1
1746540803743,MAE 197,003,959852,Mullin; Jennifer S,9999,0,9999,0
1746540804768,MATH 2,A01,957937,Staff,33,0,35,2
1746540805794,MATH 197,001,957876,Kedlaya; Kiran S.,9993,0,9999,6
1746540806823,MCWP 40,A00,892729,Duru; Nur,10,0,20,10
1746540806823,MCWP 40,B00,893304,Montejo; Carolina,14,0,20,6
1746540807849,MCWP 40R,A00,893757,Redela; Pamela Morgan,0,5,20,20
1746540808875,MCWP 50,A00,893758,Morshed; Michael James,0,0,20,20
1746540808875,MCWP 50,B00,893761,Bartulis; Jason Michael,17,0,20,3
1746540809901,MCWP 50R,A00,893766,Compas; Sean Matthew,0,1,20,20
1746540809901,MCWP 50R,B00,893769,Carter; Jennifer A,0,1,20,20
1746540809901,MCWP 50R,C00,893771,Krone; Jarret,0,3,20,20
1746540809901,MCWP 50R,D00,893772,Miller; Elizabeth Deen,0,0,20,20
1746540809901,MCWP 50R,E00,893775,Carter; Andrea L,0,1,20,20
1746540810926,MMW 11R,A01,892721,Herbst; Matthew,11,0,27,16
1746540810926,MMW 11R,A02,892722,Herbst; Matthew,0,0,0,3
1746540811953,MMW 12R,A01,892724,Herbst; Matthew,0,11,16,16
1746540811953,MMW 12R,A02,892725,Herbst; Matthew,0,10,16,16
1746540812981,MMW 13R,A01,892727,Staff,0,4,16,16
1746540812981,MMW 13R,A02,892728,Staff,0,4,16,16
1746540812981,MMW 13R,A03,958032,Staff,0,4,16,16
1746540812981,MMW 13R,A04,958033,Staff,0,4,16,16
1746540812981,MMW 13R,A05,958034,Staff,0,4,16,16
1746540814009,SIO 295LS,A00,894015,Staff,5,0,25,20
1746540815034,SIO 295S,A00,894020,Staff,5,0,25,20
1746540816061,SIOC 290S,B01,958918,Merrifield; Mark A,14,0,30,16
1746540817089,SIOC 291S,B01,958922,Gabriel; Corey John,14,0,30,16
1746540818117,SOCI 117,A01,895339,Staff,3,0,5,2
1746540819143,WES 237B,A00,894149,Staff,11,0,20,9
1746540821211,AESE 279B,A00,891859,Staff,13,0,35,22
1746540822238,AIP 197,001,891854,Vespa; Emanuel Ignacio,9999,0,9999,0
1746540823263,ANTH 289S,A00,891856,Gagneux; Pascal,12,0,12,0
1746540824291,BENG 196,001,957946,Engler; Adam J.,9996,0,9999,3
1746540825317,BISP 197,001,959851,Wilhelm; James E.,9999,0,9999,0
1746540826340,CAT 124RS,A01,956906,Staff,6,0,25,19
1746540827365,CAT 125RS,A01,922013,Staff,6,0,25,19
1746540828392,CLRE 250,A00,891860,Morris; Sheldon,9995,0,9999,4
1746540830443,CLRE 251R,A00,907817,Mehta; Ravindra L.,9994,0,9999,5
1746540831470,CLRE 252,A00,891864,Cuomo; Raphael Eduardo,9993,0,9999,6
1746540832496,CLRE 253,A00,891867,Vaida; Florin,9994,0,9999,5
1746540832496,CLRE 253,B00,907819,Staff,9999,0,9999,0
1746540833523,CLRE 259,A00,891868,Patel; Hemal,9998,0,9999,1
1746540834549,CLRE 260,A00,891872,Cuomo; Raphael Eduardo,9999,0,9999,0
1746540835574,CLRE 297,001,891888,Cuomo; Raphael Eduardo,9999,0,9999,0
1746540836601,CSE 191,A00,958773,Minnes Kemp; Mor Mia,9996,0,9999,3
1746540837626,CSE 197,001,959846,Minnes Kemp; Mor Mia,9993,0,9999,6
1746540838653,CSS 201S,A01,892054,Mignozzetti; Umberto,26,0,30,4
1746540839683,CSS 202S,A01,892056,Mignozzetti; Umberto,26,0,30,4
1746540840707,DSC 197,001,956898,Eldridge; Justin Matthew,9998,0,9999,1
1746540841734,DSC 297,001,958000,Mazumdar; Arya,9998,0,9999,1
1746540841734,DSC 297,002,959862,Wang; Yusu,9999,0,9999,0
1746540842760,EAP 100,A00,905686,Staff,9778,0,9999,221
1746540843786,ECE 45,A01,892618,Staff,0,0,65,65
1746540845837,ECE 111,A01,892719,Staff,4,0,65,61
1746540846864,ECE 197,001,957920,Mercier; Patrick Philip,9991,0,9999,8
1746540847888,ECON 178,A01,907814,Zhu; Ying,26,0,35,9
1746540848914,EDS 115,A00,895312,Staff,36,0,45,9
1746540849944,EDS 117,A01,895337,Staff,24,0,30,6
1746540850970,EDS 125,A00,895341,Jones; Gabrielle Anastasia,37,0,45,8
1746540851996,EDS 128A,A01,895459,Fargason; Sharon Gayle,44,0,45,1
1746540853025,EDS 128B,A01,895543,Pappas; Elizabeth,44,0,45,1
1746540854050,EDS 139,A00,897203,Pappas; Elizabeth,44,0,45,1
1746540854050,EDS 139,B00,897209,Fargason; Sharon Gayle,41,0,45,4
1746540855083,EDS 201,A00,895545,Staff,23,0,45,22
1746540856109,EDS 203,A01,895581,Halter; Christopher P.,23,0,45,22
1746540857135,EDS 204R,A01,895625,Heinzman; Erica M.,39,0,45,6
1746540857135,EDS 204R,B01,895693,Halter; Christopher P.,10,0,45,35
1746540858161,EDS 206R,A00,895694,Fargason; Sharon Gayle,1,0,30,29
1746540858161,EDS 206R,B00,895695,Choi; Bailey Miyeon,16,0,30,14
1746540859187,EDS 250,A00,895697,Hemans; Patricia Ann Benitez,23,0,45,22
1746540860213,EDS 281,A00,895701,Meyerott; Theresa Ann,1,0,15,14
1746540861243,EDS 284,A00,895736,Meyerott; Theresa Ann,1,0,15,14
1746540862276,EDS 286,A00,897210,Fine; Sarah,0,0,15,15
1746540863301,EDS 289C,A01,895770,Daly; Alan J.,15,0,15,0
1746540864328,EDS 290,A00,897211,Hofstetter; Carolyn,0,0,15,15
1746540865355,LIGM 5A,A00,896162,Fischer-Grunski; Eva K,13,0,20,7
1746540866385,LIGM 5B,A00,896260,Fischer-Grunski; Eva K,17,0,20,3
1746540867411,LIGM 5C,A00,896308,Fischer-Grunski; Eva K,18,0,20,2
1746540868436,LIIT 5AS,A00,896313,Carnelos; Chiara,18,0,20,2
1746540869463,LIIT 5BS,A00,896416,Carnelos; Chiara,20,0,20,0
1746540870488,LIIT 5CS,A00,896564,Carnelos; Chiara,20,0,20,0
1746540871515,LISP 5A,A00,896588,Munoz Sanchez; Alicia,3,0,20,17
1746540872540,LISP 5B,A00,896653,Munoz Sanchez; Alicia,7,0,20,13
1746540873569,LISP 5C,A00,896655,Munoz Sanchez; Alicia,0,1,20,20
1746540874594,MAE 197,001,957918,Kleissl; Jan,9996,0,9999,3
1746540874594,MAE 197,002,959806,Boechler; Nicholas Sebastia,9998,0,9999,1
1746540874594,MAE 197,003,959852,Mullin; Jennifer S,9999,0,9999,0
1746540875619,MATH 2,A01,957937,Staff,33,0,35,2
1746540876645,MATH 197,001,957876,Kedlaya; Kiran S.,9993,0,9999,6
1746540877673,MCWP 40,A00,892729,Duru; Nur,10,0,20,10
1746540877673,MCWP 40,B00,893304,Montejo; Carolina,14,0,20,6
1746540878701,MCWP 40R,A00,893757,Redela; Pamela Morgan,0,5,20,20
1746540879727,MCWP 50,A00,893758,Morshed; Michael James,0,0,20,20
1746540879727,MCWP 50,B00,893761,Bartulis; Jason Michael,17,0,20,3
1746540880752,MCWP 50R,A00,893766,Compas; Sean Matthew,0,1,20,20
1746540880752,MCWP 50R,B00,893769,Carter; Jennifer A,0,1,20,20
1746540880752,MCWP 50R,C00,893771,Krone; Jarret,0,3,20,20
1746540880752,MCWP 50R,D00,893772,Miller; Elizabeth Deen,0,0,20,20
1746540880752,MCWP 50R,E00,893775,Carter; Andrea L,0,1,20,20
1746540881779,MMW 11R,A01,892721,Herbst; Matthew,11,0,27,16
1746540881779,MMW 11R,A02,892722,Herbst; Matthew,0,0,0,3
1746540882807,MMW 12R,A01,892724,Herbst; Matthew,0,11,16,16
1746540882807,MMW 12R,A02,892725,Herbst; Matthew,0,10,16,16
1746540883832,MMW 13R,A01,892727,Staff,0,4,16,16
1746540883832,MMW 13R,A02,892728,Staff,0,4,16,16
1746540883832,MMW 13R,A03,958032,Staff,0,4,16,16
1746540883832,MMW 13R,A04,958033,Staff,0,4,16,16
1746540883832,MMW 13R,A05,958034,Staff,0,4,16,16
1746540884858,SIO 295LS,A00,894015,Staff,5,0,25,20
1746540885883,SIO 295S,A00,894020,Staff,5,0,25,20
1746540886912,SIOC 290S,B01,958918,Merrifield; Mark A,14,0,30,16
1746540887940,SIOC 291S,B01,958922,Gabriel; Corey John,14,0,30,16
1746540888968,SOCI 117,A01,895339,Staff,3,0,5,2
1746540889996,WES 237B,A00,894149,Staff,11,0,20,9
1746540892055,AESE 279B,A00,891859,Staff,13,0,35,22
1746540893117,AIP 197,001,891854,Vespa; Emanuel Ignacio,9999,0,9999,0
1746540894143,ANTH 289S,A00,891856,Gagneux; Pascal,12,0,12,0
1746540895171,BENG 196,001,957946,Engler; Adam J.,9996,0,9999,3
1746540896197,BISP 197,001,959851,Wilhelm; James E.,9999,0,9999,0
1746540897225,CAT 124RS,A01,956906,Staff,6,0,25,19
1746540898249,CAT 125RS,A01,922013,Staff,6,0,25,19
1746540899276,CLRE 250,A00,891860,Morris; Sheldon,9995,0,9999,4
1746540901329,CLRE 251R,A00,907817,Mehta; Ravindra L.,9994,0,9999,5
1746540902359,CLRE 252,A00,891864,Cuomo; Raphael Eduardo,9993,0,9999,6
1746540903387,CLRE 253,A00,891867,Vaida; Florin,9994,0,9999,5
1746540903387,CLRE 253,B00,907819,Staff,9999,0,9999,0
1746540904414,CLRE 259,A00,891868,Patel; Hemal,9998,0,9999,1
1746540905442,CLRE 260,A00,891872,Cuomo; Raphael Eduardo,9999,0,9999,0
1746540906473,CLRE 297,001,891888,Cuomo; Raphael Eduardo,9999,0,9999,0
1746540907499,CSE 191,A00,958773,Minnes Kemp; Mor Mia,9996,0,9999,3
1746540908533,CSE 197,001,959846,Minnes Kemp; Mor Mia,9993,0,9999,6
1746540909562,CSS 201S,A01,892054,Mignozzetti; Umberto,26,0,30,4
1746540910588,CSS 202S,A01,892056,Mignozzetti; Umberto,26,0,30,4
1746540911615,DSC 197,001,956898,Eldridge; Justin Matthew,9998,0,9999,1
1746540912644,DSC 297,001,958000,Mazumdar; Arya,9998,0,9999,1
1746540912644,DSC 297,002,959862,Wang; Yusu,9999,0,9999,0
1746540913670,EAP 100,A00,905686,Staff,9778,0,9999,221
1746540914699,ECE 45,A01,892618,Staff,0,0,65,65
1746540916750,ECE 111,A01,892719,Staff,4,0,65,61
1746540917779,ECE 197,001,957920,Mercier; Patrick Philip,9991,0,9999,8
1746540918803,ECON 178,A01,907814,Zhu; Ying,26,0,35,9
1746540919829,EDS 115,A00,895312,Staff,36,0,45,9
1746540920853,EDS 117,A01,895337,Staff,24,0,30,6
1746540921879,EDS 125,A00,895341,Jones; Gabrielle Anastasia,37,0,45,8
1746540922908,EDS 128A,A01,895459,Fargason; Sharon Gayle,44,0,45,1
1746540923938,EDS 128B,A01,895543,Pappas; Elizabeth,44,0,45,1
1746540924968,EDS 139,A00,897203,Pappas; Elizabeth,44,0,45,1
1746540924968,EDS 139,B00,897209,Fargason; Sharon Gayle,41,0,45,4
1746540925993,EDS 201,A00,895545,Staff,23,0,45,22
1746540927017,EDS 203,A01,895581,Halter; Christopher P.,23,0,45,22
1746540928056,EDS 204R,A01,895625,Heinzman; Erica M.,39,0,45,6
1746540928056,EDS 204R,B01,895693,Halter; Christopher P.,10,0,45,35
1746540929083,EDS 206R,A00,895694,Fargason; Sharon Gayle,1,0,30,29
1746540929083,EDS 206R,B00,895695,Choi; Bailey Miyeon,16,0,30,14
1746540930109,EDS 250,A00,895697,Hemans; Patricia Ann Benitez,23,0,45,22
1746540931136,EDS 281,A00,895701,Meyerott; Theresa Ann,1,0,15,14
1746540932160,EDS 284,A00,895736,Meyerott; Theresa Ann,1,0,15,14
1746540933188,EDS 286,A00,897210,Fine; Sarah,0,0,15,15
1746540934211,EDS 289C,A01,895770,Daly; Alan J.,15,0,15,0
1746540935240,EDS 290,A00,897211,Hofstetter; Carolyn,0,0,15,15
1746540936268,LIGM 5A,A00,896162,Fischer-Grunski; Eva K,13,0,20,7
1746540937297,LIGM 5B,A00,896260,Fischer-Grunski; Eva K,17,0,20,3
1746540938329,LIGM 5C,A00,896308,Fischer-Grunski; Eva K,18,0,20,2
1746540939356,LIIT 5AS,A00,896313,Carnelos; Chiara,18,0,20,2
1746540940381,LIIT 5BS,A00,896416,Carnelos; Chiara,20,0,20,0
1746540941406,LIIT 5CS,A00,896564,Carnelos; Chiara,20,0,20,0
1746540942435,LISP 5A,A00,896588,Munoz Sanchez; Alicia,3,0,20,17
1746540943462,LISP 5B,A00,896653,Munoz Sanchez; Alicia,7,0,20,13
1746540944488,LISP 5C,A00,896655,Munoz Sanchez; Alicia,0,1,20,20
1746540945518,MAE 197,001,957918,Kleissl; Jan,9996,0,9999,3
1746540945518,MAE 197,002,959806,Boechler; Nicholas Sebastia,9998,0,9999,1
1746540945518,MAE 197,003,959852,Mullin; Jennifer S,9999,0,9999,0
1746540946544,MATH 2,A01,957937,Staff,33,0,35,2
1746540947570,MATH 197,001,957876,Kedlaya; Kiran S.,9993,0,9999,6
1746540948595,MCWP 40,A00,892729,Duru; Nur,10,0,20,10
1746540948595,MCWP 40,B00,893304,Montejo; Carolina,14,0,20,6
1746540949620,MCWP 40R,A00,893757,Redela; Pamela Morgan,0,5,20,20
1746540950649,MCWP 50,A00,893758,Morshed; Michael James,0,0,20,20
1746540950649,MCWP 50,B00,893761,Bartulis; Jason Michael,17,0,20,3
1746540951677,MCWP 50R,A00,893766,Compas; Sean Matthew,0,1,20,20
1746540951677,MCWP 50R,B00,893769,Carter; Jennifer A,0,1,20,20
1746540951677,MCWP 50R,C00,893771,Krone; Jarret,0,3,20,20
1746540951677,MCWP 50R,D00,893772,Miller; Elizabeth Deen,0,0,20,20
1746540951677,MCWP 50R,E00,893775,Carter; Andrea L,0,1,20,20
1746540952704,MMW 11R,A01,892721,Herbst; Matthew,11,0,27,16
1746540952704,MMW 11R,A02,892722,Herbst; Matthew,0,0,0,3
1746540953729,MMW 12R,A01,892724,Herbst; Matthew,0,11,16,16
1746540953729,MMW 12R,A02,892725,Herbst; Matthew,0,10,16,16
1746540954758,MMW 13R,A01,892727,Staff,0,4,16,16
1746540954758,MMW 13R,A02,892728,Staff,0,4,16,16
1746540954758,MMW 13R,A03,958032,Staff,0,4,16,16
1746540954758,MMW 13R,A04,958033,Staff,0,4,16,16
1746540954758,MMW 13R,A05,958034,Staff,0,4,16,16
1746540955785,SIO 295LS,A00,894015,Staff,5,0,25,20
1746540956813,SIO 295S,A00,894020,Staff,5,0,25,20
1746540957840,SIOC 290S,B01,958918,Merrifield; Mark A,14,0,30,16
1746540958867,SIOC 291S,B01,958922,Gabriel; Corey John,14,0,30,16
1746540959895,SOCI 117,A01,895339,Staff,3,0,5,2
1746540960921,WES 237B,A00,894149,Staff,11,0,20,9
1746540962986,AESE 279B,A00,891859,Staff,13,0,35,22
1746540964014,AIP 197,001,891854,Vespa; Emanuel Ignacio,9999,0,9999,0
1746540965041,ANTH 289S,A00,891856,Gagneux; Pascal,12,0,12,0
1746540966068,BENG 196,001,957946,Engler; Adam J.,9996,0,9999,3
1746540967100,BISP 197,001,959851,Wilhelm; James E.,9999,0,9999,0
1746540968128,CAT 124RS,A01,956906,Staff,6,0,25,19
1746540969153,CAT 125RS,A01,922013,Staff,6,0,25,19
1746540970181,CLRE 250,A00,891860,Morris; Sheldon,9995,0,9999,4
1746540972238,CLRE 251R,A00,907817,Mehta; Ravindra L.,9994,0,9999,5
1746540973265,CLRE 252,A00,891864,Cuomo; Raphael Eduardo,9993,0,9999,6
1746540974292,CLRE 253,A00,891867,Vaida; Florin,9994,0,9999,5
1746540974292,CLRE 253,B00,907819,Staff,9999,0,9999,0
1746540975318,CLRE 259,A00,891868,Patel; Hemal,9998,0,9999,1
1746540976344,CLRE 260,A00,891872,Cuomo; Raphael Eduardo,9999,0,9999,0
1746540977371,CLRE 297,001,891888,Cuomo; Raphael Eduardo,9999,0,9999,0
1746540978402,CSE 191,A00,958773,Minnes Kemp; Mor Mia,9996,0,9999,3
1746540979427,CSE 197,001,959846,Minnes Kemp; Mor Mia,9993,0,9999,6
1746540980454,CSS 201S,A01,892054,Mignozzetti; Umberto,26,0,30,4
1746540981482,CSS 202S,A01,892056,Mignozzetti; Umberto,26,0,30,4
1746540982509,DSC 197,001,956898,Eldridge; Justin Matthew,9998,0,9999,1
1746540983536,DSC 297,001,958000,Mazumdar; Arya,9998,0,9999,1
1746540983536,DSC 297,002,959862,Wang; Yusu,9999,0,9999,0
1746540984566,EAP 100,A00,905686,Staff,9778,0,9999,221
1746540985593,ECE 45,A01,892618,Staff,0,0,65,65
1746540987650,ECE 111,A01,892719,Staff,4,0,65,61
1746540988676,ECE 197,001,957920,Mercier; Patrick Philip,9991,0,9999,8
1746540989702,ECON 178,A01,907814,Zhu; Ying,26,0,35,9
1746540990727,EDS 115,A00,895312,Staff,36,0,45,9
1746540991755,EDS 117,A01,895337,Staff,24,0,30,6
1746540992782,EDS 125,A00,895341,Jones; Gabrielle Anastasia,37,0,45,8
1746540993808,EDS 128A,A01,895459,Fargason; Sharon Gayle,44,0,45,1
1746540994833,EDS 128B,A01,895543,Pappas; Elizabeth,44,0,45,1
1746540995860,EDS 139,A00,897203,Pappas; Elizabeth,44,0,45,1
1746540995860,EDS 139,B00,897209,Fargason; Sharon Gayle,41,0,45,4
1746540996887,EDS 201,A00,895545,Staff,23,0,45,22
1746540997915,EDS 203,A01,895581,Halter; Christopher P.,23,0,45,22
1746540998943,EDS 204R,A01,895625,Heinzman; Erica M.,39,0,45,6
1746540998943,EDS 204R,B01,895693,Halter; Christopher P.,10,0,45,35
1746540999975,EDS 206R,A00,895694,Fargason; Sharon Gayle,1,0,30,29
1746540999975,EDS 206R,B00,895695,Choi; Bailey Miyeon,16,0,30,14
1746541001005,EDS 250,A00,895697,Hemans; Patricia Ann Benitez,23,0,45,22
1746541002031,EDS 281,A00,895701,Meyerott; Theresa Ann,1,0,15,14
1746541003057,EDS 284,A00,895736,Meyerott; Theresa Ann,1,0,15,14
1746541004084,EDS 286,A00,897210,Fine; Sarah,0,0,15,15
1746541005114,EDS 289C,A01,895770,Daly; Alan J.,15,0,15,0
1746541006142,EDS 290,A00,897211,Hofstetter; Carolyn,0,0,15,15
1746541007169,LIGM 5A,A00,896162,Fischer-Grunski; Eva K,13,0,20,7
1746541008197,LIGM 5B,A00,896260,Fischer-Grunski; Eva K,17,0,20,3
1746541009224,LIGM 5C,A00,896308,Fischer-Grunski; Eva K,18,0,20,2
1746541010252,LIIT 5AS,A00,896313,Carnelos; Chiara,18,0,20,2
1746541011281,LIIT 5BS,A00,896416,Carnelos; Chiara,20,0,20,0
1746541012307,LIIT 5CS,A00,896564,Carnelos; Chiara,20,0,20,0
1746541013333,LISP 5A,A00,896588,Munoz Sanchez; Alicia,3,0,20,17
1746541014364,LISP 5B,A00,896653,Munoz Sanchez; Alicia,7,0,20,13
1746541015389,LISP 5C,A00,896655,Munoz Sanchez; Alicia,0,1,20,20
1746541016419,MAE 197,001,957918,Kleissl; Jan,9996,0,9999,3
1746541016419,MAE 197,002,959806,Boechler; Nicholas Sebastia,9998,0,9999,1
1746541016419,MAE 197,003,959852,Mullin; Jennifer S,9999,0,9999,0
1746541017447,MATH 2,A01,957937,Staff,33,0,35,2
1746541018472,MATH 197,001,957876,Kedlaya; Kiran S.,9993,0,9999,6
1746541019500,MCWP 40,A00,892729,Duru; Nur,10,0,20,10
1746541019500,MCWP 40,B00,893304,Montejo; Carolina,14,0,20,6
1746541020529,MCWP 40R,A00,893757,Redela; Pamela Morgan,0,5,20,20
1746541021556,MCWP 50,A00,893758,Morshed; Michael James,0,0,20,20
1746541021556,MCWP 50,B00,893761,Bartulis; Jason Michael,17,0,20,3
1746541022589,MCWP 50R,A00,893766,Compas; Sean Matthew,0,1,20,20
1746541022589,MCWP 50R,B00,893769,Carter; Jennifer A,0,1,20,20
1746541022589,MCWP 50R,C00,893771,Krone; Jarret,0,3,20,20
1746541022589,MCWP 50R,D00,893772,Miller; Elizabeth Deen,0,0,20,20
1746541022589,MCWP 50R,E00,893775,Carter; Andrea L,0,1,20,20
1746541023616,MMW 11R,A01,892721,Herbst; Matthew,11,0,27,16
1746541023616,MMW 11R,A02,892722,Herbst; Matthew,0,0,0,3
1746541024643,MMW 12R,A01,892724,Herbst; Matthew,0,11,16,16
1746541024643,MMW 12R,A02,892725,Herbst; Matthew,0,10,16,16
1746541025672,MMW 13R,A01,892727,Staff,0,4,16,16
1746541025672,MMW 13R,A02,892728,Staff,0,4,16,16
1746541025672,MMW 13R,A03,958032,Staff,0,4,16,16
1746541025672,MMW 13R,A04,958033,Staff,0,4,16,16
1746541025672,MMW 13R,A05,958034,Staff,0,4,16,16
1746541026698,SIO 295LS,A00,894015,Staff,5,0,25,20
1746541027725,SIO 295S,A00,894020,Staff,5,0,25,20
1746541028755,SIOC 290S,B01,958918,Merrifield; Mark A,14,0,30,16
1746541029782,SIOC 291S,B01,958922,Gabriel; Corey John,14,0,30,16
1746541030806,SOCI 117,A01,895339,Staff,3,0,5,2
1746541031874,WES 237B,A00,894149,Staff,11,0,20,9
1746541033951,AESE 279B,A00,891859,Staff,13,0,35,22
1746541034980,AIP 197,001,891854,Vespa; Emanuel Ignacio,9999,0,9999,0
1746541036005,ANTH 289S,A00,891856,Gagneux; Pascal,12,0,12,0
1746541037034,BENG 196,001,957946,Engler; Adam J.,9996,0,9999,3
1746541038060,BISP 197,001,959851,Wilhelm; James E.,9999,0,9999,0
1746541039086,CAT 124RS,A01,956906,Staff,6,0,25,19
1746541040115,CAT 125RS,A01,922013,Staff,6,0,25,19
1746541041140,CLRE 250,A00,891860,Morris; Sheldon,9995,0,9999,4
1746541043194,CLRE 251R,A00,907817,Mehta; Ravindra L.,9994,0,9999,5
1746541044223,CLRE 252,A00,891864,Cuomo; Raphael Eduardo,9993,0,9999,6
1746541045247,CLRE 253,A00,891867,Vaida; Florin,9994,0,9999,5
1746541045247,CLRE 253,B00,907819,Staff,9999,0,9999,0
1746541046271,CLRE 259,A00,891868,Patel; Hemal,9998,0,9999,1
1746541047295,CLRE 260,A00,891872,Cuomo; Raphael Eduardo,9999,0,9999,0
1746541048319,CLRE 297,001,891888,Cuomo; Raphael Eduardo,9999,0,9999,0
1746541049349,CSE 191,A00,958773,Minnes Kemp; Mor Mia,9996,0,9999,3
1746541050377,CSE 197,001,959846,Minnes Kemp; Mor Mia,9993,0,9999,6
1746541051403,CSS 201S,A01,892054,Mignozzetti; Umberto,26,0,30,4
1746541052429,CSS 202S,A01,892056,Mignozzetti; Umberto,26,0,30,4
1746541053457,DSC 197,001,956898,Eldridge; Justin Matthew,9998,0,9999,1
1746541054481,DSC 297,001,958000,Mazumdar; Arya,9998,0,9999,1
1746541054481,DSC 297,002,959862,Wang; Yusu,9999,0,9999,0
1746541055508,EAP 100,A00,905686,Staff,9778,0,9999,221
1746541056536,ECE 45,A01,892618,Staff,0,0,65,65
1746541058593,ECE 111,A01,892719,Staff,4,0,65,61
1746541059618,ECE 197,001,957920,Mercier; Patrick Philip,9991,0,9999,8
1746541060648,ECON 178,A01,907814,Zhu; Ying,26,0,35,9
1746541061675,EDS 115,A00,895312,Staff,36,0,45,9
1746541062703,EDS 117,A01,895337,Staff,24,0,30,6
1746541063730,EDS 125,A00,895341,Jones; Gabrielle Anastasia,37,0,45,8
1746541064758,EDS 128A,A01,895459,Fargason; Sharon Gayle,44,0,45,1
1746541065783,EDS 128B,A01,895543,Pappas; Elizabeth,44,0,45,1
1746541066813,EDS 139,A00,897203,Pappas; Elizabeth,44,0,45,1
1746541066813,EDS 139,B00,897209,Fargason; Sharon Gayle,41,0,45,4
1746541067838,EDS 201,A00,895545,Staff,23,0,45,22
1746541068865,EDS 203,A01,895581,Halter; Christopher P.,23,0,45,22
1746541069894,EDS 204R,A01,895625,Heinzman; Erica M.,39,0,45,6
1746541069894,EDS 204R,B01,895693,Halter; Christopher P.,10,0,45,35
1746541070920,EDS 206R,A00,895694,Fargason; Sharon Gayle,1,0,30,29
1746541070920,EDS 206R,B00,895695,Choi; Bailey Miyeon,16,0,30,14
1746541071948,EDS 250,A00,895697,Hemans; Patricia Ann Benitez,23,0,45,22
1746541072973,EDS 281,A00,895701,Meyerott; Theresa Ann,1,0,15,14
1746541074001,EDS 284,A00,895736,Meyerott; Theresa Ann,1,0,15,14
1746541075030,EDS 286,A00,897210,Fine; Sarah,0,0,15,15
1746541076059,EDS 289C,A01,895770,Daly; Alan J.,15,0,15,0
1746541077085,EDS 290,A00,897211,Hofstetter; Carolyn,0,0,15,15
1746541078111,LIGM 5A,A00,896162,Fischer-Grunski; Eva K,13,0,20,7
1746541079142,LIGM 5B,A00,896260,Fischer-Grunski; Eva K,17,0,20,3
1746541080172,LIGM 5C,A00,896308,Fischer-Grunski; Eva K,18,0,20,2
1746541081197,LIIT 5AS,A00,896313,Carnelos; Chiara,18,0,20,2
1746541082222,LIIT 5BS,A00,896416,Carnelos; Chiara,20,0,20,0
1746541083249,LIIT 5CS,A00,896564,Carnelos; Chiara,20,0,20,0
1746541084274,LISP 5A,A00,896588,Munoz Sanchez; Alicia,3,0,20,17
1746541085303,LISP 5B,A00,896653,Munoz Sanchez; Alicia,7,0,20,13
1746541086330,LISP 5C,A00,896655,Munoz Sanchez; Alicia,0,1,20,20
1746541087355,MAE 197,001,957918,Kleissl; Jan,9996,0,9999,3
1746541087355,MAE 197,002,959806,Boechler; Nicholas Sebastia,9998,0,9999,1
1746541087355,MAE 197,003,959852,Mullin; Jennifer S,9999,0,9999,0
1746541088381,MATH 2,A01,957937,Staff,33,0,35,2
1746541089406,MATH 197,001,957876,Kedlaya; Kiran S.,9993,0,9999,6
1746541090432,MCWP 40,A00,892729,Duru; Nur,10,0,20,10
1746541090432,MCWP 40,B00,893304,Montejo; Carolina,14,0,20,6
1746541091458,MCWP 40R,A00,893757,Redela; Pamela Morgan,0,5,20,20
1746541092484,MCWP 50,A00,893758,Morshed; Michael James,0,0,20,20
1746541092484,MCWP 50,B00,893761,Bartulis; Jason Michael,17,0,20,3
1746541093514,MCWP 50R,A00,893766,Compas; Sean Matthew,0,1,20,20
1746541093514,MCWP 50R,B00,893769,Carter; Jennifer A,0,1,20,20
1746541093514,MCWP 50R,C00,893771,Krone; Jarret,0,3,20,20
1746541093514,MCWP 50R,D00,893772,Miller; Elizabeth Deen,0,0,20,20
1746541093514,MCWP 50R,E00,893775,Carter; Andrea L,0,1,20,20
1746541094540,MMW 11R,A01,892721,Herbst; Matthew,11,0,27,16
1746541094540,MMW 11R,A02,892722,Herbst; Matthew,0,0,0,3
1746541095568,MMW 12R,A01,892724,Herbst; Matthew,0,11,16,16
1746541095568,MMW 12R,A02,892725,Herbst; Matthew,0,10,16,16
1746541096599,MMW 13R,A01,892727,Staff,0,4,16,16
1746541096599,MMW 13R,A02,892728,Staff,0,4,16,16
1746541096599,MMW 13R,A03,958032,Staff,0,4,16,16
1746541096599,MMW 13R,A04,958033,Staff,0,4,16,16
1746541096599,MMW 13R,A05,958034,Staff,0,4,16,16
1746541097624,SIO 295LS,A00,894015,Staff,5,0,25,20
1746541098650,SIO 295S,A00,894020,Staff,5,0,25,20
1746541099682,SIOC 290S,B01,958918,Merrifield; Mark A,14,0,30,16
1746541100709,SIOC 291S,B01,958922,Gabriel; Corey John,14,0,30,16
1746541101736,SOCI 117,A01,895339,Staff,3,0,5,2
1746541102762,WES 237B,A00,894149,Staff,11,0,20,9
1746541104830,AESE 279B,A00,891859,Staff,13,0,35,22
1746541105860,AIP 197,001,891854,Vespa; Emanuel Ignacio,9999,0,9999,0
1746541106885,ANTH 289S,A00,891856,Gagneux; Pascal,12,0,12,0
1746541107913,BENG 196,001,957946,Engler; Adam J.,9996,0,9999,3
1746541108946,BISP 197,001,959851,Wilhelm; James E.,9999,0,9999,0
1746541110006,CAT 124RS,A01,956906,Staff,6,0,25,19
1746541111031,CAT 125RS,A01,922013,Staff,6,0,25,19
1746541112060,CLRE 250,A00,891860,Morris; Sheldon,9995,0,9999,4
1746541114118,CLRE 251R,A00,907817,Mehta; Ravindra L.,9994,0,9999,5
1746541115142,CLRE 252,A00,891864,Cuomo; Raphael Eduardo,9993,0,9999,6
1746541116168,CLRE 253,A00,891867,Vaida; Florin,9994,0,9999,5
1746541116168,CLRE 253,B00,907819,Staff,9999,0,9999,0
1746541117193,CLRE 259,A00,891868,Patel; Hemal,9998,0,9999,1
1746541118219,CLRE 260,A00,891872,Cuomo; Raphael Eduardo,9999,0,9999,0
1746541119244,CLRE 297,001,891888,Cuomo; Raphael Eduardo,9999,0,9999,0
1746541120272,CSE 191,A00,958773,Minnes Kemp; Mor Mia,9996,0,9999,3
1746541121300,CSE 197,001,959846,Minnes Kemp; Mor Mia,9993,0,9999,6
1746541122328,CSS 201S,A01,892054,Mignozzetti; Umberto,26,0,30,4
1746541123353,CSS 202S,A01,892056,Mignozzetti; Umberto,26,0,30,4
1746541124381,DSC 197,001,956898,Eldridge; Justin Matthew,9998,0,9999,1
1746541125410,DSC 297,001,958000,Mazumdar; Arya,9998,0,9999,1
1746541125410,DSC 297,002,959862,Wang; Yusu,9999,0,9999,0
1746541126434,EAP 100,A00,905686,Staff,9778,0,9999,221
1746541127464,ECE 45,A01,892618,Staff,0,0,65,65
1746541129519,ECE 111,A01,892719,Staff,4,0,65,61
1746541130545,ECE 197,001,957920,Mercier; Patrick Philip,9991,0,9999,8
1746541131571,ECON 178,A01,907814,Zhu; Ying,26,0,35,9
1746541132597,EDS 115,A00,895312,Staff,36,0,45,9
1746541133623,EDS 117,A01,895337,Staff,24,0,30,6
1746541134650,EDS 125,A00,895341,Jones; Gabrielle Anastasia,37,0,45,8
1746541135730,EDS 128A,A01,895459,Fargason; Sharon Gayle,44,0,45,1
1746541136758,EDS 128B,A01,895543,Pappas; Elizabeth,44,0,45,1
1746541137786,EDS 139,A00,897203,Pappas; Elizabeth,44,0,45,1
1746541137786,EDS 139,B00,897209,Fargason; Sharon Gayle,41,0,45,4
1746541138813,EDS 201,A00,895545,Staff,23,0,45,22
1746541139841,EDS 203,A01,895581,Halter; Christopher P.,23,0,45,22
1746541140869,EDS 204R,A01,895625,Heinzman; Erica M.,39,0,45,6
1746541140869,EDS 204R,B01,895693,Halter; Christopher P.,10,0,45,35
1746541141896,EDS 206R,A00,895694,Fargason; Sharon Gayle,1,0,30,29
1746541141896,EDS 206R,B00,895695,Choi; Bailey Miyeon,16,0,30,14
1746541142920,EDS 250,A00,895697,Hemans; Patricia Ann Benitez,23,0,45,22
1746541143948,EDS 281,A00,895701,Meyerott; Theresa Ann,1,0,15,14
1746541144974,EDS 284,A00,895736,Meyerott; Theresa Ann,1,0,15,14
1746541146001,EDS 286,A00,897210,Fine; Sarah,0,0,15,15
1746541147030,EDS 289C,A01,895770,Daly; Alan J.,15,0,15,0
1746541148058,EDS 290,A00,897211,Hofstetter; Carolyn,0,0,15,15
1746541149087,LIGM 5A,A00,896162,Fischer-Grunski; Eva K,13,0,20,7
1746541150117,LIGM 5B,A00,896260,Fischer-Grunski; Eva K,17,0,20,3
1746541151143,LIGM 5C,A00,896308,Fischer-Grunski; Eva K,18,0,20,2
1746541152174,LIIT 5AS,A00,896313,Carnelos; Chiara,18,0,20,2
1746541153200,LIIT 5BS,A00,896416,Carnelos; Chiara,20,0,20,0
1746541154229,LIIT 5CS,A00,896564,Carnelos; Chiara,20,0,20,0
1746541155255,LISP 5A,A00,896588,Munoz Sanchez; Alicia,3,0,20,17
1746541156280,LISP 5B,A00,896653,Munoz Sanchez; Alicia,7,0,20,13
1746541157307,LISP 5C,A00,896655,Munoz Sanchez; Alicia,0,1,20,20
1746541158334,MAE 197,001,957918,Kleissl; Jan,9996,0,9999,3
1746541158334,MAE 197,002,959806,Boechler; Nicholas Sebastia,9998,0,9999,1
1746541158334,MAE 197,003,959852,Mullin; Jennifer S,9999,0,9999,0
1746541159361,MATH 2,A01,957937,Staff,33,0,35,2
1746541160388,MATH 197,001,957876,Kedlaya; Kiran S.,9993,0,9999,6
1746541161412,MCWP 40,A00,892729,Duru; Nur,10,0,20,10
1746541161412,MCWP 40,B00,893304,Montejo; Carolina,14,0,20,6
1746541162440,MCWP 40R,A00,893757,Redela; Pamela Morgan,0,5,20,20
1746541163468,MCWP 50,A00,893758,Morshed; Michael James,0,0,20,20
1746541163468,MCWP 50,B00,893761,Bartulis; Jason Michael,17,0,20,3
1746541164496,MCWP 50R,A00,893766,Compas; Sean Matthew,0,1,20,20
1746541164496,MCWP 50R,B00,893769,Carter; Jennifer A,0,1,20,20
1746541164496,MCWP 50R,C00,893771,Krone; Jarret,0,3,20,20
1746541164496,MCWP 50R,D00,893772,Miller; Elizabeth Deen,0,0,20,20
1746541164496,MCWP 50R,E00,893775,Carter; Andrea L,0,1,20,20
1746541165520,MMW 11R,A01,892721,Herbst; Matthew,11,0,27,16
1746541165520,MMW 11R,A02,892722,Herbst; Matthew,0,0,0,3
1746541166546,MMW 12R,A01,892724,Herbst; Matthew,0,11,16,16
1746541166546,MMW 12R,A02,892725,Herbst; Matthew,0,10,16,16
1746541167571,MMW 13R,A01,892727,Staff,0,4,16,16
1746541167571,MMW 13R,A02,892728,Staff,0,4,16,16
1746541167571,MMW 13R,A03,958032,Staff,0,4,16,16
1746541167571,MMW 13R,A04,958033,Staff,0,4,16,16
1746541167571,MMW 13R,A05,958034,Staff,0,4,16,16
1746541168596,SIO 295LS,A00,894015,Staff,5,0,25,20
1746541169621,SIO 295S,A00,894020,Staff,5,0,25,20
1746541170645,SIOC 290S,B01,958918,Merrifield; Mark A,14,0,30,16
1746541171674,SIOC 291S,B01,958922,Gabriel; Corey John,14,0,30,16
1746541172702,SOCI 117,A01,895339,Staff,3,0,5,2
1746541173728,WES 237B,A00,894149,Staff,11,0,20,9
1746541175790,AESE 279B,A00,891859,Staff,13,0,35,22
1746541176816,AIP 197,001,891854,Vespa; Emanuel Ignacio,9999,0,9999,0
1746541177840,ANTH 289S,A00,891856,Gagneux; Pascal,12,0,12,0
1746541178867,BENG 196,001,957946,Engler; Adam J.,9996,0,9999,3
1746541179894,BISP 197,001,959851,Wilhelm; James E.,9999,0,9999,0
1746541180921,CAT 124RS,A01,956906,Staff,6,0,25,19
1746541181947,CAT 125RS,A01,922013,Staff,6,0,25,19
1746541182973,CLRE 250,A00,891860,Morris; Sheldon,9995,0,9999,4
1746541185030,CLRE 251R,A00,907817,Mehta; Ravindra L.,9994,0,9999,5
1746541186059,CLRE 252,A00,891864,Cuomo; Raphael Eduardo,9993,0,9999,6
1746541187086,CLRE 253,A00,891867,Vaida; Florin,9994,0,9999,5
1746541187086,CLRE 253,B00,907819,Staff,9999,0,9999,0
1746541188114,CLRE 259,A00,891868,Patel; Hemal,9998,0,9999,1
1746541189142,CLRE 260,A00,891872,Cuomo; Raphael Eduardo,9999,0,9999,0
1746541190170,CLRE 297,001,891888,Cuomo; Raphael Eduardo,9999,0,9999,0
1746541191196,CSE 191,A00,958773,Minnes Kemp; Mor Mia,9996,0,9999,3
1746541192222,CSE 197,001,959846,Minnes Kemp; Mor Mia,9993,0,9999,6
1746541193248,CSS 201S,A01,892054,Mignozzetti; Umberto,26,0,30,4
1746541194277,CSS 202S,A01,892056,Mignozzetti; Umberto,26,0,30,4
1746541195304,DSC 197,001,956898,Eldridge; Justin Matthew,9998,0,9999,1
1746541196332,DSC 297,001,958000,Mazumdar; Arya,9998,0,9999,1
1746541196332,DSC 297,002,959862,Wang; Yusu,9999,0,9999,0
1746541197357,EAP 100,A00,905686,Staff,9778,0,9999,221
1746541198389,ECE 45,A01,892618,Staff,0,0,65,65
1746541200443,ECE 111,A01,892719,Staff,4,0,65,61
1746541201478,ECE 197,001,957920,Mercier; Patrick Philip,9991,0,9999,8
1746541202508,ECON 178,A01,907814,Zhu; Ying,26,0,35,9
1746541203535,EDS 115,A00,895312,Staff,36,0,45,9
1746541204573,EDS 117,A01,895337,Staff,24,0,30,6
1746541205601,EDS 125,A00,895341,Jones; Gabrielle Anastasia,37,0,45,8
1746541206625,EDS 128A,A01,895459,Fargason; Sharon Gayle,44,0,45,1
1746541207650,EDS 128B,A01,895543,Pappas; Elizabeth,44,0,45,1
1746541208678,EDS 139,A00,897203,Pappas; Elizabeth,44,0,45,1
1746541208678,EDS 139,B00,897209,Fargason; Sharon Gayle,41,0,45,4
1746541209704,EDS 201,A00,895545,Staff,23,0,45,22
1746541210730,EDS 203,A01,895581,Halter; Christopher P.,23,0,45,22
1746541211760,EDS 204R,A01,895625,Heinzman; Erica M.,39,0,45,6
1746541211760,EDS 204R,B01,895693,Halter; Christopher P.,10,0,45,35
1746541212787,EDS 206R,A00,895694,Fargason; Sharon Gayle,1,0,30,29
1746541212787,EDS 206R,B00,895695,Choi; Bailey Miyeon,16,0,30,14
1746541213814,EDS 250,A00,895697,Hemans; Patricia Ann Benitez,23,0,45,22
1746541214840,EDS 281,A00,895701,Meyerott; Theresa Ann,1,0,15,14
1746541215866,EDS 284,A00,895736,Meyerott; Theresa Ann,1,0,15,14
1746541216894,EDS 286,A00,897210,Fine; Sarah,0,0,15,15
1746541217920,EDS 289C,A01,895770,Daly; Alan J.,15,0,15,0
1746541218948,EDS 290,A00,897211,Hofstetter; Carolyn,0,0,15,15
1746541219974,LIGM 5A,A00,896162,Fischer-Grunski; Eva K,13,0,20,7
1746541221001,LIGM 5B,A00,896260,Fischer-Grunski; Eva K,17,0,20,3
1746541222031,LIGM 5C,A00,896308,Fischer-Grunski; Eva K,18,0,20,2
1746541223058,LIIT 5AS,A00,896313,Carnelos; Chiara,18,0,20,2
1746541224086,LIIT 5BS,A00,896416,Carnelos; Chiara,20,0,20,0
1746541225114,LIIT 5CS,A00,896564,Carnelos; Chiara,20,0,20,0
1746541226141,LISP 5A,A00,896588,Munoz Sanchez; Alicia,3,0,20,17
1746541227167,LISP 5B,A00,896653,Munoz Sanchez; Alicia,7,0,20,13
1746541228193,LISP 5C,A00,896655,Munoz Sanchez; Alicia,0,1,20,20
1746541229220,MAE 197,001,957918,Kleissl; Jan,9996,0,9999,3
1746541229220,MAE 197,002,959806,Boechler; Nicholas Sebastia,9998,0,9999,1
1746541229220,MAE 197,003,959852,Mullin; Jennifer S,9999,0,9999,0
1746541230247,MATH 2,A01,957937,Staff,33,0,35,2
1746541231273,MATH 197,001,957876,Kedlaya; Kiran S.,9993,0,9999,6
1746541232300,MCWP 40,A00,892729,Duru; Nur,10,0,20,10
1746541232300,MCWP 40,B00,893304,Montejo; Carolina,14,0,20,6
1746541233328,MCWP 40R,A00,893757,Redela; Pamela Morgan,0,5,20,20
1746541234356,MCWP 50,A00,893758,Morshed; Michael James,0,0,20,20
1746541234356,MCWP 50,B00,893761,Bartulis; Jason Michael,17,0,20,3
1746541235382,MCWP 50R,A00,893766,Compas; Sean Matthew,0,1,20,20
1746541235382,MCWP 50R,B00,893769,Carter; Jennifer A,0,1,20,20
1746541235382,MCWP 50R,C00,893771,Krone; Jarret,0,3,20,20
1746541235382,MCWP 50R,D00,893772,Miller; Elizabeth Deen,0,0,20,20
1746541235382,MCWP 50R,E00,893775,Carter; Andrea L,0,1,20,20
1746541236410,MMW 11R,A01,892721,Herbst; Matthew,11,0,27,16
1746541236410,MMW 11R,A02,892722,Herbst; Matthew,0,0,0,3
1746541237435,MMW 12R,A01,892724,Herbst; Matthew,0,11,16,16
1746541237435,MMW 12R,A02,892725,Herbst; Matthew,0,10,16,16
1746541238463,MMW 13R,A01,892727,Staff,0,4,16,16
1746541238463,MMW 13R,A02,892728,Staff,0,4,16,16
1746541238463,MMW 13R,A03,958032,Staff,0,4,16,16
1746541238463,MMW 13R,A04,958033,Staff,0,4,16,16
1746541238463,MMW 13R,A05,958034,Staff,0,4,16,16
1746541239532,SIO 295LS,A00,894015,Staff,5,0,25,20
1746541240562,SIO 295S,A00,894020,Staff,5,0,25,20
1746541241592,SIOC 290S,B01,958918,Merrifield; Mark A,14,0,30,16
1746541242616,SIOC 291S,B01,958922,Gabriel; Corey John,14,0,30,16
1746541243642,SOCI 117,A01,895339,Staff,3,0,5,2
1746541244670,WES 237B,A00,894149,Staff,11,0,20,9
1746541246751,AESE 279B,A00,891859,Staff,13,0,35,22
1746541247779,AIP 197,001,891854,Vespa; Emanuel Ignacio,9999,0,9999,0
1746541248808,ANTH 289S,A00,891856,Gagneux; Pascal,12,0,12,0
1746541249836,BENG 196,001,957946,Engler; Adam J.,9996,0,9999,3
1746541250862,BISP 197,001,959851,Wilhelm; James E.,9999,0,9999,0
1746541251888,CAT 124RS,A01,956906,Staff,6,0,25,19
1746541252914,CAT 125RS,A01,922013,Staff,6,0,25,19
1746541253942,CLRE 250,A00,891860,Morris; Sheldon,9995,0,9999,4
1746541256002,CLRE 251R,A00,907817,Mehta; Ravindra L.,9994,0,9999,5
1746541257030,CLRE 252,A00,891864,Cuomo; Raphael Eduardo,9993,0,9999,6
1746541258058,CLRE 253,A00,891867,Vaida; Florin,9994,0,9999,5
1746541258058,CLRE 253,B00,907819,Staff,9999,0,9999,0
1746541259088,CLRE 259,A00,891868,Patel; Hemal,9998,0,9999,1
1746541260122,CLRE 260,A00,891872,Cuomo; Raphael Eduardo,9999,0,9999,0
1746541261148,CLRE 297,001,891888,Cuomo; Raphael Eduardo,9999,0,9999,0
1746541262178,CSE 191,A00,958773,Minnes Kemp; Mor Mia,9996,0,9999,3
1746541263203,CSE 197,001,959846,Minnes Kemp; Mor Mia,9993,0,9999,6
1746541264232,CSS 201S,A01,892054,Mignozzetti; Umberto,26,0,30,4
1746541265260,CSS 202S,A01,892056,Mignozzetti; Umberto,26,0,30,4
1746541266288,DSC 197,001,956898,Eldridge; Justin Matthew,9998,0,9999,1
1746541267316,DSC 297,001,958000,Mazumdar; Arya,9998,0,9999,1
1746541267316,DSC 297,002,959862,Wang; Yusu,9999,0,9999,0
1746541268344,EAP 100,A00,905686,Staff,9778,0,9999,221
1746541269375,ECE 45,A01,892618,Staff,0,0,65,65
1746541271429,ECE 111,A01,892719,Staff,4,0,65,61
1746541272457,ECE 197,001,957920,Mercier; Patrick Philip,9991,0,9999,8
1746541273485,ECON 178,A01,907814,Zhu; Ying,26,0,35,9
1746541274511,EDS 115,A00,895312,Staff,36,0,45,9
1746541275539,EDS 117,A01,895337,Staff,24,0,30,6
1746541276564,EDS 125,A00,895341,Jones; Gabrielle Anastasia,37,0,45,8
1746541277591,EDS 128A,A01,895459,Fargason; Sharon Gayle,44,0,45,1
1746541278619,EDS 128B,A01,895543,Pappas; Elizabeth,44,0,45,1
1746541279645,EDS 139,A00,897203,Pappas; Elizabeth,44,0,45,1
1746541279645,EDS 139,B00,897209,Fargason; Sharon Gayle,41,0,45,4
1746541280669,EDS 201,A00,895545,Staff,23,0,45,22
1746541281694,EDS 203,A01,895581,Halter; Christopher P.,23,0,45,22
1746541282723,EDS 204R,A01,895625,Heinzman; Erica M.,39,0,45,6
1746541282723,EDS 204R,B01,895693,Halter; Christopher P.,10,0,45,35
1746541283752,EDS 206R,A00,895694,Fargason; Sharon Gayle,1,0,30,29
1746541283752,EDS 206R,B00,895695,Choi; Bailey Miyeon,16,0,30,14
1746541284778,EDS 250,A00,895697,Hemans; Patricia Ann Benitez,23,0,45,22
1746541285807,EDS 281,A00,895701,Meyerott; Theresa Ann,1,0,15,14
1746541286832,EDS 284,A00,895736,Meyerott; Theresa Ann,1,0,15,14
1746541287861,EDS 286,A00,897210,Fine; Sarah,0,0,15,15
1746541288888,EDS 289C,A01,895770,Daly; Alan J.,15,0,15,0
1746541289913,EDS 290,A00,897211,Hofstetter; Carolyn,0,0,15,15
1746541290939,LIGM 5A,A00,896162,Fischer-Grunski; Eva K,13,0,20,7
1746541291964,LIGM 5B,A00,896260,Fischer-Grunski; Eva K,17,0,20,3
1746541292992,LIGM 5C,A00,896308,Fischer-Grunski; Eva K,18,0,20,2
1746541294018,LIIT 5AS,A00,896313,Carnelos; Chiara,18,0,20,2
1746541295046,LIIT 5BS,A00,896416,Carnelos; Chiara,20,0,20,0
1746541296072,LIIT 5CS,A00,896564,Carnelos; Chiara,20,0,20,0
1746541297100,LISP 5A,A00,896588,Munoz Sanchez; Alicia,3,0,20,17
1746541298129,LISP 5B,A00,896653,Munoz Sanchez; Alicia,7,0,20,13
1746541299154,LISP 5C,A00,896655,Munoz Sanchez; Alicia,0,1,20,20
1746541300180,MAE 197,001,957918,Kleissl; Jan,9996,0,9999,3
1746541300180,MAE 197,002,959806,Boechler; Nicholas Sebastia,9998,0,9999,1
1746541300180,MAE 197,003,959852,Mullin; Jennifer S,9999,0,9999,0
1746541301210,MATH 2,A01,957937,Staff,33,0,35,2
1746541302234,MATH 197,001,957876,Kedlaya; Kiran S.,9993,0,9999,6
1746541303264,MCWP 40,A00,892729,Duru; Nur,10,0,20,10
1746541303264,MCWP 40,B00,893304,Montejo; Carolina,14,0,20,6
1746541304288,MCWP 40R,A00,893757,Redela; Pamela Morgan,0,5,20,20
1746541305316,MCWP 50,A00,893758,Morshed; Michael James,0,0,20,20
1746541305316,MCWP 50,B00,893761,Bartulis; Jason Michael,17,0,20,3
1746541306342,MCWP 50R,A00,893766,Compas; Sean Matthew,0,1,20,20
1746541306342,MCWP 50R,B00,893769,Carter; Jennifer A,0,1,20,20
1746541306342,MCWP 50R,C00,893771,Krone; Jarret,0,3,20,20
1746541306342,MCWP 50R,D00,893772,Miller; Elizabeth Deen,0,0,20,20
1746541306342,MCWP 50R,E00,893775,Carter; Andrea L,0,1,20,20
1746541307371,MMW 11R,A01,892721,Herbst; Matthew,11,0,27,16
1746541307371,MMW 11R,A02,892722,Herbst; Matthew,0,0,0,3
1746541308398,MMW 12R,A01,892724,Herbst; Matthew,0,11,16,16
1746541308398,MMW 12R,A02,892725,Herbst; Matthew,0,10,16,16
1746541309423,MMW 13R,A01,892727,Staff,0,4,16,16
1746541309423,MMW 13R,A02,892728,Staff,0,4,16,16
1746541309423,MMW 13R,A03,958032,Staff,0,4,16,16
1746541309423,MMW 13R,A04,958033,Staff,0,4,16,16
1746541309423,MMW 13R,A05,958034,Staff,0,4,16,16
1746541310449,SIO 295LS,A00,894015,Staff,5,0,25,20
1746541311477,SIO 295S,A00,894020,Staff,5,0,25,20
1746541312504,SIOC 290S,B01,958918,Merrifield; Mark A,14,0,30,16
1746541313531,SIOC 291S,B01,958922,Gabriel; Corey John,14,0,30,16
1746541314557,SOCI 117,A01,895339,Staff,3,0,5,2
1746541315584,WES 237B,A00,894149,Staff,11,0,20,9
1746541317644,AESE 279B,A00,891859,Staff,13,0,35,22
1746541318674,AIP 197,001,891854,Vespa; Emanuel Ignacio,9999,0,9999,0
1746541319699,ANTH 289S,A00,891856,Gagneux; Pascal,12,0,12,0
1746541320724,BENG 196,001,957946,Engler; Adam J.,9996,0,9999,3
1746541321752,BISP 197,001,959851,Wilhelm; James E.,9999,0,9999,0
1746541322781,CAT 124RS,A01,956906,Staff,6,0,25,19
1746541323807,CAT 125RS,A01,922013,Staff,6,0,25,19
1746541324832,CLRE 250,A00,891860,Morris; Sheldon,9995,0,9999,4
1746541326884,CLRE 251R,A00,907817,Mehta; Ravindra L.,9994,0,9999,5
1746541327913,CLRE 252,A00,891864,Cuomo; Raphael Eduardo,9993,0,9999,6
1746541328943,CLRE 253,A00,891867,Vaida; Florin,9994,0,9999,5
1746541328943,CLRE 253,B00,907819,Staff,9999,0,9999,0
1746541329975,CLRE 259,A00,891868,Patel; Hemal,9998,0,9999,1
1746541330998,CLRE 260,A00,891872,Cuomo; Raphael Eduardo,9999,0,9999,0
1746541332024,CLRE 297,001,891888,Cuomo; Raphael Eduardo,9999,0,9999,0
1746541333050,CSE 191,A00,958773,Minnes Kemp; Mor Mia,9996,0,9999,3
1746541334080,CSE 197,001,959846,Minnes Kemp; Mor Mia,9993,0,9999,6
1746541335105,CSS 201S,A01,892054,Mignozzetti; Umberto,26,0,30,4
1746541336131,CSS 202S,A01,892056,Mignozzetti; Umberto,26,0,30,4
1746541337161,DSC 197,001,956898,Eldridge; Justin Matthew,9998,0,9999,1
1746541338186,DSC 297,001,958000,Mazumdar; Arya,9998,0,9999,1
1746541338186,DSC 297,002,959862,Wang; Yusu,9999,0,9999,0
1746541339215,EAP 100,A00,905686,Staff,9778,0,9999,221
1746541340243,ECE 45,A01,892618,Staff,0,0,65,65
1746541342297,ECE 111,A01,892719,Staff,4,0,65,61
1746541343327,ECE 197,001,957920,Mercier; Patrick Philip,9991,0,9999,8
1746541344356,ECON 178,A01,907814,Zhu; Ying,26,0,35,9
1746541345381,EDS 115,A00,895312,Staff,36,0,45,9
1746541346408,EDS 117,A01,895337,Staff,24,0,30,6
1746541347435,EDS 125,A00,895341,Jones; Gabrielle Anastasia,37,0,45,8
1746541348466,EDS 128A,A01,895459,Fargason; Sharon Gayle,44,0,45,1
1746541349495,EDS 128B,A01,895543,Pappas; Elizabeth,44,0,45,1
1746541350523,EDS 139,A00,897203,Pappas; Elizabeth,44,0,45,1
1746541350523,EDS 139,B00,897209,Fargason; Sharon Gayle,41,0,45,4
1746541351549,EDS 201,A00,895545,Staff,23,0,45,22
1746541352575,EDS 203,A01,895581,Halter; Christopher P.,23,0,45,22
1746541353604,EDS 204R,A01,895625,Heinzman; Erica M.,39,0,45,6
1746541353604,EDS 204R,B01,895693,Halter; Christopher P.,10,0,45,35
1746541354629,EDS 206R,A00,895694,Fargason; Sharon Gayle,1,0,30,29
1746541354629,EDS 206R,B00,895695,Choi; Bailey Miyeon,16,0,30,14
1746541355672,EDS 250,A00,895697,Hemans; Patricia Ann Benitez,23,0,45,22
1746541356701,EDS 281,A00,895701,Meyerott; Theresa Ann,1,0,15,14
1746541357725,EDS 284,A00,895736,Meyerott; Theresa Ann,1,0,15,14
1746541358752,EDS 286,A00,897210,Fine; Sarah,0,0,15,15
1746541359778,EDS 289C,A01,895770,Daly; Alan J.,15,0,15,0
1746541360802,EDS 290,A00,897211,Hofstetter; Carolyn,0,0,15,15
1746541361827,LIGM 5A,A00,896162,Fischer-Grunski; Eva K,13,0,20,7
1746541362851,LIGM 5B,A00,896260,Fischer-Grunski; Eva K,17,0,20,3
1746541363876,LIGM 5C,A00,896308,Fischer-Grunski; Eva K,18,0,20,2
1746541364903,LIIT 5AS,A00,896313,Carnelos; Chiara,18,0,20,2
1746541365932,LIIT 5BS,A00,896416,Carnelos; Chiara,20,0,20,0
1746541366957,LIIT 5CS,A00,896564,Carnelos; Chiara,20,0,20,0
1746541367985,LISP 5A,A00,896588,Munoz Sanchez; Alicia,3,0,20,17
1746541369010,LISP 5B,A00,896653,Munoz Sanchez; Alicia,7,0,20,13
1746541370034,LISP 5C,A00,896655,Munoz Sanchez; Alicia,0,1,20,20
1746541371062,MAE 197,001,957918,Kleissl; Jan,9996,0,9999,3
1746541371062,MAE 197,002,959806,Boechler; Nicholas Sebastia,9998,0,9999,1
1746541371062,MAE 197,003,959852,Mullin; Jennifer S,9999,0,9999,0
1746541372086,MATH 2,A01,957937,Staff,33,0,35,2
1746541373135,MATH 197,001,957876,Kedlaya; Kiran S.,9993,0,9999,6
1746541374162,MCWP 40,A00,892729,Duru; Nur,10,0,20,10
1746541374162,MCWP 40,B00,893304,Montejo; Carolina,14,0,20,6
1746541375186,MCWP 40R,A00,893757,Redela; Pamela Morgan,0,5,20,20
1746541376214,MCWP 50,A00,893758,Morshed; Michael James,0,0,20,20
1746541376214,MCWP 50,B00,893761,Bartulis; Jason Michael,17,0,20,3
1746541377242,MCWP 50R,A00,893766,Compas; Sean Matthew,0,1,20,20
1746541377242,MCWP 50R,B00,893769,Carter; Jennifer A,0,1,20,20
1746541377242,MCWP 50R,C00,893771,Krone; Jarret,0,3,20,20
1746541377242,MCWP 50R,D00,893772,Miller; Elizabeth Deen,0,0,20,20
1746541377242,MCWP 50R,E00,893775,Carter; Andrea L,0,1,20,20
1746541378267,MMW 11R,A01,892721,Herbst; Matthew,11,0,27,16
1746541378267,MMW 11R,A02,892722,Herbst; Matthew,0,0,0,3
1746541379295,MMW 12R,A01,892724,Herbst; Matthew,0,11,16,16
1746541379295,MMW 12R,A02,892725,Herbst; Matthew,0,10,16,16
1746541380321,MMW 13R,A01,892727,Staff,0,4,16,16
1746541380321,MMW 13R,A02,892728,Staff,0,4,16,16
1746541380321,MMW 13R,A03,958032,Staff,0,4,16,16
1746541380321,MMW 13R,A04,958033,Staff,0,4,16,16
1746541380321,MMW 13R,A05,958034,Staff,0,4,16,16
1746541381350,SIO 295LS,A00,894015,Staff,5,0,25,20
1746541382378,SIO 295S,A00,894020,Staff,5,0,25,20
1746541383405,SIOC 290S,B01,958918,Merrifield; Mark A,14,0,30,16
1746541384431,SIOC 291S,B01,958922,Gabriel; Corey John,14,0,30,16
1746541385455,SOCI 117,A01,895339,Staff,3,0,5,2
1746541386480,WES 237B,A00,894149,Staff,11,0,20,9
1746541388547,AESE 279B,A00,891859,Staff,13,0,35,22
1746541389574,AIP 197,001,891854,Vespa; Emanuel Ignacio,9999,0,9999,0
1746541390599,ANTH 289S,A00,891856,Gagneux; Pascal,12,0,12,0
1746541391625,BENG 196,001,957946,Engler; Adam J.,9996,0,9999,3
1746541392648,BISP 197,001,959851,Wilhelm; James E.,9999,0,9999,0
1746541393677,CAT 124RS,A01,956906,Staff,6,0,25,19
1746541394702,CAT 125RS,A01,922013,Staff,6,0,25,19
1746541395729,CLRE 250,A00,891860,Morris; Sheldon,9995,0,9999,4
1746541397781,CLRE 251R,A00,907817,Mehta; Ravindra L.,9994,0,9999,5
1746541398806,CLRE 252,A00,891864,Cuomo; Raphael Eduardo,9993,0,9999,6
1746541399830,CLRE 253,A00,891867,Vaida; Florin,9994,0,9999,5
1746541399830,CLRE 253,B00,907819,Staff,9999,0,9999,0
1746541400858,CLRE 259,A00,891868,Patel; Hemal,9998,0,9999,1
1746541401881,CLRE 260,A00,891872,Cuomo; Raphael Eduardo,9999,0,9999,0
1746541402906,CLRE 297,001,891888,Cuomo; Raphael Eduardo,9999,0,9999,0
1746541403934,CSE 191,A00,958773,Minnes Kemp; Mor Mia,9996,0,9999,3
1746541404959,CSE 197,001,959846,Minnes Kemp; Mor Mia,9993,0,9999,6
1746541405986,CSS 201S,A01,892054,Mignozzetti; Umberto,26,0,30,4
1746541407015,CSS 202S,A01,892056,Mignozzetti; Umberto,26,0,30,4
1746541408040,DSC 197,001,956898,Eldridge; Justin Matthew,9998,0,9999,1
1746541409064,DSC 297,001,958000,Mazumdar; Arya,9998,0,9999,1
1746541409064,DSC 297,002,959862,Wang; Yusu,9999,0,9999,0
1746541410092,EAP 100,A00,905686,Staff,9778,0,9999,221
1746541411121,ECE 45,A01,892618,Staff,0,0,65,65
1746541413171,ECE 111,A01,892719,Staff,4,0,65,61
1746541414198,ECE 197,001,957920,Mercier; Patrick Philip,9991,0,9999,8
1746541415224,ECON 178,A01,907814,Zhu; Ying,26,0,35,9
1746541416248,EDS 115,A00,895312,Staff,36,0,45,9
1746541417273,EDS 117,A01,895337,Staff,24,0,30,6
1746541418300,EDS 125,A00,895341,Jones; Gabrielle Anastasia,37,0,45,8
1746541419324,EDS 128A,A01,895459,Fargason; Sharon Gayle,44,0,45,1
1746541420350,EDS 128B,A01,895543,Pappas; Elizabeth,44,0,45,1
1746541421378,EDS 139,A00,897203,Pappas; Elizabeth,44,0,45,1
1746541421378,EDS 139,B00,897209,Fargason; Sharon Gayle,41,0,45,4
1746541422406,EDS 201,A00,895545,Staff,23,0,45,22
1746541423434,EDS 203,A01,895581,Halter; Christopher P.,23,0,45,22
1746541424461,EDS 204R,A01,895625,Heinzman; Erica M.,39,0,45,6
1746541424461,EDS 204R,B01,895693,Halter; Christopher P.,10,0,45,35
1746541425491,EDS 206R,A00,895694,Fargason; Sharon Gayle,1,0,30,29
1746541425491,EDS 206R,B00,895695,Choi; Bailey Miyeon,16,0,30,14
1746541426518,EDS 250,A00,895697,Hemans; Patricia Ann Benitez,23,0,45,22
1746541427546,EDS 281,A00,895701,Meyerott; Theresa Ann,1,0,15,14
1746541428570,EDS 284,A00,895736,Meyerott; Theresa Ann,1,0,15,14
1746541429596,EDS 286,A00,897210,Fine; Sarah,0,0,15,15
1746541430624,EDS 289C,A01,895770,Daly; Alan J.,15,0,15,0
1746541431652,EDS 290,A00,897211,Hofstetter; Carolyn,0,0,15,15
1746541432678,LIGM 5A,A00,896162,Fischer-Grunski; Eva K,13,0,20,7
1746541433704,LIGM 5B,A00,896260,Fischer-Grunski; Eva K,17,0,20,3
1746541434730,LIGM 5C,A00,896308,Fischer-Grunski; Eva K,18,0,20,2
1746541435754,LIIT 5AS,A00,896313,Carnelos; Chiara,18,0,20,2
1746541436783,LIIT 5BS,A00,896416,Carnelos; Chiara,20,0,20,0
1746541437810,LIIT 5CS,A00,896564,Carnelos; Chiara,20,0,20,0
1746541438835,LISP 5A,A00,896588,Munoz Sanchez; Alicia,3,0,20,17
1746541439862,LISP 5B,A00,896653,Munoz Sanchez; Alicia,7,0,20,13
1746541440892,LISP 5C,A00,896655,Munoz Sanchez; Alicia,0,1,20,20
1746541441917,MAE 197,001,957918,Kleissl; Jan,9996,0,9999,3
1746541441917,MAE 197,002,959806,Boechler; Nicholas Sebastia,9998,0,9999,1
1746541441917,MAE 197,003,959852,Mullin; Jennifer S,9999,0,9999,0
1746541442945,MATH 2,A01,957937,Staff,33,0,35,2
1746541443969,MATH 197,001,957876,Kedlaya; Kiran S.,9993,0,9999,6
1746541444997,MCWP 40,A00,892729,Duru; Nur,10,0,20,10
1746541444997,MCWP 40,B00,893304,Montejo; Carolina,14,0,20,6
1746541446023,MCWP 40R,A00,893757,Redela; Pamela Morgan,0,5,20,20
1746541447104,MCWP 50,A00,893758,Morshed; Michael James,0,0,20,20
1746541447104,MCWP 50,B00,893761,Bartulis; Jason Michael,17,0,20,3
1746541448133,MCWP 50R,A00,893766,Compas; Sean Matthew,0,1,20,20
1746541448133,MCWP 50R,B00,893769,Carter; Jennifer A,0,1,20,20
1746541448133,MCWP 50R,C00,893771,Krone; Jarret,0,3,20,20
1746541448133,MCWP 50R,D00,893772,Miller; Elizabeth Deen,0,0,20,20
1746541448133,MCWP 50R,E00,893775,Carter; Andrea L,0,1,20,20
1746541449159,MMW 11R,A01,892721,Herbst; Matthew,11,0,27,16
1746541449159,MMW 11R,A02,892722,Herbst; Matthew,0,0,0,3
1746541450185,MMW 12R,A01,892724,Herbst; Matthew,0,11,16,16
1746541450185,MMW 12R,A02,892725,Herbst; Matthew,0,10,16,16
1746541451214,MMW 13R,A01,892727,Staff,0,4,16,16
1746541451214,MMW 13R,A02,892728,Staff,0,4,16,16
1746541451214,MMW 13R,A03,958032,Staff,0,4,16,16
1746541451214,MMW 13R,A04,958033,Staff,0,4,16,16
1746541451214,MMW 13R,A05,958034,Staff,0,4,16,16
1746541452239,SIO 295LS,A00,894015,Staff,5,0,25,20
1746541453264,SIO 295S,A00,894020,Staff,5,0,25,20
1746541454294,SIOC 290S,B01,958918,Merrifield; Mark A,14,0,30,16
1746541455320,SIOC 291S,B01,958922,Gabriel; Corey John,14,0,30,16
1746541456349,SOCI 117,A01,895339,Staff,3,0,5,2
1746541457376,WES 237B,A00,894149,Staff,11,0,20,9
1746541459438,AESE 279B,A00,891859,Staff,13,0,35,22
1746541460465,AIP 197,001,891854,Vespa; Emanuel Ignacio,9999,0,9999,0
1746541461495,ANTH 289S,A00,891856,Gagneux; Pascal,12,0,12,0
1746541462524,BENG 196,001,957946,Engler; Adam J.,9996,0,9999,3
1746541463552,BISP 197,001,959851,Wilhelm; James E.,9999,0,9999,0
1746541464578,CAT 124RS,A01,956906,Staff,6,0,25,19
1746541465604,CAT 125RS,A01,922013,Staff,6,0,25,19
1746541466629,CLRE 250,A00,891860,Morris; Sheldon,9995,0,9999,4
1746541468684,CLRE 251R,A00,907817,Mehta; Ravindra L.,9994,0,9999,5
1746541469710,CLRE 252,A00,891864,Cuomo; Raphael Eduardo,9993,0,9999,6
1746541470736,CLRE 253,A00,891867,Vaida; Florin,9994,0,9999,5
1746541470736,CLRE 253,B00,907819,Staff,9999,0,9999,0
1746541471760,CLRE 259,A00,891868,Patel; Hemal,9998,0,9999,1
1746541472786,CLRE 260,A00,891872,Cuomo; Raphael Eduardo,9999,0,9999,0
1746541473811,CLRE 297,001,891888,Cuomo; Raphael Eduardo,9999,0,9999,0
1746541474836,CSE 191,A00,958773,Minnes Kemp; Mor Mia,9996,0,9999,3
1746541475862,CSE 197,001,959846,Minnes Kemp; Mor Mia,9993,0,9999,6
1746541476890,CSS 201S,A01,892054,Mignozzetti; Umberto,26,0,30,4
1746541477920,CSS 202S,A01,892056,Mignozzetti; Umberto,26,0,30,4
1746541478948,DSC 197,001,956898,Eldridge; Justin Matthew,9998,0,9999,1
1746541479976,DSC 297,001,958000,Mazumdar; Arya,9998,0,9999,1
1746541479976,DSC 297,002,959862,Wang; Yusu,9999,0,9999,0
1746541481003,EAP 100,A00,905686,Staff,9778,0,9999,221
1746541482028,ECE 45,A01,892618,Staff,0,0,65,65
1746541484084,ECE 111,A01,892719,Staff,4,0,65,61
1746541485111,ECE 197,001,957920,Mercier; Patrick Philip,9991,0,9999,8
1746541486136,ECON 178,A01,907814,Zhu; Ying,26,0,35,9
1746541487162,EDS 115,A00,895312,Staff,36,0,45,9
1746541488192,EDS 117,A01,895337,Staff,24,0,30,6
1746541489215,EDS 125,A00,895341,Jones; Gabrielle Anastasia,37,0,45,8
1746541490240,EDS 128A,A01,895459,Fargason; Sharon Gayle,44,0,45,1
1746541491269,EDS 128B,A01,895543,Pappas; Elizabeth,44,0,45,1
1746541492295,EDS 139,A00,897203,Pappas; Elizabeth,44,0,45,1
1746541492295,EDS 139,B00,897209,Fargason; Sharon Gayle,41,0,45,4
1746541493325,EDS 201,A00,895545,Staff,23,0,45,22
1746541494353,EDS 203,A01,895581,Halter; Christopher P.,23,0,45,22
1746541495377,EDS 204R,A01,895625,Heinzman; Erica M.,39,0,45,6
1746541495377,EDS 204R,B01,895693,Halter; Christopher P.,10,0,45,35
1746541496405,EDS 206R,A00,895694,Fargason; Sharon Gayle,1,0,30,29
1746541496405,EDS 206R,B00,895695,Choi; Bailey Miyeon,16,0,30,14
1746541497431,EDS 250,A00,895697,Hemans; Patricia Ann Benitez,23,0,45,22
1746541498456,EDS 281,A00,895701,Meyerott; Theresa Ann,1,0,15,14
1746541499487,EDS 284,A00,895736,Meyerott; Theresa Ann,1,0,15,14
1746541500513,EDS 286,A00,897210,Fine; Sarah,0,0,15,15
1746541501543,EDS 289C,A01,895770,Daly; Alan J.,15,0,15,0
1746541502570,EDS 290,A00,897211,Hofstetter; Carolyn,0,0,15,15
1746541503598,LIGM 5A,A00,896162,Fischer-Grunski; Eva K,13,0,20,7
1746541504625,LIGM 5B,A00,896260,Fischer-Grunski; Eva K,17,0,20,3
1746541505653,LIGM 5C,A00,896308,Fischer-Grunski; Eva K,18,0,20,2
1746541506681,LIIT 5AS,A00,896313,Carnelos; Chiara,18,0,20,2
1746541507711,LIIT 5BS,A00,896416,Carnelos; Chiara,20,0,20,0
1746541508739,LIIT 5CS,A00,896564,Carnelos; Chiara,20,0,20,0
1746541509768,LISP 5A,A00,896588,Munoz Sanchez; Alicia,3,0,20,17
1746541510792,LISP 5B,A00,896653,Munoz Sanchez; Alicia,7,0,20,13
1746541511818,LISP 5C,A00,896655,Munoz Sanchez; Alicia,0,1,20,20
1746541512848,MAE 197,001,957918,Kleissl; Jan,9996,0,9999,3
1746541512848,MAE 197,002,959806,Boechler; Nicholas Sebastia,9998,0,9999,1
1746541512848,MAE 197,003,959852,Mullin; Jennifer S,9999,0,9999,0
1746541513875,MATH 2,A01,957937,Staff,33,0,35,2
1746541514906,MATH 197,001,957876,Kedlaya; Kiran S.,9993,0,9999,6
1746541515934,MCWP 40,A00,892729,Duru; Nur,10,0,20,10
1746541515934,MCWP 40,B00,893304,Montejo; Carolina,14,0,20,6
1746541516962,MCWP 40R,A00,893757,Redela; Pamela Morgan,0,5,20,20
1746541517996,MCWP 50,A00,893758,Morshed; Michael James,0,0,20,20
1746541517996,MCWP 50,B00,893761,Bartulis; Jason Michael,17,0,20,3
1746541519026,MCWP 50R,A00,893766,Compas; Sean Matthew,0,1,20,20
1746541519026,MCWP 50R,B00,893769,Carter; Jennifer A,0,1,20,20
1746541519026,MCWP 50R,C00,893771,Krone; Jarret,0,3,20,20
1746541519026,MCWP 50R,D00,893772,Miller; Elizabeth Deen,0,0,20,20
1746541519026,MCWP 50R,E00,893775,Carter; Andrea L,0,1,20,20
1746541520053,MMW 11R,A01,892721,Herbst; Matthew,11,0,27,16
1746541520053,MMW 11R,A02,892722,Herbst; Matthew,0,0,0,3
1746541521080,MMW 12R,A01,892724,Herbst; Matthew,0,11,16,16
1746541521080,MMW 12R,A02,892725,Herbst; Matthew,0,10,16,16
1746541522109,MMW 13R,A01,892727,Staff,0,4,16,16
1746541522109,MMW 13R,A02,892728,Staff,0,4,16,16
1746541522109,MMW 13R,A03,958032,Staff,0,4,16,16
1746541522109,MMW 13R,A04,958033,Staff,0,4,16,16
1746541522109,MMW 13R,A05,958034,Staff,0,4,16,16
1746541523141,SIO 295LS,A00,894015,Staff,5,0,25,20
1746541524171,SIO 295S,A00,894020,Staff,5,0,25,20
1746541525207,SIOC 290S,B01,958918,Merrifield; Mark A,14,0,30,16
1746541526240,SIOC 291S,B01,958922,Gabriel; Corey John,14,0,30,16
1746541527271,SOCI 117,A01,895339,Staff,3,0,5,2
1746541528300,WES 237B,A00,894149,Staff,11,0,20,9
1746541530393,AESE 279B,A00,891859,Staff,13,0,35,22
1746541531422,AIP 197,001,891854,Vespa; Emanuel Ignacio,9999,0,9999,0
1746541532450,ANTH 289S,A00,891856,Gagneux; Pascal,12,0,12,0
1746541533478,BENG 196,001,957946,Engler; Adam J.,9996,0,9999,3
1746541534507,BISP 197,001,959851,Wilhelm; James E.,9999,0,9999,0
1746541535538,CAT 124RS,A01,956906,Staff,6,0,25,19
1746541536566,CAT 125RS,A01,922013,Staff,6,0,25,19
1746541537593,CLRE 250,A00,891860,Morris; Sheldon,9995,0,9999,4
1746541539647,CLRE 251R,A00,907817,Mehta; Ravindra L.,9994,0,9999,5
1746541540673,CLRE 252,A00,891864,Cuomo; Raphael Eduardo,9993,0,9999,6
1746541541700,CLRE 253,A00,891867,Vaida; Florin,9994,0,9999,5
1746541541700,CLRE 253,B00,907819,Staff,9999,0,9999,0
1746541542731,CLRE 259,A00,891868,Patel; Hemal,9998,0,9999,1
1746541543757,CLRE 260,A00,891872,Cuomo; Raphael Eduardo,9999,0,9999,0
1746541544789,CLRE 297,001,891888,Cuomo; Raphael Eduardo,9999,0,9999,0
1746541545815,CSE 191,A00,958773,Minnes Kemp; Mor Mia,9996,0,9999,3
1746541546842,CSE 197,001,959846,Minnes Kemp; Mor Mia,9993,0,9999,6
1746541547874,CSS 201S,A01,892054,Mignozzetti; Umberto,26,0,30,4
1746541548909,CSS 202S,A01,892056,Mignozzetti; Umberto,26,0,30,4
1746541549935,DSC 197,001,956898,Eldridge; Justin Matthew,9998,0,9999,1
1746541550961,DSC 297,001,958000,Mazumdar; Arya,9998,0,9999,1
1746541550961,DSC 297,002,959862,Wang; Yusu,9999,0,9999,0
1746541551988,EAP 100,A00,905686,Staff,9778,0,9999,221
1746541553025,ECE 45,A01,892618,Staff,0,0,65,65
1746541555077,ECE 111,A01,892719,Staff,4,0,65,61
1746541556109,ECE 197,001,957920,Mercier; Patrick Philip,9991,0,9999,8
1746541557142,ECON 178,A01,907814,Zhu; Ying,26,0,35,9
1746541558172,EDS 115,A00,895312,Staff,36,0,45,9
1746541559200,EDS 117,A01,895337,Staff,24,0,30,6
1746541560226,EDS 125,A00,895341,Jones; Gabrielle Anastasia,37,0,45,8
1746541561253,EDS 128A,A01,895459,Fargason; Sharon Gayle,44,0,45,1
1746541562279,EDS 128B,A01,895543,Pappas; Elizabeth,44,0,45,1
1746541563311,EDS 139,A00,897203,Pappas; Elizabeth,44,0,45,1
1746541563311,EDS 139,B00,897209,Fargason; Sharon Gayle,41,0,45,4
1746541564340,EDS 201,A00,895545,Staff,23,0,45,22
1746541565369,EDS 203,A01,895581,Halter; Christopher P.,23,0,45,22
1746541566397,EDS 204R,A01,895625,Heinzman; Erica M.,39,0,45,6
1746541566397,EDS 204R,B01,895693,Halter; Christopher P.,10,0,45,35
1746541567421,EDS 206R,A00,895694,Fargason; Sharon Gayle,1,0,30,29
1746541567421,EDS 206R,B00,895695,Choi; Bailey Miyeon,16,0,30,14
1746541568451,EDS 250,A00,895697,Hemans; Patricia Ann Benitez,23,0,45,22
1746541569479,EDS 281,A00,895701,Meyerott; Theresa Ann,1,0,15,14
1746541570507,EDS 284,A00,895736,Meyerott; Theresa Ann,1,0,15,14
1746541571535,EDS 286,A00,897210,Fine; Sarah,0,0,15,15
1746541572562,EDS 289C,A01,895770,Daly; Alan J.,15,0,15,0
1746541573588,EDS 290,A00,897211,Hofstetter; Carolyn,0,0,15,15
1746541574622,LIGM 5A,A00,896162,Fischer-Grunski; Eva K,13,0,20,7
1746541575653,LIGM 5B,A00,896260,Fischer-Grunski; Eva K,17,0,20,3
1746541576679,LIGM 5C,A00,896308,Fischer-Grunski; Eva K,18,0,20,2
1746541577706,LIIT 5AS,A00,896313,Carnelos; Chiara,18,0,20,2
1746541578737,LIIT 5BS,A00,896416,Carnelos; Chiara,20,0,20,0
1746541579773,LIIT 5CS,A00,896564,Carnelos; Chiara,20,0,20,0
1746541580803,LISP 5A,A00,896588,Munoz Sanchez; Alicia,3,0,20,17
1746541581830,LISP 5B,A00,896653,Munoz Sanchez; Alicia,7,0,20,13
1746541582860,LISP 5C,A00,896655,Munoz Sanchez; Alicia,0,1,20,20
1746541583895,MAE 197,001,957918,Kleissl; Jan,9996,0,9999,3
1746541583895,MAE 197,002,959806,Boechler; Nicholas Sebastia,9998,0,9999,1
1746541583895,MAE 197,003,959852,Mullin; Jennifer S,9999,0,9999,0
1746541584924,MATH 2,A01,957937,Staff,33,0,35,2
1746541585950,MATH 197,001,957876,Kedlaya; Kiran S.,9993,0,9999,6
1746541586980,MCWP 40,A00,892729,Duru; Nur,10,0,20,10
1746541586980,MCWP 40,B00,893304,Montejo; Carolina,14,0,20,6
1746541588008,MCWP 40R,A00,893757,Redela; Pamela Morgan,0,5,20,20
1746541589037,MCWP 50,A00,893758,Morshed; Michael James,0,0,20,20
1746541589037,MCWP 50,B00,893761,Bartulis; Jason Michael,17,0,20,3
1746541590064,MCWP 50R,A00,893766,Compas; Sean Matthew,0,1,20,20
1746541590064,MCWP 50R,B00,893769,Carter; Jennifer A,0,1,20,20
1746541590064,MCWP 50R,C00,893771,Krone; Jarret,0,3,20,20
1746541590064,MCWP 50R,D00,893772,Miller; Elizabeth Deen,0,0,20,20
1746541590064,MCWP 50R,E00,893775,Carter; Andrea L,0,1,20,20
1746541591093,MMW 11R,A01,892721,Herbst; Matthew,11,0,27,16
1746541591093,MMW 11R,A02,892722,Herbst; Matthew,0,0,0,3
1746541592119,MMW 12R,A01,892724,Herbst; Matthew,0,11,16,16
1746541592119,MMW 12R,A02,892725,Herbst; Matthew,0,10,16,16
1746541593147,MMW 13R,A01,892727,Staff,0,4,16,16
1746541593147,MMW 13R,A02,892728,Staff,0,4,16,16
1746541593147,MMW 13R,A03,958032,Staff,0,4,16,16
1746541593147,MMW 13R,A04,958033,Staff,0,4,16,16
1746541593147,MMW 13R,A05,958034,Staff,0,4,16,16
1746541594174,SIO 295LS,A00,894015,Staff,5,0,25,20
1746541595199,SIO 295S,A00,894020,Staff,5,0,25,20
1746541596229,SIOC 290S,B01,958918,Merrifield; Mark A,14,0,30,16
1746541597260,SIOC 291S,B01,958922,Gabriel; Corey John,14,0,30,16
1746541598287,SOCI 117,A01,895339,Staff,3,0,5,2
1746541599316,WES 237B,A00,894149,Staff,11,0,20,9
1746541601402,AESE 279B,A00,891859,Staff,13,0,35,22
1746541602427,AIP 197,001,891854,Vespa; Emanuel Ignacio,9999,0,9999,0
1746541603454,ANTH 289S,A00,891856,Gagneux; Pascal,12,0,12,0
1746541604482,BENG 196,001,957946,Engler; Adam J.,9996,0,9999,3
1746541605511,BISP 197,001,959851,Wilhelm; James E.,9999,0,9999,0
1746541606540,CAT 124RS,A01,956906,Staff,6,0,25,19
1746541607569,CAT 125RS,A01,922013,Staff,6,0,25,19
1746541608598,CLRE 250,A00,891860,Morris; Sheldon,9995,0,9999,4
1746541610654,CLRE 251R,A00,907817,Mehta; Ravindra L.,9994,0,9999,5
1746541611682,CLRE 252,A00,891864,Cuomo; Raphael Eduardo,9993,0,9999,6
1746541612710,CLRE 253,A00,891867,Vaida; Florin,9994,0,9999,5
1746541612710,CLRE 253,B00,907819,Staff,9999,0,9999,0
1746541613742,CLRE 259,A00,891868,Patel; Hemal,9998,0,9999,1
1746541614772,CLRE 260,A00,891872,Cuomo; Raphael Eduardo,9999,0,9999,0
1746541615802,CLRE 297,001,891888,Cuomo; Raphael Eduardo,9999,0,9999,0
1746541616833,CSE 191,A00,958773,Minnes Kemp; Mor Mia,9996,0,9999,3
1746541617856,CSE 197,001,959846,Minnes Kemp; Mor Mia,9993,0,9999,6
1746541618886,CSS 201S,A01,892054,Mignozzetti; Umberto,26,0,30,4
1746541619913,CSS 202S,A01,892056,Mignozzetti; Umberto,26,0,30,4
1746541620941,DSC 197,001,956898,Eldridge; Justin Matthew,9998,0,9999,1
1746541621974,DSC 297,001,958000,Mazumdar; Arya,9998,0,9999,1
1746541621974,DSC 297,002,959862,Wang; Yusu,9999,0,9999,0
1746541622999,EAP 100,A00,905686,Staff,9778,0,9999,221
1746541624033,ECE 45,A01,892618,Staff,0,0,65,65
1746541626090,ECE 111,A01,892719,Staff,4,0,65,61
1746541627117,ECE 197,001,957920,Mercier; Patrick Philip,9991,0,9999,8
1746541628152,ECON 178,A01,907814,Zhu; Ying,26,0,35,9
1746541629178,EDS 115,A00,895312,Staff,36,0,45,9
1746541630202,EDS 117,A01,895337,Staff,24,0,30,6
1746541631229,EDS 125,A00,895341,Jones; Gabrielle Anastasia,37,0,45,8
1746541632257,EDS 128A,A01,895459,Fargason; Sharon Gayle,44,0,45,1
1746541633287,EDS 128B,A01,895543,Pappas; Elizabeth,44,0,45,1
1746541634320,EDS 139,A00,897203,Pappas; Elizabeth,44,0,45,1
1746541634320,EDS 139,B00,897209,Fargason; Sharon Gayle,41,0,45,4
1746541635346,EDS 201,A00,895545,Staff,23,0,45,22
1746541636374,EDS 203,A01,895581,Halter; Christopher P.,23,0,45,22
1746541637401,EDS 204R,A01,895625,Heinzman; Erica M.,39,0,45,6
1746541637401,EDS 204R,B01,895693,Halter; Christopher P.,10,0,45,35
1746541638435,EDS 206R,A00,895694,Fargason; Sharon Gayle,1,0,30,29
1746541638435,EDS 206R,B00,895695,Choi; Bailey Miyeon,16,0,30,14
1746541639462,EDS 250,A00,895697,Hemans; Patricia Ann Benitez,23,0,45,22
1746541640489,EDS 281,A00,895701,Meyerott; Theresa Ann,1,0,15,14
1746541641514,EDS 284,A00,895736,Meyerott; Theresa Ann,1,0,15,14
1746541642540,EDS 286,A00,897210,Fine; Sarah,0,0,15,15
1746541643569,EDS 289C,A01,895770,Daly; Alan J.,15,0,15,0
1746541644594,EDS 290,A00,897211,Hofstetter; Carolyn,0,0,15,15
1746541645627,LIGM 5A,A00,896162,Fischer-Grunski; Eva K,13,0,20,7
1746541646680,LIGM 5B,A00,896260,Fischer-Grunski; Eva K,17,0,20,3
1746541647707,LIGM 5C,A00,896308,Fischer-Grunski; Eva K,18,0,20,2
1746541648739,LIIT 5AS,A00,896313,Carnelos; Chiara,18,0,20,2
1746541649764,LIIT 5BS,A00,896416,Carnelos; Chiara,20,0,20,0
1746541650789,LIIT 5CS,A00,896564,Carnelos; Chiara,20,0,20,0
1746541651815,LISP 5A,A00,896588,Munoz Sanchez; Alicia,3,0,20,17
1746541652841,LISP 5B,A00,896653,Munoz Sanchez; Alicia,7,0,20,13
1746541653868,LISP 5C,A00,896655,Munoz Sanchez; Alicia,0,1,20,20
1746541654896,MAE 197,001,957918,Kleissl; Jan,9996,0,9999,3
1746541654896,MAE 197,002,959806,Boechler; Nicholas Sebastia,9998,0,9999,1
1746541654896,MAE 197,003,959852,Mullin; Jennifer S,9999,0,9999,0
1746541655922,MATH 2,A01,957937,Staff,33,0,35,2
1746541656948,MATH 197,001,957876,Kedlaya; Kiran S.,9993,0,9999,6
1746541657976,MCWP 40,A00,892729,Duru; Nur,10,0,20,10
1746541657976,MCWP 40,B00,893304,Montejo; Carolina,14,0,20,6
1746541659003,MCWP 40R,A00,893757,Redela; Pamela Morgan,0,5,20,20
1746541660030,MCWP 50,A00,893758,Morshed; Michael James,0,0,20,20
1746541660030,MCWP 50,B00,893761,Bartulis; Jason Michael,17,0,20,3
1746541661065,MCWP 50R,A00,893766,Compas; Sean Matthew,0,1,20,20
1746541661065,MCWP 50R,B00,893769,Carter; Jennifer A,0,1,20,20
1746541661065,MCWP 50R,C00,893771,Krone; Jarret,0,3,20,20
1746541661065,MCWP 50R,D00,893772,Miller; Elizabeth Deen,0,0,20,20
1746541661065,MCWP 50R,E00,893775,Carter; Andrea L,0,1,20,20
1746541662090,MMW 11R,A01,892721,Herbst; Matthew,11,0,27,16
1746541662090,MMW 11R,A02,892722,Herbst; Matthew,0,0,0,3
1746541663117,MMW 12R,A01,892724,Herbst; Matthew,0,11,16,16
1746541663117,MMW 12R,A02,892725,Herbst; Matthew,0,10,16,16
1746541664147,MMW 13R,A01,892727,Staff,0,4,16,16
1746541664147,MMW 13R,A02,892728,Staff,0,4,16,16
1746541664147,MMW 13R,A03,958032,Staff,0,4,16,16
1746541664147,MMW 13R,A04,958033,Staff,0,4,16,16
1746541664147,MMW 13R,A05,958034,Staff,0,4,16,16
1746541665175,SIO 295LS,A00,894015,Staff,5,0,25,20
1746541666223,SIO 295S,A00,894020,Staff,5,0,25,20
1746541667251,SIOC 290S,B01,958918,Merrifield; Mark A,14,0,30,16
1746541668277,SIOC 291S,B01,958922,Gabriel; Corey John,14,0,30,16
1746541669302,SOCI 117,A01,895339,Staff,3,0,5,2
1746541670326,WES 237B,A00,894149,Staff,11,0,20,9
1746541672404,AESE 279B,A00,891859,Staff,13,0,35,22
1746541673430,AIP 197,001,891854,Vespa; Emanuel Ignacio,9999,0,9999,0
1746541674456,ANTH 289S,A00,891856,Gagneux; Pascal,12,0,12,0
1746541675485,BENG 196,001,957946,Engler; Adam J.,9996,0,9999,3
1746541676512,BISP 197,001,959851,Wilhelm; James E.,9999,0,9999,0
1746541677539,CAT 124RS,A01,956906,Staff,6,0,25,19
1746541678564,CAT 125RS,A01,922013,Staff,6,0,25,19
1746541679591,CLRE 250,A00,891860,Morris; Sheldon,9995,0,9999,4
1746541681643,CLRE 251R,A00,907817,Mehta; Ravindra L.,9994,0,9999,5
1746541682668,CLRE 252,A00,891864,Cuomo; Raphael Eduardo,9993,0,9999,6
1746541683699,CLRE 253,A00,891867,Vaida; Florin,9994,0,9999,5
1746541683699,CLRE 253,B00,907819,Staff,9999,0,9999,0
1746541684728,CLRE 259,A00,891868,Patel; Hemal,9998,0,9999,1
1746541685754,CLRE 260,A00,891872,Cuomo; Raphael Eduardo,9999,0,9999,0
1746541686783,CLRE 297,001,891888,Cuomo; Raphael Eduardo,9999,0,9999,0
1746541687809,CSE 191,A00,958773,Minnes Kemp; Mor Mia,9996,0,9999,3
1746541688840,CSE 197,001,959846,Minnes Kemp; Mor Mia,9993,0,9999,6
1746541689872,CSS 201S,A01,892054,Mignozzetti; Umberto,26,0,30,4
1746541690902,CSS 202S,A01,892056,Mignozzetti; Umberto,26,0,30,4
1746541691933,DSC 197,001,956898,Eldridge; Justin Matthew,9998,0,9999,1
1746541692961,DSC 297,001,958000,Mazumdar; Arya,9998,0,9999,1
1746541692961,DSC 297,002,959862,Wang; Yusu,9999,0,9999,0
1746541693986,EAP 100,A00,905686,Staff,9778,0,9999,221
1746541695012,ECE 45,A01,892618,Staff,0,0,65,65
1746541697065,ECE 111,A01,892719,Staff,4,0,65,61
1746541698090,ECE 197,001,957920,Mercier; Patrick Philip,9991,0,9999,8
1746541699117,ECON 178,A01,907814,Zhu; Ying,26,0,35,9
1746541700143,EDS 115,A00,895312,Staff,36,0,45,9
1746541701168,EDS 117,A01,895337,Staff,24,0,30,6
1746541702193,EDS 125,A00,895341,Jones; Gabrielle Anastasia,37,0,45,8
1746541703220,EDS 128A,A01,895459,Fargason; Sharon Gayle,44,0,45,1
1746541704250,EDS 128B,A01,895543,Pappas; Elizabeth,44,0,45,1
1746541705275,EDS 139,A00,897203,Pappas; Elizabeth,44,0,45,1
1746541705275,EDS 139,B00,897209,Fargason; Sharon Gayle,41,0,45,4
1746541706299,EDS 201,A00,895545,Staff,23,0,45,22
1746541707324,EDS 203,A01,895581,Halter; Christopher P.,23,0,45,22
1746541708350,EDS 204R,A01,895625,Heinzman; Erica M.,39,0,45,6
1746541708350,EDS 204R,B01,895693,Halter; Christopher P.,10,0,45,35
1746541709375,EDS 206R,A00,895694,Fargason; Sharon Gayle,1,0,30,29
1746541709375,EDS 206R,B00,895695,Choi; Bailey Miyeon,16,0,30,14
1746541710401,EDS 250,A00,895697,Hemans; Patricia Ann Benitez,23,0,45,22
1746541711427,EDS 281,A00,895701,Meyerott; Theresa Ann,1,0,15,14
1746541712453,EDS 284,A00,895736,Meyerott; Theresa Ann,1,0,15,14
1746541713484,EDS 286,A00,897210,Fine; Sarah,0,0,15,15
1746541714539,EDS 289C,A01,895770,Daly; Alan J.,15,0,15,0
1746541715566,EDS 290,A00,897211,Hofstetter; Carolyn,0,0,15,15
1746541716597,LIGM 5A,A00,896162,Fischer-Grunski; Eva K,13,0,20,7
1746541717623,LIGM 5B,A00,896260,Fischer-Grunski; Eva K,17,0,20,3
1746541718650,LIGM 5C,A00,896308,Fischer-Grunski; Eva K,18,0,20,2
1746541719679,LIIT 5AS,A00,896313,Carnelos; Chiara,18,0,20,2
1746541720705,LIIT 5BS,A00,896416,Carnelos; Chiara,20,0,20,0
1746541721732,LIIT 5CS,A00,896564,Carnelos; Chiara,20,0,20,0
1746541722762,LISP 5A,A00,896588,Munoz Sanchez; Alicia,3,0,20,17
1746541723791,LISP 5B,A00,896653,Munoz Sanchez; Alicia,7,0,20,13
1746541724821,LISP 5C,A00,896655,Munoz Sanchez; Alicia,0,1,20,20
1746541725856,MAE 197,001,957918,Kleissl; Jan,9996,0,9999,3
1746541725856,MAE 197,002,959806,Boechler; Nicholas Sebastia,9998,0,9999,1
1746541725856,MAE 197,003,959852,Mullin; Jennifer S,9999,0,9999,0
1746541726886,MATH 2,A01,957937,Staff,33,0,35,2
1746541727913,MATH 197,001,957876,Kedlaya; Kiran S.,9993,0,9999,6
1746541728942,MCWP 40,A00,892729,Duru; Nur,10,0,20,10
1746541728942,MCWP 40,B00,893304,Montejo; Carolina,14,0,20,6
1746541729975,MCWP 40R,A00,893757,Redela; Pamela Morgan,0,5,20,20
1746541731012,MCWP 50,A00,893758,Morshed; Michael James,0,0,20,20
1746541731012,MCWP 50,B00,893761,Bartulis; Jason Michael,17,0,20,3
1746541732041,MCWP 50R,A00,893766,Compas; Sean Matthew,0,1,20,20
1746541732041,MCWP 50R,B00,893769,Carter; Jennifer A,0,1,20,20
1746541732041,MCWP 50R,C00,893771,Krone; Jarret,0,3,20,20
1746541732041,MCWP 50R,D00,893772,Miller; Elizabeth Deen,0,0,20,20
1746541732041,MCWP 50R,E00,893775,Carter; Andrea L,0,1,20,20
1746541733069,MMW 11R,A01,892721,Herbst; Matthew,11,0,27,16
1746541733069,MMW 11R,A02,892722,Herbst; Matthew,0,0,0,3
1746541734095,MMW 12R,A01,892724,Herbst; Matthew,0,11,16,16
1746541734095,MMW 12R,A02,892725,Herbst; Matthew,0,10,16,16
1746541735124,MMW 13R,A01,892727,Staff,0,4,16,16
1746541735124,MMW 13R,A02,892728,Staff,0,4,16,16
1746541735124,MMW 13R,A03,958032,Staff,0,4,16,16
1746541735124,MMW 13R,A04,958033,Staff,0,4,16,16
1746541735124,MMW 13R,A05,958034,Staff,0,4,16,16
1746541736155,SIO 295LS,A00,894015,Staff,5,0,25,20
1746541737181,SIO 295S,A00,894020,Staff,5,0,25,20
1746541738209,SIOC 290S,B01,958918,Merrifield; Mark A,14,0,30,16
1746541739236,SIOC 291S,B01,958922,Gabriel; Corey John,14,0,30,16
1746541740261,SOCI 117,A01,895339,Staff,3,0,5,2
1746541741286,WES 237B,A00,894149,Staff,11,0,20,9
1746541743376,AESE 279B,A00,891859,Staff,13,0,35,22
1746541744401,AIP 197,001,891854,Vespa; Emanuel Ignacio,9999,0,9999,0
1746541745429,ANTH 289S,A00,891856,Gagneux; Pascal,12,0,12,0
1746541746454,BENG 196,001,957946,Engler; Adam J.,9996,0,9999,3
1746541747482,BISP 197,001,959851,Wilhelm; James E.,9999,0,9999,0
1746541748509,CAT 124RS,A01,956906,Staff,6,0,25,19
1746541749539,CAT 125RS,A01,922013,Staff,6,0,25,19
1746541750564,CLRE 250,A00,891860,Morris; Sheldon,9995,0,9999,4
1746541752617,CLRE 251R,A00,907817,Mehta; Ravindra L.,9994,0,9999,5
1746541753643,CLRE 252,A00,891864,Cuomo; Raphael Eduardo,9993,0,9999,6
1746541754670,CLRE 253,A00,891867,Vaida; Florin,9994,0,9999,5
1746541754670,CLRE 253,B00,907819,Staff,9999,0,9999,0
1746541755694,CLRE 259,A00,891868,Patel; Hemal,9998,0,9999,1
1746541756720,CLRE 260,A00,891872,Cuomo; Raphael Eduardo,9999,0,9999,0
1746541757747,CLRE 297,001,891888,Cuomo; Raphael Eduardo,9999,0,9999,0
1746541758773,CSE 191,A00,958773,Minnes Kemp; Mor Mia,9996,0,9999,3
1746541759804,CSE 197,001,959846,Minnes Kemp; Mor Mia,9993,0,9999,6
1746541760831,CSS 201S,A01,892054,Mignozzetti; Umberto,26,0,30,4
1746541761858,CSS 202S,A01,892056,Mignozzetti; Umberto,26,0,30,4
1746541762889,DSC 197,001,956898,Eldridge; Justin Matthew,9998,0,9999,1
1746541763915,DSC 297,001,958000,Mazumdar; Arya,9998,0,9999,1
1746541763915,DSC 297,002,959862,Wang; Yusu,9999,0,9999,0
1746541764941,EAP 100,A00,905686,Staff,9778,0,9999,221
1746541765969,ECE 45,A01,892618,Staff,0,0,65,65
1746541768024,ECE 111,A01,892719,Staff,4,0,65,61
1746541769050,ECE 197,001,957920,Mercier; Patrick Philip,9991,0,9999,8
1746541770078,ECON 178,A01,907814,Zhu; Ying,26,0,35,9
1746541771104,EDS 115,A00,895312,Staff,36,0,45,9
1746541772130,EDS 117,A01,895337,Staff,24,0,30,6
1746541773156,EDS 125,A00,895341,Jones; Gabrielle Anastasia,37,0,45,8
1746541774184,EDS 128A,A01,895459,Fargason; Sharon Gayle,44,0,45,1
1746541775208,EDS 128B,A01,895543,Pappas; Elizabeth,44,0,45,1
1746541776242,EDS 139,A00,897203,Pappas; Elizabeth,44,0,45,1
1746541776242,EDS 139,B00,897209,Fargason; Sharon Gayle,41,0,45,4
1746541777267,EDS 201,A00,895545,Staff,23,0,45,22
1746541778292,EDS 203,A01,895581,Halter; Christopher P.,23,0,45,22
1746541779323,EDS 204R,A01,895625,Heinzman; Erica M.,39,0,45,6
1746541779323,EDS 204R,B01,895693,Halter; Christopher P.,10,0,45,35
1746541780348,EDS 206R,A00,895694,Fargason; Sharon Gayle,1,0,30,29
1746541780348,EDS 206R,B00,895695,Choi; Bailey Miyeon,16,0,30,14
1746541781374,EDS 250,A00,895697,Hemans; Patricia Ann Benitez,23,0,45,22
1746541782406,EDS 281,A00,895701,Meyerott; Theresa Ann,1,0,15,14
1746541783430,EDS 284,A00,895736,Meyerott; Theresa Ann,1,0,15,14
1746541784455,EDS 286,A00,897210,Fine; Sarah,0,0,15,15
1746541785481,EDS 289C,A01,895770,Daly; Alan J.,15,0,15,0
1746541786511,EDS 290,A00,897211,Hofstetter; Carolyn,0,0,15,15
1746541787539,LIGM 5A,A00,896162,Fischer-Grunski; Eva K,13,0,20,7
1746541788566,LIGM 5B,A00,896260,Fischer-Grunski; Eva K,17,0,20,3
1746541789593,LIGM 5C,A00,896308,Fischer-Grunski; Eva K,18,0,20,2
1746541790621,LIIT 5AS,A00,896313,Carnelos; Chiara,18,0,20,2
1746541791648,LIIT 5BS,A00,896416,Carnelos; Chiara,20,0,20,0
1746541792676,LIIT 5CS,A00,896564,Carnelos; Chiara,20,0,20,0
1746541793701,LISP 5A,A00,896588,Munoz Sanchez; Alicia,3,0,20,17
1746541794729,LISP 5B,A00,896653,Munoz Sanchez; Alicia,7,0,20,13
1746541795764,LISP 5C,A00,896655,Munoz Sanchez; Alicia,0,1,20,20
1746541796793,MAE 197,001,957918,Kleissl; Jan,9996,0,9999,3
1746541796793,MAE 197,002,959806,Boechler; Nicholas Sebastia,9998,0,9999,1
1746541796793,MAE 197,003,959852,Mullin; Jennifer S,9999,0,9999,0
1746541797821,MATH 2,A01,957937,Staff,33,0,35,2
1746541798851,MATH 197,001,957876,Kedlaya; Kiran S.,9993,0,9999,6
1746541799881,MCWP 40,A00,892729,Duru; Nur,10,0,20,10
1746541799881,MCWP 40,B00,893304,Montejo; Carolina,14,0,20,6
1746541800907,MCWP 40R,A00,893757,Redela; Pamela Morgan,0,5,20,20
1746541801934,MCWP 50,A00,893758,Morshed; Michael James,0,0,20,20
1746541801934,MCWP 50,B00,893761,Bartulis; Jason Michael,17,0,20,3
1746541802962,MCWP 50R,A00,893766,Compas; Sean Matthew,0,1,20,20
1746541802962,MCWP 50R,B00,893769,Carter; Jennifer A,0,1,20,20
1746541802962,MCWP 50R,C00,893771,Krone; Jarret,0,3,20,20
1746541802962,MCWP 50R,D00,893772,Miller; Elizabeth Deen,0,0,20,20
1746541802962,MCWP 50R,E00,893775,Carter; Andrea L,0,1,20,20
1746541803993,MMW 11R,A01,892721,Herbst; Matthew,11,0,27,16
1746541803993,MMW 11R,A02,892722,Herbst; Matthew,0,0,0,3
1746541805018,MMW 12R,A01,892724,Herbst; Matthew,0,11,16,16
1746541805018,MMW 12R,A02,892725,Herbst; Matthew,0,10,16,16
1746541806055,MMW 13R,A01,892727,Staff,0,4,16,16
1746541806055,MMW 13R,A02,892728,Staff,0,4,16,16
1746541806055,MMW 13R,A03,958032,Staff,0,4,16,16
1746541806055,MMW 13R,A04,958033,Staff,0,4,16,16
1746541806055,MMW 13R,A05,958034,Staff,0,4,16,16
1746541807085,SIO 295LS,A00,894015,Staff,5,0,25,20
1746541808116,SIO 295S,A00,894020,Staff,5,0,25,20
1746541809157,SIOC 290S,B01,958918,Merrifield; Mark A,14,0,30,16
1746541810189,SIOC 291S,B01,958922,Gabriel; Corey John,14,0,30,16
1746541811227,SOCI 117,A01,895339,Staff,3,0,5,2
1746541812261,WES 237B,A00,894149,Staff,11,0,20,9
1746541814353,AESE 279B,A00,891859,Staff,13,0,35,22
1746541815381,AIP 197,001,891854,Vespa; Emanuel Ignacio,9999,0,9999,0
1746541816409,ANTH 289S,A00,891856,Gagneux; Pascal,12,0,12,0
1746541817443,BENG 196,001,957946,Engler; Adam J.,9996,0,9999,3
1746541818470,BISP 197,001,959851,Wilhelm; James E.,9999,0,9999,0
1746541819501,CAT 124RS,A01,956906,Staff,6,0,25,19
1746541820530,CAT 125RS,A01,922013,Staff,6,0,25,19
1746541821556,CLRE 250,A00,891860,Morris; Sheldon,9995,0,9999,4
1746541823610,CLRE 251R,A00,907817,Mehta; Ravindra L.,9994,0,9999,5
1746541824638,CLRE 252,A00,891864,Cuomo; Raphael Eduardo,9993,0,9999,6
1746541825665,CLRE 253,A00,891867,Vaida; Florin,9994,0,9999,5
1746541825665,CLRE 253,B00,907819,Staff,9999,0,9999,0
1746541826692,CLRE 259,A00,891868,Patel; Hemal,9998,0,9999,1
1746541827722,CLRE 260,A00,891872,Cuomo; Raphael Eduardo,9999,0,9999,0
1746541828749,CLRE 297,001,891888,Cuomo; Raphael Eduardo,9999,0,9999,0
1746541829786,CSE 191,A00,958773,Minnes Kemp; Mor Mia,9996,0,9999,3
1746541830812,CSE 197,001,959846,Minnes Kemp; Mor Mia,9993,0,9999,6
1746541831841,CSS 201S,A01,892054,Mignozzetti; Umberto,26,0,30,4
1746541832868,CSS 202S,A01,892056,Mignozzetti; Umberto,26,0,30,4
1746541833893,DSC 197,001,956898,Eldridge; Justin Matthew,9998,0,9999,1
1746541834927,DSC 297,001,958000,Mazumdar; Arya,9998,0,9999,1
1746541834927,DSC 297,002,959862,Wang; Yusu,9999,0,9999,0
1746541835956,EAP 100,A00,905686,Staff,9778,0,9999,221
1746541836991,ECE 45,A01,892618,Staff,0,0,65,65
1746541839045,ECE 111,A01,892719,Staff,4,0,65,61
1746541840072,ECE 197,001,957920,Mercier; Patrick Philip,9991,0,9999,8
1746541841105,ECON 178,A01,907814,Zhu; Ying,26,0,35,9
1746541842133,EDS 115,A00,895312,Staff,36,0,45,9
1746541843159,EDS 117,A01,895337,Staff,24,0,30,6
1746541844191,EDS 125,A00,895341,Jones; Gabrielle Anastasia,37,0,45,8
1746541845225,EDS 128A,A01,895459,Fargason; Sharon Gayle,44,0,45,1
1746541846256,EDS 128B,A01,895543,Pappas; Elizabeth,44,0,45,1
1746541847285,EDS 139,A00,897203,Pappas; Elizabeth,44,0,45,1
1746541847285,EDS 139,B00,897209,Fargason; Sharon Gayle,41,0,45,4
1746541848311,EDS 201,A00,895545,Staff,23,0,45,22
1746541849336,EDS 203,A01,895581,Halter; Christopher P.,23,0,45,22
1746541850363,EDS 204R,A01,895625,Heinzman; Erica M.,39,0,45,6
1746541850363,EDS 204R,B01,895693,Halter; Christopher P.,10,0,45,35
1746541851390,EDS 206R,A00,895694,Fargason; Sharon Gayle,1,0,30,29
1746541851390,EDS 206R,B00,895695,Choi; Bailey Miyeon,16,0,30,14
1746541852417,EDS 250,A00,895697,Hemans; Patricia Ann Benitez,23,0,45,22
1746541853443,EDS 281,A00,895701,Meyerott; Theresa Ann,1,0,15,14
1746541854474,EDS 284,A00,895736,Meyerott; Theresa Ann,1,0,15,14
1746541855507,EDS 286,A00,897210,Fine; Sarah,0,0,15,15
1746541856536,EDS 289C,A01,895770,Daly; Alan J.,15,0,15,0
1746541857563,EDS 290,A00,897211,Hofstetter; Carolyn,0,0,15,15
1746541858599,LIGM 5A,A00,896162,Fischer-Grunski; Eva K,13,0,20,7
1746541859654,LIGM 5B,A00,896260,Fischer-Grunski; Eva K,17,0,20,3
1746541860685,LIGM 5C,A00,896308,Fischer-Grunski; Eva K,18,0,20,2
1746541861716,LIIT 5AS,A00,896313,Carnelos; Chiara,18,0,20,2
1746541862740,LIIT 5BS,A00,896416,Carnelos; Chiara,20,0,20,0
1746541863780,LIIT 5CS,A00,896564,Carnelos; Chiara,20,0,20,0
1746541864813,LISP 5A,A00,896588,Munoz Sanchez; Alicia,3,0,20,17
1746541865846,LISP 5B,A00,896653,Munoz Sanchez; Alicia,7,0,20,13
1746541866877,LISP 5C,A00,896655,Munoz Sanchez; Alicia,0,1,20,20
1746541867931,MAE 197,001,957918,Kleissl; Jan,9996,0,9999,3
1746541867931,MAE 197,002,959806,Boechler; Nicholas Sebastia,9998,0,9999,1
1746541867931,MAE 197,003,959852,Mullin; Jennifer S,9999,0,9999,0
1746541868958,MATH 2,A01,957937,Staff,33,0,35,2
1746541869987,MATH 197,001,957876,Kedlaya; Kiran S.,9993,0,9999,6
1746541871020,MCWP 40,A00,892729,Duru; Nur,10,0,20,10
1746541871020,MCWP 40,B00,893304,Montejo; Carolina,14,0,20,6
1746541872054,MCWP 40R,A00,893757,Redela; Pamela Morgan,0,5,20,20
1746541873084,MCWP 50,A00,893758,Morshed; Michael James,0,0,20,20
1746541873084,MCWP 50,B00,893761,Bartulis; Jason Michael,17,0,20,3
1746541874114,MCWP 50R,A00,893766,Compas; Sean Matthew,0,1,20,20
1746541874114,MCWP 50R,B00,893769,Carter; Jennifer A,0,1,20,20
1746541874114,MCWP 50R,C00,893771,Krone; Jarret,0,3,20,20
1746541874114,MCWP 50R,D00,893772,Miller; Elizabeth Deen,0,0,20,20
1746541874114,MCWP 50R,E00,893775,Carter; Andrea L,0,1,20,20
1746541875140,MMW 11R,A01,892721,Herbst; Matthew,11,0,27,16
1746541875140,MMW 11R,A02,892722,Herbst; Matthew,0,0,0,3
1746541876167,MMW 12R,A01,892724,Herbst; Matthew,0,11,16,16
1746541876167,MMW 12R,A02,892725,Herbst; Matthew,0,10,16,16
1746541877194,MMW 13R,A01,892727,Staff,0,4,16,16
1746541877194,MMW 13R,A02,892728,Staff,0,4,16,16
1746541877194,MMW 13R,A03,958032,Staff,0,4,16,16
1746541877194,MMW 13R,A04,958033,Staff,0,4,16,16
1746541877194,MMW 13R,A05,958034,Staff,0,4,16,16
1746541878220,SIO 295LS,A00,894015,Staff,5,0,25,20
1746541879246,SIO 295S,A00,894020,Staff,5,0,25,20
1746541880282,SIOC 290S,B01,958918,Merrifield; Mark A,14,0,30,16
1746541881311,SIOC 291S,B01,958922,Gabriel; Corey John,14,0,30,16
1746541882338,SOCI 117,A01,895339,Staff,3,0,5,2
1746541883365,WES 237B,A00,894149,Staff,11,0,20,9
1746541885457,AESE 279B,A00,891859,Staff,13,0,35,22
1746541886484,AIP 197,001,891854,Vespa; Emanuel Ignacio,9999,0,9999,0
1746541887511,ANTH 289S,A00,891856,Gagneux; Pascal,12,0,12,0
1746541888538,BENG 196,001,957946,Engler; Adam J.,9996,0,9999,3
1746541889568,BISP 197,001,959851,Wilhelm; James E.,9999,0,9999,0
1746541890595,CAT 124RS,A01,956906,Staff,6,0,25,19
1746541891625,CAT 125RS,A01,922013,Staff,6,0,25,19
1746541892653,CLRE 250,A00,891860,Morris; Sheldon,9995,0,9999,4
1746541894710,CLRE 251R,A00,907817,Mehta; Ravindra L.,9994,0,9999,5
1746541895744,CLRE 252,A00,891864,Cuomo; Raphael Eduardo,9993,0,9999,6
1746541896773,CLRE 253,A00,891867,Vaida; Florin,9994,0,9999,5
1746541896773,CLRE 253,B00,907819,Staff,9999,0,9999,0
1746541897802,CLRE 259,A00,891868,Patel; Hemal,9998,0,9999,1
1746541898829,CLRE 260,A00,891872,Cuomo; Raphael Eduardo,9999,0,9999,0
1746541899859,CLRE 297,001,891888,Cuomo; Raphael Eduardo,9999,0,9999,0
1746541900886,CSE 191,A00,958773,Minnes Kemp; Mor Mia,9996,0,9999,3
1746541901915,CSE 197,001,959846,Minnes Kemp; Mor Mia,9993,0,9999,6
1746541902943,CSS 201S,A01,892054,Mignozzetti; Umberto,26,0,30,4
1746541903969,CSS 202S,A01,892056,Mignozzetti; Umberto,26,0,30,4
1746541905008,DSC 197,001,956898,Eldridge; Justin Matthew,9998,0,9999,1
1746541906038,DSC 297,001,958000,Mazumdar; Arya,9998,0,9999,1
1746541906038,DSC 297,002,959862,Wang; Yusu,9999,0,9999,0
1746541907067,EAP 100,A00,905686,Staff,9778,0,9999,221
1746541908094,ECE 45,A01,892618,Staff,0,0,65,65
1746541910149,ECE 111,A01,892719,Staff,4,0,65,61
1746541911179,ECE 197,001,957920,Mercier; Patrick Philip,9991,0,9999,8
1746541912204,ECON 178,A01,907814,Zhu; Ying,26,0,35,9
1746541913228,EDS 115,A00,895312,Staff,36,0,45,9
1746541914256,EDS 117,A01,895337,Staff,24,0,30,6
1746541915289,EDS 125,A00,895341,Jones; Gabrielle Anastasia,37,0,45,8
1746541916314,EDS 128A,A01,895459,Fargason; Sharon Gayle,44,0,45,1
1746541917343,EDS 128B,A01,895543,Pappas; Elizabeth,44,0,45,1
1746541918378,EDS 139,A00,897203,Pappas; Elizabeth,44,0,45,1
1746541918378,EDS 139,B00,897209,Fargason; Sharon Gayle,41,0,45,4
1746541919403,EDS 201,A00,895545,Staff,23,0,45,22
1746541920429,EDS 203,A01,895581,Halter; Christopher P.,23,0,45,22
1746541921460,EDS 204R,A01,895625,Heinzman; Erica M.,39,0,45,6
1746541921460,EDS 204R,B01,895693,Halter; Christopher P.,10,0,45,35
1746541922490,EDS 206R,A00,895694,Fargason; Sharon Gayle,1,0,30,29
1746541922490,EDS 206R,B00,895695,Choi; Bailey Miyeon,16,0,30,14
1746541923517,EDS 250,A00,895697,Hemans; Patricia Ann Benitez,23,0,45,22
1746541924543,EDS 281,A00,895701,Meyerott; Theresa Ann,1,0,15,14
1746541925567,EDS 284,A00,895736,Meyerott; Theresa Ann,1,0,15,14
1746541926596,EDS 286,A00,897210,Fine; Sarah,0,0,15,15
1746541927621,EDS 289C,A01,895770,Daly; Alan J.,15,0,15,0
1746541928647,EDS 290,A00,897211,Hofstetter; Carolyn,0,0,15,15
1746541929672,LIGM 5A,A00,896162,Fischer-Grunski; Eva K,13,0,20,7
1746541930702,LIGM 5B,A00,896260,Fischer-Grunski; Eva K,17,0,20,3
1746541931732,LIGM 5C,A00,896308,Fischer-Grunski; Eva K,18,0,20,2
1746541932757,LIIT 5AS,A00,896313,Carnelos; Chiara,18,0,20,2
1746541933787,LIIT 5BS,A00,896416,Carnelos; Chiara,20,0,20,0
1746541934817,LIIT 5CS,A00,896564,Carnelos; Chiara,20,0,20,0
1746541935843,LISP 5A,A00,896588,Munoz Sanchez; Alicia,3,0,20,17
1746541936869,LISP 5B,A00,896653,Munoz Sanchez; Alicia,7,0,20,13
1746541937896,LISP 5C,A00,896655,Munoz Sanchez; Alicia,0,1,20,20
1746541938922,MAE 197,001,957918,Kleissl; Jan,9996,0,9999,3
1746541938922,MAE 197,002,959806,Boechler; Nicholas Sebastia,9998,0,9999,1
1746541938922,MAE 197,003,959852,Mullin; Jennifer S,9999,0,9999,0
1746541939950,MATH 2,A01,957937,Staff,33,0,35,2
1746541940977,MATH 197,001,957876,Kedlaya; Kiran S.,9993,0,9999,6
1746541942011,MCWP 40,A00,892729,Duru; Nur,10,0,20,10
1746541942011,MCWP 40,B00,893304,Montejo; Carolina,14,0,20,6
1746541943039,MCWP 40R,A00,893757,Redela; Pamela Morgan,0,5,20,20
1746541944064,MCWP 50,A00,893758,Morshed; Michael James,0,0,20,20
1746541944064,MCWP 50,B00,893761,Bartulis; Jason Michael,17,0,20,3
1746541945094,MCWP 50R,A00,893766,Compas; Sean Matthew,0,1,20,20
1746541945094,MCWP 50R,B00,893769,Carter; Jennifer A,0,1,20,20
1746541945094,MCWP 50R,C00,893771,Krone; Jarret,0,3,20,20
1746541945094,MCWP 50R,D00,893772,Miller; Elizabeth Deen,0,0,20,20
1746541945094,MCWP 50R,E00,893775,Carter; Andrea L,0,1,20,20
1746541946122,MMW 11R,A01,892721,Herbst; Matthew,11,0,27,16
1746541946122,MMW 11R,A02,892722,Herbst; Matthew,0,0,0,3
1746541947149,MMW 12R,A01,892724,Herbst; Matthew,0,11,16,16
1746541947149,MMW 12R,A02,892725,Herbst; Matthew,0,10,16,16
1746541948175,MMW 13R,A01,892727,Staff,0,4,16,16
1746541948175,MMW 13R,A02,892728,Staff,0,4,16,16
1746541948175,MMW 13R,A03,958032,Staff,0,4,16,16
1746541948175,MMW 13R,A04,958033,Staff,0,4,16,16
1746541948175,MMW 13R,A05,958034,Staff,0,4,16,16
1746541949204,SIO 295LS,A00,894015,Staff,5,0,25,20
1746541950228,SIO 295S,A00,894020,Staff,5,0,25,20
1746541951252,SIOC 290S,B01,958918,Merrifield; Mark A,14,0,30,16
1746541952278,SIOC 291S,B01,958922,Gabriel; Corey John,14,0,30,16
1746541953307,SOCI 117,A01,895339,Staff,3,0,5,2
1746541954330,WES 237B,A00,894149,Staff,11,0,20,9
1746541956415,AESE 279B,A00,891859,Staff,13,0,35,22
1746541957439,AIP 197,001,891854,Vespa; Emanuel Ignacio,9999,0,9999,0
1746541958468,ANTH 289S,A00,891856,Gagneux; Pascal,12,0,12,0
1746541959495,BENG 196,001,957946,Engler; Adam J.,9996,0,9999,3
1746541960520,BISP 197,001,959851,Wilhelm; James E.,9999,0,9999,0
1746541961545,CAT 124RS,A01,956906,Staff,6,0,25,19
1746541962570,CAT 125RS,A01,922013,Staff,6,0,25,19
1746541963599,CLRE 250,A00,891860,Morris; Sheldon,9995,0,9999,4
1746541965653,CLRE 251R,A00,907817,Mehta; Ravindra L.,9994,0,9999,5
1746541966683,CLRE 252,A00,891864,Cuomo; Raphael Eduardo,9993,0,9999,6
1746541967713,CLRE 253,A00,891867,Vaida; Florin,9994,0,9999,5
1746541967713,CLRE 253,B00,907819,Staff,9999,0,9999,0
1746541968742,CLRE 259,A00,891868,Patel; Hemal,9998,0,9999,1
1746541969773,CLRE 260,A00,891872,Cuomo; Raphael Eduardo,9999,0,9999,0
1746541970798,CLRE 297,001,891888,Cuomo; Raphael Eduardo,9999,0,9999,0
1746541971827,CSE 191,A00,958773,Minnes Kemp; Mor Mia,9996,0,9999,3
1746541972884,CSE 197,001,959846,Minnes Kemp; Mor Mia,9993,0,9999,6
1746541973914,CSS 201S,A01,892054,Mignozzetti; Umberto,26,0,30,4
1746541974941,CSS 202S,A01,892056,Mignozzetti; Umberto,26,0,30,4
1746541975970,DSC 197,001,956898,Eldridge; Justin Matthew,9998,0,9999,1
1746541977000,DSC 297,001,958000,Mazumdar; Arya,9998,0,9999,1
1746541977000,DSC 297,002,959862,Wang; Yusu,9999,0,9999,0
1746541978025,EAP 100,A00,905686,Staff,9778,0,9999,221
1746541979056,ECE 45,A01,892618,Staff,0,0,65,65
1746541981111,ECE 111,A01,892719,Staff,4,0,65,61
1746541982139,ECE 197,001,957920,Mercier; Patrick Philip,9991,0,9999,8
1746541983172,ECON 178,A01,907814,Zhu; Ying,26,0,35,9
1746541984196,EDS 115,A00,895312,Staff,36,0,45,9
1746541985226,EDS 117,A01,895337,Staff,24,0,30,6
1746541986252,EDS 125,A00,895341,Jones; Gabrielle Anastasia,37,0,45,8
1746541987278,EDS 128A,A01,895459,Fargason; Sharon Gayle,44,0,45,1
1746541988302,EDS 128B,A01,895543,Pappas; Elizabeth,44,0,45,1
1746541989328,EDS 139,A00,897203,Pappas; Elizabeth,44,0,45,1
1746541989328,EDS 139,B00,897209,Fargason; Sharon Gayle,41,0,45,4
1746541990352,EDS 201,A00,895545,Staff,23,0,45,22
1746541991380,EDS 203,A01,895581,Halter; Christopher P.,23,0,45,22
1746541992416,EDS 204R,A01,895625,Heinzman; Erica M.,39,0,45,6
1746541992416,EDS 204R,B01,895693,Halter; Christopher P.,10,0,45,35
1746541993443,EDS 206R,A00,895694,Fargason; Sharon Gayle,1,0,30,29
1746541993443,EDS 206R,B00,895695,Choi; Bailey Miyeon,16,0,30,14
1746541994469,EDS 250,A00,895697,Hemans; Patricia Ann Benitez,23,0,45,22
1746541995495,EDS 281,A00,895701,Meyerott; Theresa Ann,1,0,15,14
1746541996521,EDS 284,A00,895736,Meyerott; Theresa Ann,1,0,15,14
1746541997547,EDS 286,A00,897210,Fine; Sarah,0,0,15,15
1746541998578,EDS 289C,A01,895770,Daly; Alan J.,15,0,15,0
1746541999606,EDS 290,A00,897211,Hofstetter; Carolyn,0,0,15,15
1746542000633,LIGM 5A,A00,896162,Fischer-Grunski; Eva K,13,0,20,7
1746542001666,LIGM 5B,A00,896260,Fischer-Grunski; Eva K,17,0,20,3
1746542002695,LIGM 5C,A00,896308,Fischer-Grunski; Eva K,18,0,20,2
1746542003725,LIIT 5AS,A00,896313,Carnelos; Chiara,18,0,20,2
1746542004755,LIIT 5BS,A00,896416,Carnelos; Chiara,20,0,20,0
1746542005783,LIIT 5CS,A00,896564,Carnelos; Chiara,20,0,20,0
1746542006809,LISP 5A,A00,896588,Munoz Sanchez; Alicia,3,0,20,17
1746542007837,LISP 5B,A00,896653,Munoz Sanchez; Alicia,7,0,20,13
1746542008863,LISP 5C,A00,896655,Munoz Sanchez; Alicia,0,1,20,20
1746542009891,MAE 197,001,957918,Kleissl; Jan,9996,0,9999,3
1746542009891,MAE 197,002,959806,Boechler; Nicholas Sebastia,9998,0,9999,1
1746542009891,MAE 197,003,959852,Mullin; Jennifer S,9999,0,9999,0
1746542010917,MATH 2,A01,957937,Staff,33,0,35,2
1746542011942,MATH 197,001,957876,Kedlaya; Kiran S.,9993,0,9999,6
1746542012976,MCWP 40,A00,892729,Duru; Nur,10,0,20,10
1746542012976,MCWP 40,B00,893304,Montejo; Carolina,14,0,20,6
1746542014002,MCWP 40R,A00,893757,Redela; Pamela Morgan,0,5,20,20
1746542015030,MCWP 50,A00,893758,Morshed; Michael James,0,0,20,20
1746542015030,MCWP 50,B00,893761,Bartulis; Jason Michael,17,0,20,3
1746542016064,MCWP 50R,A00,893766,Compas; Sean Matthew,0,1,20,20
1746542016064,MCWP 50R,B00,893769,Carter; Jennifer A,0,1,20,20
1746542016064,MCWP 50R,C00,893771,Krone; Jarret,0,3,20,20
1746542016064,MCWP 50R,D00,893772,Miller; Elizabeth Deen,0,0,20,20
1746542016064,MCWP 50R,E00,893775,Carter; Andrea L,0,1,20,20
1746542017093,MMW 11R,A01,892721,Herbst; Matthew,11,0,27,16
1746542017093,MMW 11R,A02,892722,Herbst; Matthew,0,0,0,3
1746542018121,MMW 12R,A01,892724,Herbst; Matthew,0,11,16,16
1746542018121,MMW 12R,A02,892725,Herbst; Matthew,0,10,16,16
1746542019146,MMW 13R,A01,892727,Staff,0,4,16,16
1746542019146,MMW 13R,A02,892728,Staff,0,4,16,16
1746542019146,MMW 13R,A03,958032,Staff,0,4,16,16
1746542019146,MMW 13R,A04,958033,Staff,0,4,16,16
1746542019146,MMW 13R,A05,958034,Staff,0,4,16,16
1746542020170,SIO 295LS,A00,894015,Staff,5,0,25,20
1746542021197,SIO 295S,A00,894020,Staff,5,0,25,20
1746542022225,SIOC 290S,B01,958918,Merrifield; Mark A,14,0,30,16
1746542023256,SIOC 291S,B01,958922,Gabriel; Corey John,14,0,30,16
1746542024283,SOCI 117,A01,895339,Staff,3,0,5,2
1746542025310,WES 237B,A00,894149,Staff,11,0,20,9
1746542027382,AESE 279B,A00,891859,Staff,13,0,35,22
1746542028407,AIP 197,001,891854,Vespa; Emanuel Ignacio,9999,0,9999,0
1746542029434,ANTH 289S,A00,891856,Gagneux; Pascal,12,0,12,0
1746542030459,BENG 196,001,957946,Engler; Adam J.,9996,0,9999,3
1746542031485,BISP 197,001,959851,Wilhelm; James E.,9999,0,9999,0
1746542032511,CAT 124RS,A01,956906,Staff,6,0,25,19
1746542033535,CAT 125RS,A01,922013,Staff,6,0,25,19
1746542034559,CLRE 250,A00,891860,Morris; Sheldon,9995,0,9999,4
1746542036615,CLRE 251R,A00,907817,Mehta; Ravindra L.,9994,0,9999,5
1746542037643,CLRE 252,A00,891864,Cuomo; Raphael Eduardo,9993,0,9999,6
1746542038668,CLRE 253,A00,891867,Vaida; Florin,9994,0,9999,5
1746542038668,CLRE 253,B00,907819,Staff,9999,0,9999,0
1746542039695,CLRE 259,A00,891868,Patel; Hemal,9998,0,9999,1
1746542040721,CLRE 260,A00,891872,Cuomo; Raphael Eduardo,9999,0,9999,0
1746542041748,CLRE 297,001,891888,Cuomo; Raphael Eduardo,9999,0,9999,0
1746542042773,CSE 191,A00,958773,Minnes Kemp; Mor Mia,9996,0,9999,3
1746542043798,CSE 197,001,959846,Minnes Kemp; Mor Mia,9993,0,9999,6
1746542044828,CSS 201S,A01,892054,Mignozzetti; Umberto,26,0,30,4
1746542045857,CSS 202S,A01,892056,Mignozzetti; Umberto,26,0,30,4
1746542046882,DSC 197,001,956898,Eldridge; Justin Matthew,9998,0,9999,1
1746542047908,DSC 297,001,958000,Mazumdar; Arya,9998,0,9999,1
1746542047908,DSC 297,002,959862,Wang; Yusu,9999,0,9999,0
1746542048936,EAP 100,A00,905686,Staff,9778,0,9999,221
1746542049966,ECE 45,A01,892618,Staff,0,0,65,65
1746542052020,ECE 111,A01,892719,Staff,4,0,65,61
1746542053047,ECE 197,001,957920,Mercier; Patrick Philip,9991,0,9999,8
1746542054079,ECON 178,A01,907814,Zhu; Ying,26,0,35,9
1746542055105,EDS 115,A00,895312,Staff,36,0,45,9
1746542056131,EDS 117,A01,895337,Staff,24,0,30,6
1746542057159,EDS 125,A00,895341,Jones; Gabrielle Anastasia,37,0,45,8
1746542058188,EDS 128A,A01,895459,Fargason; Sharon Gayle,44,0,45,1
1746542059214,EDS 128B,A01,895543,Pappas; Elizabeth,44,0,45,1
1746542060240,EDS 139,A00,897203,Pappas; Elizabeth,44,0,45,1
1746542060240,EDS 139,B00,897209,Fargason; Sharon Gayle,41,0,45,4
1746542061270,EDS 201,A00,895545,Staff,23,0,45,22
1746542062298,EDS 203,A01,895581,Halter; Christopher P.,23,0,45,22
1746542063323,EDS 204R,A01,895625,Heinzman; Erica M.,39,0,45,6
1746542063323,EDS 204R,B01,895693,Halter; Christopher P.,10,0,45,35
1746542064349,EDS 206R,A00,895694,Fargason; Sharon Gayle,1,0,30,29
1746542064349,EDS 206R,B00,895695,Choi; Bailey Miyeon,16,0,30,14
1746542065379,EDS 250,A00,895697,Hemans; Patricia Ann Benitez,23,0,45,22
1746542066408,EDS 281,A00,895701,Meyerott; Theresa Ann,1,0,15,14
1746542067433,EDS 284,A00,895736,Meyerott; Theresa Ann,1,0,15,14
1746542068459,EDS 286,A00,897210,Fine; Sarah,0,0,15,15
1746542069485,EDS 289C,A01,895770,Daly; Alan J.,15,0,15,0
1746542070512,EDS 290,A00,897211,Hofstetter; Carolyn,0,0,15,15
1746542071536,LIGM 5A,A00,896162,Fischer-Grunski; Eva K,13,0,20,7
1746542072562,LIGM 5B,A00,896260,Fischer-Grunski; Eva K,17,0,20,3
1746542073588,LIGM 5C,A00,896308,Fischer-Grunski; Eva K,18,0,20,2
1746542074614,LIIT 5AS,A00,896313,Carnelos; Chiara,18,0,20,2
1746542075644,LIIT 5BS,A00,896416,Carnelos; Chiara,20,0,20,0
1746542076672,LIIT 5CS,A00,896564,Carnelos; Chiara,20,0,20,0
1746542077701,LISP 5A,A00,896588,Munoz Sanchez; Alicia,3,0,20,17
1746542078730,LISP 5B,A00,896653,Munoz Sanchez; Alicia,7,0,20,13
1746542079755,LISP 5C,A00,896655,Munoz Sanchez; Alicia,0,1,20,20
1746542080783,MAE 197,001,957918,Kleissl; Jan,9996,0,9999,3
1746542080783,MAE 197,002,959806,Boechler; Nicholas Sebastia,9998,0,9999,1
1746542080783,MAE 197,003,959852,Mullin; Jennifer S,9999,0,9999,0
1746542081809,MATH 2,A01,957937,Staff,33,0,35,2
1746542082835,MATH 197,001,957876,Kedlaya; Kiran S.,9993,0,9999,6
1746542083859,MCWP 40,A00,892729,Duru; Nur,10,0,20,10
1746542083859,MCWP 40,B00,893304,Montejo; Carolina,14,0,20,6
1746542084887,MCWP 40R,A00,893757,Redela; Pamela Morgan,0,5,20,20
1746542085913,MCWP 50,A00,893758,Morshed; Michael James,0,0,20,20
1746542085913,MCWP 50,B00,893761,Bartulis; Jason Michael,17,0,20,3
1746542086939,MCWP 50R,A00,893766,Compas; Sean Matthew,0,1,20,20
1746542086939,MCWP 50R,B00,893769,Carter; Jennifer A,0,1,20,20
1746542086939,MCWP 50R,C00,893771,Krone; Jarret,0,3,20,20
1746542086939,MCWP 50R,D00,893772,Miller; Elizabeth Deen,0,0,20,20
1746542086939,MCWP 50R,E00,893775,Carter; Andrea L,0,1,20,20
1746542087967,MMW 11R,A01,892721,Herbst; Matthew,11,0,27,16
1746542087967,MMW 11R,A02,892722,Herbst; Matthew,0,0,0,3
1746542088992,MMW 12R,A01,892724,Herbst; Matthew,0,11,16,16
1746542088992,MMW 12R,A02,892725,Herbst; Matthew,0,10,16,16
1746542090020,MMW 13R,A01,892727,Staff,0,4,16,16
1746542090020,MMW 13R,A02,892728,Staff,0,4,16,16
1746542090020,MMW 13R,A03,958032,Staff,0,4,16,16
1746542090020,MMW 13R,A04,958033,Staff,0,4,16,16
1746542090020,MMW 13R,A05,958034,Staff,0,4,16,16
1746542091046,SIO 295LS,A00,894015,Staff,5,0,25,20
1746542092072,SIO 295S,A00,894020,Staff,5,0,25,20
1746542093100,SIOC 290S,B01,958918,Merrifield; Mark A,14,0,30,16
1746542094126,SIOC 291S,B01,958922,Gabriel; Corey John,14,0,30,16
1746542095154,SOCI 117,A01,895339,Staff,3,0,5,2
1746542096183,WES 237B,A00,894149,Staff,11,0,20,9
1746542098251,AESE 279B,A00,891859,Staff,13,0,35,22
1746542099277,AIP 197,001,891854,Vespa; Emanuel Ignacio,9999,0,9999,0
1746542100308,ANTH 289S,A00,891856,Gagneux; Pascal,12,0,12,0
1746542101335,BENG 196,001,957946,Engler; Adam J.,9996,0,9999,3
1746542102361,BISP 197,001,959851,Wilhelm; James E.,9999,0,9999,0
1746542103388,CAT 124RS,A01,956906,Staff,6,0,25,19
1746542104418,CAT 125RS,A01,922013,Staff,6,0,25,19
1746542105445,CLRE 250,A00,891860,Morris; Sheldon,9995,0,9999,4
1746542107500,CLRE 251R,A00,907817,Mehta; Ravindra L.,9994,0,9999,5
1746542108530,CLRE 252,A00,891864,Cuomo; Raphael Eduardo,9993,0,9999,6
1746542109603,CLRE 253,A00,891867,Vaida; Florin,9994,0,9999,5
1746542109603,CLRE 253,B00,907819,Staff,9999,0,9999,0
1746542110631,CLRE 259,A00,891868,Patel; Hemal,9998,0,9999,1
1746542111656,CLRE 260,A00,891872,Cuomo; Raphael Eduardo,9999,0,9999,0
1746542112682,CLRE 297,001,891888,Cuomo; Raphael Eduardo,9999,0,9999,0
1746542113709,CSE 191,A00,958773,Minnes Kemp; Mor Mia,9996,0,9999,3
1746542114734,CSE 197,001,959846,Minnes Kemp; Mor Mia,9993,0,9999,6
1746542115762,CSS 201S,A01,892054,Mignozzetti; Umberto,26,0,30,4
1746542116787,CSS 202S,A01,892056,Mignozzetti; Umberto,26,0,30,4
1746542117814,DSC 197,001,956898,Eldridge; Justin Matthew,9998,0,9999,1
1746542118842,DSC 297,001,958000,Mazumdar; Arya,9998,0,9999,1
1746542118842,DSC 297,002,959862,Wang; Yusu,9999,0,9999,0
1746542119867,EAP 100,A00,905686,Staff,9778,0,9999,221
1746542120899,ECE 45,A01,892618,Staff,0,0,65,65
1746542122956,ECE 111,A01,892719,Staff,4,0,65,61
1746542123985,ECE 197,001,957920,Mercier; Patrick Philip,9991,0,9999,8
1746542125028,ECON 178,A01,907814,Zhu; Ying,26,0,35,9
1746542126058,EDS 115,A00,895312,Staff,36,0,45,9
1746542127087,EDS 117,A01,895337,Staff,24,0,30,6
1746542128112,EDS 125,A00,895341,Jones; Gabrielle Anastasia,37,0,45,8
1746542129140,EDS 128A,A01,895459,Fargason; Sharon Gayle,44,0,45,1
1746542130167,EDS 128B,A01,895543,Pappas; Elizabeth,44,0,45,1
1746542131195,EDS 139,A00,897203,Pappas; Elizabeth,44,0,45,1
1746542131195,EDS 139,B00,897209,Fargason; Sharon Gayle,41,0,45,4
1746542132224,EDS 201,A00,895545,Staff,23,0,45,22
1746542133249,EDS 203,A01,895581,Halter; Christopher P.,23,0,45,22
1746542134274,EDS 204R,A01,895625,Heinzman; Erica M.,39,0,45,6
1746542134274,EDS 204R,B01,895693,Halter; Christopher P.,10,0,45,35
1746542135301,EDS 206R,A00,895694,Fargason; Sharon Gayle,1,0,30,29
1746542135301,EDS 206R,B00,895695,Choi; Bailey Miyeon,16,0,30,14
1746542136327,EDS 250,A00,895697,Hemans; Patricia Ann Benitez,23,0,45,22
1746542137356,EDS 281,A00,895701,Meyerott; Theresa Ann,1,0,15,14
1746542138382,EDS 284,A00,895736,Meyerott; Theresa Ann,1,0,15,14
1746542139408,EDS 286,A00,897210,Fine; Sarah,0,0,15,15
1746542140437,EDS 289C,A01,895770,Daly; Alan J.,15,0,15,0
1746542141464,EDS 290,A00,897211,Hofstetter; Carolyn,0,0,15,15
1746542142495,LIGM 5A,A00,896162,Fischer-Grunski; Eva K,13,0,20,7
1746542143521,LIGM 5B,A00,896260,Fischer-Grunski; Eva K,17,0,20,3
1746542144548,LIGM 5C,A00,896308,Fischer-Grunski; Eva K,18,0,20,2
1746542145613,LIIT 5AS,A00,896313,Carnelos; Chiara,18,0,20,2
1746542146639,LIIT 5BS,A00,896416,Carnelos; Chiara,20,0,20,0
1746542147666,LIIT 5CS,A00,896564,Carnelos; Chiara,20,0,20,0
1746542148692,LISP 5A,A00,896588,Munoz Sanchez; Alicia,3,0,20,17
1746542149717,LISP 5B,A00,896653,Munoz Sanchez; Alicia,7,0,20,13
1746542150746,LISP 5C,A00,896655,Munoz Sanchez; Alicia,0,1,20,20
1746542151773,MAE 197,001,957918,Kleissl; Jan,9996,0,9999,3
1746542151773,MAE 197,002,959806,Boechler; Nicholas Sebastia,9998,0,9999,1
1746542151773,MAE 197,003,959852,Mullin; Jennifer S,9999,0,9999,0
1746542152804,MATH 2,A01,957937,Staff,33,0,35,2
1746542153834,MATH 197,001,957876,Kedlaya; Kiran S.,9993,0,9999,6
1746542154860,MCWP 40,A00,892729,Duru; Nur,10,0,20,10
1746542154860,MCWP 40,B00,893304,Montejo; Carolina,14,0,20,6
1746542155890,MCWP 40R,A00,893757,Redela; Pamela Morgan,0,5,20,20
1746542156917,MCWP 50,A00,893758,Morshed; Michael James,0,0,20,20
1746542156917,MCWP 50,B00,893761,Bartulis; Jason Michael,17,0,20,3
1746542157942,MCWP 50R,A00,893766,Compas; Sean Matthew,0,1,20,20
1746542157942,MCWP 50R,B00,893769,Carter; Jennifer A,0,1,20,20
1746542157942,MCWP 50R,C00,893771,Krone; Jarret,0,3,20,20
1746542157942,MCWP 50R,D00,893772,Miller; Elizabeth Deen,0,0,20,20
1746542157942,MCWP 50R,E00,893775,Carter; Andrea L,0,1,20,20
1746542158968,MMW 11R,A01,892721,Herbst; Matthew,11,0,27,16
1746542158968,MMW 11R,A02,892722,Herbst; Matthew,0,0,0,3
1746542159995,MMW 12R,A01,892724,Herbst; Matthew,0,11,16,16
1746542159995,MMW 12R,A02,892725,Herbst; Matthew,0,10,16,16
1746542161020,MMW 13R,A01,892727,Staff,0,4,16,16
1746542161020,MMW 13R,A02,892728,Staff,0,4,16,16
1746542161020,MMW 13R,A03,958032,Staff,0,4,16,16
1746542161020,MMW 13R,A04,958033,Staff,0,4,16,16
1746542161020,MMW 13R,A05,958034,Staff,0,4,16,16
1746542162044,SIO 295LS,A00,894015,Staff,5,0,25,20
1746542163070,SIO 295S,A00,894020,Staff,5,0,25,20
1746542164103,SIOC 290S,B01,958918,Merrifield; Mark A,14,0,30,16
1746542165132,SIOC 291S,B01,958922,Gabriel; Corey John,14,0,30,16
1746542166159,SOCI 117,A01,895339,Staff,3,0,5,2
1746542167184,WES 237B,A00,894149,Staff,11,0,20,9
1746542169270,AESE 279B,A00,891859,Staff,13,0,35,22
1746542170294,AIP 197,001,891854,Vespa; Emanuel Ignacio,9999,0,9999,0
1746542171321,ANTH 289S,A00,891856,Gagneux; Pascal,12,0,12,0
1746542172348,BENG 196,001,957946,Engler; Adam J.,9996,0,9999,3
1746542173373,BISP 197,001,959851,Wilhelm; James E.,9999,0,9999,0
1746542174399,CAT 124RS,A01,956906,Staff,6,0,25,19
1746542175427,CAT 125RS,A01,922013,Staff,6,0,25,19
1746542176457,CLRE 250,A00,891860,Morris; Sheldon,9995,0,9999,4
1746542178516,CLRE 251R,A00,907817,Mehta; Ravindra L.,9994,0,9999,5
1746542179541,CLRE 252,A00,891864,Cuomo; Raphael Eduardo,9993,0,9999,6
1746542180568,CLRE 253,A00,891867,Vaida; Florin,9994,0,9999,5
1746542180568,CLRE 253,B00,907819,Staff,9999,0,9999,0
1746542181593,CLRE 259,A00,891868,Patel; Hemal,9998,0,9999,1
1746542182620,CLRE 260,A00,891872,Cuomo; Raphael Eduardo,9999,0,9999,0
1746542183646,CLRE 297,001,891888,Cuomo; Raphael Eduardo,9999,0,9999,0
1746542184681,CSE 191,A00,958773,Minnes Kemp; Mor Mia,9996,0,9999,3
1746542185713,CSE 197,001,959846,Minnes Kemp; Mor Mia,9993,0,9999,6
1746542186743,CSS 201S,A01,892054,Mignozzetti; Umberto,26,0,30,4
1746542187773,CSS 202S,A01,892056,Mignozzetti; Umberto,26,0,30,4
1746542188799,DSC 197,001,956898,Eldridge; Justin Matthew,9998,0,9999,1
1746542189825,DSC 297,001,958000,Mazumdar; Arya,9998,0,9999,1
1746542189825,DSC 297,002,959862,Wang; Yusu,9999,0,9999,0
1746542190851,EAP 100,A00,905686,Staff,9778,0,9999,221
1746542191876,ECE 45,A01,892618,Staff,0,0,65,65
1746542193931,ECE 111,A01,892719,Staff,4,0,65,61
1746542194957,ECE 197,001,957920,Mercier; Patrick Philip,9991,0,9999,8
1746542195988,ECON 178,A01,907814,Zhu; Ying,26,0,35,9
1746542197015,EDS 115,A00,895312,Staff,36,0,45,9
1746542198042,EDS 117,A01,895337,Staff,24,0,30,6
1746542199071,EDS 125,A00,895341,Jones; Gabrielle Anastasia,37,0,45,8
1746542200096,EDS 128A,A01,895459,Fargason; Sharon Gayle,44,0,45,1
1746542201125,EDS 128B,A01,895543,Pappas; Elizabeth,44,0,45,1
1746542202154,EDS 139,A00,897203,Pappas; Elizabeth,44,0,45,1
1746542202154,EDS 139,B00,897209,Fargason; Sharon Gayle,41,0,45,4
1746542203183,EDS 201,A00,895545,Staff,23,0,45,22
1746542204213,EDS 203,A01,895581,Halter; Christopher P.,23,0,45,22
1746542205240,EDS 204R,A01,895625,Heinzman; Erica M.,39,0,45,6
1746542205240,EDS 204R,B01,895693,Halter; Christopher P.,10,0,45,35
1746542206270,EDS 206R,A00,895694,Fargason; Sharon Gayle,1,0,30,29
1746542206270,EDS 206R,B00,895695,Choi; Bailey Miyeon,16,0,30,14
1746542207294,EDS 250,A00,895697,Hemans; Patricia Ann Benitez,23,0,45,22
1746542208323,EDS 281,A00,895701,Meyerott; Theresa Ann,1,0,15,14
1746542209353,EDS 284,A00,895736,Meyerott; Theresa Ann,1,0,15,14
1746542210382,EDS 286,A00,897210,Fine; Sarah,0,0,15,15
1746542211414,EDS 289C,A01,895770,Daly; Alan J.,15,0,15,0
1746542212445,EDS 290,A00,897211,Hofstetter; Carolyn,0,0,15,15
1746542213471,LIGM 5A,A00,896162,Fischer-Grunski; Eva K,13,0,20,7
1746542214499,LIGM 5B,A00,896260,Fischer-Grunski; Eva K,17,0,20,3
1746542215526,LIGM 5C,A00,896308,Fischer-Grunski; Eva K,18,0,20,2
1746542216554,LIIT 5AS,A00,896313,Carnelos; Chiara,18,0,20,2
1746542217581,LIIT 5BS,A00,896416,Carnelos; Chiara,20,0,20,0
1746542218609,LIIT 5CS,A00,896564,Carnelos; Chiara,20,0,20,0
1746542219634,LISP 5A,A00,896588,Munoz Sanchez; Alicia,3,0,20,17
1746542220660,LISP 5B,A00,896653,Munoz Sanchez; Alicia,7,0,20,13
1746542221689,LISP 5C,A00,896655,Munoz Sanchez; Alicia,0,1,20,20
1746542222715,MAE 197,001,957918,Kleissl; Jan,9996,0,9999,3
1746542222715,MAE 197,002,959806,Boechler; Nicholas Sebastia,9998,0,9999,1
1746542222715,MAE 197,003,959852,Mullin; Jennifer S,9999,0,9999,0
1746542223742,MATH 2,A01,957937,Staff,33,0,35,2
1746542224773,MATH 197,001,957876,Kedlaya; Kiran S.,9993,0,9999,6
1746542225803,MCWP 40,A00,892729,Duru; Nur,10,0,20,10
1746542225803,MCWP 40,B00,893304,Montejo; Carolina,14,0,20,6
1746542226831,MCWP 40R,A00,893757,Redela; Pamela Morgan,0,5,20,20
1746542227862,MCWP 50,A00,893758,Morshed; Michael James,0,0,20,20
1746542227862,MCWP 50,B00,893761,Bartulis; Jason Michael,17,0,20,3
1746542228889,MCWP 50R,A00,893766,Compas; Sean Matthew,0,1,20,20
1746542228889,MCWP 50R,B00,893769,Carter; Jennifer A,0,1,20,20
1746542228889,MCWP 50R,C00,893771,Krone; Jarret,0,3,20,20
1746542228889,MCWP 50R,D00,893772,Miller; Elizabeth Deen,0,0,20,20
1746542228889,MCWP 50R,E00,893775,Carter; Andrea L,0,1,20,20
1746542229914,MMW 11R,A01,892721,Herbst; Matthew,11,0,27,16
1746542229914,MMW 11R,A02,892722,Herbst; Matthew,0,0,0,3
1746542230943,MMW 12R,A01,892724,Herbst; Matthew,0,11,16,16
1746542230943,MMW 12R,A02,892725,Herbst; Matthew,0,10,16,16
1746542231968,MMW 13R,A01,892727,Staff,0,4,16,16
1746542231968,MMW 13R,A02,892728,Staff,0,4,16,16
1746542231968,MMW 13R,A03,958032,Staff,0,4,16,16
1746542231968,MMW 13R,A04,958033,Staff,0,4,16,16
1746542231968,MMW 13R,A05,958034,Staff,0,4,16,16
1746542232997,SIO 295LS,A00,894015,Staff,5,0,25,20
1746542234026,SIO 295S,A00,894020,Staff,5,0,25,20
1746542235060,SIOC 290S,B01,958918,Merrifield; Mark A,14,0,30,16
1746542236089,SIOC 291S,B01,958922,Gabriel; Corey John,14,0,30,16
1746542237114,SOCI 117,A01,895339,Staff,3,0,5,2
1746542238139,WES 237B,A00,894149,Staff,11,0,20,9
1746542240204,AESE 279B,A00,891859,Staff,13,0,35,22
1746542241232,AIP 197,001,891854,Vespa; Emanuel Ignacio,9999,0,9999,0
1746542242257,ANTH 289S,A00,891856,Gagneux; Pascal,12,0,12,0
1746542243281,BENG 196,001,957946,Engler; Adam J.,9996,0,9999,3
1746542244307,BISP 197,001,959851,Wilhelm; James E.,9999,0,9999,0
1746542245332,CAT 124RS,A01,956906,Staff,6,0,25,19
1746542246361,CAT 125RS,A01,922013,Staff,6,0,25,19
1746542247388,CLRE 250,A00,891860,Morris; Sheldon,9995,0,9999,4
1746542249439,CLRE 251R,A00,907817,Mehta; Ravindra L.,9994,0,9999,5
1746542250469,CLRE 252,A00,891864,Cuomo; Raphael Eduardo,9993,0,9999,6
1746542251498,CLRE 253,A00,891867,Vaida; Florin,9994,0,9999,5
1746542251498,CLRE 253,B00,907819,Staff,9999,0,9999,0
1746542252524,CLRE 259,A00,891868,Patel; Hemal,9998,0,9999,1
1746542253550,CLRE 260,A00,891872,Cuomo; Raphael Eduardo,9999,0,9999,0
1746542254575,CLRE 297,001,891888,Cuomo; Raphael Eduardo,9999,0,9999,0
1746542255601,CSE 191,A00,958773,Minnes Kemp; Mor Mia,9996,0,9999,3
1746542256630,CSE 197,001,959846,Minnes Kemp; Mor Mia,9993,0,9999,6
1746542257659,CSS 201S,A01,892054,Mignozzetti; Umberto,26,0,30,4
1746542258689,CSS 202S,A01,892056,Mignozzetti; Umberto,26,0,30,4
1746542259714,DSC 197,001,956898,Eldridge; Justin Matthew,9998,0,9999,1
1746542260739,DSC 297,001,958000,Mazumdar; Arya,9998,0,9999,1
1746542260739,DSC 297,002,959862,Wang; Yusu,9999,0,9999,0
1746542261764,EAP 100,A00,905686,Staff,9778,0,9999,221
1746542262795,ECE 45,A01,892618,Staff,0,0,65,65
1746542264850,ECE 111,A01,892719,Staff,4,0,65,61
1746542265877,ECE 197,001,957920,Mercier; Patrick Philip,9991,0,9999,8
1746542266909,ECON 178,A01,907814,Zhu; Ying,26,0,35,9
1746542267935,EDS 115,A00,895312,Staff,36,0,45,9
1746542268960,EDS 117,A01,895337,Staff,24,0,30,6
1746542269986,EDS 125,A00,895341,Jones; Gabrielle Anastasia,37,0,45,8
1746542271012,EDS 128A,A01,895459,Fargason; Sharon Gayle,44,0,45,1
1746542272043,EDS 128B,A01,895543,Pappas; Elizabeth,44,0,45,1
1746542273067,EDS 139,A00,897203,Pappas; Elizabeth,44,0,45,1
1746542273067,EDS 139,B00,897209,Fargason; Sharon Gayle,41,0,45,4
1746542274094,EDS 201,A00,895545,Staff,23,0,45,22
1746542275122,EDS 203,A01,895581,Halter; Christopher P.,23,0,45,22
1746542276152,EDS 204R,A01,895625,Heinzman; Erica M.,39,0,45,6
1746542276152,EDS 204R,B01,895693,Halter; Christopher P.,10,0,45,35
1746542277177,EDS 206R,A00,895694,Fargason; Sharon Gayle,1,0,30,29
1746542277177,EDS 206R,B00,895695,Choi; Bailey Miyeon,16,0,30,14
1746542278203,EDS 250,A00,895697,Hemans; Patricia Ann Benitez,23,0,45,22
1746542279229,EDS 281,A00,895701,Meyerott; Theresa Ann,1,0,15,14
1746542280253,EDS 284,A00,895736,Meyerott; Theresa Ann,1,0,15,14
1746542281290,EDS 286,A00,897210,Fine; Sarah,0,0,15,15
1746542282317,EDS 289C,A01,895770,Daly; Alan J.,15,0,15,0
1746542283342,EDS 290,A00,897211,Hofstetter; Carolyn,0,0,15,15
1746542284366,LIGM 5A,A00,896162,Fischer-Grunski; Eva K,13,0,20,7
1746542285390,LIGM 5B,A00,896260,Fischer-Grunski; Eva K,17,0,20,3
1746542286418,LIGM 5C,A00,896308,Fischer-Grunski; Eva K,18,0,20,2
1746542287442,LIIT 5AS,A00,896313,Carnelos; Chiara,18,0,20,2
1746542288471,LIIT 5BS,A00,896416,Carnelos; Chiara,20,0,20,0
1746542289500,LIIT 5CS,A00,896564,Carnelos; Chiara,20,0,20,0
1746542290530,LISP 5A,A00,896588,Munoz Sanchez; Alicia,3,0,20,17
1746542291566,LISP 5B,A00,896653,Munoz Sanchez; Alicia,7,0,20,13
1746542292593,LISP 5C,A00,896655,Munoz Sanchez; Alicia,0,1,20,20
1746542293620,MAE 197,001,957918,Kleissl; Jan,9996,0,9999,3
1746542293620,MAE 197,002,959806,Boechler; Nicholas Sebastia,9998,0,9999,1
1746542293620,MAE 197,003,959852,Mullin; Jennifer S,9999,0,9999,0
1746542294644,MATH 2,A01,957937,Staff,33,0,35,2
1746542295672,MATH 197,001,957876,Kedlaya; Kiran S.,9993,0,9999,6
1746542296697,MCWP 40,A00,892729,Duru; Nur,10,0,20,10
1746542296697,MCWP 40,B00,893304,Montejo; Carolina,14,0,20,6
1746542297722,MCWP 40R,A00,893757,Redela; Pamela Morgan,0,5,20,20
1746542298750,MCWP 50,A00,893758,Morshed; Michael James,0,0,20,20
1746542298750,MCWP 50,B00,893761,Bartulis; Jason Michael,17,0,20,3
1746542299785,MCWP 50R,A00,893766,Compas; Sean Matthew,0,1,20,20
1746542299785,MCWP 50R,B00,893769,Carter; Jennifer A,0,1,20,20
1746542299785,MCWP 50R,C00,893771,Krone; Jarret,0,3,20,20
1746542299785,MCWP 50R,D00,893772,Miller; Elizabeth Deen,0,0,20,20
1746542299785,MCWP 50R,E00,893775,Carter; Andrea L,0,1,20,20
1746542300813,MMW 11R,A01,892721,Herbst; Matthew,11,0,27,16
1746542300813,MMW 11R,A02,892722,Herbst; Matthew,0,0,0,3
1746542301840,MMW 12R,A01,892724,Herbst; Matthew,0,11,16,16
1746542301840,MMW 12R,A02,892725,Herbst; Matthew,0,10,16,16
1746542302867,MMW 13R,A01,892727,Staff,0,4,16,16
1746542302867,MMW 13R,A02,892728,Staff,0,4,16,16
1746542302867,MMW 13R,A03,958032,Staff,0,4,16,16
1746542302867,MMW 13R,A04,958033,Staff,0,4,16,16
1746542302867,MMW 13R,A05,958034,Staff,0,4,16,16
1746542303897,SIO 295LS,A00,894015,Staff,5,0,25,20
1746542304921,SIO 295S,A00,894020,Staff,5,0,25,20
1746542305946,SIOC 290S,B01,958918,Merrifield; Mark A,14,0,30,16
1746542306973,SIOC 291S,B01,958922,Gabriel; Corey John,14,0,30,16
1746542307999,SOCI 117,A01,895339,Staff,3,0,5,2
1746542309025,WES 237B,A00,894149,Staff,11,0,20,9
1746542311096,AESE 279B,A00,891859,Staff,13,0,35,22
1746542312121,AIP 197,001,891854,Vespa; Emanuel Ignacio,9999,0,9999,0
1746542313148,ANTH 289S,A00,891856,Gagneux; Pascal,12,0,12,0
1746542314178,BENG 196,001,957946,Engler; Adam J.,9996,0,9999,3
1746542315205,BISP 197,001,959851,Wilhelm; James E.,9999,0,9999,0
1746542316231,CAT 124RS,A01,956906,Staff,6,0,25,19
1746542317253,CAT 125RS,A01,922013,Staff,6,0,25,19
1746542318279,CLRE 250,A00,891860,Morris; Sheldon,9995,0,9999,4
1746542320337,CLRE 251R,A00,907817,Mehta; Ravindra L.,9994,0,9999,5
1746542321363,CLRE 252,A00,891864,Cuomo; Raphael Eduardo,9993,0,9999,6
1746542322398,CLRE 253,A00,891867,Vaida; Florin,9994,0,9999,5
1746542322398,CLRE 253,B00,907819,Staff,9999,0,9999,0
1746542323423,CLRE 259,A00,891868,Patel; Hemal,9998,0,9999,1
1746542324448,CLRE 260,A00,891872,Cuomo; Raphael Eduardo,9999,0,9999,0
1746542325473,CLRE 297,001,891888,Cuomo; Raphael Eduardo,9999,0,9999,0
1746542326501,CSE 191,A00,958773,Minnes Kemp; Mor Mia,9996,0,9999,3
1746542327526,CSE 197,001,959846,Minnes Kemp; Mor Mia,9993,0,9999,6
1746542328551,CSS 201S,A01,892054,Mignozzetti; Umberto,26,0,30,4
1746542329577,CSS 202S,A01,892056,Mignozzetti; Umberto,26,0,30,4
1746542330602,DSC 197,001,956898,Eldridge; Justin Matthew,9998,0,9999,1
1746542331630,DSC 297,001,958000,Mazumdar; Arya,9998,0,9999,1
1746542331630,DSC 297,002,959862,Wang; Yusu,9999,0,9999,0
1746542332661,EAP 100,A00,905686,Staff,9778,0,9999,221
1746542333690,ECE 45,A01,892618,Staff,0,0,65,65
1746542335744,ECE 111,A01,892719,Staff,4,0,65,61
1746542336772,ECE 197,001,957920,Mercier; Patrick Philip,9991,0,9999,8
1746542337801,ECON 178,A01,907814,Zhu; Ying,26,0,35,9
1746542338826,EDS 115,A00,895312,Staff,36,0,45,9
1746542339853,EDS 117,A01,895337,Staff,24,0,30,6
1746542340881,EDS 125,A00,895341,Jones; Gabrielle Anastasia,37,0,45,8
1746542341906,EDS 128A,A01,895459,Fargason; Sharon Gayle,44,0,45,1
1746542342938,EDS 128B,A01,895543,Pappas; Elizabeth,44,0,45,1
1746542343966,EDS 139,A00,897203,Pappas; Elizabeth,44,0,45,1
1746542343966,EDS 139,B00,897209,Fargason; Sharon Gayle,41,0,45,4
1746542345009,EDS 201,A00,895545,Staff,23,0,45,22
1746542346035,EDS 203,A01,895581,Halter; Christopher P.,23,0,45,22
1746542347061,EDS 204R,A01,895625,Heinzman; Erica M.,39,0,45,6
1746542347061,EDS 204R,B01,895693,Halter; Christopher P.,10,0,45,35
1746542348087,EDS 206R,A00,895694,Fargason; Sharon Gayle,1,0,30,29
1746542348087,EDS 206R,B00,895695,Choi; Bailey Miyeon,16,0,30,14
1746542349111,EDS 250,A00,895697,Hemans; Patricia Ann Benitez,23,0,45,22
1746542350139,EDS 281,A00,895701,Meyerott; Theresa Ann,1,0,15,14
1746542351168,EDS 284,A00,895736,Meyerott; Theresa Ann,1,0,15,14
1746542352194,EDS 286,A00,897210,Fine; Sarah,0,0,15,15
1746542353222,EDS 289C,A01,895770,Daly; Alan J.,15,0,15,0
1746542354246,EDS 290,A00,897211,Hofstetter; Carolyn,0,0,15,15
1746542355272,LIGM 5A,A00,896162,Fischer-Grunski; Eva K,13,0,20,7
1746542356296,LIGM 5B,A00,896260,Fischer-Grunski; Eva K,17,0,20,3
1746542357325,LIGM 5C,A00,896308,Fischer-Grunski; Eva K,18,0,20,2
1746542358351,LIIT 5AS,A00,896313,Carnelos; Chiara,18,0,20,2
1746542359374,LIIT 5BS,A00,896416,Carnelos; Chiara,20,0,20,0
1746542360406,LIIT 5CS,A00,896564,Carnelos; Chiara,20,0,20,0
1746542361433,LISP 5A,A00,896588,Munoz Sanchez; Alicia,3,0,20,17
1746542362461,LISP 5B,A00,896653,Munoz Sanchez; Alicia,7,0,20,13
1746542363487,LISP 5C,A00,896655,Munoz Sanchez; Alicia,0,1,20,20
1746542364515,MAE 197,001,957918,Kleissl; Jan,9996,0,9999,3
1746542364515,MAE 197,002,959806,Boechler; Nicholas Sebastia,9998,0,9999,1
1746542364515,MAE 197,003,959852,Mullin; Jennifer S,9999,0,9999,0
1746542365544,MATH 2,A01,957937,Staff,33,0,35,2
1746542366571,MATH 197,001,957876,Kedlaya; Kiran S.,9993,0,9999,6
1746542367597,MCWP 40,A00,892729,Duru; Nur,10,0,20,10
1746542367597,MCWP 40,B00,893304,Montejo; Carolina,14,0,20,6
1746542368622,MCWP 40R,A00,893757,Redela; Pamela Morgan,0,5,20,20
1746542369650,MCWP 50,A00,893758,Morshed; Michael James,0,0,20,20
1746542369650,MCWP 50,B00,893761,Bartulis; Jason Michael,17,0,20,3
1746542370677,MCWP 50R,A00,893766,Compas; Sean Matthew,0,1,20,20
1746542370677,MCWP 50R,B00,893769,Carter; Jennifer A,0,1,20,20
1746542370677,MCWP 50R,C00,893771,Krone; Jarret,0,3,20,20
1746542370677,MCWP 50R,D00,893772,Miller; Elizabeth Deen,0,0,20,20
1746542370677,MCWP 50R,E00,893775,Carter; Andrea L,0,1,20,20
1746542371708,MMW 11R,A01,892721,Herbst; Matthew,11,0,27,16
1746542371708,MMW 11R,A02,892722,Herbst; Matthew,0,0,0,3
1746542372736,MMW 12R,A01,892724,Herbst; Matthew,0,11,16,16
1746542372736,MMW 12R,A02,892725,Herbst; Matthew,0,10,16,16
1746542373764,MMW 13R,A01,892727,Staff,0,4,16,16
1746542373764,MMW 13R,A02,892728,Staff,0,4,16,16
1746542373764,MMW 13R,A03,958032,Staff,0,4,16,16
1746542373764,MMW 13R,A04,958033,Staff,0,4,16,16
1746542373764,MMW 13R,A05,958034,Staff,0,4,16,16
1746542374789,SIO 295LS,A00,894015,Staff,5,0,25,20
1746542375813,SIO 295S,A00,894020,Staff,5,0,25,20
1746542376842,SIOC 290S,B01,958918,Merrifield; Mark A,14,0,30,16
1746542377868,SIOC 291S,B01,958922,Gabriel; Corey John,14,0,30,16
1746542378895,SOCI 117,A01,895339,Staff,3,0,5,2
1746542379921,WES 237B,A00,894149,Staff,11,0,20,9
1746542381990,AESE 279B,A00,891859,Staff,13,0,35,22
1746542383018,AIP 197,001,891854,Vespa; Emanuel Ignacio,9999,0,9999,0
1746542384045,ANTH 289S,A00,891856,Gagneux; Pascal,12,0,12,0
1746542385074,BENG 196,001,957946,Engler; Adam J.,9996,0,9999,3
1746542386100,BISP 197,001,959851,Wilhelm; James E.,9999,0,9999,0
1746542387129,CAT 124RS,A01,956906,Staff,6,0,25,19
1746542388156,CAT 125RS,A01,922013,Staff,6,0,25,19
1746542389182,CLRE 250,A00,891860,Morris; Sheldon,9995,0,9999,4
1746542391237,CLRE 251R,A00,907817,Mehta; Ravindra L.,9994,0,9999,5
1746542392263,CLRE 252,A00,891864,Cuomo; Raphael Eduardo,9993,0,9999,6
1746542393287,CLRE 253,A00,891867,Vaida; Florin,9994,0,9999,5
1746542393287,CLRE 253,B00,907819,Staff,9999,0,9999,0
1746542394313,CLRE 259,A00,891868,Patel; Hemal,9998,0,9999,1
1746542395340,CLRE 260,A00,891872,Cuomo; Raphael Eduardo,9999,0,9999,0
1746542396364,CLRE 297,001,891888,Cuomo; Raphael Eduardo,9999,0,9999,0
1746542397393,CSE 191,A00,958773,Minnes Kemp; Mor Mia,9996,0,9999,3
1746542398417,CSE 197,001,959846,Minnes Kemp; Mor Mia,9993,0,9999,6
1746542399446,CSS 201S,A01,892054,Mignozzetti; Umberto,26,0,30,4
1746542400471,CSS 202S,A01,892056,Mignozzetti; Umberto,26,0,30,4
1746542401495,DSC 197,001,956898,Eldridge; Justin Matthew,9998,0,9999,1
1746542402524,DSC 297,001,958000,Mazumdar; Arya,9998,0,9999,1
1746542402524,DSC 297,002,959862,Wang; Yusu,9999,0,9999,0
1746542403553,EAP 100,A00,905686,Staff,9778,0,9999,221
1746542404583,ECE 45,A01,892618,Staff,0,0,65,65
1746542406645,ECE 111,A01,892719,Staff,4,0,65,61
1746542407672,ECE 197,001,957920,Mercier; Patrick Philip,9991,0,9999,8
1746542408701,ECON 178,A01,907814,Zhu; Ying,26,0,35,9
1746542409726,EDS 115,A00,895312,Staff,36,0,45,9
1746542410751,EDS 117,A01,895337,Staff,24,0,30,6
1746542411780,EDS 125,A00,895341,Jones; Gabrielle Anastasia,37,0,45,8
1746542412806,EDS 128A,A01,895459,Fargason; Sharon Gayle,44,0,45,1
1746542413832,EDS 128B,A01,895543,Pappas; Elizabeth,44,0,45,1
1746542414857,EDS 139,A00,897203,Pappas; Elizabeth,44,0,45,1
1746542414857,EDS 139,B00,897209,Fargason; Sharon Gayle,41,0,45,4
1746542415882,EDS 201,A00,895545,Staff,23,0,45,22
1746542416907,EDS 203,A01,895581,Halter; Christopher P.,23,0,45,22
1746542417934,EDS 204R,A01,895625,Heinzman; Erica M.,39,0,45,6
1746542417934,EDS 204R,B01,895693,Halter; Christopher P.,10,0,45,35
1746542418960,EDS 206R,A00,895694,Fargason; Sharon Gayle,1,0,30,29
1746542418960,EDS 206R,B00,895695,Choi; Bailey Miyeon,16,0,30,14
1746542419991,EDS 250,A00,895697,Hemans; Patricia Ann Benitez,23,0,45,22
1746542421022,EDS 281,A00,895701,Meyerott; Theresa Ann,1,0,15,14
1746542422083,EDS 284,A00,895736,Meyerott; Theresa Ann,1,0,15,14
1746542423110,EDS 286,A00,897210,Fine; Sarah,0,0,15,15
1746542424136,EDS 289C,A01,895770,Daly; Alan J.,15,0,15,0
1746542425163,EDS 290,A00,897211,Hofstetter; Carolyn,0,0,15,15
1746542426190,LIGM 5A,A00,896162,Fischer-Grunski; Eva K,13,0,20,7
1746542427214,LIGM 5B,A00,896260,Fischer-Grunski; Eva K,17,0,20,3
1746542428240,LIGM 5C,A00,896308,Fischer-Grunski; Eva K,18,0,20,2
1746542429266,LIIT 5AS,A00,896313,Carnelos; Chiara,18,0,20,2
1746542430293,LIIT 5BS,A00,896416,Carnelos; Chiara,20,0,20,0
1746542431320,LIIT 5CS,A00,896564,Carnelos; Chiara,20,0,20,0
1746542432345,LISP 5A,A00,896588,Munoz Sanchez; Alicia,3,0,20,17
1746542433372,LISP 5B,A00,896653,Munoz Sanchez; Alicia,7,0,20,13
1746542434402,LISP 5C,A00,896655,Munoz Sanchez; Alicia,0,1,20,20
1746542435431,MAE 197,001,957918,Kleissl; Jan,9996,0,9999,3
1746542435431,MAE 197,002,959806,Boechler; Nicholas Sebastia,9998,0,9999,1
1746542435431,MAE 197,003,959852,Mullin; Jennifer S,9999,0,9999,0
1746542436456,MATH 2,A01,957937,Staff,33,0,35,2
1746542437481,MATH 197,001,957876,Kedlaya; Kiran S.,9993,0,9999,6
1746542438507,MCWP 40,A00,892729,Duru; Nur,10,0,20,10
1746542438507,MCWP 40,B00,893304,Montejo; Carolina,14,0,20,6
1746542439539,MCWP 40R,A00,893757,Redela; Pamela Morgan,0,5,20,20
1746542440564,MCWP 50,A00,893758,Morshed; Michael James,0,0,20,20
1746542440564,MCWP 50,B00,893761,Bartulis; Jason Michael,17,0,20,3
1746542441598,MCWP 50R,A00,893766,Compas; Sean Matthew,0,1,20,20
1746542441598,MCWP 50R,B00,893769,Carter; Jennifer A,0,1,20,20
1746542441598,MCWP 50R,C00,893771,Krone; Jarret,0,3,20,20
1746542441598,MCWP 50R,D00,893772,Miller; Elizabeth Deen,0,0,20,20
1746542441598,MCWP 50R,E00,893775,Carter; Andrea L,0,1,20,20
1746542442627,MMW 11R,A01,892721,Herbst; Matthew,11,0,27,16
1746542442627,MMW 11R,A02,892722,Herbst; Matthew,0,0,0,3
1746542443651,MMW 12R,A01,892724,Herbst; Matthew,0,11,16,16
1746542443651,MMW 12R,A02,892725,Herbst; Matthew,0,10,16,16
1746542444678,MMW 13R,A01,892727,Staff,0,4,16,16
1746542444678,MMW 13R,A02,892728,Staff,0,4,16,16
1746542444678,MMW 13R,A03,958032,Staff,0,4,16,16
1746542444678,MMW 13R,A04,958033,Staff,0,4,16,16
1746542444678,MMW 13R,A05,958034,Staff,0,4,16,16
1746542445702,SIO 295LS,A00,894015,Staff,5,0,25,20
1746542446731,SIO 295S,A00,894020,Staff,5,0,25,20
1746542447762,SIOC 290S,B01,958918,Merrifield; Mark A,14,0,30,16
1746542448794,SIOC 291S,B01,958922,Gabriel; Corey John,14,0,30,16
1746542449826,SOCI 117,A01,895339,Staff,3,0,5,2
1746542450861,WES 237B,A00,894149,Staff,11,0,20,9
1746542452929,AESE 279B,A00,891859,Staff,13,0,35,22
1746542453956,AIP 197,001,891854,Vespa; Emanuel Ignacio,9999,0,9999,0
1746542454990,ANTH 289S,A00,891856,Gagneux; Pascal,12,0,12,0
1746542456018,BENG 196,001,957946,Engler; Adam J.,9996,0,9999,3
1746542457045,BISP 197,001,959851,Wilhelm; James E.,9999,0,9999,0
1746542458073,CAT 124RS,A01,956906,Staff,6,0,25,19
1746542459105,CAT 125RS,A01,922013,Staff,6,0,25,19
1746542460133,CLRE 250,A00,891860,Morris; Sheldon,9995,0,9999,4
1746542462200,CLRE 251R,A00,907817,Mehta; Ravindra L.,9994,0,9999,5
1746542463229,CLRE 252,A00,891864,Cuomo; Raphael Eduardo,9993,0,9999,6
1746542464255,CLRE 253,A00,891867,Vaida; Florin,9994,0,9999,5
1746542464255,CLRE 253,B00,907819,Staff,9999,0,9999,0
1746542465281,CLRE 259,A00,891868,Patel; Hemal,9998,0,9999,1
1746542466310,CLRE 260,A00,891872,Cuomo; Raphael Eduardo,9999,0,9999,0
1746542467338,CLRE 297,001,891888,Cuomo; Raphael Eduardo,9999,0,9999,0
1746542468368,CSE 191,A00,958773,Minnes Kemp; Mor Mia,9996,0,9999,3
1746542469397,CSE 197,001,959846,Minnes Kemp; Mor Mia,9993,0,9999,6
1746542470423,CSS 201S,A01,892054,Mignozzetti; Umberto,26,0,30,4
1746542471450,CSS 202S,A01,892056,Mignozzetti; Umberto,26,0,30,4
1746542472479,DSC 197,001,956898,Eldridge; Justin Matthew,9998,0,9999,1
1746542473505,DSC 297,001,958000,Mazumdar; Arya,9998,0,9999,1
1746542473505,DSC 297,002,959862,Wang; Yusu,9999,0,9999,0
1746542474537,EAP 100,A00,905686,Staff,9778,0,9999,221
1746542475568,ECE 45,A01,892618,Staff,0,0,65,65
1746542477622,ECE 111,A01,892719,Staff,4,0,65,61
1746542478651,ECE 197,001,957920,Mercier; Patrick Philip,9991,0,9999,8
1746542479680,ECON 178,A01,907814,Zhu; Ying,26,0,35,9
1746542480704,EDS 115,A00,895312,Staff,36,0,45,9
1746542481733,EDS 117,A01,895337,Staff,24,0,30,6
1746542482760,EDS 125,A00,895341,Jones; Gabrielle Anastasia,37,0,45,8
1746542483785,EDS 128A,A01,895459,Fargason; Sharon Gayle,44,0,45,1
1746542484815,EDS 128B,A01,895543,Pappas; Elizabeth,44,0,45,1
1746542485843,EDS 139,A00,897203,Pappas; Elizabeth,44,0,45,1
1746542485843,EDS 139,B00,897209,Fargason; Sharon Gayle,41,0,45,4
1746542486870,EDS 201,A00,895545,Staff,23,0,45,22
1746542487895,EDS 203,A01,895581,Halter; Christopher P.,23,0,45,22
1746542488922,EDS 204R,A01,895625,Heinzman; Erica M.,39,0,45,6
1746542488922,EDS 204R,B01,895693,Halter; Christopher P.,10,0,45,35
1746542489952,EDS 206R,A00,895694,Fargason; Sharon Gayle,1,0,30,29
1746542489952,EDS 206R,B00,895695,Choi; Bailey Miyeon,16,0,30,14
1746542490979,EDS 250,A00,895697,Hemans; Patricia Ann Benitez,23,0,45,22
1746542492004,EDS 281,A00,895701,Meyerott; Theresa Ann,1,0,15,14
1746542493034,EDS 284,A00,895736,Meyerott; Theresa Ann,1,0,15,14
1746542494059,EDS 286,A00,897210,Fine; Sarah,0,0,15,15
1746542495086,EDS 289C,A01,895770,Daly; Alan J.,15,0,15,0
1746542496113,EDS 290,A00,897211,Hofstetter; Carolyn,0,0,15,15
1746542497139,LIGM 5A,A00,896162,Fischer-Grunski; Eva K,13,0,20,7
1746542498165,LIGM 5B,A00,896260,Fischer-Grunski; Eva K,17,0,20,3
1746542499192,LIGM 5C,A00,896308,Fischer-Grunski; Eva K,18,0,20,2
1746542500221,LIIT 5AS,A00,896313,Carnelos; Chiara,18,0,20,2
1746542501248,LIIT 5BS,A00,896416,Carnelos; Chiara,20,0,20,0
1746542502276,LIIT 5CS,A00,896564,Carnelos; Chiara,20,0,20,0
1746542503302,LISP 5A,A00,896588,Munoz Sanchez; Alicia,3,0,20,17
1746542504330,LISP 5B,A00,896653,Munoz Sanchez; Alicia,7,0,20,13
1746542505360,LISP 5C,A00,896655,Munoz Sanchez; Alicia,0,1,20,20
1746542506386,MAE 197,001,957918,Kleissl; Jan,9996,0,9999,3
1746542506386,MAE 197,002,959806,Boechler; Nicholas Sebastia,9998,0,9999,1
1746542506386,MAE 197,003,959852,Mullin; Jennifer S,9999,0,9999,0
1746542507415,MATH 2,A01,957937,Staff,33,0,35,2
1746542508442,MATH 197,001,957876,Kedlaya; Kiran S.,9993,0,9999,6
1746542509473,MCWP 40,A00,892729,Duru; Nur,10,0,20,10
1746542509473,MCWP 40,B00,893304,Montejo; Carolina,14,0,20,6
1746542510500,MCWP 40R,A00,893757,Redela; Pamela Morgan,0,5,20,20
1746542511533,MCWP 50,A00,893758,Morshed; Michael James,0,0,20,20
1746542511533,MCWP 50,B00,893761,Bartulis; Jason Michael,17,0,20,3
1746542512561,MCWP 50R,A00,893766,Compas; Sean Matthew,0,1,20,20
1746542512561,MCWP 50R,B00,893769,Carter; Jennifer A,0,1,20,20
1746542512561,MCWP 50R,C00,893771,Krone; Jarret,0,3,20,20
1746542512561,MCWP 50R,D00,893772,Miller; Elizabeth Deen,0,0,20,20
1746542512561,MCWP 50R,E00,893775,Carter; Andrea L,0,1,20,20
1746542513589,MMW 11R,A01,892721,Herbst; Matthew,11,0,27,16
1746542513589,MMW 11R,A02,892722,Herbst; Matthew,0,0,0,3
1746542514632,MMW 12R,A01,892724,Herbst; Matthew,0,11,16,16
1746542514632,MMW 12R,A02,892725,Herbst; Matthew,0,10,16,16
1746542515656,MMW 13R,A01,892727,Staff,0,4,16,16
1746542515656,MMW 13R,A02,892728,Staff,0,4,16,16
1746542515656,MMW 13R,A03,958032,Staff,0,4,16,16
1746542515656,MMW 13R,A04,958033,Staff,0,4,16,16
1746542515656,MMW 13R,A05,958034,Staff,0,4,16,16
1746542516685,SIO 295LS,A00,894015,Staff,5,0,25,20
1746542517710,SIO 295S,A00,894020,Staff,5,0,25,20
1746542518743,SIOC 290S,B01,958918,Merrifield; Mark A,14,0,30,16
1746542519770,SIOC 291S,B01,958922,Gabriel; Corey John,14,0,30,16
1746542520800,SOCI 117,A01,895339,Staff,3,0,5,2
1746542521825,WES 237B,A00,894149,Staff,11,0,20,9
1746542523884,AESE 279B,A00,891859,Staff,13,0,35,22
1746542524909,AIP 197,001,891854,Vespa; Emanuel Ignacio,9999,0,9999,0
1746542525934,ANTH 289S,A00,891856,Gagneux; Pascal,12,0,12,0
1746542526969,BENG 196,001,957946,Engler; Adam J.,9996,0,9999,3
1746542527997,BISP 197,001,959851,Wilhelm; James E.,9999,0,9999,0
1746542529023,CAT 124RS,A01,956906,Staff,6,0,25,19
1746542530045,CAT 125RS,A01,922013,Staff,6,0,25,19
1746542531073,CLRE 250,A00,891860,Morris; Sheldon,9995,0,9999,4
1746542533127,CLRE 251R,A00,907817,Mehta; Ravindra L.,9994,0,9999,5
1746542534154,CLRE 252,A00,891864,Cuomo; Raphael Eduardo,9993,0,9999,6
1746542535177,CLRE 253,A00,891867,Vaida; Florin,9994,0,9999,5
1746542535177,CLRE 253,B00,907819,Staff,9999,0,9999,0
1746542536201,CLRE 259,A00,891868,Patel; Hemal,9998,0,9999,1
1746542537229,CLRE 260,A00,891872,Cuomo; Raphael Eduardo,9999,0,9999,0
1746542538256,CLRE 297,001,891888,Cuomo; Raphael Eduardo,9999,0,9999,0
1746542539282,CSE 191,A00,958773,Minnes Kemp; Mor Mia,9996,0,9999,3
1746542540310,CSE 197,001,959846,Minnes Kemp; Mor Mia,9993,0,9999,6
1746542541334,CSS 201S,A01,892054,Mignozzetti; Umberto,26,0,30,4
1746542542357,CSS 202S,A01,892056,Mignozzetti; Umberto,26,0,30,4
1746542543382,DSC 197,001,956898,Eldridge; Justin Matthew,9998,0,9999,1
1746542544411,DSC 297,001,958000,Mazumdar; Arya,9998,0,9999,1
1746542544411,DSC 297,002,959862,Wang; Yusu,9999,0,9999,0
1746542545435,EAP 100,A00,905686,Staff,9778,0,9999,221
1746542546460,ECE 45,A01,892618,Staff,0,0,65,65
1746542548511,ECE 111,A01,892719,Staff,4,0,65,61
1746542549536,ECE 197,001,957920,Mercier; Patrick Philip,9991,0,9999,8
1746542550563,ECON 178,A01,907814,Zhu; Ying,26,0,35,9
1746542551589,EDS 115,A00,895312,Staff,36,0,45,9
1746542552615,EDS 117,A01,895337,Staff,24,0,30,6
1746542553641,EDS 125,A00,895341,Jones; Gabrielle Anastasia,37,0,45,8
1746542554668,EDS 128A,A01,895459,Fargason; Sharon Gayle,44,0,45,1
1746542555694,EDS 128B,A01,895543,Pappas; Elizabeth,44,0,45,1
1746542556722,EDS 139,A00,897203,Pappas; Elizabeth,44,0,45,1
1746542556722,EDS 139,B00,897209,Fargason; Sharon Gayle,41,0,45,4
1746542557748,EDS 201,A00,895545,Staff,23,0,45,22
1746542558774,EDS 203,A01,895581,Halter; Christopher P.,23,0,45,22
1746542559800,EDS 204R,A01,895625,Heinzman; Erica M.,39,0,45,6
1746542559800,EDS 204R,B01,895693,Halter; Christopher P.,10,0,45,35
1746542560830,EDS 206R,A00,895694,Fargason; Sharon Gayle,1,0,30,29
1746542560830,EDS 206R,B00,895695,Choi; Bailey Miyeon,16,0,30,14
1746542561857,EDS 250,A00,895697,Hemans; Patricia Ann Benitez,23,0,45,22
1746542562882,EDS 281,A00,895701,Meyerott; Theresa Ann,1,0,15,14
1746542563910,EDS 284,A00,895736,Meyerott; Theresa Ann,1,0,15,14
1746542564936,EDS 286,A00,897210,Fine; Sarah,0,0,15,15
1746542565961,EDS 289C,A01,895770,Daly; Alan J.,15,0,15,0
1746542566988,EDS 290,A00,897211,Hofstetter; Carolyn,0,0,15,15
1746542568015,LIGM 5A,A00,896162,Fischer-Grunski; Eva K,13,0,20,7
1746542569040,LIGM 5B,A00,896260,Fischer-Grunski; Eva K,17,0,20,3
1746542570069,LIGM 5C,A00,896308,Fischer-Grunski; Eva K,18,0,20,2
1746542571094,LIIT 5AS,A00,896313,Carnelos; Chiara,18,0,20,2
1746542572118,LIIT 5BS,A00,896416,Carnelos; Chiara,20,0,20,0
1746542573148,LIIT 5CS,A00,896564,Carnelos; Chiara,20,0,20,0
1746542574178,LISP 5A,A00,896588,Munoz Sanchez; Alicia,3,0,20,17
1746542575207,LISP 5B,A00,896653,Munoz Sanchez; Alicia,7,0,20,13
1746542576234,LISP 5C,A00,896655,Munoz Sanchez; Alicia,0,1,20,20
1746542577264,MAE 197,001,957918,Kleissl; Jan,9996,0,9999,3
1746542577264,MAE 197,002,959806,Boechler; Nicholas Sebastia,9998,0,9999,1
1746542577264,MAE 197,003,959852,Mullin; Jennifer S,9999,0,9999,0
1746542578288,MATH 2,A01,957937,Staff,33,0,35,2
1746542579318,MATH 197,001,957876,Kedlaya; Kiran S.,9993,0,9999,6
1746542580346,MCWP 40,A00,892729,Duru; Nur,10,0,20,10
1746542580346,MCWP 40,B00,893304,Montejo; Carolina,14,0,20,6
1746542581371,MCWP 40R,A00,893757,Redela; Pamela Morgan,0,5,20,20
1746542582399,MCWP 50,A00,893758,Morshed; Michael James,0,0,20,20
1746542582399,MCWP 50,B00,893761,Bartulis; Jason Michael,17,0,20,3
1746542583447,MCWP 50R,A00,893766,Compas; Sean Matthew,0,1,20,20
1746542583447,MCWP 50R,B00,893769,Carter; Jennifer A,0,1,20,20
1746542583447,MCWP 50R,C00,893771,Krone; Jarret,0,3,20,20
1746542583447,MCWP 50R,D00,893772,Miller; Elizabeth Deen,0,0,20,20
1746542583447,MCWP 50R,E00,893775,Carter; Andrea L,0,1,20,20
1746542584473,MMW 11R,A01,892721,Herbst; Matthew,11,0,27,16
1746542584473,MMW 11R,A02,892722,Herbst; Matthew,0,0,0,3
1746542585498,MMW 12R,A01,892724,Herbst; Matthew,0,11,16,16
1746542585498,MMW 12R,A02,892725,Herbst; Matthew,0,10,16,16
1746542586523,MMW 13R,A01,892727,Staff,0,4,16,16
1746542586523,MMW 13R,A02,892728,Staff,0,4,16,16
1746542586523,MMW 13R,A03,958032,Staff,0,4,16,16
1746542586523,MMW 13R,A04,958033,Staff,0,4,16,16
1746542586523,MMW 13R,A05,958034,Staff,0,4,16,16
1746542587548,SIO 295LS,A00,894015,Staff,5,0,25,20
1746542588573,SIO 295S,A00,894020,Staff,5,0,25,20
1746542589602,SIOC 290S,B01,958918,Merrifield; Mark A,14,0,30,16
1746542590631,SIOC 291S,B01,958922,Gabriel; Corey John,14,0,30,16
1746542591657,SOCI 117,A01,895339,Staff,3,0,5,2
1746542592685,WES 237B,A00,894149,Staff,11,0,20,9
1746542594753,AESE 279B,A00,891859,Staff,13,0,35,22
1746542595779,AIP 197,001,891854,Vespa; Emanuel Ignacio,9999,0,9999,0
1746542596804,ANTH 289S,A00,891856,Gagneux; Pascal,12,0,12,0
1746542597830,BENG 196,001,957946,Engler; Adam J.,9996,0,9999,3
1746542598854,BISP 197,001,959851,Wilhelm; James E.,9999,0,9999,0
1746542599878,CAT 124RS,A01,956906,Staff,6,0,25,19
1746542600904,CAT 125RS,A01,922013,Staff,6,0,25,19
1746542601928,CLRE 250,A00,891860,Morris; Sheldon,9995,0,9999,4
1746542603982,CLRE 251R,A00,907817,Mehta; Ravindra L.,9994,0,9999,5
1746542605024,CLRE 252,A00,891864,Cuomo; Raphael Eduardo,9993,0,9999,6
1746542606050,CLRE 253,A00,891867,Vaida; Florin,9994,0,9999,5
1746542606050,CLRE 253,B00,907819,Staff,9999,0,9999,0
1746542607078,CLRE 259,A00,891868,Patel; Hemal,9998,0,9999,1
1746542608106,CLRE 260,A00,891872,Cuomo; Raphael Eduardo,9999,0,9999,0
1746542609131,CLRE 297,001,891888,Cuomo; Raphael Eduardo,9999,0,9999,0
1746542610155,CSE 191,A00,958773,Minnes Kemp; Mor Mia,9996,0,9999,3
1746542611181,CSE 197,001,959846,Minnes Kemp; Mor Mia,9993,0,9999,6
1746542612207,CSS 201S,A01,892054,Mignozzetti; Umberto,26,0,30,4
1746542613233,CSS 202S,A01,892056,Mignozzetti; Umberto,26,0,30,4
1746542614258,DSC 197,001,956898,Eldridge; Justin Matthew,9998,0,9999,1
1746542615282,DSC 297,001,958000,Mazumdar; Arya,9998,0,9999,1
1746542615282,DSC 297,002,959862,Wang; Yusu,9999,0,9999,0
1746542616311,EAP 100,A00,905686,Staff,9778,0,9999,221
1746542617341,ECE 45,A01,892618,Staff,0,0,65,65
1746542619394,ECE 111,A01,892719,Staff,4,0,65,61
1746542620419,ECE 197,001,957920,Mercier; Patrick Philip,9991,0,9999,8
1746542621447,ECON 178,A01,907814,Zhu; Ying,26,0,35,9
1746542622473,EDS 115,A00,895312,Staff,36,0,45,9
1746542623498,EDS 117,A01,895337,Staff,24,0,30,6
1746542624524,EDS 125,A00,895341,Jones; Gabrielle Anastasia,37,0,45,8
1746542625550,EDS 128A,A01,895459,Fargason; Sharon Gayle,44,0,45,1
1746542626577,EDS 128B,A01,895543,Pappas; Elizabeth,44,0,45,1
1746542627606,EDS 139,A00,897203,Pappas; Elizabeth,44,0,45,1
1746542627606,EDS 139,B00,897209,Fargason; Sharon Gayle,41,0,45,4
1746542628642,EDS 201,A00,895545,Staff,23,0,45,22
1746542629684,EDS 203,A01,895581,Halter; Christopher P.,23,0,45,22
1746542630713,EDS 204R,A01,895625,Heinzman; Erica M.,39,0,45,6
1746542630713,EDS 204R,B01,895693,Halter; Christopher P.,10,0,45,35
1746542631744,EDS 206R,A00,895694,Fargason; Sharon Gayle,1,0,30,29
1746542631744,EDS 206R,B00,895695,Choi; Bailey Miyeon,16,0,30,14
1746542632775,EDS 250,A00,895697,Hemans; Patricia Ann Benitez,23,0,45,22
1746542633799,EDS 281,A00,895701,Meyerott; Theresa Ann,1,0,15,14
1746542634824,EDS 284,A00,895736,Meyerott; Theresa Ann,1,0,15,14
1746542635852,EDS 286,A00,897210,Fine; Sarah,0,0,15,15
1746542636876,EDS 289C,A01,895770,Daly; Alan J.,15,0,15,0
1746542637901,EDS 290,A00,897211,Hofstetter; Carolyn,0,0,15,15
1746542638928,LIGM 5A,A00,896162,Fischer-Grunski; Eva K,13,0,20,7
1746542639956,LIGM 5B,A00,896260,Fischer-Grunski; Eva K,17,0,20,3
1746542640981,LIGM 5C,A00,896308,Fischer-Grunski; Eva K,18,0,20,2
1746542642012,LIIT 5AS,A00,896313,Carnelos; Chiara,18,0,20,2
1746542643035,LIIT 5BS,A00,896416,Carnelos; Chiara,20,0,20,0
1746542644064,LIIT 5CS,A00,896564,Carnelos; Chiara,20,0,20,0
1746542645091,LISP 5A,A00,896588,Munoz Sanchez; Alicia,3,0,20,17
1746542646114,LISP 5B,A00,896653,Munoz Sanchez; Alicia,7,0,20,13
1746542647140,LISP 5C,A00,896655,Munoz Sanchez; Alicia,0,1,20,20
1746542648168,MAE 197,001,957918,Kleissl; Jan,9996,0,9999,3
1746542648168,MAE 197,002,959806,Boechler; Nicholas Sebastia,9998,0,9999,1
1746542648168,MAE 197,003,959852,Mullin; Jennifer S,9999,0,9999,0
1746542649196,MATH 2,A01,957937,Staff,33,0,35,2
1746542650222,MATH 197,001,957876,Kedlaya; Kiran S.,9993,0,9999,6
1746542651252,MCWP 40,A00,892729,Duru; Nur,10,0,20,10
1746542651252,MCWP 40,B00,893304,Montejo; Carolina,14,0,20,6
1746542652281,MCWP 40R,A00,893757,Redela; Pamela Morgan,0,5,20,20
1746542653307,MCWP 50,A00,893758,Morshed; Michael James,0,0,20,20
1746542653307,MCWP 50,B00,893761,Bartulis; Jason Michael,17,0,20,3
1746542654343,MCWP 50R,A00,893766,Compas; Sean Matthew,0,1,20,20
1746542654343,MCWP 50R,B00,893769,Carter; Jennifer A,0,1,20,20
1746542654343,MCWP 50R,C00,893771,Krone; Jarret,0,3,20,20
1746542654343,MCWP 50R,D00,893772,Miller; Elizabeth Deen,0,0,20,20
1746542654343,MCWP 50R,E00,893775,Carter; Andrea L,0,1,20,20
1746542655369,MMW 11R,A01,892721,Herbst; Matthew,11,0,27,16
1746542655369,MMW 11R,A02,892722,Herbst; Matthew,0,0,0,3
1746542656393,MMW 12R,A01,892724,Herbst; Matthew,0,11,16,16
1746542656393,MMW 12R,A02,892725,Herbst; Matthew,0,10,16,16
1746542657419,MMW 13R,A01,892727,Staff,0,4,16,16
1746542657419,MMW 13R,A02,892728,Staff,0,4,16,16
1746542657419,MMW 13R,A03,958032,Staff,0,4,16,16
1746542657419,MMW 13R,A04,958033,Staff,0,4,16,16
1746542657419,MMW 13R,A05,958034,Staff,0,4,16,16
1746542658446,SIO 295LS,A00,894015,Staff,5,0,25,20
1746542659473,SIO 295S,A00,894020,Staff,5,0,25,20
1746542660500,SIOC 290S,B01,958918,Merrifield; Mark A,14,0,30,16
1746542661527,SIOC 291S,B01,958922,Gabriel; Corey John,14,0,30,16
1746542662554,SOCI 117,A01,895339,Staff,3,0,5,2
1746542663582,WES 237B,A00,894149,Staff,11,0,20,9
1746542665656,AESE 279B,A00,891859,Staff,13,0,35,22
1746542666683,AIP 197,001,891854,Vespa; Emanuel Ignacio,9999,0,9999,0
1746542667708,ANTH 289S,A00,891856,Gagneux; Pascal,12,0,12,0
1746542668735,BENG 196,001,957946,Engler; Adam J.,9996,0,9999,3
1746542669760,BISP 197,001,959851,Wilhelm; James E.,9999,0,9999,0
1746542670787,CAT 124RS,A01,956906,Staff,6,0,25,19
1746542671813,CAT 125RS,A01,922013,Staff,6,0,25,19
1746542672839,CLRE 250,A00,891860,Morris; Sheldon,9995,0,9999,4
1746542674891,CLRE 251R,A00,907817,Mehta; Ravindra L.,9994,0,9999,5
1746542675919,CLRE 252,A00,891864,Cuomo; Raphael Eduardo,9993,0,9999,6
1746542676948,CLRE 253,A00,891867,Vaida; Florin,9994,0,9999,5
1746542676948,CLRE 253,B00,907819,Staff,9999,0,9999,0
1746542677971,CLRE 259,A00,891868,Patel; Hemal,9998,0,9999,1
1746542678999,CLRE 260,A00,891872,Cuomo; Raphael Eduardo,9999,0,9999,0
1746542680026,CLRE 297,001,891888,Cuomo; Raphael Eduardo,9999,0,9999,0
1746542681050,CSE 191,A00,958773,Minnes Kemp; Mor Mia,9996,0,9999,3
1746542682077,CSE 197,001,959846,Minnes Kemp; Mor Mia,9993,0,9999,6
1746542683106,CSS 201S,A01,892054,Mignozzetti; Umberto,26,0,30,4
1746542684134,CSS 202S,A01,892056,Mignozzetti; Umberto,26,0,30,4
1746542685161,DSC 197,001,956898,Eldridge; Justin Matthew,9998,0,9999,1
1746542686189,DSC 297,001,958000,Mazumdar; Arya,9998,0,9999,1
1746542686189,DSC 297,002,959862,Wang; Yusu,9999,0,9999,0
1746542687215,EAP 100,A00,905686,Staff,9778,0,9999,221
1746542688243,ECE 45,A01,892618,Staff,0,0,65,65
1746542690298,ECE 111,A01,892719,Staff,4,0,65,61
1746542691323,ECE 197,001,957920,Mercier; Patrick Philip,9991,0,9999,8
1746542692349,ECON 178,A01,907814,Zhu; Ying,26,0,35,9
1746542693374,EDS 115,A00,895312,Staff,36,0,45,9
1746542694399,EDS 117,A01,895337,Staff,24,0,30,6
1746542695426,EDS 125,A00,895341,Jones; Gabrielle Anastasia,37,0,45,8
1746542696452,EDS 128A,A01,895459,Fargason; Sharon Gayle,44,0,45,1
1746542697482,EDS 128B,A01,895543,Pappas; Elizabeth,44,0,45,1
1746542698509,EDS 139,A00,897203,Pappas; Elizabeth,44,0,45,1
1746542698509,EDS 139,B00,897209,Fargason; Sharon Gayle,41,0,45,4
1746542699534,EDS 201,A00,895545,Staff,23,0,45,22
1746542700559,EDS 203,A01,895581,Halter; Christopher P.,23,0,45,22
1746542701588,EDS 204R,A01,895625,Heinzman; Erica M.,39,0,45,6
1746542701588,EDS 204R,B01,895693,Halter; Christopher P.,10,0,45,35
1746542702613,EDS 206R,A00,895694,Fargason; Sharon Gayle,1,0,30,29
1746542702613,EDS 206R,B00,895695,Choi; Bailey Miyeon,16,0,30,14
1746542703640,EDS 250,A00,895697,Hemans; Patricia Ann Benitez,23,0,45,22
1746542704665,EDS 281,A00,895701,Meyerott; Theresa Ann,1,0,15,14
1746542705690,EDS 284,A00,895736,Meyerott; Theresa Ann,1,0,15,14
1746542706714,EDS 286,A00,897210,Fine; Sarah,0,0,15,15
1746542707742,EDS 289C,A01,895770,Daly; Alan J.,15,0,15,0
1746542708766,EDS 290,A00,897211,Hofstetter; Carolyn,0,0,15,15
1746542709793,LIGM 5A,A00,896162,Fischer-Grunski; Eva K,13,0,20,7
1746542710841,LIGM 5B,A00,896260,Fischer-Grunski; Eva K,17,0,20,3
1746542711870,LIGM 5C,A00,896308,Fischer-Grunski; Eva K,18,0,20,2
1746542712897,LIIT 5AS,A00,896313,Carnelos; Chiara,18,0,20,2
1746542713922,LIIT 5BS,A00,896416,Carnelos; Chiara,20,0,20,0
1746542714946,LIIT 5CS,A00,896564,Carnelos; Chiara,20,0,20,0
1746542715972,LISP 5A,A00,896588,Munoz Sanchez; Alicia,3,0,20,17
1746542717000,LISP 5B,A00,896653,Munoz Sanchez; Alicia,7,0,20,13
1746542718031,LISP 5C,A00,896655,Munoz Sanchez; Alicia,0,1,20,20
1746542719057,MAE 197,001,957918,Kleissl; Jan,9996,0,9999,3
1746542719057,MAE 197,002,959806,Boechler; Nicholas Sebastia,9998,0,9999,1
1746542719057,MAE 197,003,959852,Mullin; Jennifer S,9999,0,9999,0
1746542720082,MATH 2,A01,957937,Staff,33,0,35,2
1746542721106,MATH 197,001,957876,Kedlaya; Kiran S.,9993,0,9999,6
1746542722131,MCWP 40,A00,892729,Duru; Nur,10,0,20,10
1746542722131,MCWP 40,B00,893304,Montejo; Carolina,14,0,20,6
1746542723157,MCWP 40R,A00,893757,Redela; Pamela Morgan,0,5,20,20
1746542724183,MCWP 50,A00,893758,Morshed; Michael James,0,0,20,20
1746542724183,MCWP 50,B00,893761,Bartulis; Jason Michael,17,0,20,3
1746542725208,MCWP 50R,A00,893766,Compas; Sean Matthew,0,1,20,20
1746542725208,MCWP 50R,B00,893769,Carter; Jennifer A,0,1,20,20
1746542725208,MCWP 50R,C00,893771,Krone; Jarret,0,3,20,20
1746542725208,MCWP 50R,D00,893772,Miller; Elizabeth Deen,0,0,20,20
1746542725208,MCWP 50R,E00,893775,Carter; Andrea L,0,1,20,20
1746542726239,MMW 11R,A01,892721,Herbst; Matthew,11,0,27,16
1746542726239,MMW 11R,A02,892722,Herbst; Matthew,0,0,0,3
1746542727269,MMW 12R,A01,892724,Herbst; Matthew,0,11,16,16
1746542727269,MMW 12R,A02,892725,Herbst; Matthew,0,10,16,16
1746542728297,MMW 13R,A01,892727,Staff,0,4,16,16
1746542728297,MMW 13R,A02,892728,Staff,0,4,16,16
1746542728297,MMW 13R,A03,958032,Staff,0,4,16,16
1746542728297,MMW 13R,A04,958033,Staff,0,4,16,16
1746542728297,MMW 13R,A05,958034,Staff,0,4,16,16
1746542729322,SIO 295LS,A00,894015,Staff,5,0,25,20
1746542730350,SIO 295S,A00,894020,Staff,5,0,25,20
1746542731378,SIOC 290S,B01,958918,Merrifield; Mark A,14,0,30,16
1746542732405,SIOC 291S,B01,958922,Gabriel; Corey John,14,0,30,16
1746542733430,SOCI 117,A01,895339,Staff,3,0,5,2
1746542734457,WES 237B,A00,894149,Staff,11,0,20,9
1746542736561,AESE 279B,A00,891859,Staff,13,0,35,22
1746542737587,AIP 197,001,891854,Vespa; Emanuel Ignacio,9999,0,9999,0
1746542738616,ANTH 289S,A00,891856,Gagneux; Pascal,12,0,12,0
1746542739640,BENG 196,001,957946,Engler; Adam J.,9996,0,9999,3
1746542740667,BISP 197,001,959851,Wilhelm; James E.,9999,0,9999,0
1746542741697,CAT 124RS,A01,956906,Staff,6,0,25,19
1746542742721,CAT 125RS,A01,922013,Staff,6,0,25,19
1746542743750,CLRE 250,A00,891860,Morris; Sheldon,9995,0,9999,4
1746542745806,CLRE 251R,A00,907817,Mehta; Ravindra L.,9994,0,9999,5
1746542746833,CLRE 252,A00,891864,Cuomo; Raphael Eduardo,9993,0,9999,6
1746542747859,CLRE 253,A00,891867,Vaida; Florin,9994,0,9999,5
1746542747859,CLRE 253,B00,907819,Staff,9999,0,9999,0
1746542748885,CLRE 259,A00,891868,Patel; Hemal,9998,0,9999,1
1746542749911,CLRE 260,A00,891872,Cuomo; Raphael Eduardo,9999,0,9999,0
1746542750938,CLRE 297,001,891888,Cuomo; Raphael Eduardo,9999,0,9999,0
1746542751963,CSE 191,A00,958773,Minnes Kemp; Mor Mia,9996,0,9999,3
1746542752990,CSE 197,001,959846,Minnes Kemp; Mor Mia,9993,0,9999,6
1746542754020,CSS 201S,A01,892054,Mignozzetti; Umberto,26,0,30,4
1746542755047,CSS 202S,A01,892056,Mignozzetti; Umberto,26,0,30,4
1746542756076,DSC 197,001,956898,Eldridge; Justin Matthew,9998,0,9999,1
1746542757101,DSC 297,001,958000,Mazumdar; Arya,9998,0,9999,1
1746542757101,DSC 297,002,959862,Wang; Yusu,9999,0,9999,0
1746542758128,EAP 100,A00,905686,Staff,9778,0,9999,221
1746542759166,ECE 45,A01,892618,Staff,0,0,65,65
1746542761219,ECE 111,A01,892719,Staff,4,0,65,61
1746542762243,ECE 197,001,957920,Mercier; Patrick Philip,9991,0,9999,8
1746542763274,ECON 178,A01,907814,Zhu; Ying,26,0,35,9
1746542764300,EDS 115,A00,895312,Staff,36,0,45,9
1746542765324,EDS 117,A01,895337,Staff,24,0,30,6
1746542766352,EDS 125,A00,895341,Jones; Gabrielle Anastasia,37,0,45,8
1746542767377,EDS 128A,A01,895459,Fargason; Sharon Gayle,44,0,45,1
1746542768406,EDS 128B,A01,895543,Pappas; Elizabeth,44,0,45,1
1746542769436,EDS 139,A00,897203,Pappas; Elizabeth,44,0,45,1
1746542769436,EDS 139,B00,897209,Fargason; Sharon Gayle,41,0,45,4
1746542770465,EDS 201,A00,895545,Staff,23,0,45,22
1746542771492,EDS 203,A01,895581,Halter; Christopher P.,23,0,45,22
1746542772522,EDS 204R,A01,895625,Heinzman; Erica M.,39,0,45,6
1746542772522,EDS 204R,B01,895693,Halter; Christopher P.,10,0,45,35
1746542773547,EDS 206R,A00,895694,Fargason; Sharon Gayle,1,0,30,29
1746542773547,EDS 206R,B00,895695,Choi; Bailey Miyeon,16,0,30,14
1746542774573,EDS 250,A00,895697,Hemans; Patricia Ann Benitez,23,0,45,22
1746542775601,EDS 281,A00,895701,Meyerott; Theresa Ann,1,0,15,14
1746542776628,EDS 284,A00,895736,Meyerott; Theresa Ann,1,0,15,14
1746542777654,EDS 286,A00,897210,Fine; Sarah,0,0,15,15
1746542778681,EDS 289C,A01,895770,Daly; Alan J.,15,0,15,0
1746542779708,EDS 290,A00,897211,Hofstetter; Carolyn,0,0,15,15
1746542780737,LIGM 5A,A00,896162,Fischer-Grunski; Eva K,13,0,20,7
1746542781764,LIGM 5B,A00,896260,Fischer-Grunski; Eva K,17,0,20,3
1746542782791,LIGM 5C,A00,896308,Fischer-Grunski; Eva K,18,0,20,2
1746542783821,LIIT 5AS,A00,896313,Carnelos; Chiara,18,0,20,2
1746542784848,LIIT 5BS,A00,896416,Carnelos; Chiara,20,0,20,0
1746542785872,LIIT 5CS,A00,896564,Carnelos; Chiara,20,0,20,0
1746542786897,LISP 5A,A00,896588,Munoz Sanchez; Alicia,3,0,20,17
1746542787923,LISP 5B,A00,896653,Munoz Sanchez; Alicia,7,0,20,13
1746542788947,LISP 5C,A00,896655,Munoz Sanchez; Alicia,0,1,20,20
1746542789974,MAE 197,001,957918,Kleissl; Jan,9996,0,9999,3
1746542789974,MAE 197,002,959806,Boechler; Nicholas Sebastia,9998,0,9999,1
1746542789974,MAE 197,003,959852,Mullin; Jennifer S,9999,0,9999,0
1746542790999,MATH 2,A01,957937,Staff,33,0,35,2
1746542792024,MATH 197,001,957876,Kedlaya; Kiran S.,9993,0,9999,6
1746542793053,MCWP 40,A00,892729,Duru; Nur,10,0,20,10
1746542793053,MCWP 40,B00,893304,Montejo; Carolina,14,0,20,6
1746542794080,MCWP 40R,A00,893757,Redela; Pamela Morgan,0,5,20,20
1746542795107,MCWP 50,A00,893758,Morshed; Michael James,0,0,20,20
1746542795107,MCWP 50,B00,893761,Bartulis; Jason Michael,17,0,20,3
1746542796131,MCWP 50R,A00,893766,Compas; Sean Matthew,0,1,20,20
1746542796131,MCWP 50R,B00,893769,Carter; Jennifer A,0,1,20,20
1746542796131,MCWP 50R,C00,893771,Krone; Jarret,0,3,20,20
1746542796131,MCWP 50R,D00,893772,Miller; Elizabeth Deen,0,0,20,20
1746542796131,MCWP 50R,E00,893775,Carter; Andrea L,0,1,20,20
1746542797161,MMW 11R,A01,892721,Herbst; Matthew,11,0,27,16
1746542797161,MMW 11R,A02,892722,Herbst; Matthew,0,0,0,3
1746542798192,MMW 12R,A01,892724,Herbst; Matthew,0,11,16,16
1746542798192,MMW 12R,A02,892725,Herbst; Matthew,0,10,16,16
1746542799221,MMW 13R,A01,892727,Staff,0,4,16,16
1746542799221,MMW 13R,A02,892728,Staff,0,4,16,16
1746542799221,MMW 13R,A03,958032,Staff,0,4,16,16
1746542799221,MMW 13R,A04,958033,Staff,0,4,16,16
1746542799221,MMW 13R,A05,958034,Staff,0,4,16,16
1746542800246,SIO 295LS,A00,894015,Staff,5,0,25,20
1746542801275,SIO 295S,A00,894020,Staff,5,0,25,20
1746542802304,SIOC 290S,B01,958918,Merrifield; Mark A,14,0,30,16
1746542803329,SIOC 291S,B01,958922,Gabriel; Corey John,14,0,30,16
1746542804356,SOCI 117,A01,895339,Staff,3,0,5,2
1746542805393,WES 237B,A00,894149,Staff,11,0,20,9
1746542807462,AESE 279B,A00,891859,Staff,13,0,35,22
1746542808487,AIP 197,001,891854,Vespa; Emanuel Ignacio,9999,0,9999,0
1746542809514,ANTH 289S,A00,891856,Gagneux; Pascal,12,0,12,0
1746542810541,BENG 196,001,957946,Engler; Adam J.,9996,0,9999,3
1746542811566,BISP 197,001,959851,Wilhelm; James E.,9999,0,9999,0
1746542812590,CAT 124RS,A01,956906,Staff,6,0,25,19
1746542813616,CAT 125RS,A01,922013,Staff,6,0,25,19
1746542814643,CLRE 250,A00,891860,Morris; Sheldon,9995,0,9999,4
1746542816696,CLRE 251R,A00,907817,Mehta; Ravindra L.,9994,0,9999,5
1746542817726,CLRE 252,A00,891864,Cuomo; Raphael Eduardo,9993,0,9999,6
1746542818751,CLRE 253,A00,891867,Vaida; Florin,9994,0,9999,5
1746542818751,CLRE 253,B00,907819,Staff,9999,0,9999,0
1746542819826,CLRE 259,A00,891868,Patel; Hemal,9998,0,9999,1
1746542820851,CLRE 260,A00,891872,Cuomo; Raphael Eduardo,9999,0,9999,0
1746542821877,CLRE 297,001,891888,Cuomo; Raphael Eduardo,9999,0,9999,0
1746542822905,CSE 191,A00,958773,Minnes Kemp; Mor Mia,9996,0,9999,3
1746542823932,CSE 197,001,959846,Minnes Kemp; Mor Mia,9993,0,9999,6
1746542824956,CSS 201S,A01,892054,Mignozzetti; Umberto,26,0,30,4
1746542825983,CSS 202S,A01,892056,Mignozzetti; Umberto,26,0,30,4
1746542827009,DSC 197,001,956898,Eldridge; Justin Matthew,9998,0,9999,1
1746542828034,DSC 297,001,958000,Mazumdar; Arya,9998,0,9999,1
1746542828034,DSC 297,002,959862,Wang; Yusu,9999,0,9999,0
1746542829062,EAP 100,A00,905686,Staff,9778,0,9999,221
1746542830093,ECE 45,A01,892618,Staff,0,0,65,65
1746542832142,ECE 111,A01,892719,Staff,4,0,65,61
1746542833168,ECE 197,001,957920,Mercier; Patrick Philip,9991,0,9999,8
1746542834194,ECON 178,A01,907814,Zhu; Ying,26,0,35,9
1746542835219,EDS 115,A00,895312,Staff,36,0,45,9
1746542836247,EDS 117,A01,895337,Staff,24,0,30,6
1746542837272,EDS 125,A00,895341,Jones; Gabrielle Anastasia,37,0,45,8
1746542838297,EDS 128A,A01,895459,Fargason; Sharon Gayle,44,0,45,1
1746542839323,EDS 128B,A01,895543,Pappas; Elizabeth,44,0,45,1
1746542840348,EDS 139,A00,897203,Pappas; Elizabeth,44,0,45,1
1746542840348,EDS 139,B00,897209,Fargason; Sharon Gayle,41,0,45,4
1746542841375,EDS 201,A00,895545,Staff,23,0,45,22
1746542842407,EDS 203,A01,895581,Halter; Christopher P.,23,0,45,22
1746542843434,EDS 204R,A01,895625,Heinzman; Erica M.,39,0,45,6
1746542843434,EDS 204R,B01,895693,Halter; Christopher P.,10,0,45,35
1746542844459,EDS 206R,A00,895694,Fargason; Sharon Gayle,1,0,30,29
1746542844459,EDS 206R,B00,895695,Choi; Bailey Miyeon,16,0,30,14
1746542845487,EDS 250,A00,895697,Hemans; Patricia Ann Benitez,23,0,45,22
1746542846512,EDS 281,A00,895701,Meyerott; Theresa Ann,1,0,15,14
1746542847537,EDS 284,A00,895736,Meyerott; Theresa Ann,1,0,15,14
1746542848563,EDS 286,A00,897210,Fine; Sarah,0,0,15,15
1746542849588,EDS 289C,A01,895770,Daly; Alan J.,15,0,15,0
1746542850617,EDS 290,A00,897211,Hofstetter; Carolyn,0,0,15,15
1746542851646,LIGM 5A,A00,896162,Fischer-Grunski; Eva K,13,0,20,7
1746542852675,LIGM 5B,A00,896260,Fischer-Grunski; Eva K,17,0,20,3
1746542853718,LIGM 5C,A00,896308,Fischer-Grunski; Eva K,18,0,20,2
1746542854747,LIIT 5AS,A00,896313,Carnelos; Chiara,18,0,20,2
1746542855773,LIIT 5BS,A00,896416,Carnelos; Chiara,20,0,20,0
1746542856799,LIIT 5CS,A00,896564,Carnelos; Chiara,20,0,20,0
1746542857830,LISP 5A,A00,896588,Munoz Sanchez; Alicia,3,0,20,17
1746542858855,LISP 5B,A00,896653,Munoz Sanchez; Alicia,7,0,20,13
1746542859882,LISP 5C,A00,896655,Munoz Sanchez; Alicia,0,1,20,20
1746542860907,MAE 197,001,957918,Kleissl; Jan,9996,0,9999,3
1746542860907,MAE 197,002,959806,Boechler; Nicholas Sebastia,9998,0,9999,1
1746542860907,MAE 197,003,959852,Mullin; Jennifer S,9999,0,9999,0
1746542861934,MATH 2,A01,957937,Staff,33,0,35,2
1746542862963,MATH 197,001,957876,Kedlaya; Kiran S.,9993,0,9999,6
1746542863991,MCWP 40,A00,892729,Duru; Nur,10,0,20,10
1746542863991,MCWP 40,B00,893304,Montejo; Carolina,14,0,20,6
1746542865021,MCWP 40R,A00,893757,Redela; Pamela Morgan,0,5,20,20
1746542866050,MCWP 50,A00,893758,Morshed; Michael James,0,0,20,20
1746542866050,MCWP 50,B00,893761,Bartulis; Jason Michael,17,0,20,3
1746542867080,MCWP 50R,A00,893766,Compas; Sean Matthew,0,1,20,20
1746542867080,MCWP 50R,B00,893769,Carter; Jennifer A,0,1,20,20
1746542867080,MCWP 50R,C00,893771,Krone; Jarret,0,3,20,20
1746542867080,MCWP 50R,D00,893772,Miller; Elizabeth Deen,0,0,20,20
1746542867080,MCWP 50R,E00,893775,Carter; Andrea L,0,1,20,20
1746542868106,MMW 11R,A01,892721,Herbst; Matthew,11,0,27,16
1746542868106,MMW 11R,A02,892722,Herbst; Matthew,0,0,0,3
1746542869132,MMW 12R,A01,892724,Herbst; Matthew,0,11,16,16
1746542869132,MMW 12R,A02,892725,Herbst; Matthew,0,10,16,16
1746542870160,MMW 13R,A01,892727,Staff,0,4,16,16
1746542870160,MMW 13R,A02,892728,Staff,0,4,16,16
1746542870160,MMW 13R,A03,958032,Staff,0,4,16,16
1746542870160,MMW 13R,A04,958033,Staff,0,4,16,16
1746542870160,MMW 13R,A05,958034,Staff,0,4,16,16
1746542871184,SIO 295LS,A00,894015,Staff,5,0,25,20
1746542872209,SIO 295S,A00,894020,Staff,5,0,25,20
1746542873234,SIOC 290S,B01,958918,Merrifield; Mark A,14,0,30,16
1746542874266,SIOC 291S,B01,958922,Gabriel; Corey John,14,0,30,16
1746542875295,SOCI 117,A01,895339,Staff,3,0,5,2
1746542876324,WES 237B,A00,894149,Staff,11,0,20,9
1746542878388,AESE 279B,A00,891859,Staff,13,0,35,22
1746542879417,AIP 197,001,891854,Vespa; Emanuel Ignacio,9999,0,9999,0
1746542880442,ANTH 289S,A00,891856,Gagneux; Pascal,12,0,12,0
1746542881466,BENG 196,001,957946,Engler; Adam J.,9996,0,9999,3
1746542882496,BISP 197,001,959851,Wilhelm; James E.,9999,0,9999,0
1746542883521,CAT 124RS,A01,956906,Staff,6,0,25,19
1746542884547,CAT 125RS,A01,922013,Staff,6,0,25,19
1746542885571,CLRE 250,A00,891860,Morris; Sheldon,9995,0,9999,4
1746542887624,CLRE 251R,A00,907817,Mehta; Ravindra L.,9994,0,9999,5
1746542888647,CLRE 252,A00,891864,Cuomo; Raphael Eduardo,9993,0,9999,6
1746542889679,CLRE 253,A00,891867,Vaida; Florin,9994,0,9999,5
1746542889679,CLRE 253,B00,907819,Staff,9999,0,9999,0
1746542890707,CLRE 259,A00,891868,Patel; Hemal,9998,0,9999,1
1746542891735,CLRE 260,A00,891872,Cuomo; Raphael Eduardo,9999,0,9999,0
1746542892760,CLRE 297,001,891888,Cuomo; Raphael Eduardo,9999,0,9999,0
1746542893789,CSE 191,A00,958773,Minnes Kemp; Mor Mia,9996,0,9999,3
1746542894817,CSE 197,001,959846,Minnes Kemp; Mor Mia,9993,0,9999,6
1746542895844,CSS 201S,A01,892054,Mignozzetti; Umberto,26,0,30,4
1746542896875,CSS 202S,A01,892056,Mignozzetti; Umberto,26,0,30,4
1746542897902,DSC 197,001,956898,Eldridge; Justin Matthew,9998,0,9999,1
1746542898931,DSC 297,001,958000,Mazumdar; Arya,9998,0,9999,1
1746542898931,DSC 297,002,959862,Wang; Yusu,9999,0,9999,0
1746542899958,EAP 100,A00,905686,Staff,9778,0,9999,221
1746542900983,ECE 45,A01,892618,Staff,0,0,65,65
1746542903032,ECE 111,A01,892719,Staff,4,0,65,61
1746542904061,ECE 197,001,957920,Mercier; Patrick Philip,9991,0,9999,8
1746542905091,ECON 178,A01,907814,Zhu; Ying,26,0,35,9
1746542906115,EDS 115,A00,895312,Staff,36,0,45,9
1746542907141,EDS 117,A01,895337,Staff,24,0,30,6
1746542908171,EDS 125,A00,895341,Jones; Gabrielle Anastasia,37,0,45,8
1746542909196,EDS 128A,A01,895459,Fargason; Sharon Gayle,44,0,45,1
1746542910226,EDS 128B,A01,895543,Pappas; Elizabeth,44,0,45,1
1746542911250,EDS 139,A00,897203,Pappas; Elizabeth,44,0,45,1
1746542911250,EDS 139,B00,897209,Fargason; Sharon Gayle,41,0,45,4
1746542912278,EDS 201,A00,895545,Staff,23,0,45,22
1746542913304,EDS 203,A01,895581,Halter; Christopher P.,23,0,45,22
1746542914329,EDS 204R,A01,895625,Heinzman; Erica M.,39,0,45,6
1746542914329,EDS 204R,B01,895693,Halter; Christopher P.,10,0,45,35
1746542915362,EDS 206R,A00,895694,Fargason; Sharon Gayle,1,0,30,29
1746542915362,EDS 206R,B00,895695,Choi; Bailey Miyeon,16,0,30,14
1746542916389,EDS 250,A00,895697,Hemans; Patricia Ann Benitez,23,0,45,22
1746542917414,EDS 281,A00,895701,Meyerott; Theresa Ann,1,0,15,14
1746542918440,EDS 284,A00,895736,Meyerott; Theresa Ann,1,0,15,14
1746542919464,EDS 286,A00,897210,Fine; Sarah,0,0,15,15
1746542920490,EDS 289C,A01,895770,Daly; Alan J.,15,0,15,0
1746542921517,EDS 290,A00,897211,Hofstetter; Carolyn,0,0,15,15
1746542922600,LIGM 5A,A00,896162,Fischer-Grunski; Eva K,13,0,20,7
1746542923631,LIGM 5B,A00,896260,Fischer-Grunski; Eva K,17,0,20,3
1746542924657,LIGM 5C,A00,896308,Fischer-Grunski; Eva K,18,0,20,2
1746542925683,LIIT 5AS,A00,896313,Carnelos; Chiara,18,0,20,2
1746542926712,LIIT 5BS,A00,896416,Carnelos; Chiara,20,0,20,0
1746542927737,LIIT 5CS,A00,896564,Carnelos; Chiara,20,0,20,0
1746542928763,LISP 5A,A00,896588,Munoz Sanchez; Alicia,3,0,20,17
1746542929791,LISP 5B,A00,896653,Munoz Sanchez; Alicia,7,0,20,13
1746542930815,LISP 5C,A00,896655,Munoz Sanchez; Alicia,0,1,20,20
1746542931840,MAE 197,001,957918,Kleissl; Jan,9996,0,9999,3
1746542931840,MAE 197,002,959806,Boechler; Nicholas Sebastia,9998,0,9999,1
1746542931840,MAE 197,003,959852,Mullin; Jennifer S,9999,0,9999,0
1746542932865,MATH 2,A01,957937,Staff,33,0,35,2
1746542933890,MATH 197,001,957876,Kedlaya; Kiran S.,9993,0,9999,6
1746542934916,MCWP 40,A00,892729,Duru; Nur,10,0,20,10
1746542934916,MCWP 40,B00,893304,Montejo; Carolina,14,0,20,6
1746542935944,MCWP 40R,A00,893757,Redela; Pamela Morgan,0,5,20,20
1746542936972,MCWP 50,A00,893758,Morshed; Michael James,0,0,20,20
1746542936972,MCWP 50,B00,893761,Bartulis; Jason Michael,17,0,20,3
1746542937996,MCWP 50R,A00,893766,Compas; Sean Matthew,0,1,20,20
1746542937996,MCWP 50R,B00,893769,Carter; Jennifer A,0,1,20,20
1746542937996,MCWP 50R,C00,893771,Krone; Jarret,0,3,20,20
1746542937996,MCWP 50R,D00,893772,Miller; Elizabeth Deen,0,0,20,20
1746542937996,MCWP 50R,E00,893775,Carter; Andrea L,0,1,20,20
1746542939024,MMW 11R,A01,892721,Herbst; Matthew,11,0,27,16
1746542939024,MMW 11R,A02,892722,Herbst; Matthew,0,0,0,3
1746542940051,MMW 12R,A01,892724,Herbst; Matthew,0,11,16,16
1746542940051,MMW 12R,A02,892725,Herbst; Matthew,0,10,16,16
1746542941079,MMW 13R,A01,892727,Staff,0,4,16,16
1746542941079,MMW 13R,A02,892728,Staff,0,4,16,16
1746542941079,MMW 13R,A03,958032,Staff,0,4,16,16
1746542941079,MMW 13R,A04,958033,Staff,0,4,16,16
1746542941079,MMW 13R,A05,958034,Staff,0,4,16,16
1746542942109,SIO 295LS,A00,894015,Staff,5,0,25,20
1746542943138,SIO 295S,A00,894020,Staff,5,0,25,20
1746542944167,SIOC 290S,B01,958918,Merrifield; Mark A,14,0,30,16
1746542945195,SIOC 291S,B01,958922,Gabriel; Corey John,14,0,30,16
1746542946220,SOCI 117,A01,895339,Staff,3,0,5,2
1746542947247,WES 237B,A00,894149,Staff,11,0,20,9
1746542949311,AESE 279B,A00,891859,Staff,13,0,35,22
1746542950337,AIP 197,001,891854,Vespa; Emanuel Ignacio,9999,0,9999,0
1746542951364,ANTH 289S,A00,891856,Gagneux; Pascal,12,0,12,0
1746542952389,BENG 196,001,957946,Engler; Adam J.,9996,0,9999,3
1746542953414,BISP 197,001,959851,Wilhelm; James E.,9999,0,9999,0
1746542954439,CAT 124RS,A01,956906,Staff,6,0,25,19
1746542955465,CAT 125RS,A01,922013,Staff,6,0,25,19
1746542956490,CLRE 250,A00,891860,Morris; Sheldon,9995,0,9999,4
1746542958543,CLRE 251R,A00,907817,Mehta; Ravindra L.,9994,0,9999,5
1746542959571,CLRE 252,A00,891864,Cuomo; Raphael Eduardo,9993,0,9999,6
1746542960602,CLRE 253,A00,891867,Vaida; Florin,9994,0,9999,5
1746542960602,CLRE 253,B00,907819,Staff,9999,0,9999,0
1746542961630,CLRE 259,A00,891868,Patel; Hemal,9998,0,9999,1
1746542962654,CLRE 260,A00,891872,Cuomo; Raphael Eduardo,9999,0,9999,0
1746542963681,CLRE 297,001,891888,Cuomo; Raphael Eduardo,9999,0,9999,0
1746542964707,CSE 191,A00,958773,Minnes Kemp; Mor Mia,9996,0,9999,3
1746542965733,CSE 197,001,959846,Minnes Kemp; Mor Mia,9993,0,9999,6
1746542966758,CSS 201S,A01,892054,Mignozzetti; Umberto,26,0,30,4
1746542967784,CSS 202S,A01,892056,Mignozzetti; Umberto,26,0,30,4
1746542968812,DSC 197,001,956898,Eldridge; Justin Matthew,9998,0,9999,1
1746542969839,DSC 297,001,958000,Mazumdar; Arya,9998,0,9999,1
1746542969839,DSC 297,002,959862,Wang; Yusu,9999,0,9999,0
1746542970864,EAP 100,A00,905686,Staff,9778,0,9999,221
1746542971893,ECE 45,A01,892618,Staff,0,0,65,65
1746542973943,ECE 111,A01,892719,Staff,4,0,65,61
1746542974969,ECE 197,001,957920,Mercier; Patrick Philip,9991,0,9999,8
1746542975995,ECON 178,A01,907814,Zhu; Ying,26,0,35,9
1746542977022,EDS 115,A00,895312,Staff,36,0,45,9
1746542978047,EDS 117,A01,895337,Staff,24,0,30,6
1746542979073,EDS 125,A00,895341,Jones; Gabrielle Anastasia,37,0,45,8
1746542980103,EDS 128A,A01,895459,Fargason; Sharon Gayle,44,0,45,1
1746542981131,EDS 128B,A01,895543,Pappas; Elizabeth,44,0,45,1
1746542982164,EDS 139,A00,897203,Pappas; Elizabeth,44,0,45,1
1746542982164,EDS 139,B00,897209,Fargason; Sharon Gayle,41,0,45,4
1746542983188,EDS 201,A00,895545,Staff,23,0,45,22
1746542984214,EDS 203,A01,895581,Halter; Christopher P.,23,0,45,22
1746542985293,EDS 204R,A01,895625,Heinzman; Erica M.,39,0,45,6
1746542985293,EDS 204R,B01,895693,Halter; Christopher P.,10,0,45,35
1746542986320,EDS 206R,A00,895694,Fargason; Sharon Gayle,1,0,30,29
1746542986320,EDS 206R,B00,895695,Choi; Bailey Miyeon,16,0,30,14
1746542987345,EDS 250,A00,895697,Hemans; Patricia Ann Benitez,23,0,45,22
1746542988371,EDS 281,A00,895701,Meyerott; Theresa Ann,1,0,15,14
1746542989398,EDS 284,A00,895736,Meyerott; Theresa Ann,1,0,15,14
1746542990426,EDS 286,A00,897210,Fine; Sarah,0,0,15,15
1746542991451,EDS 289C,A01,895770,Daly; Alan J.,15,0,15,0
1746542992476,EDS 290,A00,897211,Hofstetter; Carolyn,0,0,15,15
1746542993504,LIGM 5A,A00,896162,Fischer-Grunski; Eva K,13,0,20,7
1746542994534,LIGM 5B,A00,896260,Fischer-Grunski; Eva K,17,0,20,3
1746542995560,LIGM 5C,A00,896308,Fischer-Grunski; Eva K,18,0,20,2
1746542996586,LIIT 5AS,A00,896313,Carnelos; Chiara,18,0,20,2
1746542997611,LIIT 5BS,A00,896416,Carnelos; Chiara,20,0,20,0
1746542998637,LIIT 5CS,A00,896564,Carnelos; Chiara,20,0,20,0
1746542999663,LISP 5A,A00,896588,Munoz Sanchez; Alicia,3,0,20,17
1746543000692,LISP 5B,A00,896653,Munoz Sanchez; Alicia,7,0,20,13
1746543001720,LISP 5C,A00,896655,Munoz Sanchez; Alicia,0,1,20,20
1746543002747,MAE 197,001,957918,Kleissl; Jan,9996,0,9999,3
1746543002747,MAE 197,002,959806,Boechler; Nicholas Sebastia,9998,0,9999,1
1746543002747,MAE 197,003,959852,Mullin; Jennifer S,9999,0,9999,0
1746543003776,MATH 2,A01,957937,Staff,33,0,35,2
1746543004803,MATH 197,001,957876,Kedlaya; Kiran S.,9993,0,9999,6
1746543005833,MCWP 40,A00,892729,Duru; Nur,10,0,20,10
1746543005833,MCWP 40,B00,893304,Montejo; Carolina,14,0,20,6
1746543006861,MCWP 40R,A00,893757,Redela; Pamela Morgan,0,5,20,20
1746543007886,MCWP 50,A00,893758,Morshed; Michael James,0,0,20,20
1746543007886,MCWP 50,B00,893761,Bartulis; Jason Michael,17,0,20,3
1746543008913,MCWP 50R,A00,893766,Compas; Sean Matthew,0,1,20,20
1746543008913,MCWP 50R,B00,893769,Carter; Jennifer A,0,1,20,20
1746543008913,MCWP 50R,C00,893771,Krone; Jarret,0,3,20,20
1746543008913,MCWP 50R,D00,893772,Miller; Elizabeth Deen,0,0,20,20
1746543008913,MCWP 50R,E00,893775,Carter; Andrea L,0,1,20,20
1746543009940,MMW 11R,A01,892721,Herbst; Matthew,11,0,27,16
1746543009940,MMW 11R,A02,892722,Herbst; Matthew,0,0,0,3
1746543010965,MMW 12R,A01,892724,Herbst; Matthew,0,11,16,16
1746543010965,MMW 12R,A02,892725,Herbst; Matthew,0,10,16,16
1746543011990,MMW 13R,A01,892727,Staff,0,4,16,16
1746543011990,MMW 13R,A02,892728,Staff,0,4,16,16
1746543011990,MMW 13R,A03,958032,Staff,0,4,16,16
1746543011990,MMW 13R,A04,958033,Staff,0,4,16,16
1746543011990,MMW 13R,A05,958034,Staff,0,4,16,16
1746543013015,SIO 295LS,A00,894015,Staff,5,0,25,20
1746543014043,SIO 295S,A00,894020,Staff,5,0,25,20
1746543015070,SIOC 290S,B01,958918,Merrifield; Mark A,14,0,30,16
1746543016096,SIOC 291S,B01,958922,Gabriel; Corey John,14,0,30,16
1746543017123,SOCI 117,A01,895339,Staff,3,0,5,2
1746543018148,WES 237B,A00,894149,Staff,11,0,20,9
1746543020211,AESE 279B,A00,891859,Staff,13,0,35,22
1746543021240,AIP 197,001,891854,Vespa; Emanuel Ignacio,9999,0,9999,0
1746543022268,ANTH 289S,A00,891856,Gagneux; Pascal,12,0,12,0
1746543023295,BENG 196,001,957946,Engler; Adam J.,9996,0,9999,3
1746543024323,BISP 197,001,959851,Wilhelm; James E.,9999,0,9999,0
1746543025387,CAT 124RS,A01,956906,Staff,6,0,25,19
1746543026412,CAT 125RS,A01,922013,Staff,6,0,25,19
1746543027440,CLRE 250,A00,891860,Morris; Sheldon,9995,0,9999,4
1746543029495,CLRE 251R,A00,907817,Mehta; Ravindra L.,9994,0,9999,5
1746543030522,CLRE 252,A00,891864,Cuomo; Raphael Eduardo,9993,0,9999,6
1746543031550,CLRE 253,A00,891867,Vaida; Florin,9994,0,9999,5
1746543031550,CLRE 253,B00,907819,Staff,9999,0,9999,0
1746543032578,CLRE 259,A00,891868,Patel; Hemal,9998,0,9999,1
1746543033605,CLRE 260,A00,891872,Cuomo; Raphael Eduardo,9999,0,9999,0
1746543034632,CLRE 297,001,891888,Cuomo; Raphael Eduardo,9999,0,9999,0
1746543035659,CSE 191,A00,958773,Minnes Kemp; Mor Mia,9996,0,9999,3
1746543036684,CSE 197,001,959846,Minnes Kemp; Mor Mia,9993,0,9999,6
1746543037709,CSS 201S,A01,892054,Mignozzetti; Umberto,26,0,30,4
1746543038739,CSS 202S,A01,892056,Mignozzetti; Umberto,26,0,30,4
1746543039764,DSC 197,001,956898,Eldridge; Justin Matthew,9998,0,9999,1
1746543040790,DSC 297,001,958000,Mazumdar; Arya,9998,0,9999,1
1746543040790,DSC 297,002,959862,Wang; Yusu,9999,0,9999,0
1746543041818,EAP 100,A00,905686,Staff,9778,0,9999,221
1746543042848,ECE 45,A01,892618,Staff,0,0,65,65
1746543044903,ECE 111,A01,892719,Staff,4,0,65,61
1746543045930,ECE 197,001,957920,Mercier; Patrick Philip,9991,0,9999,8
1746543046958,ECON 178,A01,907814,Zhu; Ying,26,0,35,9
1746543047982,EDS 115,A00,895312,Staff,36,0,45,9
1746543049008,EDS 117,A01,895337,Staff,24,0,30,6
1746543050035,EDS 125,A00,895341,Jones; Gabrielle Anastasia,37,0,45,8
1746543051060,EDS 128A,A01,895459,Fargason; Sharon Gayle,44,0,45,1
1746543052085,EDS 128B,A01,895543,Pappas; Elizabeth,44,0,45,1
1746543053112,EDS 139,A00,897203,Pappas; Elizabeth,44,0,45,1
1746543053112,EDS 139,B00,897209,Fargason; Sharon Gayle,41,0,45,4
1746543054138,EDS 201,A00,895545,Staff,23,0,45,22
1746543055164,EDS 203,A01,895581,Halter; Christopher P.,23,0,45,22
1746543056193,EDS 204R,A01,895625,Heinzman; Erica M.,39,0,45,6
1746543056193,EDS 204R,B01,895693,Halter; Christopher P.,10,0,45,35
1746543057221,EDS 206R,A00,895694,Fargason; Sharon Gayle,1,0,30,29
1746543057221,EDS 206R,B00,895695,Choi; Bailey Miyeon,16,0,30,14
1746543058246,EDS 250,A00,895697,Hemans; Patricia Ann Benitez,23,0,45,22
1746543059272,EDS 281,A00,895701,Meyerott; Theresa Ann,1,0,15,14
1746543060300,EDS 284,A00,895736,Meyerott; Theresa Ann,1,0,15,14
1746543061325,EDS 286,A00,897210,Fine; Sarah,0,0,15,15
1746543062353,EDS 289C,A01,895770,Daly; Alan J.,15,0,15,0
1746543063378,EDS 290,A00,897211,Hofstetter; Carolyn,0,0,15,15
1746543064403,LIGM 5A,A00,896162,Fischer-Grunski; Eva K,13,0,20,7
1746543065433,LIGM 5B,A00,896260,Fischer-Grunski; Eva K,17,0,20,3
1746543066462,LIGM 5C,A00,896308,Fischer-Grunski; Eva K,18,0,20,2
1746543067490,LIIT 5AS,A00,896313,Carnelos; Chiara,18,0,20,2
1746543068517,LIIT 5BS,A00,896416,Carnelos; Chiara,20,0,20,0
1746543069545,LIIT 5CS,A00,896564,Carnelos; Chiara,20,0,20,0
1746543070575,LISP 5A,A00,896588,Munoz Sanchez; Alicia,3,0,20,17
1746543071606,LISP 5B,A00,896653,Munoz Sanchez; Alicia,7,0,20,13
1746543072630,LISP 5C,A00,896655,Munoz Sanchez; Alicia,0,1,20,20
1746543073656,MAE 197,001,957918,Kleissl; Jan,9996,0,9999,3
1746543073656,MAE 197,002,959806,Boechler; Nicholas Sebastia,9998,0,9999,1
1746543073656,MAE 197,003,959852,Mullin; Jennifer S,9999,0,9999,0
1746543074682,MATH 2,A01,957937,Staff,33,0,35,2
1746543075707,MATH 197,001,957876,Kedlaya; Kiran S.,9993,0,9999,6
1746543076734,MCWP 40,A00,892729,Duru; Nur,10,0,20,10
1746543076734,MCWP 40,B00,893304,Montejo; Carolina,14,0,20,6
1746543077761,MCWP 40R,A00,893757,Redela; Pamela Morgan,0,5,20,20
1746543078787,MCWP 50,A00,893758,Morshed; Michael James,0,0,20,20
1746543078787,MCWP 50,B00,893761,Bartulis; Jason Michael,17,0,20,3
1746543079816,MCWP 50R,A00,893766,Compas; Sean Matthew,0,1,20,20
1746543079816,MCWP 50R,B00,893769,Carter; Jennifer A,0,1,20,20
1746543079816,MCWP 50R,C00,893771,Krone; Jarret,0,3,20,20
1746543079816,MCWP 50R,D00,893772,Miller; Elizabeth Deen,0,0,20,20
1746543079816,MCWP 50R,E00,893775,Carter; Andrea L,0,1,20,20
1746543080844,MMW 11R,A01,892721,Herbst; Matthew,11,0,27,16
1746543080844,MMW 11R,A02,892722,Herbst; Matthew,0,0,0,3
1746543081870,MMW 12R,A01,892724,Herbst; Matthew,0,11,16,16
1746543081870,MMW 12R,A02,892725,Herbst; Matthew,0,10,16,16
1746543082895,MMW 13R,A01,892727,Staff,0,4,16,16
1746543082895,MMW 13R,A02,892728,Staff,0,4,16,16
1746543082895,MMW 13R,A03,958032,Staff,0,4,16,16
1746543082895,MMW 13R,A04,958033,Staff,0,4,16,16
1746543082895,MMW 13R,A05,958034,Staff,0,4,16,16
1746543083924,SIO 295LS,A00,894015,Staff,5,0,25,20
1746543084956,SIO 295S,A00,894020,Staff,5,0,25,20
1746543085987,SIOC 290S,B01,958918,Merrifield; Mark A,14,0,30,16
1746543087016,SIOC 291S,B01,958922,Gabriel; Corey John,14,0,30,16
1746543088044,SOCI 117,A01,895339,Staff,3,0,5,2
1746543089071,WES 237B,A00,894149,Staff,11,0,20,9
1746543091144,AESE 279B,A00,891859,Staff,13,0,35,22
1746543092174,AIP 197,001,891854,Vespa; Emanuel Ignacio,9999,0,9999,0
1746543093200,ANTH 289S,A00,891856,Gagneux; Pascal,12,0,12,0
1746543094223,BENG 196,001,957946,Engler; Adam J.,9996,0,9999,3
1746543095253,BISP 197,001,959851,Wilhelm; James E.,9999,0,9999,0
1746543096282,CAT 124RS,A01,956906,Staff,6,0,25,19
1746543097306,CAT 125RS,A01,922013,Staff,6,0,25,19
1746543098331,CLRE 250,A00,891860,Morris; Sheldon,9995,0,9999,4
1746543100382,CLRE 251R,A00,907817,Mehta; Ravindra L.,9994,0,9999,5
1746543101407,CLRE 252,A00,891864,Cuomo; Raphael Eduardo,9993,0,9999,6
1746543102431,CLRE 253,A00,891867,Vaida; Florin,9994,0,9999,5
1746543102431,CLRE 253,B00,907819,Staff,9999,0,9999,0
1746543103455,CLRE 259,A00,891868,Patel; Hemal,9998,0,9999,1
1746543104482,CLRE 260,A00,891872,Cuomo; Raphael Eduardo,9999,0,9999,0
1746543105509,CLRE 297,001,891888,Cuomo; Raphael Eduardo,9999,0,9999,0
1746543106539,CSE 191,A00,958773,Minnes Kemp; Mor Mia,9996,0,9999,3
1746543107567,CSE 197,001,959846,Minnes Kemp; Mor Mia,9993,0,9999,6
1746543108597,CSS 201S,A01,892054,Mignozzetti; Umberto,26,0,30,4
1746543109628,CSS 202S,A01,892056,Mignozzetti; Umberto,26,0,30,4
1746543110653,DSC 197,001,956898,Eldridge; Justin Matthew,9998,0,9999,1
1746543111678,DSC 297,001,958000,Mazumdar; Arya,9998,0,9999,1
1746543111678,DSC 297,002,959862,Wang; Yusu,9999,0,9999,0
1746543112702,EAP 100,A00,905686,Staff,9778,0,9999,221
1746543113732,ECE 45,A01,892618,Staff,0,0,65,65
1746543115784,ECE 111,A01,892719,Staff,4,0,65,61
1746543116810,ECE 197,001,957920,Mercier; Patrick Philip,9991,0,9999,8
1746543117839,ECON 178,A01,907814,Zhu; Ying,26,0,35,9
1746543118864,EDS 115,A00,895312,Staff,36,0,45,9
1746543119892,EDS 117,A01,895337,Staff,24,0,30,6
1746543120917,EDS 125,A00,895341,Jones; Gabrielle Anastasia,37,0,45,8
1746543121944,EDS 128A,A01,895459,Fargason; Sharon Gayle,44,0,45,1
1746543122971,EDS 128B,A01,895543,Pappas; Elizabeth,44,0,45,1
1746543123996,EDS 139,A00,897203,Pappas; Elizabeth,44,0,45,1
1746543123996,EDS 139,B00,897209,Fargason; Sharon Gayle,41,0,45,4
1746543125034,EDS 201,A00,895545,Staff,23,0,45,22
1746543126061,EDS 203,A01,895581,Halter; Christopher P.,23,0,45,22
1746543127085,EDS 204R,A01,895625,Heinzman; Erica M.,39,0,45,6
1746543127085,EDS 204R,B01,895693,Halter; Christopher P.,10,0,45,35
1746543128111,EDS 206R,A00,895694,Fargason; Sharon Gayle,1,0,30,29
1746543128111,EDS 206R,B00,895695,Choi; Bailey Miyeon,16,0,30,14
1746543129137,EDS 250,A00,895697,Hemans; Patricia Ann Benitez,23,0,45,22
1746543130163,EDS 281,A00,895701,Meyerott; Theresa Ann,1,0,15,14
1746543131191,EDS 284,A00,895736,Meyerott; Theresa Ann,1,0,15,14
1746543132217,EDS 286,A00,897210,Fine; Sarah,0,0,15,15
1746543133247,EDS 289C,A01,895770,Daly; Alan J.,15,0,15,0
1746543134276,EDS 290,A00,897211,Hofstetter; Carolyn,0,0,15,15
1746543135300,LIGM 5A,A00,896162,Fischer-Grunski; Eva K,13,0,20,7
1746543136328,LIGM 5B,A00,896260,Fischer-Grunski; Eva K,17,0,20,3
1746543137356,LIGM 5C,A00,896308,Fischer-Grunski; Eva K,18,0,20,2
1746543138386,LIIT 5AS,A00,896313,Carnelos; Chiara,18,0,20,2
1746543139413,LIIT 5BS,A00,896416,Carnelos; Chiara,20,0,20,0
1746543140465,LIIT 5CS,A00,896564,Carnelos; Chiara,20,0,20,0
1746543141496,LISP 5A,A00,896588,Munoz Sanchez; Alicia,3,0,20,17
1746543142526,LISP 5B,A00,896653,Munoz Sanchez; Alicia,7,0,20,13
1746543143554,LISP 5C,A00,896655,Munoz Sanchez; Alicia,0,1,20,20
1746543144581,MAE 197,001,957918,Kleissl; Jan,9996,0,9999,3
1746543144581,MAE 197,002,959806,Boechler; Nicholas Sebastia,9998,0,9999,1
1746543144581,MAE 197,003,959852,Mullin; Jennifer S,9999,0,9999,0
1746543145623,MATH 2,A01,957937,Staff,33,0,35,2
1746543146646,MATH 197,001,957876,Kedlaya; Kiran S.,9993,0,9999,6
1746543147672,MCWP 40,A00,892729,Duru; Nur,10,0,20,10
1746543147672,MCWP 40,B00,893304,Montejo; Carolina,14,0,20,6
1746543148700,MCWP 40R,A00,893757,Redela; Pamela Morgan,0,5,20,20
1746543149726,MCWP 50,A00,893758,Morshed; Michael James,0,0,20,20
1746543149726,MCWP 50,B00,893761,Bartulis; Jason Michael,17,0,20,3
1746543150750,MCWP 50R,A00,893766,Compas; Sean Matthew,0,1,20,20
1746543150750,MCWP 50R,B00,893769,Carter; Jennifer A,0,1,20,20
1746543150750,MCWP 50R,C00,893771,Krone; Jarret,0,3,20,20
1746543150750,MCWP 50R,D00,893772,Miller; Elizabeth Deen,0,0,20,20
1746543150750,MCWP 50R,E00,893775,Carter; Andrea L,0,1,20,20
1746543151777,MMW 11R,A01,892721,Herbst; Matthew,11,0,27,16
1746543151777,MMW 11R,A02,892722,Herbst; Matthew,0,0,0,3
1746543152807,MMW 12R,A01,892724,Herbst; Matthew,0,11,16,16
1746543152807,MMW 12R,A02,892725,Herbst; Matthew,0,10,16,16
1746543153832,MMW 13R,A01,892727,Staff,0,4,16,16
1746543153832,MMW 13R,A02,892728,Staff,0,4,16,16
1746543153832,MMW 13R,A03,958032,Staff,0,4,16,16
1746543153832,MMW 13R,A04,958033,Staff,0,4,16,16
1746543153832,MMW 13R,A05,958034,Staff,0,4,16,16
1746543154857,SIO 295LS,A00,894015,Staff,5,0,25,20
1746543155882,SIO 295S,A00,894020,Staff,5,0,25,20
1746543156912,SIOC 290S,B01,958918,Merrifield; Mark A,14,0,30,16
1746543157943,SIOC 291S,B01,958922,Gabriel; Corey John,14,0,30,16
1746543158970,SOCI 117,A01,895339,Staff,3,0,5,2
1746543160000,WES 237B,A00,894149,Staff,11,0,20,9
1746543162061,AESE 279B,A00,891859,Staff,13,0,35,22
1746543163088,AIP 197,001,891854,Vespa; Emanuel Ignacio,9999,0,9999,0
1746543164114,ANTH 289S,A00,891856,Gagneux; Pascal,12,0,12,0
1746543165145,BENG 196,001,957946,Engler; Adam J.,9996,0,9999,3
1746543166174,BISP 197,001,959851,Wilhelm; James E.,9999,0,9999,0
1746543167199,CAT 124RS,A01,956906,Staff,6,0,25,19
1746543168227,CAT 125RS,A01,922013,Staff,6,0,25,19
1746543169256,CLRE 250,A00,891860,Morris; Sheldon,9995,0,9999,4
1746543171314,CLRE 251R,A00,907817,Mehta; Ravindra L.,9994,0,9999,5
1746543172340,CLRE 252,A00,891864,Cuomo; Raphael Eduardo,9993,0,9999,6
1746543173366,CLRE 253,A00,891867,Vaida; Florin,9994,0,9999,5
1746543173366,CLRE 253,B00,907819,Staff,9999,0,9999,0
1746543174391,CLRE 259,A00,891868,Patel; Hemal,9998,0,9999,1
1746543175416,CLRE 260,A00,891872,Cuomo; Raphael Eduardo,9999,0,9999,0
1746543176441,CLRE 297,001,891888,Cuomo; Raphael Eduardo,9999,0,9999,0
1746543177484,CSE 191,A00,958773,Minnes Kemp; Mor Mia,9996,0,9999,3
1746543178509,CSE 197,001,959846,Minnes Kemp; Mor Mia,9993,0,9999,6
1746543179535,CSS 201S,A01,892054,Mignozzetti; Umberto,26,0,30,4
1746543180559,CSS 202S,A01,892056,Mignozzetti; Umberto,26,0,30,4
1746543181582,DSC 197,001,956898,Eldridge; Justin Matthew,9998,0,9999,1
1746543182609,DSC 297,001,958000,Mazumdar; Arya,9998,0,9999,1
1746543182609,DSC 297,002,959862,Wang; Yusu,9999,0,9999,0
1746543183633,EAP 100,A00,905686,Staff,9778,0,9999,221
1746543184658,ECE 45,A01,892618,Staff,0,0,65,65
1746543186711,ECE 111,A01,892719,Staff,4,0,65,61
1746543187735,ECE 197,001,957920,Mercier; Patrick Philip,9991,0,9999,8
1746543188759,ECON 178,A01,907814,Zhu; Ying,26,0,35,9
1746543189784,EDS 115,A00,895312,Staff,36,0,45,9
1746543190808,EDS 117,A01,895337,Staff,24,0,30,6
1746543191832,EDS 125,A00,895341,Jones; Gabrielle Anastasia,37,0,45,8
1746543192860,EDS 128A,A01,895459,Fargason; Sharon Gayle,44,0,45,1
1746543193887,EDS 128B,A01,895543,Pappas; Elizabeth,44,0,45,1
1746543194912,EDS 139,A00,897203,Pappas; Elizabeth,44,0,45,1
1746543194912,EDS 139,B00,897209,Fargason; Sharon Gayle,41,0,45,4
1746543195937,EDS 201,A00,895545,Staff,23,0,45,22
1746543196961,EDS 203,A01,895581,Halter; Christopher P.,23,0,45,22
1746543197986,EDS 204R,A01,895625,Heinzman; Erica M.,39,0,45,6
1746543197986,EDS 204R,B01,895693,Halter; Christopher P.,10,0,45,35
1746543199012,EDS 206R,A00,895694,Fargason; Sharon Gayle,1,0,30,29
1746543199012,EDS 206R,B00,895695,Choi; Bailey Miyeon,16,0,30,14
1746543200037,EDS 250,A00,895697,Hemans; Patricia Ann Benitez,23,0,45,22
1746543201067,EDS 281,A00,895701,Meyerott; Theresa Ann,1,0,15,14
1746543202097,EDS 284,A00,895736,Meyerott; Theresa Ann,1,0,15,14
1746543203122,EDS 286,A00,897210,Fine; Sarah,0,0,15,15
1746543204147,EDS 289C,A01,895770,Daly; Alan J.,15,0,15,0
1746543205173,EDS 290,A00,897211,Hofstetter; Carolyn,0,0,15,15
1746543206200,LIGM 5A,A00,896162,Fischer-Grunski; Eva K,13,0,20,7
1746543207226,LIGM 5B,A00,896260,Fischer-Grunski; Eva K,17,0,20,3
1746543208252,LIGM 5C,A00,896308,Fischer-Grunski; Eva K,18,0,20,2
1746543209280,LIIT 5AS,A00,896313,Carnelos; Chiara,18,0,20,2
1746543210307,LIIT 5BS,A00,896416,Carnelos; Chiara,20,0,20,0
1746543211333,LIIT 5CS,A00,896564,Carnelos; Chiara,20,0,20,0
1746543212361,LISP 5A,A00,896588,Munoz Sanchez; Alicia,3,0,20,17
1746543213388,LISP 5B,A00,896653,Munoz Sanchez; Alicia,7,0,20,13
1746543214415,LISP 5C,A00,896655,Munoz Sanchez; Alicia,0,1,20,20
1746543215442,MAE 197,001,957918,Kleissl; Jan,9996,0,9999,3
1746543215442,MAE 197,002,959806,Boechler; Nicholas Sebastia,9998,0,9999,1
1746543215442,MAE 197,003,959852,Mullin; Jennifer S,9999,0,9999,0
1746543216468,MATH 2,A01,957937,Staff,33,0,35,2
1746543217494,MATH 197,001,957876,Kedlaya; Kiran S.,9993,0,9999,6
1746543218525,MCWP 40,A00,892729,Duru; Nur,10,0,20,10
1746543218525,MCWP 40,B00,893304,Montejo; Carolina,14,0,20,6
1746543219554,MCWP 40R,A00,893757,Redela; Pamela Morgan,0,5,20,20
1746543220581,MCWP 50,A00,893758,Morshed; Michael James,0,0,20,20
1746543220581,MCWP 50,B00,893761,Bartulis; Jason Michael,17,0,20,3
1746543221606,MCWP 50R,A00,893766,Compas; Sean Matthew,0,1,20,20
1746543221606,MCWP 50R,B00,893769,Carter; Jennifer A,0,1,20,20
1746543221606,MCWP 50R,C00,893771,Krone; Jarret,0,3,20,20
1746543221606,MCWP 50R,D00,893772,Miller; Elizabeth Deen,0,0,20,20
1746543221606,MCWP 50R,E00,893775,Carter; Andrea L,0,1,20,20
1746543222632,MMW 11R,A01,892721,Herbst; Matthew,11,0,27,16
1746543222632,MMW 11R,A02,892722,Herbst; Matthew,0,0,0,3
1746543223658,MMW 12R,A01,892724,Herbst; Matthew,0,11,16,16
1746543223658,MMW 12R,A02,892725,Herbst; Matthew,0,10,16,16
1746543224683,MMW 13R,A01,892727,Staff,0,4,16,16
1746543224683,MMW 13R,A02,892728,Staff,0,4,16,16
1746543224683,MMW 13R,A03,958032,Staff,0,4,16,16
1746543224683,MMW 13R,A04,958033,Staff,0,4,16,16
1746543224683,MMW 13R,A05,958034,Staff,0,4,16,16
1746543225710,SIO 295LS,A00,894015,Staff,5,0,25,20
1746543226735,SIO 295S,A00,894020,Staff,5,0,25,20
1746543227765,SIOC 290S,B01,958918,Merrifield; Mark A,14,0,30,16
1746543228795,SIOC 291S,B01,958922,Gabriel; Corey John,14,0,30,16
1746543229818,SOCI 117,A01,895339,Staff,3,0,5,2
1746543230845,WES 237B,A00,894149,Staff,11,0,20,9
1746543232905,AESE 279B,A00,891859,Staff,13,0,35,22
1746543233930,AIP 197,001,891854,Vespa; Emanuel Ignacio,9999,0,9999,0
1746543234956,ANTH 289S,A00,891856,Gagneux; Pascal,12,0,12,0
1746543235984,BENG 196,001,957946,Engler; Adam J.,9996,0,9999,3
1746543237010,BISP 197,001,959851,Wilhelm; James E.,9999,0,9999,0
1746543238036,CAT 124RS,A01,956906,Staff,6,0,25,19
1746543239067,CAT 125RS,A01,922013,Staff,6,0,25,19
1746543240095,CLRE 250,A00,891860,Morris; Sheldon,9995,0,9999,4
1746543242152,CLRE 251R,A00,907817,Mehta; Ravindra L.,9994,0,9999,5
1746543243177,CLRE 252,A00,891864,Cuomo; Raphael Eduardo,9993,0,9999,6
1746543244224,CLRE 253,A00,891867,Vaida; Florin,9994,0,9999,5
1746543244224,CLRE 253,B00,907819,Staff,9999,0,9999,0
1746543245251,CLRE 259,A00,891868,Patel; Hemal,9998,0,9999,1
1746543246276,CLRE 260,A00,891872,Cuomo; Raphael Eduardo,9999,0,9999,0
1746543247301,CLRE 297,001,891888,Cuomo; Raphael Eduardo,9999,0,9999,0
1746543248332,CSE 191,A00,958773,Minnes Kemp; Mor Mia,9996,0,9999,3
1746543249361,CSE 197,001,959846,Minnes Kemp; Mor Mia,9993,0,9999,6
1746543250387,CSS 201S,A01,892054,Mignozzetti; Umberto,26,0,30,4
1746543251413,CSS 202S,A01,892056,Mignozzetti; Umberto,26,0,30,4
1746543252440,DSC 197,001,956898,Eldridge; Justin Matthew,9998,0,9999,1
1746543253464,DSC 297,001,958000,Mazumdar; Arya,9998,0,9999,1
1746543253464,DSC 297,002,959862,Wang; Yusu,9999,0,9999,0
1746543254493,EAP 100,A00,905686,Staff,9778,0,9999,221
1746543255518,ECE 45,A01,892618,Staff,0,0,65,65
1746543257572,ECE 111,A01,892719,Staff,4,0,65,61
1746543258603,ECE 197,001,957920,Mercier; Patrick Philip,9991,0,9999,8
1746543259630,ECON 178,A01,907814,Zhu; Ying,26,0,35,9
1746543260656,EDS 115,A00,895312,Staff,36,0,45,9
1746543261683,EDS 117,A01,895337,Staff,24,0,30,6
1746543262710,EDS 125,A00,895341,Jones; Gabrielle Anastasia,37,0,45,8
1746543263735,EDS 128A,A01,895459,Fargason; Sharon Gayle,44,0,45,1
1746543264764,EDS 128B,A01,895543,Pappas; Elizabeth,44,0,45,1
1746543265793,EDS 139,A00,897203,Pappas; Elizabeth,44,0,45,1
1746543265793,EDS 139,B00,897209,Fargason; Sharon Gayle,41,0,45,4
1746543266817,EDS 201,A00,895545,Staff,23,0,45,22
1746543267845,EDS 203,A01,895581,Halter; Christopher P.,23,0,45,22
1746543268871,EDS 204R,A01,895625,Heinzman; Erica M.,39,0,45,6
1746543268871,EDS 204R,B01,895693,Halter; Christopher P.,10,0,45,35
1746543269899,EDS 206R,A00,895694,Fargason; Sharon Gayle,1,0,30,29
1746543269899,EDS 206R,B00,895695,Choi; Bailey Miyeon,16,0,30,14
1746543270926,EDS 250,A00,895697,Hemans; Patricia Ann Benitez,23,0,45,22
1746543271952,EDS 281,A00,895701,Meyerott; Theresa Ann,1,0,15,14
1746543272976,EDS 284,A00,895736,Meyerott; Theresa Ann,1,0,15,14
1746543274002,EDS 286,A00,897210,Fine; Sarah,0,0,15,15
1746543275028,EDS 289C,A01,895770,Daly; Alan J.,15,0,15,0
1746543276057,EDS 290,A00,897211,Hofstetter; Carolyn,0,0,15,15
1746543277080,LIGM 5A,A00,896162,Fischer-Grunski; Eva K,13,0,20,7
1746543278106,LIGM 5B,A00,896260,Fischer-Grunski; Eva K,17,0,20,3
1746543279133,LIGM 5C,A00,896308,Fischer-Grunski; Eva K,18,0,20,2
1746543280161,LIIT 5AS,A00,896313,Carnelos; Chiara,18,0,20,2
1746543281186,LIIT 5BS,A00,896416,Carnelos; Chiara,20,0,20,0
1746543282210,LIIT 5CS,A00,896564,Carnelos; Chiara,20,0,20,0
1746543283233,LISP 5A,A00,896588,Munoz Sanchez; Alicia,3,0,20,17
1746543284257,LISP 5B,A00,896653,Munoz Sanchez; Alicia,7,0,20,13
1746543285287,LISP 5C,A00,896655,Munoz Sanchez; Alicia,0,1,20,20
1746543286315,MAE 197,001,957918,Kleissl; Jan,9996,0,9999,3
1746543286315,MAE 197,002,959806,Boechler; Nicholas Sebastia,9998,0,9999,1
1746543286315,MAE 197,003,959852,Mullin; Jennifer S,9999,0,9999,0
1746543287342,MATH 2,A01,957937,Staff,33,0,35,2
1746543288366,MATH 197,001,957876,Kedlaya; Kiran S.,9993,0,9999,6
1746543289393,MCWP 40,A00,892729,Duru; Nur,10,0,20,10
1746543289393,MCWP 40,B00,893304,Montejo; Carolina,14,0,20,6
1746543290418,MCWP 40R,A00,893757,Redela; Pamela Morgan,0,5,20,20
1746543291442,MCWP 50,A00,893758,Morshed; Michael James,0,0,20,20
1746543291442,MCWP 50,B00,893761,Bartulis; Jason Michael,17,0,20,3
1746543292468,MCWP 50R,A00,893766,Compas; Sean Matthew,0,1,20,20
1746543292468,MCWP 50R,B00,893769,Carter; Jennifer A,0,1,20,20
1746543292468,MCWP 50R,C00,893771,Krone; Jarret,0,3,20,20
1746543292468,MCWP 50R,D00,893772,Miller; Elizabeth Deen,0,0,20,20
1746543292468,MCWP 50R,E00,893775,Carter; Andrea L,0,1,20,20
1746543293493,MMW 11R,A01,892721,Herbst; Matthew,11,0,27,16
1746543293493,MMW 11R,A02,892722,Herbst; Matthew,0,0,0,3
1746543294520,MMW 12R,A01,892724,Herbst; Matthew,0,11,16,16
1746543294520,MMW 12R,A02,892725,Herbst; Matthew,0,10,16,16
1746543295549,MMW 13R,A01,892727,Staff,0,4,16,16
1746543295549,MMW 13R,A02,892728,Staff,0,4,16,16
1746543295549,MMW 13R,A03,958032,Staff,0,4,16,16
1746543295549,MMW 13R,A04,958033,Staff,0,4,16,16
1746543295549,MMW 13R,A05,958034,Staff,0,4,16,16
1746543296579,SIO 295LS,A00,894015,Staff,5,0,25,20
1746543297604,SIO 295S,A00,894020,Staff,5,0,25,20
1746543298633,SIOC 290S,B01,958918,Merrifield; Mark A,14,0,30,16
1746543299662,SIOC 291S,B01,958922,Gabriel; Corey John,14,0,30,16
1746543300687,SOCI 117,A01,895339,Staff,3,0,5,2
1746543301714,WES 237B,A00,894149,Staff,11,0,20,9
1746543303781,AESE 279B,A00,891859,Staff,13,0,35,22
1746543304809,AIP 197,001,891854,Vespa; Emanuel Ignacio,9999,0,9999,0
1746543305836,ANTH 289S,A00,891856,Gagneux; Pascal,12,0,12,0
1746543306953,BENG 196,001,957946,Engler; Adam J.,9996,0,9999,3
1746543307982,BISP 197,001,959851,Wilhelm; James E.,9999,0,9999,0
1746543309009,CAT 124RS,A01,956906,Staff,6,0,25,19
1746543310036,CAT 125RS,A01,922013,Staff,6,0,25,19
1746543311063,CLRE 250,A00,891860,Morris; Sheldon,9995,0,9999,4
1746543313117,CLRE 251R,A00,907817,Mehta; Ravindra L.,9994,0,9999,5
1746543314142,CLRE 252,A00,891864,Cuomo; Raphael Eduardo,9993,0,9999,6
1746543315169,CLRE 253,A00,891867,Vaida; Florin,9994,0,9999,5
1746543315169,CLRE 253,B00,907819,Staff,9999,0,9999,0
1746543316196,CLRE 259,A00,891868,Patel; Hemal,9998,0,9999,1
1746543317222,CLRE 260,A00,891872,Cuomo; Raphael Eduardo,9999,0,9999,0
1746543318248,CLRE 297,001,891888,Cuomo; Raphael Eduardo,9999,0,9999,0
1746543319274,CSE 191,A00,958773,Minnes Kemp; Mor Mia,9996,0,9999,3
1746543320303,CSE 197,001,959846,Minnes Kemp; Mor Mia,9993,0,9999,6
1746543321331,CSS 201S,A01,892054,Mignozzetti; Umberto,26,0,30,4
1746543322359,CSS 202S,A01,892056,Mignozzetti; Umberto,26,0,30,4
1746543323386,DSC 197,001,956898,Eldridge; Justin Matthew,9998,0,9999,1
1746543324416,DSC 297,001,958000,Mazumdar; Arya,9998,0,9999,1
1746543324416,DSC 297,002,959862,Wang; Yusu,9999,0,9999,0
1746543325442,EAP 100,A00,905686,Staff,9778,0,9999,221
1746543326473,ECE 45,A01,892618,Staff,0,0,65,65
1746543328522,ECE 111,A01,892719,Staff,4,0,65,61
1746543329546,ECE 197,001,957920,Mercier; Patrick Philip,9991,0,9999,8
1746543330571,ECON 178,A01,907814,Zhu; Ying,26,0,35,9
1746543331596,EDS 115,A00,895312,Staff,36,0,45,9
1746543332622,EDS 117,A01,895337,Staff,24,0,30,6
1746543333655,EDS 125,A00,895341,Jones; Gabrielle Anastasia,37,0,45,8
1746543334681,EDS 128A,A01,895459,Fargason; Sharon Gayle,44,0,45,1
1746543335705,EDS 128B,A01,895543,Pappas; Elizabeth,44,0,45,1
1746543336730,EDS 139,A00,897203,Pappas; Elizabeth,44,0,45,1
1746543336730,EDS 139,B00,897209,Fargason; Sharon Gayle,41,0,45,4
1746543337755,EDS 201,A00,895545,Staff,23,0,45,22
1746543338781,EDS 203,A01,895581,Halter; Christopher P.,23,0,45,22
1746543339806,EDS 204R,A01,895625,Heinzman; Erica M.,39,0,45,6
1746543339806,EDS 204R,B01,895693,Halter; Christopher P.,10,0,45,35
1746543340835,EDS 206R,A00,895694,Fargason; Sharon Gayle,1,0,30,29
1746543340835,EDS 206R,B00,895695,Choi; Bailey Miyeon,16,0,30,14
1746543341865,EDS 250,A00,895697,Hemans; Patricia Ann Benitez,23,0,45,22
1746543342890,EDS 281,A00,895701,Meyerott; Theresa Ann,1,0,15,14
1746543343917,EDS 284,A00,895736,Meyerott; Theresa Ann,1,0,15,14
1746543344944,EDS 286,A00,897210,Fine; Sarah,0,0,15,15
1746543345973,EDS 289C,A01,895770,Daly; Alan J.,15,0,15,0
1746543347000,EDS 290,A00,897211,Hofstetter; Carolyn,0,0,15,15
1746543348026,LIGM 5A,A00,896162,Fischer-Grunski; Eva K,13,0,20,7
1746543349051,LIGM 5B,A00,896260,Fischer-Grunski; Eva K,17,0,20,3
1746543350117,LIGM 5C,A00,896308,Fischer-Grunski; Eva K,18,0,20,2
1746543351142,LIIT 5AS,A00,896313,Carnelos; Chiara,18,0,20,2
1746543352170,LIIT 5BS,A00,896416,Carnelos; Chiara,20,0,20,0
1746543353199,LIIT 5CS,A00,896564,Carnelos; Chiara,20,0,20,0
1746543354226,LISP 5A,A00,896588,Munoz Sanchez; Alicia,3,0,20,17
1746543355254,LISP 5B,A00,896653,Munoz Sanchez; Alicia,7,0,20,13
1746543356282,LISP 5C,A00,896655,Munoz Sanchez; Alicia,0,1,20,20
1746543357316,MAE 197,001,957918,Kleissl; Jan,9996,0,9999,3
1746543357316,MAE 197,002,959806,Boechler; Nicholas Sebastia,9998,0,9999,1
1746543357316,MAE 197,003,959852,Mullin; Jennifer S,9999,0,9999,0
1746543358343,MATH 2,A01,957937,Staff,33,0,35,2
1746543359368,MATH 197,001,957876,Kedlaya; Kiran S.,9993,0,9999,6
1746543360395,MCWP 40,A00,892729,Duru; Nur,10,0,20,10
1746543360395,MCWP 40,B00,893304,Montejo; Carolina,14,0,20,6
1746543361436,MCWP 40R,A00,893757,Redela; Pamela Morgan,0,5,20,20
1746543362462,MCWP 50,A00,893758,Morshed; Michael James,0,0,20,20
1746543362462,MCWP 50,B00,893761,Bartulis; Jason Michael,17,0,20,3
1746543363491,MCWP 50R,A00,893766,Compas; Sean Matthew,0,1,20,20
1746543363491,MCWP 50R,B00,893769,Carter; Jennifer A,0,1,20,20
1746543363491,MCWP 50R,C00,893771,Krone; Jarret,0,3,20,20
1746543363491,MCWP 50R,D00,893772,Miller; Elizabeth Deen,0,0,20,20
1746543363491,MCWP 50R,E00,893775,Carter; Andrea L,0,1,20,20
1746543364519,MMW 11R,A01,892721,Herbst; Matthew,11,0,27,16
1746543364519,MMW 11R,A02,892722,Herbst; Matthew,0,0,0,3
1746543365547,MMW 12R,A01,892724,Herbst; Matthew,0,11,16,16
1746543365547,MMW 12R,A02,892725,Herbst; Matthew,0,10,16,16
1746543366572,MMW 13R,A01,892727,Staff,0,4,16,16
1746543366572,MMW 13R,A02,892728,Staff,0,4,16,16
1746543366572,MMW 13R,A03,958032,Staff,0,4,16,16
1746543366572,MMW 13R,A04,958033,Staff,0,4,16,16
1746543366572,MMW 13R,A05,958034,Staff,0,4,16,16
1746543367599,SIO 295LS,A00,894015,Staff,5,0,25,20
1746543368626,SIO 295S,A00,894020,Staff,5,0,25,20
1746543369653,SIOC 290S,B01,958918,Merrifield; Mark A,14,0,30,16
1746543370684,SIOC 291S,B01,958922,Gabriel; Corey John,14,0,30,16
1746543371710,SOCI 117,A01,895339,Staff,3,0,5,2
1746543372741,WES 237B,A00,894149,Staff,11,0,20,9
1746543374813,AESE 279B,A00,891859,Staff,13,0,35,22
1746543375839,AIP 197,001,891854,Vespa; Emanuel Ignacio,9999,0,9999,0
1746543376869,ANTH 289S,A00,891856,Gagneux; Pascal,12,0,12,0
1746543377895,BENG 196,001,957946,Engler; Adam J.,9996,0,9999,3
1746543378925,BISP 197,001,959851,Wilhelm; James E.,9999,0,9999,0
1746543379951,CAT 124RS,A01,956906,Staff,6,0,25,19
1746543380978,CAT 125RS,A01,922013,Staff,6,0,25,19
1746543382005,CLRE 250,A00,891860,Morris; Sheldon,9995,0,9999,4
1746543384057,CLRE 251R,A00,907817,Mehta; Ravindra L.,9994,0,9999,5
1746543385085,CLRE 252,A00,891864,Cuomo; Raphael Eduardo,9993,0,9999,6
1746543386111,CLRE 253,A00,891867,Vaida; Florin,9994,0,9999,5
1746543386111,CLRE 253,B00,907819,Staff,9999,0,9999,0
1746543387137,CLRE 259,A00,891868,Patel; Hemal,9998,0,9999,1
1746543388163,CLRE 260,A00,891872,Cuomo; Raphael Eduardo,9999,0,9999,0
1746543389187,CLRE 297,001,891888,Cuomo; Raphael Eduardo,9999,0,9999,0
1746543390218,CSE 191,A00,958773,Minnes Kemp; Mor Mia,9996,0,9999,3
1746543391244,CSE 197,001,959846,Minnes Kemp; Mor Mia,9993,0,9999,6
1746543392272,CSS 201S,A01,892054,Mignozzetti; Umberto,26,0,30,4
1746543393298,CSS 202S,A01,892056,Mignozzetti; Umberto,26,0,30,4
1746543394326,DSC 197,001,956898,Eldridge; Justin Matthew,9998,0,9999,1
1746543395353,DSC 297,001,958000,Mazumdar; Arya,9998,0,9999,1
1746543395353,DSC 297,002,959862,Wang; Yusu,9999,0,9999,0
1746543396379,EAP 100,A00,905686,Staff,9778,0,9999,221
1746543397408,ECE 45,A01,892618,Staff,0,0,65,65
1746543399462,ECE 111,A01,892719,Staff,4,0,65,61
1746543400487,ECE 197,001,957920,Mercier; Patrick Philip,9991,0,9999,8
1746543401513,ECON 178,A01,907814,Zhu; Ying,26,0,35,9
1746543402541,EDS 115,A00,895312,Staff,36,0,45,9
1746543403569,EDS 117,A01,895337,Staff,24,0,30,6
1746543404594,EDS 125,A00,895341,Jones; Gabrielle Anastasia,37,0,45,8
1746543405627,EDS 128A,A01,895459,Fargason; Sharon Gayle,44,0,45,1
1746543406654,EDS 128B,A01,895543,Pappas; Elizabeth,44,0,45,1
1746543407680,EDS 139,A00,897203,Pappas; Elizabeth,44,0,45,1
1746543407680,EDS 139,B00,897209,Fargason; Sharon Gayle,41,0,45,4
1746543408708,EDS 201,A00,895545,Staff,23,0,45,22
1746543409774,EDS 203,A01,895581,Halter; Christopher P.,23,0,45,22
1746543410805,EDS 204R,A01,895625,Heinzman; Erica M.,39,0,45,6
1746543410805,EDS 204R,B01,895693,Halter; Christopher P.,10,0,45,35
1746543411836,EDS 206R,A00,895694,Fargason; Sharon Gayle,1,0,30,29
1746543411836,EDS 206R,B00,895695,Choi; Bailey Miyeon,16,0,30,14
1746543412867,EDS 250,A00,895697,Hemans; Patricia Ann Benitez,23,0,45,22
1746543413891,EDS 281,A00,895701,Meyerott; Theresa Ann,1,0,15,14
1746543414916,EDS 284,A00,895736,Meyerott; Theresa Ann,1,0,15,14
1746543415942,EDS 286,A00,897210,Fine; Sarah,0,0,15,15
1746543416967,EDS 289C,A01,895770,Daly; Alan J.,15,0,15,0
1746543417994,EDS 290,A00,897211,Hofstetter; Carolyn,0,0,15,15
1746543419023,LIGM 5A,A00,896162,Fischer-Grunski; Eva K,13,0,20,7
1746543420052,LIGM 5B,A00,896260,Fischer-Grunski; Eva K,17,0,20,3
1746543421081,LIGM 5C,A00,896308,Fischer-Grunski; Eva K,18,0,20,2
1746543422113,LIIT 5AS,A00,896313,Carnelos; Chiara,18,0,20,2
1746543423138,LIIT 5BS,A00,896416,Carnelos; Chiara,20,0,20,0
1746543424164,LIIT 5CS,A00,896564,Carnelos; Chiara,20,0,20,0
1746543425191,LISP 5A,A00,896588,Munoz Sanchez; Alicia,3,0,20,17
1746543426217,LISP 5B,A00,896653,Munoz Sanchez; Alicia,7,0,20,13
1746543427247,LISP 5C,A00,896655,Munoz Sanchez; Alicia,0,1,20,20
1746543428272,MAE 197,001,957918,Kleissl; Jan,9996,0,9999,3
1746543428272,MAE 197,002,959806,Boechler; Nicholas Sebastia,9998,0,9999,1
1746543428272,MAE 197,003,959852,Mullin; Jennifer S,9999,0,9999,0
1746543429297,MATH 2,A01,957937,Staff,33,0,35,2
1746543430324,MATH 197,001,957876,Kedlaya; Kiran S.,9993,0,9999,6
1746543431352,MCWP 40,A00,892729,Duru; Nur,10,0,20,10
1746543431352,MCWP 40,B00,893304,Montejo; Carolina,14,0,20,6
1746543432378,MCWP 40R,A00,893757,Redela; Pamela Morgan,0,5,20,20
1746543433405,MCWP 50,A00,893758,Morshed; Michael James,0,0,20,20
1746543433405,MCWP 50,B00,893761,Bartulis; Jason Michael,17,0,20,3
1746543434434,MCWP 50R,A00,893766,Compas; Sean Matthew,0,1,20,20
1746543434434,MCWP 50R,B00,893769,Carter; Jennifer A,0,1,20,20
1746543434434,MCWP 50R,C00,893771,Krone; Jarret,0,3,20,20
1746543434434,MCWP 50R,D00,893772,Miller; Elizabeth Deen,0,0,20,20
1746543434434,MCWP 50R,E00,893775,Carter; Andrea L,0,1,20,20
1746543435459,MMW 11R,A01,892721,Herbst; Matthew,11,0,27,16
1746543435459,MMW 11R,A02,892722,Herbst; Matthew,0,0,0,3
1746543436485,MMW 12R,A01,892724,Herbst; Matthew,0,11,16,16
1746543436485,MMW 12R,A02,892725,Herbst; Matthew,0,10,16,16
1746543437513,MMW 13R,A01,892727,Staff,0,4,16,16
1746543437513,MMW 13R,A02,892728,Staff,0,4,16,16
1746543437513,MMW 13R,A03,958032,Staff,0,4,16,16
1746543437513,MMW 13R,A04,958033,Staff,0,4,16,16
1746543437513,MMW 13R,A05,958034,Staff,0,4,16,16
1746543438540,SIO 295LS,A00,894015,Staff,5,0,25,20
1746543439568,SIO 295S,A00,894020,Staff,5,0,25,20
1746543440602,SIOC 290S,B01,958918,Merrifield; Mark A,14,0,30,16
1746543441630,SIOC 291S,B01,958922,Gabriel; Corey John,14,0,30,16
1746543442657,SOCI 117,A01,895339,Staff,3,0,5,2
1746543443684,WES 237B,A00,894149,Staff,11,0,20,9
1746543445749,AESE 279B,A00,891859,Staff,13,0,35,22
1746543446774,AIP 197,001,891854,Vespa; Emanuel Ignacio,9999,0,9999,0
1746543448831,ANTH 289S,A00,891856,Gagneux; Pascal,12,0,12,0
1746543449856,BENG 196,001,957946,Engler; Adam J.,9996,0,9999,3
1746543450885,BISP 197,001,959851,Wilhelm; James E.,9999,0,9999,0
1746543451910,CAT 124RS,A01,956906,Staff,6,0,25,19
1746543452939,CAT 125RS,A01,922013,Staff,6,0,25,19
1746543453963,CLRE 250,A00,891860,Morris; Sheldon,9995,0,9999,4
1746543456017,CLRE 251R,A00,907817,Mehta; Ravindra L.,9994,0,9999,5
1746543457041,CLRE 252,A00,891864,Cuomo; Raphael Eduardo,9993,0,9999,6
1746543458070,CLRE 253,A00,891867,Vaida; Florin,9994,0,9999,5
1746543458070,CLRE 253,B00,907819,Staff,9999,0,9999,0
1746543459100,CLRE 259,A00,891868,Patel; Hemal,9998,0,9999,1
1746543460126,CLRE 260,A00,891872,Cuomo; Raphael Eduardo,9999,0,9999,0
1746543461152,CLRE 297,001,891888,Cuomo; Raphael Eduardo,9999,0,9999,0
1746543462178,CSE 191,A00,958773,Minnes Kemp; Mor Mia,9996,0,9999,3
1746543463205,CSE 197,001,959846,Minnes Kemp; Mor Mia,9993,0,9999,6
1746543464230,CSS 201S,A01,892054,Mignozzetti; Umberto,26,0,30,4
1746543465255,CSS 202S,A01,892056,Mignozzetti; Umberto,26,0,30,4
1746543466281,DSC 197,001,956898,Eldridge; Justin Matthew,9998,0,9999,1
1746543467310,DSC 297,001,958000,Mazumdar; Arya,9998,0,9999,1
1746543467310,DSC 297,002,959862,Wang; Yusu,9999,0,9999,0
1746543468337,EAP 100,A00,905686,Staff,9778,0,9999,221
1746543469367,ECE 45,A01,892618,Staff,0,0,65,65
1746543471416,ECE 111,A01,892719,Staff,4,0,65,61
1746543472443,ECE 197,001,957920,Mercier; Patrick Philip,9991,0,9999,8
1746543473469,ECON 178,A01,907814,Zhu; Ying,26,0,35,9
1746543474496,EDS 115,A00,895312,Staff,36,0,45,9
1746543475523,EDS 117,A01,895337,Staff,24,0,30,6
1746543476552,EDS 125,A00,895341,Jones; Gabrielle Anastasia,37,0,45,8
1746543477580,EDS 128A,A01,895459,Fargason; Sharon Gayle,44,0,45,1
1746543478606,EDS 128B,A01,895543,Pappas; Elizabeth,44,0,45,1
1746543479632,EDS 139,A00,897203,Pappas; Elizabeth,44,0,45,1
1746543479632,EDS 139,B00,897209,Fargason; Sharon Gayle,41,0,45,4
1746543480657,EDS 201,A00,895545,Staff,23,0,45,22
1746543481682,EDS 203,A01,895581,Halter; Christopher P.,23,0,45,22
1746543482708,EDS 204R,A01,895625,Heinzman; Erica M.,39,0,45,6
1746543482708,EDS 204R,B01,895693,Halter; Christopher P.,10,0,45,35
1746543483735,EDS 206R,A00,895694,Fargason; Sharon Gayle,1,0,30,29
1746543483735,EDS 206R,B00,895695,Choi; Bailey Miyeon,16,0,30,14
1746543484763,EDS 250,A00,895697,Hemans; Patricia Ann Benitez,23,0,45,22
1746543485788,EDS 281,A00,895701,Meyerott; Theresa Ann,1,0,15,14
1746543486816,EDS 284,A00,895736,Meyerott; Theresa Ann,1,0,15,14
1746543487843,EDS 286,A00,897210,Fine; Sarah,0,0,15,15
1746543488871,EDS 289C,A01,895770,Daly; Alan J.,15,0,15,0
1746543489897,EDS 290,A00,897211,Hofstetter; Carolyn,0,0,15,15
1746543490923,LIGM 5A,A00,896162,Fischer-Grunski; Eva K,13,0,20,7
1746543491948,LIGM 5B,A00,896260,Fischer-Grunski; Eva K,17,0,20,3
1746543492978,LIGM 5C,A00,896308,Fischer-Grunski; Eva K,18,0,20,2
1746543494007,LIIT 5AS,A00,896313,Carnelos; Chiara,18,0,20,2
1746543495037,LIIT 5BS,A00,896416,Carnelos; Chiara,20,0,20,0
1746543496065,LIIT 5CS,A00,896564,Carnelos; Chiara,20,0,20,0
1746543497092,LISP 5A,A00,896588,Munoz Sanchez; Alicia,3,0,20,17
1746543498122,LISP 5B,A00,896653,Munoz Sanchez; Alicia,7,0,20,13
1746543499148,LISP 5C,A00,896655,Munoz Sanchez; Alicia,0,1,20,20
1746543500176,MAE 197,001,957918,Kleissl; Jan,9996,0,9999,3
1746543500176,MAE 197,002,959806,Boechler; Nicholas Sebastia,9998,0,9999,1
1746543500176,MAE 197,003,959852,Mullin; Jennifer S,9999,0,9999,0
1746543501202,MATH 2,A01,957937,Staff,33,0,35,2
1746543502230,MATH 197,001,957876,Kedlaya; Kiran S.,9993,0,9999,6
1746543503255,MCWP 40,A00,892729,Duru; Nur,10,0,20,10
1746543503255,MCWP 40,B00,893304,Montejo; Carolina,14,0,20,6
1746543504284,MCWP 40R,A00,893757,Redela; Pamela Morgan,0,5,20,20
1746543505310,MCWP 50,A00,893758,Morshed; Michael James,0,0,20,20
1746543505310,MCWP 50,B00,893761,Bartulis; Jason Michael,17,0,20,3
1746543506337,MCWP 50R,A00,893766,Compas; Sean Matthew,0,1,20,20
1746543506337,MCWP 50R,B00,893769,Carter; Jennifer A,0,1,20,20
1746543506337,MCWP 50R,C00,893771,Krone; Jarret,0,3,20,20
1746543506337,MCWP 50R,D00,893772,Miller; Elizabeth Deen,0,0,20,20
1746543506337,MCWP 50R,E00,893775,Carter; Andrea L,0,1,20,20
1746543507364,MMW 11R,A01,892721,Herbst; Matthew,11,0,27,16
1746543507364,MMW 11R,A02,892722,Herbst; Matthew,0,0,0,3
1746543508390,MMW 12R,A01,892724,Herbst; Matthew,0,11,16,16
1746543508390,MMW 12R,A02,892725,Herbst; Matthew,0,10,16,16
1746543509416,MMW 13R,A01,892727,Staff,0,4,16,16
1746543509416,MMW 13R,A02,892728,Staff,0,4,16,16
1746543509416,MMW 13R,A03,958032,Staff,0,4,16,16
1746543509416,MMW 13R,A04,958033,Staff,0,4,16,16
1746543509416,MMW 13R,A05,958034,Staff,0,4,16,16
1746543510442,SIO 295LS,A00,894015,Staff,5,0,25,20
1746543511468,SIO 295S,A00,894020,Staff,5,0,25,20
1746543512497,SIOC 290S,B01,958918,Merrifield; Mark A,14,0,30,16
1746543513523,SIOC 291S,B01,958922,Gabriel; Corey John,14,0,30,16
1746543514550,SOCI 117,A01,895339,Staff,3,0,5,2
1746543515573,WES 237B,A00,894149,Staff,11,0,20,9
1746543517641,AESE 279B,A00,891859,Staff,13,0,35,22
1746543518671,AIP 197,001,891854,Vespa; Emanuel Ignacio,9999,0,9999,0
1746543519699,ANTH 289S,A00,891856,Gagneux; Pascal,12,0,12,0
1746543520726,BENG 196,001,957946,Engler; Adam J.,9996,0,9999,3
1746543521754,BISP 197,001,959851,Wilhelm; James E.,9999,0,9999,0
1746543522778,CAT 124RS,A01,956906,Staff,6,0,25,19
1746543523862,CAT 125RS,A01,922013,Staff,6,0,25,19
1746543524888,CLRE 250,A00,891860,Morris; Sheldon,9995,0,9999,4
1746543526941,CLRE 251R,A00,907817,Mehta; Ravindra L.,9994,0,9999,5
1746543527965,CLRE 252,A00,891864,Cuomo; Raphael Eduardo,9993,0,9999,6
1746543528994,CLRE 253,A00,891867,Vaida; Florin,9994,0,9999,5
1746543528994,CLRE 253,B00,907819,Staff,9999,0,9999,0
1746543530023,CLRE 259,A00,891868,Patel; Hemal,9998,0,9999,1
1746543531049,CLRE 260,A00,891872,Cuomo; Raphael Eduardo,9999,0,9999,0
1746543532076,CLRE 297,001,891888,Cuomo; Raphael Eduardo,9999,0,9999,0
1746543533101,CSE 191,A00,958773,Minnes Kemp; Mor Mia,9996,0,9999,3
1746543534125,CSE 197,001,959846,Minnes Kemp; Mor Mia,9993,0,9999,6
1746543535156,CSS 201S,A01,892054,Mignozzetti; Umberto,26,0,30,4
1746543536182,CSS 202S,A01,892056,Mignozzetti; Umberto,26,0,30,4
1746543537206,DSC 197,001,956898,Eldridge; Justin Matthew,9998,0,9999,1
1746543538231,DSC 297,001,958000,Mazumdar; Arya,9998,0,9999,1
1746543538231,DSC 297,002,959862,Wang; Yusu,9999,0,9999,0
1746543539257,EAP 100,A00,905686,Staff,9778,0,9999,221
1746543540327,ECE 45,A01,892618,Staff,0,0,65,65
1746543542385,ECE 111,A01,892719,Staff,4,0,65,61
1746543543412,ECE 197,001,957920,Mercier; Patrick Philip,9991,0,9999,8
1746543544438,ECON 178,A01,907814,Zhu; Ying,26,0,35,9
1746543545462,EDS 115,A00,895312,Staff,36,0,45,9
1746543546489,EDS 117,A01,895337,Staff,24,0,30,6
1746543547514,EDS 125,A00,895341,Jones; Gabrielle Anastasia,37,0,45,8
1746543548543,EDS 128A,A01,895459,Fargason; Sharon Gayle,44,0,45,1
1746543549567,EDS 128B,A01,895543,Pappas; Elizabeth,44,0,45,1
1746543550595,EDS 139,A00,897203,Pappas; Elizabeth,44,0,45,1
1746543550595,EDS 139,B00,897209,Fargason; Sharon Gayle,41,0,45,4
1746543551620,EDS 201,A00,895545,Staff,23,0,45,22
1746543552644,EDS 203,A01,895581,Halter; Christopher P.,23,0,45,22
1746543553669,EDS 204R,A01,895625,Heinzman; Erica M.,39,0,45,6
1746543553669,EDS 204R,B01,895693,Halter; Christopher P.,10,0,45,35
1746543554698,EDS 206R,A00,895694,Fargason; Sharon Gayle,1,0,30,29
1746543554698,EDS 206R,B00,895695,Choi; Bailey Miyeon,16,0,30,14
1746543555725,EDS 250,A00,895697,Hemans; Patricia Ann Benitez,23,0,45,22
1746543556752,EDS 281,A00,895701,Meyerott; Theresa Ann,1,0,15,14
1746543557778,EDS 284,A00,895736,Meyerott; Theresa Ann,1,0,15,14
1746543558806,EDS 286,A00,897210,Fine; Sarah,0,0,15,15
1746543559830,EDS 289C,A01,895770,Daly; Alan J.,15,0,15,0
1746543560856,EDS 290,A00,897211,Hofstetter; Carolyn,0,0,15,15
1746543561884,LIGM 5A,A00,896162,Fischer-Grunski; Eva K,13,0,20,7
1746543562910,LIGM 5B,A00,896260,Fischer-Grunski; Eva K,17,0,20,3
1746543563935,LIGM 5C,A00,896308,Fischer-Grunski; Eva K,18,0,20,2
1746543564960,LIIT 5AS,A00,896313,Carnelos; Chiara,18,0,20,2
1746543565987,LIIT 5BS,A00,896416,Carnelos; Chiara,20,0,20,0
1746543567013,LIIT 5CS,A00,896564,Carnelos; Chiara,20,0,20,0
1746543568041,LISP 5A,A00,896588,Munoz Sanchez; Alicia,3,0,20,17
1746543569067,LISP 5B,A00,896653,Munoz Sanchez; Alicia,7,0,20,13
1746543570092,LISP 5C,A00,896655,Munoz Sanchez; Alicia,0,1,20,20
1746543571122,MAE 197,001,957918,Kleissl; Jan,9996,0,9999,3
1746543571122,MAE 197,002,959806,Boechler; Nicholas Sebastia,9998,0,9999,1
1746543571122,MAE 197,003,959852,Mullin; Jennifer S,9999,0,9999,0
1746543572149,MATH 2,A01,957937,Staff,33,0,35,2
1746543573174,MATH 197,001,957876,Kedlaya; Kiran S.,9993,0,9999,6
1746543574203,MCWP 40,A00,892729,Duru; Nur,10,0,20,10
1746543574203,MCWP 40,B00,893304,Montejo; Carolina,14,0,20,6
1746543575227,MCWP 40R,A00,893757,Redela; Pamela Morgan,0,5,20,20
1746543576253,MCWP 50,A00,893758,Morshed; Michael James,0,0,20,20
1746543576253,MCWP 50,B00,893761,Bartulis; Jason Michael,17,0,20,3
1746543577279,MCWP 50R,A00,893766,Compas; Sean Matthew,0,1,20,20
1746543577279,MCWP 50R,B00,893769,Carter; Jennifer A,0,1,20,20
1746543577279,MCWP 50R,C00,893771,Krone; Jarret,0,3,20,20
1746543577279,MCWP 50R,D00,893772,Miller; Elizabeth Deen,0,0,20,20
1746543577279,MCWP 50R,E00,893775,Carter; Andrea L,0,1,20,20
1746543578306,MMW 11R,A01,892721,Herbst; Matthew,11,0,27,16
1746543578306,MMW 11R,A02,892722,Herbst; Matthew,0,0,0,3
1746543579334,MMW 12R,A01,892724,Herbst; Matthew,0,11,16,16
1746543579334,MMW 12R,A02,892725,Herbst; Matthew,0,10,16,16
1746543580358,MMW 13R,A01,892727,Staff,0,4,16,16
1746543580358,MMW 13R,A02,892728,Staff,0,4,16,16
1746543580358,MMW 13R,A03,958032,Staff,0,4,16,16
1746543580358,MMW 13R,A04,958033,Staff,0,4,16,16
1746543580358,MMW 13R,A05,958034,Staff,0,4,16,16
1746543581382,SIO 295LS,A00,894015,Staff,5,0,25,20
1746543582420,SIO 295S,A00,894020,Staff,5,0,25,20
1746543583445,SIOC 290S,B01,958918,Merrifield; Mark A,14,0,30,16
1746543584470,SIOC 291S,B01,958922,Gabriel; Corey John,14,0,30,16
1746543585498,SOCI 117,A01,895339,Staff,3,0,5,2
1746543586523,WES 237B,A00,894149,Staff,11,0,20,9
1746543588596,AESE 279B,A00,891859,Staff,13,0,35,22
1746543589627,AIP 197,001,891854,Vespa; Emanuel Ignacio,9999,0,9999,0
1746543590652,ANTH 289S,A00,891856,Gagneux; Pascal,12,0,12,0
1746543591678,BENG 196,001,957946,Engler; Adam J.,9996,0,9999,3
1746543592706,BISP 197,001,959851,Wilhelm; James E.,9999,0,9999,0
1746543593731,CAT 124RS,A01,956906,Staff,6,0,25,19
1746543594763,CAT 125RS,A01,922013,Staff,6,0,25,19
1746543595790,CLRE 250,A00,891860,Morris; Sheldon,9995,0,9999,4
1746543597843,CLRE 251R,A00,907817,Mehta; Ravindra L.,9994,0,9999,5
1746543598868,CLRE 252,A00,891864,Cuomo; Raphael Eduardo,9993,0,9999,6
1746543599897,CLRE 253,A00,891867,Vaida; Florin,9994,0,9999,5
1746543599897,CLRE 253,B00,907819,Staff,9999,0,9999,0
1746543600923,CLRE 259,A00,891868,Patel; Hemal,9998,0,9999,1
1746543601948,CLRE 260,A00,891872,Cuomo; Raphael Eduardo,9999,0,9999,0
1746543602977,CLRE 297,001,891888,Cuomo; Raphael Eduardo,9999,0,9999,0
1746543604002,CSE 191,A00,958773,Minnes Kemp; Mor Mia,9996,0,9999,3
1746543605028,CSE 197,001,959846,Minnes Kemp; Mor Mia,9993,0,9999,6
1746543606059,CSS 201S,A01,892054,Mignozzetti; Umberto,26,0,30,4
1746543607085,CSS 202S,A01,892056,Mignozzetti; Umberto,26,0,30,4
1746543608112,DSC 197,001,956898,Eldridge; Justin Matthew,9998,0,9999,1
1746543609143,DSC 297,001,958000,Mazumdar; Arya,9998,0,9999,1
1746543609143,DSC 297,002,959862,Wang; Yusu,9999,0,9999,0
1746543610168,EAP 100,A00,905686,Staff,9778,0,9999,221
1746543611197,ECE 45,A01,892618,Staff,0,0,65,65
1746543613248,ECE 111,A01,892719,Staff,4,0,65,61
1746543614276,ECE 197,001,957920,Mercier; Patrick Philip,9991,0,9999,8
1746543615304,ECON 178,A01,907814,Zhu; Ying,26,0,35,9
1746543616331,EDS 115,A00,895312,Staff,36,0,45,9
1746543617362,EDS 117,A01,895337,Staff,24,0,30,6
1746543618388,EDS 125,A00,895341,Jones; Gabrielle Anastasia,37,0,45,8
1746543619413,EDS 128A,A01,895459,Fargason; Sharon Gayle,44,0,45,1
1746543620442,EDS 128B,A01,895543,Pappas; Elizabeth,44,0,45,1
1746543621472,EDS 139,A00,897203,Pappas; Elizabeth,44,0,45,1
1746543621472,EDS 139,B00,897209,Fargason; Sharon Gayle,41,0,45,4
1746543622500,EDS 201,A00,895545,Staff,23,0,45,22
1746543623526,EDS 203,A01,895581,Halter; Christopher P.,23,0,45,22
1746543624553,EDS 204R,A01,895625,Heinzman; Erica M.,39,0,45,6
1746543624553,EDS 204R,B01,895693,Halter; Christopher P.,10,0,45,35
1746543625579,EDS 206R,A00,895694,Fargason; Sharon Gayle,1,0,30,29
1746543625579,EDS 206R,B00,895695,Choi; Bailey Miyeon,16,0,30,14
1746543626605,EDS 250,A00,895697,Hemans; Patricia Ann Benitez,23,0,45,22
1746543627670,EDS 281,A00,895701,Meyerott; Theresa Ann,1,0,15,14
1746543628697,EDS 284,A00,895736,Meyerott; Theresa Ann,1,0,15,14
1746543629724,EDS 286,A00,897210,Fine; Sarah,0,0,15,15
1746543630749,EDS 289C,A01,895770,Daly; Alan J.,15,0,15,0
1746543631777,EDS 290,A00,897211,Hofstetter; Carolyn,0,0,15,15
1746543632806,LIGM 5A,A00,896162,Fischer-Grunski; Eva K,13,0,20,7
1746543633836,LIGM 5B,A00,896260,Fischer-Grunski; Eva K,17,0,20,3
1746543634865,LIGM 5C,A00,896308,Fischer-Grunski; Eva K,18,0,20,2
1746543635891,LIIT 5AS,A00,896313,Carnelos; Chiara,18,0,20,2
1746543636917,LIIT 5BS,A00,896416,Carnelos; Chiara,20,0,20,0
1746543637942,LIIT 5CS,A00,896564,Carnelos; Chiara,20,0,20,0
1746543638967,LISP 5A,A00,896588,Munoz Sanchez; Alicia,3,0,20,17
1746543639993,LISP 5B,A00,896653,Munoz Sanchez; Alicia,7,0,20,13
1746543641018,LISP 5C,A00,896655,Munoz Sanchez; Alicia,0,1,20,20
1746543642048,MAE 197,001,957918,Kleissl; Jan,9996,0,9999,3
1746543642048,MAE 197,002,959806,Boechler; Nicholas Sebastia,9998,0,9999,1
1746543642048,MAE 197,003,959852,Mullin; Jennifer S,9999,0,9999,0
1746543643077,MATH 2,A01,957937,Staff,33,0,35,2
1746543644102,MATH 197,001,957876,Kedlaya; Kiran S.,9993,0,9999,6
1746543645132,MCWP 40,A00,892729,Duru; Nur,10,0,20,10
1746543645132,MCWP 40,B00,893304,Montejo; Carolina,14,0,20,6
1746543646157,MCWP 40R,A00,893757,Redela; Pamela Morgan,0,5,20,20
1746543647186,MCWP 50,A00,893758,Morshed; Michael James,0,0,20,20
1746543647186,MCWP 50,B00,893761,Bartulis; Jason Michael,17,0,20,3
1746543648212,MCWP 50R,A00,893766,Compas; Sean Matthew,0,1,20,20
1746543648212,MCWP 50R,B00,893769,Carter; Jennifer A,0,1,20,20
1746543648212,MCWP 50R,C00,893771,Krone; Jarret,0,3,20,20
1746543648212,MCWP 50R,D00,893772,Miller; Elizabeth Deen,0,0,20,20
1746543648212,MCWP 50R,E00,893775,Carter; Andrea L,0,1,20,20
1746543649237,MMW 11R,A01,892721,Herbst; Matthew,11,0,27,16
1746543649237,MMW 11R,A02,892722,Herbst; Matthew,0,0,0,3
1746543650262,MMW 12R,A01,892724,Herbst; Matthew,0,11,16,16
1746543650262,MMW 12R,A02,892725,Herbst; Matthew,0,10,16,16
1746543651289,MMW 13R,A01,892727,Staff,0,4,16,16
1746543651289,MMW 13R,A02,892728,Staff,0,4,16,16
1746543651289,MMW 13R,A03,958032,Staff,0,4,16,16
1746543651289,MMW 13R,A04,958033,Staff,0,4,16,16
1746543651289,MMW 13R,A05,958034,Staff,0,4,16,16
1746543652316,SIO 295LS,A00,894015,Staff,5,0,25,20
1746543653345,SIO 295S,A00,894020,Staff,5,0,25,20
1746543654371,SIOC 290S,B01,958918,Merrifield; Mark A,14,0,30,16
1746543655398,SIOC 291S,B01,958922,Gabriel; Corey John,14,0,30,16
1746543656423,SOCI 117,A01,895339,Staff,3,0,5,2
1746543657447,WES 237B,A00,894149,Staff,11,0,20,9
1746543659512,AESE 279B,A00,891859,Staff,13,0,35,22
1746543660541,AIP 197,001,891854,Vespa; Emanuel Ignacio,9999,0,9999,0
1746543661570,ANTH 289S,A00,891856,Gagneux; Pascal,12,0,12,0
1746543662597,BENG 196,001,957946,Engler; Adam J.,9996,0,9999,3
1746543663625,BISP 197,001,959851,Wilhelm; James E.,9999,0,9999,0
1746543664650,CAT 124RS,A01,956906,Staff,6,0,25,19
1746543665678,CAT 125RS,A01,922013,Staff,6,0,25,19
1746543666708,CLRE 250,A00,891860,Morris; Sheldon,9995,0,9999,4
1746543668767,CLRE 251R,A00,907817,Mehta; Ravindra L.,9994,0,9999,5
1746543669794,CLRE 252,A00,891864,Cuomo; Raphael Eduardo,9993,0,9999,6
1746543670822,CLRE 253,A00,891867,Vaida; Florin,9994,0,9999,5
1746543670822,CLRE 253,B00,907819,Staff,9999,0,9999,0
1746543671849,CLRE 259,A00,891868,Patel; Hemal,9998,0,9999,1
1746543672873,CLRE 260,A00,891872,Cuomo; Raphael Eduardo,9999,0,9999,0
1746543673900,CLRE 297,001,891888,Cuomo; Raphael Eduardo,9999,0,9999,0
1746543674930,CSE 191,A00,958773,Minnes Kemp; Mor Mia,9996,0,9999,3
1746543675955,CSE 197,001,959846,Minnes Kemp; Mor Mia,9993,0,9999,6
1746543676981,CSS 201S,A01,892054,Mignozzetti; Umberto,26,0,30,4
1746543678007,CSS 202S,A01,892056,Mignozzetti; Umberto,26,0,30,4
1746543679033,DSC 197,001,956898,Eldridge; Justin Matthew,9998,0,9999,1
1746543680058,DSC 297,001,958000,Mazumdar; Arya,9998,0,9999,1
1746543680058,DSC 297,002,959862,Wang; Yusu,9999,0,9999,0
1746543681085,EAP 100,A00,905686,Staff,9778,0,9999,221
1746543682109,ECE 45,A01,892618,Staff,0,0,65,65
1746543684163,ECE 111,A01,892719,Staff,4,0,65,61
1746543685188,ECE 197,001,957920,Mercier; Patrick Philip,9991,0,9999,8
1746543686214,ECON 178,A01,907814,Zhu; Ying,26,0,35,9
1746543687239,EDS 115,A00,895312,Staff,36,0,45,9
1746543688266,EDS 117,A01,895337,Staff,24,0,30,6
1746543689293,EDS 125,A00,895341,Jones; Gabrielle Anastasia,37,0,45,8
1746543690319,EDS 128A,A01,895459,Fargason; Sharon Gayle,44,0,45,1
1746543691347,EDS 128B,A01,895543,Pappas; Elizabeth,44,0,45,1
1746543692375,EDS 139,A00,897203,Pappas; Elizabeth,44,0,45,1
1746543692375,EDS 139,B00,897209,Fargason; Sharon Gayle,41,0,45,4
1746543693402,EDS 201,A00,895545,Staff,23,0,45,22
1746543694427,EDS 203,A01,895581,Halter; Christopher P.,23,0,45,22
1746543695456,EDS 204R,A01,895625,Heinzman; Erica M.,39,0,45,6
1746543695456,EDS 204R,B01,895693,Halter; Christopher P.,10,0,45,35
1746543696481,EDS 206R,A00,895694,Fargason; Sharon Gayle,1,0,30,29
1746543696481,EDS 206R,B00,895695,Choi; Bailey Miyeon,16,0,30,14
1746543697507,EDS 250,A00,895697,Hemans; Patricia Ann Benitez,23,0,45,22
1746543698531,EDS 281,A00,895701,Meyerott; Theresa Ann,1,0,15,14
1746543699557,EDS 284,A00,895736,Meyerott; Theresa Ann,1,0,15,14
1746543700584,EDS 286,A00,897210,Fine; Sarah,0,0,15,15
1746543701612,EDS 289C,A01,895770,Daly; Alan J.,15,0,15,0
1746543702640,EDS 290,A00,897211,Hofstetter; Carolyn,0,0,15,15
1746543703668,LIGM 5A,A00,896162,Fischer-Grunski; Eva K,13,0,20,7
1746543704697,LIGM 5B,A00,896260,Fischer-Grunski; Eva K,17,0,20,3
1746543705723,LIGM 5C,A00,896308,Fischer-Grunski; Eva K,18,0,20,2
1746543706749,LIIT 5AS,A00,896313,Carnelos; Chiara,18,0,20,2
1746543707776,LIIT 5BS,A00,896416,Carnelos; Chiara,20,0,20,0
1746543708802,LIIT 5CS,A00,896564,Carnelos; Chiara,20,0,20,0
1746543709846,LISP 5A,A00,896588,Munoz Sanchez; Alicia,3,0,20,17
1746543710874,LISP 5B,A00,896653,Munoz Sanchez; Alicia,7,0,20,13
1746543711901,LISP 5C,A00,896655,Munoz Sanchez; Alicia,0,1,20,20
1746543712928,MAE 197,001,957918,Kleissl; Jan,9996,0,9999,3
1746543712928,MAE 197,002,959806,Boechler; Nicholas Sebastia,9998,0,9999,1
1746543712928,MAE 197,003,959852,Mullin; Jennifer S,9999,0,9999,0
1746543713954,MATH 2,A01,957937,Staff,33,0,35,2
1746543714979,MATH 197,001,957876,Kedlaya; Kiran S.,9993,0,9999,6
1746543716005,MCWP 40,A00,892729,Duru; Nur,10,0,20,10
1746543716005,MCWP 40,B00,893304,Montejo; Carolina,14,0,20,6
1746543717031,MCWP 40R,A00,893757,Redela; Pamela Morgan,0,5,20,20
1746543718060,MCWP 50,A00,893758,Morshed; Michael James,0,0,20,20
1746543718060,MCWP 50,B00,893761,Bartulis; Jason Michael,17,0,20,3
1746543719092,MCWP 50R,A00,893766,Compas; Sean Matthew,0,1,20,20
1746543719092,MCWP 50R,B00,893769,Carter; Jennifer A,0,1,20,20
1746543719092,MCWP 50R,C00,893771,Krone; Jarret,0,3,20,20
1746543719092,MCWP 50R,D00,893772,Miller; Elizabeth Deen,0,0,20,20
1746543719092,MCWP 50R,E00,893775,Carter; Andrea L,0,1,20,20
1746543720118,MMW 11R,A01,892721,Herbst; Matthew,11,0,27,16
1746543720118,MMW 11R,A02,892722,Herbst; Matthew,0,0,0,3
1746543721147,MMW 12R,A01,892724,Herbst; Matthew,0,11,16,16
1746543721147,MMW 12R,A02,892725,Herbst; Matthew,0,10,16,16
1746543722172,MMW 13R,A01,892727,Staff,0,4,16,16
1746543722172,MMW 13R,A02,892728,Staff,0,4,16,16
1746543722172,MMW 13R,A03,958032,Staff,0,4,16,16
1746543722172,MMW 13R,A04,958033,Staff,0,4,16,16
1746543722172,MMW 13R,A05,958034,Staff,0,4,16,16
1746543723198,SIO 295LS,A00,894015,Staff,5,0,25,20
1746543724224,SIO 295S,A00,894020,Staff,5,0,25,20
1746543725257,SIOC 290S,B01,958918,Merrifield; Mark A,14,0,30,16
1746543726288,SIOC 291S,B01,958922,Gabriel; Corey John,14,0,30,16
1746543727317,SOCI 117,A01,895339,Staff,3,0,5,2
1746543728344,WES 237B,A00,894149,Staff,11,0,20,9
1746543730421,AESE 279B,A00,891859,Staff,13,0,35,22
1746543731502,AIP 197,001,891854,Vespa; Emanuel Ignacio,9999,0,9999,0
1746543732528,ANTH 289S,A00,891856,Gagneux; Pascal,12,0,12,0
1746543733555,BENG 196,001,957946,Engler; Adam J.,9996,0,9999,3
1746543734579,BISP 197,001,959851,Wilhelm; James E.,9999,0,9999,0
1746543735604,CAT 124RS,A01,956906,Staff,6,0,25,19
1746543736629,CAT 125RS,A01,922013,Staff,6,0,25,19
1746543737657,CLRE 250,A00,891860,Morris; Sheldon,9995,0,9999,4
1746543739710,CLRE 251R,A00,907817,Mehta; Ravindra L.,9994,0,9999,5
1746543740735,CLRE 252,A00,891864,Cuomo; Raphael Eduardo,9993,0,9999,6
1746543741761,CLRE 253,A00,891867,Vaida; Florin,9994,0,9999,5
1746543741761,CLRE 253,B00,907819,Staff,9999,0,9999,0
1746543742785,CLRE 259,A00,891868,Patel; Hemal,9998,0,9999,1
1746543743809,CLRE 260,A00,891872,Cuomo; Raphael Eduardo,9999,0,9999,0
1746543744838,CLRE 297,001,891888,Cuomo; Raphael Eduardo,9999,0,9999,0
1746543745862,CSE 191,A00,958773,Minnes Kemp; Mor Mia,9996,0,9999,3
1746543746886,CSE 197,001,959846,Minnes Kemp; Mor Mia,9993,0,9999,6
1746543747911,CSS 201S,A01,892054,Mignozzetti; Umberto,26,0,30,4
1746543748936,CSS 202S,A01,892056,Mignozzetti; Umberto,26,0,30,4
1746543749961,DSC 197,001,956898,Eldridge; Justin Matthew,9998,0,9999,1
1746543750988,DSC 297,001,958000,Mazumdar; Arya,9998,0,9999,1
1746543750988,DSC 297,002,959862,Wang; Yusu,9999,0,9999,0
1746543752011,EAP 100,A00,905686,Staff,9778,0,9999,221
1746543753037,ECE 45,A01,892618,Staff,0,0,65,65
1746543755088,ECE 111,A01,892719,Staff,4,0,65,61
1746543756113,ECE 197,001,957920,Mercier; Patrick Philip,9991,0,9999,8
1746543757138,ECON 178,A01,907814,Zhu; Ying,26,0,35,9
1746543758163,EDS 115,A00,895312,Staff,36,0,45,9
1746543759190,EDS 117,A01,895337,Staff,24,0,30,6
1746543760216,EDS 125,A00,895341,Jones; Gabrielle Anastasia,37,0,45,8
1746543761241,EDS 128A,A01,895459,Fargason; Sharon Gayle,44,0,45,1
1746543762265,EDS 128B,A01,895543,Pappas; Elizabeth,44,0,45,1
1746543763289,EDS 139,A00,897203,Pappas; Elizabeth,44,0,45,1
1746543763289,EDS 139,B00,897209,Fargason; Sharon Gayle,41,0,45,4
1746543764317,EDS 201,A00,895545,Staff,23,0,45,22
1746543765343,EDS 203,A01,895581,Halter; Christopher P.,23,0,45,22
1746543766367,EDS 204R,A01,895625,Heinzman; Erica M.,39,0,45,6
1746543766367,EDS 204R,B01,895693,Halter; Christopher P.,10,0,45,35
1746543767393,EDS 206R,A00,895694,Fargason; Sharon Gayle,1,0,30,29
1746543767393,EDS 206R,B00,895695,Choi; Bailey Miyeon,16,0,30,14
1746543768418,EDS 250,A00,895697,Hemans; Patricia Ann Benitez,23,0,45,22
1746543769443,EDS 281,A00,895701,Meyerott; Theresa Ann,1,0,15,14
1746543770466,EDS 284,A00,895736,Meyerott; Theresa Ann,1,0,15,14
1746543771491,EDS 286,A00,897210,Fine; Sarah,0,0,15,15
1746543772520,EDS 289C,A01,895770,Daly; Alan J.,15,0,15,0
1746543773549,EDS 290,A00,897211,Hofstetter; Carolyn,0,0,15,15
1746543774573,LIGM 5A,A00,896162,Fischer-Grunski; Eva K,13,0,20,7
1746543775603,LIGM 5B,A00,896260,Fischer-Grunski; Eva K,17,0,20,3
1746543776632,LIGM 5C,A00,896308,Fischer-Grunski; Eva K,18,0,20,2
1746543777657,LIIT 5AS,A00,896313,Carnelos; Chiara,18,0,20,2
1746543778683,LIIT 5BS,A00,896416,Carnelos; Chiara,20,0,20,0
1746543779710,LIIT 5CS,A00,896564,Carnelos; Chiara,20,0,20,0
1746543780735,LISP 5A,A00,896588,Munoz Sanchez; Alicia,3,0,20,17
1746543781761,LISP 5B,A00,896653,Munoz Sanchez; Alicia,7,0,20,13
1746543782787,LISP 5C,A00,896655,Munoz Sanchez; Alicia,0,1,20,20
1746543783812,MAE 197,001,957918,Kleissl; Jan,9996,0,9999,3
1746543783812,MAE 197,002,959806,Boechler; Nicholas Sebastia,9998,0,9999,1
1746543783812,MAE 197,003,959852,Mullin; Jennifer S,9999,0,9999,0
1746543784837,MATH 2,A01,957937,Staff,33,0,35,2
1746543785862,MATH 197,001,957876,Kedlaya; Kiran S.,9993,0,9999,6
1746543786891,MCWP 40,A00,892729,Duru; Nur,10,0,20,10
1746543786891,MCWP 40,B00,893304,Montejo; Carolina,14,0,20,6
1746543787917,MCWP 40R,A00,893757,Redela; Pamela Morgan,0,5,20,20
1746543788941,MCWP 50,A00,893758,Morshed; Michael James,0,0,20,20
1746543788941,MCWP 50,B00,893761,Bartulis; Jason Michael,17,0,20,3
1746543789967,MCWP 50R,A00,893766,Compas; Sean Matthew,0,1,20,20
1746543789967,MCWP 50R,B00,893769,Carter; Jennifer A,0,1,20,20
1746543789967,MCWP 50R,C00,893771,Krone; Jarret,0,3,20,20
1746543789967,MCWP 50R,D00,893772,Miller; Elizabeth Deen,0,0,20,20
1746543789967,MCWP 50R,E00,893775,Carter; Andrea L,0,1,20,20
1746543790996,MMW 11R,A01,892721,Herbst; Matthew,11,0,27,16
1746543790996,MMW 11R,A02,892722,Herbst; Matthew,0,0,0,3
1746543792021,MMW 12R,A01,892724,Herbst; Matthew,0,11,16,16
1746543792021,MMW 12R,A02,892725,Herbst; Matthew,0,10,16,16
1746543793048,MMW 13R,A01,892727,Staff,0,4,16,16
1746543793048,MMW 13R,A02,892728,Staff,0,4,16,16
1746543793048,MMW 13R,A03,958032,Staff,0,4,16,16
1746543793048,MMW 13R,A04,958033,Staff,0,4,16,16
1746543793048,MMW 13R,A05,958034,Staff,0,4,16,16
1746543794074,SIO 295LS,A00,894015,Staff,5,0,25,20
1746543795103,SIO 295S,A00,894020,Staff,5,0,25,20
1746543796145,SIOC 290S,B01,958918,Merrifield; Mark A,14,0,30,16
1746543797171,SIOC 291S,B01,958922,Gabriel; Corey John,14,0,30,16
1746543798195,SOCI 117,A01,895339,Staff,3,0,5,2
1746543799223,WES 237B,A00,894149,Staff,11,0,20,9
1746543801294,AESE 279B,A00,891859,Staff,13,0,35,22
1746543802319,AIP 197,001,891854,Vespa; Emanuel Ignacio,9999,0,9999,0
1746543803346,ANTH 289S,A00,891856,Gagneux; Pascal,12,0,12,0
1746543804370,BENG 196,001,957946,Engler; Adam J.,9996,0,9999,3
1746543805398,BISP 197,001,959851,Wilhelm; James E.,9999,0,9999,0
1746543806423,CAT 124RS,A01,956906,Staff,6,0,25,19
1746543807450,CAT 125RS,A01,922013,Staff,6,0,25,19
1746543808474,CLRE 250,A00,891860,Morris; Sheldon,9995,0,9999,4
1746543810526,CLRE 251R,A00,907817,Mehta; Ravindra L.,9994,0,9999,5
1746543811553,CLRE 252,A00,891864,Cuomo; Raphael Eduardo,9993,0,9999,6
1746543812578,CLRE 253,A00,891867,Vaida; Florin,9994,0,9999,5
1746543812578,CLRE 253,B00,907819,Staff,9999,0,9999,0
1746543813605,CLRE 259,A00,891868,Patel; Hemal,9998,0,9999,1
1746543814628,CLRE 260,A00,891872,Cuomo; Raphael Eduardo,9999,0,9999,0
1746543815656,CLRE 297,001,891888,Cuomo; Raphael Eduardo,9999,0,9999,0
1746543816684,CSE 191,A00,958773,Minnes Kemp; Mor Mia,9996,0,9999,3
1746543817710,CSE 197,001,959846,Minnes Kemp; Mor Mia,9993,0,9999,6
1746543818736,CSS 201S,A01,892054,Mignozzetti; Umberto,26,0,30,4
1746543819761,CSS 202S,A01,892056,Mignozzetti; Umberto,26,0,30,4
1746543820787,DSC 197,001,956898,Eldridge; Justin Matthew,9998,0,9999,1
1746543821812,DSC 297,001,958000,Mazumdar; Arya,9998,0,9999,1
1746543821812,DSC 297,002,959862,Wang; Yusu,9999,0,9999,0
1746543822839,EAP 100,A00,905686,Staff,9778,0,9999,221
1746543823869,ECE 45,A01,892618,Staff,0,0,65,65
1746543825919,ECE 111,A01,892719,Staff,4,0,65,61
1746543826943,ECE 197,001,957920,Mercier; Patrick Philip,9991,0,9999,8
1746543827969,ECON 178,A01,907814,Zhu; Ying,26,0,35,9
1746543828996,EDS 115,A00,895312,Staff,36,0,45,9
1746543830022,EDS 117,A01,895337,Staff,24,0,30,6
1746543831047,EDS 125,A00,895341,Jones; Gabrielle Anastasia,37,0,45,8
1746543832075,EDS 128A,A01,895459,Fargason; Sharon Gayle,44,0,45,1
1746543833105,EDS 128B,A01,895543,Pappas; Elizabeth,44,0,45,1
1746543834133,EDS 139,A00,897203,Pappas; Elizabeth,44,0,45,1
1746543834133,EDS 139,B00,897209,Fargason; Sharon Gayle,41,0,45,4
1746543835197,EDS 201,A00,895545,Staff,23,0,45,22
1746543836221,EDS 203,A01,895581,Halter; Christopher P.,23,0,45,22
1746543837249,EDS 204R,A01,895625,Heinzman; Erica M.,39,0,45,6
1746543837249,EDS 204R,B01,895693,Halter; Christopher P.,10,0,45,35
1746543838276,EDS 206R,A00,895694,Fargason; Sharon Gayle,1,0,30,29
1746543838276,EDS 206R,B00,895695,Choi; Bailey Miyeon,16,0,30,14
1746543839305,EDS 250,A00,895697,Hemans; Patricia Ann Benitez,23,0,45,22
1746543840333,EDS 281,A00,895701,Meyerott; Theresa Ann,1,0,15,14
1746543841357,EDS 284,A00,895736,Meyerott; Theresa Ann,1,0,15,14
1746543842399,EDS 286,A00,897210,Fine; Sarah,0,0,15,15
1746543843425,EDS 289C,A01,895770,Daly; Alan J.,15,0,15,0
1746543844449,EDS 290,A00,897211,Hofstetter; Carolyn,0,0,15,15
1746543845475,LIGM 5A,A00,896162,Fischer-Grunski; Eva K,13,0,20,7
1746543846501,LIGM 5B,A00,896260,Fischer-Grunski; Eva K,17,0,20,3
1746543847532,LIGM 5C,A00,896308,Fischer-Grunski; Eva K,18,0,20,2
1746543848561,LIIT 5AS,A00,896313,Carnelos; Chiara,18,0,20,2
1746543849585,LIIT 5BS,A00,896416,Carnelos; Chiara,20,0,20,0
1746543850610,LIIT 5CS,A00,896564,Carnelos; Chiara,20,0,20,0
1746543851634,LISP 5A,A00,896588,Munoz Sanchez; Alicia,3,0,20,17
1746543852660,LISP 5B,A00,896653,Munoz Sanchez; Alicia,7,0,20,13
1746543853689,LISP 5C,A00,896655,Munoz Sanchez; Alicia,0,1,20,20
1746543854716,MAE 197,001,957918,Kleissl; Jan,9996,0,9999,3
1746543854716,MAE 197,002,959806,Boechler; Nicholas Sebastia,9998,0,9999,1
1746543854716,MAE 197,003,959852,Mullin; Jennifer S,9999,0,9999,0
1746543855742,MATH 2,A01,957937,Staff,33,0,35,2
1746543856770,MATH 197,001,957876,Kedlaya; Kiran S.,9993,0,9999,6
1746543857799,MCWP 40,A00,892729,Duru; Nur,10,0,20,10
1746543857799,MCWP 40,B00,893304,Montejo; Carolina,14,0,20,6
1746543858825,MCWP 40R,A00,893757,Redela; Pamela Morgan,0,5,20,20
1746543859853,MCWP 50,A00,893758,Morshed; Michael James,0,0,20,20
1746543859853,MCWP 50,B00,893761,Bartulis; Jason Michael,17,0,20,3
1746543860878,MCWP 50R,A00,893766,Compas; Sean Matthew,0,1,20,20
1746543860878,MCWP 50R,B00,893769,Carter; Jennifer A,0,1,20,20
1746543860878,MCWP 50R,C00,893771,Krone; Jarret,0,3,20,20
1746543860878,MCWP 50R,D00,893772,Miller; Elizabeth Deen,0,0,20,20
1746543860878,MCWP 50R,E00,893775,Carter; Andrea L,0,1,20,20
1746543861909,MMW 11R,A01,892721,Herbst; Matthew,11,0,27,16
1746543861909,MMW 11R,A02,892722,Herbst; Matthew,0,0,0,3
1746543862933,MMW 12R,A01,892724,Herbst; Matthew,0,11,16,16
1746543862933,MMW 12R,A02,892725,Herbst; Matthew,0,10,16,16
1746543863963,MMW 13R,A01,892727,Staff,0,4,16,16
1746543863963,MMW 13R,A02,892728,Staff,0,4,16,16
1746543863963,MMW 13R,A03,958032,Staff,0,4,16,16
1746543863963,MMW 13R,A04,958033,Staff,0,4,16,16
1746543863963,MMW 13R,A05,958034,Staff,0,4,16,16
1746543864993,SIO 295LS,A00,894015,Staff,5,0,25,20
1746543866017,SIO 295S,A00,894020,Staff,5,0,25,20
1746543867044,SIOC 290S,B01,958918,Merrifield; Mark A,14,0,30,16
1746543868073,SIOC 291S,B01,958922,Gabriel; Corey John,14,0,30,16
1746543869102,SOCI 117,A01,895339,Staff,3,0,5,2
1746543870129,WES 237B,A00,894149,Staff,11,0,20,9
1746543872185,AESE 279B,A00,891859,Staff,13,0,35,22
1746543873213,AIP 197,001,891854,Vespa; Emanuel Ignacio,9999,0,9999,0
1746543874237,ANTH 289S,A00,891856,Gagneux; Pascal,12,0,12,0
1746543875262,BENG 196,001,957946,Engler; Adam J.,9996,0,9999,3
1746543876287,BISP 197,001,959851,Wilhelm; James E.,9999,0,9999,0
1746543877314,CAT 124RS,A01,956906,Staff,6,0,25,19
1746543878341,CAT 125RS,A01,922013,Staff,6,0,25,19
1746543879366,CLRE 250,A00,891860,Morris; Sheldon,9995,0,9999,4
1746543881422,CLRE 251R,A00,907817,Mehta; Ravindra L.,9994,0,9999,5
1746543882450,CLRE 252,A00,891864,Cuomo; Raphael Eduardo,9993,0,9999,6
1746543883473,CLRE 253,A00,891867,Vaida; Florin,9994,0,9999,5
1746543883473,CLRE 253,B00,907819,Staff,9999,0,9999,0
1746543884497,CLRE 259,A00,891868,Patel; Hemal,9998,0,9999,1
1746543885526,CLRE 260,A00,891872,Cuomo; Raphael Eduardo,9999,0,9999,0
1746543886551,CLRE 297,001,891888,Cuomo; Raphael Eduardo,9999,0,9999,0
1746543887577,CSE 191,A00,958773,Minnes Kemp; Mor Mia,9996,0,9999,3
1746543888601,CSE 197,001,959846,Minnes Kemp; Mor Mia,9993,0,9999,6
1746543889627,CSS 201S,A01,892054,Mignozzetti; Umberto,26,0,30,4
1746543890656,CSS 202S,A01,892056,Mignozzetti; Umberto,26,0,30,4
1746543891682,DSC 197,001,956898,Eldridge; Justin Matthew,9998,0,9999,1
1746543892712,DSC 297,001,958000,Mazumdar; Arya,9998,0,9999,1
1746543892712,DSC 297,002,959862,Wang; Yusu,9999,0,9999,0
1746543893739,EAP 100,A00,905686,Staff,9778,0,9999,221
1746543894767,ECE 45,A01,892618,Staff,0,0,65,65
1746543896818,ECE 111,A01,892719,Staff,4,0,65,61
1746543897843,ECE 197,001,957920,Mercier; Patrick Philip,9991,0,9999,8
1746543898868,ECON 178,A01,907814,Zhu; Ying,26,0,35,9
1746543899894,EDS 115,A00,895312,Staff,36,0,45,9
1746543900918,EDS 117,A01,895337,Staff,24,0,30,6
1746543901944,EDS 125,A00,895341,Jones; Gabrielle Anastasia,37,0,45,8
1746543902970,EDS 128A,A01,895459,Fargason; Sharon Gayle,44,0,45,1
1746543904001,EDS 128B,A01,895543,Pappas; Elizabeth,44,0,45,1
1746543905031,EDS 139,A00,897203,Pappas; Elizabeth,44,0,45,1
1746543905031,EDS 139,B00,897209,Fargason; Sharon Gayle,41,0,45,4
1746543906059,EDS 201,A00,895545,Staff,23,0,45,22
1746543907087,EDS 203,A01,895581,Halter; Christopher P.,23,0,45,22
1746543908112,EDS 204R,A01,895625,Heinzman; Erica M.,39,0,45,6
1746543908112,EDS 204R,B01,895693,Halter; Christopher P.,10,0,45,35
1746543909137,EDS 206R,A00,895694,Fargason; Sharon Gayle,1,0,30,29
1746543909137,EDS 206R,B00,895695,Choi; Bailey Miyeon,16,0,30,14
1746543910164,EDS 250,A00,895697,Hemans; Patricia Ann Benitez,23,0,45,22
1746543911193,EDS 281,A00,895701,Meyerott; Theresa Ann,1,0,15,14
1746543912221,EDS 284,A00,895736,Meyerott; Theresa Ann,1,0,15,14
1746543913247,EDS 286,A00,897210,Fine; Sarah,0,0,15,15
1746543914274,EDS 289C,A01,895770,Daly; Alan J.,15,0,15,0
1746543915303,EDS 290,A00,897211,Hofstetter; Carolyn,0,0,15,15
1746543916328,LIGM 5A,A00,896162,Fischer-Grunski; Eva K,13,0,20,7
1746543917361,LIGM 5B,A00,896260,Fischer-Grunski; Eva K,17,0,20,3
1746543918386,LIGM 5C,A00,896308,Fischer-Grunski; Eva K,18,0,20,2
1746543919412,LIIT 5AS,A00,896313,Carnelos; Chiara,18,0,20,2
1746543920438,LIIT 5BS,A00,896416,Carnelos; Chiara,20,0,20,0
1746543921465,LIIT 5CS,A00,896564,Carnelos; Chiara,20,0,20,0
1746543922490,LISP 5A,A00,896588,Munoz Sanchez; Alicia,3,0,20,17
1746543923517,LISP 5B,A00,896653,Munoz Sanchez; Alicia,7,0,20,13
1746543924546,LISP 5C,A00,896655,Munoz Sanchez; Alicia,0,1,20,20
1746543925572,MAE 197,001,957918,Kleissl; Jan,9996,0,9999,3
1746543925572,MAE 197,002,959806,Boechler; Nicholas Sebastia,9998,0,9999,1
1746543925572,MAE 197,003,959852,Mullin; Jennifer S,9999,0,9999,0
1746543926602,MATH 2,A01,957937,Staff,33,0,35,2
1746543927626,MATH 197,001,957876,Kedlaya; Kiran S.,9993,0,9999,6
1746543928652,MCWP 40,A00,892729,Duru; Nur,10,0,20,10
1746543928652,MCWP 40,B00,893304,Montejo; Carolina,14,0,20,6
1746543929677,MCWP 40R,A00,893757,Redela; Pamela Morgan,0,5,20,20
1746543930703,MCWP 50,A00,893758,Morshed; Michael James,0,0,20,20
1746543930703,MCWP 50,B00,893761,Bartulis; Jason Michael,17,0,20,3
1746543931732,MCWP 50R,A00,893766,Compas; Sean Matthew,0,1,20,20
1746543931732,MCWP 50R,B00,893769,Carter; Jennifer A,0,1,20,20
1746543931732,MCWP 50R,C00,893771,Krone; Jarret,0,3,20,20
1746543931732,MCWP 50R,D00,893772,Miller; Elizabeth Deen,0,0,20,20
1746543931732,MCWP 50R,E00,893775,Carter; Andrea L,0,1,20,20
1746543932758,MMW 11R,A01,892721,Herbst; Matthew,11,0,27,16
1746543932758,MMW 11R,A02,892722,Herbst; Matthew,0,0,0,3
1746543933782,MMW 12R,A01,892724,Herbst; Matthew,0,11,16,16
1746543933782,MMW 12R,A02,892725,Herbst; Matthew,0,10,16,16
1746543934808,MMW 13R,A01,892727,Staff,0,4,16,16
1746543934808,MMW 13R,A02,892728,Staff,0,4,16,16
1746543934808,MMW 13R,A03,958032,Staff,0,4,16,16
1746543934808,MMW 13R,A04,958033,Staff,0,4,16,16
1746543934808,MMW 13R,A05,958034,Staff,0,4,16,16
1746543935834,SIO 295LS,A00,894015,Staff,5,0,25,20
1746543936861,SIO 295S,A00,894020,Staff,5,0,25,20
1746543937888,SIOC 290S,B01,958918,Merrifield; Mark A,14,0,30,16
1746543938916,SIOC 291S,B01,958922,Gabriel; Corey John,14,0,30,16
1746543939942,SOCI 117,A01,895339,Staff,3,0,5,2
1746543940968,WES 237B,A00,894149,Staff,11,0,20,9
1746543943030,AESE 279B,A00,891859,Staff,13,0,35,22
1746543944054,AIP 197,001,891854,Vespa; Emanuel Ignacio,9999,0,9999,0
1746543945079,ANTH 289S,A00,891856,Gagneux; Pascal,12,0,12,0
1746543946105,BENG 196,001,957946,Engler; Adam J.,9996,0,9999,3
1746543947128,BISP 197,001,959851,Wilhelm; James E.,9999,0,9999,0
1746543948156,CAT 124RS,A01,956906,Staff,6,0,25,19
1746543949181,CAT 125RS,A01,922013,Staff,6,0,25,19
1746543950209,CLRE 250,A00,891860,Morris; Sheldon,9995,0,9999,4
1746543952261,CLRE 251R,A00,907817,Mehta; Ravindra L.,9994,0,9999,5
1746543953288,CLRE 252,A00,891864,Cuomo; Raphael Eduardo,9993,0,9999,6
1746543954314,CLRE 253,A00,891867,Vaida; Florin,9994,0,9999,5
1746543954314,CLRE 253,B00,907819,Staff,9999,0,9999,0
1746543955340,CLRE 259,A00,891868,Patel; Hemal,9998,0,9999,1
1746543956366,CLRE 260,A00,891872,Cuomo; Raphael Eduardo,9999,0,9999,0
1746543957393,CLRE 297,001,891888,Cuomo; Raphael Eduardo,9999,0,9999,0
1746543958421,CSE 191,A00,958773,Minnes Kemp; Mor Mia,9996,0,9999,3
1746543959445,CSE 197,001,959846,Minnes Kemp; Mor Mia,9993,0,9999,6
1746543960477,CSS 201S,A01,892054,Mignozzetti; Umberto,26,0,30,4
1746543961506,CSS 202S,A01,892056,Mignozzetti; Umberto,26,0,30,4
1746543962533,DSC 197,001,956898,Eldridge; Justin Matthew,9998,0,9999,1
1746543963560,DSC 297,001,958000,Mazumdar; Arya,9998,0,9999,1
1746543963560,DSC 297,002,959862,Wang; Yusu,9999,0,9999,0
1746543964590,EAP 100,A00,905686,Staff,9778,0,9999,221
1746543965621,ECE 45,A01,892618,Staff,0,0,65,65
1746543967675,ECE 111,A01,892719,Staff,4,0,65,61
1746543968702,ECE 197,001,957920,Mercier; Patrick Philip,9991,0,9999,8
1746543969729,ECON 178,A01,907814,Zhu; Ying,26,0,35,9
1746543970758,EDS 115,A00,895312,Staff,36,0,45,9
1746543971784,EDS 117,A01,895337,Staff,24,0,30,6
1746543972812,EDS 125,A00,895341,Jones; Gabrielle Anastasia,37,0,45,8
1746543973840,EDS 128A,A01,895459,Fargason; Sharon Gayle,44,0,45,1
1746543974868,EDS 128B,A01,895543,Pappas; Elizabeth,44,0,45,1
1746543975895,EDS 139,A00,897203,Pappas; Elizabeth,44,0,45,1
1746543975895,EDS 139,B00,897209,Fargason; Sharon Gayle,41,0,45,4
1746543976921,EDS 201,A00,895545,Staff,23,0,45,22
1746543977950,EDS 203,A01,895581,Halter; Christopher P.,23,0,45,22
1746543978977,EDS 204R,A01,895625,Heinzman; Erica M.,39,0,45,6
1746543978977,EDS 204R,B01,895693,Halter; Christopher P.,10,0,45,35
1746543980015,EDS 206R,A00,895694,Fargason; Sharon Gayle,1,0,30,29
1746543980015,EDS 206R,B00,895695,Choi; Bailey Miyeon,16,0,30,14
1746543981041,EDS 250,A00,895697,Hemans; Patricia Ann Benitez,23,0,45,22
1746543982067,EDS 281,A00,895701,Meyerott; Theresa Ann,1,0,15,14
1746543983092,EDS 284,A00,895736,Meyerott; Theresa Ann,1,0,15,14
1746543984119,EDS 286,A00,897210,Fine; Sarah,0,0,15,15
1746543985148,EDS 289C,A01,895770,Daly; Alan J.,15,0,15,0
1746543986177,EDS 290,A00,897211,Hofstetter; Carolyn,0,0,15,15
1746543987204,LIGM 5A,A00,896162,Fischer-Grunski; Eva K,13,0,20,7
1746543988231,LIGM 5B,A00,896260,Fischer-Grunski; Eva K,17,0,20,3
1746543989257,LIGM 5C,A00,896308,Fischer-Grunski; Eva K,18,0,20,2
1746543990287,LIIT 5AS,A00,896313,Carnelos; Chiara,18,0,20,2
1746543991314,LIIT 5BS,A00,896416,Carnelos; Chiara,20,0,20,0
1746543992340,LIIT 5CS,A00,896564,Carnelos; Chiara,20,0,20,0
1746543993365,LISP 5A,A00,896588,Munoz Sanchez; Alicia,3,0,20,17
1746543994390,LISP 5B,A00,896653,Munoz Sanchez; Alicia,7,0,20,13
1746543995415,LISP 5C,A00,896655,Munoz Sanchez; Alicia,0,1,20,20
1746543996443,MAE 197,001,957918,Kleissl; Jan,9996,0,9999,3
1746543996443,MAE 197,002,959806,Boechler; Nicholas Sebastia,9998,0,9999,1
1746543996443,MAE 197,003,959852,Mullin; Jennifer S,9999,0,9999,0
1746543997471,MATH 2,A01,957937,Staff,33,0,35,2
1746543998496,MATH 197,001,957876,Kedlaya; Kiran S.,9993,0,9999,6
1746543999522,MCWP 40,A00,892729,Duru; Nur,10,0,20,10
1746543999522,MCWP 40,B00,893304,Montejo; Carolina,14,0,20,6
1746544000553,MCWP 40R,A00,893757,Redela; Pamela Morgan,0,5,20,20
1746544001580,MCWP 50,A00,893758,Morshed; Michael James,0,0,20,20
1746544001580,MCWP 50,B00,893761,Bartulis; Jason Michael,17,0,20,3
1746544002607,MCWP 50R,A00,893766,Compas; Sean Matthew,0,1,20,20
1746544002607,MCWP 50R,B00,893769,Carter; Jennifer A,0,1,20,20
1746544002607,MCWP 50R,C00,893771,Krone; Jarret,0,3,20,20
1746544002607,MCWP 50R,D00,893772,Miller; Elizabeth Deen,0,0,20,20
1746544002607,MCWP 50R,E00,893775,Carter; Andrea L,0,1,20,20
1746544003631,MMW 11R,A01,892721,Herbst; Matthew,11,0,27,16
1746544003631,MMW 11R,A02,892722,Herbst; Matthew,0,0,0,3
1746544004660,MMW 12R,A01,892724,Herbst; Matthew,0,11,16,16
1746544004660,MMW 12R,A02,892725,Herbst; Matthew,0,10,16,16
1746544005686,MMW 13R,A01,892727,Staff,0,4,16,16
1746544005686,MMW 13R,A02,892728,Staff,0,4,16,16
1746544005686,MMW 13R,A03,958032,Staff,0,4,16,16
1746544005686,MMW 13R,A04,958033,Staff,0,4,16,16
1746544005686,MMW 13R,A05,958034,Staff,0,4,16,16
1746544006714,SIO 295LS,A00,894015,Staff,5,0,25,20
1746544007738,SIO 295S,A00,894020,Staff,5,0,25,20
1746544008764,SIOC 290S,B01,958918,Merrifield; Mark A,14,0,30,16
1746544009791,SIOC 291S,B01,958922,Gabriel; Corey John,14,0,30,16
1746544010815,SOCI 117,A01,895339,Staff,3,0,5,2
1746544011842,WES 237B,A00,894149,Staff,11,0,20,9
1746544013911,AESE 279B,A00,891859,Staff,13,0,35,22
1746544014936,AIP 197,001,891854,Vespa; Emanuel Ignacio,9999,0,9999,0
1746544015964,ANTH 289S,A00,891856,Gagneux; Pascal,12,0,12,0
1746544016993,BENG 196,001,957946,Engler; Adam J.,9996,0,9999,3
1746544018023,BISP 197,001,959851,Wilhelm; James E.,9999,0,9999,0
1746544019052,CAT 124RS,A01,956906,Staff,6,0,25,19
1746544020081,CAT 125RS,A01,922013,Staff,6,0,25,19
1746544021107,CLRE 250,A00,891860,Morris; Sheldon,9995,0,9999,4
1746544023170,CLRE 251R,A00,907817,Mehta; Ravindra L.,9994,0,9999,5
1746544024194,CLRE 252,A00,891864,Cuomo; Raphael Eduardo,9993,0,9999,6
1746544025220,CLRE 253,A00,891867,Vaida; Florin,9994,0,9999,5
1746544025220,CLRE 253,B00,907819,Staff,9999,0,9999,0
1746544026249,CLRE 259,A00,891868,Patel; Hemal,9998,0,9999,1
1746544027276,CLRE 260,A00,891872,Cuomo; Raphael Eduardo,9999,0,9999,0
1746544028305,CLRE 297,001,891888,Cuomo; Raphael Eduardo,9999,0,9999,0
1746544029330,CSE 191,A00,958773,Minnes Kemp; Mor Mia,9996,0,9999,3
1746544030355,CSE 197,001,959846,Minnes Kemp; Mor Mia,9993,0,9999,6
1746544031386,CSS 201S,A01,892054,Mignozzetti; Umberto,26,0,30,4
1746544032421,CSS 202S,A01,892056,Mignozzetti; Umberto,26,0,30,4
1746544033447,DSC 197,001,956898,Eldridge; Justin Matthew,9998,0,9999,1
1746544034473,DSC 297,001,958000,Mazumdar; Arya,9998,0,9999,1
1746544034473,DSC 297,002,959862,Wang; Yusu,9999,0,9999,0
1746544035499,EAP 100,A00,905686,Staff,9778,0,9999,221
1746544036528,ECE 45,A01,892618,Staff,0,0,65,65
1746544038575,ECE 111,A01,892719,Staff,4,0,65,61
1746544039602,ECE 197,001,957920,Mercier; Patrick Philip,9991,0,9999,8
1746544040630,ECON 178,A01,907814,Zhu; Ying,26,0,35,9
1746544041655,EDS 115,A00,895312,Staff,36,0,45,9
1746544042681,EDS 117,A01,895337,Staff,24,0,30,6
1746544043710,EDS 125,A00,895341,Jones; Gabrielle Anastasia,37,0,45,8
1746544044740,EDS 128A,A01,895459,Fargason; Sharon Gayle,44,0,45,1
1746544045765,EDS 128B,A01,895543,Pappas; Elizabeth,44,0,45,1
1746544047313,EDS 139,A00,897203,Pappas; Elizabeth,44,0,45,1
1746544047313,EDS 139,B00,897209,Fargason; Sharon Gayle,41,0,45,4
1746544048338,EDS 201,A00,895545,Staff,23,0,45,22
1746544049366,EDS 203,A01,895581,Halter; Christopher P.,23,0,45,22
1746544050390,EDS 204R,A01,895625,Heinzman; Erica M.,39,0,45,6
1746544050390,EDS 204R,B01,895693,Halter; Christopher P.,10,0,45,35
1746544051414,EDS 206R,A00,895694,Fargason; Sharon Gayle,1,0,30,29
1746544051414,EDS 206R,B00,895695,Choi; Bailey Miyeon,16,0,30,14
1746544052445,EDS 250,A00,895697,Hemans; Patricia Ann Benitez,23,0,45,22
1746544053471,EDS 281,A00,895701,Meyerott; Theresa Ann,1,0,15,14
1746544054497,EDS 284,A00,895736,Meyerott; Theresa Ann,1,0,15,14
1746544055523,EDS 286,A00,897210,Fine; Sarah,0,0,15,15
1746544056552,EDS 289C,A01,895770,Daly; Alan J.,15,0,15,0
1746544057579,EDS 290,A00,897211,Hofstetter; Carolyn,0,0,15,15
1746544058606,LIGM 5A,A00,896162,Fischer-Grunski; Eva K,13,0,20,7
1746544059631,LIGM 5B,A00,896260,Fischer-Grunski; Eva K,17,0,20,3
1746544060673,LIGM 5C,A00,896308,Fischer-Grunski; Eva K,18,0,20,2
1746544061699,LIIT 5AS,A00,896313,Carnelos; Chiara,18,0,20,2
1746544062725,LIIT 5BS,A00,896416,Carnelos; Chiara,20,0,20,0
1746544063751,LIIT 5CS,A00,896564,Carnelos; Chiara,20,0,20,0
1746544064777,LISP 5A,A00,896588,Munoz Sanchez; Alicia,3,0,20,17
1746544065805,LISP 5B,A00,896653,Munoz Sanchez; Alicia,7,0,20,13
1746544066830,LISP 5C,A00,896655,Munoz Sanchez; Alicia,0,1,20,20
1746544067859,MAE 197,001,957918,Kleissl; Jan,9996,0,9999,3
1746544067859,MAE 197,002,959806,Boechler; Nicholas Sebastia,9998,0,9999,1
1746544067859,MAE 197,003,959852,Mullin; Jennifer S,9999,0,9999,0
1746544068888,MATH 2,A01,957937,Staff,33,0,35,2
1746544069914,MATH 197,001,957876,Kedlaya; Kiran S.,9993,0,9999,6
1746544070940,MCWP 40,A00,892729,Duru; Nur,10,0,20,10
1746544070940,MCWP 40,B00,893304,Montejo; Carolina,14,0,20,6
1746544071966,MCWP 40R,A00,893757,Redela; Pamela Morgan,0,5,20,20
1746544072993,MCWP 50,A00,893758,Morshed; Michael James,0,0,20,20
1746544072993,MCWP 50,B00,893761,Bartulis; Jason Michael,17,0,20,3
1746544074019,MCWP 50R,A00,893766,Compas; Sean Matthew,0,1,20,20
1746544074019,MCWP 50R,B00,893769,Carter; Jennifer A,0,1,20,20
1746544074019,MCWP 50R,C00,893771,Krone; Jarret,0,3,20,20
1746544074019,MCWP 50R,D00,893772,Miller; Elizabeth Deen,0,0,20,20
1746544074019,MCWP 50R,E00,893775,Carter; Andrea L,0,1,20,20
1746544075042,MMW 11R,A01,892721,Herbst; Matthew,11,0,27,16
1746544075042,MMW 11R,A02,892722,Herbst; Matthew,0,0,0,3
1746544076067,MMW 12R,A01,892724,Herbst; Matthew,0,11,16,16
1746544076067,MMW 12R,A02,892725,Herbst; Matthew,0,10,16,16
1746544077097,MMW 13R,A01,892727,Staff,0,4,16,16
1746544077097,MMW 13R,A02,892728,Staff,0,4,16,16
1746544077097,MMW 13R,A03,958032,Staff,0,4,16,16
1746544077097,MMW 13R,A04,958033,Staff,0,4,16,16
1746544077097,MMW 13R,A05,958034,Staff,0,4,16,16
1746544078124,SIO 295LS,A00,894015,Staff,5,0,25,20
1746544079150,SIO 295S,A00,894020,Staff,5,0,25,20
1746544080176,SIOC 290S,B01,958918,Merrifield; Mark A,14,0,30,16
1746544081200,SIOC 291S,B01,958922,Gabriel; Corey John,14,0,30,16
1746544082226,SOCI 117,A01,895339,Staff,3,0,5,2
1746544083250,WES 237B,A00,894149,Staff,11,0,20,9
1746544085316,AESE 279B,A00,891859,Staff,13,0,35,22
1746544086342,AIP 197,001,891854,Vespa; Emanuel Ignacio,9999,0,9999,0
1746544087366,ANTH 289S,A00,891856,Gagneux; Pascal,12,0,12,0
1746544088390,BENG 196,001,957946,Engler; Adam J.,9996,0,9999,3
1746544089420,BISP 197,001,959851,Wilhelm; James E.,9999,0,9999,0
1746544090446,CAT 124RS,A01,956906,Staff,6,0,25,19
1746544091473,CAT 125RS,A01,922013,Staff,6,0,25,19
1746544092497,CLRE 250,A00,891860,Morris; Sheldon,9995,0,9999,4
1746544094550,CLRE 251R,A00,907817,Mehta; Ravindra L.,9994,0,9999,5
1746544095576,CLRE 252,A00,891864,Cuomo; Raphael Eduardo,9993,0,9999,6
1746544096603,CLRE 253,A00,891867,Vaida; Florin,9994,0,9999,5
1746544096603,CLRE 253,B00,907819,Staff,9999,0,9999,0
1746544097633,CLRE 259,A00,891868,Patel; Hemal,9998,0,9999,1
1746544098659,CLRE 260,A00,891872,Cuomo; Raphael Eduardo,9999,0,9999,0
1746544099684,CLRE 297,001,891888,Cuomo; Raphael Eduardo,9999,0,9999,0
1746544100710,CSE 191,A00,958773,Minnes Kemp; Mor Mia,9996,0,9999,3
1746544101735,CSE 197,001,959846,Minnes Kemp; Mor Mia,9993,0,9999,6
1746544102762,CSS 201S,A01,892054,Mignozzetti; Umberto,26,0,30,4
1746544103791,CSS 202S,A01,892056,Mignozzetti; Umberto,26,0,30,4
1746544104821,DSC 197,001,956898,Eldridge; Justin Matthew,9998,0,9999,1
1746544105846,DSC 297,001,958000,Mazumdar; Arya,9998,0,9999,1
1746544105846,DSC 297,002,959862,Wang; Yusu,9999,0,9999,0
1746544106871,EAP 100,A00,905686,Staff,9778,0,9999,221
1746544107896,ECE 45,A01,892618,Staff,0,0,65,65
1746544110002,ECE 111,A01,892719,Staff,4,0,65,61
1746544111027,ECE 197,001,957920,Mercier; Patrick Philip,9991,0,9999,8
1746544112056,ECON 178,A01,907814,Zhu; Ying,26,0,35,9
1746544113083,EDS 115,A00,895312,Staff,36,0,45,9
1746544114108,EDS 117,A01,895337,Staff,24,0,30,6
1746544115136,EDS 125,A00,895341,Jones; Gabrielle Anastasia,37,0,45,8
1746544116163,EDS 128A,A01,895459,Fargason; Sharon Gayle,44,0,45,1
1746544117191,EDS 128B,A01,895543,Pappas; Elizabeth,44,0,45,1
1746544118217,EDS 139,A00,897203,Pappas; Elizabeth,44,0,45,1
1746544118217,EDS 139,B00,897209,Fargason; Sharon Gayle,41,0,45,4
1746544119242,EDS 201,A00,895545,Staff,23,0,45,22
1746544120268,EDS 203,A01,895581,Halter; Christopher P.,23,0,45,22
1746544121295,EDS 204R,A01,895625,Heinzman; Erica M.,39,0,45,6
1746544121295,EDS 204R,B01,895693,Halter; Christopher P.,10,0,45,35
1746544122320,EDS 206R,A00,895694,Fargason; Sharon Gayle,1,0,30,29
1746544122320,EDS 206R,B00,895695,Choi; Bailey Miyeon,16,0,30,14
1746544123351,EDS 250,A00,895697,Hemans; Patricia Ann Benitez,23,0,45,22
1746544124375,EDS 281,A00,895701,Meyerott; Theresa Ann,1,0,15,14
1746544125403,EDS 284,A00,895736,Meyerott; Theresa Ann,1,0,15,14
1746544126430,EDS 286,A00,897210,Fine; Sarah,0,0,15,15
1746544127458,EDS 289C,A01,895770,Daly; Alan J.,15,0,15,0
1746544128484,EDS 290,A00,897211,Hofstetter; Carolyn,0,0,15,15
1746544129509,LIGM 5A,A00,896162,Fischer-Grunski; Eva K,13,0,20,7
1746544130538,LIGM 5B,A00,896260,Fischer-Grunski; Eva K,17,0,20,3
1746544131564,LIGM 5C,A00,896308,Fischer-Grunski; Eva K,18,0,20,2
1746544132589,LIIT 5AS,A00,896313,Carnelos; Chiara,18,0,20,2
1746544133617,LIIT 5BS,A00,896416,Carnelos; Chiara,20,0,20,0
1746544134641,LIIT 5CS,A00,896564,Carnelos; Chiara,20,0,20,0
1746544135670,LISP 5A,A00,896588,Munoz Sanchez; Alicia,3,0,20,17
1746544136699,LISP 5B,A00,896653,Munoz Sanchez; Alicia,7,0,20,13
1746544137725,LISP 5C,A00,896655,Munoz Sanchez; Alicia,0,1,20,20
1746544138751,MAE 197,001,957918,Kleissl; Jan,9996,0,9999,3
1746544138751,MAE 197,002,959806,Boechler; Nicholas Sebastia,9998,0,9999,1
1746544138751,MAE 197,003,959852,Mullin; Jennifer S,9999,0,9999,0
1746544139778,MATH 2,A01,957937,Staff,33,0,35,2
1746544140802,MATH 197,001,957876,Kedlaya; Kiran S.,9993,0,9999,6
1746544141835,MCWP 40,A00,892729,Duru; Nur,10,0,20,10
1746544141835,MCWP 40,B00,893304,Montejo; Carolina,14,0,20,6
1746544142865,MCWP 40R,A00,893757,Redela; Pamela Morgan,0,5,20,20
1746544143892,MCWP 50,A00,893758,Morshed; Michael James,0,0,20,20
1746544143892,MCWP 50,B00,893761,Bartulis; Jason Michael,17,0,20,3
1746544144918,MCWP 50R,A00,893766,Compas; Sean Matthew,0,1,20,20
1746544144918,MCWP 50R,B00,893769,Carter; Jennifer A,0,1,20,20
1746544144918,MCWP 50R,C00,893771,Krone; Jarret,0,3,20,20
1746544144918,MCWP 50R,D00,893772,Miller; Elizabeth Deen,0,0,20,20
1746544144918,MCWP 50R,E00,893775,Carter; Andrea L,0,1,20,20
1746544145943,MMW 11R,A01,892721,Herbst; Matthew,11,0,27,16
1746544145943,MMW 11R,A02,892722,Herbst; Matthew,0,0,0,3
1746544146968,MMW 12R,A01,892724,Herbst; Matthew,0,11,16,16
1746544146968,MMW 12R,A02,892725,Herbst; Matthew,0,10,16,16
1746544147998,MMW 13R,A01,892727,Staff,0,4,16,16
1746544147998,MMW 13R,A02,892728,Staff,0,4,16,16
1746544147998,MMW 13R,A03,958032,Staff,0,4,16,16
1746544147998,MMW 13R,A04,958033,Staff,0,4,16,16
1746544147998,MMW 13R,A05,958034,Staff,0,4,16,16
1746544149026,SIO 295LS,A00,894015,Staff,5,0,25,20
1746544150057,SIO 295S,A00,894020,Staff,5,0,25,20
1746544151083,SIOC 290S,B01,958918,Merrifield; Mark A,14,0,30,16
1746544152109,SIOC 291S,B01,958922,Gabriel; Corey John,14,0,30,16
1746544153136,SOCI 117,A01,895339,Staff,3,0,5,2
1746544154163,WES 237B,A00,894149,Staff,11,0,20,9
1746544156224,AESE 279B,A00,891859,Staff,13,0,35,22
1746544157252,AIP 197,001,891854,Vespa; Emanuel Ignacio,9999,0,9999,0
1746544158276,ANTH 289S,A00,891856,Gagneux; Pascal,12,0,12,0
1746544159301,BENG 196,001,957946,Engler; Adam J.,9996,0,9999,3
1746544160326,BISP 197,001,959851,Wilhelm; James E.,9999,0,9999,0
1746544161355,CAT 124RS,A01,956906,Staff,6,0,25,19
1746544162380,CAT 125RS,A01,922013,Staff,6,0,25,19
1746544163404,CLRE 250,A00,891860,Morris; Sheldon,9995,0,9999,4
1746544165454,CLRE 251R,A00,907817,Mehta; Ravindra L.,9994,0,9999,5
1746544166481,CLRE 252,A00,891864,Cuomo; Raphael Eduardo,9993,0,9999,6
1746544167506,CLRE 253,A00,891867,Vaida; Florin,9994,0,9999,5
1746544167506,CLRE 253,B00,907819,Staff,9999,0,9999,0
1746544168531,CLRE 259,A00,891868,Patel; Hemal,9998,0,9999,1
1746544169556,CLRE 260,A00,891872,Cuomo; Raphael Eduardo,9999,0,9999,0
1746544170584,CLRE 297,001,891888,Cuomo; Raphael Eduardo,9999,0,9999,0
1746544171612,CSE 191,A00,958773,Minnes Kemp; Mor Mia,9996,0,9999,3
1746544172638,CSE 197,001,959846,Minnes Kemp; Mor Mia,9993,0,9999,6
1746544173666,CSS 201S,A01,892054,Mignozzetti; Umberto,26,0,30,4
1746544174693,CSS 202S,A01,892056,Mignozzetti; Umberto,26,0,30,4
1746544175721,DSC 197,001,956898,Eldridge; Justin Matthew,9998,0,9999,1
1746544176746,DSC 297,001,958000,Mazumdar; Arya,9998,0,9999,1
1746544176746,DSC 297,002,959862,Wang; Yusu,9999,0,9999,0
1746544177771,EAP 100,A00,905686,Staff,9778,0,9999,221
1746544178799,ECE 45,A01,892618,Staff,0,0,65,65
1746544180854,ECE 111,A01,892719,Staff,4,0,65,61
1746544181882,ECE 197,001,957920,Mercier; Patrick Philip,9991,0,9999,8
1746544182912,ECON 178,A01,907814,Zhu; Ying,26,0,35,9
1746544183940,EDS 115,A00,895312,Staff,36,0,45,9
1746544184965,EDS 117,A01,895337,Staff,24,0,30,6
1746544185992,EDS 125,A00,895341,Jones; Gabrielle Anastasia,37,0,45,8
1746544187021,EDS 128A,A01,895459,Fargason; Sharon Gayle,44,0,45,1
1746544188047,EDS 128B,A01,895543,Pappas; Elizabeth,44,0,45,1
1746544189073,EDS 139,A00,897203,Pappas; Elizabeth,44,0,45,1
1746544189073,EDS 139,B00,897209,Fargason; Sharon Gayle,41,0,45,4
1746544190100,EDS 201,A00,895545,Staff,23,0,45,22
1746544191125,EDS 203,A01,895581,Halter; Christopher P.,23,0,45,22
1746544192154,EDS 204R,A01,895625,Heinzman; Erica M.,39,0,45,6
1746544192154,EDS 204R,B01,895693,Halter; Christopher P.,10,0,45,35
1746544193185,EDS 206R,A00,895694,Fargason; Sharon Gayle,1,0,30,29
1746544193185,EDS 206R,B00,895695,Choi; Bailey Miyeon,16,0,30,14
1746544194215,EDS 250,A00,895697,Hemans; Patricia Ann Benitez,23,0,45,22
1746544195239,EDS 281,A00,895701,Meyerott; Theresa Ann,1,0,15,14
1746544196268,EDS 284,A00,895736,Meyerott; Theresa Ann,1,0,15,14
1746544197295,EDS 286,A00,897210,Fine; Sarah,0,0,15,15
1746544198324,EDS 289C,A01,895770,Daly; Alan J.,15,0,15,0
1746544199351,EDS 290,A00,897211,Hofstetter; Carolyn,0,0,15,15
1746544200375,LIGM 5A,A00,896162,Fischer-Grunski; Eva K,13,0,20,7
1746544201401,LIGM 5B,A00,896260,Fischer-Grunski; Eva K,17,0,20,3
1746544202431,LIGM 5C,A00,896308,Fischer-Grunski; Eva K,18,0,20,2
1746544203459,LIIT 5AS,A00,896313,Carnelos; Chiara,18,0,20,2
1746544204487,LIIT 5BS,A00,896416,Carnelos; Chiara,20,0,20,0
1746544205516,LIIT 5CS,A00,896564,Carnelos; Chiara,20,0,20,0
1746544206545,LISP 5A,A00,896588,Munoz Sanchez; Alicia,3,0,20,17
1746544207570,LISP 5B,A00,896653,Munoz Sanchez; Alicia,7,0,20,13
1746544208601,LISP 5C,A00,896655,Munoz Sanchez; Alicia,0,1,20,20
1746544209626,MAE 197,001,957918,Kleissl; Jan,9996,0,9999,3
1746544209626,MAE 197,002,959806,Boechler; Nicholas Sebastia,9998,0,9999,1
1746544209626,MAE 197,003,959852,Mullin; Jennifer S,9999,0,9999,0
1746544210656,MATH 2,A01,957937,Staff,33,0,35,2
1746544211681,MATH 197,001,957876,Kedlaya; Kiran S.,9993,0,9999,6
1746544212708,MCWP 40,A00,892729,Duru; Nur,10,0,20,10
1746544212708,MCWP 40,B00,893304,Montejo; Carolina,14,0,20,6
1746544213734,MCWP 40R,A00,893757,Redela; Pamela Morgan,0,5,20,20
1746544214762,MCWP 50,A00,893758,Morshed; Michael James,0,0,20,20
1746544214762,MCWP 50,B00,893761,Bartulis; Jason Michael,17,0,20,3
1746544215794,MCWP 50R,A00,893766,Compas; Sean Matthew,0,1,20,20
1746544215794,MCWP 50R,B00,893769,Carter; Jennifer A,0,1,20,20
1746544215794,MCWP 50R,C00,893771,Krone; Jarret,0,3,20,20
1746544215794,MCWP 50R,D00,893772,Miller; Elizabeth Deen,0,0,20,20
1746544215794,MCWP 50R,E00,893775,Carter; Andrea L,0,1,20,20
1746544216824,MMW 11R,A01,892721,Herbst; Matthew,11,0,27,16
1746544216824,MMW 11R,A02,892722,Herbst; Matthew,0,0,0,3
1746544217852,MMW 12R,A01,892724,Herbst; Matthew,0,11,16,16
1746544217852,MMW 12R,A02,892725,Herbst; Matthew,0,10,16,16
1746544218877,MMW 13R,A01,892727,Staff,0,4,16,16
1746544218877,MMW 13R,A02,892728,Staff,0,4,16,16
1746544218877,MMW 13R,A03,958032,Staff,0,4,16,16
1746544218877,MMW 13R,A04,958033,Staff,0,4,16,16
1746544218877,MMW 13R,A05,958034,Staff,0,4,16,16
1746544219908,SIO 295LS,A00,894015,Staff,5,0,25,20
1746544220934,SIO 295S,A00,894020,Staff,5,0,25,20
1746544221967,SIOC 290S,B01,958918,Merrifield; Mark A,14,0,30,16
1746544222991,SIOC 291S,B01,958922,Gabriel; Corey John,14,0,30,16
1746544224020,SOCI 117,A01,895339,Staff,3,0,5,2
1746544225052,WES 237B,A00,894149,Staff,11,0,20,9
1746544227119,AESE 279B,A00,891859,Staff,13,0,35,22
1746544228142,AIP 197,001,891854,Vespa; Emanuel Ignacio,9999,0,9999,0
1746544229168,ANTH 289S,A00,891856,Gagneux; Pascal,12,0,12,0
1746544230194,BENG 196,001,957946,Engler; Adam J.,9996,0,9999,3
1746544231219,BISP 197,001,959851,Wilhelm; James E.,9999,0,9999,0
1746544232247,CAT 124RS,A01,956906,Staff,6,0,25,19
1746544233274,CAT 125RS,A01,922013,Staff,6,0,25,19
1746544234300,CLRE 250,A00,891860,Morris; Sheldon,9995,0,9999,4
1746544236352,CLRE 251R,A00,907817,Mehta; Ravindra L.,9994,0,9999,5
1746544237378,CLRE 252,A00,891864,Cuomo; Raphael Eduardo,9993,0,9999,6
1746544238407,CLRE 253,A00,891867,Vaida; Florin,9994,0,9999,5
1746544238407,CLRE 253,B00,907819,Staff,9999,0,9999,0
1746544239436,CLRE 259,A00,891868,Patel; Hemal,9998,0,9999,1
1746544240461,CLRE 260,A00,891872,Cuomo; Raphael Eduardo,9999,0,9999,0
1746544241486,CLRE 297,001,891888,Cuomo; Raphael Eduardo,9999,0,9999,0
1746544242510,CSE 191,A00,958773,Minnes Kemp; Mor Mia,9996,0,9999,3
1746544243536,CSE 197,001,959846,Minnes Kemp; Mor Mia,9993,0,9999,6
1746544244562,CSS 201S,A01,892054,Mignozzetti; Umberto,26,0,30,4
1746544245592,CSS 202S,A01,892056,Mignozzetti; Umberto,26,0,30,4
1746544246619,DSC 197,001,956898,Eldridge; Justin Matthew,9998,0,9999,1
1746544247646,DSC 297,001,958000,Mazumdar; Arya,9998,0,9999,1
1746544247646,DSC 297,002,959862,Wang; Yusu,9999,0,9999,0
1746544248672,EAP 100,A00,905686,Staff,9778,0,9999,221
1746544249698,ECE 45,A01,892618,Staff,0,0,65,65
1746544251749,ECE 111,A01,892719,Staff,4,0,65,61
1746544252775,ECE 197,001,957920,Mercier; Patrick Philip,9991,0,9999,8
1746544253803,ECON 178,A01,907814,Zhu; Ying,26,0,35,9
1746544254828,EDS 115,A00,895312,Staff,36,0,45,9
1746544255857,EDS 117,A01,895337,Staff,24,0,30,6
1746544256883,EDS 125,A00,895341,Jones; Gabrielle Anastasia,37,0,45,8
1746544257910,EDS 128A,A01,895459,Fargason; Sharon Gayle,44,0,45,1
1746544258933,EDS 128B,A01,895543,Pappas; Elizabeth,44,0,45,1
1746544259961,EDS 139,A00,897203,Pappas; Elizabeth,44,0,45,1
1746544259961,EDS 139,B00,897209,Fargason; Sharon Gayle,41,0,45,4
1746544260987,EDS 201,A00,895545,Staff,23,0,45,22
1746544262012,EDS 203,A01,895581,Halter; Christopher P.,23,0,45,22
1746544263042,EDS 204R,A01,895625,Heinzman; Erica M.,39,0,45,6
1746544263042,EDS 204R,B01,895693,Halter; Christopher P.,10,0,45,35
1746544264067,EDS 206R,A00,895694,Fargason; Sharon Gayle,1,0,30,29
1746544264067,EDS 206R,B00,895695,Choi; Bailey Miyeon,16,0,30,14
1746544265095,EDS 250,A00,895697,Hemans; Patricia Ann Benitez,23,0,45,22
1746544266123,EDS 281,A00,895701,Meyerott; Theresa Ann,1,0,15,14
1746544267148,EDS 284,A00,895736,Meyerott; Theresa Ann,1,0,15,14
1746544268174,EDS 286,A00,897210,Fine; Sarah,0,0,15,15
1746544269200,EDS 289C,A01,895770,Daly; Alan J.,15,0,15,0
1746544270227,EDS 290,A00,897211,Hofstetter; Carolyn,0,0,15,15
1746544271254,LIGM 5A,A00,896162,Fischer-Grunski; Eva K,13,0,20,7
1746544272279,LIGM 5B,A00,896260,Fischer-Grunski; Eva K,17,0,20,3
1746544273303,LIGM 5C,A00,896308,Fischer-Grunski; Eva K,18,0,20,2
1746544274334,LIIT 5AS,A00,896313,Carnelos; Chiara,18,0,20,2
1746544275363,LIIT 5BS,A00,896416,Carnelos; Chiara,20,0,20,0
1746544276388,LIIT 5CS,A00,896564,Carnelos; Chiara,20,0,20,0
1746544277416,LISP 5A,A00,896588,Munoz Sanchez; Alicia,3,0,20,17
1746544278446,LISP 5B,A00,896653,Munoz Sanchez; Alicia,7,0,20,13
1746544279471,LISP 5C,A00,896655,Munoz Sanchez; Alicia,0,1,20,20
1746544280499,MAE 197,001,957918,Kleissl; Jan,9996,0,9999,3
1746544280499,MAE 197,002,959806,Boechler; Nicholas Sebastia,9998,0,9999,1
1746544280499,MAE 197,003,959852,Mullin; Jennifer S,9999,0,9999,0
1746544281527,MATH 2,A01,957937,Staff,33,0,35,2
1746544282556,MATH 197,001,957876,Kedlaya; Kiran S.,9993,0,9999,6
1746544283581,MCWP 40,A00,892729,Duru; Nur,10,0,20,10
1746544283581,MCWP 40,B00,893304,Montejo; Carolina,14,0,20,6
1746544284607,MCWP 40R,A00,893757,Redela; Pamela Morgan,0,5,20,20
1746544285635,MCWP 50,A00,893758,Morshed; Michael James,0,0,20,20
1746544285635,MCWP 50,B00,893761,Bartulis; Jason Michael,17,0,20,3
1746544286661,MCWP 50R,A00,893766,Compas; Sean Matthew,0,1,20,20
1746544286661,MCWP 50R,B00,893769,Carter; Jennifer A,0,1,20,20
1746544286661,MCWP 50R,C00,893771,Krone; Jarret,0,3,20,20
1746544286661,MCWP 50R,D00,893772,Miller; Elizabeth Deen,0,0,20,20
1746544286661,MCWP 50R,E00,893775,Carter; Andrea L,0,1,20,20
1746544287687,MMW 11R,A01,892721,Herbst; Matthew,11,0,27,16
1746544287687,MMW 11R,A02,892722,Herbst; Matthew,0,0,0,3
1746544288713,MMW 12R,A01,892724,Herbst; Matthew,0,11,16,16
1746544288713,MMW 12R,A02,892725,Herbst; Matthew,0,10,16,16
1746544289745,MMW 13R,A01,892727,Staff,0,4,16,16
1746544289745,MMW 13R,A02,892728,Staff,0,4,16,16
1746544289745,MMW 13R,A03,958032,Staff,0,4,16,16
1746544289745,MMW 13R,A04,958033,Staff,0,4,16,16
1746544289745,MMW 13R,A05,958034,Staff,0,4,16,16
1746544290772,SIO 295LS,A00,894015,Staff,5,0,25,20
1746544291798,SIO 295S,A00,894020,Staff,5,0,25,20
1746544292823,SIOC 290S,B01,958918,Merrifield; Mark A,14,0,30,16
1746544293850,SIOC 291S,B01,958922,Gabriel; Corey John,14,0,30,16
1746544294874,SOCI 117,A01,895339,Staff,3,0,5,2
1746544295899,WES 237B,A00,894149,Staff,11,0,20,9
1746544297961,AESE 279B,A00,891859,Staff,13,0,35,22
1746544298987,AIP 197,001,891854,Vespa; Emanuel Ignacio,9999,0,9999,0
1746544300013,ANTH 289S,A00,891856,Gagneux; Pascal,12,0,12,0
1746544301042,BENG 196,001,957946,Engler; Adam J.,9996,0,9999,3
1746544302070,BISP 197,001,959851,Wilhelm; James E.,9999,0,9999,0
1746544303097,CAT 124RS,A01,956906,Staff,6,0,25,19
1746544304124,CAT 125RS,A01,922013,Staff,6,0,25,19
1746544305153,CLRE 250,A00,891860,Morris; Sheldon,9995,0,9999,4
1746544307205,CLRE 251R,A00,907817,Mehta; Ravindra L.,9994,0,9999,5
1746544308230,CLRE 252,A00,891864,Cuomo; Raphael Eduardo,9993,0,9999,6
1746544309257,CLRE 253,A00,891867,Vaida; Florin,9994,0,9999,5
1746544309257,CLRE 253,B00,907819,Staff,9999,0,9999,0
1746544310285,CLRE 259,A00,891868,Patel; Hemal,9998,0,9999,1
1746544311313,CLRE 260,A00,891872,Cuomo; Raphael Eduardo,9999,0,9999,0
1746544312337,CLRE 297,001,891888,Cuomo; Raphael Eduardo,9999,0,9999,0
1746544313365,CSE 191,A00,958773,Minnes Kemp; Mor Mia,9996,0,9999,3
1746544314388,CSE 197,001,959846,Minnes Kemp; Mor Mia,9993,0,9999,6
1746544315414,CSS 201S,A01,892054,Mignozzetti; Umberto,26,0,30,4
1746544316440,CSS 202S,A01,892056,Mignozzetti; Umberto,26,0,30,4
1746544317504,DSC 197,001,956898,Eldridge; Justin Matthew,9998,0,9999,1
1746544318530,DSC 297,001,958000,Mazumdar; Arya,9998,0,9999,1
1746544318530,DSC 297,002,959862,Wang; Yusu,9999,0,9999,0
1746544319558,EAP 100,A00,905686,Staff,9778,0,9999,221
1746544320583,ECE 45,A01,892618,Staff,0,0,65,65
1746544322636,ECE 111,A01,892719,Staff,4,0,65,61
1746544323660,ECE 197,001,957920,Mercier; Patrick Philip,9991,0,9999,8
1746544324692,ECON 178,A01,907814,Zhu; Ying,26,0,35,9
1746544325718,EDS 115,A00,895312,Staff,36,0,45,9
1746544326747,EDS 117,A01,895337,Staff,24,0,30,6
1746544327777,EDS 125,A00,895341,Jones; Gabrielle Anastasia,37,0,45,8
1746544328803,EDS 128A,A01,895459,Fargason; Sharon Gayle,44,0,45,1
1746544329831,EDS 128B,A01,895543,Pappas; Elizabeth,44,0,45,1
1746544330858,EDS 139,A00,897203,Pappas; Elizabeth,44,0,45,1
1746544330858,EDS 139,B00,897209,Fargason; Sharon Gayle,41,0,45,4
1746544331888,EDS 201,A00,895545,Staff,23,0,45,22
1746544332914,EDS 203,A01,895581,Halter; Christopher P.,23,0,45,22
1746544333943,EDS 204R,A01,895625,Heinzman; Erica M.,39,0,45,6
1746544333943,EDS 204R,B01,895693,Halter; Christopher P.,10,0,45,35
1746544334971,EDS 206R,A00,895694,Fargason; Sharon Gayle,1,0,30,29
1746544334971,EDS 206R,B00,895695,Choi; Bailey Miyeon,16,0,30,14
1746544335997,EDS 250,A00,895697,Hemans; Patricia Ann Benitez,23,0,45,22
1746544337023,EDS 281,A00,895701,Meyerott; Theresa Ann,1,0,15,14
1746544338053,EDS 284,A00,895736,Meyerott; Theresa Ann,1,0,15,14
1746544339081,EDS 286,A00,897210,Fine; Sarah,0,0,15,15
1746544340111,EDS 289C,A01,895770,Daly; Alan J.,15,0,15,0
1746544341137,EDS 290,A00,897211,Hofstetter; Carolyn,0,0,15,15
1746544342167,LIGM 5A,A00,896162,Fischer-Grunski; Eva K,13,0,20,7
1746544343197,LIGM 5B,A00,896260,Fischer-Grunski; Eva K,17,0,20,3
1746544344223,LIGM 5C,A00,896308,Fischer-Grunski; Eva K,18,0,20,2
1746544345248,LIIT 5AS,A00,896313,Carnelos; Chiara,18,0,20,2
1746544346273,LIIT 5BS,A00,896416,Carnelos; Chiara,20,0,20,0
1746544347301,LIIT 5CS,A00,896564,Carnelos; Chiara,20,0,20,0
1746544348329,LISP 5A,A00,896588,Munoz Sanchez; Alicia,3,0,20,17
1746544349356,LISP 5B,A00,896653,Munoz Sanchez; Alicia,7,0,20,13
1746544350381,LISP 5C,A00,896655,Munoz Sanchez; Alicia,0,1,20,20
1746544351407,MAE 197,001,957918,Kleissl; Jan,9996,0,9999,3
1746544351407,MAE 197,002,959806,Boechler; Nicholas Sebastia,9998,0,9999,1
1746544351407,MAE 197,003,959852,Mullin; Jennifer S,9999,0,9999,0
1746544352434,MATH 2,A01,957937,Staff,33,0,35,2
1746544353459,MATH 197,001,957876,Kedlaya; Kiran S.,9993,0,9999,6
1746544354484,MCWP 40,A00,892729,Duru; Nur,10,0,20,10
1746544354484,MCWP 40,B00,893304,Montejo; Carolina,14,0,20,6
1746544355516,MCWP 40R,A00,893757,Redela; Pamela Morgan,0,5,20,20
1746544356540,MCWP 50,A00,893758,Morshed; Michael James,0,0,20,20
1746544356540,MCWP 50,B00,893761,Bartulis; Jason Michael,17,0,20,3
1746544357571,MCWP 50R,A00,893766,Compas; Sean Matthew,0,1,20,20
1746544357571,MCWP 50R,B00,893769,Carter; Jennifer A,0,1,20,20
1746544357571,MCWP 50R,C00,893771,Krone; Jarret,0,3,20,20
1746544357571,MCWP 50R,D00,893772,Miller; Elizabeth Deen,0,0,20,20
1746544357571,MCWP 50R,E00,893775,Carter; Andrea L,0,1,20,20
1746544358601,MMW 11R,A01,892721,Herbst; Matthew,11,0,27,16
1746544358601,MMW 11R,A02,892722,Herbst; Matthew,0,0,0,3
1746544359629,MMW 12R,A01,892724,Herbst; Matthew,0,11,16,16
1746544359629,MMW 12R,A02,892725,Herbst; Matthew,0,10,16,16
1746544360657,MMW 13R,A01,892727,Staff,0,4,16,16
1746544360657,MMW 13R,A02,892728,Staff,0,4,16,16
1746544360657,MMW 13R,A03,958032,Staff,0,4,16,16
1746544360657,MMW 13R,A04,958033,Staff,0,4,16,16
1746544360657,MMW 13R,A05,958034,Staff,0,4,16,16
1746544361683,SIO 295LS,A00,894015,Staff,5,0,25,20
1746544362708,SIO 295S,A00,894020,Staff,5,0,25,20
1746544363735,SIOC 290S,B01,958918,Merrifield; Mark A,14,0,30,16
1746544364762,SIOC 291S,B01,958922,Gabriel; Corey John,14,0,30,16
1746544365791,SOCI 117,A01,895339,Staff,3,0,5,2
1746544366816,WES 237B,A00,894149,Staff,11,0,20,9
1746544368884,AESE 279B,A00,891859,Staff,13,0,35,22
1746544369911,AIP 197,001,891854,Vespa; Emanuel Ignacio,9999,0,9999,0
1746544370938,ANTH 289S,A00,891856,Gagneux; Pascal,12,0,12,0
1746544371966,BENG 196,001,957946,Engler; Adam J.,9996,0,9999,3
1746544372992,BISP 197,001,959851,Wilhelm; James E.,9999,0,9999,0
1746544374020,CAT 124RS,A01,956906,Staff,6,0,25,19
1746544375045,CAT 125RS,A01,922013,Staff,6,0,25,19
1746544376070,CLRE 250,A00,891860,Morris; Sheldon,9995,0,9999,4
1746544378119,CLRE 251R,A00,907817,Mehta; Ravindra L.,9994,0,9999,5
1746544379145,CLRE 252,A00,891864,Cuomo; Raphael Eduardo,9993,0,9999,6
1746544380171,CLRE 253,A00,891867,Vaida; Florin,9994,0,9999,5
1746544380171,CLRE 253,B00,907819,Staff,9999,0,9999,0
1746544381194,CLRE 259,A00,891868,Patel; Hemal,9998,0,9999,1
1746544382233,CLRE 260,A00,891872,Cuomo; Raphael Eduardo,9999,0,9999,0
1746544383261,CLRE 297,001,891888,Cuomo; Raphael Eduardo,9999,0,9999,0
1746544384285,CSE 191,A00,958773,Minnes Kemp; Mor Mia,9996,0,9999,3
1746544385308,CSE 197,001,959846,Minnes Kemp; Mor Mia,9993,0,9999,6
1746544386336,CSS 201S,A01,892054,Mignozzetti; Umberto,26,0,30,4
1746544387362,CSS 202S,A01,892056,Mignozzetti; Umberto,26,0,30,4
1746544388390,DSC 197,001,956898,Eldridge; Justin Matthew,9998,0,9999,1
1746544389415,DSC 297,001,958000,Mazumdar; Arya,9998,0,9999,1
1746544389415,DSC 297,002,959862,Wang; Yusu,9999,0,9999,0
1746544390444,EAP 100,A00,905686,Staff,9778,0,9999,221
1746544391470,ECE 45,A01,892618,Staff,0,0,65,65
1746544393520,ECE 111,A01,892719,Staff,4,0,65,61
1746544394547,ECE 197,001,957920,Mercier; Patrick Philip,9991,0,9999,8
1746544395573,ECON 178,A01,907814,Zhu; Ying,26,0,35,9
1746544396598,EDS 115,A00,895312,Staff,36,0,45,9
1746544397626,EDS 117,A01,895337,Staff,24,0,30,6
1746544398652,EDS 125,A00,895341,Jones; Gabrielle Anastasia,37,0,45,8
1746544399679,EDS 128A,A01,895459,Fargason; Sharon Gayle,44,0,45,1
1746544400705,EDS 128B,A01,895543,Pappas; Elizabeth,44,0,45,1
1746544401733,EDS 139,A00,897203,Pappas; Elizabeth,44,0,45,1
1746544401733,EDS 139,B00,897209,Fargason; Sharon Gayle,41,0,45,4
1746544402758,EDS 201,A00,895545,Staff,23,0,45,22
1746544403785,EDS 203,A01,895581,Halter; Christopher P.,23,0,45,22
1746544404811,EDS 204R,A01,895625,Heinzman; Erica M.,39,0,45,6
1746544404811,EDS 204R,B01,895693,Halter; Christopher P.,10,0,45,35
1746544405836,EDS 206R,A00,895694,Fargason; Sharon Gayle,1,0,30,29
1746544405836,EDS 206R,B00,895695,Choi; Bailey Miyeon,16,0,30,14
1746544406865,EDS 250,A00,895697,Hemans; Patricia Ann Benitez,23,0,45,22
1746544407890,EDS 281,A00,895701,Meyerott; Theresa Ann,1,0,15,14
1746544408920,EDS 284,A00,895736,Meyerott; Theresa Ann,1,0,15,14
1746544409944,EDS 286,A00,897210,Fine; Sarah,0,0,15,15
1746544410972,EDS 289C,A01,895770,Daly; Alan J.,15,0,15,0
1746544411997,EDS 290,A00,897211,Hofstetter; Carolyn,0,0,15,15
1746544413027,LIGM 5A,A00,896162,Fischer-Grunski; Eva K,13,0,20,7
1746544414052,LIGM 5B,A00,896260,Fischer-Grunski; Eva K,17,0,20,3
1746544415077,LIGM 5C,A00,896308,Fischer-Grunski; Eva K,18,0,20,2
1746544416103,LIIT 5AS,A00,896313,Carnelos; Chiara,18,0,20,2
1746544417128,LIIT 5BS,A00,896416,Carnelos; Chiara,20,0,20,0
1746544418156,LIIT 5CS,A00,896564,Carnelos; Chiara,20,0,20,0
1746544419182,LISP 5A,A00,896588,Munoz Sanchez; Alicia,3,0,20,17
1746544420208,LISP 5B,A00,896653,Munoz Sanchez; Alicia,7,0,20,13
1746544421237,LISP 5C,A00,896655,Munoz Sanchez; Alicia,0,1,20,20
1746544422263,MAE 197,001,957918,Kleissl; Jan,9996,0,9999,3
1746544422263,MAE 197,002,959806,Boechler; Nicholas Sebastia,9998,0,9999,1
1746544422263,MAE 197,003,959852,Mullin; Jennifer S,9999,0,9999,0
1746544423288,MATH 2,A01,957937,Staff,33,0,35,2
1746544424315,MATH 197,001,957876,Kedlaya; Kiran S.,9993,0,9999,6
1746544425343,MCWP 40,A00,892729,Duru; Nur,10,0,20,10
1746544425343,MCWP 40,B00,893304,Montejo; Carolina,14,0,20,6
1746544426371,MCWP 40R,A00,893757,Redela; Pamela Morgan,0,5,20,20
1746544427398,MCWP 50,A00,893758,Morshed; Michael James,0,0,20,20
1746544427398,MCWP 50,B00,893761,Bartulis; Jason Michael,17,0,20,3
1746544428424,MCWP 50R,A00,893766,Compas; Sean Matthew,0,1,20,20
1746544428424,MCWP 50R,B00,893769,Carter; Jennifer A,0,1,20,20
1746544428424,MCWP 50R,C00,893771,Krone; Jarret,0,3,20,20
1746544428424,MCWP 50R,D00,893772,Miller; Elizabeth Deen,0,0,20,20
1746544428424,MCWP 50R,E00,893775,Carter; Andrea L,0,1,20,20
1746544429450,MMW 11R,A01,892721,Herbst; Matthew,11,0,27,16
1746544429450,MMW 11R,A02,892722,Herbst; Matthew,0,0,0,3
1746544430476,MMW 12R,A01,892724,Herbst; Matthew,0,11,16,16
1746544430476,MMW 12R,A02,892725,Herbst; Matthew,0,10,16,16
1746544431502,MMW 13R,A01,892727,Staff,0,4,16,16
1746544431502,MMW 13R,A02,892728,Staff,0,4,16,16
1746544431502,MMW 13R,A03,958032,Staff,0,4,16,16
1746544431502,MMW 13R,A04,958033,Staff,0,4,16,16
1746544431502,MMW 13R,A05,958034,Staff,0,4,16,16
1746544432530,SIO 295LS,A00,894015,Staff,5,0,25,20
1746544433558,SIO 295S,A00,894020,Staff,5,0,25,20
1746544434585,SIOC 290S,B01,958918,Merrifield; Mark A,14,0,30,16
1746544435610,SIOC 291S,B01,958922,Gabriel; Corey John,14,0,30,16
1746544436636,SOCI 117,A01,895339,Staff,3,0,5,2
1746544437663,WES 237B,A00,894149,Staff,11,0,20,9
1746544439736,AESE 279B,A00,891859,Staff,13,0,35,22
1746544440763,AIP 197,001,891854,Vespa; Emanuel Ignacio,9999,0,9999,0
1746544441793,ANTH 289S,A00,891856,Gagneux; Pascal,12,0,12,0
1746544442818,BENG 196,001,957946,Engler; Adam J.,9996,0,9999,3
1746544443844,BISP 197,001,959851,Wilhelm; James E.,9999,0,9999,0
1746544444869,CAT 124RS,A01,956906,Staff,6,0,25,19
1746544445896,CAT 125RS,A01,922013,Staff,6,0,25,19
1746544446924,CLRE 250,A00,891860,Morris; Sheldon,9995,0,9999,4
1746544448978,CLRE 251R,A00,907817,Mehta; Ravindra L.,9994,0,9999,5
1746544450006,CLRE 252,A00,891864,Cuomo; Raphael Eduardo,9993,0,9999,6
1746544451033,CLRE 253,A00,891867,Vaida; Florin,9994,0,9999,5
1746544451033,CLRE 253,B00,907819,Staff,9999,0,9999,0
1746544452060,CLRE 259,A00,891868,Patel; Hemal,9998,0,9999,1
1746544453085,CLRE 260,A00,891872,Cuomo; Raphael Eduardo,9999,0,9999,0
1746544454110,CLRE 297,001,891888,Cuomo; Raphael Eduardo,9999,0,9999,0
1746544455138,CSE 191,A00,958773,Minnes Kemp; Mor Mia,9996,0,9999,3
1746544456163,CSE 197,001,959846,Minnes Kemp; Mor Mia,9993,0,9999,6
1746544457189,CSS 201S,A01,892054,Mignozzetti; Umberto,26,0,30,4
1746544458215,CSS 202S,A01,892056,Mignozzetti; Umberto,26,0,30,4
1746544459239,DSC 197,001,956898,Eldridge; Justin Matthew,9998,0,9999,1
1746544460264,DSC 297,001,958000,Mazumdar; Arya,9998,0,9999,1
1746544460264,DSC 297,002,959862,Wang; Yusu,9999,0,9999,0
1746544461289,EAP 100,A00,905686,Staff,9778,0,9999,221
1746544462315,ECE 45,A01,892618,Staff,0,0,65,65
1746544464365,ECE 111,A01,892719,Staff,4,0,65,61
1746544465395,ECE 197,001,957920,Mercier; Patrick Philip,9991,0,9999,8
1746544466422,ECON 178,A01,907814,Zhu; Ying,26,0,35,9
1746544467450,EDS 115,A00,895312,Staff,36,0,45,9
1746544468479,EDS 117,A01,895337,Staff,24,0,30,6
1746544469505,EDS 125,A00,895341,Jones; Gabrielle Anastasia,37,0,45,8
1746544470530,EDS 128A,A01,895459,Fargason; Sharon Gayle,44,0,45,1
1746544471556,EDS 128B,A01,895543,Pappas; Elizabeth,44,0,45,1
1746544472581,EDS 139,A00,897203,Pappas; Elizabeth,44,0,45,1
1746544472581,EDS 139,B00,897209,Fargason; Sharon Gayle,41,0,45,4
1746544473606,EDS 201,A00,895545,Staff,23,0,45,22
1746544474633,EDS 203,A01,895581,Halter; Christopher P.,23,0,45,22
1746544475658,EDS 204R,A01,895625,Heinzman; Erica M.,39,0,45,6
1746544475658,EDS 204R,B01,895693,Halter; Christopher P.,10,0,45,35
1746544476682,EDS 206R,A00,895694,Fargason; Sharon Gayle,1,0,30,29
1746544476682,EDS 206R,B00,895695,Choi; Bailey Miyeon,16,0,30,14
1746544477710,EDS 250,A00,895697,Hemans; Patricia Ann Benitez,23,0,45,22
1746544478734,EDS 281,A00,895701,Meyerott; Theresa Ann,1,0,15,14
1746544479758,EDS 284,A00,895736,Meyerott; Theresa Ann,1,0,15,14
1746544480786,EDS 286,A00,897210,Fine; Sarah,0,0,15,15
1746544481809,EDS 289C,A01,895770,Daly; Alan J.,15,0,15,0
1746544482834,EDS 290,A00,897211,Hofstetter; Carolyn,0,0,15,15
1746544483860,LIGM 5A,A00,896162,Fischer-Grunski; Eva K,13,0,20,7
1746544484886,LIGM 5B,A00,896260,Fischer-Grunski; Eva K,17,0,20,3
1746544485911,LIGM 5C,A00,896308,Fischer-Grunski; Eva K,18,0,20,2
1746544486941,LIIT 5AS,A00,896313,Carnelos; Chiara,18,0,20,2
1746544487967,LIIT 5BS,A00,896416,Carnelos; Chiara,20,0,20,0
1746544488993,LIIT 5CS,A00,896564,Carnelos; Chiara,20,0,20,0
1746544490016,LISP 5A,A00,896588,Munoz Sanchez; Alicia,3,0,20,17
1746544491044,LISP 5B,A00,896653,Munoz Sanchez; Alicia,7,0,20,13
1746544492070,LISP 5C,A00,896655,Munoz Sanchez; Alicia,0,1,20,20
1746544493102,MAE 197,001,957918,Kleissl; Jan,9996,0,9999,3
1746544493102,MAE 197,002,959806,Boechler; Nicholas Sebastia,9998,0,9999,1
1746544493102,MAE 197,003,959852,Mullin; Jennifer S,9999,0,9999,0
1746544494126,MATH 2,A01,957937,Staff,33,0,35,2
1746544495150,MATH 197,001,957876,Kedlaya; Kiran S.,9993,0,9999,6
1746544496176,MCWP 40,A00,892729,Duru; Nur,10,0,20,10
1746544496176,MCWP 40,B00,893304,Montejo; Carolina,14,0,20,6
1746544497206,MCWP 40R,A00,893757,Redela; Pamela Morgan,0,5,20,20
1746544498231,MCWP 50,A00,893758,Morshed; Michael James,0,0,20,20
1746544498231,MCWP 50,B00,893761,Bartulis; Jason Michael,17,0,20,3
1746544499262,MCWP 50R,A00,893766,Compas; Sean Matthew,0,1,20,20
1746544499262,MCWP 50R,B00,893769,Carter; Jennifer A,0,1,20,20
1746544499262,MCWP 50R,C00,893771,Krone; Jarret,0,3,20,20
1746544499262,MCWP 50R,D00,893772,Miller; Elizabeth Deen,0,0,20,20
1746544499262,MCWP 50R,E00,893775,Carter; Andrea L,0,1,20,20
1746544500287,MMW 11R,A01,892721,Herbst; Matthew,11,0,27,16
1746544500287,MMW 11R,A02,892722,Herbst; Matthew,0,0,0,3
1746544501315,MMW 12R,A01,892724,Herbst; Matthew,0,11,16,16
1746544501315,MMW 12R,A02,892725,Herbst; Matthew,0,10,16,16
1746544502343,MMW 13R,A01,892727,Staff,0,4,16,16
1746544502343,MMW 13R,A02,892728,Staff,0,4,16,16
1746544502343,MMW 13R,A03,958032,Staff,0,4,16,16
1746544502343,MMW 13R,A04,958033,Staff,0,4,16,16
1746544502343,MMW 13R,A05,958034,Staff,0,4,16,16
1746544503370,SIO 295LS,A00,894015,Staff,5,0,25,20
1746544504397,SIO 295S,A00,894020,Staff,5,0,25,20
1746544505423,SIOC 290S,B01,958918,Merrifield; Mark A,14,0,30,16
1746544506447,SIOC 291S,B01,958922,Gabriel; Corey John,14,0,30,16
1746544507472,SOCI 117,A01,895339,Staff,3,0,5,2
1746544508496,WES 237B,A00,894149,Staff,11,0,20,9
1746544510573,AESE 279B,A00,891859,Staff,13,0,35,22
1746544511600,AIP 197,001,891854,Vespa; Emanuel Ignacio,9999,0,9999,0
1746544512629,ANTH 289S,A00,891856,Gagneux; Pascal,12,0,12,0
1746544513657,BENG 196,001,957946,Engler; Adam J.,9996,0,9999,3
1746544514686,BISP 197,001,959851,Wilhelm; James E.,9999,0,9999,0
1746544515711,CAT 124RS,A01,956906,Staff,6,0,25,19
1746544516739,CAT 125RS,A01,922013,Staff,6,0,25,19
1746544517768,CLRE 250,A00,891860,Morris; Sheldon,9995,0,9999,4
1746544519821,CLRE 251R,A00,907817,Mehta; Ravindra L.,9994,0,9999,5
1746544520847,CLRE 252,A00,891864,Cuomo; Raphael Eduardo,9993,0,9999,6
1746544521873,CLRE 253,A00,891867,Vaida; Florin,9994,0,9999,5
1746544521873,CLRE 253,B00,907819,Staff,9999,0,9999,0
1746544522897,CLRE 259,A00,891868,Patel; Hemal,9998,0,9999,1
1746544523922,CLRE 260,A00,891872,Cuomo; Raphael Eduardo,9999,0,9999,0
1746544524948,CLRE 297,001,891888,Cuomo; Raphael Eduardo,9999,0,9999,0
1746544525974,CSE 191,A00,958773,Minnes Kemp; Mor Mia,9996,0,9999,3
1746544526998,CSE 197,001,959846,Minnes Kemp; Mor Mia,9993,0,9999,6
1746544528027,CSS 201S,A01,892054,Mignozzetti; Umberto,26,0,30,4
1746544529052,CSS 202S,A01,892056,Mignozzetti; Umberto,26,0,30,4
1746544530076,DSC 197,001,956898,Eldridge; Justin Matthew,9998,0,9999,1
1746544531102,DSC 297,001,958000,Mazumdar; Arya,9998,0,9999,1
1746544531102,DSC 297,002,959862,Wang; Yusu,9999,0,9999,0
1746544532130,EAP 100,A00,905686,Staff,9778,0,9999,221
1746544533157,ECE 45,A01,892618,Staff,0,0,65,65
1746544535209,ECE 111,A01,892719,Staff,4,0,65,61
1746544536236,ECE 197,001,957920,Mercier; Patrick Philip,9991,0,9999,8
1746544537260,ECON 178,A01,907814,Zhu; Ying,26,0,35,9
1746544538286,EDS 115,A00,895312,Staff,36,0,45,9
1746544539313,EDS 117,A01,895337,Staff,24,0,30,6
1746544540340,EDS 125,A00,895341,Jones; Gabrielle Anastasia,37,0,45,8
1746544541369,EDS 128A,A01,895459,Fargason; Sharon Gayle,44,0,45,1
1746544542407,EDS 128B,A01,895543,Pappas; Elizabeth,44,0,45,1
1746544543431,EDS 139,A00,897203,Pappas; Elizabeth,44,0,45,1
1746544543431,EDS 139,B00,897209,Fargason; Sharon Gayle,41,0,45,4
1746544544459,EDS 201,A00,895545,Staff,23,0,45,22
1746544545488,EDS 203,A01,895581,Halter; Christopher P.,23,0,45,22
1746544546514,EDS 204R,A01,895625,Heinzman; Erica M.,39,0,45,6
1746544546514,EDS 204R,B01,895693,Halter; Christopher P.,10,0,45,35
1746544547539,EDS 206R,A00,895694,Fargason; Sharon Gayle,1,0,30,29
1746544547539,EDS 206R,B00,895695,Choi; Bailey Miyeon,16,0,30,14
1746544548563,EDS 250,A00,895697,Hemans; Patricia Ann Benitez,23,0,45,22
1746544549587,EDS 281,A00,895701,Meyerott; Theresa Ann,1,0,15,14
1746544550613,EDS 284,A00,895736,Meyerott; Theresa Ann,1,0,15,14
1746544551640,EDS 286,A00,897210,Fine; Sarah,0,0,15,15
1746544552665,EDS 289C,A01,895770,Daly; Alan J.,15,0,15,0
1746544553690,EDS 290,A00,897211,Hofstetter; Carolyn,0,0,15,15
1746544554716,LIGM 5A,A00,896162,Fischer-Grunski; Eva K,13,0,20,7
1746544555747,LIGM 5B,A00,896260,Fischer-Grunski; Eva K,17,0,20,3
1746544556772,LIGM 5C,A00,896308,Fischer-Grunski; Eva K,18,0,20,2
1746544557801,LIIT 5AS,A00,896313,Carnelos; Chiara,18,0,20,2
1746544558832,LIIT 5BS,A00,896416,Carnelos; Chiara,20,0,20,0
1746544559863,LIIT 5CS,A00,896564,Carnelos; Chiara,20,0,20,0
1746544560890,LISP 5A,A00,896588,Munoz Sanchez; Alicia,3,0,20,17
1746544561915,LISP 5B,A00,896653,Munoz Sanchez; Alicia,7,0,20,13
1746544562942,LISP 5C,A00,896655,Munoz Sanchez; Alicia,0,1,20,20
1746544563968,MAE 197,001,957918,Kleissl; Jan,9996,0,9999,3
1746544563968,MAE 197,002,959806,Boechler; Nicholas Sebastia,9998,0,9999,1
1746544563968,MAE 197,003,959852,Mullin; Jennifer S,9999,0,9999,0
1746544564994,MATH 2,A01,957937,Staff,33,0,35,2
1746544566021,MATH 197,001,957876,Kedlaya; Kiran S.,9993,0,9999,6
1746544567050,MCWP 40,A00,892729,Duru; Nur,10,0,20,10
1746544567050,MCWP 40,B00,893304,Montejo; Carolina,14,0,20,6
1746544568077,MCWP 40R,A00,893757,Redela; Pamela Morgan,0,5,20,20
1746544569103,MCWP 50,A00,893758,Morshed; Michael James,0,0,20,20
1746544569103,MCWP 50,B00,893761,Bartulis; Jason Michael,17,0,20,3
1746544570131,MCWP 50R,A00,893766,Compas; Sean Matthew,0,1,20,20
1746544570131,MCWP 50R,B00,893769,Carter; Jennifer A,0,1,20,20
1746544570131,MCWP 50R,C00,893771,Krone; Jarret,0,3,20,20
1746544570131,MCWP 50R,D00,893772,Miller; Elizabeth Deen,0,0,20,20
1746544570131,MCWP 50R,E00,893775,Carter; Andrea L,0,1,20,20
1746544571158,MMW 11R,A01,892721,Herbst; Matthew,11,0,27,16
1746544571158,MMW 11R,A02,892722,Herbst; Matthew,0,0,0,3
1746544572184,MMW 12R,A01,892724,Herbst; Matthew,0,11,16,16
1746544572184,MMW 12R,A02,892725,Herbst; Matthew,0,10,16,16
1746544573208,MMW 13R,A01,892727,Staff,0,4,16,16
1746544573208,MMW 13R,A02,892728,Staff,0,4,16,16
1746544573208,MMW 13R,A03,958032,Staff,0,4,16,16
1746544573208,MMW 13R,A04,958033,Staff,0,4,16,16
1746544573208,MMW 13R,A05,958034,Staff,0,4,16,16
1746544574237,SIO 295LS,A00,894015,Staff,5,0,25,20
1746544575267,SIO 295S,A00,894020,Staff,5,0,25,20
1746544576292,SIOC 290S,B01,958918,Merrifield; Mark A,14,0,30,16
1746544577319,SIOC 291S,B01,958922,Gabriel; Corey John,14,0,30,16
1746544578348,SOCI 117,A01,895339,Staff,3,0,5,2
1746544579373,WES 237B,A00,894149,Staff,11,0,20,9
1746544581442,AESE 279B,A00,891859,Staff,13,0,35,22
1746544582469,AIP 197,001,891854,Vespa; Emanuel Ignacio,9999,0,9999,0
1746544583499,ANTH 289S,A00,891856,Gagneux; Pascal,12,0,12,0
1746544584525,BENG 196,001,957946,Engler; Adam J.,9996,0,9999,3
1746544585550,BISP 197,001,959851,Wilhelm; James E.,9999,0,9999,0
1746544586576,CAT 124RS,A01,956906,Staff,6,0,25,19
1746544587600,CAT 125RS,A01,922013,Staff,6,0,25,19
1746544588627,CLRE 250,A00,891860,Morris; Sheldon,9995,0,9999,4
1746544590677,CLRE 251R,A00,907817,Mehta; Ravindra L.,9994,0,9999,5
1746544591702,CLRE 252,A00,891864,Cuomo; Raphael Eduardo,9993,0,9999,6
1746544592727,CLRE 253,A00,891867,Vaida; Florin,9994,0,9999,5
1746544592727,CLRE 253,B00,907819,Staff,9999,0,9999,0
1746544593752,CLRE 259,A00,891868,Patel; Hemal,9998,0,9999,1
1746544594777,CLRE 260,A00,891872,Cuomo; Raphael Eduardo,9999,0,9999,0
1746544595804,CLRE 297,001,891888,Cuomo; Raphael Eduardo,9999,0,9999,0
1746544596828,CSE 191,A00,958773,Minnes Kemp; Mor Mia,9996,0,9999,3
1746544597854,CSE 197,001,959846,Minnes Kemp; Mor Mia,9993,0,9999,6
1746544598885,CSS 201S,A01,892054,Mignozzetti; Umberto,26,0,30,4
1746544599911,CSS 202S,A01,892056,Mignozzetti; Umberto,26,0,30,4
1746544600939,DSC 197,001,956898,Eldridge; Justin Matthew,9998,0,9999,1
1746544601967,DSC 297,001,958000,Mazumdar; Arya,9998,0,9999,1
1746544601967,DSC 297,002,959862,Wang; Yusu,9999,0,9999,0
1746544602994,EAP 100,A00,905686,Staff,9778,0,9999,221
1746544604023,ECE 45,A01,892618,Staff,0,0,65,65
1746544606081,ECE 111,A01,892719,Staff,4,0,65,61
1746544607105,ECE 197,001,957920,Mercier; Patrick Philip,9991,0,9999,8
1746544608131,ECON 178,A01,907814,Zhu; Ying,26,0,35,9
1746544609158,EDS 115,A00,895312,Staff,36,0,45,9
1746544610218,EDS 117,A01,895337,Staff,24,0,30,6
1746544611245,EDS 125,A00,895341,Jones; Gabrielle Anastasia,37,0,45,8
1746544612270,EDS 128A,A01,895459,Fargason; Sharon Gayle,44,0,45,1
1746544613301,EDS 128B,A01,895543,Pappas; Elizabeth,44,0,45,1
1746544614325,EDS 139,A00,897203,Pappas; Elizabeth,44,0,45,1
1746544614325,EDS 139,B00,897209,Fargason; Sharon Gayle,41,0,45,4
1746544615351,EDS 201,A00,895545,Staff,23,0,45,22
1746544616381,EDS 203,A01,895581,Halter; Christopher P.,23,0,45,22
1746544617411,EDS 204R,A01,895625,Heinzman; Erica M.,39,0,45,6
1746544617411,EDS 204R,B01,895693,Halter; Christopher P.,10,0,45,35
1746544618437,EDS 206R,A00,895694,Fargason; Sharon Gayle,1,0,30,29
1746544618437,EDS 206R,B00,895695,Choi; Bailey Miyeon,16,0,30,14
1746544619463,EDS 250,A00,895697,Hemans; Patricia Ann Benitez,23,0,45,22
1746544620490,EDS 281,A00,895701,Meyerott; Theresa Ann,1,0,15,14
1746544621514,EDS 284,A00,895736,Meyerott; Theresa Ann,1,0,15,14
1746544622540,EDS 286,A00,897210,Fine; Sarah,0,0,15,15
1746544623565,EDS 289C,A01,895770,Daly; Alan J.,15,0,15,0
1746544624588,EDS 290,A00,897211,Hofstetter; Carolyn,0,0,15,15
1746544625613,LIGM 5A,A00,896162,Fischer-Grunski; Eva K,13,0,20,7
1746544626640,LIGM 5B,A00,896260,Fischer-Grunski; Eva K,17,0,20,3
1746544627666,LIGM 5C,A00,896308,Fischer-Grunski; Eva K,18,0,20,2
1746544628691,LIIT 5AS,A00,896313,Carnelos; Chiara,18,0,20,2
1746544629719,LIIT 5BS,A00,896416,Carnelos; Chiara,20,0,20,0
1746544630746,LIIT 5CS,A00,896564,Carnelos; Chiara,20,0,20,0
1746544631773,LISP 5A,A00,896588,Munoz Sanchez; Alicia,3,0,20,17
1746544632800,LISP 5B,A00,896653,Munoz Sanchez; Alicia,7,0,20,13
1746544633826,LISP 5C,A00,896655,Munoz Sanchez; Alicia,0,1,20,20
1746544634852,MAE 197,001,957918,Kleissl; Jan,9996,0,9999,3
1746544634852,MAE 197,002,959806,Boechler; Nicholas Sebastia,9998,0,9999,1
1746544634852,MAE 197,003,959852,Mullin; Jennifer S,9999,0,9999,0
1746544635878,MATH 2,A01,957937,Staff,33,0,35,2
1746544636945,MATH 197,001,957876,Kedlaya; Kiran S.,9993,0,9999,6
1746544637973,MCWP 40,A00,892729,Duru; Nur,10,0,20,10
1746544637973,MCWP 40,B00,893304,Montejo; Carolina,14,0,20,6
1746544638999,MCWP 40R,A00,893757,Redela; Pamela Morgan,0,5,20,20
1746544640029,MCWP 50,A00,893758,Morshed; Michael James,0,0,20,20
1746544640029,MCWP 50,B00,893761,Bartulis; Jason Michael,17,0,20,3
1746544641060,MCWP 50R,A00,893766,Compas; Sean Matthew,0,1,20,20
1746544641060,MCWP 50R,B00,893769,Carter; Jennifer A,0,1,20,20
1746544641060,MCWP 50R,C00,893771,Krone; Jarret,0,3,20,20
1746544641060,MCWP 50R,D00,893772,Miller; Elizabeth Deen,0,0,20,20
1746544641060,MCWP 50R,E00,893775,Carter; Andrea L,0,1,20,20
1746544642086,MMW 11R,A01,892721,Herbst; Matthew,11,0,27,16
1746544642086,MMW 11R,A02,892722,Herbst; Matthew,0,0,0,3
1746544643115,MMW 12R,A01,892724,Herbst; Matthew,0,11,16,16
1746544643115,MMW 12R,A02,892725,Herbst; Matthew,0,10,16,16
1746544644142,MMW 13R,A01,892727,Staff,0,4,16,16
1746544644142,MMW 13R,A02,892728,Staff,0,4,16,16
1746544644142,MMW 13R,A03,958032,Staff,0,4,16,16
1746544644142,MMW 13R,A04,958033,Staff,0,4,16,16
1746544644142,MMW 13R,A05,958034,Staff,0,4,16,16
1746544645167,SIO 295LS,A00,894015,Staff,5,0,25,20
1746544646192,SIO 295S,A00,894020,Staff,5,0,25,20
1746544647222,SIOC 290S,B01,958918,Merrifield; Mark A,14,0,30,16
1746544648250,SIOC 291S,B01,958922,Gabriel; Corey John,14,0,30,16
1746544649275,SOCI 117,A01,895339,Staff,3,0,5,2
1746544650302,WES 237B,A00,894149,Staff,11,0,20,9
1746544652362,AESE 279B,A00,891859,Staff,13,0,35,22
1746544653389,AIP 197,001,891854,Vespa; Emanuel Ignacio,9999,0,9999,0
1746544654412,ANTH 289S,A00,891856,Gagneux; Pascal,12,0,12,0
1746544655440,BENG 196,001,957946,Engler; Adam J.,9996,0,9999,3
1746544656467,BISP 197,001,959851,Wilhelm; James E.,9999,0,9999,0
1746544657493,CAT 124RS,A01,956906,Staff,6,0,25,19
1746544658519,CAT 125RS,A01,922013,Staff,6,0,25,19
1746544659544,CLRE 250,A00,891860,Morris; Sheldon,9995,0,9999,4
1746544661602,CLRE 251R,A00,907817,Mehta; Ravindra L.,9994,0,9999,5
1746544662631,CLRE 252,A00,891864,Cuomo; Raphael Eduardo,9993,0,9999,6
1746544663660,CLRE 253,A00,891867,Vaida; Florin,9994,0,9999,5
1746544663660,CLRE 253,B00,907819,Staff,9999,0,9999,0
1746544664686,CLRE 259,A00,891868,Patel; Hemal,9998,0,9999,1
1746544665711,CLRE 260,A00,891872,Cuomo; Raphael Eduardo,9999,0,9999,0
1746544666739,CLRE 297,001,891888,Cuomo; Raphael Eduardo,9999,0,9999,0
1746544667764,CSE 191,A00,958773,Minnes Kemp; Mor Mia,9996,0,9999,3
1746544668793,CSE 197,001,959846,Minnes Kemp; Mor Mia,9993,0,9999,6
1746544669823,CSS 201S,A01,892054,Mignozzetti; Umberto,26,0,30,4
1746544670855,CSS 202S,A01,892056,Mignozzetti; Umberto,26,0,30,4
1746544671882,DSC 197,001,956898,Eldridge; Justin Matthew,9998,0,9999,1
1746544672911,DSC 297,001,958000,Mazumdar; Arya,9998,0,9999,1
1746544672911,DSC 297,002,959862,Wang; Yusu,9999,0,9999,0
1746544673938,EAP 100,A00,905686,Staff,9778,0,9999,221
1746544674964,ECE 45,A01,892618,Staff,0,0,65,65
1746544677017,ECE 111,A01,892719,Staff,4,0,65,61
1746544678044,ECE 197,001,957920,Mercier; Patrick Philip,9991,0,9999,8
1746544679072,ECON 178,A01,907814,Zhu; Ying,26,0,35,9
1746544680100,EDS 115,A00,895312,Staff,36,0,45,9
1746544681127,EDS 117,A01,895337,Staff,24,0,30,6
1746544682153,EDS 125,A00,895341,Jones; Gabrielle Anastasia,37,0,45,8
1746544683180,EDS 128A,A01,895459,Fargason; Sharon Gayle,44,0,45,1
1746544684208,EDS 128B,A01,895543,Pappas; Elizabeth,44,0,45,1
1746544685232,EDS 139,A00,897203,Pappas; Elizabeth,44,0,45,1
1746544685232,EDS 139,B00,897209,Fargason; Sharon Gayle,41,0,45,4
1746544686256,EDS 201,A00,895545,Staff,23,0,45,22
1746544687281,EDS 203,A01,895581,Halter; Christopher P.,23,0,45,22
1746544688307,EDS 204R,A01,895625,Heinzman; Erica M.,39,0,45,6
1746544688307,EDS 204R,B01,895693,Halter; Christopher P.,10,0,45,35
1746544689335,EDS 206R,A00,895694,Fargason; Sharon Gayle,1,0,30,29
1746544689335,EDS 206R,B00,895695,Choi; Bailey Miyeon,16,0,30,14
1746544690361,EDS 250,A00,895697,Hemans; Patricia Ann Benitez,23,0,45,22
1746544691385,EDS 281,A00,895701,Meyerott; Theresa Ann,1,0,15,14
1746544692411,EDS 284,A00,895736,Meyerott; Theresa Ann,1,0,15,14
1746544693439,EDS 286,A00,897210,Fine; Sarah,0,0,15,15
1746544694469,EDS 289C,A01,895770,Daly; Alan J.,15,0,15,0
1746544695493,EDS 290,A00,897211,Hofstetter; Carolyn,0,0,15,15
1746544696522,LIGM 5A,A00,896162,Fischer-Grunski; Eva K,13,0,20,7
1746544697550,LIGM 5B,A00,896260,Fischer-Grunski; Eva K,17,0,20,3
1746544698576,LIGM 5C,A00,896308,Fischer-Grunski; Eva K,18,0,20,2
1746544699606,LIIT 5AS,A00,896313,Carnelos; Chiara,18,0,20,2
1746544700634,LIIT 5BS,A00,896416,Carnelos; Chiara,20,0,20,0
1746544701663,LIIT 5CS,A00,896564,Carnelos; Chiara,20,0,20,0
1746544702690,LISP 5A,A00,896588,Munoz Sanchez; Alicia,3,0,20,17
1746544703715,LISP 5B,A00,896653,Munoz Sanchez; Alicia,7,0,20,13
1746544704741,LISP 5C,A00,896655,Munoz Sanchez; Alicia,0,1,20,20
1746544705769,MAE 197,001,957918,Kleissl; Jan,9996,0,9999,3
1746544705769,MAE 197,002,959806,Boechler; Nicholas Sebastia,9998,0,9999,1
1746544705769,MAE 197,003,959852,Mullin; Jennifer S,9999,0,9999,0
1746544706797,MATH 2,A01,957937,Staff,33,0,35,2
1746544707823,MATH 197,001,957876,Kedlaya; Kiran S.,9993,0,9999,6
1746544708849,MCWP 40,A00,892729,Duru; Nur,10,0,20,10
1746544708849,MCWP 40,B00,893304,Montejo; Carolina,14,0,20,6
1746544709875,MCWP 40R,A00,893757,Redela; Pamela Morgan,0,5,20,20
1746544710904,MCWP 50,A00,893758,Morshed; Michael James,0,0,20,20
1746544710904,MCWP 50,B00,893761,Bartulis; Jason Michael,17,0,20,3
1746544711933,MCWP 50R,A00,893766,Compas; Sean Matthew,0,1,20,20
1746544711933,MCWP 50R,B00,893769,Carter; Jennifer A,0,1,20,20
1746544711933,MCWP 50R,C00,893771,Krone; Jarret,0,3,20,20
1746544711933,MCWP 50R,D00,893772,Miller; Elizabeth Deen,0,0,20,20
1746544711933,MCWP 50R,E00,893775,Carter; Andrea L,0,1,20,20
1746544712962,MMW 11R,A01,892721,Herbst; Matthew,11,0,27,16
1746544712962,MMW 11R,A02,892722,Herbst; Matthew,0,0,0,3
1746544713987,MMW 12R,A01,892724,Herbst; Matthew,0,11,16,16
1746544713987,MMW 12R,A02,892725,Herbst; Matthew,0,10,16,16
1746544715015,MMW 13R,A01,892727,Staff,0,4,16,16
1746544715015,MMW 13R,A02,892728,Staff,0,4,16,16
1746544715015,MMW 13R,A03,958032,Staff,0,4,16,16
1746544715015,MMW 13R,A04,958033,Staff,0,4,16,16
1746544715015,MMW 13R,A05,958034,Staff,0,4,16,16
1746544716043,SIO 295LS,A00,894015,Staff,5,0,25,20
1746544717069,SIO 295S,A00,894020,Staff,5,0,25,20
1746544718094,SIOC 290S,B01,958918,Merrifield; Mark A,14,0,30,16
1746544719125,SIOC 291S,B01,958922,Gabriel; Corey John,14,0,30,16
1746544720153,SOCI 117,A01,895339,Staff,3,0,5,2
1746544721178,WES 237B,A00,894149,Staff,11,0,20,9
1746544723244,AESE 279B,A00,891859,Staff,13,0,35,22
1746544724268,AIP 197,001,891854,Vespa; Emanuel Ignacio,9999,0,9999,0
1746544725297,ANTH 289S,A00,891856,Gagneux; Pascal,12,0,12,0
1746544726321,BENG 196,001,957946,Engler; Adam J.,9996,0,9999,3
1746544727349,BISP 197,001,959851,Wilhelm; James E.,9999,0,9999,0
1746544728377,CAT 124RS,A01,956906,Staff,6,0,25,19
1746544729404,CAT 125RS,A01,922013,Staff,6,0,25,19
1746544730432,CLRE 250,A00,891860,Morris; Sheldon,9995,0,9999,4
1746544732486,CLRE 251R,A00,907817,Mehta; Ravindra L.,9994,0,9999,5
1746544733513,CLRE 252,A00,891864,Cuomo; Raphael Eduardo,9993,0,9999,6
1746544734541,CLRE 253,A00,891867,Vaida; Florin,9994,0,9999,5
1746544734541,CLRE 253,B00,907819,Staff,9999,0,9999,0
1746544735568,CLRE 259,A00,891868,Patel; Hemal,9998,0,9999,1
1746544736594,CLRE 260,A00,891872,Cuomo; Raphael Eduardo,9999,0,9999,0
1746544737618,CLRE 297,001,891888,Cuomo; Raphael Eduardo,9999,0,9999,0
1746544738643,CSE 191,A00,958773,Minnes Kemp; Mor Mia,9996,0,9999,3
1746544739671,CSE 197,001,959846,Minnes Kemp; Mor Mia,9993,0,9999,6
1746544740701,CSS 201S,A01,892054,Mignozzetti; Umberto,26,0,30,4
1746544741726,CSS 202S,A01,892056,Mignozzetti; Umberto,26,0,30,4
1746544742754,DSC 197,001,956898,Eldridge; Justin Matthew,9998,0,9999,1
1746544743779,DSC 297,001,958000,Mazumdar; Arya,9998,0,9999,1
1746544743779,DSC 297,002,959862,Wang; Yusu,9999,0,9999,0
1746544744806,EAP 100,A00,905686,Staff,9778,0,9999,221
1746544745836,ECE 45,A01,892618,Staff,0,0,65,65
1746544747889,ECE 111,A01,892719,Staff,4,0,65,61
1746544748915,ECE 197,001,957920,Mercier; Patrick Philip,9991,0,9999,8
1746544749946,ECON 178,A01,907814,Zhu; Ying,26,0,35,9
1746544750970,EDS 115,A00,895312,Staff,36,0,45,9
1746544752000,EDS 117,A01,895337,Staff,24,0,30,6
1746544753027,EDS 125,A00,895341,Jones; Gabrielle Anastasia,37,0,45,8
1746544754053,EDS 128A,A01,895459,Fargason; Sharon Gayle,44,0,45,1
1746544755082,EDS 128B,A01,895543,Pappas; Elizabeth,44,0,45,1
1746544756107,EDS 139,A00,897203,Pappas; Elizabeth,44,0,45,1
1746544756107,EDS 139,B00,897209,Fargason; Sharon Gayle,41,0,45,4
1746544757133,EDS 201,A00,895545,Staff,23,0,45,22
1746544758162,EDS 203,A01,895581,Halter; Christopher P.,23,0,45,22
1746544759188,EDS 204R,A01,895625,Heinzman; Erica M.,39,0,45,6
1746544759188,EDS 204R,B01,895693,Halter; Christopher P.,10,0,45,35
1746544760214,EDS 206R,A00,895694,Fargason; Sharon Gayle,1,0,30,29
1746544760214,EDS 206R,B00,895695,Choi; Bailey Miyeon,16,0,30,14
1746544761242,EDS 250,A00,895697,Hemans; Patricia Ann Benitez,23,0,45,22
1746544762270,EDS 281,A00,895701,Meyerott; Theresa Ann,1,0,15,14
1746544763297,EDS 284,A00,895736,Meyerott; Theresa Ann,1,0,15,14
1746544764322,EDS 286,A00,897210,Fine; Sarah,0,0,15,15
1746544765351,EDS 289C,A01,895770,Daly; Alan J.,15,0,15,0
1746544766378,EDS 290,A00,897211,Hofstetter; Carolyn,0,0,15,15
1746544767456,LIGM 5A,A00,896162,Fischer-Grunski; Eva K,13,0,20,7
1746544768480,LIGM 5B,A00,896260,Fischer-Grunski; Eva K,17,0,20,3
1746544769508,LIGM 5C,A00,896308,Fischer-Grunski; Eva K,18,0,20,2
1746544770538,LIIT 5AS,A00,896313,Carnelos; Chiara,18,0,20,2
1746544771564,LIIT 5BS,A00,896416,Carnelos; Chiara,20,0,20,0
1746544772587,LIIT 5CS,A00,896564,Carnelos; Chiara,20,0,20,0
1746544773615,LISP 5A,A00,896588,Munoz Sanchez; Alicia,3,0,20,17
1746544774638,LISP 5B,A00,896653,Munoz Sanchez; Alicia,7,0,20,13
1746544775665,LISP 5C,A00,896655,Munoz Sanchez; Alicia,0,1,20,20
1746544776689,MAE 197,001,957918,Kleissl; Jan,9996,0,9999,3
1746544776689,MAE 197,002,959806,Boechler; Nicholas Sebastia,9998,0,9999,1
1746544776689,MAE 197,003,959852,Mullin; Jennifer S,9999,0,9999,0
1746544777716,MATH 2,A01,957937,Staff,33,0,35,2
1746544778742,MATH 197,001,957876,Kedlaya; Kiran S.,9993,0,9999,6
1746544779768,MCWP 40,A00,892729,Duru; Nur,10,0,20,10
1746544779768,MCWP 40,B00,893304,Montejo; Carolina,14,0,20,6
1746544780792,MCWP 40R,A00,893757,Redela; Pamela Morgan,0,5,20,20
1746544781817,MCWP 50,A00,893758,Morshed; Michael James,0,0,20,20
1746544781817,MCWP 50,B00,893761,Bartulis; Jason Michael,17,0,20,3
1746544782845,MCWP 50R,A00,893766,Compas; Sean Matthew,0,1,20,20
1746544782845,MCWP 50R,B00,893769,Carter; Jennifer A,0,1,20,20
1746544782845,MCWP 50R,C00,893771,Krone; Jarret,0,3,20,20
1746544782845,MCWP 50R,D00,893772,Miller; Elizabeth Deen,0,0,20,20
1746544782845,MCWP 50R,E00,893775,Carter; Andrea L,0,1,20,20
1746544783873,MMW 11R,A01,892721,Herbst; Matthew,11,0,27,16
1746544783873,MMW 11R,A02,892722,Herbst; Matthew,0,0,0,3
1746544784899,MMW 12R,A01,892724,Herbst; Matthew,0,11,16,16
1746544784899,MMW 12R,A02,892725,Herbst; Matthew,0,10,16,16
1746544785923,MMW 13R,A01,892727,Staff,0,4,16,16
1746544785923,MMW 13R,A02,892728,Staff,0,4,16,16
1746544785923,MMW 13R,A03,958032,Staff,0,4,16,16
1746544785923,MMW 13R,A04,958033,Staff,0,4,16,16
1746544785923,MMW 13R,A05,958034,Staff,0,4,16,16
1746544786948,SIO 295LS,A00,894015,Staff,5,0,25,20
1746544787973,SIO 295S,A00,894020,Staff,5,0,25,20
1746544789003,SIOC 290S,B01,958918,Merrifield; Mark A,14,0,30,16
1746544790029,SIOC 291S,B01,958922,Gabriel; Corey John,14,0,30,16
1746544791057,SOCI 117,A01,895339,Staff,3,0,5,2
1746544792082,WES 237B,A00,894149,Staff,11,0,20,9
1746544794153,AESE 279B,A00,891859,Staff,13,0,35,22
1746544795180,AIP 197,001,891854,Vespa; Emanuel Ignacio,9999,0,9999,0
1746544796206,ANTH 289S,A00,891856,Gagneux; Pascal,12,0,12,0
1746544797232,BENG 196,001,957946,Engler; Adam J.,9996,0,9999,3
1746544798259,BISP 197,001,959851,Wilhelm; James E.,9999,0,9999,0
1746544799284,CAT 124RS,A01,956906,Staff,6,0,25,19
1746544800311,CAT 125RS,A01,922013,Staff,6,0,25,19
1746544801336,CLRE 250,A00,891860,Morris; Sheldon,9995,0,9999,4
1746544803397,CLRE 251R,A00,907817,Mehta; Ravindra L.,9994,0,9999,5
1746544804422,CLRE 252,A00,891864,Cuomo; Raphael Eduardo,9993,0,9999,6
1746544805447,CLRE 253,A00,891867,Vaida; Florin,9994,0,9999,5
1746544805447,CLRE 253,B00,907819,Staff,9999,0,9999,0
1746544806472,CLRE 259,A00,891868,Patel; Hemal,9998,0,9999,1
1746544807499,CLRE 260,A00,891872,Cuomo; Raphael Eduardo,9999,0,9999,0
1746544808525,CLRE 297,001,891888,Cuomo; Raphael Eduardo,9999,0,9999,0
1746544809550,CSE 191,A00,958773,Minnes Kemp; Mor Mia,9996,0,9999,3
1746544810576,CSE 197,001,959846,Minnes Kemp; Mor Mia,9993,0,9999,6
1746544811602,CSS 201S,A01,892054,Mignozzetti; Umberto,26,0,30,4
1746544812631,CSS 202S,A01,892056,Mignozzetti; Umberto,26,0,30,4
1746544813658,DSC 197,001,956898,Eldridge; Justin Matthew,9998,0,9999,1
1746544814683,DSC 297,001,958000,Mazumdar; Arya,9998,0,9999,1
1746544814683,DSC 297,002,959862,Wang; Yusu,9999,0,9999,0
1746544815707,EAP 100,A00,905686,Staff,9778,0,9999,221
1746544816734,ECE 45,A01,892618,Staff,0,0,65,65
1746544818785,ECE 111,A01,892719,Staff,4,0,65,61
1746544819815,ECE 197,001,957920,Mercier; Patrick Philip,9991,0,9999,8
1746544820841,ECON 178,A01,907814,Zhu; Ying,26,0,35,9
1746544821867,EDS 115,A00,895312,Staff,36,0,45,9
1746544822894,EDS 117,A01,895337,Staff,24,0,30,6
1746544823918,EDS 125,A00,895341,Jones; Gabrielle Anastasia,37,0,45,8
1746544824945,EDS 128A,A01,895459,Fargason; Sharon Gayle,44,0,45,1
1746544825970,EDS 128B,A01,895543,Pappas; Elizabeth,44,0,45,1
1746544826995,EDS 139,A00,897203,Pappas; Elizabeth,44,0,45,1
1746544826995,EDS 139,B00,897209,Fargason; Sharon Gayle,41,0,45,4
1746544828022,EDS 201,A00,895545,Staff,23,0,45,22
1746544829049,EDS 203,A01,895581,Halter; Christopher P.,23,0,45,22
1746544830077,EDS 204R,A01,895625,Heinzman; Erica M.,39,0,45,6
1746544830077,EDS 204R,B01,895693,Halter; Christopher P.,10,0,45,35
1746544831101,EDS 206R,A00,895694,Fargason; Sharon Gayle,1,0,30,29
1746544831101,EDS 206R,B00,895695,Choi; Bailey Miyeon,16,0,30,14
1746544832127,EDS 250,A00,895697,Hemans; Patricia Ann Benitez,23,0,45,22
1746544833153,EDS 281,A00,895701,Meyerott; Theresa Ann,1,0,15,14
1746544834176,EDS 284,A00,895736,Meyerott; Theresa Ann,1,0,15,14
1746544835204,EDS 286,A00,897210,Fine; Sarah,0,0,15,15
1746544836230,EDS 289C,A01,895770,Daly; Alan J.,15,0,15,0
1746544837255,EDS 290,A00,897211,Hofstetter; Carolyn,0,0,15,15
1746544838280,LIGM 5A,A00,896162,Fischer-Grunski; Eva K,13,0,20,7
1746544839306,LIGM 5B,A00,896260,Fischer-Grunski; Eva K,17,0,20,3
1746544840336,LIGM 5C,A00,896308,Fischer-Grunski; Eva K,18,0,20,2
1746544841364,LIIT 5AS,A00,896313,Carnelos; Chiara,18,0,20,2
1746544842406,LIIT 5BS,A00,896416,Carnelos; Chiara,20,0,20,0
1746544843430,LIIT 5CS,A00,896564,Carnelos; Chiara,20,0,20,0
1746544844457,LISP 5A,A00,896588,Munoz Sanchez; Alicia,3,0,20,17
1746544845494,LISP 5B,A00,896653,Munoz Sanchez; Alicia,7,0,20,13
1746544846523,LISP 5C,A00,896655,Munoz Sanchez; Alicia,0,1,20,20
1746544847548,MAE 197,001,957918,Kleissl; Jan,9996,0,9999,3
1746544847548,MAE 197,002,959806,Boechler; Nicholas Sebastia,9998,0,9999,1
1746544847548,MAE 197,003,959852,Mullin; Jennifer S,9999,0,9999,0
1746544848571,MATH 2,A01,957937,Staff,33,0,35,2
1746544849599,MATH 197,001,957876,Kedlaya; Kiran S.,9993,0,9999,6
1746544850625,MCWP 40,A00,892729,Duru; Nur,10,0,20,10
1746544850625,MCWP 40,B00,893304,Montejo; Carolina,14,0,20,6
1746544851652,MCWP 40R,A00,893757,Redela; Pamela Morgan,0,5,20,20
1746544852677,MCWP 50,A00,893758,Morshed; Michael James,0,0,20,20
1746544852677,MCWP 50,B00,893761,Bartulis; Jason Michael,17,0,20,3
1746544853707,MCWP 50R,A00,893766,Compas; Sean Matthew,0,1,20,20
1746544853707,MCWP 50R,B00,893769,Carter; Jennifer A,0,1,20,20
1746544853707,MCWP 50R,C00,893771,Krone; Jarret,0,3,20,20
1746544853707,MCWP 50R,D00,893772,Miller; Elizabeth Deen,0,0,20,20
1746544853707,MCWP 50R,E00,893775,Carter; Andrea L,0,1,20,20
1746544854734,MMW 11R,A01,892721,Herbst; Matthew,11,0,27,16
1746544854734,MMW 11R,A02,892722,Herbst; Matthew,0,0,0,3
1746544855759,MMW 12R,A01,892724,Herbst; Matthew,0,11,16,16
1746544855759,MMW 12R,A02,892725,Herbst; Matthew,0,10,16,16
1746544856786,MMW 13R,A01,892727,Staff,0,4,16,16
1746544856786,MMW 13R,A02,892728,Staff,0,4,16,16
1746544856786,MMW 13R,A03,958032,Staff,0,4,16,16
1746544856786,MMW 13R,A04,958033,Staff,0,4,16,16
1746544856786,MMW 13R,A05,958034,Staff,0,4,16,16
1746544857810,SIO 295LS,A00,894015,Staff,5,0,25,20
1746544858838,SIO 295S,A00,894020,Staff,5,0,25,20
1746544859862,SIOC 290S,B01,958918,Merrifield; Mark A,14,0,30,16
1746544860909,SIOC 291S,B01,958922,Gabriel; Corey John,14,0,30,16
1746544861934,SOCI 117,A01,895339,Staff,3,0,5,2
1746544862960,WES 237B,A00,894149,Staff,11,0,20,9
1746544865028,AESE 279B,A00,891859,Staff,13,0,35,22
1746544866057,AIP 197,001,891854,Vespa; Emanuel Ignacio,9999,0,9999,0
1746544867084,ANTH 289S,A00,891856,Gagneux; Pascal,12,0,12,0
1746544868112,BENG 196,001,957946,Engler; Adam J.,9996,0,9999,3
1746544869140,BISP 197,001,959851,Wilhelm; James E.,9999,0,9999,0
1746544870168,CAT 124RS,A01,956906,Staff,6,0,25,19
1746544871195,CAT 125RS,A01,922013,Staff,6,0,25,19
1746544872223,CLRE 250,A00,891860,Morris; Sheldon,9995,0,9999,4
1746544874275,CLRE 251R,A00,907817,Mehta; Ravindra L.,9994,0,9999,5
1746544875301,CLRE 252,A00,891864,Cuomo; Raphael Eduardo,9993,0,9999,6
1746544876327,CLRE 253,A00,891867,Vaida; Florin,9994,0,9999,5
1746544876327,CLRE 253,B00,907819,Staff,9999,0,9999,0
1746544877351,CLRE 259,A00,891868,Patel; Hemal,9998,0,9999,1
1746544878380,CLRE 260,A00,891872,Cuomo; Raphael Eduardo,9999,0,9999,0
1746544879406,CLRE 297,001,891888,Cuomo; Raphael Eduardo,9999,0,9999,0
1746544880432,CSE 191,A00,958773,Minnes Kemp; Mor Mia,9996,0,9999,3
1746544881459,CSE 197,001,959846,Minnes Kemp; Mor Mia,9993,0,9999,6
1746544882488,CSS 201S,A01,892054,Mignozzetti; Umberto,26,0,30,4
1746544883513,CSS 202S,A01,892056,Mignozzetti; Umberto,26,0,30,4
1746544884541,DSC 197,001,956898,Eldridge; Justin Matthew,9998,0,9999,1
1746544885569,DSC 297,001,958000,Mazumdar; Arya,9998,0,9999,1
1746544885569,DSC 297,002,959862,Wang; Yusu,9999,0,9999,0
1746544886594,EAP 100,A00,905686,Staff,9778,0,9999,221
1746544887623,ECE 45,A01,892618,Staff,0,0,65,65
1746544889675,ECE 111,A01,892719,Staff,4,0,65,61
1746544890700,ECE 197,001,957920,Mercier; Patrick Philip,9991,0,9999,8
1746544891731,ECON 178,A01,907814,Zhu; Ying,26,0,35,9
1746544892758,EDS 115,A00,895312,Staff,36,0,45,9
1746544893783,EDS 117,A01,895337,Staff,24,0,30,6
1746544894811,EDS 125,A00,895341,Jones; Gabrielle Anastasia,37,0,45,8
1746544895837,EDS 128A,A01,895459,Fargason; Sharon Gayle,44,0,45,1
1746544896866,EDS 128B,A01,895543,Pappas; Elizabeth,44,0,45,1
1746544897891,EDS 139,A00,897203,Pappas; Elizabeth,44,0,45,1
1746544897891,EDS 139,B00,897209,Fargason; Sharon Gayle,41,0,45,4
1746544898915,EDS 201,A00,895545,Staff,23,0,45,22
1746544899942,EDS 203,A01,895581,Halter; Christopher P.,23,0,45,22
1746544900967,EDS 204R,A01,895625,Heinzman; Erica M.,39,0,45,6
1746544900967,EDS 204R,B01,895693,Halter; Christopher P.,10,0,45,35
1746544901992,EDS 206R,A00,895694,Fargason; Sharon Gayle,1,0,30,29
1746544901992,EDS 206R,B00,895695,Choi; Bailey Miyeon,16,0,30,14
1746544903020,EDS 250,A00,895697,Hemans; Patricia Ann Benitez,23,0,45,22
1746544904044,EDS 281,A00,895701,Meyerott; Theresa Ann,1,0,15,14
1746544905071,EDS 284,A00,895736,Meyerott; Theresa Ann,1,0,15,14
1746544906098,EDS 286,A00,897210,Fine; Sarah,0,0,15,15
1746544907123,EDS 289C,A01,895770,Daly; Alan J.,15,0,15,0
1746544908149,EDS 290,A00,897211,Hofstetter; Carolyn,0,0,15,15
1746544909175,LIGM 5A,A00,896162,Fischer-Grunski; Eva K,13,0,20,7
1746544910206,LIGM 5B,A00,896260,Fischer-Grunski; Eva K,17,0,20,3
1746544911251,LIGM 5C,A00,896308,Fischer-Grunski; Eva K,18,0,20,2
1746544912276,LIIT 5AS,A00,896313,Carnelos; Chiara,18,0,20,2
1746544913305,LIIT 5BS,A00,896416,Carnelos; Chiara,20,0,20,0
1746544914330,LIIT 5CS,A00,896564,Carnelos; Chiara,20,0,20,0
1746544915354,LISP 5A,A00,896588,Munoz Sanchez; Alicia,3,0,20,17
1746544916380,LISP 5B,A00,896653,Munoz Sanchez; Alicia,7,0,20,13
1746544917407,LISP 5C,A00,896655,Munoz Sanchez; Alicia,0,1,20,20
1746544918434,MAE 197,001,957918,Kleissl; Jan,9996,0,9999,3
1746544918434,MAE 197,002,959806,Boechler; Nicholas Sebastia,9998,0,9999,1
1746544918434,MAE 197,003,959852,Mullin; Jennifer S,9999,0,9999,0
1746544919463,MATH 2,A01,957937,Staff,33,0,35,2
1746544920488,MATH 197,001,957876,Kedlaya; Kiran S.,9993,0,9999,6
1746544921517,MCWP 40,A00,892729,Duru; Nur,10,0,20,10
1746544921517,MCWP 40,B00,893304,Montejo; Carolina,14,0,20,6
1746544922544,MCWP 40R,A00,893757,Redela; Pamela Morgan,0,5,20,20
1746544923570,MCWP 50,A00,893758,Morshed; Michael James,0,0,20,20
1746544923570,MCWP 50,B00,893761,Bartulis; Jason Michael,17,0,20,3
1746544924601,MCWP 50R,A00,893766,Compas; Sean Matthew,0,1,20,20
1746544924601,MCWP 50R,B00,893769,Carter; Jennifer A,0,1,20,20
1746544924601,MCWP 50R,C00,893771,Krone; Jarret,0,3,20,20
1746544924601,MCWP 50R,D00,893772,Miller; Elizabeth Deen,0,0,20,20
1746544924601,MCWP 50R,E00,893775,Carter; Andrea L,0,1,20,20
1746544925625,MMW 11R,A01,892721,Herbst; Matthew,11,0,27,16
1746544925625,MMW 11R,A02,892722,Herbst; Matthew,0,0,0,3
1746544926651,MMW 12R,A01,892724,Herbst; Matthew,0,11,16,16
1746544926651,MMW 12R,A02,892725,Herbst; Matthew,0,10,16,16
1746544927677,MMW 13R,A01,892727,Staff,0,4,16,16
1746544927677,MMW 13R,A02,892728,Staff,0,4,16,16
1746544927677,MMW 13R,A03,958032,Staff,0,4,16,16
1746544927677,MMW 13R,A04,958033,Staff,0,4,16,16
1746544927677,MMW 13R,A05,958034,Staff,0,4,16,16
1746544928706,SIO 295LS,A00,894015,Staff,5,0,25,20
1746544929733,SIO 295S,A00,894020,Staff,5,0,25,20
1746544930762,SIOC 290S,B01,958918,Merrifield; Mark A,14,0,30,16
1746544931786,SIOC 291S,B01,958922,Gabriel; Corey John,14,0,30,16
1746544932811,SOCI 117,A01,895339,Staff,3,0,5,2
1746544933839,WES 237B,A00,894149,Staff,11,0,20,9
1746544935902,AESE 279B,A00,891859,Staff,13,0,35,22
1746544936930,AIP 197,001,891854,Vespa; Emanuel Ignacio,9999,0,9999,0
1746544937955,ANTH 289S,A00,891856,Gagneux; Pascal,12,0,12,0
1746544938984,BENG 196,001,957946,Engler; Adam J.,9996,0,9999,3
1746544940012,BISP 197,001,959851,Wilhelm; James E.,9999,0,9999,0
1746544941040,CAT 124RS,A01,956906,Staff,6,0,25,19
1746544942065,CAT 125RS,A01,922013,Staff,6,0,25,19
1746544943090,CLRE 250,A00,891860,Morris; Sheldon,9995,0,9999,4
1746544945149,CLRE 251R,A00,907817,Mehta; Ravindra L.,9994,0,9999,5
1746544946176,CLRE 252,A00,891864,Cuomo; Raphael Eduardo,9993,0,9999,6
1746544947207,CLRE 253,A00,891867,Vaida; Florin,9994,0,9999,5
1746544947207,CLRE 253,B00,907819,Staff,9999,0,9999,0
1746544948230,CLRE 259,A00,891868,Patel; Hemal,9998,0,9999,1
1746544949255,CLRE 260,A00,891872,Cuomo; Raphael Eduardo,9999,0,9999,0
1746544950280,CLRE 297,001,891888,Cuomo; Raphael Eduardo,9999,0,9999,0
1746544951307,CSE 191,A00,958773,Minnes Kemp; Mor Mia,9996,0,9999,3
1746544952336,CSE 197,001,959846,Minnes Kemp; Mor Mia,9993,0,9999,6
1746544953363,CSS 201S,A01,892054,Mignozzetti; Umberto,26,0,30,4
1746544954389,CSS 202S,A01,892056,Mignozzetti; Umberto,26,0,30,4
1746544955414,DSC 197,001,956898,Eldridge; Justin Matthew,9998,0,9999,1
1746544956439,DSC 297,001,958000,Mazumdar; Arya,9998,0,9999,1
1746544956439,DSC 297,002,959862,Wang; Yusu,9999,0,9999,0
1746544957465,EAP 100,A00,905686,Staff,9778,0,9999,221
1746544958492,ECE 45,A01,892618,Staff,0,0,65,65
1746544960546,ECE 111,A01,892719,Staff,4,0,65,61
1746544961572,ECE 197,001,957920,Mercier; Patrick Philip,9991,0,9999,8
1746544962597,ECON 178,A01,907814,Zhu; Ying,26,0,35,9
1746544963624,EDS 115,A00,895312,Staff,36,0,45,9
1746544964651,EDS 117,A01,895337,Staff,24,0,30,6
1746544965677,EDS 125,A00,895341,Jones; Gabrielle Anastasia,37,0,45,8
1746544966706,EDS 128A,A01,895459,Fargason; Sharon Gayle,44,0,45,1
1746544967730,EDS 128B,A01,895543,Pappas; Elizabeth,44,0,45,1
1746544968756,EDS 139,A00,897203,Pappas; Elizabeth,44,0,45,1
1746544968756,EDS 139,B00,897209,Fargason; Sharon Gayle,41,0,45,4
1746544969790,EDS 201,A00,895545,Staff,23,0,45,22
1746544970816,EDS 203,A01,895581,Halter; Christopher P.,23,0,45,22
1746544971843,EDS 204R,A01,895625,Heinzman; Erica M.,39,0,45,6
1746544971843,EDS 204R,B01,895693,Halter; Christopher P.,10,0,45,35
1746544972868,EDS 206R,A00,895694,Fargason; Sharon Gayle,1,0,30,29
1746544972868,EDS 206R,B00,895695,Choi; Bailey Miyeon,16,0,30,14
1746544973913,EDS 250,A00,895697,Hemans; Patricia Ann Benitez,23,0,45,22
1746544974940,EDS 281,A00,895701,Meyerott; Theresa Ann,1,0,15,14
1746544975964,EDS 284,A00,895736,Meyerott; Theresa Ann,1,0,15,14
1746544976989,EDS 286,A00,897210,Fine; Sarah,0,0,15,15
1746544978015,EDS 289C,A01,895770,Daly; Alan J.,15,0,15,0
1746544979042,EDS 290,A00,897211,Hofstetter; Carolyn,0,0,15,15
1746544980071,LIGM 5A,A00,896162,Fischer-Grunski; Eva K,13,0,20,7
1746544981096,LIGM 5B,A00,896260,Fischer-Grunski; Eva K,17,0,20,3
1746544982121,LIGM 5C,A00,896308,Fischer-Grunski; Eva K,18,0,20,2
1746544983152,LIIT 5AS,A00,896313,Carnelos; Chiara,18,0,20,2
1746544984178,LIIT 5BS,A00,896416,Carnelos; Chiara,20,0,20,0
1746544985207,LIIT 5CS,A00,896564,Carnelos; Chiara,20,0,20,0
1746544986231,LISP 5A,A00,896588,Munoz Sanchez; Alicia,3,0,20,17
1746544987256,LISP 5B,A00,896653,Munoz Sanchez; Alicia,7,0,20,13
1746544988280,LISP 5C,A00,896655,Munoz Sanchez; Alicia,0,1,20,20
1746544989306,MAE 197,001,957918,Kleissl; Jan,9996,0,9999,3
1746544989306,MAE 197,002,959806,Boechler; Nicholas Sebastia,9998,0,9999,1
1746544989306,MAE 197,003,959852,Mullin; Jennifer S,9999,0,9999,0
1746544990334,MATH 2,A01,957937,Staff,33,0,35,2
1746544991360,MATH 197,001,957876,Kedlaya; Kiran S.,9993,0,9999,6
1746544992386,MCWP 40,A00,892729,Duru; Nur,10,0,20,10
1746544992386,MCWP 40,B00,893304,Montejo; Carolina,14,0,20,6
1746544993416,MCWP 40R,A00,893757,Redela; Pamela Morgan,0,5,20,20
1746544994443,MCWP 50,A00,893758,Morshed; Michael James,0,0,20,20
1746544994443,MCWP 50,B00,893761,Bartulis; Jason Michael,17,0,20,3
1746544995469,MCWP 50R,A00,893766,Compas; Sean Matthew,0,1,20,20
1746544995469,MCWP 50R,B00,893769,Carter; Jennifer A,0,1,20,20
1746544995469,MCWP 50R,C00,893771,Krone; Jarret,0,3,20,20
1746544995469,MCWP 50R,D00,893772,Miller; Elizabeth Deen,0,0,20,20
1746544995469,MCWP 50R,E00,893775,Carter; Andrea L,0,1,20,20
1746544996493,MMW 11R,A01,892721,Herbst; Matthew,11,0,27,16
1746544996493,MMW 11R,A02,892722,Herbst; Matthew,0,0,0,3
1746544997517,MMW 12R,A01,892724,Herbst; Matthew,0,11,16,16
1746544997517,MMW 12R,A02,892725,Herbst; Matthew,0,10,16,16
1746544998543,MMW 13R,A01,892727,Staff,0,4,16,16
1746544998543,MMW 13R,A02,892728,Staff,0,4,16,16
1746544998543,MMW 13R,A03,958032,Staff,0,4,16,16
1746544998543,MMW 13R,A04,958033,Staff,0,4,16,16
1746544998543,MMW 13R,A05,958034,Staff,0,4,16,16
1746544999570,SIO 295LS,A00,894015,Staff,5,0,25,20
1746545000597,SIO 295S,A00,894020,Staff,5,0,25,20
1746545001626,SIOC 290S,B01,958918,Merrifield; Mark A,14,0,30,16
1746545002653,SIOC 291S,B01,958922,Gabriel; Corey John,14,0,30,16
1746545003680,SOCI 117,A01,895339,Staff,3,0,5,2
1746545004709,WES 237B,A00,894149,Staff,11,0,20,9
1746545006779,AESE 279B,A00,891859,Staff,13,0,35,22
1746545007809,AIP 197,001,891854,Vespa; Emanuel Ignacio,9999,0,9999,0
1746545008835,ANTH 289S,A00,891856,Gagneux; Pascal,12,0,12,0
1746545009859,BENG 196,001,957946,Engler; Adam J.,9996,0,9999,3
1746545010885,BISP 197,001,959851,Wilhelm; James E.,9999,0,9999,0
1746545011913,CAT 124RS,A01,956906,Staff,6,0,25,19
1746545012938,CAT 125RS,A01,922013,Staff,6,0,25,19
1746545013962,CLRE 250,A00,891860,Morris; Sheldon,9995,0,9999,4
1746545016015,CLRE 251R,A00,907817,Mehta; Ravindra L.,9994,0,9999,5
1746545017043,CLRE 252,A00,891864,Cuomo; Raphael Eduardo,9993,0,9999,6
1746545018073,CLRE 253,A00,891867,Vaida; Florin,9994,0,9999,5
1746545018073,CLRE 253,B00,907819,Staff,9999,0,9999,0
1746545019104,CLRE 259,A00,891868,Patel; Hemal,9998,0,9999,1
1746545020131,CLRE 260,A00,891872,Cuomo; Raphael Eduardo,9999,0,9999,0
1746545021156,CLRE 297,001,891888,Cuomo; Raphael Eduardo,9999,0,9999,0
1746545022186,CSE 191,A00,958773,Minnes Kemp; Mor Mia,9996,0,9999,3
1746545023212,CSE 197,001,959846,Minnes Kemp; Mor Mia,9993,0,9999,6
1746545024242,CSS 201S,A01,892054,Mignozzetti; Umberto,26,0,30,4
1746545025268,CSS 202S,A01,892056,Mignozzetti; Umberto,26,0,30,4
1746545026298,DSC 197,001,956898,Eldridge; Justin Matthew,9998,0,9999,1
1746545027324,DSC 297,001,958000,Mazumdar; Arya,9998,0,9999,1
1746545027324,DSC 297,002,959862,Wang; Yusu,9999,0,9999,0
1746545028353,EAP 100,A00,905686,Staff,9778,0,9999,221
1746545029381,ECE 45,A01,892618,Staff,0,0,65,65
1746545031433,ECE 111,A01,892719,Staff,4,0,65,61
1746545032462,ECE 197,001,957920,Mercier; Patrick Philip,9991,0,9999,8
1746545033491,ECON 178,A01,907814,Zhu; Ying,26,0,35,9
1746545034523,EDS 115,A00,895312,Staff,36,0,45,9
1746545035549,EDS 117,A01,895337,Staff,24,0,30,6
1746545036574,EDS 125,A00,895341,Jones; Gabrielle Anastasia,37,0,45,8
1746545037606,EDS 128A,A01,895459,Fargason; Sharon Gayle,44,0,45,1
1746545038632,EDS 128B,A01,895543,Pappas; Elizabeth,44,0,45,1
1746545039657,EDS 139,A00,897203,Pappas; Elizabeth,44,0,45,1
1746545039657,EDS 139,B00,897209,Fargason; Sharon Gayle,41,0,45,4
1746545040682,EDS 201,A00,895545,Staff,23,0,45,22
1746545041713,EDS 203,A01,895581,Halter; Christopher P.,23,0,45,22
1746545042738,EDS 204R,A01,895625,Heinzman; Erica M.,39,0,45,6
1746545042738,EDS 204R,B01,895693,Halter; Christopher P.,10,0,45,35
1746545043766,EDS 206R,A00,895694,Fargason; Sharon Gayle,1,0,30,29
1746545043766,EDS 206R,B00,895695,Choi; Bailey Miyeon,16,0,30,14
1746545044794,EDS 250,A00,895697,Hemans; Patricia Ann Benitez,23,0,45,22
1746545045821,EDS 281,A00,895701,Meyerott; Theresa Ann,1,0,15,14
1746545046849,EDS 284,A00,895736,Meyerott; Theresa Ann,1,0,15,14
1746545047878,EDS 286,A00,897210,Fine; Sarah,0,0,15,15
1746545048907,EDS 289C,A01,895770,Daly; Alan J.,15,0,15,0
1746545049935,EDS 290,A00,897211,Hofstetter; Carolyn,0,0,15,15
1746545050968,LIGM 5A,A00,896162,Fischer-Grunski; Eva K,13,0,20,7
1746545052065,LIGM 5B,A00,896260,Fischer-Grunski; Eva K,17,0,20,3
1746545053091,LIGM 5C,A00,896308,Fischer-Grunski; Eva K,18,0,20,2
1746545054119,LIIT 5AS,A00,896313,Carnelos; Chiara,18,0,20,2
1746545055146,LIIT 5BS,A00,896416,Carnelos; Chiara,20,0,20,0
1746545056175,LIIT 5CS,A00,896564,Carnelos; Chiara,20,0,20,0
1746545057202,LISP 5A,A00,896588,Munoz Sanchez; Alicia,3,0,20,17
1746545058227,LISP 5B,A00,896653,Munoz Sanchez; Alicia,7,0,20,13
1746545059254,LISP 5C,A00,896655,Munoz Sanchez; Alicia,0,1,20,20
1746545060285,MAE 197,001,957918,Kleissl; Jan,9996,0,9999,3
1746545060285,MAE 197,002,959806,Boechler; Nicholas Sebastia,9998,0,9999,1
1746545060285,MAE 197,003,959852,Mullin; Jennifer S,9999,0,9999,0
1746545061313,MATH 2,A01,957937,Staff,33,0,35,2
1746545062339,MATH 197,001,957876,Kedlaya; Kiran S.,9993,0,9999,6
1746545063366,MCWP 40,A00,892729,Duru; Nur,10,0,20,10
1746545063366,MCWP 40,B00,893304,Montejo; Carolina,14,0,20,6
1746545064392,MCWP 40R,A00,893757,Redela; Pamela Morgan,0,5,20,20
1746545065418,MCWP 50,A00,893758,Morshed; Michael James,0,0,20,20
1746545065418,MCWP 50,B00,893761,Bartulis; Jason Michael,17,0,20,3
1746545066446,MCWP 50R,A00,893766,Compas; Sean Matthew,0,1,20,20
1746545066446,MCWP 50R,B00,893769,Carter; Jennifer A,0,1,20,20
1746545066446,MCWP 50R,C00,893771,Krone; Jarret,0,3,20,20
1746545066446,MCWP 50R,D00,893772,Miller; Elizabeth Deen,0,0,20,20
1746545066446,MCWP 50R,E00,893775,Carter; Andrea L,0,1,20,20
1746545067473,MMW 11R,A01,892721,Herbst; Matthew,11,0,27,16
1746545067473,MMW 11R,A02,892722,Herbst; Matthew,0,0,0,3
1746545068498,MMW 12R,A01,892724,Herbst; Matthew,0,11,16,16
1746545068498,MMW 12R,A02,892725,Herbst; Matthew,0,10,16,16
1746545069566,MMW 13R,A01,892727,Staff,0,4,16,16
1746545069566,MMW 13R,A02,892728,Staff,0,4,16,16
1746545069566,MMW 13R,A03,958032,Staff,0,4,16,16
1746545069566,MMW 13R,A04,958033,Staff,0,4,16,16
1746545069566,MMW 13R,A05,958034,Staff,0,4,16,16
1746545070593,SIO 295LS,A00,894015,Staff,5,0,25,20
1746545071618,SIO 295S,A00,894020,Staff,5,0,25,20
1746545072648,SIOC 290S,B01,958918,Merrifield; Mark A,14,0,30,16
1746545073673,SIOC 291S,B01,958922,Gabriel; Corey John,14,0,30,16
1746545074700,SOCI 117,A01,895339,Staff,3,0,5,2
1746545075727,WES 237B,A00,894149,Staff,11,0,20,9
1746545077796,AESE 279B,A00,891859,Staff,13,0,35,22
1746545078821,AIP 197,001,891854,Vespa; Emanuel Ignacio,9999,0,9999,0
1746545079848,ANTH 289S,A00,891856,Gagneux; Pascal,12,0,12,0
1746545080878,BENG 196,001,957946,Engler; Adam J.,9996,0,9999,3
1746545081905,BISP 197,001,959851,Wilhelm; James E.,9999,0,9999,0
1746545082935,CAT 124RS,A01,956906,Staff,6,0,25,19
1746545083961,CAT 125RS,A01,922013,Staff,6,0,25,19
1746545084992,CLRE 250,A00,891860,Morris; Sheldon,9995,0,9999,4
1746545087052,CLRE 251R,A00,907817,Mehta; Ravindra L.,9994,0,9999,5
1746545088078,CLRE 252,A00,891864,Cuomo; Raphael Eduardo,9993,0,9999,6
1746545089108,CLRE 253,A00,891867,Vaida; Florin,9994,0,9999,5
1746545089108,CLRE 253,B00,907819,Staff,9999,0,9999,0
1746545090134,CLRE 259,A00,891868,Patel; Hemal,9998,0,9999,1
1746545091159,CLRE 260,A00,891872,Cuomo; Raphael Eduardo,9999,0,9999,0
1746545092185,CLRE 297,001,891888,Cuomo; Raphael Eduardo,9999,0,9999,0
1746545093214,CSE 191,A00,958773,Minnes Kemp; Mor Mia,9996,0,9999,3
1746545094240,CSE 197,001,959846,Minnes Kemp; Mor Mia,9993,0,9999,6
1746545095270,CSS 201S,A01,892054,Mignozzetti; Umberto,26,0,30,4
1746545096302,CSS 202S,A01,892056,Mignozzetti; Umberto,26,0,30,4
1746545097326,DSC 197,001,956898,Eldridge; Justin Matthew,9998,0,9999,1
1746545098351,DSC 297,001,958000,Mazumdar; Arya,9998,0,9999,1
1746545098351,DSC 297,002,959862,Wang; Yusu,9999,0,9999,0
1746545099380,EAP 100,A00,905686,Staff,9778,0,9999,221
1746545100413,ECE 45,A01,892618,Staff,0,0,65,65
1746545102469,ECE 111,A01,892719,Staff,4,0,65,61
1746545103496,ECE 197,001,957920,Mercier; Patrick Philip,9991,0,9999,8
1746545104522,ECON 178,A01,907814,Zhu; Ying,26,0,35,9
1746545105548,EDS 115,A00,895312,Staff,36,0,45,9
1746545106577,EDS 117,A01,895337,Staff,24,0,30,6
1746545107602,EDS 125,A00,895341,Jones; Gabrielle Anastasia,37,0,45,8
1746545108626,EDS 128A,A01,895459,Fargason; Sharon Gayle,44,0,45,1
1746545109651,EDS 128B,A01,895543,Pappas; Elizabeth,44,0,45,1
1746545110681,EDS 139,A00,897203,Pappas; Elizabeth,44,0,45,1
1746545110681,EDS 139,B00,897209,Fargason; Sharon Gayle,41,0,45,4
1746545111707,EDS 201,A00,895545,Staff,23,0,45,22
1746545112759,EDS 203,A01,895581,Halter; Christopher P.,23,0,45,22
1746545113787,EDS 204R,A01,895625,Heinzman; Erica M.,39,0,45,6
1746545113787,EDS 204R,B01,895693,Halter; Christopher P.,10,0,45,35
1746545114816,EDS 206R,A00,895694,Fargason; Sharon Gayle,1,0,30,29
1746545114816,EDS 206R,B00,895695,Choi; Bailey Miyeon,16,0,30,14
1746545115846,EDS 250,A00,895697,Hemans; Patricia Ann Benitez,23,0,45,22
1746545116872,EDS 281,A00,895701,Meyerott; Theresa Ann,1,0,15,14
1746545117900,EDS 284,A00,895736,Meyerott; Theresa Ann,1,0,15,14
1746545118926,EDS 286,A00,897210,Fine; Sarah,0,0,15,15
1746545119951,EDS 289C,A01,895770,Daly; Alan J.,15,0,15,0
1746545120975,EDS 290,A00,897211,Hofstetter; Carolyn,0,0,15,15
1746545122005,LIGM 5A,A00,896162,Fischer-Grunski; Eva K,13,0,20,7
1746545123033,LIGM 5B,A00,896260,Fischer-Grunski; Eva K,17,0,20,3
1746545124060,LIGM 5C,A00,896308,Fischer-Grunski; Eva K,18,0,20,2
1746545125088,LIIT 5AS,A00,896313,Carnelos; Chiara,18,0,20,2
1746545126114,LIIT 5BS,A00,896416,Carnelos; Chiara,20,0,20,0
1746545127142,LIIT 5CS,A00,896564,Carnelos; Chiara,20,0,20,0
1746545128166,LISP 5A,A00,896588,Munoz Sanchez; Alicia,3,0,20,17
1746545129191,LISP 5B,A00,896653,Munoz Sanchez; Alicia,7,0,20,13
1746545130214,LISP 5C,A00,896655,Munoz Sanchez; Alicia,0,1,20,20
1746545131245,MAE 197,001,957918,Kleissl; Jan,9996,0,9999,3
1746545131245,MAE 197,002,959806,Boechler; Nicholas Sebastia,9998,0,9999,1
1746545131245,MAE 197,003,959852,Mullin; Jennifer S,9999,0,9999,0
1746545132270,MATH 2,A01,957937,Staff,33,0,35,2
1746545133295,MATH 197,001,957876,Kedlaya; Kiran S.,9993,0,9999,6
1746545134328,MCWP 40,A00,892729,Duru; Nur,10,0,20,10
1746545134328,MCWP 40,B00,893304,Montejo; Carolina,14,0,20,6
1746545135355,MCWP 40R,A00,893757,Redela; Pamela Morgan,0,5,20,20
1746545136380,MCWP 50,A00,893758,Morshed; Michael James,0,0,20,20
1746545136380,MCWP 50,B00,893761,Bartulis; Jason Michael,17,0,20,3
1746545137406,MCWP 50R,A00,893766,Compas; Sean Matthew,0,1,20,20
1746545137406,MCWP 50R,B00,893769,Carter; Jennifer A,0,1,20,20
1746545137406,MCWP 50R,C00,893771,Krone; Jarret,0,3,20,20
1746545137406,MCWP 50R,D00,893772,Miller; Elizabeth Deen,0,0,20,20
1746545137406,MCWP 50R,E00,893775,Carter; Andrea L,0,1,20,20
1746545138435,MMW 11R,A01,892721,Herbst; Matthew,11,0,27,16
1746545138435,MMW 11R,A02,892722,Herbst; Matthew,0,0,0,3
1746545139464,MMW 12R,A01,892724,Herbst; Matthew,0,11,16,16
1746545139464,MMW 12R,A02,892725,Herbst; Matthew,0,10,16,16
1746545140491,MMW 13R,A01,892727,Staff,0,4,16,16
1746545140491,MMW 13R,A02,892728,Staff,0,4,16,16
1746545140491,MMW 13R,A03,958032,Staff,0,4,16,16
1746545140491,MMW 13R,A04,958033,Staff,0,4,16,16
1746545140491,MMW 13R,A05,958034,Staff,0,4,16,16
1746545141516,SIO 295LS,A00,894015,Staff,5,0,25,20
1746545142547,SIO 295S,A00,894020,Staff,5,0,25,20
1746545143574,SIOC 290S,B01,958918,Merrifield; Mark A,14,0,30,16
1746545144599,SIOC 291S,B01,958922,Gabriel; Corey John,14,0,30,16
1746545145629,SOCI 117,A01,895339,Staff,3,0,5,2
1746545146656,WES 237B,A00,894149,Staff,11,0,20,9
1746545148720,AESE 279B,A00,891859,Staff,13,0,35,22
1746545149747,AIP 197,001,891854,Vespa; Emanuel Ignacio,9999,0,9999,0
1746545150773,ANTH 289S,A00,891856,Gagneux; Pascal,12,0,12,0
1746545151798,BENG 196,001,957946,Engler; Adam J.,9996,0,9999,3
1746545152825,BISP 197,001,959851,Wilhelm; James E.,9999,0,9999,0
1746545153850,CAT 124RS,A01,956906,Staff,6,0,25,19
1746545154875,CAT 125RS,A01,922013,Staff,6,0,25,19
1746545155901,CLRE 250,A00,891860,Morris; Sheldon,9995,0,9999,4
1746545157962,CLRE 251R,A00,907817,Mehta; Ravindra L.,9994,0,9999,5
1746545158990,CLRE 252,A00,891864,Cuomo; Raphael Eduardo,9993,0,9999,6
1746545160020,CLRE 253,A00,891867,Vaida; Florin,9994,0,9999,5
1746545160020,CLRE 253,B00,907819,Staff,9999,0,9999,0
1746545161046,CLRE 259,A00,891868,Patel; Hemal,9998,0,9999,1
1746545162072,CLRE 260,A00,891872,Cuomo; Raphael Eduardo,9999,0,9999,0
1746545163099,CLRE 297,001,891888,Cuomo; Raphael Eduardo,9999,0,9999,0
1746545164149,CSE 191,A00,958773,Minnes Kemp; Mor Mia,9996,0,9999,3
1746545165174,CSE 197,001,959846,Minnes Kemp; Mor Mia,9993,0,9999,6
1746545166204,CSS 201S,A01,892054,Mignozzetti; Umberto,26,0,30,4
1746545167229,CSS 202S,A01,892056,Mignozzetti; Umberto,26,0,30,4
1746545168255,DSC 197,001,956898,Eldridge; Justin Matthew,9998,0,9999,1
1746545169281,DSC 297,001,958000,Mazumdar; Arya,9998,0,9999,1
1746545169281,DSC 297,002,959862,Wang; Yusu,9999,0,9999,0
1746545170308,EAP 100,A00,905686,Staff,9778,0,9999,221
1746545171333,ECE 45,A01,892618,Staff,0,0,65,65
1746545173384,ECE 111,A01,892719,Staff,4,0,65,61
1746545174409,ECE 197,001,957920,Mercier; Patrick Philip,9991,0,9999,8
1746545175436,ECON 178,A01,907814,Zhu; Ying,26,0,35,9
1746545176461,EDS 115,A00,895312,Staff,36,0,45,9
1746545177486,EDS 117,A01,895337,Staff,24,0,30,6
1746545178512,EDS 125,A00,895341,Jones; Gabrielle Anastasia,37,0,45,8
1746545179536,EDS 128A,A01,895459,Fargason; Sharon Gayle,44,0,45,1
1746545180564,EDS 128B,A01,895543,Pappas; Elizabeth,44,0,45,1
1746545181608,EDS 139,A00,897203,Pappas; Elizabeth,44,0,45,1
1746545181608,EDS 139,B00,897209,Fargason; Sharon Gayle,41,0,45,4
1746545182634,EDS 201,A00,895545,Staff,23,0,45,22
1746545183661,EDS 203,A01,895581,Halter; Christopher P.,23,0,45,22
1746545184691,EDS 204R,A01,895625,Heinzman; Erica M.,39,0,45,6
1746545184691,EDS 204R,B01,895693,Halter; Christopher P.,10,0,45,35
1746545185723,EDS 206R,A00,895694,Fargason; Sharon Gayle,1,0,30,29
1746545185723,EDS 206R,B00,895695,Choi; Bailey Miyeon,16,0,30,14
1746545186748,EDS 250,A00,895697,Hemans; Patricia Ann Benitez,23,0,45,22
1746545187778,EDS 281,A00,895701,Meyerott; Theresa Ann,1,0,15,14
1746545188804,EDS 284,A00,895736,Meyerott; Theresa Ann,1,0,15,14
1746545189829,EDS 286,A00,897210,Fine; Sarah,0,0,15,15
1746545190857,EDS 289C,A01,895770,Daly; Alan J.,15,0,15,0
1746545191882,EDS 290,A00,897211,Hofstetter; Carolyn,0,0,15,15
1746545192908,LIGM 5A,A00,896162,Fischer-Grunski; Eva K,13,0,20,7
1746545193935,LIGM 5B,A00,896260,Fischer-Grunski; Eva K,17,0,20,3
1746545194961,LIGM 5C,A00,896308,Fischer-Grunski; Eva K,18,0,20,2
1746545195989,LIIT 5AS,A00,896313,Carnelos; Chiara,18,0,20,2
1746545197020,LIIT 5BS,A00,896416,Carnelos; Chiara,20,0,20,0
1746545198046,LIIT 5CS,A00,896564,Carnelos; Chiara,20,0,20,0
1746545199071,LISP 5A,A00,896588,Munoz Sanchez; Alicia,3,0,20,17
1746545200098,LISP 5B,A00,896653,Munoz Sanchez; Alicia,7,0,20,13
1746545201123,LISP 5C,A00,896655,Munoz Sanchez; Alicia,0,1,20,20
1746545202147,MAE 197,001,957918,Kleissl; Jan,9996,0,9999,3
1746545202147,MAE 197,002,959806,Boechler; Nicholas Sebastia,9998,0,9999,1
1746545202147,MAE 197,003,959852,Mullin; Jennifer S,9999,0,9999,0
1746545203173,MATH 2,A01,957937,Staff,33,0,35,2
1746545204198,MATH 197,001,957876,Kedlaya; Kiran S.,9993,0,9999,6
1746545205227,MCWP 40,A00,892729,Duru; Nur,10,0,20,10
1746545205227,MCWP 40,B00,893304,Montejo; Carolina,14,0,20,6
1746545206252,MCWP 40R,A00,893757,Redela; Pamela Morgan,0,5,20,20
1746545207279,MCWP 50,A00,893758,Morshed; Michael James,0,0,20,20
1746545207279,MCWP 50,B00,893761,Bartulis; Jason Michael,17,0,20,3
1746545208309,MCWP 50R,A00,893766,Compas; Sean Matthew,0,1,20,20
1746545208309,MCWP 50R,B00,893769,Carter; Jennifer A,0,1,20,20
1746545208309,MCWP 50R,C00,893771,Krone; Jarret,0,3,20,20
1746545208309,MCWP 50R,D00,893772,Miller; Elizabeth Deen,0,0,20,20
1746545208309,MCWP 50R,E00,893775,Carter; Andrea L,0,1,20,20
1746545209335,MMW 11R,A01,892721,Herbst; Matthew,11,0,27,16
1746545209335,MMW 11R,A02,892722,Herbst; Matthew,0,0,0,3
1746545210364,MMW 12R,A01,892724,Herbst; Matthew,0,11,16,16
1746545210364,MMW 12R,A02,892725,Herbst; Matthew,0,10,16,16
1746545211389,MMW 13R,A01,892727,Staff,0,4,16,16
1746545211389,MMW 13R,A02,892728,Staff,0,4,16,16
1746545211389,MMW 13R,A03,958032,Staff,0,4,16,16
1746545211389,MMW 13R,A04,958033,Staff,0,4,16,16
1746545211389,MMW 13R,A05,958034,Staff,0,4,16,16
1746545212419,SIO 295LS,A00,894015,Staff,5,0,25,20
1746545213445,SIO 295S,A00,894020,Staff,5,0,25,20
1746545214473,SIOC 290S,B01,958918,Merrifield; Mark A,14,0,30,16
1746545215498,SIOC 291S,B01,958922,Gabriel; Corey John,14,0,30,16
1746545216525,SOCI 117,A01,895339,Staff,3,0,5,2
1746545217555,WES 237B,A00,894149,Staff,11,0,20,9
1746545219613,AESE 279B,A00,891859,Staff,13,0,35,22
1746545220639,AIP 197,001,891854,Vespa; Emanuel Ignacio,9999,0,9999,0
1746545221666,ANTH 289S,A00,891856,Gagneux; Pascal,12,0,12,0
1746545222694,BENG 196,001,957946,Engler; Adam J.,9996,0,9999,3
1746545223720,BISP 197,001,959851,Wilhelm; James E.,9999,0,9999,0
1746545224746,CAT 124RS,A01,956906,Staff,6,0,25,19
1746545225770,CAT 125RS,A01,922013,Staff,6,0,25,19
1746545226795,CLRE 250,A00,891860,Morris; Sheldon,9995,0,9999,4
1746545228851,CLRE 251R,A00,907817,Mehta; Ravindra L.,9994,0,9999,5
1746545229877,CLRE 252,A00,891864,Cuomo; Raphael Eduardo,9993,0,9999,6
1746545230904,CLRE 253,A00,891867,Vaida; Florin,9994,0,9999,5
1746545230904,CLRE 253,B00,907819,Staff,9999,0,9999,0
1746545231930,CLRE 259,A00,891868,Patel; Hemal,9998,0,9999,1
1746545232957,CLRE 260,A00,891872,Cuomo; Raphael Eduardo,9999,0,9999,0
1746545233983,CLRE 297,001,891888,Cuomo; Raphael Eduardo,9999,0,9999,0
1746545235015,CSE 191,A00,958773,Minnes Kemp; Mor Mia,9996,0,9999,3
1746545236042,CSE 197,001,959846,Minnes Kemp; Mor Mia,9993,0,9999,6
1746545237071,CSS 201S,A01,892054,Mignozzetti; Umberto,26,0,30,4
1746545238098,CSS 202S,A01,892056,Mignozzetti; Umberto,26,0,30,4
1746545239128,DSC 197,001,956898,Eldridge; Justin Matthew,9998,0,9999,1
1746545240158,DSC 297,001,958000,Mazumdar; Arya,9998,0,9999,1
1746545240158,DSC 297,002,959862,Wang; Yusu,9999,0,9999,0
1746545241185,EAP 100,A00,905686,Staff,9778,0,9999,221
1746545242211,ECE 45,A01,892618,Staff,0,0,65,65
1746545244266,ECE 111,A01,892719,Staff,4,0,65,61
1746545245292,ECE 197,001,957920,Mercier; Patrick Philip,9991,0,9999,8
1746545246317,ECON 178,A01,907814,Zhu; Ying,26,0,35,9
1746545247344,EDS 115,A00,895312,Staff,36,0,45,9
1746545248369,EDS 117,A01,895337,Staff,24,0,30,6
1746545249395,EDS 125,A00,895341,Jones; Gabrielle Anastasia,37,0,45,8
1746545250424,EDS 128A,A01,895459,Fargason; Sharon Gayle,44,0,45,1
1746545251449,EDS 128B,A01,895543,Pappas; Elizabeth,44,0,45,1
1746545252475,EDS 139,A00,897203,Pappas; Elizabeth,44,0,45,1
1746545252475,EDS 139,B00,897209,Fargason; Sharon Gayle,41,0,45,4
1746545253500,EDS 201,A00,895545,Staff,23,0,45,22
1746545254526,EDS 203,A01,895581,Halter; Christopher P.,23,0,45,22
1746545255551,EDS 204R,A01,895625,Heinzman; Erica M.,39,0,45,6
1746545255551,EDS 204R,B01,895693,Halter; Christopher P.,10,0,45,35
1746545256583,EDS 206R,A00,895694,Fargason; Sharon Gayle,1,0,30,29
1746545256583,EDS 206R,B00,895695,Choi; Bailey Miyeon,16,0,30,14
1746545257610,EDS 250,A00,895697,Hemans; Patricia Ann Benitez,23,0,45,22
1746545258636,EDS 281,A00,895701,Meyerott; Theresa Ann,1,0,15,14
1746545259661,EDS 284,A00,895736,Meyerott; Theresa Ann,1,0,15,14
1746545260687,EDS 286,A00,897210,Fine; Sarah,0,0,15,15
1746545261717,EDS 289C,A01,895770,Daly; Alan J.,15,0,15,0
1746545262741,EDS 290,A00,897211,Hofstetter; Carolyn,0,0,15,15
1746545263770,LIGM 5A,A00,896162,Fischer-Grunski; Eva K,13,0,20,7
1746545264796,LIGM 5B,A00,896260,Fischer-Grunski; Eva K,17,0,20,3
1746545265822,LIGM 5C,A00,896308,Fischer-Grunski; Eva K,18,0,20,2
1746545266848,LIIT 5AS,A00,896313,Carnelos; Chiara,18,0,20,2
1746545267877,LIIT 5BS,A00,896416,Carnelos; Chiara,20,0,20,0
1746545268906,LIIT 5CS,A00,896564,Carnelos; Chiara,20,0,20,0
1746545269935,LISP 5A,A00,896588,Munoz Sanchez; Alicia,3,0,20,17
1746545270959,LISP 5B,A00,896653,Munoz Sanchez; Alicia,7,0,20,13
1746545271987,LISP 5C,A00,896655,Munoz Sanchez; Alicia,0,1,20,20
1746545273014,MAE 197,001,957918,Kleissl; Jan,9996,0,9999,3
1746545273014,MAE 197,002,959806,Boechler; Nicholas Sebastia,9998,0,9999,1
1746545273014,MAE 197,003,959852,Mullin; Jennifer S,9999,0,9999,0
1746545274040,MATH 2,A01,957937,Staff,33,0,35,2
1746545275067,MATH 197,001,957876,Kedlaya; Kiran S.,9993,0,9999,6
1746545276097,MCWP 40,A00,892729,Duru; Nur,10,0,20,10
1746545276097,MCWP 40,B00,893304,Montejo; Carolina,14,0,20,6
1746545277122,MCWP 40R,A00,893757,Redela; Pamela Morgan,0,5,20,20
1746545278148,MCWP 50,A00,893758,Morshed; Michael James,0,0,20,20
1746545278148,MCWP 50,B00,893761,Bartulis; Jason Michael,17,0,20,3
1746545279177,MCWP 50R,A00,893766,Compas; Sean Matthew,0,1,20,20
1746545279177,MCWP 50R,B00,893769,Carter; Jennifer A,0,1,20,20
1746545279177,MCWP 50R,C00,893771,Krone; Jarret,0,3,20,20
1746545279177,MCWP 50R,D00,893772,Miller; Elizabeth Deen,0,0,20,20
1746545279177,MCWP 50R,E00,893775,Carter; Andrea L,0,1,20,20
1746545280204,MMW 11R,A01,892721,Herbst; Matthew,11,0,27,16
1746545280204,MMW 11R,A02,892722,Herbst; Matthew,0,0,0,3
1746545281232,MMW 12R,A01,892724,Herbst; Matthew,0,11,16,16
1746545281232,MMW 12R,A02,892725,Herbst; Matthew,0,10,16,16
1746545282262,MMW 13R,A01,892727,Staff,0,4,16,16
1746545282262,MMW 13R,A02,892728,Staff,0,4,16,16
1746545282262,MMW 13R,A03,958032,Staff,0,4,16,16
1746545282262,MMW 13R,A04,958033,Staff,0,4,16,16
1746545282262,MMW 13R,A05,958034,Staff,0,4,16,16
1746545283293,SIO 295LS,A00,894015,Staff,5,0,25,20
1746545284317,SIO 295S,A00,894020,Staff,5,0,25,20
1746545285348,SIOC 290S,B01,958918,Merrifield; Mark A,14,0,30,16
1746545286379,SIOC 291S,B01,958922,Gabriel; Corey John,14,0,30,16
1746545287404,SOCI 117,A01,895339,Staff,3,0,5,2
1746545288429,WES 237B,A00,894149,Staff,11,0,20,9
1746545290487,AESE 279B,A00,891859,Staff,13,0,35,22
1746545291539,AIP 197,001,891854,Vespa; Emanuel Ignacio,9999,0,9999,0
1746545292563,ANTH 289S,A00,891856,Gagneux; Pascal,12,0,12,0
1746545293590,BENG 196,001,957946,Engler; Adam J.,9996,0,9999,3
1746545294618,BISP 197,001,959851,Wilhelm; James E.,9999,0,9999,0
1746545295644,CAT 124RS,A01,956906,Staff,6,0,25,19
1746545296671,CAT 125RS,A01,922013,Staff,6,0,25,19
1746545297700,CLRE 250,A00,891860,Morris; Sheldon,9995,0,9999,4
1746545299757,CLRE 251R,A00,907817,Mehta; Ravindra L.,9994,0,9999,5
1746545300782,CLRE 252,A00,891864,Cuomo; Raphael Eduardo,9993,0,9999,6
1746545301810,CLRE 253,A00,891867,Vaida; Florin,9994,0,9999,5
1746545301810,CLRE 253,B00,907819,Staff,9999,0,9999,0
1746545302839,CLRE 259,A00,891868,Patel; Hemal,9998,0,9999,1
1746545303864,CLRE 260,A00,891872,Cuomo; Raphael Eduardo,9999,0,9999,0
1746545304890,CLRE 297,001,891888,Cuomo; Raphael Eduardo,9999,0,9999,0
1746545305914,CSE 191,A00,958773,Minnes Kemp; Mor Mia,9996,0,9999,3
1746545306939,CSE 197,001,959846,Minnes Kemp; Mor Mia,9993,0,9999,6
1746545307965,CSS 201S,A01,892054,Mignozzetti; Umberto,26,0,30,4
1746545308993,CSS 202S,A01,892056,Mignozzetti; Umberto,26,0,30,4
1746545310022,DSC 197,001,956898,Eldridge; Justin Matthew,9998,0,9999,1
1746545311050,DSC 297,001,958000,Mazumdar; Arya,9998,0,9999,1
1746545311050,DSC 297,002,959862,Wang; Yusu,9999,0,9999,0
1746545312077,EAP 100,A00,905686,Staff,9778,0,9999,221
1746545313104,ECE 45,A01,892618,Staff,0,0,65,65
1746545315155,ECE 111,A01,892719,Staff,4,0,65,61
1746545316182,ECE 197,001,957920,Mercier; Patrick Philip,9991,0,9999,8
1746545317206,ECON 178,A01,907814,Zhu; Ying,26,0,35,9
1746545318231,EDS 115,A00,895312,Staff,36,0,45,9
1746545319257,EDS 117,A01,895337,Staff,24,0,30,6
1746545320281,EDS 125,A00,895341,Jones; Gabrielle Anastasia,37,0,45,8
1746545321308,EDS 128A,A01,895459,Fargason; Sharon Gayle,44,0,45,1
1746545322334,EDS 128B,A01,895543,Pappas; Elizabeth,44,0,45,1
1746545323361,EDS 139,A00,897203,Pappas; Elizabeth,44,0,45,1
1746545323361,EDS 139,B00,897209,Fargason; Sharon Gayle,41,0,45,4
1746545324387,EDS 201,A00,895545,Staff,23,0,45,22
1746545325413,EDS 203,A01,895581,Halter; Christopher P.,23,0,45,22
1746545326440,EDS 204R,A01,895625,Heinzman; Erica M.,39,0,45,6
1746545326440,EDS 204R,B01,895693,Halter; Christopher P.,10,0,45,35
1746545327467,EDS 206R,A00,895694,Fargason; Sharon Gayle,1,0,30,29
1746545327467,EDS 206R,B00,895695,Choi; Bailey Miyeon,16,0,30,14
1746545328494,EDS 250,A00,895697,Hemans; Patricia Ann Benitez,23,0,45,22
1746545329521,EDS 281,A00,895701,Meyerott; Theresa Ann,1,0,15,14
1746545330546,EDS 284,A00,895736,Meyerott; Theresa Ann,1,0,15,14
1746545331571,EDS 286,A00,897210,Fine; Sarah,0,0,15,15
1746545332597,EDS 289C,A01,895770,Daly; Alan J.,15,0,15,0
1746545333623,EDS 290,A00,897211,Hofstetter; Carolyn,0,0,15,15
1746545334652,LIGM 5A,A00,896162,Fischer-Grunski; Eva K,13,0,20,7
1746545335679,LIGM 5B,A00,896260,Fischer-Grunski; Eva K,17,0,20,3
1746545336706,LIGM 5C,A00,896308,Fischer-Grunski; Eva K,18,0,20,2
1746545337731,LIIT 5AS,A00,896313,Carnelos; Chiara,18,0,20,2
1746545338759,LIIT 5BS,A00,896416,Carnelos; Chiara,20,0,20,0
1746545339797,LIIT 5CS,A00,896564,Carnelos; Chiara,20,0,20,0
1746545340827,LISP 5A,A00,896588,Munoz Sanchez; Alicia,3,0,20,17
1746545341857,LISP 5B,A00,896653,Munoz Sanchez; Alicia,7,0,20,13
1746545342882,LISP 5C,A00,896655,Munoz Sanchez; Alicia,0,1,20,20
1746545343911,MAE 197,001,957918,Kleissl; Jan,9996,0,9999,3
1746545343911,MAE 197,002,959806,Boechler; Nicholas Sebastia,9998,0,9999,1
1746545343911,MAE 197,003,959852,Mullin; Jennifer S,9999,0,9999,0
1746545344938,MATH 2,A01,957937,Staff,33,0,35,2
1746545345966,MATH 197,001,957876,Kedlaya; Kiran S.,9993,0,9999,6
1746545346993,MCWP 40,A00,892729,Duru; Nur,10,0,20,10
1746545346993,MCWP 40,B00,893304,Montejo; Carolina,14,0,20,6
1746545348017,MCWP 40R,A00,893757,Redela; Pamela Morgan,0,5,20,20
1746545349043,MCWP 50,A00,893758,Morshed; Michael James,0,0,20,20
1746545349043,MCWP 50,B00,893761,Bartulis; Jason Michael,17,0,20,3
1746545350070,MCWP 50R,A00,893766,Compas; Sean Matthew,0,1,20,20
1746545350070,MCWP 50R,B00,893769,Carter; Jennifer A,0,1,20,20
1746545350070,MCWP 50R,C00,893771,Krone; Jarret,0,3,20,20
1746545350070,MCWP 50R,D00,893772,Miller; Elizabeth Deen,0,0,20,20
1746545350070,MCWP 50R,E00,893775,Carter; Andrea L,0,1,20,20
1746545351096,MMW 11R,A01,892721,Herbst; Matthew,11,0,27,16
1746545351096,MMW 11R,A02,892722,Herbst; Matthew,0,0,0,3
1746545352123,MMW 12R,A01,892724,Herbst; Matthew,0,11,16,16
1746545352123,MMW 12R,A02,892725,Herbst; Matthew,0,10,16,16
1746545353151,MMW 13R,A01,892727,Staff,0,4,16,16
1746545353151,MMW 13R,A02,892728,Staff,0,4,16,16
1746545353151,MMW 13R,A03,958032,Staff,0,4,16,16
1746545353151,MMW 13R,A04,958033,Staff,0,4,16,16
1746545353151,MMW 13R,A05,958034,Staff,0,4,16,16
1746545354177,SIO 295LS,A00,894015,Staff,5,0,25,20
1746545355201,SIO 295S,A00,894020,Staff,5,0,25,20
1746545356227,SIOC 290S,B01,958918,Merrifield; Mark A,14,0,30,16
1746545357260,SIOC 291S,B01,958922,Gabriel; Corey John,14,0,30,16
1746545358286,SOCI 117,A01,895339,Staff,3,0,5,2
1746545359312,WES 237B,A00,894149,Staff,11,0,20,9
1746545361376,AESE 279B,A00,891859,Staff,13,0,35,22
1746545362405,AIP 197,001,891854,Vespa; Emanuel Ignacio,9999,0,9999,0
1746545363432,ANTH 289S,A00,891856,Gagneux; Pascal,12,0,12,0
1746545364458,BENG 196,001,957946,Engler; Adam J.,9996,0,9999,3
1746545365486,BISP 197,001,959851,Wilhelm; James E.,9999,0,9999,0
1746545366514,CAT 124RS,A01,956906,Staff,6,0,25,19
1746545367540,CAT 125RS,A01,922013,Staff,6,0,25,19
1746545368567,CLRE 250,A00,891860,Morris; Sheldon,9995,0,9999,4
1746545370617,CLRE 251R,A00,907817,Mehta; Ravindra L.,9994,0,9999,5
1746545371645,CLRE 252,A00,891864,Cuomo; Raphael Eduardo,9993,0,9999,6
1746545372670,CLRE 253,A00,891867,Vaida; Florin,9994,0,9999,5
1746545372670,CLRE 253,B00,907819,Staff,9999,0,9999,0
1746545373698,CLRE 259,A00,891868,Patel; Hemal,9998,0,9999,1
1746545374726,CLRE 260,A00,891872,Cuomo; Raphael Eduardo,9999,0,9999,0
1746545375753,CLRE 297,001,891888,Cuomo; Raphael Eduardo,9999,0,9999,0
1746545376782,CSE 191,A00,958773,Minnes Kemp; Mor Mia,9996,0,9999,3
1746545377811,CSE 197,001,959846,Minnes Kemp; Mor Mia,9993,0,9999,6
1746545378836,CSS 201S,A01,892054,Mignozzetti; Umberto,26,0,30,4
1746545379863,CSS 202S,A01,892056,Mignozzetti; Umberto,26,0,30,4
1746545380888,DSC 197,001,956898,Eldridge; Justin Matthew,9998,0,9999,1
1746545381914,DSC 297,001,958000,Mazumdar; Arya,9998,0,9999,1
1746545381914,DSC 297,002,959862,Wang; Yusu,9999,0,9999,0
1746545382939,EAP 100,A00,905686,Staff,9778,0,9999,221
1746545383965,ECE 45,A01,892618,Staff,0,0,65,65
1746545386026,ECE 111,A01,892719,Staff,4,0,65,61
1746545387051,ECE 197,001,957920,Mercier; Patrick Philip,9991,0,9999,8
1746545388083,ECON 178,A01,907814,Zhu; Ying,26,0,35,9
1746545389109,EDS 115,A00,895312,Staff,36,0,45,9
1746545390135,EDS 117,A01,895337,Staff,24,0,30,6
1746545391161,EDS 125,A00,895341,Jones; Gabrielle Anastasia,37,0,45,8
1746545392186,EDS 128A,A01,895459,Fargason; Sharon Gayle,44,0,45,1
1746545393212,EDS 128B,A01,895543,Pappas; Elizabeth,44,0,45,1
1746545394239,EDS 139,A00,897203,Pappas; Elizabeth,44,0,45,1
1746545394239,EDS 139,B00,897209,Fargason; Sharon Gayle,41,0,45,4
1746545395265,EDS 201,A00,895545,Staff,23,0,45,22
1746545396291,EDS 203,A01,895581,Halter; Christopher P.,23,0,45,22
1746545397319,EDS 204R,A01,895625,Heinzman; Erica M.,39,0,45,6
1746545397319,EDS 204R,B01,895693,Halter; Christopher P.,10,0,45,35
1746545398348,EDS 206R,A00,895694,Fargason; Sharon Gayle,1,0,30,29
1746545398348,EDS 206R,B00,895695,Choi; Bailey Miyeon,16,0,30,14
1746545399374,EDS 250,A00,895697,Hemans; Patricia Ann Benitez,23,0,45,22
1746545400401,EDS 281,A00,895701,Meyerott; Theresa Ann,1,0,15,14
1746545401426,EDS 284,A00,895736,Meyerott; Theresa Ann,1,0,15,14
1746545402454,EDS 286,A00,897210,Fine; Sarah,0,0,15,15
1746545403479,EDS 289C,A01,895770,Daly; Alan J.,15,0,15,0
1746545404507,EDS 290,A00,897211,Hofstetter; Carolyn,0,0,15,15
1746545405533,LIGM 5A,A00,896162,Fischer-Grunski; Eva K,13,0,20,7
1746545406562,LIGM 5B,A00,896260,Fischer-Grunski; Eva K,17,0,20,3
1746545407592,LIGM 5C,A00,896308,Fischer-Grunski; Eva K,18,0,20,2
1746545408619,LIIT 5AS,A00,896313,Carnelos; Chiara,18,0,20,2
1746545409649,LIIT 5BS,A00,896416,Carnelos; Chiara,20,0,20,0
1746545410674,LIIT 5CS,A00,896564,Carnelos; Chiara,20,0,20,0
1746545411700,LISP 5A,A00,896588,Munoz Sanchez; Alicia,3,0,20,17
1746545412726,LISP 5B,A00,896653,Munoz Sanchez; Alicia,7,0,20,13
1746545413753,LISP 5C,A00,896655,Munoz Sanchez; Alicia,0,1,20,20
1746545414779,MAE 197,001,957918,Kleissl; Jan,9996,0,9999,3
1746545414779,MAE 197,002,959806,Boechler; Nicholas Sebastia,9998,0,9999,1
1746545414779,MAE 197,003,959852,Mullin; Jennifer S,9999,0,9999,0
1746545415809,MATH 2,A01,957937,Staff,33,0,35,2
1746545416834,MATH 197,001,957876,Kedlaya; Kiran S.,9993,0,9999,6
1746545417863,MCWP 40,A00,892729,Duru; Nur,10,0,20,10
1746545417863,MCWP 40,B00,893304,Montejo; Carolina,14,0,20,6
1746545418891,MCWP 40R,A00,893757,Redela; Pamela Morgan,0,5,20,20
1746545419921,MCWP 50,A00,893758,Morshed; Michael James,0,0,20,20
1746545419921,MCWP 50,B00,893761,Bartulis; Jason Michael,17,0,20,3
1746545420950,MCWP 50R,A00,893766,Compas; Sean Matthew,0,1,20,20
1746545420950,MCWP 50R,B00,893769,Carter; Jennifer A,0,1,20,20
1746545420950,MCWP 50R,C00,893771,Krone; Jarret,0,3,20,20
1746545420950,MCWP 50R,D00,893772,Miller; Elizabeth Deen,0,0,20,20
1746545420950,MCWP 50R,E00,893775,Carter; Andrea L,0,1,20,20
1746545421974,MMW 11R,A01,892721,Herbst; Matthew,11,0,27,16
1746545421974,MMW 11R,A02,892722,Herbst; Matthew,0,0,0,3
1746545422998,MMW 12R,A01,892724,Herbst; Matthew,0,11,16,16
1746545422998,MMW 12R,A02,892725,Herbst; Matthew,0,10,16,16
1746545424027,MMW 13R,A01,892727,Staff,0,4,16,16
1746545424027,MMW 13R,A02,892728,Staff,0,4,16,16
1746545424027,MMW 13R,A03,958032,Staff,0,4,16,16
1746545424027,MMW 13R,A04,958033,Staff,0,4,16,16
1746545424027,MMW 13R,A05,958034,Staff,0,4,16,16
1746545425082,SIO 295LS,A00,894015,Staff,5,0,25,20
1746545426112,SIO 295S,A00,894020,Staff,5,0,25,20
1746545427138,SIOC 290S,B01,958918,Merrifield; Mark A,14,0,30,16
1746545428169,SIOC 291S,B01,958922,Gabriel; Corey John,14,0,30,16
1746545429197,SOCI 117,A01,895339,Staff,3,0,5,2
1746545430224,WES 237B,A00,894149,Staff,11,0,20,9
1746545432292,AESE 279B,A00,891859,Staff,13,0,35,22
1746545433316,AIP 197,001,891854,Vespa; Emanuel Ignacio,9999,0,9999,0
1746545434342,ANTH 289S,A00,891856,Gagneux; Pascal,12,0,12,0
1746545435370,BENG 196,001,957946,Engler; Adam J.,9996,0,9999,3
1746545436399,BISP 197,001,959851,Wilhelm; James E.,9998,0,9999,1
1746545437425,CAT 124RS,A01,956906,Staff,6,0,25,19
1746545438451,CAT 125RS,A01,922013,Staff,6,0,25,19
1746545439479,CLRE 250,A00,891860,Morris; Sheldon,9995,0,9999,4
1746545441530,CLRE 251R,A00,907817,Mehta; Ravindra L.,9994,0,9999,5
1746545442558,CLRE 252,A00,891864,Cuomo; Raphael Eduardo,9993,0,9999,6
1746545443586,CLRE 253,A00,891867,Vaida; Florin,9994,0,9999,5
1746545443586,CLRE 253,B00,907819,Staff,9999,0,9999,0
1746545444612,CLRE 259,A00,891868,Patel; Hemal,9998,0,9999,1
1746545445638,CLRE 260,A00,891872,Cuomo; Raphael Eduardo,9999,0,9999,0
1746545446664,CLRE 297,001,891888,Cuomo; Raphael Eduardo,9999,0,9999,0
1746545447694,CSE 191,A00,958773,Minnes Kemp; Mor Mia,9996,0,9999,3
1746545448721,CSE 197,001,959846,Minnes Kemp; Mor Mia,9993,0,9999,6
1746545449753,CSS 201S,A01,892054,Mignozzetti; Umberto,26,0,30,4
1746545450781,CSS 202S,A01,892056,Mignozzetti; Umberto,26,0,30,4
1746545451805,DSC 197,001,956898,Eldridge; Justin Matthew,9998,0,9999,1
1746545452833,DSC 297,001,958000,Mazumdar; Arya,9998,0,9999,1
1746545452833,DSC 297,002,959862,Wang; Yusu,9999,0,9999,0
1746545453860,EAP 100,A00,905686,Staff,9778,0,9999,221
1746545454888,ECE 45,A01,892618,Staff,0,0,65,65
1746545456943,ECE 111,A01,892719,Staff,4,0,65,61
1746545457972,ECE 197,001,957920,Mercier; Patrick Philip,9991,0,9999,8
1746545459001,ECON 178,A01,907814,Zhu; Ying,26,0,35,9
1746545460028,EDS 115,A00,895312,Staff,36,0,45,9
1746545461055,EDS 117,A01,895337,Staff,24,0,30,6
1746545462084,EDS 125,A00,895341,Jones; Gabrielle Anastasia,37,0,45,8
1746545463111,EDS 128A,A01,895459,Fargason; Sharon Gayle,44,0,45,1
1746545464137,EDS 128B,A01,895543,Pappas; Elizabeth,44,0,45,1
1746545465167,EDS 139,A00,897203,Pappas; Elizabeth,44,0,45,1
1746545465167,EDS 139,B00,897209,Fargason; Sharon Gayle,41,0,45,4
1746545466195,EDS 201,A00,895545,Staff,23,0,45,22
1746545467221,EDS 203,A01,895581,Halter; Christopher P.,23,0,45,22
1746545468248,EDS 204R,A01,895625,Heinzman; Erica M.,39,0,45,6
1746545468248,EDS 204R,B01,895693,Halter; Christopher P.,10,0,45,35
1746545469278,EDS 206R,A00,895694,Fargason; Sharon Gayle,1,0,30,29
1746545469278,EDS 206R,B00,895695,Choi; Bailey Miyeon,16,0,30,14
1746545470306,EDS 250,A00,895697,Hemans; Patricia Ann Benitez,23,0,45,22
1746545471335,EDS 281,A00,895701,Meyerott; Theresa Ann,1,0,15,14
1746545472364,EDS 284,A00,895736,Meyerott; Theresa Ann,1,0,15,14
1746545473389,EDS 286,A00,897210,Fine; Sarah,0,0,15,15
1746545474421,EDS 289C,A01,895770,Daly; Alan J.,15,0,15,0
1746545475448,EDS 290,A00,897211,Hofstetter; Carolyn,0,0,15,15
1746545476474,LIGM 5A,A00,896162,Fischer-Grunski; Eva K,13,0,20,7
1746545477500,LIGM 5B,A00,896260,Fischer-Grunski; Eva K,17,0,20,3
1746545478529,LIGM 5C,A00,896308,Fischer-Grunski; Eva K,18,0,20,2
1746545479556,LIIT 5AS,A00,896313,Carnelos; Chiara,18,0,20,2
1746545480586,LIIT 5BS,A00,896416,Carnelos; Chiara,20,0,20,0
1746545481612,LIIT 5CS,A00,896564,Carnelos; Chiara,20,0,20,0
1746545482639,LISP 5A,A00,896588,Munoz Sanchez; Alicia,3,0,20,17
1746545483667,LISP 5B,A00,896653,Munoz Sanchez; Alicia,7,0,20,13
1746545484694,LISP 5C,A00,896655,Munoz Sanchez; Alicia,0,1,20,20
1746545485722,MAE 197,001,957918,Kleissl; Jan,9996,0,9999,3
1746545485722,MAE 197,002,959806,Boechler; Nicholas Sebastia,9998,0,9999,1
1746545485722,MAE 197,003,959852,Mullin; Jennifer S,9999,0,9999,0
1746545486752,MATH 2,A01,957937,Staff,33,0,35,2
1746545487779,MATH 197,001,957876,Kedlaya; Kiran S.,9993,0,9999,6
1746545488809,MCWP 40,A00,892729,Duru; Nur,10,0,20,10
1746545488809,MCWP 40,B00,893304,Montejo; Carolina,14,0,20,6
1746545489836,MCWP 40R,A00,893757,Redela; Pamela Morgan,0,5,20,20
1746545490863,MCWP 50,A00,893758,Morshed; Michael James,0,0,20,20
1746545490863,MCWP 50,B00,893761,Bartulis; Jason Michael,17,0,20,3
1746545491892,MCWP 50R,A00,893766,Compas; Sean Matthew,0,1,20,20
1746545491892,MCWP 50R,B00,893769,Carter; Jennifer A,0,1,20,20
1746545491892,MCWP 50R,C00,893771,Krone; Jarret,0,3,20,20
1746545491892,MCWP 50R,D00,893772,Miller; Elizabeth Deen,0,0,20,20
1746545491892,MCWP 50R,E00,893775,Carter; Andrea L,0,1,20,20
1746545492920,MMW 11R,A01,892721,Herbst; Matthew,11,0,27,16
1746545492920,MMW 11R,A02,892722,Herbst; Matthew,0,0,0,3
1746545493948,MMW 12R,A01,892724,Herbst; Matthew,0,11,16,16
1746545493948,MMW 12R,A02,892725,Herbst; Matthew,0,10,16,16
1746545494981,MMW 13R,A01,892727,Staff,0,4,16,16
1746545494981,MMW 13R,A02,892728,Staff,0,4,16,16
1746545494981,MMW 13R,A03,958032,Staff,0,4,16,16
1746545494981,MMW 13R,A04,958033,Staff,0,4,16,16
1746545494981,MMW 13R,A05,958034,Staff,0,4,16,16
1746545496009,SIO 295LS,A00,894015,Staff,5,0,25,20
1746545497038,SIO 295S,A00,894020,Staff,5,0,25,20
1746545498064,SIOC 290S,B01,958918,Merrifield; Mark A,14,0,30,16
1746545499099,SIOC 291S,B01,958922,Gabriel; Corey John,14,0,30,16
1746545500123,SOCI 117,A01,895339,Staff,3,0,5,2
1746545501148,WES 237B,A00,894149,Staff,11,0,20,9
1746545503249,AESE 279B,A00,891859,Staff,13,0,35,22
1746545504275,AIP 197,001,891854,Vespa; Emanuel Ignacio,9999,0,9999,0
1746545505307,ANTH 289S,A00,891856,Gagneux; Pascal,12,0,12,0
1746545506332,BENG 196,001,957946,Engler; Adam J.,9996,0,9999,3
1746545507362,BISP 197,001,959851,Wilhelm; James E.,9998,0,9999,1
1746545508391,CAT 124RS,A01,956906,Staff,6,0,25,19
1746545509420,CAT 125RS,A01,922013,Staff,6,0,25,19
1746545510451,CLRE 250,A00,891860,Morris; Sheldon,9995,0,9999,4
1746545512510,CLRE 251R,A00,907817,Mehta; Ravindra L.,9994,0,9999,5
1746545513542,CLRE 252,A00,891864,Cuomo; Raphael Eduardo,9993,0,9999,6
1746545514573,CLRE 253,A00,891867,Vaida; Florin,9994,0,9999,5
1746545514573,CLRE 253,B00,907819,Staff,9999,0,9999,0
1746545515653,CLRE 259,A00,891868,Patel; Hemal,9998,0,9999,1
1746545516680,CLRE 260,A00,891872,Cuomo; Raphael Eduardo,9999,0,9999,0
1746545517705,CLRE 297,001,891888,Cuomo; Raphael Eduardo,9999,0,9999,0
1746545518736,CSE 191,A00,958773,Minnes Kemp; Mor Mia,9996,0,9999,3
1746545519761,CSE 197,001,959846,Minnes Kemp; Mor Mia,9992,0,9999,7
1746545520792,CSS 201S,A01,892054,Mignozzetti; Umberto,26,0,30,4
1746545521822,CSS 202S,A01,892056,Mignozzetti; Umberto,26,0,30,4
1746545522855,DSC 197,001,956898,Eldridge; Justin Matthew,9998,0,9999,1
1746545523884,DSC 297,001,958000,Mazumdar; Arya,9998,0,9999,1
1746545523884,DSC 297,002,959862,Wang; Yusu,9999,0,9999,0
1746545524909,EAP 100,A00,905686,Staff,9778,0,9999,221
1746545525935,ECE 45,A01,892618,Staff,0,0,65,65
1746545527993,ECE 111,A01,892719,Staff,4,0,65,61
1746545529020,ECE 197,001,957920,Mercier; Patrick Philip,9991,0,9999,8
1746545530048,ECON 178,A01,907814,Zhu; Ying,26,0,35,9
1746545531073,EDS 115,A00,895312,Staff,36,0,45,9
1746545532099,EDS 117,A01,895337,Staff,24,0,30,6
1746545533125,EDS 125,A00,895341,Jones; Gabrielle Anastasia,37,0,45,8
1746545534152,EDS 128A,A01,895459,Fargason; Sharon Gayle,44,0,45,1
1746545535181,EDS 128B,A01,895543,Pappas; Elizabeth,44,0,45,1
1746545536209,EDS 139,A00,897203,Pappas; Elizabeth,44,0,45,1
1746545536209,EDS 139,B00,897209,Fargason; Sharon Gayle,41,0,45,4
1746545537233,EDS 201,A00,895545,Staff,23,0,45,22
1746545538263,EDS 203,A01,895581,Halter; Christopher P.,23,0,45,22
1746545539294,EDS 204R,A01,895625,Heinzman; Erica M.,39,0,45,6
1746545539294,EDS 204R,B01,895693,Halter; Christopher P.,10,0,45,35
1746545540324,EDS 206R,A00,895694,Fargason; Sharon Gayle,1,0,30,29
1746545540324,EDS 206R,B00,895695,Choi; Bailey Miyeon,16,0,30,14
1746545541355,EDS 250,A00,895697,Hemans; Patricia Ann Benitez,23,0,45,22
1746545542381,EDS 281,A00,895701,Meyerott; Theresa Ann,1,0,15,14
1746545543410,EDS 284,A00,895736,Meyerott; Theresa Ann,1,0,15,14
1746545544436,EDS 286,A00,897210,Fine; Sarah,0,0,15,15
1746545545463,EDS 289C,A01,895770,Daly; Alan J.,15,0,15,0
1746545546493,EDS 290,A00,897211,Hofstetter; Carolyn,0,0,15,15
1746545547521,LIGM 5A,A00,896162,Fischer-Grunski; Eva K,13,0,20,7
1746545548548,LIGM 5B,A00,896260,Fischer-Grunski; Eva K,17,0,20,3
1746545549577,LIGM 5C,A00,896308,Fischer-Grunski; Eva K,18,0,20,2
1746545550608,LIIT 5AS,A00,896313,Carnelos; Chiara,18,0,20,2
1746545551635,LIIT 5BS,A00,896416,Carnelos; Chiara,20,0,20,0
1746545552666,LIIT 5CS,A00,896564,Carnelos; Chiara,20,0,20,0
1746545553692,LISP 5A,A00,896588,Munoz Sanchez; Alicia,3,0,20,17
1746545554722,LISP 5B,A00,896653,Munoz Sanchez; Alicia,7,0,20,13
1746545555752,LISP 5C,A00,896655,Munoz Sanchez; Alicia,0,1,20,20
1746545556777,MAE 197,001,957918,Kleissl; Jan,9996,0,9999,3
1746545556777,MAE 197,002,959806,Boechler; Nicholas Sebastia,9998,0,9999,1
1746545556777,MAE 197,003,959852,Mullin; Jennifer S,9999,0,9999,0
1746545557804,MATH 2,A01,957937,Staff,33,0,35,2
1746545558834,MATH 197,001,957876,Kedlaya; Kiran S.,9993,0,9999,6
1746545559861,MCWP 40,A00,892729,Duru; Nur,10,0,20,10
1746545559861,MCWP 40,B00,893304,Montejo; Carolina,14,0,20,6
1746545560890,MCWP 40R,A00,893757,Redela; Pamela Morgan,0,5,20,20
1746545561921,MCWP 50,A00,893758,Morshed; Michael James,0,0,20,20
1746545561921,MCWP 50,B00,893761,Bartulis; Jason Michael,17,0,20,3
1746545562949,MCWP 50R,A00,893766,Compas; Sean Matthew,0,1,20,20
1746545562949,MCWP 50R,B00,893769,Carter; Jennifer A,0,1,20,20
1746545562949,MCWP 50R,C00,893771,Krone; Jarret,0,3,20,20
1746545562949,MCWP 50R,D00,893772,Miller; Elizabeth Deen,0,0,20,20
1746545562949,MCWP 50R,E00,893775,Carter; Andrea L,0,1,20,20
1746545563975,MMW 11R,A01,892721,Herbst; Matthew,11,0,27,16
1746545563975,MMW 11R,A02,892722,Herbst; Matthew,0,0,0,3
1746545565031,MMW 12R,A01,892724,Herbst; Matthew,0,11,16,16
1746545565031,MMW 12R,A02,892725,Herbst; Matthew,0,10,16,16
1746545566060,MMW 13R,A01,892727,Staff,0,4,16,16
1746545566060,MMW 13R,A02,892728,Staff,0,4,16,16
1746545566060,MMW 13R,A03,958032,Staff,0,4,16,16
1746545566060,MMW 13R,A04,958033,Staff,0,4,16,16
1746545566060,MMW 13R,A05,958034,Staff,0,4,16,16
1746545567088,SIO 295LS,A00,894015,Staff,5,0,25,20
1746545568115,SIO 295S,A00,894020,Staff,5,0,25,20
1746545569143,SIOC 290S,B01,958918,Merrifield; Mark A,14,0,30,16
1746545570172,SIOC 291S,B01,958922,Gabriel; Corey John,14,0,30,16
1746545571198,SOCI 117,A01,895339,Staff,3,0,5,2
1746545572225,WES 237B,A00,894149,Staff,11,0,20,9
1746545574301,AESE 279B,A00,891859,Staff,13,0,35,22
1746545575341,AIP 197,001,891854,Vespa; Emanuel Ignacio,9999,0,9999,0
1746545576369,ANTH 289S,A00,891856,Gagneux; Pascal,12,0,12,0
1746545577397,BENG 196,001,957946,Engler; Adam J.,9996,0,9999,3
1746545578422,BISP 197,001,959851,Wilhelm; James E.,9998,0,9999,1
1746545579447,CAT 124RS,A01,956906,Staff,6,0,25,19
1746545580473,CAT 125RS,A01,922013,Staff,6,0,25,19
1746545581504,CLRE 250,A00,891860,Morris; Sheldon,9995,0,9999,4
1746545583554,CLRE 251R,A00,907817,Mehta; Ravindra L.,9994,0,9999,5
1746545584587,CLRE 252,A00,891864,Cuomo; Raphael Eduardo,9993,0,9999,6
1746545585612,CLRE 253,A00,891867,Vaida; Florin,9994,0,9999,5
1746545585612,CLRE 253,B00,907819,Staff,9999,0,9999,0
1746545586637,CLRE 259,A00,891868,Patel; Hemal,9998,0,9999,1
1746545587665,CLRE 260,A00,891872,Cuomo; Raphael Eduardo,9999,0,9999,0
1746545588692,CLRE 297,001,891888,Cuomo; Raphael Eduardo,9999,0,9999,0
1746545589718,CSE 191,A00,958773,Minnes Kemp; Mor Mia,9996,0,9999,3
1746545590747,CSE 197,001,959846,Minnes Kemp; Mor Mia,9992,0,9999,7
1746545591785,CSS 201S,A01,892054,Mignozzetti; Umberto,26,0,30,4
1746545592812,CSS 202S,A01,892056,Mignozzetti; Umberto,26,0,30,4
1746545593838,DSC 197,001,956898,Eldridge; Justin Matthew,9998,0,9999,1
1746545594864,DSC 297,001,958000,Mazumdar; Arya,9998,0,9999,1
1746545594864,DSC 297,002,959862,Wang; Yusu,9999,0,9999,0
1746545595893,EAP 100,A00,905686,Staff,9778,0,9999,221
1746545596924,ECE 45,A01,892618,Staff,0,0,65,65
1746545598979,ECE 111,A01,892719,Staff,4,0,65,61
1746545600007,ECE 197,001,957920,Mercier; Patrick Philip,9991,0,9999,8
1746545601033,ECON 178,A01,907814,Zhu; Ying,26,0,35,9
1746545602058,EDS 115,A00,895312,Staff,36,0,45,9
1746545603083,EDS 117,A01,895337,Staff,24,0,30,6
1746545604108,EDS 125,A00,895341,Jones; Gabrielle Anastasia,37,0,45,8
1746545605138,EDS 128A,A01,895459,Fargason; Sharon Gayle,44,0,45,1
1746545606166,EDS 128B,A01,895543,Pappas; Elizabeth,44,0,45,1
1746545607193,EDS 139,A00,897203,Pappas; Elizabeth,44,0,45,1
1746545607193,EDS 139,B00,897209,Fargason; Sharon Gayle,41,0,45,4
1746545608220,EDS 201,A00,895545,Staff,23,0,45,22
1746545609245,EDS 203,A01,895581,Halter; Christopher P.,23,0,45,22
1746545610276,EDS 204R,A01,895625,Heinzman; Erica M.,39,0,45,6
1746545610276,EDS 204R,B01,895693,Halter; Christopher P.,10,0,45,35
1746545611302,EDS 206R,A00,895694,Fargason; Sharon Gayle,1,0,30,29
1746545611302,EDS 206R,B00,895695,Choi; Bailey Miyeon,16,0,30,14
1746545612327,EDS 250,A00,895697,Hemans; Patricia Ann Benitez,23,0,45,22
1746545613354,EDS 281,A00,895701,Meyerott; Theresa Ann,1,0,15,14
1746545614380,EDS 284,A00,895736,Meyerott; Theresa Ann,1,0,15,14
1746545615405,EDS 286,A00,897210,Fine; Sarah,0,0,15,15
1746545616434,EDS 289C,A01,895770,Daly; Alan J.,15,0,15,0
1746545617460,EDS 290,A00,897211,Hofstetter; Carolyn,0,0,15,15
1746545618488,LIGM 5A,A00,896162,Fischer-Grunski; Eva K,13,0,20,7
1746545619514,LIGM 5B,A00,896260,Fischer-Grunski; Eva K,17,0,20,3
1746545620539,LIGM 5C,A00,896308,Fischer-Grunski; Eva K,18,0,20,2
1746545621571,LIIT 5AS,A00,896313,Carnelos; Chiara,18,0,20,2
1746545622601,LIIT 5BS,A00,896416,Carnelos; Chiara,20,0,20,0
1746545623630,LIIT 5CS,A00,896564,Carnelos; Chiara,20,0,20,0
1746545624657,LISP 5A,A00,896588,Munoz Sanchez; Alicia,3,0,20,17
1746545625684,LISP 5B,A00,896653,Munoz Sanchez; Alicia,7,0,20,13
1746545626711,LISP 5C,A00,896655,Munoz Sanchez; Alicia,0,1,20,20
1746545627738,MAE 197,001,957918,Kleissl; Jan,9996,0,9999,3
1746545627738,MAE 197,002,959806,Boechler; Nicholas Sebastia,9998,0,9999,1
1746545627738,MAE 197,003,959852,Mullin; Jennifer S,9999,0,9999,0
1746545628763,MATH 2,A01,957937,Staff,33,0,35,2
1746545629789,MATH 197,001,957876,Kedlaya; Kiran S.,9993,0,9999,6
1746545630815,MCWP 40,A00,892729,Duru; Nur,10,0,20,10
1746545630815,MCWP 40,B00,893304,Montejo; Carolina,14,0,20,6
1746545631841,MCWP 40R,A00,893757,Redela; Pamela Morgan,0,5,20,20
1746545632871,MCWP 50,A00,893758,Morshed; Michael James,0,0,20,20
1746545632871,MCWP 50,B00,893761,Bartulis; Jason Michael,17,0,20,3
1746545633898,MCWP 50R,A00,893766,Compas; Sean Matthew,0,1,20,20
1746545633898,MCWP 50R,B00,893769,Carter; Jennifer A,0,1,20,20
1746545633898,MCWP 50R,C00,893771,Krone; Jarret,0,3,20,20
1746545633898,MCWP 50R,D00,893772,Miller; Elizabeth Deen,0,0,20,20
1746545633898,MCWP 50R,E00,893775,Carter; Andrea L,0,1,20,20
1746545634926,MMW 11R,A01,892721,Herbst; Matthew,11,0,27,16
1746545634926,MMW 11R,A02,892722,Herbst; Matthew,0,0,0,3
1746545635951,MMW 12R,A01,892724,Herbst; Matthew,0,11,16,16
1746545635951,MMW 12R,A02,892725,Herbst; Matthew,0,10,16,16
1746545636977,MMW 13R,A01,892727,Staff,0,4,16,16
1746545636977,MMW 13R,A02,892728,Staff,0,4,16,16
1746545636977,MMW 13R,A03,958032,Staff,0,4,16,16
1746545636977,MMW 13R,A04,958033,Staff,0,4,16,16
1746545636977,MMW 13R,A05,958034,Staff,0,4,16,16
1746545638005,SIO 295LS,A00,894015,Staff,5,0,25,20
1746545639033,SIO 295S,A00,894020,Staff,5,0,25,20
1746545640064,SIOC 290S,B01,958918,Merrifield; Mark A,14,0,30,16
1746545641108,SIOC 291S,B01,958922,Gabriel; Corey John,14,0,30,16
1746545642134,SOCI 117,A01,895339,Staff,3,0,5,2
1746545643159,WES 237B,A00,894149,Staff,11,0,20,9
1746545645253,AESE 279B,A00,891859,Staff,13,0,35,22
1746545646276,AIP 197,001,891854,Vespa; Emanuel Ignacio,9999,0,9999,0
1746545647315,ANTH 289S,A00,891856,Gagneux; Pascal,12,0,12,0
1746545648342,BENG 196,001,957946,Engler; Adam J.,9996,0,9999,3
1746545649366,BISP 197,001,959851,Wilhelm; James E.,9998,0,9999,1
1746545650390,CAT 124RS,A01,956906,Staff,6,0,25,19
1746545651416,CAT 125RS,A01,922013,Staff,6,0,25,19
1746545652444,CLRE 250,A00,891860,Morris; Sheldon,9995,0,9999,4
1746545654492,CLRE 251R,A00,907817,Mehta; Ravindra L.,9994,0,9999,5
1746545655519,CLRE 252,A00,891864,Cuomo; Raphael Eduardo,9993,0,9999,6
1746545656549,CLRE 253,A00,891867,Vaida; Florin,9994,0,9999,5
1746545656549,CLRE 253,B00,907819,Staff,9999,0,9999,0
1746545657572,CLRE 259,A00,891868,Patel; Hemal,9998,0,9999,1
1746545658598,CLRE 260,A00,891872,Cuomo; Raphael Eduardo,9999,0,9999,0
1746545659623,CLRE 297,001,891888,Cuomo; Raphael Eduardo,9999,0,9999,0
1746545660656,CSE 191,A00,958773,Minnes Kemp; Mor Mia,9996,0,9999,3
1746545661684,CSE 197,001,959846,Minnes Kemp; Mor Mia,9990,0,9999,9
1746545662715,CSS 201S,A01,892054,Mignozzetti; Umberto,26,0,30,4
1746545663741,CSS 202S,A01,892056,Mignozzetti; Umberto,26,0,30,4
1746545664768,DSC 197,001,956898,Eldridge; Justin Matthew,9998,0,9999,1
1746545665796,DSC 297,001,958000,Mazumdar; Arya,9998,0,9999,1
1746545665796,DSC 297,002,959862,Wang; Yusu,9999,0,9999,0
1746545666827,EAP 100,A00,905686,Staff,9778,0,9999,221
1746545667853,ECE 45,A01,892618,Staff,0,0,65,65
1746545669903,ECE 111,A01,892719,Staff,4,0,65,61
1746545670931,ECE 197,001,957920,Mercier; Patrick Philip,9991,0,9999,8
1746545671957,ECON 178,A01,907814,Zhu; Ying,26,0,35,9
1746545672984,EDS 115,A00,895312,Staff,36,0,45,9
1746545674011,EDS 117,A01,895337,Staff,24,0,30,6
1746545675041,EDS 125,A00,895341,Jones; Gabrielle Anastasia,37,0,45,8
1746545676067,EDS 128A,A01,895459,Fargason; Sharon Gayle,44,0,45,1
1746545677098,EDS 128B,A01,895543,Pappas; Elizabeth,44,0,45,1
1746545678123,EDS 139,A00,897203,Pappas; Elizabeth,44,0,45,1
1746545678123,EDS 139,B00,897209,Fargason; Sharon Gayle,41,0,45,4
1746545679149,EDS 201,A00,895545,Staff,23,0,45,22
1746545680178,EDS 203,A01,895581,Halter; Christopher P.,23,0,45,22
1746545681205,EDS 204R,A01,895625,Heinzman; Erica M.,39,0,45,6
1746545681205,EDS 204R,B01,895693,Halter; Christopher P.,10,0,45,35
1746545682235,EDS 206R,A00,895694,Fargason; Sharon Gayle,1,0,30,29
1746545682235,EDS 206R,B00,895695,Choi; Bailey Miyeon,16,0,30,14
1746545683264,EDS 250,A00,895697,Hemans; Patricia Ann Benitez,23,0,45,22
1746545684291,EDS 281,A00,895701,Meyerott; Theresa Ann,1,0,15,14
1746545685318,EDS 284,A00,895736,Meyerott; Theresa Ann,1,0,15,14
1746545686345,EDS 286,A00,897210,Fine; Sarah,0,0,15,15
1746545687375,EDS 289C,A01,895770,Daly; Alan J.,15,0,15,0
1746545688400,EDS 290,A00,897211,Hofstetter; Carolyn,0,0,15,15
1746545689426,LIGM 5A,A00,896162,Fischer-Grunski; Eva K,13,0,20,7
1746545690455,LIGM 5B,A00,896260,Fischer-Grunski; Eva K,17,0,20,3
1746545691485,LIGM 5C,A00,896308,Fischer-Grunski; Eva K,18,0,20,2
1746545692510,LIIT 5AS,A00,896313,Carnelos; Chiara,18,0,20,2
1746545693537,LIIT 5BS,A00,896416,Carnelos; Chiara,20,0,20,0
1746545694568,LIIT 5CS,A00,896564,Carnelos; Chiara,20,0,20,0
1746545695595,LISP 5A,A00,896588,Munoz Sanchez; Alicia,3,0,20,17
1746545696623,LISP 5B,A00,896653,Munoz Sanchez; Alicia,7,0,20,13
1746545697649,LISP 5C,A00,896655,Munoz Sanchez; Alicia,0,1,20,20
1746545698677,MAE 197,001,957918,Kleissl; Jan,9996,0,9999,3
1746545698677,MAE 197,002,959806,Boechler; Nicholas Sebastia,9998,0,9999,1
1746545698677,MAE 197,003,959852,Mullin; Jennifer S,9999,0,9999,0
1746545699705,MATH 2,A01,957937,Staff,33,0,35,2
1746545700734,MATH 197,001,957876,Kedlaya; Kiran S.,9993,0,9999,6
1746545701765,MCWP 40,A00,892729,Duru; Nur,10,0,20,10
1746545701765,MCWP 40,B00,893304,Montejo; Carolina,14,0,20,6
1746545702790,MCWP 40R,A00,893757,Redela; Pamela Morgan,0,5,20,20
1746545703816,MCWP 50,A00,893758,Morshed; Michael James,0,0,20,20
1746545703816,MCWP 50,B00,893761,Bartulis; Jason Michael,17,0,20,3
1746545704854,MCWP 50R,A00,893766,Compas; Sean Matthew,0,1,20,20
1746545704854,MCWP 50R,B00,893769,Carter; Jennifer A,0,1,20,20
1746545704854,MCWP 50R,C00,893771,Krone; Jarret,0,3,20,20
1746545704854,MCWP 50R,D00,893772,Miller; Elizabeth Deen,0,0,20,20
1746545704854,MCWP 50R,E00,893775,Carter; Andrea L,0,1,20,20
1746545705881,MMW 11R,A01,892721,Herbst; Matthew,11,0,27,16
1746545705881,MMW 11R,A02,892722,Herbst; Matthew,0,0,0,3
1746545706910,MMW 12R,A01,892724,Herbst; Matthew,0,11,16,16
1746545706910,MMW 12R,A02,892725,Herbst; Matthew,0,10,16,16
1746545707937,MMW 13R,A01,892727,Staff,0,4,16,16
1746545707937,MMW 13R,A02,892728,Staff,0,4,16,16
1746545707937,MMW 13R,A03,958032,Staff,0,4,16,16
1746545707937,MMW 13R,A04,958033,Staff,0,4,16,16
1746545707937,MMW 13R,A05,958034,Staff,0,4,16,16
1746545708963,SIO 295LS,A00,894015,Staff,5,0,25,20
1746545709994,SIO 295S,A00,894020,Staff,5,0,25,20
1746545711020,SIOC 290S,B01,958918,Merrifield; Mark A,14,0,30,16
1746545712052,SIOC 291S,B01,958922,Gabriel; Corey John,14,0,30,16
1746545713081,SOCI 117,A01,895339,Staff,3,0,5,2
1746545714108,WES 237B,A00,894149,Staff,11,0,20,9
1746545716195,AESE 279B,A00,891859,Staff,13,0,35,22
1746545717221,AIP 197,001,891854,Vespa; Emanuel Ignacio,9999,0,9999,0
1746545718245,ANTH 289S,A00,891856,Gagneux; Pascal,12,0,12,0
1746545719269,BENG 196,001,957946,Engler; Adam J.,9996,0,9999,3
1746545720297,BISP 197,001,959851,Wilhelm; James E.,9998,0,9999,1
1746545721321,CAT 124RS,A01,956906,Staff,6,0,25,19
1746545722351,CAT 125RS,A01,922013,Staff,6,0,25,19
1746545723378,CLRE 250,A00,891860,Morris; Sheldon,9995,0,9999,4
1746545725427,CLRE 251R,A00,907817,Mehta; Ravindra L.,9994,0,9999,5
1746545726453,CLRE 252,A00,891864,Cuomo; Raphael Eduardo,9993,0,9999,6
1746545727481,CLRE 253,A00,891867,Vaida; Florin,9994,0,9999,5
1746545727481,CLRE 253,B00,907819,Staff,9999,0,9999,0
1746545728510,CLRE 259,A00,891868,Patel; Hemal,9998,0,9999,1
1746545729538,CLRE 260,A00,891872,Cuomo; Raphael Eduardo,9999,0,9999,0
1746545730563,CLRE 297,001,891888,Cuomo; Raphael Eduardo,9999,0,9999,0
1746545731587,CSE 191,A00,958773,Minnes Kemp; Mor Mia,9996,0,9999,3
1746545732611,CSE 197,001,959846,Minnes Kemp; Mor Mia,9990,0,9999,9
1746545733636,CSS 201S,A01,892054,Mignozzetti; Umberto,26,0,30,4
1746545734664,CSS 202S,A01,892056,Mignozzetti; Umberto,26,0,30,4
1746545735693,DSC 197,001,956898,Eldridge; Justin Matthew,9998,0,9999,1
1746545736717,DSC 297,001,958000,Mazumdar; Arya,9998,0,9999,1
1746545736717,DSC 297,002,959862,Wang; Yusu,9999,0,9999,0
1746545737745,EAP 100,A00,905686,Staff,9778,0,9999,221
1746545738774,ECE 45,A01,892618,Staff,0,0,65,65
1746545740825,ECE 111,A01,892719,Staff,4,0,65,61
1746545741902,ECE 197,001,957920,Mercier; Patrick Philip,9991,0,9999,8
1746545742935,ECON 178,A01,907814,Zhu; Ying,26,0,35,9
1746545743961,EDS 115,A00,895312,Staff,36,0,45,9
1746545745033,EDS 117,A01,895337,Staff,24,0,30,6
1746545746056,EDS 125,A00,895341,Jones; Gabrielle Anastasia,37,0,45,8
1746545747081,EDS 128A,A01,895459,Fargason; Sharon Gayle,44,0,45,1
1746545748106,EDS 128B,A01,895543,Pappas; Elizabeth,44,0,45,1
1746545749134,EDS 139,A00,897203,Pappas; Elizabeth,44,0,45,1
1746545749134,EDS 139,B00,897209,Fargason; Sharon Gayle,41,0,45,4
1746545750163,EDS 201,A00,895545,Staff,23,0,45,22
1746545751188,EDS 203,A01,895581,Halter; Christopher P.,23,0,45,22
1746545752213,EDS 204R,A01,895625,Heinzman; Erica M.,39,0,45,6
1746545752213,EDS 204R,B01,895693,Halter; Christopher P.,10,0,45,35
1746545753238,EDS 206R,A00,895694,Fargason; Sharon Gayle,1,0,30,29
1746545753238,EDS 206R,B00,895695,Choi; Bailey Miyeon,16,0,30,14
1746545754263,EDS 250,A00,895697,Hemans; Patricia Ann Benitez,23,0,45,22
1746545755288,EDS 281,A00,895701,Meyerott; Theresa Ann,1,0,15,14
1746545756315,EDS 284,A00,895736,Meyerott; Theresa Ann,1,0,15,14
1746545757342,EDS 286,A00,897210,Fine; Sarah,0,0,15,15
1746545758368,EDS 289C,A01,895770,Daly; Alan J.,15,0,15,0
1746545759392,EDS 290,A00,897211,Hofstetter; Carolyn,0,0,15,15
1746545760423,LIGM 5A,A00,896162,Fischer-Grunski; Eva K,13,0,20,7
1746545761452,LIGM 5B,A00,896260,Fischer-Grunski; Eva K,17,0,20,3
1746545762478,LIGM 5C,A00,896308,Fischer-Grunski; Eva K,18,0,20,2
1746545763506,LIIT 5AS,A00,896313,Carnelos; Chiara,18,0,20,2
1746545764534,LIIT 5BS,A00,896416,Carnelos; Chiara,20,0,20,0
1746545765564,LIIT 5CS,A00,896564,Carnelos; Chiara,20,0,20,0
1746545766588,LISP 5A,A00,896588,Munoz Sanchez; Alicia,3,0,20,17
1746545767618,LISP 5B,A00,896653,Munoz Sanchez; Alicia,7,0,20,13
1746545768648,LISP 5C,A00,896655,Munoz Sanchez; Alicia,0,1,20,20
1746545769678,MAE 197,001,957918,Kleissl; Jan,9996,0,9999,3
1746545769678,MAE 197,002,959806,Boechler; Nicholas Sebastia,9998,0,9999,1
1746545769678,MAE 197,003,959852,Mullin; Jennifer S,9999,0,9999,0
1746545770704,MATH 2,A01,957937,Staff,33,0,35,2
1746545771733,MATH 197,001,957876,Kedlaya; Kiran S.,9993,0,9999,6
1746545772763,MCWP 40,A00,892729,Duru; Nur,10,0,20,10
1746545772763,MCWP 40,B00,893304,Montejo; Carolina,14,0,20,6
1746545773788,MCWP 40R,A00,893757,Redela; Pamela Morgan,0,5,20,20
1746545774813,MCWP 50,A00,893758,Morshed; Michael James,0,0,20,20
1746545774813,MCWP 50,B00,893761,Bartulis; Jason Michael,17,0,20,3
1746545775840,MCWP 50R,A00,893766,Compas; Sean Matthew,0,1,20,20
1746545775840,MCWP 50R,B00,893769,Carter; Jennifer A,0,1,20,20
1746545775840,MCWP 50R,C00,893771,Krone; Jarret,0,3,20,20
1746545775840,MCWP 50R,D00,893772,Miller; Elizabeth Deen,0,0,20,20
1746545775840,MCWP 50R,E00,893775,Carter; Andrea L,0,1,20,20
1746545776865,MMW 11R,A01,892721,Herbst; Matthew,11,0,27,16
1746545776865,MMW 11R,A02,892722,Herbst; Matthew,0,0,0,3
1746545777911,MMW 12R,A01,892724,Herbst; Matthew,0,11,16,16
1746545777911,MMW 12R,A02,892725,Herbst; Matthew,0,10,16,16
1746545778938,MMW 13R,A01,892727,Staff,0,4,16,16
1746545778938,MMW 13R,A02,892728,Staff,0,4,16,16
1746545778938,MMW 13R,A03,958032,Staff,0,4,16,16
1746545778938,MMW 13R,A04,958033,Staff,0,4,16,16
1746545778938,MMW 13R,A05,958034,Staff,0,4,16,16
1746545779963,SIO 295LS,A00,894015,Staff,5,0,25,20
1746545780988,SIO 295S,A00,894020,Staff,5,0,25,20
1746545782018,SIOC 290S,B01,958918,Merrifield; Mark A,14,0,30,16
1746545783050,SIOC 291S,B01,958922,Gabriel; Corey John,14,0,30,16
1746545784077,SOCI 117,A01,895339,Staff,3,0,5,2
1746545785103,WES 237B,A00,894149,Staff,11,0,20,9
1746545787164,AESE 279B,A00,891859,Staff,13,0,35,22
1746545788189,AIP 197,001,891854,Vespa; Emanuel Ignacio,9999,0,9999,0
1746545789214,ANTH 289S,A00,891856,Gagneux; Pascal,12,0,12,0
1746545790249,BENG 196,001,957946,Engler; Adam J.,9996,0,9999,3
1746545791277,BISP 197,001,959851,Wilhelm; James E.,9998,0,9999,1
1746545792302,CAT 124RS,A01,956906,Staff,6,0,25,19
1746545793327,CAT 125RS,A01,922013,Staff,6,0,25,19
1746545794353,CLRE 250,A00,891860,Morris; Sheldon,9995,0,9999,4
1746545796407,CLRE 251R,A00,907817,Mehta; Ravindra L.,9994,0,9999,5
1746545797433,CLRE 252,A00,891864,Cuomo; Raphael Eduardo,9993,0,9999,6
1746545798461,CLRE 253,A00,891867,Vaida; Florin,9994,0,9999,5
1746545798461,CLRE 253,B00,907819,Staff,9999,0,9999,0
1746545799487,CLRE 259,A00,891868,Patel; Hemal,9998,0,9999,1
1746545800512,CLRE 260,A00,891872,Cuomo; Raphael Eduardo,9999,0,9999,0
1746545801539,CLRE 297,001,891888,Cuomo; Raphael Eduardo,9999,0,9999,0
1746545802565,CSE 191,A00,958773,Minnes Kemp; Mor Mia,9996,0,9999,3
1746545803593,CSE 197,001,959846,Minnes Kemp; Mor Mia,9990,0,9999,9
1746545804623,CSS 201S,A01,892054,Mignozzetti; Umberto,26,0,30,4
1746545805648,CSS 202S,A01,892056,Mignozzetti; Umberto,26,0,30,4
1746545806678,DSC 197,001,956898,Eldridge; Justin Matthew,9998,0,9999,1
1746545807703,DSC 297,001,958000,Mazumdar; Arya,9998,0,9999,1
1746545807703,DSC 297,002,959862,Wang; Yusu,9999,0,9999,0
1746545808728,EAP 100,A00,905686,Staff,9778,0,9999,221
1746545809753,ECE 45,A01,892618,Staff,0,0,65,65
1746545811814,ECE 111,A01,892719,Staff,4,0,65,61
1746545812843,ECE 197,001,957920,Mercier; Patrick Philip,9991,0,9999,8
1746545813869,ECON 178,A01,907814,Zhu; Ying,26,0,35,9
1746545814895,EDS 115,A00,895312,Staff,36,0,45,9
1746545815921,EDS 117,A01,895337,Staff,24,0,30,6
1746545816948,EDS 125,A00,895341,Jones; Gabrielle Anastasia,37,0,45,8
1746545817977,EDS 128A,A01,895459,Fargason; Sharon Gayle,44,0,45,1
1746545819002,EDS 128B,A01,895543,Pappas; Elizabeth,44,0,45,1
1746545820029,EDS 139,A00,897203,Pappas; Elizabeth,44,0,45,1
1746545820029,EDS 139,B00,897209,Fargason; Sharon Gayle,41,0,45,4
1746545821057,EDS 201,A00,895545,Staff,23,0,45,22
1746545822085,EDS 203,A01,895581,Halter; Christopher P.,23,0,45,22
1746545823113,EDS 204R,A01,895625,Heinzman; Erica M.,39,0,45,6
1746545823113,EDS 204R,B01,895693,Halter; Christopher P.,10,0,45,35
1746545824141,EDS 206R,A00,895694,Fargason; Sharon Gayle,1,0,30,29
1746545824141,EDS 206R,B00,895695,Choi; Bailey Miyeon,16,0,30,14
1746545825168,EDS 250,A00,895697,Hemans; Patricia Ann Benitez,23,0,45,22
1746545826194,EDS 281,A00,895701,Meyerott; Theresa Ann,1,0,15,14
1746545827221,EDS 284,A00,895736,Meyerott; Theresa Ann,1,0,15,14
1746545828246,EDS 286,A00,897210,Fine; Sarah,0,0,15,15
1746545829272,EDS 289C,A01,895770,Daly; Alan J.,15,0,15,0
1746545830297,EDS 290,A00,897211,Hofstetter; Carolyn,0,0,15,15
1746545831321,LIGM 5A,A00,896162,Fischer-Grunski; Eva K,13,0,20,7
1746545832347,LIGM 5B,A00,896260,Fischer-Grunski; Eva K,17,0,20,3
1746545833373,LIGM 5C,A00,896308,Fischer-Grunski; Eva K,18,0,20,2
1746545834403,LIIT 5AS,A00,896313,Carnelos; Chiara,18,0,20,2
1746545835432,LIIT 5BS,A00,896416,Carnelos; Chiara,20,0,20,0
1746545836458,LIIT 5CS,A00,896564,Carnelos; Chiara,20,0,20,0
1746545837486,LISP 5A,A00,896588,Munoz Sanchez; Alicia,3,0,20,17
1746545838515,LISP 5B,A00,896653,Munoz Sanchez; Alicia,7,0,20,13
1746545839542,LISP 5C,A00,896655,Munoz Sanchez; Alicia,0,1,20,20
1746545840571,MAE 197,001,957918,Kleissl; Jan,9996,0,9999,3
1746545840571,MAE 197,002,959806,Boechler; Nicholas Sebastia,9998,0,9999,1
1746545840571,MAE 197,003,959852,Mullin; Jennifer S,9999,0,9999,0
1746545841596,MATH 2,A01,957937,Staff,33,0,35,2
1746545842621,MATH 197,001,957876,Kedlaya; Kiran S.,9993,0,9999,6
1746545843646,MCWP 40,A00,892729,Duru; Nur,10,0,20,10
1746545843646,MCWP 40,B00,893304,Montejo; Carolina,14,0,20,6
1746545844672,MCWP 40R,A00,893757,Redela; Pamela Morgan,0,5,20,20
1746545845701,MCWP 50,A00,893758,Morshed; Michael James,0,0,20,20
1746545845701,MCWP 50,B00,893761,Bartulis; Jason Michael,17,0,20,3
1746545846731,MCWP 50R,A00,893766,Compas; Sean Matthew,0,1,20,20
1746545846731,MCWP 50R,B00,893769,Carter; Jennifer A,0,1,20,20
1746545846731,MCWP 50R,C00,893771,Krone; Jarret,0,3,20,20
1746545846731,MCWP 50R,D00,893772,Miller; Elizabeth Deen,0,0,20,20
1746545846731,MCWP 50R,E00,893775,Carter; Andrea L,0,1,20,20
1746545847758,MMW 11R,A01,892721,Herbst; Matthew,11,0,27,16
1746545847758,MMW 11R,A02,892722,Herbst; Matthew,0,0,0,3
1746545848784,MMW 12R,A01,892724,Herbst; Matthew,0,11,16,16
1746545848784,MMW 12R,A02,892725,Herbst; Matthew,0,10,16,16
1746545849813,MMW 13R,A01,892727,Staff,0,4,16,16
1746545849813,MMW 13R,A02,892728,Staff,0,4,16,16
1746545849813,MMW 13R,A03,958032,Staff,0,4,16,16
1746545849813,MMW 13R,A04,958033,Staff,0,4,16,16
1746545849813,MMW 13R,A05,958034,Staff,0,4,16,16
1746545850838,SIO 295LS,A00,894015,Staff,5,0,25,20
1746545851862,SIO 295S,A00,894020,Staff,5,0,25,20
1746545852888,SIOC 290S,B01,958918,Merrifield; Mark A,14,0,30,16
1746545853913,SIOC 291S,B01,958922,Gabriel; Corey John,14,0,30,16
1746545854939,SOCI 117,A01,895339,Staff,3,0,5,2
1746545855967,WES 237B,A00,894149,Staff,11,0,20,9
1746545858040,AESE 279B,A00,891859,Staff,13,0,35,22
1746545859066,AIP 197,001,891854,Vespa; Emanuel Ignacio,9999,0,9999,0
1746545860095,ANTH 289S,A00,891856,Gagneux; Pascal,12,0,12,0
1746545861122,BENG 196,001,957946,Engler; Adam J.,9996,0,9999,3
1746545862150,BISP 197,001,959851,Wilhelm; James E.,9998,0,9999,1
1746545863176,CAT 124RS,A01,956906,Staff,6,0,25,19
1746545864204,CAT 125RS,A01,922013,Staff,6,0,25,19
1746545865233,CLRE 250,A00,891860,Morris; Sheldon,9995,0,9999,4
1746545867287,CLRE 251R,A00,907817,Mehta; Ravindra L.,9994,0,9999,5
1746545868313,CLRE 252,A00,891864,Cuomo; Raphael Eduardo,9993,0,9999,6
1746545869343,CLRE 253,A00,891867,Vaida; Florin,9994,0,9999,5
1746545869343,CLRE 253,B00,907819,Staff,9999,0,9999,0
1746545870367,CLRE 259,A00,891868,Patel; Hemal,9998,0,9999,1
1746545871394,CLRE 260,A00,891872,Cuomo; Raphael Eduardo,9999,0,9999,0
1746545872423,CLRE 297,001,891888,Cuomo; Raphael Eduardo,9999,0,9999,0
1746545873450,CSE 191,A00,958773,Minnes Kemp; Mor Mia,9996,0,9999,3
1746545874475,CSE 197,001,959846,Minnes Kemp; Mor Mia,9990,0,9999,9
1746545875504,CSS 201S,A01,892054,Mignozzetti; Umberto,26,0,30,4
1746545876530,CSS 202S,A01,892056,Mignozzetti; Umberto,26,0,30,4
1746545877557,DSC 197,001,956898,Eldridge; Justin Matthew,9998,0,9999,1
1746545878582,DSC 297,001,958000,Mazumdar; Arya,9998,0,9999,1
1746545878582,DSC 297,002,959862,Wang; Yusu,9999,0,9999,0
1746545879607,EAP 100,A00,905686,Staff,9778,0,9999,221
1746545880632,ECE 45,A01,892618,Staff,0,0,65,65
1746545882681,ECE 111,A01,892719,Staff,4,0,65,61
1746545883707,ECE 197,001,957920,Mercier; Patrick Philip,9991,0,9999,8
1746545884734,ECON 178,A01,907814,Zhu; Ying,26,0,35,9
1746545885759,EDS 115,A00,895312,Staff,36,0,45,9
1746545886785,EDS 117,A01,895337,Staff,24,0,30,6
1746545887814,EDS 125,A00,895341,Jones; Gabrielle Anastasia,37,0,45,8
1746545888838,EDS 128A,A01,895459,Fargason; Sharon Gayle,44,0,45,1
1746545889868,EDS 128B,A01,895543,Pappas; Elizabeth,44,0,45,1
1746545890894,EDS 139,A00,897203,Pappas; Elizabeth,44,0,45,1
1746545890894,EDS 139,B00,897209,Fargason; Sharon Gayle,41,0,45,4
1746545891924,EDS 201,A00,895545,Staff,23,0,45,22
1746545892948,EDS 203,A01,895581,Halter; Christopher P.,23,0,45,22
1746545893978,EDS 204R,A01,895625,Heinzman; Erica M.,39,0,45,6
1746545893978,EDS 204R,B01,895693,Halter; Christopher P.,10,0,45,35
1746545895005,EDS 206R,A00,895694,Fargason; Sharon Gayle,1,0,30,29
1746545895005,EDS 206R,B00,895695,Choi; Bailey Miyeon,16,0,30,14
1746545896090,EDS 250,A00,895697,Hemans; Patricia Ann Benitez,23,0,45,22
1746545897116,EDS 281,A00,895701,Meyerott; Theresa Ann,1,0,15,14
1746545898141,EDS 284,A00,895736,Meyerott; Theresa Ann,1,0,15,14
1746545899168,EDS 286,A00,897210,Fine; Sarah,0,0,15,15
1746545900196,EDS 289C,A01,895770,Daly; Alan J.,15,0,15,0
1746545901223,EDS 290,A00,897211,Hofstetter; Carolyn,0,0,15,15
1746545902250,LIGM 5A,A00,896162,Fischer-Grunski; Eva K,13,0,20,7
1746545903279,LIGM 5B,A00,896260,Fischer-Grunski; Eva K,17,0,20,3
1746545904309,LIGM 5C,A00,896308,Fischer-Grunski; Eva K,18,0,20,2
1746545905336,LIIT 5AS,A00,896313,Carnelos; Chiara,18,0,20,2
1746545906362,LIIT 5BS,A00,896416,Carnelos; Chiara,20,0,20,0
1746545907389,LIIT 5CS,A00,896564,Carnelos; Chiara,20,0,20,0
1746545908413,LISP 5A,A00,896588,Munoz Sanchez; Alicia,3,0,20,17
1746545909443,LISP 5B,A00,896653,Munoz Sanchez; Alicia,7,0,20,13
1746545910468,LISP 5C,A00,896655,Munoz Sanchez; Alicia,0,1,20,20
1746545911495,MAE 197,001,957918,Kleissl; Jan,9996,0,9999,3
1746545911495,MAE 197,002,959806,Boechler; Nicholas Sebastia,9998,0,9999,1
1746545911495,MAE 197,003,959852,Mullin; Jennifer S,9999,0,9999,0
1746545912520,MATH 2,A01,957937,Staff,33,0,35,2
1746545913548,MATH 197,001,957876,Kedlaya; Kiran S.,9993,0,9999,6
1746545914575,MCWP 40,A00,892729,Duru; Nur,10,0,20,10
1746545914575,MCWP 40,B00,893304,Montejo; Carolina,14,0,20,6
1746545915602,MCWP 40R,A00,893757,Redela; Pamela Morgan,0,5,20,20
1746545916627,MCWP 50,A00,893758,Morshed; Michael James,0,0,20,20
1746545916627,MCWP 50,B00,893761,Bartulis; Jason Michael,17,0,20,3
1746545917654,MCWP 50R,A00,893766,Compas; Sean Matthew,0,1,20,20
1746545917654,MCWP 50R,B00,893769,Carter; Jennifer A,0,1,20,20
1746545917654,MCWP 50R,C00,893771,Krone; Jarret,0,3,20,20
1746545917654,MCWP 50R,D00,893772,Miller; Elizabeth Deen,0,0,20,20
1746545917654,MCWP 50R,E00,893775,Carter; Andrea L,0,1,20,20
1746545918680,MMW 11R,A01,892721,Herbst; Matthew,11,0,27,16
1746545918680,MMW 11R,A02,892722,Herbst; Matthew,0,0,0,3
1746545919709,MMW 12R,A01,892724,Herbst; Matthew,0,11,16,16
1746545919709,MMW 12R,A02,892725,Herbst; Matthew,0,10,16,16
1746545920739,MMW 13R,A01,892727,Staff,0,4,16,16
1746545920739,MMW 13R,A02,892728,Staff,0,4,16,16
1746545920739,MMW 13R,A03,958032,Staff,0,4,16,16
1746545920739,MMW 13R,A04,958033,Staff,0,4,16,16
1746545920739,MMW 13R,A05,958034,Staff,0,4,16,16
1746545921766,SIO 295LS,A00,894015,Staff,5,0,25,20
1746545922790,SIO 295S,A00,894020,Staff,5,0,25,20
1746545923818,SIOC 290S,B01,958918,Merrifield; Mark A,14,0,30,16
1746545924848,SIOC 291S,B01,958922,Gabriel; Corey John,14,0,30,16
1746545925873,SOCI 117,A01,895339,Staff,3,0,5,2
1746545926898,WES 237B,A00,894149,Staff,11,0,20,9
1746545928958,AESE 279B,A00,891859,Staff,13,0,35,22
1746545929985,AIP 197,001,891854,Vespa; Emanuel Ignacio,9999,0,9999,0
1746545931009,ANTH 289S,A00,891856,Gagneux; Pascal,12,0,12,0
1746545932036,BENG 196,001,957946,Engler; Adam J.,9996,0,9999,3
1746545933061,BISP 197,001,959851,Wilhelm; James E.,9998,0,9999,1
1746545934084,CAT 124RS,A01,956906,Staff,6,0,25,19
1746545935113,CAT 125RS,A01,922013,Staff,6,0,25,19
1746545936140,CLRE 250,A00,891860,Morris; Sheldon,9995,0,9999,4
1746545938193,CLRE 251R,A00,907817,Mehta; Ravindra L.,9994,0,9999,5
1746545939218,CLRE 252,A00,891864,Cuomo; Raphael Eduardo,9993,0,9999,6
1746545940245,CLRE 253,A00,891867,Vaida; Florin,9994,0,9999,5
1746545940245,CLRE 253,B00,907819,Staff,9999,0,9999,0
1746545941273,CLRE 259,A00,891868,Patel; Hemal,9998,0,9999,1
1746545942313,CLRE 260,A00,891872,Cuomo; Raphael Eduardo,9999,0,9999,0
1746545943341,CLRE 297,001,891888,Cuomo; Raphael Eduardo,9999,0,9999,0
1746545944366,CSE 191,A00,958773,Minnes Kemp; Mor Mia,9996,0,9999,3
1746545945392,CSE 197,001,959846,Minnes Kemp; Mor Mia,9990,0,9999,9
1746545946419,CSS 201S,A01,892054,Mignozzetti; Umberto,26,0,30,4
1746545947442,CSS 202S,A01,892056,Mignozzetti; Umberto,26,0,30,4
1746545948467,DSC 197,001,956898,Eldridge; Justin Matthew,9998,0,9999,1
1746545949493,DSC 297,001,958000,Mazumdar; Arya,9998,0,9999,1
1746545949493,DSC 297,002,959862,Wang; Yusu,9999,0,9999,0
1746545950523,EAP 100,A00,905686,Staff,9778,0,9999,221
1746545951550,ECE 45,A01,892618,Staff,0,0,65,65
1746545953601,ECE 111,A01,892719,Staff,4,0,65,61
1746545954628,ECE 197,001,957920,Mercier; Patrick Philip,9991,0,9999,8
1746545955657,ECON 178,A01,907814,Zhu; Ying,26,0,35,9
1746545956681,EDS 115,A00,895312,Staff,36,0,45,9
1746545957707,EDS 117,A01,895337,Staff,24,0,30,6
1746545958732,EDS 125,A00,895341,Jones; Gabrielle Anastasia,37,0,45,8
1746545959757,EDS 128A,A01,895459,Fargason; Sharon Gayle,44,0,45,1
1746545960821,EDS 128B,A01,895543,Pappas; Elizabeth,44,0,45,1
1746545961847,EDS 139,A00,897203,Pappas; Elizabeth,44,0,45,1
1746545961847,EDS 139,B00,897209,Fargason; Sharon Gayle,41,0,45,4
1746545962873,EDS 201,A00,895545,Staff,23,0,45,22
1746545963900,EDS 203,A01,895581,Halter; Christopher P.,23,0,45,22
1746545964927,EDS 204R,A01,895625,Heinzman; Erica M.,39,0,45,6
1746545964927,EDS 204R,B01,895693,Halter; Christopher P.,10,0,45,35
1746545965952,EDS 206R,A00,895694,Fargason; Sharon Gayle,1,0,30,29
1746545965952,EDS 206R,B00,895695,Choi; Bailey Miyeon,16,0,30,14
1746545966981,EDS 250,A00,895697,Hemans; Patricia Ann Benitez,23,0,45,22
1746545968005,EDS 281,A00,895701,Meyerott; Theresa Ann,1,0,15,14
1746545969030,EDS 284,A00,895736,Meyerott; Theresa Ann,1,0,15,14
1746545970055,EDS 286,A00,897210,Fine; Sarah,0,0,15,15
1746545971080,EDS 289C,A01,895770,Daly; Alan J.,15,0,15,0
1746545972105,EDS 290,A00,897211,Hofstetter; Carolyn,0,0,15,15
1746545973134,LIGM 5A,A00,896162,Fischer-Grunski; Eva K,13,0,20,7
1746545974159,LIGM 5B,A00,896260,Fischer-Grunski; Eva K,17,0,20,3
1746545975185,LIGM 5C,A00,896308,Fischer-Grunski; Eva K,18,0,20,2
1746545976210,LIIT 5AS,A00,896313,Carnelos; Chiara,18,0,20,2
1746545977236,LIIT 5BS,A00,896416,Carnelos; Chiara,20,0,20,0
1746545978260,LIIT 5CS,A00,896564,Carnelos; Chiara,20,0,20,0
1746545979290,LISP 5A,A00,896588,Munoz Sanchez; Alicia,3,0,20,17
1746545980315,LISP 5B,A00,896653,Munoz Sanchez; Alicia,7,0,20,13
1746545981343,LISP 5C,A00,896655,Munoz Sanchez; Alicia,0,1,20,20
1746545982373,MAE 197,001,957918,Kleissl; Jan,9996,0,9999,3
1746545982373,MAE 197,002,959806,Boechler; Nicholas Sebastia,9998,0,9999,1
1746545982373,MAE 197,003,959852,Mullin; Jennifer S,9999,0,9999,0
1746545983397,MATH 2,A01,957937,Staff,33,0,35,2
1746545984424,MATH 197,001,957876,Kedlaya; Kiran S.,9993,0,9999,6
1746545985452,MCWP 40,A00,892729,Duru; Nur,10,0,20,10
1746545985452,MCWP 40,B00,893304,Montejo; Carolina,14,0,20,6
1746545986480,MCWP 40R,A00,893757,Redela; Pamela Morgan,0,5,20,20
1746545987505,MCWP 50,A00,893758,Morshed; Michael James,0,0,20,20
1746545987505,MCWP 50,B00,893761,Bartulis; Jason Michael,17,0,20,3
1746545988532,MCWP 50R,A00,893766,Compas; Sean Matthew,0,1,20,20
1746545988532,MCWP 50R,B00,893769,Carter; Jennifer A,0,1,20,20
1746545988532,MCWP 50R,C00,893771,Krone; Jarret,0,3,20,20
1746545988532,MCWP 50R,D00,893772,Miller; Elizabeth Deen,0,0,20,20
1746545988532,MCWP 50R,E00,893775,Carter; Andrea L,0,1,20,20
1746545989558,MMW 11R,A01,892721,Herbst; Matthew,11,0,27,16
1746545989558,MMW 11R,A02,892722,Herbst; Matthew,0,0,0,3
1746545990586,MMW 12R,A01,892724,Herbst; Matthew,0,11,16,16
1746545990586,MMW 12R,A02,892725,Herbst; Matthew,0,10,16,16
1746545991614,MMW 13R,A01,892727,Staff,0,4,16,16
1746545991614,MMW 13R,A02,892728,Staff,0,4,16,16
1746545991614,MMW 13R,A03,958032,Staff,0,4,16,16
1746545991614,MMW 13R,A04,958033,Staff,0,4,16,16
1746545991614,MMW 13R,A05,958034,Staff,0,4,16,16
1746545992644,SIO 295LS,A00,894015,Staff,5,0,25,20
1746545993668,SIO 295S,A00,894020,Staff,5,0,25,20
1746545994698,SIOC 290S,B01,958918,Merrifield; Mark A,14,0,30,16
1746545995729,SIOC 291S,B01,958922,Gabriel; Corey John,14,0,30,16
1746545996753,SOCI 117,A01,895339,Staff,3,0,5,2
1746545997778,WES 237B,A00,894149,Staff,11,0,20,9
1746545999842,AESE 279B,A00,891859,Staff,13,0,35,22
1746546000870,AIP 197,001,891854,Vespa; Emanuel Ignacio,9999,0,9999,0
1746546001899,ANTH 289S,A00,891856,Gagneux; Pascal,12,0,12,0
1746546002926,BENG 196,001,957946,Engler; Adam J.,9996,0,9999,3
1746546003950,BISP 197,001,959851,Wilhelm; James E.,9998,0,9999,1
1746546004976,CAT 124RS,A01,956906,Staff,6,0,25,19
1746546006003,CAT 125RS,A01,922013,Staff,6,0,25,19
1746546007032,CLRE 250,A00,891860,Morris; Sheldon,9995,0,9999,4
1746546009087,CLRE 251R,A00,907817,Mehta; Ravindra L.,9994,0,9999,5
1746546010114,CLRE 252,A00,891864,Cuomo; Raphael Eduardo,9993,0,9999,6
1746546011141,CLRE 253,A00,891867,Vaida; Florin,9994,0,9999,5
1746546011141,CLRE 253,B00,907819,Staff,9999,0,9999,0
1746546012167,CLRE 259,A00,891868,Patel; Hemal,9998,0,9999,1
1746546013191,CLRE 260,A00,891872,Cuomo; Raphael Eduardo,9999,0,9999,0
1746546014219,CLRE 297,001,891888,Cuomo; Raphael Eduardo,9999,0,9999,0
1746546015249,CSE 191,A00,958773,Minnes Kemp; Mor Mia,9996,0,9999,3
1746546016274,CSE 197,001,959846,Minnes Kemp; Mor Mia,9990,0,9999,9
1746546017299,CSS 201S,A01,892054,Mignozzetti; Umberto,26,0,30,4
1746546018327,CSS 202S,A01,892056,Mignozzetti; Umberto,26,0,30,4
1746546019354,DSC 197,001,956898,Eldridge; Justin Matthew,9998,0,9999,1
1746546020385,DSC 297,001,958000,Mazumdar; Arya,9998,0,9999,1
1746546020385,DSC 297,002,959862,Wang; Yusu,9999,0,9999,0
1746546021412,EAP 100,A00,905686,Staff,9778,0,9999,221
1746546022437,ECE 45,A01,892618,Staff,0,0,65,65
1746546024492,ECE 111,A01,892719,Staff,4,0,65,61
1746546025517,ECE 197,001,957920,Mercier; Patrick Philip,9991,0,9999,8
1746546026543,ECON 178,A01,907814,Zhu; Ying,26,0,35,9
1746546027567,EDS 115,A00,895312,Staff,36,0,45,9
1746546028592,EDS 117,A01,895337,Staff,24,0,30,6
1746546029620,EDS 125,A00,895341,Jones; Gabrielle Anastasia,37,0,45,8
1746546030645,EDS 128A,A01,895459,Fargason; Sharon Gayle,44,0,45,1
1746546031670,EDS 128B,A01,895543,Pappas; Elizabeth,44,0,45,1
1746546032696,EDS 139,A00,897203,Pappas; Elizabeth,44,0,45,1
1746546032696,EDS 139,B00,897209,Fargason; Sharon Gayle,41,0,45,4
1746546033720,EDS 201,A00,895545,Staff,23,0,45,22
1746546034749,EDS 203,A01,895581,Halter; Christopher P.,23,0,45,22
1746546035776,EDS 204R,A01,895625,Heinzman; Erica M.,39,0,45,6
1746546035776,EDS 204R,B01,895693,Halter; Christopher P.,10,0,45,35
1746546036802,EDS 206R,A00,895694,Fargason; Sharon Gayle,1,0,30,29
1746546036802,EDS 206R,B00,895695,Choi; Bailey Miyeon,16,0,30,14
1746546037829,EDS 250,A00,895697,Hemans; Patricia Ann Benitez,23,0,45,22
1746546038854,EDS 281,A00,895701,Meyerott; Theresa Ann,1,0,15,14
1746546039882,EDS 284,A00,895736,Meyerott; Theresa Ann,1,0,15,14
1746546040909,EDS 286,A00,897210,Fine; Sarah,0,0,15,15
1746546041934,EDS 289C,A01,895770,Daly; Alan J.,15,0,15,0
1746546042961,EDS 290,A00,897211,Hofstetter; Carolyn,0,0,15,15
1746546043988,LIGM 5A,A00,896162,Fischer-Grunski; Eva K,13,0,20,7
1746546045025,LIGM 5B,A00,896260,Fischer-Grunski; Eva K,17,0,20,3
1746546062101,LIGM 5C,A00,896308,Fischer-Grunski; Eva K,18,0,20,2
1746546063130,LIIT 5AS,A00,896313,Carnelos; Chiara,18,0,20,2
1746546064156,LIIT 5BS,A00,896416,Carnelos; Chiara,20,0,20,0
1746546065184,LIIT 5CS,A00,896564,Carnelos; Chiara,20,0,20,0
1746546066208,LISP 5A,A00,896588,Munoz Sanchez; Alicia,3,0,20,17
1746546067234,LISP 5B,A00,896653,Munoz Sanchez; Alicia,7,0,20,13
1746546068259,LISP 5C,A00,896655,Munoz Sanchez; Alicia,0,1,20,20
1746546069285,MAE 197,001,957918,Kleissl; Jan,9996,0,9999,3
1746546069285,MAE 197,002,959806,Boechler; Nicholas Sebastia,9998,0,9999,1
1746546069285,MAE 197,003,959852,Mullin; Jennifer S,9999,0,9999,0
1746546070314,MATH 2,A01,957937,Staff,33,0,35,2
1746546071339,MATH 197,001,957876,Kedlaya; Kiran S.,9993,0,9999,6
1746546072366,MCWP 40,A00,892729,Duru; Nur,10,0,20,10
1746546072366,MCWP 40,B00,893304,Montejo; Carolina,14,0,20,6
1746546073390,MCWP 40R,A00,893757,Redela; Pamela Morgan,0,5,20,20
1746546074416,MCWP 50,A00,893758,Morshed; Michael James,0,0,20,20
1746546074416,MCWP 50,B00,893761,Bartulis; Jason Michael,17,0,20,3
1746546075445,MCWP 50R,A00,893766,Compas; Sean Matthew,0,1,20,20
1746546075445,MCWP 50R,B00,893769,Carter; Jennifer A,0,1,20,20
1746546075445,MCWP 50R,C00,893771,Krone; Jarret,0,3,20,20
1746546075445,MCWP 50R,D00,893772,Miller; Elizabeth Deen,0,0,20,20
1746546075445,MCWP 50R,E00,893775,Carter; Andrea L,0,1,20,20
1746546076470,MMW 11R,A01,892721,Herbst; Matthew,11,0,27,16
1746546076470,MMW 11R,A02,892722,Herbst; Matthew,0,0,0,3
1746546077497,MMW 12R,A01,892724,Herbst; Matthew,0,11,16,16
1746546077497,MMW 12R,A02,892725,Herbst; Matthew,0,10,16,16
1746546078524,MMW 13R,A01,892727,Staff,0,4,16,16
1746546078524,MMW 13R,A02,892728,Staff,0,4,16,16
1746546078524,MMW 13R,A03,958032,Staff,0,4,16,16
1746546078524,MMW 13R,A04,958033,Staff,0,4,16,16
1746546078524,MMW 13R,A05,958034,Staff,0,4,16,16
1746546079553,SIO 295LS,A00,894015,Staff,5,0,25,20
1746546080578,SIO 295S,A00,894020,Staff,5,0,25,20
1746546081608,SIOC 290S,B01,958918,Merrifield; Mark A,14,0,30,16
1746546082633,SIOC 291S,B01,958922,Gabriel; Corey John,14,0,30,16
1746546083663,SOCI 117,A01,895339,Staff,3,0,5,2
1746546084691,WES 237B,A00,894149,Staff,11,0,20,9
1746546086761,AESE 279B,A00,891859,Staff,13,0,35,22
1746546087787,AIP 197,001,891854,Vespa; Emanuel Ignacio,9999,0,9999,0
1746546088811,ANTH 289S,A00,891856,Gagneux; Pascal,12,0,12,0
1746546089835,BENG 196,001,957946,Engler; Adam J.,9996,0,9999,3
1746546090861,BISP 197,001,959851,Wilhelm; James E.,9998,0,9999,1
1746546091888,CAT 124RS,A01,956906,Staff,6,0,25,19
1746546092918,CAT 125RS,A01,922013,Staff,6,0,25,19
1746546093945,CLRE 250,A00,891860,Morris; Sheldon,9995,0,9999,4
1746546096001,CLRE 251R,A00,907817,Mehta; Ravindra L.,9994,0,9999,5
1746546097030,CLRE 252,A00,891864,Cuomo; Raphael Eduardo,9993,0,9999,6
1746546098058,CLRE 253,A00,891867,Vaida; Florin,9994,0,9999,5
1746546098058,CLRE 253,B00,907819,Staff,9999,0,9999,0
1746546099083,CLRE 259,A00,891868,Patel; Hemal,9998,0,9999,1
1746546100109,CLRE 260,A00,891872,Cuomo; Raphael Eduardo,9999,0,9999,0
1746546101137,CLRE 297,001,891888,Cuomo; Raphael Eduardo,9999,0,9999,0
1746546102203,CSE 191,A00,958773,Minnes Kemp; Mor Mia,9996,0,9999,3
1746546103227,CSE 197,001,959846,Minnes Kemp; Mor Mia,9990,0,9999,9
1746546104253,CSS 201S,A01,892054,Mignozzetti; Umberto,26,0,30,4
1746546105281,CSS 202S,A01,892056,Mignozzetti; Umberto,26,0,30,4
1746546106308,DSC 197,001,956898,Eldridge; Justin Matthew,9998,0,9999,1
1746546107334,DSC 297,001,958000,Mazumdar; Arya,9998,0,9999,1
1746546107334,DSC 297,002,959862,Wang; Yusu,9999,0,9999,0
1746546108362,EAP 100,A00,905686,Staff,9778,0,9999,221
1746546109388,ECE 45,A01,892618,Staff,0,0,65,65
1746546111441,ECE 111,A01,892719,Staff,4,0,65,61
1746546112468,ECE 197,001,957920,Mercier; Patrick Philip,9991,0,9999,8
1746546113496,ECON 178,A01,907814,Zhu; Ying,26,0,35,9
1746546114521,EDS 115,A00,895312,Staff,36,0,45,9
1746546115547,EDS 117,A01,895337,Staff,24,0,30,6
1746546116574,EDS 125,A00,895341,Jones; Gabrielle Anastasia,37,0,45,8
1746546117602,EDS 128A,A01,895459,Fargason; Sharon Gayle,44,0,45,1
1746546118630,EDS 128B,A01,895543,Pappas; Elizabeth,44,0,45,1
1746546119655,EDS 139,A00,897203,Pappas; Elizabeth,44,0,45,1
1746546119655,EDS 139,B00,897209,Fargason; Sharon Gayle,41,0,45,4
1746546120684,EDS 201,A00,895545,Staff,23,0,45,22
1746546121709,EDS 203,A01,895581,Halter; Christopher P.,23,0,45,22
1746546122738,EDS 204R,A01,895625,Heinzman; Erica M.,39,0,45,6
1746546122738,EDS 204R,B01,895693,Halter; Christopher P.,10,0,45,35
1746546123765,EDS 206R,A00,895694,Fargason; Sharon Gayle,1,0,30,29
1746546123765,EDS 206R,B00,895695,Choi; Bailey Miyeon,16,0,30,14
1746546124792,EDS 250,A00,895697,Hemans; Patricia Ann Benitez,23,0,45,22
1746546125818,EDS 281,A00,895701,Meyerott; Theresa Ann,1,0,15,14
1746546126849,EDS 284,A00,895736,Meyerott; Theresa Ann,1,0,15,14
1746546127876,EDS 286,A00,897210,Fine; Sarah,0,0,15,15
1746546128902,EDS 289C,A01,895770,Daly; Alan J.,15,0,15,0
1746546129932,EDS 290,A00,897211,Hofstetter; Carolyn,0,0,15,15
1746546130956,LIGM 5A,A00,896162,Fischer-Grunski; Eva K,13,0,20,7
1746546131981,LIGM 5B,A00,896260,Fischer-Grunski; Eva K,17,0,20,3
1746546133009,LIGM 5C,A00,896308,Fischer-Grunski; Eva K,18,0,20,2
1746546134033,LIIT 5AS,A00,896313,Carnelos; Chiara,18,0,20,2
1746546135060,LIIT 5BS,A00,896416,Carnelos; Chiara,20,0,20,0
1746546136087,LIIT 5CS,A00,896564,Carnelos; Chiara,20,0,20,0
1746546137114,LISP 5A,A00,896588,Munoz Sanchez; Alicia,3,0,20,17
1746546138138,LISP 5B,A00,896653,Munoz Sanchez; Alicia,7,0,20,13
1746546139168,LISP 5C,A00,896655,Munoz Sanchez; Alicia,0,1,20,20
1746546140197,MAE 197,001,957918,Kleissl; Jan,9996,0,9999,3
1746546140197,MAE 197,002,959806,Boechler; Nicholas Sebastia,9998,0,9999,1
1746546140197,MAE 197,003,959852,Mullin; Jennifer S,9999,0,9999,0
1746546141225,MATH 2,A01,957937,Staff,33,0,35,2
1746546142256,MATH 197,001,957876,Kedlaya; Kiran S.,9993,0,9999,6
1746546143282,MCWP 40,A00,892729,Duru; Nur,10,0,20,10
1746546143282,MCWP 40,B00,893304,Montejo; Carolina,14,0,20,6
1746546144307,MCWP 40R,A00,893757,Redela; Pamela Morgan,0,5,20,20
1746546145334,MCWP 50,A00,893758,Morshed; Michael James,0,0,20,20
1746546145334,MCWP 50,B00,893761,Bartulis; Jason Michael,17,0,20,3
1746546146359,MCWP 50R,A00,893766,Compas; Sean Matthew,0,1,20,20
1746546146359,MCWP 50R,B00,893769,Carter; Jennifer A,0,1,20,20
1746546146359,MCWP 50R,C00,893771,Krone; Jarret,0,3,20,20
1746546146359,MCWP 50R,D00,893772,Miller; Elizabeth Deen,0,0,20,20
1746546146359,MCWP 50R,E00,893775,Carter; Andrea L,0,1,20,20
1746546147382,MMW 11R,A01,892721,Herbst; Matthew,11,0,27,16
1746546147382,MMW 11R,A02,892722,Herbst; Matthew,0,0,0,3
1746546148409,MMW 12R,A01,892724,Herbst; Matthew,0,11,16,16
1746546148409,MMW 12R,A02,892725,Herbst; Matthew,0,10,16,16
1746546149436,MMW 13R,A01,892727,Staff,0,4,16,16
1746546149436,MMW 13R,A02,892728,Staff,0,4,16,16
1746546149436,MMW 13R,A03,958032,Staff,0,4,16,16
1746546149436,MMW 13R,A04,958033,Staff,0,4,16,16
1746546149436,MMW 13R,A05,958034,Staff,0,4,16,16
1746546150463,SIO 295LS,A00,894015,Staff,5,0,25,20
1746546151490,SIO 295S,A00,894020,Staff,5,0,25,20
1746546152515,SIOC 290S,B01,958918,Merrifield; Mark A,14,0,30,16
1746546153545,SIOC 291S,B01,958922,Gabriel; Corey John,14,0,30,16
1746546154572,SOCI 117,A01,895339,Staff,3,0,5,2
1746546155598,WES 237B,A00,894149,Staff,11,0,20,9
1746546157657,AESE 279B,A00,891859,Staff,13,0,35,22
1746546158684,AIP 197,001,891854,Vespa; Emanuel Ignacio,9999,0,9999,0
1746546159730,ANTH 289S,A00,891856,Gagneux; Pascal,12,0,12,0
1746546160754,BENG 196,001,957946,Engler; Adam J.,9996,0,9999,3
1746546161780,BISP 197,001,959851,Wilhelm; James E.,9998,0,9999,1
1746546162804,CAT 124RS,A01,956906,Staff,6,0,25,19
1746546163829,CAT 125RS,A01,922013,Staff,6,0,25,19
1746546164854,CLRE 250,A00,891860,Morris; Sheldon,9995,0,9999,4
1746546166903,CLRE 251R,A00,907817,Mehta; Ravindra L.,9994,0,9999,5
1746546167930,CLRE 252,A00,891864,Cuomo; Raphael Eduardo,9993,0,9999,6
1746546168966,CLRE 253,A00,891867,Vaida; Florin,9994,0,9999,5
1746546168966,CLRE 253,B00,907819,Staff,9999,0,9999,0
1746546170000,CLRE 259,A00,891868,Patel; Hemal,9998,0,9999,1
1746546171023,CLRE 260,A00,891872,Cuomo; Raphael Eduardo,9999,0,9999,0
1746546172048,CLRE 297,001,891888,Cuomo; Raphael Eduardo,9999,0,9999,0
1746546173076,CSE 191,A00,958773,Minnes Kemp; Mor Mia,9996,0,9999,3
1746546174101,CSE 197,001,959846,Minnes Kemp; Mor Mia,9990,0,9999,9
1746546175127,CSS 201S,A01,892054,Mignozzetti; Umberto,26,0,30,4
1746546176156,CSS 202S,A01,892056,Mignozzetti; Umberto,26,0,30,4
1746546177181,DSC 197,001,956898,Eldridge; Justin Matthew,9998,0,9999,1
1746546178208,DSC 297,001,958000,Mazumdar; Arya,9998,0,9999,1
1746546178208,DSC 297,002,959862,Wang; Yusu,9999,0,9999,0
1746546179251,EAP 100,A00,905686,Staff,9778,0,9999,221
1746546180280,ECE 45,A01,892618,Staff,0,0,65,65
1746546182335,ECE 111,A01,892719,Staff,4,0,65,61
1746546183361,ECE 197,001,957920,Mercier; Patrick Philip,9991,0,9999,8
1746546184389,ECON 178,A01,907814,Zhu; Ying,26,0,35,9
1746546185418,EDS 115,A00,895312,Staff,36,0,45,9
1746546186443,EDS 117,A01,895337,Staff,24,0,30,6
1746546187469,EDS 125,A00,895341,Jones; Gabrielle Anastasia,37,0,45,8
1746546188498,EDS 128A,A01,895459,Fargason; Sharon Gayle,44,0,45,1
1746546189523,EDS 128B,A01,895543,Pappas; Elizabeth,44,0,45,1
1746546190550,EDS 139,A00,897203,Pappas; Elizabeth,44,0,45,1
1746546190550,EDS 139,B00,897209,Fargason; Sharon Gayle,41,0,45,4
1746546191576,EDS 201,A00,895545,Staff,23,0,45,22
1746546192604,EDS 203,A01,895581,Halter; Christopher P.,23,0,45,22
1746546193629,EDS 204R,A01,895625,Heinzman; Erica M.,39,0,45,6
1746546193629,EDS 204R,B01,895693,Halter; Christopher P.,10,0,45,35
1746546194655,EDS 206R,A00,895694,Fargason; Sharon Gayle,1,0,30,29
1746546194655,EDS 206R,B00,895695,Choi; Bailey Miyeon,16,0,30,14
1746546195683,EDS 250,A00,895697,Hemans; Patricia Ann Benitez,23,0,45,22
1746546196708,EDS 281,A00,895701,Meyerott; Theresa Ann,1,0,15,14
1746546197735,EDS 284,A00,895736,Meyerott; Theresa Ann,1,0,15,14
1746546198761,EDS 286,A00,897210,Fine; Sarah,0,0,15,15
1746546199788,EDS 289C,A01,895770,Daly; Alan J.,15,0,15,0
1746546200815,EDS 290,A00,897211,Hofstetter; Carolyn,0,0,15,15
1746546201842,LIGM 5A,A00,896162,Fischer-Grunski; Eva K,13,0,20,7
1746546202868,LIGM 5B,A00,896260,Fischer-Grunski; Eva K,17,0,20,3
1746546203894,LIGM 5C,A00,896308,Fischer-Grunski; Eva K,18,0,20,2
1746546204924,LIIT 5AS,A00,896313,Carnelos; Chiara,18,0,20,2
1746546205952,LIIT 5BS,A00,896416,Carnelos; Chiara,20,0,20,0
1746546206976,LIIT 5CS,A00,896564,Carnelos; Chiara,20,0,20,0
1746546208001,LISP 5A,A00,896588,Munoz Sanchez; Alicia,3,0,20,17
1746546209028,LISP 5B,A00,896653,Munoz Sanchez; Alicia,7,0,20,13
1746546210056,LISP 5C,A00,896655,Munoz Sanchez; Alicia,0,1,20,20
1746546211083,MAE 197,001,957918,Kleissl; Jan,9996,0,9999,3
1746546211083,MAE 197,002,959806,Boechler; Nicholas Sebastia,9998,0,9999,1
1746546211083,MAE 197,003,959852,Mullin; Jennifer S,9999,0,9999,0
1746546212110,MATH 2,A01,957937,Staff,33,0,35,2
1746546213135,MATH 197,001,957876,Kedlaya; Kiran S.,9993,0,9999,6
1746546214161,MCWP 40,A00,892729,Duru; Nur,10,0,20,10
1746546214161,MCWP 40,B00,893304,Montejo; Carolina,14,0,20,6
1746546215190,MCWP 40R,A00,893757,Redela; Pamela Morgan,0,5,20,20
1746546216217,MCWP 50,A00,893758,Morshed; Michael James,0,0,20,20
1746546216217,MCWP 50,B00,893761,Bartulis; Jason Michael,17,0,20,3
1746546217246,MCWP 50R,A00,893766,Compas; Sean Matthew,0,1,20,20
1746546217246,MCWP 50R,B00,893769,Carter; Jennifer A,0,1,20,20
1746546217246,MCWP 50R,C00,893771,Krone; Jarret,0,3,20,20
1746546217246,MCWP 50R,D00,893772,Miller; Elizabeth Deen,0,0,20,20
1746546217246,MCWP 50R,E00,893775,Carter; Andrea L,0,1,20,20
1746546218275,MMW 11R,A01,892721,Herbst; Matthew,11,0,27,16
1746546218275,MMW 11R,A02,892722,Herbst; Matthew,0,0,0,3
1746546219300,MMW 12R,A01,892724,Herbst; Matthew,0,11,16,16
1746546219300,MMW 12R,A02,892725,Herbst; Matthew,0,10,16,16
1746546220325,MMW 13R,A01,892727,Staff,0,4,16,16
1746546220325,MMW 13R,A02,892728,Staff,0,4,16,16
1746546220325,MMW 13R,A03,958032,Staff,0,4,16,16
1746546220325,MMW 13R,A04,958033,Staff,0,4,16,16
1746546220325,MMW 13R,A05,958034,Staff,0,4,16,16
1746546221355,SIO 295LS,A00,894015,Staff,5,0,25,20
1746546222385,SIO 295S,A00,894020,Staff,5,0,25,20
1746546223412,SIOC 290S,B01,958918,Merrifield; Mark A,14,0,30,16
1746546224439,SIOC 291S,B01,958922,Gabriel; Corey John,14,0,30,16
1746546225465,SOCI 117,A01,895339,Staff,3,0,5,2
1746546226492,WES 237B,A00,894149,Staff,11,0,20,9
1746546228552,AESE 279B,A00,891859,Staff,13,0,35,22
1746546229575,AIP 197,001,891854,Vespa; Emanuel Ignacio,9999,0,9999,0
1746546230603,ANTH 289S,A00,891856,Gagneux; Pascal,12,0,12,0
1746546231628,BENG 196,001,957946,Engler; Adam J.,9996,0,9999,3
1746546232651,BISP 197,001,959851,Wilhelm; James E.,9998,0,9999,1
1746546233677,CAT 124RS,A01,956906,Staff,6,0,25,19
1746546234707,CAT 125RS,A01,922013,Staff,6,0,25,19
1746546235735,CLRE 250,A00,891860,Morris; Sheldon,9995,0,9999,4
1746546237786,CLRE 251R,A00,907817,Mehta; Ravindra L.,9994,0,9999,5
1746546238813,CLRE 252,A00,891864,Cuomo; Raphael Eduardo,9993,0,9999,6
1746546239842,CLRE 253,A00,891867,Vaida; Florin,9994,0,9999,5
1746546239842,CLRE 253,B00,907819,Staff,9999,0,9999,0
1746546240870,CLRE 259,A00,891868,Patel; Hemal,9998,0,9999,1
1746546241893,CLRE 260,A00,891872,Cuomo; Raphael Eduardo,9999,0,9999,0
1746546242918,CLRE 297,001,891888,Cuomo; Raphael Eduardo,9999,0,9999,0
1746546243945,CSE 191,A00,958773,Minnes Kemp; Mor Mia,9996,0,9999,3
1746546244970,CSE 197,001,959846,Minnes Kemp; Mor Mia,9990,0,9999,9
1746546246000,CSS 201S,A01,892054,Mignozzetti; Umberto,26,0,30,4
1746546247026,CSS 202S,A01,892056,Mignozzetti; Umberto,26,0,30,4
1746546248052,DSC 197,001,956898,Eldridge; Justin Matthew,9998,0,9999,1
1746546249081,DSC 297,001,958000,Mazumdar; Arya,9998,0,9999,1
1746546249081,DSC 297,002,959862,Wang; Yusu,9999,0,9999,0
1746546250109,EAP 100,A00,905686,Staff,9778,0,9999,221
1746546251137,ECE 45,A01,892618,Staff,0,0,65,65
1746546253189,ECE 111,A01,892719,Staff,4,0,65,61
1746546254218,ECE 197,001,957920,Mercier; Patrick Philip,9991,0,9999,8
1746546255243,ECON 178,A01,907814,Zhu; Ying,26,0,35,9
1746546256270,EDS 115,A00,895312,Staff,36,0,45,9
1746546257298,EDS 117,A01,895337,Staff,24,0,30,6
1746546258328,EDS 125,A00,895341,Jones; Gabrielle Anastasia,37,0,45,8
1746546259352,EDS 128A,A01,895459,Fargason; Sharon Gayle,44,0,45,1
1746546260380,EDS 128B,A01,895543,Pappas; Elizabeth,44,0,45,1
1746546261407,EDS 139,A00,897203,Pappas; Elizabeth,44,0,45,1
1746546261407,EDS 139,B00,897209,Fargason; Sharon Gayle,41,0,45,4
1746546262432,EDS 201,A00,895545,Staff,23,0,45,22
1746546263457,EDS 203,A01,895581,Halter; Christopher P.,23,0,45,22
1746546264483,EDS 204R,A01,895625,Heinzman; Erica M.,39,0,45,6
1746546264483,EDS 204R,B01,895693,Halter; Christopher P.,10,0,45,35
1746546265509,EDS 206R,A00,895694,Fargason; Sharon Gayle,1,0,30,29
1746546265509,EDS 206R,B00,895695,Choi; Bailey Miyeon,16,0,30,14
1746546266540,EDS 250,A00,895697,Hemans; Patricia Ann Benitez,23,0,45,22
1746546267568,EDS 281,A00,895701,Meyerott; Theresa Ann,1,0,15,14
1746546268593,EDS 284,A00,895736,Meyerott; Theresa Ann,1,0,15,14
1746546269618,EDS 286,A00,897210,Fine; Sarah,0,0,15,15
1746546270644,EDS 289C,A01,895770,Daly; Alan J.,15,0,15,0
1746546271672,EDS 290,A00,897211,Hofstetter; Carolyn,0,0,15,15
1746546272701,LIGM 5A,A00,896162,Fischer-Grunski; Eva K,13,0,20,7
1746546273729,LIGM 5B,A00,896260,Fischer-Grunski; Eva K,17,0,20,3
1746546274756,LIGM 5C,A00,896308,Fischer-Grunski; Eva K,18,0,20,2
1746546275785,LIIT 5AS,A00,896313,Carnelos; Chiara,18,0,20,2
1746546276808,LIIT 5BS,A00,896416,Carnelos; Chiara,20,0,20,0
1746546277833,LIIT 5CS,A00,896564,Carnelos; Chiara,20,0,20,0
1746546278857,LISP 5A,A00,896588,Munoz Sanchez; Alicia,3,0,20,17
1746546279882,LISP 5B,A00,896653,Munoz Sanchez; Alicia,7,0,20,13
1746546280910,LISP 5C,A00,896655,Munoz Sanchez; Alicia,0,1,20,20
1746546281937,MAE 197,001,957918,Kleissl; Jan,9996,0,9999,3
1746546281937,MAE 197,002,959806,Boechler; Nicholas Sebastia,9998,0,9999,1
1746546281937,MAE 197,003,959852,Mullin; Jennifer S,9999,0,9999,0
1746546282965,MATH 2,A01,957937,Staff,33,0,35,2
1746546283989,MATH 197,001,957876,Kedlaya; Kiran S.,9993,0,9999,6
1746546285015,MCWP 40,A00,892729,Duru; Nur,10,0,20,10
1746546285015,MCWP 40,B00,893304,Montejo; Carolina,14,0,20,6
1746546286042,MCWP 40R,A00,893757,Redela; Pamela Morgan,0,5,20,20
1746546287071,MCWP 50,A00,893758,Morshed; Michael James,0,0,20,20
1746546287071,MCWP 50,B00,893761,Bartulis; Jason Michael,17,0,20,3
1746546288097,MCWP 50R,A00,893766,Compas; Sean Matthew,0,1,20,20
1746546288097,MCWP 50R,B00,893769,Carter; Jennifer A,0,1,20,20
1746546288097,MCWP 50R,C00,893771,Krone; Jarret,0,3,20,20
1746546288097,MCWP 50R,D00,893772,Miller; Elizabeth Deen,0,0,20,20
1746546288097,MCWP 50R,E00,893775,Carter; Andrea L,0,1,20,20
1746546289125,MMW 11R,A01,892721,Herbst; Matthew,11,0,27,16
1746546289125,MMW 11R,A02,892722,Herbst; Matthew,0,0,0,3
1746546290152,MMW 12R,A01,892724,Herbst; Matthew,0,11,16,16
1746546290152,MMW 12R,A02,892725,Herbst; Matthew,0,10,16,16
1746546291180,MMW 13R,A01,892727,Staff,0,4,16,16
1746546291180,MMW 13R,A02,892728,Staff,0,4,16,16
1746546291180,MMW 13R,A03,958032,Staff,0,4,16,16
1746546291180,MMW 13R,A04,958033,Staff,0,4,16,16
1746546291180,MMW 13R,A05,958034,Staff,0,4,16,16
1746546292208,SIO 295LS,A00,894015,Staff,5,0,25,20
1746546293236,SIO 295S,A00,894020,Staff,5,0,25,20
1746546294265,SIOC 290S,B01,958918,Merrifield; Mark A,14,0,30,16
1746546295289,SIOC 291S,B01,958922,Gabriel; Corey John,14,0,30,16
1746546296317,SOCI 117,A01,895339,Staff,3,0,5,2
1746546297342,WES 237B,A00,894149,Staff,11,0,20,9
1746546299401,AESE 279B,A00,891859,Staff,13,0,35,22
1746546300425,AIP 197,001,891854,Vespa; Emanuel Ignacio,9999,0,9999,0
1746546301450,ANTH 289S,A00,891856,Gagneux; Pascal,12,0,12,0
1746546302475,BENG 196,001,957946,Engler; Adam J.,9996,0,9999,3
1746546303501,BISP 197,001,959851,Wilhelm; James E.,9998,0,9999,1
1746546304527,CAT 124RS,A01,956906,Staff,6,0,25,19
1746546305554,CAT 125RS,A01,922013,Staff,6,0,25,19
1746546306580,CLRE 250,A00,891860,Morris; Sheldon,9995,0,9999,4
1746546308634,CLRE 251R,A00,907817,Mehta; Ravindra L.,9994,0,9999,5
1746546309658,CLRE 252,A00,891864,Cuomo; Raphael Eduardo,9993,0,9999,6
1746546310684,CLRE 253,A00,891867,Vaida; Florin,9994,0,9999,5
1746546310684,CLRE 253,B00,907819,Staff,9999,0,9999,0
1746546311709,CLRE 259,A00,891868,Patel; Hemal,9998,0,9999,1
1746546312735,CLRE 260,A00,891872,Cuomo; Raphael Eduardo,9999,0,9999,0
1746546313761,CLRE 297,001,891888,Cuomo; Raphael Eduardo,9999,0,9999,0
1746546314787,CSE 191,A00,958773,Minnes Kemp; Mor Mia,9996,0,9999,3
1746546315813,CSE 197,001,959846,Minnes Kemp; Mor Mia,9990,0,9999,9
1746546316838,CSS 201S,A01,892054,Mignozzetti; Umberto,26,0,30,4
1746546317865,CSS 202S,A01,892056,Mignozzetti; Umberto,26,0,30,4
1746546318892,DSC 197,001,956898,Eldridge; Justin Matthew,9998,0,9999,1
1746546319919,DSC 297,001,958000,Mazumdar; Arya,9998,0,9999,1
1746546319919,DSC 297,002,959862,Wang; Yusu,9999,0,9999,0
1746546320944,EAP 100,A00,905686,Staff,9778,0,9999,221
1746546321968,ECE 45,A01,892618,Staff,0,0,65,65
1746546324016,ECE 111,A01,892719,Staff,4,0,65,61
1746546325044,ECE 197,001,957920,Mercier; Patrick Philip,9991,0,9999,8
1746546326070,ECON 178,A01,907814,Zhu; Ying,26,0,35,9
1746546327097,EDS 115,A00,895312,Staff,36,0,45,9
1746546328123,EDS 117,A01,895337,Staff,24,0,30,6
1746546329149,EDS 125,A00,895341,Jones; Gabrielle Anastasia,37,0,45,8
1746546330174,EDS 128A,A01,895459,Fargason; Sharon Gayle,44,0,45,1
1746546331199,EDS 128B,A01,895543,Pappas; Elizabeth,44,0,45,1
1746546332223,EDS 139,A00,897203,Pappas; Elizabeth,44,0,45,1
1746546332223,EDS 139,B00,897209,Fargason; Sharon Gayle,41,0,45,4
1746546333250,EDS 201,A00,895545,Staff,23,0,45,22
1746546334274,EDS 203,A01,895581,Halter; Christopher P.,23,0,45,22
1746546335299,EDS 204R,A01,895625,Heinzman; Erica M.,39,0,45,6
1746546335299,EDS 204R,B01,895693,Halter; Christopher P.,10,0,45,35
1746546336326,EDS 206R,A00,895694,Fargason; Sharon Gayle,1,0,30,29
1746546336326,EDS 206R,B00,895695,Choi; Bailey Miyeon,16,0,30,14
1746546337353,EDS 250,A00,895697,Hemans; Patricia Ann Benitez,23,0,45,22
1746546338381,EDS 281,A00,895701,Meyerott; Theresa Ann,1,0,15,14
1746546339405,EDS 284,A00,895736,Meyerott; Theresa Ann,1,0,15,14
1746546340433,EDS 286,A00,897210,Fine; Sarah,0,0,15,15
1746546341458,EDS 289C,A01,895770,Daly; Alan J.,15,0,15,0
1746546342482,EDS 290,A00,897211,Hofstetter; Carolyn,0,0,15,15
1746546343506,LIGM 5A,A00,896162,Fischer-Grunski; Eva K,13,0,20,7
1746546344531,LIGM 5B,A00,896260,Fischer-Grunski; Eva K,17,0,20,3
1746546345558,LIGM 5C,A00,896308,Fischer-Grunski; Eva K,18,0,20,2
1746546346585,LIIT 5AS,A00,896313,Carnelos; Chiara,18,0,20,2
1746546347610,LIIT 5BS,A00,896416,Carnelos; Chiara,20,0,20,0
1746546348637,LIIT 5CS,A00,896564,Carnelos; Chiara,20,0,20,0
1746546349660,LISP 5A,A00,896588,Munoz Sanchez; Alicia,3,0,20,17
1746546350744,LISP 5B,A00,896653,Munoz Sanchez; Alicia,7,0,20,13
1746546351769,LISP 5C,A00,896655,Munoz Sanchez; Alicia,0,1,20,20
1746546352793,MAE 197,001,957918,Kleissl; Jan,9996,0,9999,3
1746546352793,MAE 197,002,959806,Boechler; Nicholas Sebastia,9998,0,9999,1
1746546352793,MAE 197,003,959852,Mullin; Jennifer S,9999,0,9999,0
1746546354022,MATH 2,A01,957937,Staff,33,0,35,2
1746546355050,MATH 197,001,957876,Kedlaya; Kiran S.,9993,0,9999,6
1746546356076,MCWP 40,A00,892729,Duru; Nur,10,0,20,10
1746546356076,MCWP 40,B00,893304,Montejo; Carolina,14,0,20,6
1746546357103,MCWP 40R,A00,893757,Redela; Pamela Morgan,0,5,20,20
1746546358128,MCWP 50,A00,893758,Morshed; Michael James,0,0,20,20
1746546358128,MCWP 50,B00,893761,Bartulis; Jason Michael,17,0,20,3
1746546359159,MCWP 50R,A00,893766,Compas; Sean Matthew,0,1,20,20
1746546359159,MCWP 50R,B00,893769,Carter; Jennifer A,0,1,20,20
1746546359159,MCWP 50R,C00,893771,Krone; Jarret,0,3,20,20
1746546359159,MCWP 50R,D00,893772,Miller; Elizabeth Deen,0,0,20,20
1746546359159,MCWP 50R,E00,893775,Carter; Andrea L,0,1,20,20
1746546360191,MMW 11R,A01,892721,Herbst; Matthew,11,0,27,16
1746546360191,MMW 11R,A02,892722,Herbst; Matthew,0,0,0,3
1746546361215,MMW 12R,A01,892724,Herbst; Matthew,0,11,16,16
1746546361215,MMW 12R,A02,892725,Herbst; Matthew,0,10,16,16
1746546362243,MMW 13R,A01,892727,Staff,0,4,16,16
1746546362243,MMW 13R,A02,892728,Staff,0,4,16,16
1746546362243,MMW 13R,A03,958032,Staff,0,4,16,16
1746546362243,MMW 13R,A04,958033,Staff,0,4,16,16
1746546362243,MMW 13R,A05,958034,Staff,0,4,16,16
1746546363269,SIO 295LS,A00,894015,Staff,5,0,25,20
1746546364293,SIO 295S,A00,894020,Staff,5,0,25,20
1746546365323,SIOC 290S,B01,958918,Merrifield; Mark A,14,0,30,16
1746546366356,SIOC 291S,B01,958922,Gabriel; Corey John,14,0,30,16
1746546367380,SOCI 117,A01,895339,Staff,3,0,5,2
1746546368405,WES 237B,A00,894149,Staff,11,0,20,9
1746546370474,AESE 279B,A00,891859,Staff,13,0,35,22
1746546371498,AIP 197,001,891854,Vespa; Emanuel Ignacio,9999,0,9999,0
1746546372525,ANTH 289S,A00,891856,Gagneux; Pascal,12,0,12,0
1746546373553,BENG 196,001,957946,Engler; Adam J.,9996,0,9999,3
1746546374577,BISP 197,001,959851,Wilhelm; James E.,9998,0,9999,1
1746546375601,CAT 124RS,A01,956906,Staff,6,0,25,19
1746546376627,CAT 125RS,A01,922013,Staff,6,0,25,19
1746546377651,CLRE 250,A00,891860,Morris; Sheldon,9995,0,9999,4
1746546379707,CLRE 251R,A00,907817,Mehta; Ravindra L.,9994,0,9999,5
1746546380731,CLRE 252,A00,891864,Cuomo; Raphael Eduardo,9993,0,9999,6
1746546381757,CLRE 253,A00,891867,Vaida; Florin,9994,0,9999,5
1746546381757,CLRE 253,B00,907819,Staff,9999,0,9999,0
1746546382781,CLRE 259,A00,891868,Patel; Hemal,9998,0,9999,1
1746546383807,CLRE 260,A00,891872,Cuomo; Raphael Eduardo,9999,0,9999,0
1746546384834,CLRE 297,001,891888,Cuomo; Raphael Eduardo,9999,0,9999,0
1746546385860,CSE 191,A00,958773,Minnes Kemp; Mor Mia,9996,0,9999,3
1746546386889,CSE 197,001,959846,Minnes Kemp; Mor Mia,9990,0,9999,9
1746546387919,CSS 201S,A01,892054,Mignozzetti; Umberto,26,0,30,4
1746546388945,CSS 202S,A01,892056,Mignozzetti; Umberto,26,0,30,4
1746546389971,DSC 197,001,956898,Eldridge; Justin Matthew,9998,0,9999,1
1746546390998,DSC 297,001,958000,Mazumdar; Arya,9998,0,9999,1
1746546390998,DSC 297,002,959862,Wang; Yusu,9999,0,9999,0
1746546392024,EAP 100,A00,905686,Staff,9778,0,9999,221
1746546393048,ECE 45,A01,892618,Staff,0,0,65,65
1746546395099,ECE 111,A01,892719,Staff,4,0,65,61
1746546396124,ECE 197,001,957920,Mercier; Patrick Philip,9991,0,9999,8
1746546397153,ECON 178,A01,907814,Zhu; Ying,26,0,35,9
1746546398179,EDS 115,A00,895312,Staff,36,0,45,9
1746546399205,EDS 117,A01,895337,Staff,24,0,30,6
1746546400229,EDS 125,A00,895341,Jones; Gabrielle Anastasia,37,0,45,8
1746546401257,EDS 128A,A01,895459,Fargason; Sharon Gayle,44,0,45,1
1746546402283,EDS 128B,A01,895543,Pappas; Elizabeth,44,0,45,1
1746546403313,EDS 139,A00,897203,Pappas; Elizabeth,44,0,45,1
1746546403313,EDS 139,B00,897209,Fargason; Sharon Gayle,41,0,45,4
1746546404338,EDS 201,A00,895545,Staff,23,0,45,22
1746546405362,EDS 203,A01,895581,Halter; Christopher P.,23,0,45,22
1746546406389,EDS 204R,A01,895625,Heinzman; Erica M.,39,0,45,6
1746546406389,EDS 204R,B01,895693,Halter; Christopher P.,10,0,45,35
1746546407414,EDS 206R,A00,895694,Fargason; Sharon Gayle,1,0,30,29
1746546407414,EDS 206R,B00,895695,Choi; Bailey Miyeon,16,0,30,14
1746546408439,EDS 250,A00,895697,Hemans; Patricia Ann Benitez,23,0,45,22
1746546409467,EDS 281,A00,895701,Meyerott; Theresa Ann,1,0,15,14
1746546410491,EDS 284,A00,895736,Meyerott; Theresa Ann,1,0,15,14
1746546411515,EDS 286,A00,897210,Fine; Sarah,0,0,15,15
1746546412543,EDS 289C,A01,895770,Daly; Alan J.,15,0,15,0
1746546413568,EDS 290,A00,897211,Hofstetter; Carolyn,0,0,15,15
1746546414594,LIGM 5A,A00,896162,Fischer-Grunski; Eva K,13,0,20,7
1746546415621,LIGM 5B,A00,896260,Fischer-Grunski; Eva K,17,0,20,3
1746546416645,LIGM 5C,A00,896308,Fischer-Grunski; Eva K,18,0,20,2
1746546417671,LIIT 5AS,A00,896313,Carnelos; Chiara,18,0,20,2
1746546418699,LIIT 5BS,A00,896416,Carnelos; Chiara,20,0,20,0
1746546419724,LIIT 5CS,A00,896564,Carnelos; Chiara,20,0,20,0
1746546420753,LISP 5A,A00,896588,Munoz Sanchez; Alicia,3,0,20,17
1746546422325,LISP 5B,A00,896653,Munoz Sanchez; Alicia,7,0,20,13
1746546423353,LISP 5C,A00,896655,Munoz Sanchez; Alicia,0,1,20,20
1746546424378,MAE 197,001,957918,Kleissl; Jan,9996,0,9999,3
1746546424378,MAE 197,002,959806,Boechler; Nicholas Sebastia,9998,0,9999,1
1746546424378,MAE 197,003,959852,Mullin; Jennifer S,9999,0,9999,0
1746546425402,MATH 2,A01,957937,Staff,33,0,35,2
1746546426429,MATH 197,001,957876,Kedlaya; Kiran S.,9993,0,9999,6
1746546427457,MCWP 40,A00,892729,Duru; Nur,10,0,20,10
1746546427457,MCWP 40,B00,893304,Montejo; Carolina,14,0,20,6
1746546428485,MCWP 40R,A00,893757,Redela; Pamela Morgan,0,5,20,20
1746546429513,MCWP 50,A00,893758,Morshed; Michael James,0,0,20,20
1746546429513,MCWP 50,B00,893761,Bartulis; Jason Michael,17,0,20,3
1746546430539,MCWP 50R,A00,893766,Compas; Sean Matthew,0,1,20,20
1746546430539,MCWP 50R,B00,893769,Carter; Jennifer A,0,1,20,20
1746546430539,MCWP 50R,C00,893771,Krone; Jarret,0,3,20,20
1746546430539,MCWP 50R,D00,893772,Miller; Elizabeth Deen,0,0,20,20
1746546430539,MCWP 50R,E00,893775,Carter; Andrea L,0,1,20,20
1746546431568,MMW 11R,A01,892721,Herbst; Matthew,11,0,27,16
1746546431568,MMW 11R,A02,892722,Herbst; Matthew,0,0,0,3
1746546432593,MMW 12R,A01,892724,Herbst; Matthew,0,11,16,16
1746546432593,MMW 12R,A02,892725,Herbst; Matthew,0,10,16,16
1746546433617,MMW 13R,A01,892727,Staff,0,4,16,16
1746546433617,MMW 13R,A02,892728,Staff,0,4,16,16
1746546433617,MMW 13R,A03,958032,Staff,0,4,16,16
1746546433617,MMW 13R,A04,958033,Staff,0,4,16,16
1746546433617,MMW 13R,A05,958034,Staff,0,4,16,16
1746546434644,SIO 295LS,A00,894015,Staff,5,0,25,20
1746546435672,SIO 295S,A00,894020,Staff,5,0,25,20
1746546436698,SIOC 290S,B01,958918,Merrifield; Mark A,14,0,30,16
1746546437726,SIOC 291S,B01,958922,Gabriel; Corey John,14,0,30,16
1746546438753,SOCI 117,A01,895339,Staff,3,0,5,2
1746546439781,WES 237B,A00,894149,Staff,11,0,20,9
1746546441843,AESE 279B,A00,891859,Staff,13,0,35,22
1746546442869,AIP 197,001,891854,Vespa; Emanuel Ignacio,9999,0,9999,0
1746546443894,ANTH 289S,A00,891856,Gagneux; Pascal,12,0,12,0
1746546444920,BENG 196,001,957946,Engler; Adam J.,9996,0,9999,3
1746546445947,BISP 197,001,959851,Wilhelm; James E.,9998,0,9999,1
1746546446971,CAT 124RS,A01,956906,Staff,6,0,25,19
1746546447996,CAT 125RS,A01,922013,Staff,6,0,25,19
1746546449020,CLRE 250,A00,891860,Morris; Sheldon,9995,0,9999,4
1746546451068,CLRE 251R,A00,907817,Mehta; Ravindra L.,9994,0,9999,5
1746546452093,CLRE 252,A00,891864,Cuomo; Raphael Eduardo,9993,0,9999,6
1746546453117,CLRE 253,A00,891867,Vaida; Florin,9994,0,9999,5
1746546453117,CLRE 253,B00,907819,Staff,9999,0,9999,0
1746546454142,CLRE 259,A00,891868,Patel; Hemal,9998,0,9999,1
1746546455205,CLRE 260,A00,891872,Cuomo; Raphael Eduardo,9999,0,9999,0
1746546456230,CLRE 297,001,891888,Cuomo; Raphael Eduardo,9999,0,9999,0
1746546457255,CSE 191,A00,958773,Minnes Kemp; Mor Mia,9996,0,9999,3
1746546458282,CSE 197,001,959846,Minnes Kemp; Mor Mia,9990,0,9999,9
1746546459307,CSS 201S,A01,892054,Mignozzetti; Umberto,26,0,30,4
1746546460330,CSS 202S,A01,892056,Mignozzetti; Umberto,26,0,30,4
1746546461356,DSC 197,001,956898,Eldridge; Justin Matthew,9998,0,9999,1
1746546462379,DSC 297,001,958000,Mazumdar; Arya,9998,0,9999,1
1746546462379,DSC 297,002,959862,Wang; Yusu,9999,0,9999,0
1746546463404,EAP 100,A00,905686,Staff,9778,0,9999,221
1746546464433,ECE 45,A01,892618,Staff,0,0,65,65
1746546466482,ECE 111,A01,892719,Staff,4,0,65,61
1746546467510,ECE 197,001,957920,Mercier; Patrick Philip,9991,0,9999,8
1746546468536,ECON 178,A01,907814,Zhu; Ying,26,0,35,9
1746546469563,EDS 115,A00,895312,Staff,36,0,45,9
1746546470588,EDS 117,A01,895337,Staff,24,0,30,6
1746546471616,EDS 125,A00,895341,Jones; Gabrielle Anastasia,37,0,45,8
1746546472640,EDS 128A,A01,895459,Fargason; Sharon Gayle,44,0,45,1
1746546473669,EDS 128B,A01,895543,Pappas; Elizabeth,44,0,45,1
1746546474694,EDS 139,A00,897203,Pappas; Elizabeth,44,0,45,1
1746546474694,EDS 139,B00,897209,Fargason; Sharon Gayle,41,0,45,4
1746546475720,EDS 201,A00,895545,Staff,23,0,45,22
1746546476745,EDS 203,A01,895581,Halter; Christopher P.,23,0,45,22
1746546477769,EDS 204R,A01,895625,Heinzman; Erica M.,39,0,45,6
1746546477769,EDS 204R,B01,895693,Halter; Christopher P.,10,0,45,35
1746546478794,EDS 206R,A00,895694,Fargason; Sharon Gayle,1,0,30,29
1746546478794,EDS 206R,B00,895695,Choi; Bailey Miyeon,16,0,30,14
1746546479820,EDS 250,A00,895697,Hemans; Patricia Ann Benitez,23,0,45,22
1746546480847,EDS 281,A00,895701,Meyerott; Theresa Ann,1,0,15,14
1746546481871,EDS 284,A00,895736,Meyerott; Theresa Ann,1,0,15,14
1746546482898,EDS 286,A00,897210,Fine; Sarah,0,0,15,15
1746546483925,EDS 289C,A01,895770,Daly; Alan J.,15,0,15,0
1746546484954,EDS 290,A00,897211,Hofstetter; Carolyn,0,0,15,15
1746546485984,LIGM 5A,A00,896162,Fischer-Grunski; Eva K,13,0,20,7
1746546487013,LIGM 5B,A00,896260,Fischer-Grunski; Eva K,17,0,20,3
1746546488040,LIGM 5C,A00,896308,Fischer-Grunski; Eva K,18,0,20,2
1746546489064,LIIT 5AS,A00,896313,Carnelos; Chiara,18,0,20,2
1746546490135,LIIT 5BS,A00,896416,Carnelos; Chiara,20,0,20,0
1746546491165,LIIT 5CS,A00,896564,Carnelos; Chiara,20,0,20,0
1746546492191,LISP 5A,A00,896588,Munoz Sanchez; Alicia,3,0,20,17
1746546493219,LISP 5B,A00,896653,Munoz Sanchez; Alicia,7,0,20,13
1746546494245,LISP 5C,A00,896655,Munoz Sanchez; Alicia,0,1,20,20
1746546495273,MAE 197,001,957918,Kleissl; Jan,9996,0,9999,3
1746546495273,MAE 197,002,959806,Boechler; Nicholas Sebastia,9998,0,9999,1
1746546495273,MAE 197,003,959852,Mullin; Jennifer S,9999,0,9999,0
1746546496297,MATH 2,A01,957937,Staff,33,0,35,2
1746546497324,MATH 197,001,957876,Kedlaya; Kiran S.,9993,0,9999,6
1746546498354,MCWP 40,A00,892729,Duru; Nur,10,0,20,10
1746546498354,MCWP 40,B00,893304,Montejo; Carolina,14,0,20,6
1746546499378,MCWP 40R,A00,893757,Redela; Pamela Morgan,0,5,20,20
1746546500404,MCWP 50,A00,893758,Morshed; Michael James,0,0,20,20
1746546500404,MCWP 50,B00,893761,Bartulis; Jason Michael,17,0,20,3
1746546501430,MCWP 50R,A00,893766,Compas; Sean Matthew,0,1,20,20
1746546501430,MCWP 50R,B00,893769,Carter; Jennifer A,0,1,20,20
1746546501430,MCWP 50R,C00,893771,Krone; Jarret,0,3,20,20
1746546501430,MCWP 50R,D00,893772,Miller; Elizabeth Deen,0,0,20,20
1746546501430,MCWP 50R,E00,893775,Carter; Andrea L,0,1,20,20
1746546502461,MMW 11R,A01,892721,Herbst; Matthew,11,0,27,16
1746546502461,MMW 11R,A02,892722,Herbst; Matthew,0,0,0,3
1746546503490,MMW 12R,A01,892724,Herbst; Matthew,0,11,16,16
1746546503490,MMW 12R,A02,892725,Herbst; Matthew,0,10,16,16
1746546504516,MMW 13R,A01,892727,Staff,0,4,16,16
1746546504516,MMW 13R,A02,892728,Staff,0,4,16,16
1746546504516,MMW 13R,A03,958032,Staff,0,4,16,16
1746546504516,MMW 13R,A04,958033,Staff,0,4,16,16
1746546504516,MMW 13R,A05,958034,Staff,0,4,16,16
1746546505540,SIO 295LS,A00,894015,Staff,5,0,25,20
1746546506572,SIO 295S,A00,894020,Staff,5,0,25,20
1746546507600,SIOC 290S,B01,958918,Merrifield; Mark A,14,0,30,16
1746546508629,SIOC 291S,B01,958922,Gabriel; Corey John,14,0,30,16
1746546509652,SOCI 117,A01,895339,Staff,3,0,5,2
1746546510678,WES 237B,A00,894149,Staff,11,0,20,9
1746546512734,AESE 279B,A00,891859,Staff,13,0,35,22
1746546513759,AIP 197,001,891854,Vespa; Emanuel Ignacio,9999,0,9999,0
1746546514784,ANTH 289S,A00,891856,Gagneux; Pascal,12,0,12,0
1746546515810,BENG 196,001,957946,Engler; Adam J.,9996,0,9999,3
1746546516833,BISP 197,001,959851,Wilhelm; James E.,9998,0,9999,1
1746546517859,CAT 124RS,A01,956906,Staff,6,0,25,19
1746546518885,CAT 125RS,A01,922013,Staff,6,0,25,19
1746546519911,CLRE 250,A00,891860,Morris; Sheldon,9995,0,9999,4
1746546521966,CLRE 251R,A00,907817,Mehta; Ravindra L.,9994,0,9999,5
1746546522993,CLRE 252,A00,891864,Cuomo; Raphael Eduardo,9993,0,9999,6
1746546524018,CLRE 253,A00,891867,Vaida; Florin,9994,0,9999,5
1746546524018,CLRE 253,B00,907819,Staff,9999,0,9999,0
1746546525046,CLRE 259,A00,891868,Patel; Hemal,9998,0,9999,1
1746546526074,CLRE 260,A00,891872,Cuomo; Raphael Eduardo,9999,0,9999,0
1746546527101,CLRE 297,001,891888,Cuomo; Raphael Eduardo,9999,0,9999,0
1746546528128,CSE 191,A00,958773,Minnes Kemp; Mor Mia,9996,0,9999,3
1746546529156,CSE 197,001,959846,Minnes Kemp; Mor Mia,9990,0,9999,9
1746546530184,CSS 201S,A01,892054,Mignozzetti; Umberto,26,0,30,4
1746546531214,CSS 202S,A01,892056,Mignozzetti; Umberto,26,0,30,4
1746546532238,DSC 197,001,956898,Eldridge; Justin Matthew,9998,0,9999,1
1746546533264,DSC 297,001,958000,Mazumdar; Arya,9998,0,9999,1
1746546533264,DSC 297,002,959862,Wang; Yusu,9999,0,9999,0
1746546534291,EAP 100,A00,905686,Staff,9778,0,9999,221
1746546535321,ECE 45,A01,892618,Staff,0,0,65,65
1746546537381,ECE 111,A01,892719,Staff,4,0,65,61
1746546538406,ECE 197,001,957920,Mercier; Patrick Philip,9991,0,9999,8
1746546539434,ECON 178,A01,907814,Zhu; Ying,26,0,35,9
1746546540460,EDS 115,A00,895312,Staff,36,0,45,9
1746546541485,EDS 117,A01,895337,Staff,24,0,30,6
1746546542515,EDS 125,A00,895341,Jones; Gabrielle Anastasia,37,0,45,8
1746546543542,EDS 128A,A01,895459,Fargason; Sharon Gayle,44,0,45,1
1746546544565,EDS 128B,A01,895543,Pappas; Elizabeth,44,0,45,1
1746546545590,EDS 139,A00,897203,Pappas; Elizabeth,44,0,45,1
1746546545590,EDS 139,B00,897209,Fargason; Sharon Gayle,41,0,45,4
1746546546617,EDS 201,A00,895545,Staff,23,0,45,22
1746546547643,EDS 203,A01,895581,Halter; Christopher P.,23,0,45,22
1746546548670,EDS 204R,A01,895625,Heinzman; Erica M.,39,0,45,6
1746546548670,EDS 204R,B01,895693,Halter; Christopher P.,10,0,45,35
1746546549696,EDS 206R,A00,895694,Fargason; Sharon Gayle,1,0,30,29
1746546549696,EDS 206R,B00,895695,Choi; Bailey Miyeon,16,0,30,14
1746546550719,EDS 250,A00,895697,Hemans; Patricia Ann Benitez,23,0,45,22
1746546551747,EDS 281,A00,895701,Meyerott; Theresa Ann,1,0,15,14
1746546552773,EDS 284,A00,895736,Meyerott; Theresa Ann,1,0,15,14
1746546553798,EDS 286,A00,897210,Fine; Sarah,0,0,15,15
1746546554824,EDS 289C,A01,895770,Daly; Alan J.,15,0,15,0
1746546555852,EDS 290,A00,897211,Hofstetter; Carolyn,0,0,15,15
1746546556878,LIGM 5A,A00,896162,Fischer-Grunski; Eva K,13,0,20,7
1746546557904,LIGM 5B,A00,896260,Fischer-Grunski; Eva K,17,0,20,3
1746546558929,LIGM 5C,A00,896308,Fischer-Grunski; Eva K,18,0,20,2
1746546559954,LIIT 5AS,A00,896313,Carnelos; Chiara,18,0,20,2
1746546560980,LIIT 5BS,A00,896416,Carnelos; Chiara,20,0,20,0
1746546562008,LIIT 5CS,A00,896564,Carnelos; Chiara,20,0,20,0
1746546563034,LISP 5A,A00,896588,Munoz Sanchez; Alicia,3,0,20,17
1746546564060,LISP 5B,A00,896653,Munoz Sanchez; Alicia,7,0,20,13
1746546565089,LISP 5C,A00,896655,Munoz Sanchez; Alicia,0,1,20,20
1746546566113,MAE 197,001,957918,Kleissl; Jan,9996,0,9999,3
1746546566113,MAE 197,002,959806,Boechler; Nicholas Sebastia,9998,0,9999,1
1746546566113,MAE 197,003,959852,Mullin; Jennifer S,9999,0,9999,0
1746546567139,MATH 2,A01,957937,Staff,33,0,35,2
1746546568165,MATH 197,001,957876,Kedlaya; Kiran S.,9993,0,9999,6
1746546569190,MCWP 40,A00,892729,Duru; Nur,10,0,20,10
1746546569190,MCWP 40,B00,893304,Montejo; Carolina,14,0,20,6
1746546570216,MCWP 40R,A00,893757,Redela; Pamela Morgan,0,5,20,20
1746546571240,MCWP 50,A00,893758,Morshed; Michael James,0,0,20,20
1746546571240,MCWP 50,B00,893761,Bartulis; Jason Michael,17,0,20,3
1746546572268,MCWP 50R,A00,893766,Compas; Sean Matthew,0,1,20,20
1746546572268,MCWP 50R,B00,893769,Carter; Jennifer A,0,1,20,20
1746546572268,MCWP 50R,C00,893771,Krone; Jarret,0,3,20,20
1746546572268,MCWP 50R,D00,893772,Miller; Elizabeth Deen,0,0,20,20
1746546572268,MCWP 50R,E00,893775,Carter; Andrea L,0,1,20,20
1746546573293,MMW 11R,A01,892721,Herbst; Matthew,11,0,27,16
1746546573293,MMW 11R,A02,892722,Herbst; Matthew,0,0,0,3
1746546574317,MMW 12R,A01,892724,Herbst; Matthew,0,11,16,16
1746546574317,MMW 12R,A02,892725,Herbst; Matthew,0,10,16,16
1746546575342,MMW 13R,A01,892727,Staff,0,4,16,16
1746546575342,MMW 13R,A02,892728,Staff,0,4,16,16
1746546575342,MMW 13R,A03,958032,Staff,0,4,16,16
1746546575342,MMW 13R,A04,958033,Staff,0,4,16,16
1746546575342,MMW 13R,A05,958034,Staff,0,4,16,16
1746546576366,SIO 295LS,A00,894015,Staff,5,0,25,20
1746546577392,SIO 295S,A00,894020,Staff,5,0,25,20
1746546578420,SIOC 290S,B01,958918,Merrifield; Mark A,14,0,30,16
1746546579448,SIOC 291S,B01,958922,Gabriel; Corey John,14,0,30,16
1746546580473,SOCI 117,A01,895339,Staff,3,0,5,2
1746546581498,WES 237B,A00,894149,Staff,11,0,20,9
1746546583561,AESE 279B,A00,891859,Staff,13,0,35,22
1746546584585,AIP 197,001,891854,Vespa; Emanuel Ignacio,9999,0,9999,0
1746546585610,ANTH 289S,A00,891856,Gagneux; Pascal,12,0,12,0
1746546586634,BENG 196,001,957946,Engler; Adam J.,9996,0,9999,3
1746546587658,BISP 197,001,959851,Wilhelm; James E.,9998,0,9999,1
1746546588682,CAT 124RS,A01,956906,Staff,6,0,25,19
1746546589708,CAT 125RS,A01,922013,Staff,6,0,25,19
1746546590734,CLRE 250,A00,891860,Morris; Sheldon,9995,0,9999,4
1746546592782,CLRE 251R,A00,907817,Mehta; Ravindra L.,9994,0,9999,5
1746546593845,CLRE 252,A00,891864,Cuomo; Raphael Eduardo,9993,0,9999,6
1746546594872,CLRE 253,A00,891867,Vaida; Florin,9994,0,9999,5
1746546594872,CLRE 253,B00,907819,Staff,9999,0,9999,0
1746546595900,CLRE 259,A00,891868,Patel; Hemal,9998,0,9999,1
1746546596923,CLRE 260,A00,891872,Cuomo; Raphael Eduardo,9999,0,9999,0
1746546597950,CLRE 297,001,891888,Cuomo; Raphael Eduardo,9999,0,9999,0
1746546598977,CSE 191,A00,958773,Minnes Kemp; Mor Mia,9996,0,9999,3
1746546600007,CSE 197,001,959846,Minnes Kemp; Mor Mia,9990,0,9999,9
1746546601039,CSS 201S,A01,892054,Mignozzetti; Umberto,26,0,30,4
1746546602066,CSS 202S,A01,892056,Mignozzetti; Umberto,26,0,30,4
1746546603097,DSC 197,001,956898,Eldridge; Justin Matthew,9998,0,9999,1
1746546604121,DSC 297,001,958000,Mazumdar; Arya,9998,0,9999,1
1746546604121,DSC 297,002,959862,Wang; Yusu,9999,0,9999,0
1746546605147,EAP 100,A00,905686,Staff,9778,0,9999,221
1746546606173,ECE 45,A01,892618,Staff,0,0,65,65
1746546608226,ECE 111,A01,892719,Staff,4,0,65,61
1746546609252,ECE 197,001,957920,Mercier; Patrick Philip,9991,0,9999,8
1746546610282,ECON 178,A01,907814,Zhu; Ying,26,0,35,9
1746546611309,EDS 115,A00,895312,Staff,36,0,45,9
1746546612334,EDS 117,A01,895337,Staff,24,0,30,6
1746546613360,EDS 125,A00,895341,Jones; Gabrielle Anastasia,37,0,45,8
1746546614387,EDS 128A,A01,895459,Fargason; Sharon Gayle,44,0,45,1
1746546615412,EDS 128B,A01,895543,Pappas; Elizabeth,44,0,45,1
1746546616442,EDS 139,A00,897203,Pappas; Elizabeth,44,0,45,1
1746546616442,EDS 139,B00,897209,Fargason; Sharon Gayle,41,0,45,4
1746546617469,EDS 201,A00,895545,Staff,23,0,45,22
1746546618496,EDS 203,A01,895581,Halter; Christopher P.,23,0,45,22
1746546619525,EDS 204R,A01,895625,Heinzman; Erica M.,39,0,45,6
1746546619525,EDS 204R,B01,895693,Halter; Christopher P.,10,0,45,35
1746546620552,EDS 206R,A00,895694,Fargason; Sharon Gayle,1,0,30,29
1746546620552,EDS 206R,B00,895695,Choi; Bailey Miyeon,16,0,30,14
1746546621583,EDS 250,A00,895697,Hemans; Patricia Ann Benitez,23,0,45,22
1746546622612,EDS 281,A00,895701,Meyerott; Theresa Ann,1,0,15,14
1746546623637,EDS 284,A00,895736,Meyerott; Theresa Ann,1,0,15,14
1746546624665,EDS 286,A00,897210,Fine; Sarah,0,0,15,15
1746546625706,EDS 289C,A01,895770,Daly; Alan J.,15,0,15,0
1746546626733,EDS 290,A00,897211,Hofstetter; Carolyn,0,0,15,15
1746546627757,LIGM 5A,A00,896162,Fischer-Grunski; Eva K,13,0,20,7
1746546628785,LIGM 5B,A00,896260,Fischer-Grunski; Eva K,17,0,20,3
1746546629809,LIGM 5C,A00,896308,Fischer-Grunski; Eva K,18,0,20,2
1746546630834,LIIT 5AS,A00,896313,Carnelos; Chiara,18,0,20,2
1746546631859,LIIT 5BS,A00,896416,Carnelos; Chiara,20,0,20,0
1746546632889,LIIT 5CS,A00,896564,Carnelos; Chiara,20,0,20,0
1746546633915,LISP 5A,A00,896588,Munoz Sanchez; Alicia,3,0,20,17
1746546634948,LISP 5B,A00,896653,Munoz Sanchez; Alicia,7,0,20,13
1746546635975,LISP 5C,A00,896655,Munoz Sanchez; Alicia,0,1,20,20
1746546637001,MAE 197,001,957918,Kleissl; Jan,9996,0,9999,3
1746546637001,MAE 197,002,959806,Boechler; Nicholas Sebastia,9998,0,9999,1
1746546637001,MAE 197,003,959852,Mullin; Jennifer S,9999,0,9999,0
1746546638028,MATH 2,A01,957937,Staff,33,0,35,2
1746546639054,MATH 197,001,957876,Kedlaya; Kiran S.,9993,0,9999,6
1746546640082,MCWP 40,A00,892729,Duru; Nur,10,0,20,10
1746546640082,MCWP 40,B00,893304,Montejo; Carolina,14,0,20,6
1746546641110,MCWP 40R,A00,893757,Redela; Pamela Morgan,0,5,20,20
1746546642137,MCWP 50,A00,893758,Morshed; Michael James,0,0,20,20
1746546642137,MCWP 50,B00,893761,Bartulis; Jason Michael,17,0,20,3
1746546643167,MCWP 50R,A00,893766,Compas; Sean Matthew,0,1,20,20
1746546643167,MCWP 50R,B00,893769,Carter; Jennifer A,0,1,20,20
1746546643167,MCWP 50R,C00,893771,Krone; Jarret,0,3,20,20
1746546643167,MCWP 50R,D00,893772,Miller; Elizabeth Deen,0,0,20,20
1746546643167,MCWP 50R,E00,893775,Carter; Andrea L,0,1,20,20
1746546644195,MMW 11R,A01,892721,Herbst; Matthew,11,0,27,16
1746546644195,MMW 11R,A02,892722,Herbst; Matthew,0,0,0,3
1746546645222,MMW 12R,A01,892724,Herbst; Matthew,0,11,16,16
1746546645222,MMW 12R,A02,892725,Herbst; Matthew,0,10,16,16
1746546646247,MMW 13R,A01,892727,Staff,0,4,16,16
1746546646247,MMW 13R,A02,892728,Staff,0,4,16,16
1746546646247,MMW 13R,A03,958032,Staff,0,4,16,16
1746546646247,MMW 13R,A04,958033,Staff,0,4,16,16
1746546646247,MMW 13R,A05,958034,Staff,0,4,16,16
1746546647273,SIO 295LS,A00,894015,Staff,5,0,25,20
1746546648299,SIO 295S,A00,894020,Staff,5,0,25,20
1746546649325,SIOC 290S,B01,958918,Merrifield; Mark A,14,0,30,16
1746546650359,SIOC 291S,B01,958922,Gabriel; Corey John,14,0,30,16
1746546651386,SOCI 117,A01,895339,Staff,3,0,5,2
1746546652421,WES 237B,A00,894149,Staff,11,0,20,9
1746546654485,AESE 279B,A00,891859,Staff,13,0,35,22
1746546655511,AIP 197,001,891854,Vespa; Emanuel Ignacio,9999,0,9999,0
1746546656539,ANTH 289S,A00,891856,Gagneux; Pascal,12,0,12,0
1746546657565,BENG 196,001,957946,Engler; Adam J.,9996,0,9999,3
1746546658591,BISP 197,001,959851,Wilhelm; James E.,9998,0,9999,1
1746546659616,CAT 124RS,A01,956906,Staff,6,0,25,19
1746546660642,CAT 125RS,A01,922013,Staff,6,0,25,19
1746546661669,CLRE 250,A00,891860,Morris; Sheldon,9995,0,9999,4
1746546663723,CLRE 251R,A00,907817,Mehta; Ravindra L.,9994,0,9999,5
1746546664747,CLRE 252,A00,891864,Cuomo; Raphael Eduardo,9993,0,9999,6
1746546665775,CLRE 253,A00,891867,Vaida; Florin,9994,0,9999,5
1746546665775,CLRE 253,B00,907819,Staff,9999,0,9999,0
1746546666803,CLRE 259,A00,891868,Patel; Hemal,9998,0,9999,1
1746546667828,CLRE 260,A00,891872,Cuomo; Raphael Eduardo,9999,0,9999,0
1746546668855,CLRE 297,001,891888,Cuomo; Raphael Eduardo,9999,0,9999,0
1746546669882,CSE 191,A00,958773,Minnes Kemp; Mor Mia,9996,0,9999,3
1746546670907,CSE 197,001,959846,Minnes Kemp; Mor Mia,9990,0,9999,9
1746546671933,CSS 201S,A01,892054,Mignozzetti; Umberto,26,0,30,4
1746546672961,CSS 202S,A01,892056,Mignozzetti; Umberto,26,0,30,4
1746546673986,DSC 197,001,956898,Eldridge; Justin Matthew,9998,0,9999,1
1746546675013,DSC 297,001,958000,Mazumdar; Arya,9998,0,9999,1
1746546675013,DSC 297,002,959862,Wang; Yusu,9999,0,9999,0
1746546676041,EAP 100,A00,905686,Staff,9778,0,9999,221
1746546677068,ECE 45,A01,892618,Staff,0,0,65,65
1746546679120,ECE 111,A01,892719,Staff,4,0,65,61
1746546680149,ECE 197,001,957920,Mercier; Patrick Philip,9991,0,9999,8
1746546681174,ECON 178,A01,907814,Zhu; Ying,26,0,35,9
1746546682201,EDS 115,A00,895312,Staff,36,0,45,9
1746546683229,EDS 117,A01,895337,Staff,24,0,30,6
1746546684254,EDS 125,A00,895341,Jones; Gabrielle Anastasia,37,0,45,8
1746546685281,EDS 128A,A01,895459,Fargason; Sharon Gayle,44,0,45,1
1746546686309,EDS 128B,A01,895543,Pappas; Elizabeth,44,0,45,1
1746546687333,EDS 139,A00,897203,Pappas; Elizabeth,44,0,45,1
1746546687333,EDS 139,B00,897209,Fargason; Sharon Gayle,41,0,45,4
1746546688360,EDS 201,A00,895545,Staff,22,0,45,23
1746546689387,EDS 203,A01,895581,Halter; Christopher P.,23,0,45,22
1746546690412,EDS 204R,A01,895625,Heinzman; Erica M.,39,0,45,6
1746546690412,EDS 204R,B01,895693,Halter; Christopher P.,10,0,45,35
1746546691437,EDS 206R,A00,895694,Fargason; Sharon Gayle,1,0,30,29
1746546691437,EDS 206R,B00,895695,Choi; Bailey Miyeon,16,0,30,14
1746546692461,EDS 250,A00,895697,Hemans; Patricia Ann Benitez,23,0,45,22
1746546693485,EDS 281,A00,895701,Meyerott; Theresa Ann,1,0,15,14
1746546694508,EDS 284,A00,895736,Meyerott; Theresa Ann,1,0,15,14
1746546695534,EDS 286,A00,897210,Fine; Sarah,0,0,15,15
1746546696561,EDS 289C,A01,895770,Daly; Alan J.,15,0,15,0
1746546697623,EDS 290,A00,897211,Hofstetter; Carolyn,0,0,15,15
1746546698649,LIGM 5A,A00,896162,Fischer-Grunski; Eva K,13,0,20,7
1746546699676,LIGM 5B,A00,896260,Fischer-Grunski; Eva K,17,0,20,3
1746546700700,LIGM 5C,A00,896308,Fischer-Grunski; Eva K,18,0,20,2
1746546701729,LIIT 5AS,A00,896313,Carnelos; Chiara,18,0,20,2
1746546702753,LIIT 5BS,A00,896416,Carnelos; Chiara,20,0,20,0
1746546703779,LIIT 5CS,A00,896564,Carnelos; Chiara,20,0,20,0
1746546704804,LISP 5A,A00,896588,Munoz Sanchez; Alicia,3,0,20,17
1746546705833,LISP 5B,A00,896653,Munoz Sanchez; Alicia,7,0,20,13
1746546706858,LISP 5C,A00,896655,Munoz Sanchez; Alicia,0,1,20,20
1746546707888,MAE 197,001,957918,Kleissl; Jan,9996,0,9999,3
1746546707888,MAE 197,002,959806,Boechler; Nicholas Sebastia,9998,0,9999,1
1746546707888,MAE 197,003,959852,Mullin; Jennifer S,9999,0,9999,0
1746546708914,MATH 2,A01,957937,Staff,33,0,35,2
1746546709941,MATH 197,001,957876,Kedlaya; Kiran S.,9993,0,9999,6
1746546710972,MCWP 40,A00,892729,Duru; Nur,10,0,20,10
1746546710972,MCWP 40,B00,893304,Montejo; Carolina,14,0,20,6
1746546712000,MCWP 40R,A00,893757,Redela; Pamela Morgan,0,5,20,20
1746546713026,MCWP 50,A00,893758,Morshed; Michael James,0,0,20,20
1746546713026,MCWP 50,B00,893761,Bartulis; Jason Michael,17,0,20,3
1746546714051,MCWP 50R,A00,893766,Compas; Sean Matthew,0,1,20,20
1746546714051,MCWP 50R,B00,893769,Carter; Jennifer A,0,1,20,20
1746546714051,MCWP 50R,C00,893771,Krone; Jarret,0,3,20,20
1746546714051,MCWP 50R,D00,893772,Miller; Elizabeth Deen,0,0,20,20
1746546714051,MCWP 50R,E00,893775,Carter; Andrea L,0,1,20,20
1746546715079,MMW 11R,A01,892721,Herbst; Matthew,11,0,27,16
1746546715079,MMW 11R,A02,892722,Herbst; Matthew,0,0,0,3
1746546716104,MMW 12R,A01,892724,Herbst; Matthew,0,11,16,16
1746546716104,MMW 12R,A02,892725,Herbst; Matthew,0,10,16,16
1746546717129,MMW 13R,A01,892727,Staff,0,4,16,16
1746546717129,MMW 13R,A02,892728,Staff,0,4,16,16
1746546717129,MMW 13R,A03,958032,Staff,0,4,16,16
1746546717129,MMW 13R,A04,958033,Staff,0,4,16,16
1746546717129,MMW 13R,A05,958034,Staff,0,4,16,16
1746546718161,SIO 295LS,A00,894015,Staff,5,0,25,20
1746546719193,SIO 295S,A00,894020,Staff,5,0,25,20
1746546720223,SIOC 290S,B01,958918,Merrifield; Mark A,14,0,30,16
1746546721251,SIOC 291S,B01,958922,Gabriel; Corey John,14,0,30,16
1746546722277,SOCI 117,A01,895339,Staff,3,0,5,2
1746546723304,WES 237B,A00,894149,Staff,11,0,20,9
1746546725395,AESE 279B,A00,891859,Staff,13,0,35,22
1746546726419,AIP 197,001,891854,Vespa; Emanuel Ignacio,9999,0,9999,0
1746546727447,ANTH 289S,A00,891856,Gagneux; Pascal,12,0,12,0
1746546728475,BENG 196,001,957946,Engler; Adam J.,9996,0,9999,3
1746546729501,BISP 197,001,959851,Wilhelm; James E.,9998,0,9999,1
1746546730527,CAT 124RS,A01,956906,Staff,6,0,25,19
1746546731553,CAT 125RS,A01,922013,Staff,6,0,25,19
1746546732581,CLRE 250,A00,891860,Morris; Sheldon,9995,0,9999,4
1746546734632,CLRE 251R,A00,907817,Mehta; Ravindra L.,9994,0,9999,5
1746546735660,CLRE 252,A00,891864,Cuomo; Raphael Eduardo,9993,0,9999,6
1746546736689,CLRE 253,A00,891867,Vaida; Florin,9994,0,9999,5
1746546736689,CLRE 253,B00,907819,Staff,9999,0,9999,0
1746546737716,CLRE 259,A00,891868,Patel; Hemal,9998,0,9999,1
1746546738743,CLRE 260,A00,891872,Cuomo; Raphael Eduardo,9999,0,9999,0
1746546739770,CLRE 297,001,891888,Cuomo; Raphael Eduardo,9999,0,9999,0
1746546740798,CSE 191,A00,958773,Minnes Kemp; Mor Mia,9996,0,9999,3
1746546741826,CSE 197,001,959846,Minnes Kemp; Mor Mia,9990,0,9999,9
1746546742855,CSS 201S,A01,892054,Mignozzetti; Umberto,26,0,30,4
1746546743880,CSS 202S,A01,892056,Mignozzetti; Umberto,26,0,30,4
1746546744908,DSC 197,001,956898,Eldridge; Justin Matthew,9998,0,9999,1
1746546745936,DSC 297,001,958000,Mazumdar; Arya,9998,0,9999,1
1746546745936,DSC 297,002,959862,Wang; Yusu,9999,0,9999,0
1746546746962,EAP 100,A00,905686,Staff,9778,0,9999,221
1746546747987,ECE 45,A01,892618,Staff,0,0,65,65
1746546750039,ECE 111,A01,892719,Staff,4,0,65,61
1746546751063,ECE 197,001,957920,Mercier; Patrick Philip,9991,0,9999,8
1746546752090,ECON 178,A01,907814,Zhu; Ying,26,0,35,9
1746546753118,EDS 115,A00,895312,Staff,36,0,45,9
1746546754144,EDS 117,A01,895337,Staff,24,0,30,6
1746546755175,EDS 125,A00,895341,Jones; Gabrielle Anastasia,37,0,45,8
1746546756203,EDS 128A,A01,895459,Fargason; Sharon Gayle,44,0,45,1
1746546757230,EDS 128B,A01,895543,Pappas; Elizabeth,44,0,45,1
1746546758260,EDS 139,A00,897203,Pappas; Elizabeth,44,0,45,1
1746546758260,EDS 139,B00,897209,Fargason; Sharon Gayle,41,0,45,4
1746546759288,EDS 201,A00,895545,Staff,22,0,45,23
1746546760313,EDS 203,A01,895581,Halter; Christopher P.,22,0,45,23
1746546761338,EDS 204R,A01,895625,Heinzman; Erica M.,39,0,45,6
1746546761338,EDS 204R,B01,895693,Halter; Christopher P.,10,0,45,35
1746546762365,EDS 206R,A00,895694,Fargason; Sharon Gayle,1,0,30,29
1746546762365,EDS 206R,B00,895695,Choi; Bailey Miyeon,16,0,30,14
1746546763391,EDS 250,A00,895697,Hemans; Patricia Ann Benitez,22,0,45,23
1746546764420,EDS 281,A00,895701,Meyerott; Theresa Ann,1,0,15,14
1746546765446,EDS 284,A00,895736,Meyerott; Theresa Ann,1,0,15,14
1746546766471,EDS 286,A00,897210,Fine; Sarah,0,0,15,15
1746546767495,EDS 289C,A01,895770,Daly; Alan J.,15,0,15,0
1746546768523,EDS 290,A00,897211,Hofstetter; Carolyn,0,0,15,15
1746546769554,LIGM 5A,A00,896162,Fischer-Grunski; Eva K,13,0,20,7
1746546770579,LIGM 5B,A00,896260,Fischer-Grunski; Eva K,17,0,20,3
1746546771605,LIGM 5C,A00,896308,Fischer-Grunski; Eva K,18,0,20,2
1746546772633,LIIT 5AS,A00,896313,Carnelos; Chiara,18,0,20,2
1746546773666,LIIT 5BS,A00,896416,Carnelos; Chiara,20,0,20,0
1746546774692,LIIT 5CS,A00,896564,Carnelos; Chiara,20,0,20,0
1746546775718,LISP 5A,A00,896588,Munoz Sanchez; Alicia,3,0,20,17
1746546776743,LISP 5B,A00,896653,Munoz Sanchez; Alicia,7,0,20,13
1746546777772,LISP 5C,A00,896655,Munoz Sanchez; Alicia,0,1,20,20
1746546778797,MAE 197,001,957918,Kleissl; Jan,9996,0,9999,3
1746546778797,MAE 197,002,959806,Boechler; Nicholas Sebastia,9998,0,9999,1
1746546778797,MAE 197,003,959852,Mullin; Jennifer S,9999,0,9999,0
1746546779826,MATH 2,A01,957937,Staff,33,0,35,2
1746546780853,MATH 197,001,957876,Kedlaya; Kiran S.,9993,0,9999,6
1746546781879,MCWP 40,A00,892729,Duru; Nur,10,0,20,10
1746546781879,MCWP 40,B00,893304,Montejo; Carolina,14,0,20,6
1746546782909,MCWP 40R,A00,893757,Redela; Pamela Morgan,0,5,20,20
1746546783940,MCWP 50,A00,893758,Morshed; Michael James,0,0,20,20
1746546783940,MCWP 50,B00,893761,Bartulis; Jason Michael,17,0,20,3
1746546784965,MCWP 50R,A00,893766,Compas; Sean Matthew,0,1,20,20
1746546784965,MCWP 50R,B00,893769,Carter; Jennifer A,0,1,20,20
1746546784965,MCWP 50R,C00,893771,Krone; Jarret,0,3,20,20
1746546784965,MCWP 50R,D00,893772,Miller; Elizabeth Deen,0,0,20,20
1746546784965,MCWP 50R,E00,893775,Carter; Andrea L,0,1,20,20
1746546785992,MMW 11R,A01,892721,Herbst; Matthew,11,0,27,16
1746546785992,MMW 11R,A02,892722,Herbst; Matthew,0,0,0,3
1746546787017,MMW 12R,A01,892724,Herbst; Matthew,0,11,16,16
1746546787017,MMW 12R,A02,892725,Herbst; Matthew,0,10,16,16
1746546788046,MMW 13R,A01,892727,Staff,0,4,16,16
1746546788046,MMW 13R,A02,892728,Staff,0,4,16,16
1746546788046,MMW 13R,A03,958032,Staff,0,4,16,16
1746546788046,MMW 13R,A04,958033,Staff,0,4,16,16
1746546788046,MMW 13R,A05,958034,Staff,0,4,16,16
1746546789071,SIO 295LS,A00,894015,Staff,5,0,25,20
1746546790098,SIO 295S,A00,894020,Staff,5,0,25,20
1746546791125,SIOC 290S,B01,958918,Merrifield; Mark A,14,0,30,16
1746546792157,SIOC 291S,B01,958922,Gabriel; Corey John,14,0,30,16
1746546793181,SOCI 117,A01,895339,Staff,3,0,5,2
1746546794205,WES 237B,A00,894149,Staff,11,0,20,9
1746546796283,AESE 279B,A00,891859,Staff,13,0,35,22
1746546797308,AIP 197,001,891854,Vespa; Emanuel Ignacio,9999,0,9999,0
1746546798333,ANTH 289S,A00,891856,Gagneux; Pascal,12,0,12,0
1746546799356,BENG 196,001,957946,Engler; Adam J.,9996,0,9999,3
1746546800382,BISP 197,001,959851,Wilhelm; James E.,9998,0,9999,1
1746546801408,CAT 124RS,A01,956906,Staff,6,0,25,19
1746546802431,CAT 125RS,A01,922013,Staff,6,0,25,19
1746546803457,CLRE 250,A00,891860,Morris; Sheldon,9995,0,9999,4
1746546805508,CLRE 251R,A00,907817,Mehta; Ravindra L.,9994,0,9999,5
1746546806550,CLRE 252,A00,891864,Cuomo; Raphael Eduardo,9993,0,9999,6
1746546807575,CLRE 253,A00,891867,Vaida; Florin,9994,0,9999,5
1746546807575,CLRE 253,B00,907819,Staff,9999,0,9999,0
1746546808601,CLRE 259,A00,891868,Patel; Hemal,9998,0,9999,1
1746546809628,CLRE 260,A00,891872,Cuomo; Raphael Eduardo,9999,0,9999,0
1746546810655,CLRE 297,001,891888,Cuomo; Raphael Eduardo,9999,0,9999,0
1746546811680,CSE 191,A00,958773,Minnes Kemp; Mor Mia,9996,0,9999,3
1746546812707,CSE 197,001,959846,Minnes Kemp; Mor Mia,9990,0,9999,9
1746546813736,CSS 201S,A01,892054,Mignozzetti; Umberto,26,0,30,4
1746546814765,CSS 202S,A01,892056,Mignozzetti; Umberto,26,0,30,4
1746546815792,DSC 197,001,956898,Eldridge; Justin Matthew,9998,0,9999,1
1746546816819,DSC 297,001,958000,Mazumdar; Arya,9998,0,9999,1
1746546816819,DSC 297,002,959862,Wang; Yusu,9999,0,9999,0
1746546817845,EAP 100,A00,905686,Staff,9778,0,9999,221
1746546818870,ECE 45,A01,892618,Staff,0,0,65,65
1746546820923,ECE 111,A01,892719,Staff,4,0,65,61
1746546821946,ECE 197,001,957920,Mercier; Patrick Philip,9991,0,9999,8
1746546822972,ECON 178,A01,907814,Zhu; Ying,26,0,35,9
1746546823999,EDS 115,A00,895312,Staff,36,0,45,9
1746546825027,EDS 117,A01,895337,Staff,24,0,30,6
1746546826051,EDS 125,A00,895341,Jones; Gabrielle Anastasia,37,0,45,8
1746546827078,EDS 128A,A01,895459,Fargason; Sharon Gayle,44,0,45,1
1746546828105,EDS 128B,A01,895543,Pappas; Elizabeth,44,0,45,1
1746546829134,EDS 139,A00,897203,Pappas; Elizabeth,44,0,45,1
1746546829134,EDS 139,B00,897209,Fargason; Sharon Gayle,41,0,45,4
1746546830158,EDS 201,A00,895545,Staff,22,0,45,23
1746546831185,EDS 203,A01,895581,Halter; Christopher P.,22,0,45,23
1746546832210,EDS 204R,A01,895625,Heinzman; Erica M.,39,0,45,6
1746546832210,EDS 204R,B01,895693,Halter; Christopher P.,10,0,45,35
1746546833236,EDS 206R,A00,895694,Fargason; Sharon Gayle,1,0,30,29
1746546833236,EDS 206R,B00,895695,Choi; Bailey Miyeon,16,0,30,14
1746546834259,EDS 250,A00,895697,Hemans; Patricia Ann Benitez,22,0,45,23
1746546835286,EDS 281,A00,895701,Meyerott; Theresa Ann,1,0,15,14
1746546836309,EDS 284,A00,895736,Meyerott; Theresa Ann,1,0,15,14
1746546837333,EDS 286,A00,897210,Fine; Sarah,0,0,15,15
1746546838356,EDS 289C,A01,895770,Daly; Alan J.,15,0,15,0
1746546839381,EDS 290,A00,897211,Hofstetter; Carolyn,0,0,15,15
1746546840409,LIGM 5A,A00,896162,Fischer-Grunski; Eva K,13,0,20,7
1746546841434,LIGM 5B,A00,896260,Fischer-Grunski; Eva K,17,0,20,3
1746546842460,LIGM 5C,A00,896308,Fischer-Grunski; Eva K,18,0,20,2
1746546843488,LIIT 5AS,A00,896313,Carnelos; Chiara,18,0,20,2
1746546844512,LIIT 5BS,A00,896416,Carnelos; Chiara,20,0,20,0
1746546845539,LIIT 5CS,A00,896564,Carnelos; Chiara,20,0,20,0
1746546846564,LISP 5A,A00,896588,Munoz Sanchez; Alicia,3,0,20,17
1746546847592,LISP 5B,A00,896653,Munoz Sanchez; Alicia,7,0,20,13
1746546848635,LISP 5C,A00,896655,Munoz Sanchez; Alicia,0,1,20,20
1746546849662,MAE 197,001,957918,Kleissl; Jan,9996,0,9999,3
1746546849662,MAE 197,002,959806,Boechler; Nicholas Sebastia,9998,0,9999,1
1746546849662,MAE 197,003,959852,Mullin; Jennifer S,9999,0,9999,0
1746546850689,MATH 2,A01,957937,Staff,33,0,35,2
1746546851714,MATH 197,001,957876,Kedlaya; Kiran S.,9993,0,9999,6
1746546852739,MCWP 40,A00,892729,Duru; Nur,10,0,20,10
1746546852739,MCWP 40,B00,893304,Montejo; Carolina,14,0,20,6
1746546853767,MCWP 40R,A00,893757,Redela; Pamela Morgan,0,5,20,20
1746546854793,MCWP 50,A00,893758,Morshed; Michael James,0,0,20,20
1746546854793,MCWP 50,B00,893761,Bartulis; Jason Michael,17,0,20,3
1746546855816,MCWP 50R,A00,893766,Compas; Sean Matthew,0,1,20,20
1746546855816,MCWP 50R,B00,893769,Carter; Jennifer A,0,1,20,20
1746546855816,MCWP 50R,C00,893771,Krone; Jarret,0,3,20,20
1746546855816,MCWP 50R,D00,893772,Miller; Elizabeth Deen,0,0,20,20
1746546855816,MCWP 50R,E00,893775,Carter; Andrea L,0,1,20,20
1746546856842,MMW 11R,A01,892721,Herbst; Matthew,11,0,27,16
1746546856842,MMW 11R,A02,892722,Herbst; Matthew,0,0,0,3
1746546857869,MMW 12R,A01,892724,Herbst; Matthew,0,11,16,16
1746546857869,MMW 12R,A02,892725,Herbst; Matthew,0,10,16,16
1746546858895,MMW 13R,A01,892727,Staff,0,4,16,16
1746546858895,MMW 13R,A02,892728,Staff,0,4,16,16
1746546858895,MMW 13R,A03,958032,Staff,0,4,16,16
1746546858895,MMW 13R,A04,958033,Staff,0,4,16,16
1746546858895,MMW 13R,A05,958034,Staff,0,4,16,16
1746546859922,SIO 295LS,A00,894015,Staff,5,0,25,20
1746546860944,SIO 295S,A00,894020,Staff,5,0,25,20
1746546861969,SIOC 290S,B01,958918,Merrifield; Mark A,14,0,30,16
1746546862994,SIOC 291S,B01,958922,Gabriel; Corey John,14,0,30,16
1746546864019,SOCI 117,A01,895339,Staff,3,0,5,2
1746546865045,WES 237B,A00,894149,Staff,11,0,20,9
1746546867105,AESE 279B,A00,891859,Staff,13,0,35,22
1746546868135,AIP 197,001,891854,Vespa; Emanuel Ignacio,9999,0,9999,0
1746546869160,ANTH 289S,A00,891856,Gagneux; Pascal,12,0,12,0
1746546870182,BENG 196,001,957946,Engler; Adam J.,9996,0,9999,3
1746546871206,BISP 197,001,959851,Wilhelm; James E.,9998,0,9999,1
1746546872231,CAT 124RS,A01,956906,Staff,6,0,25,19
1746546873256,CAT 125RS,A01,922013,Staff,6,0,25,19
1746546874279,CLRE 250,A00,891860,Morris; Sheldon,9995,0,9999,4
1746546876331,CLRE 251R,A00,907817,Mehta; Ravindra L.,9994,0,9999,5
1746546877354,CLRE 252,A00,891864,Cuomo; Raphael Eduardo,9993,0,9999,6
1746546878379,CLRE 253,A00,891867,Vaida; Florin,9994,0,9999,5
1746546878379,CLRE 253,B00,907819,Staff,9999,0,9999,0
1746546879407,CLRE 259,A00,891868,Patel; Hemal,9998,0,9999,1
1746546880434,CLRE 260,A00,891872,Cuomo; Raphael Eduardo,9999,0,9999,0
1746546881462,CLRE 297,001,891888,Cuomo; Raphael Eduardo,9999,0,9999,0
1746546882489,CSE 191,A00,958773,Minnes Kemp; Mor Mia,9996,0,9999,3
1746546883513,CSE 197,001,959846,Minnes Kemp; Mor Mia,9990,0,9999,9
1746546884539,CSS 201S,A01,892054,Mignozzetti; Umberto,26,0,30,4
1746546885565,CSS 202S,A01,892056,Mignozzetti; Umberto,26,0,30,4
1746546886592,DSC 197,001,956898,Eldridge; Justin Matthew,9998,0,9999,1
1746546887619,DSC 297,001,958000,Mazumdar; Arya,9998,0,9999,1
1746546887619,DSC 297,002,959862,Wang; Yusu,9999,0,9999,0
1746546888645,EAP 100,A00,905686,Staff,9778,0,9999,221
1746546889675,ECE 45,A01,892618,Staff,0,0,65,65
1746546891726,ECE 111,A01,892719,Staff,4,0,65,61
1746546892753,ECE 197,001,957920,Mercier; Patrick Philip,9991,0,9999,8
1746546893778,ECON 178,A01,907814,Zhu; Ying,26,0,35,9
1746546894806,EDS 115,A00,895312,Staff,36,0,45,9
1746546895831,EDS 117,A01,895337,Staff,24,0,30,6
1746546896855,EDS 125,A00,895341,Jones; Gabrielle Anastasia,37,0,45,8
1746546897883,EDS 128A,A01,895459,Fargason; Sharon Gayle,44,0,45,1
1746546898908,EDS 128B,A01,895543,Pappas; Elizabeth,44,0,45,1
1746546899937,EDS 139,A00,897203,Pappas; Elizabeth,44,0,45,1
1746546899937,EDS 139,B00,897209,Fargason; Sharon Gayle,41,0,45,4
1746546900966,EDS 201,A00,895545,Staff,22,0,45,23
1746546901995,EDS 203,A01,895581,Halter; Christopher P.,22,0,45,23
1746546903022,EDS 204R,A01,895625,Heinzman; Erica M.,39,0,45,6
1746546903022,EDS 204R,B01,895693,Halter; Christopher P.,10,0,45,35
1746546904046,EDS 206R,A00,895694,Fargason; Sharon Gayle,1,0,30,29
1746546904046,EDS 206R,B00,895695,Choi; Bailey Miyeon,16,0,30,14
1746546905071,EDS 250,A00,895697,Hemans; Patricia Ann Benitez,22,0,45,23
1746546906099,EDS 281,A00,895701,Meyerott; Theresa Ann,1,0,15,14
1746546907125,EDS 284,A00,895736,Meyerott; Theresa Ann,1,0,15,14
1746546908154,EDS 286,A00,897210,Fine; Sarah,0,0,15,15
1746546909180,EDS 289C,A01,895770,Daly; Alan J.,15,0,15,0
1746546910205,EDS 290,A00,897211,Hofstetter; Carolyn,0,0,15,15
1746546911234,LIGM 5A,A00,896162,Fischer-Grunski; Eva K,13,0,20,7
1746546912259,LIGM 5B,A00,896260,Fischer-Grunski; Eva K,17,0,20,3
1746546913287,LIGM 5C,A00,896308,Fischer-Grunski; Eva K,18,0,20,2
1746546914317,LIIT 5AS,A00,896313,Carnelos; Chiara,18,0,20,2
1746546915348,LIIT 5BS,A00,896416,Carnelos; Chiara,20,0,20,0
1746546916374,LIIT 5CS,A00,896564,Carnelos; Chiara,20,0,20,0
1746546917401,LISP 5A,A00,896588,Munoz Sanchez; Alicia,3,0,20,17
1746546918429,LISP 5B,A00,896653,Munoz Sanchez; Alicia,7,0,20,13
1746546919456,LISP 5C,A00,896655,Munoz Sanchez; Alicia,0,1,20,20
1746546920483,MAE 197,001,957918,Kleissl; Jan,9996,0,9999,3
1746546920483,MAE 197,002,959806,Boechler; Nicholas Sebastia,9998,0,9999,1
1746546920483,MAE 197,003,959852,Mullin; Jennifer S,9999,0,9999,0
1746546921511,MATH 2,A01,957937,Staff,33,0,35,2
1746546922535,MATH 197,001,957876,Kedlaya; Kiran S.,9993,0,9999,6
1746546923564,MCWP 40,A00,892729,Duru; Nur,10,0,20,10
1746546923564,MCWP 40,B00,893304,Montejo; Carolina,14,0,20,6
1746546924587,MCWP 40R,A00,893757,Redela; Pamela Morgan,0,5,20,20
1746546925613,MCWP 50,A00,893758,Morshed; Michael James,0,0,20,20
1746546925613,MCWP 50,B00,893761,Bartulis; Jason Michael,17,0,20,3
1746546926639,MCWP 50R,A00,893766,Compas; Sean Matthew,0,1,20,20
1746546926639,MCWP 50R,B00,893769,Carter; Jennifer A,0,1,20,20
1746546926639,MCWP 50R,C00,893771,Krone; Jarret,0,3,20,20
1746546926639,MCWP 50R,D00,893772,Miller; Elizabeth Deen,0,0,20,20
1746546926639,MCWP 50R,E00,893775,Carter; Andrea L,0,1,20,20
1746546927666,MMW 11R,A01,892721,Herbst; Matthew,11,0,27,16
1746546927666,MMW 11R,A02,892722,Herbst; Matthew,0,0,0,3
1746546928694,MMW 12R,A01,892724,Herbst; Matthew,0,11,16,16
1746546928694,MMW 12R,A02,892725,Herbst; Matthew,0,10,16,16
1746546929719,MMW 13R,A01,892727,Staff,0,4,16,16
1746546929719,MMW 13R,A02,892728,Staff,0,4,16,16
1746546929719,MMW 13R,A03,958032,Staff,0,4,16,16
1746546929719,MMW 13R,A04,958033,Staff,0,4,16,16
1746546929719,MMW 13R,A05,958034,Staff,0,4,16,16
1746546930747,SIO 295LS,A00,894015,Staff,5,0,25,20
1746546931773,SIO 295S,A00,894020,Staff,5,0,25,20
1746546932798,SIOC 290S,B01,958918,Merrifield; Mark A,14,0,30,16
1746546933826,SIOC 291S,B01,958922,Gabriel; Corey John,14,0,30,16
1746546934851,SOCI 117,A01,895339,Staff,3,0,5,2
1746546935876,WES 237B,A00,894149,Staff,11,0,20,9
1746546937934,AESE 279B,A00,891859,Staff,13,0,35,22
1746546938958,AIP 197,001,891854,Vespa; Emanuel Ignacio,9999,0,9999,0
1746546939986,ANTH 289S,A00,891856,Gagneux; Pascal,12,0,12,0
1746546941013,BENG 196,001,957946,Engler; Adam J.,9996,0,9999,3
1746546942042,BISP 197,001,959851,Wilhelm; James E.,9998,0,9999,1
1746546943065,CAT 124RS,A01,956906,Staff,6,0,25,19
1746546944089,CAT 125RS,A01,922013,Staff,6,0,25,19
1746546945113,CLRE 250,A00,891860,Morris; Sheldon,9995,0,9999,4
1746546947166,CLRE 251R,A00,907817,Mehta; Ravindra L.,9994,0,9999,5
1746546948190,CLRE 252,A00,891864,Cuomo; Raphael Eduardo,9993,0,9999,6
1746546949215,CLRE 253,A00,891867,Vaida; Florin,9994,0,9999,5
1746546949215,CLRE 253,B00,907819,Staff,9999,0,9999,0
1746546950245,CLRE 259,A00,891868,Patel; Hemal,9998,0,9999,1
1746546951272,CLRE 260,A00,891872,Cuomo; Raphael Eduardo,9999,0,9999,0
1746546952295,CLRE 297,001,891888,Cuomo; Raphael Eduardo,9999,0,9999,0
1746546953320,CSE 191,A00,958773,Minnes Kemp; Mor Mia,9996,0,9999,3
1746546954347,CSE 197,001,959846,Minnes Kemp; Mor Mia,9990,0,9999,9
1746546955373,CSS 201S,A01,892054,Mignozzetti; Umberto,26,0,30,4
1746546956401,CSS 202S,A01,892056,Mignozzetti; Umberto,26,0,30,4
1746546957429,DSC 197,001,956898,Eldridge; Justin Matthew,9998,0,9999,1
1746546958454,DSC 297,001,958000,Mazumdar; Arya,9998,0,9999,1
1746546958454,DSC 297,002,959862,Wang; Yusu,9999,0,9999,0
1746546959480,EAP 100,A00,905686,Staff,9778,0,9999,221
1746546960510,ECE 45,A01,892618,Staff,0,0,65,65
1746546962561,ECE 111,A01,892719,Staff,4,0,65,61
1746546963586,ECE 197,001,957920,Mercier; Patrick Philip,9991,0,9999,8
1746546964616,ECON 178,A01,907814,Zhu; Ying,26,0,35,9
1746546965658,EDS 115,A00,895312,Staff,36,0,45,9
1746546966683,EDS 117,A01,895337,Staff,24,0,30,6
1746546967710,EDS 125,A00,895341,Jones; Gabrielle Anastasia,37,0,45,8
1746546968739,EDS 128A,A01,895459,Fargason; Sharon Gayle,44,0,45,1
1746546969765,EDS 128B,A01,895543,Pappas; Elizabeth,44,0,45,1
1746546970791,EDS 139,A00,897203,Pappas; Elizabeth,44,0,45,1
1746546970791,EDS 139,B00,897209,Fargason; Sharon Gayle,41,0,45,4
1746546971816,EDS 201,A00,895545,Staff,22,0,45,23
1746546972850,EDS 203,A01,895581,Halter; Christopher P.,22,0,45,23
1746546973879,EDS 204R,A01,895625,Heinzman; Erica M.,39,0,45,6
1746546973879,EDS 204R,B01,895693,Halter; Christopher P.,10,0,45,35
1746546974906,EDS 206R,A00,895694,Fargason; Sharon Gayle,1,0,30,29
1746546974906,EDS 206R,B00,895695,Choi; Bailey Miyeon,16,0,30,14
1746546975934,EDS 250,A00,895697,Hemans; Patricia Ann Benitez,22,0,45,23
1746546976958,EDS 281,A00,895701,Meyerott; Theresa Ann,1,0,15,14
1746546977985,EDS 284,A00,895736,Meyerott; Theresa Ann,1,0,15,14
1746546979009,EDS 286,A00,897210,Fine; Sarah,0,0,15,15
1746546980034,EDS 289C,A01,895770,Daly; Alan J.,15,0,15,0
1746546981060,EDS 290,A00,897211,Hofstetter; Carolyn,0,0,15,15
1746546982087,LIGM 5A,A00,896162,Fischer-Grunski; Eva K,13,0,20,7
1746546983111,LIGM 5B,A00,896260,Fischer-Grunski; Eva K,17,0,20,3
1746546984139,LIGM 5C,A00,896308,Fischer-Grunski; Eva K,18,0,20,2
1746546985168,LIIT 5AS,A00,896313,Carnelos; Chiara,18,0,20,2
1746546986196,LIIT 5BS,A00,896416,Carnelos; Chiara,20,0,20,0
1746546987221,LIIT 5CS,A00,896564,Carnelos; Chiara,20,0,20,0
1746546988250,LISP 5A,A00,896588,Munoz Sanchez; Alicia,3,0,20,17
1746546989277,LISP 5B,A00,896653,Munoz Sanchez; Alicia,7,0,20,13
1746546990307,LISP 5C,A00,896655,Munoz Sanchez; Alicia,0,1,20,20
1746546991330,MAE 197,001,957918,Kleissl; Jan,9996,0,9999,3
1746546991330,MAE 197,002,959806,Boechler; Nicholas Sebastia,9998,0,9999,1
1746546991330,MAE 197,003,959852,Mullin; Jennifer S,9999,0,9999,0
1746546992359,MATH 2,A01,957937,Staff,33,0,35,2
1746546993384,MATH 197,001,957876,Kedlaya; Kiran S.,9993,0,9999,6
1746546994410,MCWP 40,A00,892729,Duru; Nur,10,0,20,10
1746546994410,MCWP 40,B00,893304,Montejo; Carolina,14,0,20,6
1746546995435,MCWP 40R,A00,893757,Redela; Pamela Morgan,0,5,20,20
1746546996460,MCWP 50,A00,893758,Morshed; Michael James,0,0,20,20
1746546996460,MCWP 50,B00,893761,Bartulis; Jason Michael,17,0,20,3
1746546997488,MCWP 50R,A00,893766,Compas; Sean Matthew,0,1,20,20
1746546997488,MCWP 50R,B00,893769,Carter; Jennifer A,0,1,20,20
1746546997488,MCWP 50R,C00,893771,Krone; Jarret,0,3,20,20
1746546997488,MCWP 50R,D00,893772,Miller; Elizabeth Deen,0,0,20,20
1746546997488,MCWP 50R,E00,893775,Carter; Andrea L,0,1,20,20
1746546998515,MMW 11R,A01,892721,Herbst; Matthew,11,0,27,16
1746546998515,MMW 11R,A02,892722,Herbst; Matthew,0,0,0,3
1746546999544,MMW 12R,A01,892724,Herbst; Matthew,0,11,16,16
1746546999544,MMW 12R,A02,892725,Herbst; Matthew,0,10,16,16
1746547000567,MMW 13R,A01,892727,Staff,0,4,16,16
1746547000567,MMW 13R,A02,892728,Staff,0,4,16,16
1746547000567,MMW 13R,A03,958032,Staff,0,4,16,16
1746547000567,MMW 13R,A04,958033,Staff,0,4,16,16
1746547000567,MMW 13R,A05,958034,Staff,0,4,16,16
1746547001595,SIO 295LS,A00,894015,Staff,5,0,25,20
1746547002623,SIO 295S,A00,894020,Staff,5,0,25,20
1746547003650,SIOC 290S,B01,958918,Merrifield; Mark A,14,0,30,16
1746547004679,SIOC 291S,B01,958922,Gabriel; Corey John,14,0,30,16
1746547005705,SOCI 117,A01,895339,Staff,3,0,5,2
1746547006731,WES 237B,A00,894149,Staff,11,0,20,9
1746547008829,AESE 279B,A00,891859,Staff,13,0,35,22
1746547009856,AIP 197,001,891854,Vespa; Emanuel Ignacio,9999,0,9999,0
1746547010880,ANTH 289S,A00,891856,Gagneux; Pascal,12,0,12,0
1746547011907,BENG 196,001,957946,Engler; Adam J.,9996,0,9999,3
1746547012935,BISP 197,001,959851,Wilhelm; James E.,9998,0,9999,1
1746547013961,CAT 124RS,A01,956906,Staff,6,0,25,19
1746547014985,CAT 125RS,A01,922013,Staff,6,0,25,19
1746547016012,CLRE 250,A00,891860,Morris; Sheldon,9995,0,9999,4
1746547018066,CLRE 251R,A00,907817,Mehta; Ravindra L.,9994,0,9999,5
1746547019090,CLRE 252,A00,891864,Cuomo; Raphael Eduardo,9993,0,9999,6
1746547020116,CLRE 253,A00,891867,Vaida; Florin,9994,0,9999,5
1746547020116,CLRE 253,B00,907819,Staff,9999,0,9999,0
1746547021143,CLRE 259,A00,891868,Patel; Hemal,9998,0,9999,1
1746547022170,CLRE 260,A00,891872,Cuomo; Raphael Eduardo,9999,0,9999,0
1746547023197,CLRE 297,001,891888,Cuomo; Raphael Eduardo,9999,0,9999,0
1746547024225,CSE 191,A00,958773,Minnes Kemp; Mor Mia,9996,0,9999,3
1746547025253,CSE 197,001,959846,Minnes Kemp; Mor Mia,9990,0,9999,9
1746547026280,CSS 201S,A01,892054,Mignozzetti; Umberto,26,0,30,4
1746547027307,CSS 202S,A01,892056,Mignozzetti; Umberto,26,0,30,4
1746547028332,DSC 197,001,956898,Eldridge; Justin Matthew,9998,0,9999,1
1746547029355,DSC 297,001,958000,Mazumdar; Arya,9998,0,9999,1
1746547029355,DSC 297,002,959862,Wang; Yusu,9999,0,9999,0
1746547030383,EAP 100,A00,905686,Staff,9778,0,9999,221
1746547031412,ECE 45,A01,892618,Staff,0,0,65,65
1746547033466,ECE 111,A01,892719,Staff,4,0,65,61
1746547034495,ECE 197,001,957920,Mercier; Patrick Philip,9991,0,9999,8
1746547035521,ECON 178,A01,907814,Zhu; Ying,26,0,35,9
1746547036546,EDS 115,A00,895312,Staff,36,0,45,9
1746547037571,EDS 117,A01,895337,Staff,24,0,30,6
1746547038602,EDS 125,A00,895341,Jones; Gabrielle Anastasia,37,0,45,8
1746547039629,EDS 128A,A01,895459,Fargason; Sharon Gayle,44,0,45,1
1746547040745,EDS 128B,A01,895543,Pappas; Elizabeth,44,0,45,1
1746547041773,EDS 139,A00,897203,Pappas; Elizabeth,44,0,45,1
1746547041773,EDS 139,B00,897209,Fargason; Sharon Gayle,41,0,45,4
1746547042799,EDS 201,A00,895545,Staff,22,0,45,23
1746547043827,EDS 203,A01,895581,Halter; Christopher P.,22,0,45,23
1746547044855,EDS 204R,A01,895625,Heinzman; Erica M.,39,0,45,6
1746547044855,EDS 204R,B01,895693,Halter; Christopher P.,10,0,45,35
1746547045881,EDS 206R,A00,895694,Fargason; Sharon Gayle,1,0,30,29
1746547045881,EDS 206R,B00,895695,Choi; Bailey Miyeon,16,0,30,14
1746547046908,EDS 250,A00,895697,Hemans; Patricia Ann Benitez,22,0,45,23
1746547047934,EDS 281,A00,895701,Meyerott; Theresa Ann,1,0,15,14
1746547048961,EDS 284,A00,895736,Meyerott; Theresa Ann,1,0,15,14
1746547049988,EDS 286,A00,897210,Fine; Sarah,0,0,15,15
1746547051014,EDS 289C,A01,895770,Daly; Alan J.,15,0,15,0
1746547052042,EDS 290,A00,897211,Hofstetter; Carolyn,0,0,15,15
1746547053068,LIGM 5A,A00,896162,Fischer-Grunski; Eva K,13,0,20,7
1746547054094,LIGM 5B,A00,896260,Fischer-Grunski; Eva K,17,0,20,3
1746547055119,LIGM 5C,A00,896308,Fischer-Grunski; Eva K,18,0,20,2
1746547056144,LIIT 5AS,A00,896313,Carnelos; Chiara,18,0,20,2
1746547057173,LIIT 5BS,A00,896416,Carnelos; Chiara,20,0,20,0
1746547058200,LIIT 5CS,A00,896564,Carnelos; Chiara,20,0,20,0
1746547059226,LISP 5A,A00,896588,Munoz Sanchez; Alicia,3,0,20,17
1746547060256,LISP 5B,A00,896653,Munoz Sanchez; Alicia,7,0,20,13
1746547061283,LISP 5C,A00,896655,Munoz Sanchez; Alicia,0,1,20,20
1746547062310,MAE 197,001,957918,Kleissl; Jan,9996,0,9999,3
1746547062310,MAE 197,002,959806,Boechler; Nicholas Sebastia,9998,0,9999,1
1746547062310,MAE 197,003,959852,Mullin; Jennifer S,9999,0,9999,0
1746547063342,MATH 2,A01,957937,Staff,33,0,35,2
1746547064371,MATH 197,001,957876,Kedlaya; Kiran S.,9993,0,9999,6
1746547065396,MCWP 40,A00,892729,Duru; Nur,10,0,20,10
1746547065396,MCWP 40,B00,893304,Montejo; Carolina,14,0,20,6
1746547066420,MCWP 40R,A00,893757,Redela; Pamela Morgan,0,5,20,20
1746547067451,MCWP 50,A00,893758,Morshed; Michael James,0,0,20,20
1746547067451,MCWP 50,B00,893761,Bartulis; Jason Michael,17,0,20,3
1746547068477,MCWP 50R,A00,893766,Compas; Sean Matthew,0,1,20,20
1746547068477,MCWP 50R,B00,893769,Carter; Jennifer A,0,1,20,20
1746547068477,MCWP 50R,C00,893771,Krone; Jarret,0,3,20,20
1746547068477,MCWP 50R,D00,893772,Miller; Elizabeth Deen,0,0,20,20
1746547068477,MCWP 50R,E00,893775,Carter; Andrea L,0,1,20,20
1746547069506,MMW 11R,A01,892721,Herbst; Matthew,11,0,27,16
1746547069506,MMW 11R,A02,892722,Herbst; Matthew,0,0,0,3
1746547070534,MMW 12R,A01,892724,Herbst; Matthew,0,11,16,16
1746547070534,MMW 12R,A02,892725,Herbst; Matthew,0,10,16,16
1746547071560,MMW 13R,A01,892727,Staff,0,4,16,16
1746547071560,MMW 13R,A02,892728,Staff,0,4,16,16
1746547071560,MMW 13R,A03,958032,Staff,0,4,16,16
1746547071560,MMW 13R,A04,958033,Staff,0,4,16,16
1746547071560,MMW 13R,A05,958034,Staff,0,4,16,16
1746547072584,SIO 295LS,A00,894015,Staff,5,0,25,20
1746547073612,SIO 295S,A00,894020,Staff,5,0,25,20
1746547074638,SIOC 290S,B01,958918,Merrifield; Mark A,14,0,30,16
1746547075663,SIOC 291S,B01,958922,Gabriel; Corey John,14,0,30,16
1746547076689,SOCI 117,A01,895339,Staff,3,0,5,2
1746547077717,WES 237B,A00,894149,Staff,11,0,20,9
1746547079785,AESE 279B,A00,891859,Staff,13,0,35,22
1746547080811,AIP 197,001,891854,Vespa; Emanuel Ignacio,9999,0,9999,0
1746547081841,ANTH 289S,A00,891856,Gagneux; Pascal,12,0,12,0
1746547082869,BENG 196,001,957946,Engler; Adam J.,9996,0,9999,3
1746547083896,BISP 197,001,959851,Wilhelm; James E.,9998,0,9999,1
1746547084923,CAT 124RS,A01,956906,Staff,6,0,25,19
1746547085948,CAT 125RS,A01,922013,Staff,6,0,25,19
1746547086975,CLRE 250,A00,891860,Morris; Sheldon,9995,0,9999,4
1746547089030,CLRE 251R,A00,907817,Mehta; Ravindra L.,9994,0,9999,5
1746547090072,CLRE 252,A00,891864,Cuomo; Raphael Eduardo,9993,0,9999,6
1746547091100,CLRE 253,A00,891867,Vaida; Florin,9994,0,9999,5
1746547091100,CLRE 253,B00,907819,Staff,9999,0,9999,0
1746547092130,CLRE 259,A00,891868,Patel; Hemal,9998,0,9999,1
1746547093156,CLRE 260,A00,891872,Cuomo; Raphael Eduardo,9999,0,9999,0
1746547094183,CLRE 297,001,891888,Cuomo; Raphael Eduardo,9999,0,9999,0
1746547095210,CSE 191,A00,958773,Minnes Kemp; Mor Mia,9996,0,9999,3
1746547096235,CSE 197,001,959846,Minnes Kemp; Mor Mia,9990,0,9999,9
1746547097259,CSS 201S,A01,892054,Mignozzetti; Umberto,26,0,30,4
1746547098288,CSS 202S,A01,892056,Mignozzetti; Umberto,26,0,30,4
1746547099316,DSC 197,001,956898,Eldridge; Justin Matthew,9998,0,9999,1
1746547100342,DSC 297,001,958000,Mazumdar; Arya,9998,0,9999,1
1746547100342,DSC 297,002,959862,Wang; Yusu,9999,0,9999,0
1746547101370,EAP 100,A00,905686,Staff,9778,0,9999,221
1746547102397,ECE 45,A01,892618,Staff,0,0,65,65
1746547104448,ECE 111,A01,892719,Staff,4,0,65,61
1746547105473,ECE 197,001,957920,Mercier; Patrick Philip,9991,0,9999,8
1746547106502,ECON 178,A01,907814,Zhu; Ying,26,0,35,9
1746547107526,EDS 115,A00,895312,Staff,36,0,45,9
1746547108554,EDS 117,A01,895337,Staff,24,0,30,6
1746547109582,EDS 125,A00,895341,Jones; Gabrielle Anastasia,37,0,45,8
1746547110607,EDS 128A,A01,895459,Fargason; Sharon Gayle,44,0,45,1
1746547111634,EDS 128B,A01,895543,Pappas; Elizabeth,44,0,45,1
1746547112662,EDS 139,A00,897203,Pappas; Elizabeth,44,0,45,1
1746547112662,EDS 139,B00,897209,Fargason; Sharon Gayle,41,0,45,4
1746547113686,EDS 201,A00,895545,Staff,22,0,45,23
1746547114712,EDS 203,A01,895581,Halter; Christopher P.,22,0,45,23
1746547115737,EDS 204R,A01,895625,Heinzman; Erica M.,39,0,45,6
1746547115737,EDS 204R,B01,895693,Halter; Christopher P.,10,0,45,35
1746547116761,EDS 206R,A00,895694,Fargason; Sharon Gayle,1,0,30,29
1746547116761,EDS 206R,B00,895695,Choi; Bailey Miyeon,16,0,30,14
1746547117789,EDS 250,A00,895697,Hemans; Patricia Ann Benitez,22,0,45,23
1746547118816,EDS 281,A00,895701,Meyerott; Theresa Ann,1,0,15,14
1746547119840,EDS 284,A00,895736,Meyerott; Theresa Ann,1,0,15,14
1746547120865,EDS 286,A00,897210,Fine; Sarah,0,0,15,15
1746547121889,EDS 289C,A01,895770,Daly; Alan J.,15,0,15,0
1746547122918,EDS 290,A00,897211,Hofstetter; Carolyn,0,0,15,15
1746547123947,LIGM 5A,A00,896162,Fischer-Grunski; Eva K,13,0,20,7
1746547124975,LIGM 5B,A00,896260,Fischer-Grunski; Eva K,17,0,20,3
1746547126002,LIGM 5C,A00,896308,Fischer-Grunski; Eva K,18,0,20,2
1746547127028,LIIT 5AS,A00,896313,Carnelos; Chiara,18,0,20,2
1746547128054,LIIT 5BS,A00,896416,Carnelos; Chiara,20,0,20,0
1746547129081,LIIT 5CS,A00,896564,Carnelos; Chiara,20,0,20,0
1746547130106,LISP 5A,A00,896588,Munoz Sanchez; Alicia,3,0,20,17
1746547131136,LISP 5B,A00,896653,Munoz Sanchez; Alicia,7,0,20,13
1746547132166,LISP 5C,A00,896655,Munoz Sanchez; Alicia,0,1,20,20
1746547133195,MAE 197,001,957918,Kleissl; Jan,9996,0,9999,3
1746547133195,MAE 197,002,959806,Boechler; Nicholas Sebastia,9998,0,9999,1
1746547133195,MAE 197,003,959852,Mullin; Jennifer S,9999,0,9999,0
1746547134222,MATH 2,A01,957937,Staff,33,0,35,2
1746547135245,MATH 197,001,957876,Kedlaya; Kiran S.,9993,0,9999,6
1746547136273,MCWP 40,A00,892729,Duru; Nur,10,0,20,10
1746547136273,MCWP 40,B00,893304,Montejo; Carolina,14,0,20,6
1746547137299,MCWP 40R,A00,893757,Redela; Pamela Morgan,0,5,20,20
1746547138324,MCWP 50,A00,893758,Morshed; Michael James,0,0,20,20
1746547138324,MCWP 50,B00,893761,Bartulis; Jason Michael,17,0,20,3
1746547139351,MCWP 50R,A00,893766,Compas; Sean Matthew,0,1,20,20
1746547139351,MCWP 50R,B00,893769,Carter; Jennifer A,0,1,20,20
1746547139351,MCWP 50R,C00,893771,Krone; Jarret,0,3,20,20
1746547139351,MCWP 50R,D00,893772,Miller; Elizabeth Deen,0,0,20,20
1746547139351,MCWP 50R,E00,893775,Carter; Andrea L,0,1,20,20
1746547140377,MMW 11R,A01,892721,Herbst; Matthew,11,0,27,16
1746547140377,MMW 11R,A02,892722,Herbst; Matthew,0,0,0,3
1746547141424,MMW 12R,A01,892724,Herbst; Matthew,0,11,16,16
1746547141424,MMW 12R,A02,892725,Herbst; Matthew,0,10,16,16
1746547142449,MMW 13R,A01,892727,Staff,0,4,16,16
1746547142449,MMW 13R,A02,892728,Staff,0,4,16,16
1746547142449,MMW 13R,A03,958032,Staff,0,4,16,16
1746547142449,MMW 13R,A04,958033,Staff,0,4,16,16
1746547142449,MMW 13R,A05,958034,Staff,0,4,16,16
1746547143476,SIO 295LS,A00,894015,Staff,5,0,25,20
1746547144503,SIO 295S,A00,894020,Staff,5,0,25,20
1746547145535,SIOC 290S,B01,958918,Merrifield; Mark A,14,0,30,16
1746547146561,SIOC 291S,B01,958922,Gabriel; Corey John,14,0,30,16
1746547147588,SOCI 117,A01,895339,Staff,3,0,5,2
1746547148613,WES 237B,A00,894149,Staff,11,0,20,9
1746547150683,AESE 279B,A00,891859,Staff,13,0,35,22
1746547151709,AIP 197,001,891854,Vespa; Emanuel Ignacio,9999,0,9999,0
1746547152734,ANTH 289S,A00,891856,Gagneux; Pascal,12,0,12,0
1746547153760,BENG 196,001,957946,Engler; Adam J.,9996,0,9999,3
1746547154785,BISP 197,001,959851,Wilhelm; James E.,9998,0,9999,1
1746547155816,CAT 124RS,A01,956906,Staff,6,0,25,19
1746547156840,CAT 125RS,A01,922013,Staff,6,0,25,19
1746547157867,CLRE 250,A00,891860,Morris; Sheldon,9995,0,9999,4
1746547159916,CLRE 251R,A00,907817,Mehta; Ravindra L.,9994,0,9999,5
1746547160940,CLRE 252,A00,891864,Cuomo; Raphael Eduardo,9993,0,9999,6
1746547161965,CLRE 253,A00,891867,Vaida; Florin,9994,0,9999,5
1746547161965,CLRE 253,B00,907819,Staff,9999,0,9999,0
1746547163002,CLRE 259,A00,891868,Patel; Hemal,9998,0,9999,1
1746547164028,CLRE 260,A00,891872,Cuomo; Raphael Eduardo,9999,0,9999,0
1746547165054,CLRE 297,001,891888,Cuomo; Raphael Eduardo,9999,0,9999,0
1746547166081,CSE 191,A00,958773,Minnes Kemp; Mor Mia,9996,0,9999,3
1746547167106,CSE 197,001,959846,Minnes Kemp; Mor Mia,9990,0,9999,9
1746547168135,CSS 201S,A01,892054,Mignozzetti; Umberto,26,0,30,4
1746547169160,CSS 202S,A01,892056,Mignozzetti; Umberto,26,0,30,4
1746547170185,DSC 197,001,956898,Eldridge; Justin Matthew,9998,0,9999,1
1746547171210,DSC 297,001,958000,Mazumdar; Arya,9998,0,9999,1
1746547171210,DSC 297,002,959862,Wang; Yusu,9999,0,9999,0
1746547172238,EAP 100,A00,905686,Staff,9778,0,9999,221
1746547173263,ECE 45,A01,892618,Staff,0,0,65,65
1746547175314,ECE 111,A01,892719,Staff,4,0,65,61
1746547176339,ECE 197,001,957920,Mercier; Patrick Philip,9991,0,9999,8
1746547177370,ECON 178,A01,907814,Zhu; Ying,26,0,35,9
1746547178396,EDS 115,A00,895312,Staff,36,0,45,9
1746547179425,EDS 117,A01,895337,Staff,24,0,30,6
1746547180455,EDS 125,A00,895341,Jones; Gabrielle Anastasia,37,0,45,8
1746547181480,EDS 128A,A01,895459,Fargason; Sharon Gayle,44,0,45,1
1746547182507,EDS 128B,A01,895543,Pappas; Elizabeth,44,0,45,1
1746547183531,EDS 139,A00,897203,Pappas; Elizabeth,44,0,45,1
1746547183531,EDS 139,B00,897209,Fargason; Sharon Gayle,41,0,45,4
1746547184557,EDS 201,A00,895545,Staff,22,0,45,23
1746547185584,EDS 203,A01,895581,Halter; Christopher P.,22,0,45,23
1746547186608,EDS 204R,A01,895625,Heinzman; Erica M.,39,0,45,6
1746547186608,EDS 204R,B01,895693,Halter; Christopher P.,10,0,45,35
1746547187635,EDS 206R,A00,895694,Fargason; Sharon Gayle,1,0,30,29
1746547187635,EDS 206R,B00,895695,Choi; Bailey Miyeon,16,0,30,14
1746547188663,EDS 250,A00,895697,Hemans; Patricia Ann Benitez,22,0,45,23
1746547189691,EDS 281,A00,895701,Meyerott; Theresa Ann,1,0,15,14
1746547190719,EDS 284,A00,895736,Meyerott; Theresa Ann,1,0,15,14
1746547191744,EDS 286,A00,897210,Fine; Sarah,0,0,15,15
1746547192771,EDS 289C,A01,895770,Daly; Alan J.,15,0,15,0
1746547193797,EDS 290,A00,897211,Hofstetter; Carolyn,0,0,15,15
1746547194825,LIGM 5A,A00,896162,Fischer-Grunski; Eva K,13,0,20,7
1746547195850,LIGM 5B,A00,896260,Fischer-Grunski; Eva K,17,0,20,3
1746547196876,LIGM 5C,A00,896308,Fischer-Grunski; Eva K,18,0,20,2
1746547197905,LIIT 5AS,A00,896313,Carnelos; Chiara,18,0,20,2
1746547198931,LIIT 5BS,A00,896416,Carnelos; Chiara,20,0,20,0
1746547199960,LIIT 5CS,A00,896564,Carnelos; Chiara,20,0,20,0
1746547200985,LISP 5A,A00,896588,Munoz Sanchez; Alicia,3,0,20,17
1746547202012,LISP 5B,A00,896653,Munoz Sanchez; Alicia,7,0,20,13
1746547203037,LISP 5C,A00,896655,Munoz Sanchez; Alicia,0,1,20,20
1746547204061,MAE 197,001,957918,Kleissl; Jan,9996,0,9999,3
1746547204061,MAE 197,002,959806,Boechler; Nicholas Sebastia,9998,0,9999,1
1746547204061,MAE 197,003,959852,Mullin; Jennifer S,9999,0,9999,0
1746547205087,MATH 2,A01,957937,Staff,33,0,35,2
1746547206115,MATH 197,001,957876,Kedlaya; Kiran S.,9993,0,9999,6
1746547207145,MCWP 40,A00,892729,Duru; Nur,10,0,20,10
1746547207145,MCWP 40,B00,893304,Montejo; Carolina,14,0,20,6
1746547208171,MCWP 40R,A00,893757,Redela; Pamela Morgan,0,5,20,20
1746547209197,MCWP 50,A00,893758,Morshed; Michael James,0,0,20,20
1746547209197,MCWP 50,B00,893761,Bartulis; Jason Michael,17,0,20,3
1746547210228,MCWP 50R,A00,893766,Compas; Sean Matthew,0,1,20,20
1746547210228,MCWP 50R,B00,893769,Carter; Jennifer A,0,1,20,20
1746547210228,MCWP 50R,C00,893771,Krone; Jarret,0,3,20,20
1746547210228,MCWP 50R,D00,893772,Miller; Elizabeth Deen,0,0,20,20
1746547210228,MCWP 50R,E00,893775,Carter; Andrea L,0,1,20,20
1746547211254,MMW 11R,A01,892721,Herbst; Matthew,11,0,27,16
1746547211254,MMW 11R,A02,892722,Herbst; Matthew,0,0,0,3
1746547212280,MMW 12R,A01,892724,Herbst; Matthew,0,11,16,16
1746547212280,MMW 12R,A02,892725,Herbst; Matthew,0,10,16,16
1746547213305,MMW 13R,A01,892727,Staff,0,4,16,16
1746547213305,MMW 13R,A02,892728,Staff,0,4,16,16
1746547213305,MMW 13R,A03,958032,Staff,0,4,16,16
1746547213305,MMW 13R,A04,958033,Staff,0,4,16,16
1746547213305,MMW 13R,A05,958034,Staff,0,4,16,16
1746547214332,SIO 295LS,A00,894015,Staff,5,0,25,20
1746547215360,SIO 295S,A00,894020,Staff,5,0,25,20
1746547216386,SIOC 290S,B01,958918,Merrifield; Mark A,14,0,30,16
1746547217411,SIOC 291S,B01,958922,Gabriel; Corey John,14,0,30,16
1746547218438,SOCI 117,A01,895339,Staff,3,0,5,2
1746547219466,WES 237B,A00,894149,Staff,11,0,20,9
1746547221530,AESE 279B,A00,891859,Staff,13,0,35,22
1746547222557,AIP 197,001,891854,Vespa; Emanuel Ignacio,9999,0,9999,0
1746547223585,ANTH 289S,A00,891856,Gagneux; Pascal,12,0,12,0
1746547224612,BENG 196,001,957946,Engler; Adam J.,9996,0,9999,3
1746547225639,BISP 197,001,959851,Wilhelm; James E.,9998,0,9999,1
1746547226666,CAT 124RS,A01,956906,Staff,6,0,25,19
1746547227693,CAT 125RS,A01,922013,Staff,6,0,25,19
1746547228719,CLRE 250,A00,891860,Morris; Sheldon,9995,0,9999,4
1746547230770,CLRE 251R,A00,907817,Mehta; Ravindra L.,9994,0,9999,5
1746547231795,CLRE 252,A00,891864,Cuomo; Raphael Eduardo,9993,0,9999,6
1746547232821,CLRE 253,A00,891867,Vaida; Florin,9994,0,9999,5
1746547232821,CLRE 253,B00,907819,Staff,9999,0,9999,0
1746547233847,CLRE 259,A00,891868,Patel; Hemal,9998,0,9999,1
1746547234876,CLRE 260,A00,891872,Cuomo; Raphael Eduardo,9999,0,9999,0
1746547235902,CLRE 297,001,891888,Cuomo; Raphael Eduardo,9999,0,9999,0
1746547236925,CSE 191,A00,958773,Minnes Kemp; Mor Mia,9996,0,9999,3
1746547237954,CSE 197,001,959846,Minnes Kemp; Mor Mia,9990,0,9999,9
1746547238980,CSS 201S,A01,892054,Mignozzetti; Umberto,26,0,30,4
1746547240007,CSS 202S,A01,892056,Mignozzetti; Umberto,26,0,30,4
1746547241033,DSC 197,001,956898,Eldridge; Justin Matthew,9998,0,9999,1
1746547242056,DSC 297,001,958000,Mazumdar; Arya,9998,0,9999,1
1746547242056,DSC 297,002,959862,Wang; Yusu,9999,0,9999,0
1746547243083,EAP 100,A00,905686,Staff,9778,0,9999,221
1746547244109,ECE 45,A01,892618,Staff,0,0,65,65
1746547246162,ECE 111,A01,892719,Staff,4,0,65,61
1746547247190,ECE 197,001,957920,Mercier; Patrick Philip,9991,0,9999,8
1746547248216,ECON 178,A01,907814,Zhu; Ying,26,0,35,9
1746547249245,EDS 115,A00,895312,Staff,36,0,45,9
1746547250270,EDS 117,A01,895337,Staff,24,0,30,6
1746547251297,EDS 125,A00,895341,Jones; Gabrielle Anastasia,37,0,45,8
1746547252322,EDS 128A,A01,895459,Fargason; Sharon Gayle,44,0,45,1
1746547253346,EDS 128B,A01,895543,Pappas; Elizabeth,44,0,45,1
1746547254372,EDS 139,A00,897203,Pappas; Elizabeth,44,0,45,1
1746547254372,EDS 139,B00,897209,Fargason; Sharon Gayle,41,0,45,4
1746547255400,EDS 201,A00,895545,Staff,22,0,45,23
1746547256426,EDS 203,A01,895581,Halter; Christopher P.,22,0,45,23
1746547257454,EDS 204R,A01,895625,Heinzman; Erica M.,39,0,45,6
1746547257454,EDS 204R,B01,895693,Halter; Christopher P.,10,0,45,35
1746547258481,EDS 206R,A00,895694,Fargason; Sharon Gayle,1,0,30,29
1746547258481,EDS 206R,B00,895695,Choi; Bailey Miyeon,16,0,30,14
1746547259509,EDS 250,A00,895697,Hemans; Patricia Ann Benitez,22,0,45,23
1746547260537,EDS 281,A00,895701,Meyerott; Theresa Ann,1,0,15,14
1746547261562,EDS 284,A00,895736,Meyerott; Theresa Ann,1,0,15,14
1746547262598,EDS 286,A00,897210,Fine; Sarah,0,0,15,15
1746547263623,EDS 289C,A01,895770,Daly; Alan J.,15,0,15,0
1746547264649,EDS 290,A00,897211,Hofstetter; Carolyn,0,0,15,15
1746547265677,LIGM 5A,A00,896162,Fischer-Grunski; Eva K,13,0,20,7
1746547266701,LIGM 5B,A00,896260,Fischer-Grunski; Eva K,17,0,20,3
1746547267726,LIGM 5C,A00,896308,Fischer-Grunski; Eva K,18,0,20,2
1746547268753,LIIT 5AS,A00,896313,Carnelos; Chiara,18,0,20,2
1746547269780,LIIT 5BS,A00,896416,Carnelos; Chiara,20,0,20,0
1746547270807,LIIT 5CS,A00,896564,Carnelos; Chiara,20,0,20,0
1746547271834,LISP 5A,A00,896588,Munoz Sanchez; Alicia,3,0,20,17
1746547272859,LISP 5B,A00,896653,Munoz Sanchez; Alicia,7,0,20,13
1746547273887,LISP 5C,A00,896655,Munoz Sanchez; Alicia,0,1,20,20
1746547274915,MAE 197,001,957918,Kleissl; Jan,9996,0,9999,3
1746547274915,MAE 197,002,959806,Boechler; Nicholas Sebastia,9998,0,9999,1
1746547274915,MAE 197,003,959852,Mullin; Jennifer S,9998,0,9999,1
1746547275943,MATH 2,A01,957937,Staff,33,0,35,2
1746547276974,MATH 197,001,957876,Kedlaya; Kiran S.,9993,0,9999,6
1746547278002,MCWP 40,A00,892729,Duru; Nur,10,0,20,10
1746547278002,MCWP 40,B00,893304,Montejo; Carolina,14,0,20,6
1746547279033,MCWP 40R,A00,893757,Redela; Pamela Morgan,0,5,20,20
1746547280063,MCWP 50,A00,893758,Morshed; Michael James,0,0,20,20
1746547280063,MCWP 50,B00,893761,Bartulis; Jason Michael,17,0,20,3
1746547281094,MCWP 50R,A00,893766,Compas; Sean Matthew,0,1,20,20
1746547281094,MCWP 50R,B00,893769,Carter; Jennifer A,0,1,20,20
1746547281094,MCWP 50R,C00,893771,Krone; Jarret,0,3,20,20
1746547281094,MCWP 50R,D00,893772,Miller; Elizabeth Deen,0,0,20,20
1746547281094,MCWP 50R,E00,893775,Carter; Andrea L,0,1,20,20
1746547282120,MMW 11R,A01,892721,Herbst; Matthew,11,0,27,16
1746547282120,MMW 11R,A02,892722,Herbst; Matthew,0,0,0,3
1746547283146,MMW 12R,A01,892724,Herbst; Matthew,0,11,16,16
1746547283146,MMW 12R,A02,892725,Herbst; Matthew,0,10,16,16
1746547284174,MMW 13R,A01,892727,Staff,0,4,16,16
1746547284174,MMW 13R,A02,892728,Staff,0,4,16,16
1746547284174,MMW 13R,A03,958032,Staff,0,4,16,16
1746547284174,MMW 13R,A04,958033,Staff,0,4,16,16
1746547284174,MMW 13R,A05,958034,Staff,0,4,16,16
1746547285200,SIO 295LS,A00,894015,Staff,5,0,25,20
1746547286229,SIO 295S,A00,894020,Staff,5,0,25,20
1746547287258,SIOC 290S,B01,958918,Merrifield; Mark A,14,0,30,16
1746547288289,SIOC 291S,B01,958922,Gabriel; Corey John,14,0,30,16
1746547289316,SOCI 117,A01,895339,Staff,3,0,5,2
1746547290343,WES 237B,A00,894149,Staff,11,0,20,9
1746547292406,AESE 279B,A00,891859,Staff,13,0,35,22
1746547293430,AIP 197,001,891854,Vespa; Emanuel Ignacio,9999,0,9999,0
1746547294455,ANTH 289S,A00,891856,Gagneux; Pascal,12,0,12,0
1746547295480,BENG 196,001,957946,Engler; Adam J.,9996,0,9999,3
1746547296509,BISP 197,001,959851,Wilhelm; James E.,9998,0,9999,1
1746547297533,CAT 124RS,A01,956906,Staff,6,0,25,19
1746547298560,CAT 125RS,A01,922013,Staff,6,0,25,19
1746547299589,CLRE 250,A00,891860,Morris; Sheldon,9995,0,9999,4
1746547301644,CLRE 251R,A00,907817,Mehta; Ravindra L.,9994,0,9999,5
1746547302670,CLRE 252,A00,891864,Cuomo; Raphael Eduardo,9993,0,9999,6
1746547303696,CLRE 253,A00,891867,Vaida; Florin,9994,0,9999,5
1746547303696,CLRE 253,B00,907819,Staff,9999,0,9999,0
1746547304724,CLRE 259,A00,891868,Patel; Hemal,9998,0,9999,1
1746547305751,CLRE 260,A00,891872,Cuomo; Raphael Eduardo,9999,0,9999,0
1746547306774,CLRE 297,001,891888,Cuomo; Raphael Eduardo,9999,0,9999,0
1746547307803,CSE 191,A00,958773,Minnes Kemp; Mor Mia,9996,0,9999,3
1746547308831,CSE 197,001,959846,Minnes Kemp; Mor Mia,9990,0,9999,9
1746547309858,CSS 201S,A01,892054,Mignozzetti; Umberto,26,0,30,4
1746547310884,CSS 202S,A01,892056,Mignozzetti; Umberto,26,0,30,4
1746547311909,DSC 197,001,956898,Eldridge; Justin Matthew,9998,0,9999,1
1746547312939,DSC 297,001,958000,Mazumdar; Arya,9998,0,9999,1
1746547312939,DSC 297,002,959862,Wang; Yusu,9999,0,9999,0
1746547313966,EAP 100,A00,905686,Staff,9778,0,9999,221
1746547314996,ECE 45,A01,892618,Staff,0,0,65,65
1746547317052,ECE 111,A01,892719,Staff,4,0,65,61
1746547318080,ECE 197,001,957920,Mercier; Patrick Philip,9991,0,9999,8
1746547319107,ECON 178,A01,907814,Zhu; Ying,26,0,35,9
1746547320144,EDS 115,A00,895312,Staff,36,0,45,9
1746547321170,EDS 117,A01,895337,Staff,24,0,30,6
1746547322198,EDS 125,A00,895341,Jones; Gabrielle Anastasia,37,0,45,8
1746547323222,EDS 128A,A01,895459,Fargason; Sharon Gayle,44,0,45,1
1746547324251,EDS 128B,A01,895543,Pappas; Elizabeth,44,0,45,1
1746547325280,EDS 139,A00,897203,Pappas; Elizabeth,44,0,45,1
1746547325280,EDS 139,B00,897209,Fargason; Sharon Gayle,41,0,45,4
1746547326304,EDS 201,A00,895545,Staff,22,0,45,23
1746547327331,EDS 203,A01,895581,Halter; Christopher P.,22,0,45,23
1746547328357,EDS 204R,A01,895625,Heinzman; Erica M.,39,0,45,6
1746547328357,EDS 204R,B01,895693,Halter; Christopher P.,10,0,45,35
1746547329382,EDS 206R,A00,895694,Fargason; Sharon Gayle,1,0,30,29
1746547329382,EDS 206R,B00,895695,Choi; Bailey Miyeon,16,0,30,14
1746547330407,EDS 250,A00,895697,Hemans; Patricia Ann Benitez,22,0,45,23
1746547331432,EDS 281,A00,895701,Meyerott; Theresa Ann,1,0,15,14
1746547332457,EDS 284,A00,895736,Meyerott; Theresa Ann,1,0,15,14
1746547333487,EDS 286,A00,897210,Fine; Sarah,0,0,15,15
1746547334512,EDS 289C,A01,895770,Daly; Alan J.,15,0,15,0
1746547335540,EDS 290,A00,897211,Hofstetter; Carolyn,0,0,15,15
1746547336568,LIGM 5A,A00,896162,Fischer-Grunski; Eva K,13,0,20,7
1746547337592,LIGM 5B,A00,896260,Fischer-Grunski; Eva K,17,0,20,3
1746547338618,LIGM 5C,A00,896308,Fischer-Grunski; Eva K,18,0,20,2
1746547339647,LIIT 5AS,A00,896313,Carnelos; Chiara,18,0,20,2
1746547340674,LIIT 5BS,A00,896416,Carnelos; Chiara,20,0,20,0
1746547341702,LIIT 5CS,A00,896564,Carnelos; Chiara,20,0,20,0
1746547342727,LISP 5A,A00,896588,Munoz Sanchez; Alicia,3,0,20,17
1746547343754,LISP 5B,A00,896653,Munoz Sanchez; Alicia,7,0,20,13
1746547344780,LISP 5C,A00,896655,Munoz Sanchez; Alicia,0,1,20,20
1746547345807,MAE 197,001,957918,Kleissl; Jan,9996,0,9999,3
1746547345807,MAE 197,002,959806,Boechler; Nicholas Sebastia,9998,0,9999,1
1746547345807,MAE 197,003,959852,Mullin; Jennifer S,9998,0,9999,1
1746547346831,MATH 2,A01,957937,Staff,33,0,35,2
1746547347858,MATH 197,001,957876,Kedlaya; Kiran S.,9993,0,9999,6
1746547348886,MCWP 40,A00,892729,Duru; Nur,10,0,20,10
1746547348886,MCWP 40,B00,893304,Montejo; Carolina,14,0,20,6
1746547349912,MCWP 40R,A00,893757,Redela; Pamela Morgan,0,5,20,20
1746547350941,MCWP 50,A00,893758,Morshed; Michael James,0,0,20,20
1746547350941,MCWP 50,B00,893761,Bartulis; Jason Michael,17,0,20,3
1746547351967,MCWP 50R,A00,893766,Compas; Sean Matthew,0,1,20,20
1746547351967,MCWP 50R,B00,893769,Carter; Jennifer A,0,1,20,20
1746547351967,MCWP 50R,C00,893771,Krone; Jarret,0,3,20,20
1746547351967,MCWP 50R,D00,893772,Miller; Elizabeth Deen,0,0,20,20
1746547351967,MCWP 50R,E00,893775,Carter; Andrea L,0,1,20,20
1746547352993,MMW 11R,A01,892721,Herbst; Matthew,11,0,27,16
1746547352993,MMW 11R,A02,892722,Herbst; Matthew,0,0,0,3
1746547354021,MMW 12R,A01,892724,Herbst; Matthew,0,11,16,16
1746547354021,MMW 12R,A02,892725,Herbst; Matthew,0,10,16,16
1746547355047,MMW 13R,A01,892727,Staff,0,4,16,16
1746547355047,MMW 13R,A02,892728,Staff,0,4,16,16
1746547355047,MMW 13R,A03,958032,Staff,0,4,16,16
1746547355047,MMW 13R,A04,958033,Staff,0,4,16,16
1746547355047,MMW 13R,A05,958034,Staff,0,4,16,16
1746547356074,SIO 295LS,A00,894015,Staff,5,0,25,20
1746547357101,SIO 295S,A00,894020,Staff,5,0,25,20
1746547358126,SIOC 290S,B01,958918,Merrifield; Mark A,14,0,30,16
1746547359155,SIOC 291S,B01,958922,Gabriel; Corey John,14,0,30,16
1746547360184,SOCI 117,A01,895339,Staff,3,0,5,2
1746547361209,WES 237B,A00,894149,Staff,11,0,20,9
1746547363269,AESE 279B,A00,891859,Staff,13,0,35,22
1746547364293,AIP 197,001,891854,Vespa; Emanuel Ignacio,9999,0,9999,0
1746547365319,ANTH 289S,A00,891856,Gagneux; Pascal,12,0,12,0
1746547366345,BENG 196,001,957946,Engler; Adam J.,9996,0,9999,3
1746547367372,BISP 197,001,959851,Wilhelm; James E.,9998,0,9999,1
1746547368398,CAT 124RS,A01,956906,Staff,6,0,25,19
1746547369424,CAT 125RS,A01,922013,Staff,6,0,25,19
1746547370452,CLRE 250,A00,891860,Morris; Sheldon,9995,0,9999,4
1746547372508,CLRE 251R,A00,907817,Mehta; Ravindra L.,9994,0,9999,5
1746547373536,CLRE 252,A00,891864,Cuomo; Raphael Eduardo,9993,0,9999,6
1746547374562,CLRE 253,A00,891867,Vaida; Florin,9994,0,9999,5
1746547374562,CLRE 253,B00,907819,Staff,9999,0,9999,0
1746547375588,CLRE 259,A00,891868,Patel; Hemal,9998,0,9999,1
1746547376618,CLRE 260,A00,891872,Cuomo; Raphael Eduardo,9999,0,9999,0
1746547377641,CLRE 297,001,891888,Cuomo; Raphael Eduardo,9999,0,9999,0
1746547378670,CSE 191,A00,958773,Minnes Kemp; Mor Mia,9996,0,9999,3
1746547379698,CSE 197,001,959846,Minnes Kemp; Mor Mia,9990,0,9999,9
1746547380724,CSS 201S,A01,892054,Mignozzetti; Umberto,26,0,30,4
1746547381751,CSS 202S,A01,892056,Mignozzetti; Umberto,26,0,30,4
1746547382781,DSC 197,001,956898,Eldridge; Justin Matthew,9998,0,9999,1
1746547383806,DSC 297,001,958000,Mazumdar; Arya,9998,0,9999,1
1746547383806,DSC 297,002,959862,Wang; Yusu,9999,0,9999,0
1746547384831,EAP 100,A00,905686,Staff,9778,0,9999,221
1746547385857,ECE 45,A01,892618,Staff,0,0,65,65
1746547387906,ECE 111,A01,892719,Staff,4,0,65,61
1746547388934,ECE 197,001,957920,Mercier; Patrick Philip,9991,0,9999,8
1746547389959,ECON 178,A01,907814,Zhu; Ying,26,0,35,9
1746547390985,EDS 115,A00,895312,Staff,36,0,45,9
1746547392013,EDS 117,A01,895337,Staff,24,0,30,6
1746547393038,EDS 125,A00,895341,Jones; Gabrielle Anastasia,37,0,45,8
1746547394063,EDS 128A,A01,895459,Fargason; Sharon Gayle,44,0,45,1
1746547395088,EDS 128B,A01,895543,Pappas; Elizabeth,44,0,45,1
1746547396117,EDS 139,A00,897203,Pappas; Elizabeth,44,0,45,1
1746547396117,EDS 139,B00,897209,Fargason; Sharon Gayle,41,0,45,4
1746547397141,EDS 201,A00,895545,Staff,22,0,45,23
1746547398167,EDS 203,A01,895581,Halter; Christopher P.,22,0,45,23
1746547399197,EDS 204R,A01,895625,Heinzman; Erica M.,39,0,45,6
1746547399197,EDS 204R,B01,895693,Halter; Christopher P.,10,0,45,35
1746547400223,EDS 206R,A00,895694,Fargason; Sharon Gayle,1,0,30,29
1746547400223,EDS 206R,B00,895695,Choi; Bailey Miyeon,16,0,30,14
1746547401252,EDS 250,A00,895697,Hemans; Patricia Ann Benitez,22,0,45,23
1746547402275,EDS 281,A00,895701,Meyerott; Theresa Ann,1,0,15,14
1746547403300,EDS 284,A00,895736,Meyerott; Theresa Ann,1,0,15,14
1746547404326,EDS 286,A00,897210,Fine; Sarah,0,0,15,15
1746547405350,EDS 289C,A01,895770,Daly; Alan J.,15,0,15,0
1746547406376,EDS 290,A00,897211,Hofstetter; Carolyn,0,0,15,15
1746547407402,LIGM 5A,A00,896162,Fischer-Grunski; Eva K,13,0,20,7
1746547408426,LIGM 5B,A00,896260,Fischer-Grunski; Eva K,17,0,20,3
1746547409453,LIGM 5C,A00,896308,Fischer-Grunski; Eva K,18,0,20,2
1746547410483,LIIT 5AS,A00,896313,Carnelos; Chiara,18,0,20,2
1746547411507,LIIT 5BS,A00,896416,Carnelos; Chiara,20,0,20,0
1746547412536,LIIT 5CS,A00,896564,Carnelos; Chiara,20,0,20,0
1746547413563,LISP 5A,A00,896588,Munoz Sanchez; Alicia,3,0,20,17
1746547414589,LISP 5B,A00,896653,Munoz Sanchez; Alicia,7,0,20,13
1746547415615,LISP 5C,A00,896655,Munoz Sanchez; Alicia,0,1,20,20
1746547416642,MAE 197,001,957918,Kleissl; Jan,9996,0,9999,3
1746547416642,MAE 197,002,959806,Boechler; Nicholas Sebastia,9998,0,9999,1
1746547416642,MAE 197,003,959852,Mullin; Jennifer S,9998,0,9999,1
1746547417668,MATH 2,A01,957937,Staff,33,0,35,2
1746547418695,MATH 197,001,957876,Kedlaya; Kiran S.,9993,0,9999,6
1746547419722,MCWP 40,A00,892729,Duru; Nur,10,0,20,10
1746547419722,MCWP 40,B00,893304,Montejo; Carolina,14,0,20,6
1746547420748,MCWP 40R,A00,893757,Redela; Pamela Morgan,0,5,20,20
1746547421775,MCWP 50,A00,893758,Morshed; Michael James,0,0,20,20
1746547421775,MCWP 50,B00,893761,Bartulis; Jason Michael,17,0,20,3
1746547422800,MCWP 50R,A00,893766,Compas; Sean Matthew,0,1,20,20
1746547422800,MCWP 50R,B00,893769,Carter; Jennifer A,0,1,20,20
1746547422800,MCWP 50R,C00,893771,Krone; Jarret,0,3,20,20
1746547422800,MCWP 50R,D00,893772,Miller; Elizabeth Deen,0,0,20,20
1746547422800,MCWP 50R,E00,893775,Carter; Andrea L,0,1,20,20
1746547423827,MMW 11R,A01,892721,Herbst; Matthew,11,0,27,16
1746547423827,MMW 11R,A02,892722,Herbst; Matthew,0,0,0,3
1746547424856,MMW 12R,A01,892724,Herbst; Matthew,0,11,16,16
1746547424856,MMW 12R,A02,892725,Herbst; Matthew,0,10,16,16
1746547425884,MMW 13R,A01,892727,Staff,0,4,16,16
1746547425884,MMW 13R,A02,892728,Staff,0,4,16,16
1746547425884,MMW 13R,A03,958032,Staff,0,4,16,16
1746547425884,MMW 13R,A04,958033,Staff,0,4,16,16
1746547425884,MMW 13R,A05,958034,Staff,0,4,16,16
1746547426910,SIO 295LS,A00,894015,Staff,5,0,25,20
1746547427934,SIO 295S,A00,894020,Staff,5,0,25,20
1746547428960,SIOC 290S,B01,958918,Merrifield; Mark A,14,0,30,16
1746547429991,SIOC 291S,B01,958922,Gabriel; Corey John,14,0,30,16
1746547431019,SOCI 117,A01,895339,Staff,3,0,5,2
1746547432045,WES 237B,A00,894149,Staff,11,0,20,9
1746547434105,AESE 279B,A00,891859,Staff,13,0,35,22
1746547435133,AIP 197,001,891854,Vespa; Emanuel Ignacio,9999,0,9999,0
1746547436158,ANTH 289S,A00,891856,Gagneux; Pascal,12,0,12,0
1746547437185,BENG 196,001,957946,Engler; Adam J.,9996,0,9999,3
1746547438209,BISP 197,001,959851,Wilhelm; James E.,9998,0,9999,1
1746547439237,CAT 124RS,A01,956906,Staff,6,0,25,19
1746547440263,CAT 125RS,A01,922013,Staff,6,0,25,19
1746547441293,CLRE 250,A00,891860,Morris; Sheldon,9995,0,9999,4
1746547443349,CLRE 251R,A00,907817,Mehta; Ravindra L.,9994,0,9999,5
1746547444374,CLRE 252,A00,891864,Cuomo; Raphael Eduardo,9993,0,9999,6
1746547445403,CLRE 253,A00,891867,Vaida; Florin,9994,0,9999,5
1746547445403,CLRE 253,B00,907819,Staff,9999,0,9999,0
1746547446429,CLRE 259,A00,891868,Patel; Hemal,9998,0,9999,1
1746547447457,CLRE 260,A00,891872,Cuomo; Raphael Eduardo,9999,0,9999,0
1746547448481,CLRE 297,001,891888,Cuomo; Raphael Eduardo,9999,0,9999,0
1746547449507,CSE 191,A00,958773,Minnes Kemp; Mor Mia,9996,0,9999,3
1746547450531,CSE 197,001,959846,Minnes Kemp; Mor Mia,9990,0,9999,9
1746547451560,CSS 201S,A01,892054,Mignozzetti; Umberto,26,0,30,4
1746547452588,CSS 202S,A01,892056,Mignozzetti; Umberto,26,0,30,4
1746547453613,DSC 197,001,956898,Eldridge; Justin Matthew,9998,0,9999,1
1746547454640,DSC 297,001,958000,Mazumdar; Arya,9998,0,9999,1
1746547454640,DSC 297,002,959862,Wang; Yusu,9999,0,9999,0
1746547455664,EAP 100,A00,905686,Staff,9778,0,9999,221
1746547456693,ECE 45,A01,892618,Staff,0,0,65,65
1746547458747,ECE 111,A01,892719,Staff,4,0,65,61
1746547459774,ECE 197,001,957920,Mercier; Patrick Philip,9991,0,9999,8
1746547460803,ECON 178,A01,907814,Zhu; Ying,26,0,35,9
1746547461828,EDS 115,A00,895312,Staff,36,0,45,9
1746547462856,EDS 117,A01,895337,Staff,24,0,30,6
1746547463884,EDS 125,A00,895341,Jones; Gabrielle Anastasia,37,0,45,8
1746547464911,EDS 128A,A01,895459,Fargason; Sharon Gayle,44,0,45,1
1746547465940,EDS 128B,A01,895543,Pappas; Elizabeth,44,0,45,1
1746547466967,EDS 139,A00,897203,Pappas; Elizabeth,44,0,45,1
1746547466967,EDS 139,B00,897209,Fargason; Sharon Gayle,41,0,45,4
1746547467993,EDS 201,A00,895545,Staff,22,0,45,23
1746547469022,EDS 203,A01,895581,Halter; Christopher P.,22,0,45,23
1746547470050,EDS 204R,A01,895625,Heinzman; Erica M.,39,0,45,6
1746547470050,EDS 204R,B01,895693,Halter; Christopher P.,10,0,45,35
1746547471074,EDS 206R,A00,895694,Fargason; Sharon Gayle,1,0,30,29
1746547471074,EDS 206R,B00,895695,Choi; Bailey Miyeon,16,0,30,14
1746547472103,EDS 250,A00,895697,Hemans; Patricia Ann Benitez,22,0,45,23
1746547473127,EDS 281,A00,895701,Meyerott; Theresa Ann,1,0,15,14
1746547474154,EDS 284,A00,895736,Meyerott; Theresa Ann,1,0,15,14
1746547475183,EDS 286,A00,897210,Fine; Sarah,0,0,15,15
1746547476206,EDS 289C,A01,895770,Daly; Alan J.,15,0,15,0
1746547477232,EDS 290,A00,897211,Hofstetter; Carolyn,0,0,15,15
1746547478262,LIGM 5A,A00,896162,Fischer-Grunski; Eva K,13,0,20,7
1746547479293,LIGM 5B,A00,896260,Fischer-Grunski; Eva K,17,0,20,3
1746547480320,LIGM 5C,A00,896308,Fischer-Grunski; Eva K,18,0,20,2
1746547481349,LIIT 5AS,A00,896313,Carnelos; Chiara,18,0,20,2
1746547482377,LIIT 5BS,A00,896416,Carnelos; Chiara,20,0,20,0
1746547483402,LIIT 5CS,A00,896564,Carnelos; Chiara,20,0,20,0
1746547484429,LISP 5A,A00,896588,Munoz Sanchez; Alicia,3,0,20,17
1746547485458,LISP 5B,A00,896653,Munoz Sanchez; Alicia,7,0,20,13
1746547486484,LISP 5C,A00,896655,Munoz Sanchez; Alicia,0,1,20,20
1746547487510,MAE 197,001,957918,Kleissl; Jan,9996,0,9999,3
1746547487510,MAE 197,002,959806,Boechler; Nicholas Sebastia,9998,0,9999,1
1746547487510,MAE 197,003,959852,Mullin; Jennifer S,9998,0,9999,1
1746547488538,MATH 2,A01,957937,Staff,33,0,35,2
1746547489565,MATH 197,001,957876,Kedlaya; Kiran S.,9993,0,9999,6
1746547490591,MCWP 40,A00,892729,Duru; Nur,10,0,20,10
1746547490591,MCWP 40,B00,893304,Montejo; Carolina,14,0,20,6
1746547491617,MCWP 40R,A00,893757,Redela; Pamela Morgan,0,5,20,20
1746547492645,MCWP 50,A00,893758,Morshed; Michael James,0,0,20,20
1746547492645,MCWP 50,B00,893761,Bartulis; Jason Michael,17,0,20,3
1746547493672,MCWP 50R,A00,893766,Compas; Sean Matthew,0,1,20,20
1746547493672,MCWP 50R,B00,893769,Carter; Jennifer A,0,1,20,20
1746547493672,MCWP 50R,C00,893771,Krone; Jarret,0,3,20,20
1746547493672,MCWP 50R,D00,893772,Miller; Elizabeth Deen,0,0,20,20
1746547493672,MCWP 50R,E00,893775,Carter; Andrea L,0,1,20,20
1746547494701,MMW 11R,A01,892721,Herbst; Matthew,11,0,27,16
1746547494701,MMW 11R,A02,892722,Herbst; Matthew,0,0,0,3
1746547495765,MMW 12R,A01,892724,Herbst; Matthew,0,11,16,16
1746547495765,MMW 12R,A02,892725,Herbst; Matthew,0,10,16,16
1746547496791,MMW 13R,A01,892727,Staff,0,4,16,16
1746547496791,MMW 13R,A02,892728,Staff,0,4,16,16
1746547496791,MMW 13R,A03,958032,Staff,0,4,16,16
1746547496791,MMW 13R,A04,958033,Staff,0,4,16,16
1746547496791,MMW 13R,A05,958034,Staff,0,4,16,16
1746547497817,SIO 295LS,A00,894015,Staff,5,0,25,20
1746547498847,SIO 295S,A00,894020,Staff,5,0,25,20
1746547499875,SIOC 290S,B01,958918,Merrifield; Mark A,14,0,30,16
1746547500899,SIOC 291S,B01,958922,Gabriel; Corey John,14,0,30,16
1746547501927,SOCI 117,A01,895339,Staff,3,0,5,2
1746547502954,WES 237B,A00,894149,Staff,11,0,20,9
1746547505016,AESE 279B,A00,891859,Staff,13,0,35,22
1746547506043,AIP 197,001,891854,Vespa; Emanuel Ignacio,9999,0,9999,0
1746547507070,ANTH 289S,A00,891856,Gagneux; Pascal,12,0,12,0
1746547508099,BENG 196,001,957946,Engler; Adam J.,9996,0,9999,3
1746547509124,BISP 197,001,959851,Wilhelm; James E.,9998,0,9999,1
1746547510153,CAT 124RS,A01,956906,Staff,6,0,25,19
1746547511180,CAT 125RS,A01,922013,Staff,6,0,25,19
1746547512205,CLRE 250,A00,891860,Morris; Sheldon,9995,0,9999,4
1746547514254,CLRE 251R,A00,907817,Mehta; Ravindra L.,9994,0,9999,5
1746547515280,CLRE 252,A00,891864,Cuomo; Raphael Eduardo,9993,0,9999,6
1746547516308,CLRE 253,A00,891867,Vaida; Florin,9994,0,9999,5
1746547516308,CLRE 253,B00,907819,Staff,9999,0,9999,0
1746547517336,CLRE 259,A00,891868,Patel; Hemal,9998,0,9999,1
1746547518361,CLRE 260,A00,891872,Cuomo; Raphael Eduardo,9999,0,9999,0
1746547519389,CLRE 297,001,891888,Cuomo; Raphael Eduardo,9999,0,9999,0
1746547520415,CSE 191,A00,958773,Minnes Kemp; Mor Mia,9996,0,9999,3
1746547521444,CSE 197,001,959846,Minnes Kemp; Mor Mia,9990,0,9999,9
1746547522470,CSS 201S,A01,892054,Mignozzetti; Umberto,26,0,30,4
1746547523498,CSS 202S,A01,892056,Mignozzetti; Umberto,26,0,30,4
1746547524526,DSC 197,001,956898,Eldridge; Justin Matthew,9998,0,9999,1
1746547525550,DSC 297,001,958000,Mazumdar; Arya,9998,0,9999,1
1746547525550,DSC 297,002,959862,Wang; Yusu,9999,0,9999,0
1746547526573,EAP 100,A00,905686,Staff,9778,0,9999,221
1746547527599,ECE 45,A01,892618,Staff,0,0,65,65
1746547529652,ECE 111,A01,892719,Staff,4,0,65,61
1746547530677,ECE 197,001,957920,Mercier; Patrick Philip,9991,0,9999,8
1746547531704,ECON 178,A01,907814,Zhu; Ying,26,0,35,9
1746547532728,EDS 115,A00,895312,Staff,36,0,45,9
1746547533755,EDS 117,A01,895337,Staff,24,0,30,6
1746547534781,EDS 125,A00,895341,Jones; Gabrielle Anastasia,37,0,45,8
1746547535808,EDS 128A,A01,895459,Fargason; Sharon Gayle,44,0,45,1
1746547536833,EDS 128B,A01,895543,Pappas; Elizabeth,44,0,45,1
1746547537858,EDS 139,A00,897203,Pappas; Elizabeth,44,0,45,1
1746547537858,EDS 139,B00,897209,Fargason; Sharon Gayle,41,0,45,4
1746547538888,EDS 201,A00,895545,Staff,22,0,45,23
1746547539915,EDS 203,A01,895581,Halter; Christopher P.,22,0,45,23
1746547540941,EDS 204R,A01,895625,Heinzman; Erica M.,39,0,45,6
1746547540941,EDS 204R,B01,895693,Halter; Christopher P.,10,0,45,35
1746547541967,EDS 206R,A00,895694,Fargason; Sharon Gayle,1,0,30,29
1746547541967,EDS 206R,B00,895695,Choi; Bailey Miyeon,16,0,30,14
1746547542995,EDS 250,A00,895697,Hemans; Patricia Ann Benitez,22,0,45,23
1746547544019,EDS 281,A00,895701,Meyerott; Theresa Ann,1,0,15,14
1746547545051,EDS 284,A00,895736,Meyerott; Theresa Ann,1,0,15,14
1746547546078,EDS 286,A00,897210,Fine; Sarah,0,0,15,15
1746547547108,EDS 289C,A01,895770,Daly; Alan J.,15,0,15,0
1746547548133,EDS 290,A00,897211,Hofstetter; Carolyn,0,0,15,15
1746547549158,LIGM 5A,A00,896162,Fischer-Grunski; Eva K,13,0,20,7
1746547550188,LIGM 5B,A00,896260,Fischer-Grunski; Eva K,17,0,20,3
1746547551214,LIGM 5C,A00,896308,Fischer-Grunski; Eva K,18,0,20,2
1746547552240,LIIT 5AS,A00,896313,Carnelos; Chiara,18,0,20,2
1746547553264,LIIT 5BS,A00,896416,Carnelos; Chiara,20,0,20,0
1746547554290,LIIT 5CS,A00,896564,Carnelos; Chiara,20,0,20,0
1746547555319,LISP 5A,A00,896588,Munoz Sanchez; Alicia,3,0,20,17
1746547556345,LISP 5B,A00,896653,Munoz Sanchez; Alicia,7,0,20,13
1746547557373,LISP 5C,A00,896655,Munoz Sanchez; Alicia,0,1,20,20
1746547558398,MAE 197,001,957918,Kleissl; Jan,9996,0,9999,3
1746547558398,MAE 197,002,959806,Boechler; Nicholas Sebastia,9998,0,9999,1
1746547558398,MAE 197,003,959852,Mullin; Jennifer S,9998,0,9999,1
1746547559423,MATH 2,A01,957937,Staff,33,0,35,2
1746547560452,MATH 197,001,957876,Kedlaya; Kiran S.,9993,0,9999,6
1746547561481,MCWP 40,A00,892729,Duru; Nur,10,0,20,10
1746547561481,MCWP 40,B00,893304,Montejo; Carolina,14,0,20,6
1746547562510,MCWP 40R,A00,893757,Redela; Pamela Morgan,0,5,20,20
1746547563536,MCWP 50,A00,893758,Morshed; Michael James,0,0,20,20
1746547563536,MCWP 50,B00,893761,Bartulis; Jason Michael,17,0,20,3
1746547564564,MCWP 50R,A00,893766,Compas; Sean Matthew,0,1,20,20
1746547564564,MCWP 50R,B00,893769,Carter; Jennifer A,0,1,20,20
1746547564564,MCWP 50R,C00,893771,Krone; Jarret,0,3,20,20
1746547564564,MCWP 50R,D00,893772,Miller; Elizabeth Deen,0,0,20,20
1746547564564,MCWP 50R,E00,893775,Carter; Andrea L,0,1,20,20
1746547565589,MMW 11R,A01,892721,Herbst; Matthew,11,0,27,16
1746547565589,MMW 11R,A02,892722,Herbst; Matthew,0,0,0,3
1746547566613,MMW 12R,A01,892724,Herbst; Matthew,0,11,16,16
1746547566613,MMW 12R,A02,892725,Herbst; Matthew,0,10,16,16
1746547567642,MMW 13R,A01,892727,Staff,0,4,16,16
1746547567642,MMW 13R,A02,892728,Staff,0,4,16,16
1746547567642,MMW 13R,A03,958032,Staff,0,4,16,16
1746547567642,MMW 13R,A04,958033,Staff,0,4,16,16
1746547567642,MMW 13R,A05,958034,Staff,0,4,16,16
1746547568669,SIO 295LS,A00,894015,Staff,5,0,25,20
1746547569697,SIO 295S,A00,894020,Staff,5,0,25,20
1746547570725,SIOC 290S,B01,958918,Merrifield; Mark A,14,0,30,16
1746547571750,SIOC 291S,B01,958922,Gabriel; Corey John,14,0,30,16
1746547572776,SOCI 117,A01,895339,Staff,3,0,5,2
1746547573800,WES 237B,A00,894149,Staff,11,0,20,9
1746547575862,AESE 279B,A00,891859,Staff,13,0,35,22
1746547576887,AIP 197,001,891854,Vespa; Emanuel Ignacio,9999,0,9999,0
1746547577916,ANTH 289S,A00,891856,Gagneux; Pascal,12,0,12,0
1746547578941,BENG 196,001,957946,Engler; Adam J.,9996,0,9999,3
1746547579972,BISP 197,001,959851,Wilhelm; James E.,9998,0,9999,1
1746547580998,CAT 124RS,A01,956906,Staff,6,0,25,19
1746547582024,CAT 125RS,A01,922013,Staff,6,0,25,19
1746547583050,CLRE 250,A00,891860,Morris; Sheldon,9995,0,9999,4
1746547585108,CLRE 251R,A00,907817,Mehta; Ravindra L.,9994,0,9999,5
1746547586134,CLRE 252,A00,891864,Cuomo; Raphael Eduardo,9993,0,9999,6
1746547587159,CLRE 253,A00,891867,Vaida; Florin,9994,0,9999,5
1746547587159,CLRE 253,B00,907819,Staff,9999,0,9999,0
1746547588184,CLRE 259,A00,891868,Patel; Hemal,9998,0,9999,1
1746547589213,CLRE 260,A00,891872,Cuomo; Raphael Eduardo,9999,0,9999,0
1746547590241,CLRE 297,001,891888,Cuomo; Raphael Eduardo,9999,0,9999,0
1746547591269,CSE 191,A00,958773,Minnes Kemp; Mor Mia,9996,0,9999,3
1746547592297,CSE 197,001,959846,Minnes Kemp; Mor Mia,9990,0,9999,9
1746547593327,CSS 201S,A01,892054,Mignozzetti; Umberto,26,0,30,4
1746547594351,CSS 202S,A01,892056,Mignozzetti; Umberto,26,0,30,4
1746547595380,DSC 197,001,956898,Eldridge; Justin Matthew,9998,0,9999,1
1746547596407,DSC 297,001,958000,Mazumdar; Arya,9998,0,9999,1
1746547596407,DSC 297,002,959862,Wang; Yusu,9999,0,9999,0
1746547597433,EAP 100,A00,905686,Staff,9778,0,9999,221
1746547598463,ECE 45,A01,892618,Staff,0,0,65,65
1746547600572,ECE 111,A01,892719,Staff,4,0,65,61
1746547601601,ECE 197,001,957920,Mercier; Patrick Philip,9991,0,9999,8
1746547602631,ECON 178,A01,907814,Zhu; Ying,26,0,35,9
1746547603659,EDS 115,A00,895312,Staff,36,0,45,9
1746547604683,EDS 117,A01,895337,Staff,24,0,30,6
1746547605709,EDS 125,A00,895341,Jones; Gabrielle Anastasia,37,0,45,8
1746547606737,EDS 128A,A01,895459,Fargason; Sharon Gayle,44,0,45,1
1746547607766,EDS 128B,A01,895543,Pappas; Elizabeth,44,0,45,1
1746547608795,EDS 139,A00,897203,Pappas; Elizabeth,44,0,45,1
1746547608795,EDS 139,B00,897209,Fargason; Sharon Gayle,41,0,45,4
1746547609820,EDS 201,A00,895545,Staff,22,0,45,23
1746547610847,EDS 203,A01,895581,Halter; Christopher P.,22,0,45,23
1746547611871,EDS 204R,A01,895625,Heinzman; Erica M.,39,0,45,6
1746547611871,EDS 204R,B01,895693,Halter; Christopher P.,10,0,45,35
1746547612897,EDS 206R,A00,895694,Fargason; Sharon Gayle,1,0,30,29
1746547612897,EDS 206R,B00,895695,Choi; Bailey Miyeon,16,0,30,14
1746547613925,EDS 250,A00,895697,Hemans; Patricia Ann Benitez,22,0,45,23
1746547614950,EDS 281,A00,895701,Meyerott; Theresa Ann,1,0,15,14
1746547615976,EDS 284,A00,895736,Meyerott; Theresa Ann,1,0,15,14
1746547617002,EDS 286,A00,897210,Fine; Sarah,0,0,15,15
1746547618031,EDS 289C,A01,895770,Daly; Alan J.,15,0,15,0
1746547619060,EDS 290,A00,897211,Hofstetter; Carolyn,0,0,15,15
1746547620090,LIGM 5A,A00,896162,Fischer-Grunski; Eva K,13,0,20,7
1746547621117,LIGM 5B,A00,896260,Fischer-Grunski; Eva K,17,0,20,3
1746547622145,LIGM 5C,A00,896308,Fischer-Grunski; Eva K,18,0,20,2
1746547623174,LIIT 5AS,A00,896313,Carnelos; Chiara,18,0,20,2
1746547624198,LIIT 5BS,A00,896416,Carnelos; Chiara,20,0,20,0
1746547625227,LIIT 5CS,A00,896564,Carnelos; Chiara,20,0,20,0
1746547626252,LISP 5A,A00,896588,Munoz Sanchez; Alicia,3,0,20,17
1746547627280,LISP 5B,A00,896653,Munoz Sanchez; Alicia,7,0,20,13
1746547628309,LISP 5C,A00,896655,Munoz Sanchez; Alicia,0,1,20,20
1746547629337,MAE 197,001,957918,Kleissl; Jan,9996,0,9999,3
1746547629337,MAE 197,002,959806,Boechler; Nicholas Sebastia,9998,0,9999,1
1746547629337,MAE 197,003,959852,Mullin; Jennifer S,9998,0,9999,1
1746547630362,MATH 2,A01,957937,Staff,33,0,35,2
1746547631386,MATH 197,001,957876,Kedlaya; Kiran S.,9993,0,9999,6
1746547632420,MCWP 40,A00,892729,Duru; Nur,10,0,20,10
1746547632420,MCWP 40,B00,893304,Montejo; Carolina,14,0,20,6
1746547633446,MCWP 40R,A00,893757,Redela; Pamela Morgan,0,5,20,20
1746547634472,MCWP 50,A00,893758,Morshed; Michael James,0,0,20,20
1746547634472,MCWP 50,B00,893761,Bartulis; Jason Michael,17,0,20,3
1746547635497,MCWP 50R,A00,893766,Compas; Sean Matthew,0,1,20,20
1746547635497,MCWP 50R,B00,893769,Carter; Jennifer A,0,1,20,20
1746547635497,MCWP 50R,C00,893771,Krone; Jarret,0,3,20,20
1746547635497,MCWP 50R,D00,893772,Miller; Elizabeth Deen,0,0,20,20
1746547635497,MCWP 50R,E00,893775,Carter; Andrea L,0,1,20,20
1746547636526,MMW 11R,A01,892721,Herbst; Matthew,11,0,27,16
1746547636526,MMW 11R,A02,892722,Herbst; Matthew,0,0,0,3
1746547637554,MMW 12R,A01,892724,Herbst; Matthew,0,11,16,16
1746547637554,MMW 12R,A02,892725,Herbst; Matthew,0,10,16,16
1746547638584,MMW 13R,A01,892727,Staff,0,4,16,16
1746547638584,MMW 13R,A02,892728,Staff,0,4,16,16
1746547638584,MMW 13R,A03,958032,Staff,0,4,16,16
1746547638584,MMW 13R,A04,958033,Staff,0,4,16,16
1746547638584,MMW 13R,A05,958034,Staff,0,4,16,16
1746547639608,SIO 295LS,A00,894015,Staff,5,0,25,20
1746547640636,SIO 295S,A00,894020,Staff,5,0,25,20
1746547641663,SIOC 290S,B01,958918,Merrifield; Mark A,14,0,30,16
1746547642691,SIOC 291S,B01,958922,Gabriel; Corey John,14,0,30,16
1746547643716,SOCI 117,A01,895339,Staff,3,0,5,2
1746547644741,WES 237B,A00,894149,Staff,11,0,20,9
1746547646801,AESE 279B,A00,891859,Staff,13,0,35,22
1746547647828,AIP 197,001,891854,Vespa; Emanuel Ignacio,9999,0,9999,0
1746547648857,ANTH 289S,A00,891856,Gagneux; Pascal,12,0,12,0
1746547649883,BENG 196,001,957946,Engler; Adam J.,9996,0,9999,3
1746547650911,BISP 197,001,959851,Wilhelm; James E.,9998,0,9999,1
1746547651938,CAT 124RS,A01,956906,Staff,6,0,25,19
1746547652964,CAT 125RS,A01,922013,Staff,6,0,25,19
1746547653992,CLRE 250,A00,891860,Morris; Sheldon,9995,0,9999,4
1746547656045,CLRE 251R,A00,907817,Mehta; Ravindra L.,9994,0,9999,5
1746547657070,CLRE 252,A00,891864,Cuomo; Raphael Eduardo,9993,0,9999,6
1746547658099,CLRE 253,A00,891867,Vaida; Florin,9994,0,9999,5
1746547658099,CLRE 253,B00,907819,Staff,9999,0,9999,0
1746547659128,CLRE 259,A00,891868,Patel; Hemal,9998,0,9999,1
1746547660156,CLRE 260,A00,891872,Cuomo; Raphael Eduardo,9999,0,9999,0
1746547661182,CLRE 297,001,891888,Cuomo; Raphael Eduardo,9999,0,9999,0
1746547662210,CSE 191,A00,958773,Minnes Kemp; Mor Mia,9996,0,9999,3
1746547663235,CSE 197,001,959846,Minnes Kemp; Mor Mia,9990,0,9999,9
1746547664264,CSS 201S,A01,892054,Mignozzetti; Umberto,26,0,30,4
1746547665291,CSS 202S,A01,892056,Mignozzetti; Umberto,26,0,30,4
1746547666321,DSC 197,001,956898,Eldridge; Justin Matthew,9998,0,9999,1
1746547667347,DSC 297,001,958000,Mazumdar; Arya,9998,0,9999,1
1746547667347,DSC 297,002,959862,Wang; Yusu,9999,0,9999,0
1746547668375,EAP 100,A00,905686,Staff,9778,0,9999,221
1746547669403,ECE 45,A01,892618,Staff,0,0,65,65
1746547671456,ECE 111,A01,892719,Staff,4,0,65,61
1746547672484,ECE 197,001,957920,Mercier; Patrick Philip,9991,0,9999,8
1746547673512,ECON 178,A01,907814,Zhu; Ying,26,0,35,9
1746547674540,EDS 115,A00,895312,Staff,36,0,45,9
1746547675566,EDS 117,A01,895337,Staff,24,0,30,6
1746547676595,EDS 125,A00,895341,Jones; Gabrielle Anastasia,37,0,45,8
1746547677619,EDS 128A,A01,895459,Fargason; Sharon Gayle,44,0,45,1
1746547678648,EDS 128B,A01,895543,Pappas; Elizabeth,44,0,45,1
1746547679674,EDS 139,A00,897203,Pappas; Elizabeth,44,0,45,1
1746547679674,EDS 139,B00,897209,Fargason; Sharon Gayle,41,0,45,4
1746547680699,EDS 201,A00,895545,Staff,22,0,45,23
1746547681727,EDS 203,A01,895581,Halter; Christopher P.,22,0,45,23
1746547682755,EDS 204R,A01,895625,Heinzman; Erica M.,39,0,45,6
1746547682755,EDS 204R,B01,895693,Halter; Christopher P.,10,0,45,35
1746547683783,EDS 206R,A00,895694,Fargason; Sharon Gayle,1,0,30,29
1746547683783,EDS 206R,B00,895695,Choi; Bailey Miyeon,16,0,30,14
1746547684812,EDS 250,A00,895697,Hemans; Patricia Ann Benitez,22,0,45,23
1746547685839,EDS 281,A00,895701,Meyerott; Theresa Ann,1,0,15,14
1746547686866,EDS 284,A00,895736,Meyerott; Theresa Ann,1,0,15,14
1746547687894,EDS 286,A00,897210,Fine; Sarah,0,0,15,15
1746547688920,EDS 289C,A01,895770,Daly; Alan J.,15,0,15,0
1746547689946,EDS 290,A00,897211,Hofstetter; Carolyn,0,0,15,15
1746547690973,LIGM 5A,A00,896162,Fischer-Grunski; Eva K,13,0,20,7
1746547692001,LIGM 5B,A00,896260,Fischer-Grunski; Eva K,17,0,20,3
1746547693027,LIGM 5C,A00,896308,Fischer-Grunski; Eva K,18,0,20,2
1746547694053,LIIT 5AS,A00,896313,Carnelos; Chiara,18,0,20,2
1746547695086,LIIT 5BS,A00,896416,Carnelos; Chiara,20,0,20,0
1746547696134,LIIT 5CS,A00,896564,Carnelos; Chiara,20,0,20,0
1746547697159,LISP 5A,A00,896588,Munoz Sanchez; Alicia,3,0,20,17
1746547698186,LISP 5B,A00,896653,Munoz Sanchez; Alicia,7,0,20,13
1746547699213,LISP 5C,A00,896655,Munoz Sanchez; Alicia,0,1,20,20
1746547700242,MAE 197,001,957918,Kleissl; Jan,9996,0,9999,3
1746547700242,MAE 197,002,959806,Boechler; Nicholas Sebastia,9998,0,9999,1
1746547700242,MAE 197,003,959852,Mullin; Jennifer S,9998,0,9999,1
1746547701266,MATH 2,A01,957937,Staff,33,0,35,2
1746547702293,MATH 197,001,957876,Kedlaya; Kiran S.,9993,0,9999,6
1746547703320,MCWP 40,A00,892729,Duru; Nur,10,0,20,10
1746547703320,MCWP 40,B00,893304,Montejo; Carolina,14,0,20,6
1746547704346,MCWP 40R,A00,893757,Redela; Pamela Morgan,0,5,20,20
1746547705370,MCWP 50,A00,893758,Morshed; Michael James,0,0,20,20
1746547705370,MCWP 50,B00,893761,Bartulis; Jason Michael,17,0,20,3
1746547706395,MCWP 50R,A00,893766,Compas; Sean Matthew,0,1,20,20
1746547706395,MCWP 50R,B00,893769,Carter; Jennifer A,0,1,20,20
1746547706395,MCWP 50R,C00,893771,Krone; Jarret,0,3,20,20
1746547706395,MCWP 50R,D00,893772,Miller; Elizabeth Deen,0,0,20,20
1746547706395,MCWP 50R,E00,893775,Carter; Andrea L,0,1,20,20
1746547707426,MMW 11R,A01,892721,Herbst; Matthew,11,0,27,16
1746547707426,MMW 11R,A02,892722,Herbst; Matthew,0,0,0,3
1746547708453,MMW 12R,A01,892724,Herbst; Matthew,0,11,16,16
1746547708453,MMW 12R,A02,892725,Herbst; Matthew,0,10,16,16
1746547709479,MMW 13R,A01,892727,Staff,0,4,16,16
1746547709479,MMW 13R,A02,892728,Staff,0,4,16,16
1746547709479,MMW 13R,A03,958032,Staff,0,4,16,16
1746547709479,MMW 13R,A04,958033,Staff,0,4,16,16
1746547709479,MMW 13R,A05,958034,Staff,0,4,16,16
1746547710507,SIO 295LS,A00,894015,Staff,5,0,25,20
1746547711534,SIO 295S,A00,894020,Staff,5,0,25,20
1746547712560,SIOC 290S,B01,958918,Merrifield; Mark A,14,0,30,16
1746547713584,SIOC 291S,B01,958922,Gabriel; Corey John,14,0,30,16
1746547714608,SOCI 117,A01,895339,Staff,3,0,5,2
1746547715633,WES 237B,A00,894149,Staff,11,0,20,9
1746547717689,AESE 279B,A00,891859,Staff,13,0,35,22
1746547718715,AIP 197,001,891854,Vespa; Emanuel Ignacio,9999,0,9999,0
1746547719739,ANTH 289S,A00,891856,Gagneux; Pascal,12,0,12,0
1746547720763,BENG 196,001,957946,Engler; Adam J.,9996,0,9999,3
1746547721790,BISP 197,001,959851,Wilhelm; James E.,9998,0,9999,1
1746547722818,CAT 124RS,A01,956906,Staff,6,0,25,19
1746547723846,CAT 125RS,A01,922013,Staff,6,0,25,19
1746547724872,CLRE 250,A00,891860,Morris; Sheldon,9995,0,9999,4
1746547726920,CLRE 251R,A00,907817,Mehta; Ravindra L.,9994,0,9999,5
1746547727946,CLRE 252,A00,891864,Cuomo; Raphael Eduardo,9993,0,9999,6
1746547728973,CLRE 253,A00,891867,Vaida; Florin,9994,0,9999,5
1746547728973,CLRE 253,B00,907819,Staff,9999,0,9999,0
1746547729999,CLRE 259,A00,891868,Patel; Hemal,9998,0,9999,1
1746547731026,CLRE 260,A00,891872,Cuomo; Raphael Eduardo,9999,0,9999,0
1746547732052,CLRE 297,001,891888,Cuomo; Raphael Eduardo,9999,0,9999,0
1746547733086,CSE 191,A00,958773,Minnes Kemp; Mor Mia,9996,0,9999,3
1746547734113,CSE 197,001,959846,Minnes Kemp; Mor Mia,9990,0,9999,9
1746547735143,CSS 201S,A01,892054,Mignozzetti; Umberto,26,0,30,4
1746547736172,CSS 202S,A01,892056,Mignozzetti; Umberto,26,0,30,4
1746547737196,DSC 197,001,956898,Eldridge; Justin Matthew,9998,0,9999,1
1746547738221,DSC 297,001,958000,Mazumdar; Arya,9998,0,9999,1
1746547738221,DSC 297,002,959862,Wang; Yusu,9999,0,9999,0
1746547739246,EAP 100,A00,905686,Staff,9778,0,9999,221
1746547740271,ECE 45,A01,892618,Staff,0,0,65,65
1746547742320,ECE 111,A01,892719,Staff,4,0,65,61
1746547743347,ECE 197,001,957920,Mercier; Patrick Philip,9991,0,9999,8
1746547744371,ECON 178,A01,907814,Zhu; Ying,26,0,35,9
1746547745395,EDS 115,A00,895312,Staff,36,0,45,9
1746547746418,EDS 117,A01,895337,Staff,24,0,30,6
1746547747444,EDS 125,A00,895341,Jones; Gabrielle Anastasia,37,0,45,8
1746547748470,EDS 128A,A01,895459,Fargason; Sharon Gayle,44,0,45,1
1746547749498,EDS 128B,A01,895543,Pappas; Elizabeth,44,0,45,1
1746547750526,EDS 139,A00,897203,Pappas; Elizabeth,44,0,45,1
1746547750526,EDS 139,B00,897209,Fargason; Sharon Gayle,41,0,45,4
1746547751555,EDS 201,A00,895545,Staff,22,0,45,23
1746547752578,EDS 203,A01,895581,Halter; Christopher P.,22,0,45,23
1746547753605,EDS 204R,A01,895625,Heinzman; Erica M.,39,0,45,6
1746547753605,EDS 204R,B01,895693,Halter; Christopher P.,10,0,45,35
1746547754628,EDS 206R,A00,895694,Fargason; Sharon Gayle,1,0,30,29
1746547754628,EDS 206R,B00,895695,Choi; Bailey Miyeon,16,0,30,14
1746547755658,EDS 250,A00,895697,Hemans; Patricia Ann Benitez,22,0,45,23
1746547756683,EDS 281,A00,895701,Meyerott; Theresa Ann,1,0,15,14
1746547757711,EDS 284,A00,895736,Meyerott; Theresa Ann,1,0,15,14
1746547758737,EDS 286,A00,897210,Fine; Sarah,0,0,15,15
1746547759770,EDS 289C,A01,895770,Daly; Alan J.,15,0,15,0
1746547760795,EDS 290,A00,897211,Hofstetter; Carolyn,0,0,15,15
1746547761821,LIGM 5A,A00,896162,Fischer-Grunski; Eva K,13,0,20,7
1746547762848,LIGM 5B,A00,896260,Fischer-Grunski; Eva K,17,0,20,3
1746547763876,LIGM 5C,A00,896308,Fischer-Grunski; Eva K,18,0,20,2
1746547764901,LIIT 5AS,A00,896313,Carnelos; Chiara,18,0,20,2
1746547765926,LIIT 5BS,A00,896416,Carnelos; Chiara,20,0,20,0
1746547766952,LIIT 5CS,A00,896564,Carnelos; Chiara,20,0,20,0
1746547767981,LISP 5A,A00,896588,Munoz Sanchez; Alicia,3,0,20,17
1746547769009,LISP 5B,A00,896653,Munoz Sanchez; Alicia,7,0,20,13
1746547770035,LISP 5C,A00,896655,Munoz Sanchez; Alicia,0,1,20,20
1746547771065,MAE 197,001,957918,Kleissl; Jan,9996,0,9999,3
1746547771065,MAE 197,002,959806,Boechler; Nicholas Sebastia,9998,0,9999,1
1746547771065,MAE 197,003,959852,Mullin; Jennifer S,9998,0,9999,1
1746547772092,MATH 2,A01,957937,Staff,33,0,35,2
1746547773118,MATH 197,001,957876,Kedlaya; Kiran S.,9993,0,9999,6
1746547774147,MCWP 40,A00,892729,Duru; Nur,10,0,20,10
1746547774147,MCWP 40,B00,893304,Montejo; Carolina,14,0,20,6
1746547775172,MCWP 40R,A00,893757,Redela; Pamela Morgan,0,5,20,20
1746547776199,MCWP 50,A00,893758,Morshed; Michael James,0,0,20,20
1746547776199,MCWP 50,B00,893761,Bartulis; Jason Michael,17,0,20,3
1746547777224,MCWP 50R,A00,893766,Compas; Sean Matthew,0,1,20,20
1746547777224,MCWP 50R,B00,893769,Carter; Jennifer A,0,1,20,20
1746547777224,MCWP 50R,C00,893771,Krone; Jarret,0,3,20,20
1746547777224,MCWP 50R,D00,893772,Miller; Elizabeth Deen,0,0,20,20
1746547777224,MCWP 50R,E00,893775,Carter; Andrea L,0,1,20,20
1746547778253,MMW 11R,A01,892721,Herbst; Matthew,11,0,27,16
1746547778253,MMW 11R,A02,892722,Herbst; Matthew,0,0,0,3
1746547779278,MMW 12R,A01,892724,Herbst; Matthew,0,11,16,16
1746547779278,MMW 12R,A02,892725,Herbst; Matthew,0,10,16,16
1746547780304,MMW 13R,A01,892727,Staff,0,4,16,16
1746547780304,MMW 13R,A02,892728,Staff,0,4,16,16
1746547780304,MMW 13R,A03,958032,Staff,0,4,16,16
1746547780304,MMW 13R,A04,958033,Staff,0,4,16,16
1746547780304,MMW 13R,A05,958034,Staff,0,4,16,16
1746547781329,SIO 295LS,A00,894015,Staff,5,0,25,20
1746547782355,SIO 295S,A00,894020,Staff,5,0,25,20
1746547783382,SIOC 290S,B01,958918,Merrifield; Mark A,14,0,30,16
1746547784408,SIOC 291S,B01,958922,Gabriel; Corey John,14,0,30,16
1746547785433,SOCI 117,A01,895339,Staff,3,0,5,2
1746547786460,WES 237B,A00,894149,Staff,11,0,20,9
1746547788529,AESE 279B,A00,891859,Staff,13,0,35,22
1746547789558,AIP 197,001,891854,Vespa; Emanuel Ignacio,9999,0,9999,0
1746547790585,ANTH 289S,A00,891856,Gagneux; Pascal,12,0,12,0
1746547791611,BENG 196,001,957946,Engler; Adam J.,9996,0,9999,3
1746547792638,BISP 197,001,959851,Wilhelm; James E.,9998,0,9999,1
1746547793662,CAT 124RS,A01,956906,Staff,6,0,25,19
1746547794688,CAT 125RS,A01,922013,Staff,6,0,25,19
1746547795715,CLRE 250,A00,891860,Morris; Sheldon,9995,0,9999,4
1746547797769,CLRE 251R,A00,907817,Mehta; Ravindra L.,9994,0,9999,5
1746547798792,CLRE 252,A00,891864,Cuomo; Raphael Eduardo,9993,0,9999,6
1746547799822,CLRE 253,A00,891867,Vaida; Florin,9994,0,9999,5
1746547799822,CLRE 253,B00,907819,Staff,9999,0,9999,0
1746547800849,CLRE 259,A00,891868,Patel; Hemal,9998,0,9999,1
1746547801874,CLRE 260,A00,891872,Cuomo; Raphael Eduardo,9999,0,9999,0
1746547802905,CLRE 297,001,891888,Cuomo; Raphael Eduardo,9999,0,9999,0
1746547803932,CSE 191,A00,958773,Minnes Kemp; Mor Mia,9996,0,9999,3
1746547804959,CSE 197,001,959846,Minnes Kemp; Mor Mia,9990,0,9999,9
1746547805984,CSS 201S,A01,892054,Mignozzetti; Umberto,26,0,30,4
1746547807013,CSS 202S,A01,892056,Mignozzetti; Umberto,26,0,30,4
1746547808039,DSC 197,001,956898,Eldridge; Justin Matthew,9998,0,9999,1
1746547809065,DSC 297,001,958000,Mazumdar; Arya,9998,0,9999,1
1746547809065,DSC 297,002,959862,Wang; Yusu,9999,0,9999,0
1746547810090,EAP 100,A00,905686,Staff,9778,0,9999,221
1746547811119,ECE 45,A01,892618,Staff,0,0,65,65
1746547813169,ECE 111,A01,892719,Staff,4,0,65,61
1746547814194,ECE 197,001,957920,Mercier; Patrick Philip,9991,0,9999,8
1746547815220,ECON 178,A01,907814,Zhu; Ying,26,0,35,9
1746547816245,EDS 115,A00,895312,Staff,36,0,45,9
1746547817270,EDS 117,A01,895337,Staff,24,0,30,6
1746547818299,EDS 125,A00,895341,Jones; Gabrielle Anastasia,37,0,45,8
1746547819329,EDS 128A,A01,895459,Fargason; Sharon Gayle,44,0,45,1
1746547820361,EDS 128B,A01,895543,Pappas; Elizabeth,44,0,45,1
1746547821384,EDS 139,A00,897203,Pappas; Elizabeth,44,0,45,1
1746547821384,EDS 139,B00,897209,Fargason; Sharon Gayle,41,0,45,4
1746547822422,EDS 201,A00,895545,Staff,22,0,45,23
1746547823447,EDS 203,A01,895581,Halter; Christopher P.,22,0,45,23
1746547824470,EDS 204R,A01,895625,Heinzman; Erica M.,39,0,45,6
1746547824470,EDS 204R,B01,895693,Halter; Christopher P.,10,0,45,35
1746547825499,EDS 206R,A00,895694,Fargason; Sharon Gayle,1,0,30,29
1746547825499,EDS 206R,B00,895695,Choi; Bailey Miyeon,16,0,30,14
1746547826557,EDS 250,A00,895697,Hemans; Patricia Ann Benitez,22,0,45,23
1746547827585,EDS 281,A00,895701,Meyerott; Theresa Ann,1,0,15,14
1746547828610,EDS 284,A00,895736,Meyerott; Theresa Ann,1,0,15,14
1746547829636,EDS 286,A00,897210,Fine; Sarah,0,0,15,15
1746547830662,EDS 289C,A01,895770,Daly; Alan J.,15,0,15,0
1746547831689,EDS 290,A00,897211,Hofstetter; Carolyn,0,0,15,15
1746547832718,LIGM 5A,A00,896162,Fischer-Grunski; Eva K,13,0,20,7
1746547833743,LIGM 5B,A00,896260,Fischer-Grunski; Eva K,17,0,20,3
1746547834773,LIGM 5C,A00,896308,Fischer-Grunski; Eva K,18,0,20,2
1746547835799,LIIT 5AS,A00,896313,Carnelos; Chiara,18,0,20,2
1746547836827,LIIT 5BS,A00,896416,Carnelos; Chiara,20,0,20,0
1746547837851,LIIT 5CS,A00,896564,Carnelos; Chiara,20,0,20,0
1746547838878,LISP 5A,A00,896588,Munoz Sanchez; Alicia,3,0,20,17
1746547839903,LISP 5B,A00,896653,Munoz Sanchez; Alicia,7,0,20,13
1746547840932,LISP 5C,A00,896655,Munoz Sanchez; Alicia,0,1,20,20
1746547841958,MAE 197,001,957918,Kleissl; Jan,9996,0,9999,3
1746547841958,MAE 197,002,959806,Boechler; Nicholas Sebastia,9998,0,9999,1
1746547841958,MAE 197,003,959852,Mullin; Jennifer S,9998,0,9999,1
1746547842985,MATH 2,A01,957937,Staff,33,0,35,2
1746547844009,MATH 197,001,957876,Kedlaya; Kiran S.,9993,0,9999,6
1746547845035,MCWP 40,A00,892729,Duru; Nur,10,0,20,10
1746547845035,MCWP 40,B00,893304,Montejo; Carolina,14,0,20,6
1746547846071,MCWP 40R,A00,893757,Redela; Pamela Morgan,0,5,20,20
1746547847095,MCWP 50,A00,893758,Morshed; Michael James,0,0,20,20
1746547847095,MCWP 50,B00,893761,Bartulis; Jason Michael,17,0,20,3
1746547848122,MCWP 50R,A00,893766,Compas; Sean Matthew,0,1,20,20
1746547848122,MCWP 50R,B00,893769,Carter; Jennifer A,0,1,20,20
1746547848122,MCWP 50R,C00,893771,Krone; Jarret,0,3,20,20
1746547848122,MCWP 50R,D00,893772,Miller; Elizabeth Deen,0,0,20,20
1746547848122,MCWP 50R,E00,893775,Carter; Andrea L,0,1,20,20
1746547849147,MMW 11R,A01,892721,Herbst; Matthew,11,0,27,16
1746547849147,MMW 11R,A02,892722,Herbst; Matthew,0,0,0,3
1746547850172,MMW 12R,A01,892724,Herbst; Matthew,0,11,16,16
1746547850172,MMW 12R,A02,892725,Herbst; Matthew,0,10,16,16
1746547851200,MMW 13R,A01,892727,Staff,0,4,16,16
1746547851200,MMW 13R,A02,892728,Staff,0,4,16,16
1746547851200,MMW 13R,A03,958032,Staff,0,4,16,16
1746547851200,MMW 13R,A04,958033,Staff,0,4,16,16
1746547851200,MMW 13R,A05,958034,Staff,0,4,16,16
1746547852227,SIO 295LS,A00,894015,Staff,5,0,25,20
1746547853251,SIO 295S,A00,894020,Staff,5,0,25,20
1746547854279,SIOC 290S,B01,958918,Merrifield; Mark A,14,0,30,16
1746547855307,SIOC 291S,B01,958922,Gabriel; Corey John,14,0,30,16
1746547856331,SOCI 117,A01,895339,Staff,3,0,5,2
1746547857356,WES 237B,A00,894149,Staff,11,0,20,9
1746547859430,AESE 279B,A00,891859,Staff,13,0,35,22
1746547860453,AIP 197,001,891854,Vespa; Emanuel Ignacio,9999,0,9999,0
1746547861477,ANTH 289S,A00,891856,Gagneux; Pascal,12,0,12,0
1746547862502,BENG 196,001,957946,Engler; Adam J.,9996,0,9999,3
1746547863528,BISP 197,001,959851,Wilhelm; James E.,9998,0,9999,1
1746547864552,CAT 124RS,A01,956906,Staff,6,0,25,19
1746547865581,CAT 125RS,A01,922013,Staff,6,0,25,19
1746547866610,CLRE 250,A00,891860,Morris; Sheldon,9995,0,9999,4
1746547868664,CLRE 251R,A00,907817,Mehta; Ravindra L.,9994,0,9999,5
1746547869693,CLRE 252,A00,891864,Cuomo; Raphael Eduardo,9993,0,9999,6
1746547870720,CLRE 253,A00,891867,Vaida; Florin,9994,0,9999,5
1746547870720,CLRE 253,B00,907819,Staff,9999,0,9999,0
1746547871747,CLRE 259,A00,891868,Patel; Hemal,9998,0,9999,1
1746547872771,CLRE 260,A00,891872,Cuomo; Raphael Eduardo,9999,0,9999,0
1746547873796,CLRE 297,001,891888,Cuomo; Raphael Eduardo,9999,0,9999,0
1746547874824,CSE 191,A00,958773,Minnes Kemp; Mor Mia,9996,0,9999,3
1746547875850,CSE 197,001,959846,Minnes Kemp; Mor Mia,9990,0,9999,9
1746547876876,CSS 201S,A01,892054,Mignozzetti; Umberto,26,0,30,4
1746547877902,CSS 202S,A01,892056,Mignozzetti; Umberto,26,0,30,4
1746547878929,DSC 197,001,956898,Eldridge; Justin Matthew,9998,0,9999,1
1746547879957,DSC 297,001,958000,Mazumdar; Arya,9998,0,9999,1
1746547879957,DSC 297,002,959862,Wang; Yusu,9999,0,9999,0
1746547880982,EAP 100,A00,905686,Staff,9778,0,9999,221
1746547882007,ECE 45,A01,892618,Staff,0,0,65,65
1746547884060,ECE 111,A01,892719,Staff,4,0,65,61
1746547885085,ECE 197,001,957920,Mercier; Patrick Philip,9991,0,9999,8
1746547886114,ECON 178,A01,907814,Zhu; Ying,26,0,35,9
1746547887140,EDS 115,A00,895312,Staff,36,0,45,9
1746547888167,EDS 117,A01,895337,Staff,24,0,30,6
1746547889196,EDS 125,A00,895341,Jones; Gabrielle Anastasia,37,0,45,8
1746547890221,EDS 128A,A01,895459,Fargason; Sharon Gayle,44,0,45,1
1746547891248,EDS 128B,A01,895543,Pappas; Elizabeth,44,0,45,1
1746547892273,EDS 139,A00,897203,Pappas; Elizabeth,44,0,45,1
1746547892273,EDS 139,B00,897209,Fargason; Sharon Gayle,41,0,45,4
1746547893300,EDS 201,A00,895545,Staff,22,0,45,23
1746547894328,EDS 203,A01,895581,Halter; Christopher P.,22,0,45,23
1746547895355,EDS 204R,A01,895625,Heinzman; Erica M.,39,0,45,6
1746547895355,EDS 204R,B01,895693,Halter; Christopher P.,10,0,45,35
1746547896383,EDS 206R,A00,895694,Fargason; Sharon Gayle,1,0,30,29
1746547896383,EDS 206R,B00,895695,Choi; Bailey Miyeon,16,0,30,14
1746547897411,EDS 250,A00,895697,Hemans; Patricia Ann Benitez,22,0,45,23
1746547898434,EDS 281,A00,895701,Meyerott; Theresa Ann,1,0,15,14
1746547899459,EDS 284,A00,895736,Meyerott; Theresa Ann,1,0,15,14
1746547900484,EDS 286,A00,897210,Fine; Sarah,0,0,15,15
1746547901512,EDS 289C,A01,895770,Daly; Alan J.,15,0,15,0
1746547902538,EDS 290,A00,897211,Hofstetter; Carolyn,0,0,15,15
1746547903593,LIGM 5A,A00,896162,Fischer-Grunski; Eva K,13,0,20,7
1746547904623,LIGM 5B,A00,896260,Fischer-Grunski; Eva K,17,0,20,3
1746547905648,LIGM 5C,A00,896308,Fischer-Grunski; Eva K,18,0,20,2
1746547906677,LIIT 5AS,A00,896313,Carnelos; Chiara,18,0,20,2
1746547907703,LIIT 5BS,A00,896416,Carnelos; Chiara,20,0,20,0
1746547908733,LIIT 5CS,A00,896564,Carnelos; Chiara,20,0,20,0
1746547909763,LISP 5A,A00,896588,Munoz Sanchez; Alicia,3,0,20,17
1746547910790,LISP 5B,A00,896653,Munoz Sanchez; Alicia,7,0,20,13
1746547911815,LISP 5C,A00,896655,Munoz Sanchez; Alicia,0,1,20,20
1746547912842,MAE 197,001,957918,Kleissl; Jan,9996,0,9999,3
1746547912842,MAE 197,002,959806,Boechler; Nicholas Sebastia,9998,0,9999,1
1746547912842,MAE 197,003,959852,Mullin; Jennifer S,9998,0,9999,1
1746547913865,MATH 2,A01,957937,Staff,33,0,35,2
1746547914890,MATH 197,001,957876,Kedlaya; Kiran S.,9993,0,9999,6
1746547915915,MCWP 40,A00,892729,Duru; Nur,10,0,20,10
1746547915915,MCWP 40,B00,893304,Montejo; Carolina,14,0,20,6
1746547916943,MCWP 40R,A00,893757,Redela; Pamela Morgan,0,5,20,20
1746547917981,MCWP 50,A00,893758,Morshed; Michael James,0,0,20,20
1746547917981,MCWP 50,B00,893761,Bartulis; Jason Michael,17,0,20,3
1746547919010,MCWP 50R,A00,893766,Compas; Sean Matthew,0,1,20,20
1746547919010,MCWP 50R,B00,893769,Carter; Jennifer A,0,1,20,20
1746547919010,MCWP 50R,C00,893771,Krone; Jarret,0,3,20,20
1746547919010,MCWP 50R,D00,893772,Miller; Elizabeth Deen,0,0,20,20
1746547919010,MCWP 50R,E00,893775,Carter; Andrea L,0,1,20,20
1746547920038,MMW 11R,A01,892721,Herbst; Matthew,11,0,27,16
1746547920038,MMW 11R,A02,892722,Herbst; Matthew,0,0,0,3
1746547921063,MMW 12R,A01,892724,Herbst; Matthew,0,11,16,16
1746547921063,MMW 12R,A02,892725,Herbst; Matthew,0,10,16,16
1746547922087,MMW 13R,A01,892727,Staff,0,4,16,16
1746547922087,MMW 13R,A02,892728,Staff,0,4,16,16
1746547922087,MMW 13R,A03,958032,Staff,0,4,16,16
1746547922087,MMW 13R,A04,958033,Staff,0,4,16,16
1746547922087,MMW 13R,A05,958034,Staff,0,4,16,16
1746547923116,SIO 295LS,A00,894015,Staff,5,0,25,20
1746547924144,SIO 295S,A00,894020,Staff,5,0,25,20
1746547925174,SIOC 290S,B01,958918,Merrifield; Mark A,14,0,30,16
1746547926203,SIOC 291S,B01,958922,Gabriel; Corey John,14,0,30,16
1746547927228,SOCI 117,A01,895339,Staff,3,0,5,2
1746547928253,WES 237B,A00,894149,Staff,11,0,20,9
1746547930312,AESE 279B,A00,891859,Staff,13,0,35,22
1746547931339,AIP 197,001,891854,Vespa; Emanuel Ignacio,9999,0,9999,0
1746547932366,ANTH 289S,A00,891856,Gagneux; Pascal,12,0,12,0
1746547933391,BENG 196,001,957946,Engler; Adam J.,9996,0,9999,3
1746547934419,BISP 197,001,959851,Wilhelm; James E.,9998,0,9999,1
1746547935446,CAT 124RS,A01,956906,Staff,6,0,25,19
1746547936473,CAT 125RS,A01,922013,Staff,6,0,25,19
1746547937498,CLRE 250,A00,891860,Morris; Sheldon,9995,0,9999,4
1746547939555,CLRE 251R,A00,907817,Mehta; Ravindra L.,9994,0,9999,5
1746547940580,CLRE 252,A00,891864,Cuomo; Raphael Eduardo,9993,0,9999,6
1746547941612,CLRE 253,A00,891867,Vaida; Florin,9994,0,9999,5
1746547941612,CLRE 253,B00,907819,Staff,9999,0,9999,0
1746547942640,CLRE 259,A00,891868,Patel; Hemal,9998,0,9999,1
1746547943665,CLRE 260,A00,891872,Cuomo; Raphael Eduardo,9999,0,9999,0
1746547944691,CLRE 297,001,891888,Cuomo; Raphael Eduardo,9999,0,9999,0
1746547945717,CSE 191,A00,958773,Minnes Kemp; Mor Mia,9996,0,9999,3
1746547946744,CSE 197,001,959846,Minnes Kemp; Mor Mia,9990,0,9999,9
1746547947771,CSS 201S,A01,892054,Mignozzetti; Umberto,26,0,30,4
1746547948796,CSS 202S,A01,892056,Mignozzetti; Umberto,26,0,30,4
1746547949826,DSC 197,001,956898,Eldridge; Justin Matthew,9998,0,9999,1
1746547950855,DSC 297,001,958000,Mazumdar; Arya,9998,0,9999,1
1746547950855,DSC 297,002,959862,Wang; Yusu,9999,0,9999,0
1746547951883,EAP 100,A00,905686,Staff,9778,0,9999,221
1746547952911,ECE 45,A01,892618,Staff,0,0,65,65
1746547954963,ECE 111,A01,892719,Staff,4,0,65,61
1746547955989,ECE 197,001,957920,Mercier; Patrick Philip,9991,0,9999,8
1746547957015,ECON 178,A01,907814,Zhu; Ying,26,0,35,9
1746547958044,EDS 115,A00,895312,Staff,36,0,45,9
1746547959070,EDS 117,A01,895337,Staff,24,0,30,6
1746547960099,EDS 125,A00,895341,Jones; Gabrielle Anastasia,37,0,45,8
1746547961127,EDS 128A,A01,895459,Fargason; Sharon Gayle,44,0,45,1
1746547962154,EDS 128B,A01,895543,Pappas; Elizabeth,44,0,45,1
1746547963181,EDS 139,A00,897203,Pappas; Elizabeth,44,0,45,1
1746547963181,EDS 139,B00,897209,Fargason; Sharon Gayle,41,0,45,4
1746547964208,EDS 201,A00,895545,Staff,22,0,45,23
1746547965233,EDS 203,A01,895581,Halter; Christopher P.,22,0,45,23
1746547966264,EDS 204R,A01,895625,Heinzman; Erica M.,39,0,45,6
1746547966264,EDS 204R,B01,895693,Halter; Christopher P.,10,0,45,35
1746547967293,EDS 206R,A00,895694,Fargason; Sharon Gayle,1,0,30,29
1746547967293,EDS 206R,B00,895695,Choi; Bailey Miyeon,16,0,30,14
1746547968317,EDS 250,A00,895697,Hemans; Patricia Ann Benitez,22,0,45,23
1746547969341,EDS 281,A00,895701,Meyerott; Theresa Ann,1,0,15,14
1746547970365,EDS 284,A00,895736,Meyerott; Theresa Ann,1,0,15,14
1746547971418,EDS 286,A00,897210,Fine; Sarah,0,0,15,15
1746547972446,EDS 289C,A01,895770,Daly; Alan J.,15,0,15,0
1746547973471,EDS 290,A00,897211,Hofstetter; Carolyn,0,0,15,15
1746547974500,LIGM 5A,A00,896162,Fischer-Grunski; Eva K,13,0,20,7
1746547975526,LIGM 5B,A00,896260,Fischer-Grunski; Eva K,17,0,20,3
1746547976551,LIGM 5C,A00,896308,Fischer-Grunski; Eva K,18,0,20,2
1746547977576,LIIT 5AS,A00,896313,Carnelos; Chiara,18,0,20,2
1746547978600,LIIT 5BS,A00,896416,Carnelos; Chiara,20,0,20,0
1746547979625,LIIT 5CS,A00,896564,Carnelos; Chiara,20,0,20,0
1746547980649,LISP 5A,A00,896588,Munoz Sanchez; Alicia,3,0,20,17
1746547981677,LISP 5B,A00,896653,Munoz Sanchez; Alicia,7,0,20,13
1746547982703,LISP 5C,A00,896655,Munoz Sanchez; Alicia,0,1,20,20
1746547983725,MAE 197,001,957918,Kleissl; Jan,9996,0,9999,3
1746547983725,MAE 197,002,959806,Boechler; Nicholas Sebastia,9998,0,9999,1
1746547983725,MAE 197,003,959852,Mullin; Jennifer S,9998,0,9999,1
1746547984752,MATH 2,A01,957937,Staff,33,0,35,2
1746547985777,MATH 197,001,957876,Kedlaya; Kiran S.,9993,0,9999,6
1746547986805,MCWP 40,A00,892729,Duru; Nur,10,0,20,10
1746547986805,MCWP 40,B00,893304,Montejo; Carolina,14,0,20,6
1746547987853,MCWP 40R,A00,893757,Redela; Pamela Morgan,0,5,20,20
1746547988877,MCWP 50,A00,893758,Morshed; Michael James,0,0,20,20
1746547988877,MCWP 50,B00,893761,Bartulis; Jason Michael,17,0,20,3
1746547989904,MCWP 50R,A00,893766,Compas; Sean Matthew,0,1,20,20
1746547989904,MCWP 50R,B00,893769,Carter; Jennifer A,0,1,20,20
1746547989904,MCWP 50R,C00,893771,Krone; Jarret,0,3,20,20
1746547989904,MCWP 50R,D00,893772,Miller; Elizabeth Deen,0,0,20,20
1746547989904,MCWP 50R,E00,893775,Carter; Andrea L,0,1,20,20
1746547990928,MMW 11R,A01,892721,Herbst; Matthew,11,0,27,16
1746547990928,MMW 11R,A02,892722,Herbst; Matthew,0,0,0,3
1746547991952,MMW 12R,A01,892724,Herbst; Matthew,0,11,16,16
1746547991952,MMW 12R,A02,892725,Herbst; Matthew,0,10,16,16
1746547992978,MMW 13R,A01,892727,Staff,0,4,16,16
1746547992978,MMW 13R,A02,892728,Staff,0,4,16,16
1746547992978,MMW 13R,A03,958032,Staff,0,4,16,16
1746547992978,MMW 13R,A04,958033,Staff,0,4,16,16
1746547992978,MMW 13R,A05,958034,Staff,0,4,16,16
1746547994006,SIO 295LS,A00,894015,Staff,5,0,25,20
1746547995033,SIO 295S,A00,894020,Staff,5,0,25,20
1746547996062,SIOC 290S,B01,958918,Merrifield; Mark A,14,0,30,16
1746547997091,SIOC 291S,B01,958922,Gabriel; Corey John,14,0,30,16
1746547998115,SOCI 117,A01,895339,Staff,3,0,5,2
1746547999141,WES 237B,A00,894149,Staff,11,0,20,9
1746548001206,AESE 279B,A00,891859,Staff,13,0,35,22
1746548002232,AIP 197,001,891854,Vespa; Emanuel Ignacio,9999,0,9999,0
1746548003259,ANTH 289S,A00,891856,Gagneux; Pascal,12,0,12,0
1746548004283,BENG 196,001,957946,Engler; Adam J.,9996,0,9999,3
1746548005309,BISP 197,001,959851,Wilhelm; James E.,9998,0,9999,1
1746548006354,CAT 124RS,A01,956906,Staff,6,0,25,19
1746548007382,CAT 125RS,A01,922013,Staff,6,0,25,19
1746548008407,CLRE 250,A00,891860,Morris; Sheldon,9995,0,9999,4
1746548010456,CLRE 251R,A00,907817,Mehta; Ravindra L.,9994,0,9999,5
1746548011484,CLRE 252,A00,891864,Cuomo; Raphael Eduardo,9993,0,9999,6
1746548012512,CLRE 253,A00,891867,Vaida; Florin,9994,0,9999,5
1746548012512,CLRE 253,B00,907819,Staff,9999,0,9999,0
1746548013538,CLRE 259,A00,891868,Patel; Hemal,9998,0,9999,1
1746548014562,CLRE 260,A00,891872,Cuomo; Raphael Eduardo,9999,0,9999,0
1746548015586,CLRE 297,001,891888,Cuomo; Raphael Eduardo,9999,0,9999,0
1746548016614,CSE 191,A00,958773,Minnes Kemp; Mor Mia,9996,0,9999,3
1746548017640,CSE 197,001,959846,Minnes Kemp; Mor Mia,9990,0,9999,9
1746548018667,CSS 201S,A01,892054,Mignozzetti; Umberto,26,0,30,4
1746548019694,CSS 202S,A01,892056,Mignozzetti; Umberto,26,0,30,4
1746548020721,DSC 197,001,956898,Eldridge; Justin Matthew,9998,0,9999,1
1746548021747,DSC 297,001,958000,Mazumdar; Arya,9998,0,9999,1
1746548021747,DSC 297,002,959862,Wang; Yusu,9999,0,9999,0
1746548022772,EAP 100,A00,905686,Staff,9778,0,9999,221
1746548023802,ECE 45,A01,892618,Staff,0,0,65,65
1746548025855,ECE 111,A01,892719,Staff,4,0,65,61
1746548026881,ECE 197,001,957920,Mercier; Patrick Philip,9991,0,9999,8
1746548027906,ECON 178,A01,907814,Zhu; Ying,26,0,35,9
1746548028930,EDS 115,A00,895312,Staff,36,0,45,9
1746548029955,EDS 117,A01,895337,Staff,24,0,30,6
1746548030982,EDS 125,A00,895341,Jones; Gabrielle Anastasia,37,0,45,8
1746548032007,EDS 128A,A01,895459,Fargason; Sharon Gayle,44,0,45,1
1746548033032,EDS 128B,A01,895543,Pappas; Elizabeth,44,0,45,1
1746548034059,EDS 139,A00,897203,Pappas; Elizabeth,44,0,45,1
1746548034059,EDS 139,B00,897209,Fargason; Sharon Gayle,41,0,45,4
1746548035084,EDS 201,A00,895545,Staff,22,0,45,23
1746548036116,EDS 203,A01,895581,Halter; Christopher P.,22,0,45,23
1746548037139,EDS 204R,A01,895625,Heinzman; Erica M.,39,0,45,6
1746548037139,EDS 204R,B01,895693,Halter; Christopher P.,10,0,45,35
1746548038163,EDS 206R,A00,895694,Fargason; Sharon Gayle,1,0,30,29
1746548038163,EDS 206R,B00,895695,Choi; Bailey Miyeon,16,0,30,14
1746548039192,EDS 250,A00,895697,Hemans; Patricia Ann Benitez,22,0,45,23
1746548040217,EDS 281,A00,895701,Meyerott; Theresa Ann,1,0,15,14
1746548041243,EDS 284,A00,895736,Meyerott; Theresa Ann,1,0,15,14
1746548042266,EDS 286,A00,897210,Fine; Sarah,0,0,15,15
1746548043292,EDS 289C,A01,895770,Daly; Alan J.,15,0,15,0
1746548044315,EDS 290,A00,897211,Hofstetter; Carolyn,0,0,15,15
1746548045341,LIGM 5A,A00,896162,Fischer-Grunski; Eva K,13,0,20,7
1746548046368,LIGM 5B,A00,896260,Fischer-Grunski; Eva K,17,0,20,3
1746548047391,LIGM 5C,A00,896308,Fischer-Grunski; Eva K,18,0,20,2
1746548048419,LIIT 5AS,A00,896313,Carnelos; Chiara,18,0,20,2
1746548049444,LIIT 5BS,A00,896416,Carnelos; Chiara,20,0,20,0
1746548050469,LIIT 5CS,A00,896564,Carnelos; Chiara,20,0,20,0
1746548051497,LISP 5A,A00,896588,Munoz Sanchez; Alicia,3,0,20,17
1746548052523,LISP 5B,A00,896653,Munoz Sanchez; Alicia,7,0,20,13
1746548053551,LISP 5C,A00,896655,Munoz Sanchez; Alicia,0,1,20,20
1746548054579,MAE 197,001,957918,Kleissl; Jan,9996,0,9999,3
1746548054579,MAE 197,002,959806,Boechler; Nicholas Sebastia,9998,0,9999,1
1746548054579,MAE 197,003,959852,Mullin; Jennifer S,9998,0,9999,1
1746548055605,MATH 2,A01,957937,Staff,33,0,35,2
1746548056629,MATH 197,001,957876,Kedlaya; Kiran S.,9993,0,9999,6
1746548057654,MCWP 40,A00,892729,Duru; Nur,10,0,20,10
1746548057654,MCWP 40,B00,893304,Montejo; Carolina,14,0,20,6
1746548058682,MCWP 40R,A00,893757,Redela; Pamela Morgan,0,5,20,20
1746548059709,MCWP 50,A00,893758,Morshed; Michael James,0,0,20,20
1746548059709,MCWP 50,B00,893761,Bartulis; Jason Michael,17,0,20,3
1746548060735,MCWP 50R,A00,893766,Compas; Sean Matthew,0,1,20,20
1746548060735,MCWP 50R,B00,893769,Carter; Jennifer A,0,1,20,20
1746548060735,MCWP 50R,C00,893771,Krone; Jarret,0,3,20,20
1746548060735,MCWP 50R,D00,893772,Miller; Elizabeth Deen,0,0,20,20
1746548060735,MCWP 50R,E00,893775,Carter; Andrea L,0,1,20,20
1746548061760,MMW 11R,A01,892721,Herbst; Matthew,11,0,27,16
1746548061760,MMW 11R,A02,892722,Herbst; Matthew,0,0,0,3
1746548062786,MMW 12R,A01,892724,Herbst; Matthew,0,11,16,16
1746548062786,MMW 12R,A02,892725,Herbst; Matthew,0,10,16,16
1746548063813,MMW 13R,A01,892727,Staff,0,4,16,16
1746548063813,MMW 13R,A02,892728,Staff,0,4,16,16
1746548063813,MMW 13R,A03,958032,Staff,0,4,16,16
1746548063813,MMW 13R,A04,958033,Staff,0,4,16,16
1746548063813,MMW 13R,A05,958034,Staff,0,4,16,16
1746548064840,SIO 295LS,A00,894015,Staff,5,0,25,20
1746548065868,SIO 295S,A00,894020,Staff,5,0,25,20
1746548066895,SIOC 290S,B01,958918,Merrifield; Mark A,14,0,30,16
1746548067924,SIOC 291S,B01,958922,Gabriel; Corey John,14,0,30,16
1746548068947,SOCI 117,A01,895339,Staff,3,0,5,2
1746548069973,WES 237B,A00,894149,Staff,11,0,20,9
1746548072036,AESE 279B,A00,891859,Staff,13,0,35,22
1746548073063,AIP 197,001,891854,Vespa; Emanuel Ignacio,9999,0,9999,0
1746548074090,ANTH 289S,A00,891856,Gagneux; Pascal,12,0,12,0
1746548075120,BENG 196,001,957946,Engler; Adam J.,9996,0,9999,3
1746548076150,BISP 197,001,959851,Wilhelm; James E.,9998,0,9999,1
1746548077177,CAT 124RS,A01,956906,Staff,6,0,25,19
1746548078202,CAT 125RS,A01,922013,Staff,6,0,25,19
1746548079227,CLRE 250,A00,891860,Morris; Sheldon,9995,0,9999,4
1746548081274,CLRE 251R,A00,907817,Mehta; Ravindra L.,9994,0,9999,5
1746548082299,CLRE 252,A00,891864,Cuomo; Raphael Eduardo,9993,0,9999,6
1746548083326,CLRE 253,A00,891867,Vaida; Florin,9994,0,9999,5
1746548083326,CLRE 253,B00,907819,Staff,9999,0,9999,0
1746548084350,CLRE 259,A00,891868,Patel; Hemal,9998,0,9999,1
1746548085374,CLRE 260,A00,891872,Cuomo; Raphael Eduardo,9999,0,9999,0
1746548086398,CLRE 297,001,891888,Cuomo; Raphael Eduardo,9999,0,9999,0
1746548087424,CSE 191,A00,958773,Minnes Kemp; Mor Mia,9996,0,9999,3
1746548088450,CSE 197,001,959846,Minnes Kemp; Mor Mia,9990,0,9999,9
1746548089477,CSS 201S,A01,892054,Mignozzetti; Umberto,26,0,30,4
1746548090516,CSS 202S,A01,892056,Mignozzetti; Umberto,26,0,30,4
1746548091543,DSC 197,001,956898,Eldridge; Justin Matthew,9998,0,9999,1
1746548092569,DSC 297,001,958000,Mazumdar; Arya,9998,0,9999,1
1746548092569,DSC 297,002,959862,Wang; Yusu,9999,0,9999,0
1746548093598,EAP 100,A00,905686,Staff,9778,0,9999,221
1746548094627,ECE 45,A01,892618,Staff,0,0,65,65
1746548096676,ECE 111,A01,892719,Staff,4,0,65,61
1746548097704,ECE 197,001,957920,Mercier; Patrick Philip,9991,0,9999,8
1746548098730,ECON 178,A01,907814,Zhu; Ying,26,0,35,9
1746548099755,EDS 115,A00,895312,Staff,36,0,45,9
1746548100781,EDS 117,A01,895337,Staff,24,0,30,6
1746548101808,EDS 125,A00,895341,Jones; Gabrielle Anastasia,37,0,45,8
1746548102853,EDS 128A,A01,895459,Fargason; Sharon Gayle,44,0,45,1
1746548103884,EDS 128B,A01,895543,Pappas; Elizabeth,44,0,45,1
1746548104909,EDS 139,A00,897203,Pappas; Elizabeth,44,0,45,1
1746548104909,EDS 139,B00,897209,Fargason; Sharon Gayle,41,0,45,4
1746548105933,EDS 201,A00,895545,Staff,22,0,45,23
1746548106958,EDS 203,A01,895581,Halter; Christopher P.,22,0,45,23
1746548107985,EDS 204R,A01,895625,Heinzman; Erica M.,39,0,45,6
1746548107985,EDS 204R,B01,895693,Halter; Christopher P.,10,0,45,35
1746548109010,EDS 206R,A00,895694,Fargason; Sharon Gayle,1,0,30,29
1746548109010,EDS 206R,B00,895695,Choi; Bailey Miyeon,16,0,30,14
1746548110038,EDS 250,A00,895697,Hemans; Patricia Ann Benitez,22,0,45,23
1746548111065,EDS 281,A00,895701,Meyerott; Theresa Ann,1,0,15,14
1746548112089,EDS 284,A00,895736,Meyerott; Theresa Ann,1,0,15,14
1746548113115,EDS 286,A00,897210,Fine; Sarah,0,0,15,15
1746548114139,EDS 289C,A01,895770,Daly; Alan J.,15,0,15,0
1746548115163,EDS 290,A00,897211,Hofstetter; Carolyn,0,0,15,15
1746548116188,LIGM 5A,A00,896162,Fischer-Grunski; Eva K,13,0,20,7
1746548117213,LIGM 5B,A00,896260,Fischer-Grunski; Eva K,17,0,20,3
1746548118241,LIGM 5C,A00,896308,Fischer-Grunski; Eva K,18,0,20,2
1746548119269,LIIT 5AS,A00,896313,Carnelos; Chiara,18,0,20,2
1746548120293,LIIT 5BS,A00,896416,Carnelos; Chiara,20,0,20,0
1746548121318,LIIT 5CS,A00,896564,Carnelos; Chiara,20,0,20,0
1746548122346,LISP 5A,A00,896588,Munoz Sanchez; Alicia,3,0,20,17
1746548123374,LISP 5B,A00,896653,Munoz Sanchez; Alicia,7,0,20,13
1746548124398,LISP 5C,A00,896655,Munoz Sanchez; Alicia,0,1,20,20
1746548125426,MAE 197,001,957918,Kleissl; Jan,9996,0,9999,3
1746548125426,MAE 197,002,959806,Boechler; Nicholas Sebastia,9998,0,9999,1
1746548125426,MAE 197,003,959852,Mullin; Jennifer S,9998,0,9999,1
1746548126455,MATH 2,A01,957937,Staff,33,0,35,2
1746548127480,MATH 197,001,957876,Kedlaya; Kiran S.,9993,0,9999,6
1746548128504,MCWP 40,A00,892729,Duru; Nur,10,0,20,10
1746548128504,MCWP 40,B00,893304,Montejo; Carolina,14,0,20,6
1746548129531,MCWP 40R,A00,893757,Redela; Pamela Morgan,0,5,20,20
1746548130560,MCWP 50,A00,893758,Morshed; Michael James,0,0,20,20
1746548130560,MCWP 50,B00,893761,Bartulis; Jason Michael,17,0,20,3
1746548131589,MCWP 50R,A00,893766,Compas; Sean Matthew,0,1,20,20
1746548131589,MCWP 50R,B00,893769,Carter; Jennifer A,0,1,20,20
1746548131589,MCWP 50R,C00,893771,Krone; Jarret,0,3,20,20
1746548131589,MCWP 50R,D00,893772,Miller; Elizabeth Deen,0,0,20,20
1746548131589,MCWP 50R,E00,893775,Carter; Andrea L,0,1,20,20
1746548132616,MMW 11R,A01,892721,Herbst; Matthew,11,0,27,16
1746548132616,MMW 11R,A02,892722,Herbst; Matthew,0,0,0,3
1746548133641,MMW 12R,A01,892724,Herbst; Matthew,0,11,16,16
1746548133641,MMW 12R,A02,892725,Herbst; Matthew,0,10,16,16
1746548134667,MMW 13R,A01,892727,Staff,0,4,16,16
1746548134667,MMW 13R,A02,892728,Staff,0,4,16,16
1746548134667,MMW 13R,A03,958032,Staff,0,4,16,16
1746548134667,MMW 13R,A04,958033,Staff,0,4,16,16
1746548134667,MMW 13R,A05,958034,Staff,0,4,16,16
1746548135694,SIO 295LS,A00,894015,Staff,5,0,25,20
1746548136721,SIO 295S,A00,894020,Staff,5,0,25,20
1746548137745,SIOC 290S,B01,958918,Merrifield; Mark A,14,0,30,16
1746548138771,SIOC 291S,B01,958922,Gabriel; Corey John,14,0,30,16
1746548139796,SOCI 117,A01,895339,Staff,3,0,5,2
1746548140824,WES 237B,A00,894149,Staff,11,0,20,9
1746548142897,AESE 279B,A00,891859,Staff,13,0,35,22
1746548143927,AIP 197,001,891854,Vespa; Emanuel Ignacio,9999,0,9999,0
1746548144953,ANTH 289S,A00,891856,Gagneux; Pascal,12,0,12,0
1746548145981,BENG 196,001,957946,Engler; Adam J.,9996,0,9999,3
1746548147008,BISP 197,001,959851,Wilhelm; James E.,9998,0,9999,1
1746548148035,CAT 124RS,A01,956906,Staff,6,0,25,19
1746548149060,CAT 125RS,A01,922013,Staff,6,0,25,19
1746548150089,CLRE 250,A00,891860,Morris; Sheldon,9995,0,9999,4
1746548152144,CLRE 251R,A00,907817,Mehta; Ravindra L.,9994,0,9999,5
1746548153172,CLRE 252,A00,891864,Cuomo; Raphael Eduardo,9993,0,9999,6
1746548154197,CLRE 253,A00,891867,Vaida; Florin,9994,0,9999,5
1746548154197,CLRE 253,B00,907819,Staff,9999,0,9999,0
1746548155222,CLRE 259,A00,891868,Patel; Hemal,9998,0,9999,1
1746548156249,CLRE 260,A00,891872,Cuomo; Raphael Eduardo,9999,0,9999,0
1746548157275,CLRE 297,001,891888,Cuomo; Raphael Eduardo,9999,0,9999,0
1746548158299,CSE 191,A00,958773,Minnes Kemp; Mor Mia,9996,0,9999,3
1746548159326,CSE 197,001,959846,Minnes Kemp; Mor Mia,9990,0,9999,9
1746548160351,CSS 201S,A01,892054,Mignozzetti; Umberto,26,0,30,4
1746548161375,CSS 202S,A01,892056,Mignozzetti; Umberto,26,0,30,4
1746548162415,DSC 197,001,956898,Eldridge; Justin Matthew,9998,0,9999,1
1746548163443,DSC 297,001,958000,Mazumdar; Arya,9998,0,9999,1
1746548163443,DSC 297,002,959862,Wang; Yusu,9999,0,9999,0
1746548164467,EAP 100,A00,905686,Staff,9778,0,9999,221
1746548165495,ECE 45,A01,892618,Staff,0,0,65,65
1746548167543,ECE 111,A01,892719,Staff,4,0,65,61
1746548168569,ECE 197,001,957920,Mercier; Patrick Philip,9991,0,9999,8
1746548169598,ECON 178,A01,907814,Zhu; Ying,26,0,35,9
1746548170622,EDS 115,A00,895312,Staff,36,0,45,9
1746548171645,EDS 117,A01,895337,Staff,24,0,30,6
1746548172673,EDS 125,A00,895341,Jones; Gabrielle Anastasia,37,0,45,8
1746548173725,EDS 128A,A01,895459,Fargason; Sharon Gayle,44,0,45,1
1746548174754,EDS 128B,A01,895543,Pappas; Elizabeth,44,0,45,1
1746548175782,EDS 139,A00,897203,Pappas; Elizabeth,44,0,45,1
1746548175782,EDS 139,B00,897209,Fargason; Sharon Gayle,41,0,45,4
1746548176807,EDS 201,A00,895545,Staff,22,0,45,23
1746548177833,EDS 203,A01,895581,Halter; Christopher P.,22,0,45,23
1746548178859,EDS 204R,A01,895625,Heinzman; Erica M.,39,0,45,6
1746548178859,EDS 204R,B01,895693,Halter; Christopher P.,10,0,45,35
1746548179883,EDS 206R,A00,895694,Fargason; Sharon Gayle,1,0,30,29
1746548179883,EDS 206R,B00,895695,Choi; Bailey Miyeon,16,0,30,14
1746548180908,EDS 250,A00,895697,Hemans; Patricia Ann Benitez,22,0,45,23
1746548181934,EDS 281,A00,895701,Meyerott; Theresa Ann,1,0,15,14
1746548182960,EDS 284,A00,895736,Meyerott; Theresa Ann,1,0,15,14
1746548183985,EDS 286,A00,897210,Fine; Sarah,0,0,15,15
1746548185011,EDS 289C,A01,895770,Daly; Alan J.,15,0,15,0
1746548186038,EDS 290,A00,897211,Hofstetter; Carolyn,0,0,15,15
1746548187067,LIGM 5A,A00,896162,Fischer-Grunski; Eva K,13,0,20,7
1746548188097,LIGM 5B,A00,896260,Fischer-Grunski; Eva K,17,0,20,3
1746548189123,LIGM 5C,A00,896308,Fischer-Grunski; Eva K,18,0,20,2
1746548190150,LIIT 5AS,A00,896313,Carnelos; Chiara,18,0,20,2
1746548191176,LIIT 5BS,A00,896416,Carnelos; Chiara,20,0,20,0
1746548192203,LIIT 5CS,A00,896564,Carnelos; Chiara,20,0,20,0
1746548193227,LISP 5A,A00,896588,Munoz Sanchez; Alicia,3,0,20,17
1746548194252,LISP 5B,A00,896653,Munoz Sanchez; Alicia,7,0,20,13
1746548195277,LISP 5C,A00,896655,Munoz Sanchez; Alicia,0,1,20,20
1746548196306,MAE 197,001,957918,Kleissl; Jan,9996,0,9999,3
1746548196306,MAE 197,002,959806,Boechler; Nicholas Sebastia,9998,0,9999,1
1746548196306,MAE 197,003,959852,Mullin; Jennifer S,9998,0,9999,1
1746548197332,MATH 2,A01,957937,Staff,33,0,35,2
1746548198359,MATH 197,001,957876,Kedlaya; Kiran S.,9993,0,9999,6
1746548199385,MCWP 40,A00,892729,Duru; Nur,10,0,20,10
1746548199385,MCWP 40,B00,893304,Montejo; Carolina,14,0,20,6
1746548200413,MCWP 40R,A00,893757,Redela; Pamela Morgan,0,5,20,20
1746548201441,MCWP 50,A00,893758,Morshed; Michael James,0,0,20,20
1746548201441,MCWP 50,B00,893761,Bartulis; Jason Michael,17,0,20,3
1746548202469,MCWP 50R,A00,893766,Compas; Sean Matthew,0,1,20,20
1746548202469,MCWP 50R,B00,893769,Carter; Jennifer A,0,1,20,20
1746548202469,MCWP 50R,C00,893771,Krone; Jarret,0,3,20,20
1746548202469,MCWP 50R,D00,893772,Miller; Elizabeth Deen,0,0,20,20
1746548202469,MCWP 50R,E00,893775,Carter; Andrea L,0,1,20,20
1746548203496,MMW 11R,A01,892721,Herbst; Matthew,11,0,27,16
1746548203496,MMW 11R,A02,892722,Herbst; Matthew,0,0,0,3
1746548204522,MMW 12R,A01,892724,Herbst; Matthew,0,11,16,16
1746548204522,MMW 12R,A02,892725,Herbst; Matthew,0,10,16,16
1746548205550,MMW 13R,A01,892727,Staff,0,4,16,16
1746548205550,MMW 13R,A02,892728,Staff,0,4,16,16
1746548205550,MMW 13R,A03,958032,Staff,0,4,16,16
1746548205550,MMW 13R,A04,958033,Staff,0,4,16,16
1746548205550,MMW 13R,A05,958034,Staff,0,4,16,16
1746548206576,SIO 295LS,A00,894015,Staff,5,0,25,20
1746548207602,SIO 295S,A00,894020,Staff,5,0,25,20
1746548208627,SIOC 290S,B01,958918,Merrifield; Mark A,14,0,30,16
1746548209654,SIOC 291S,B01,958922,Gabriel; Corey John,14,0,30,16
1746548210683,SOCI 117,A01,895339,Staff,3,0,5,2
1746548211708,WES 237B,A00,894149,Staff,11,0,20,9
1746548213769,AESE 279B,A00,891859,Staff,13,0,35,22
1746548214796,AIP 197,001,891854,Vespa; Emanuel Ignacio,9999,0,9999,0
1746548215836,ANTH 289S,A00,891856,Gagneux; Pascal,12,0,12,0
1746548216862,BENG 196,001,957946,Engler; Adam J.,9996,0,9999,3
1746548217886,BISP 197,001,959851,Wilhelm; James E.,9998,0,9999,1
1746548218911,CAT 124RS,A01,956906,Staff,6,0,25,19
1746548219937,CAT 125RS,A01,922013,Staff,6,0,25,19
1746548220961,CLRE 250,A00,891860,Morris; Sheldon,9995,0,9999,4
1746548223010,CLRE 251R,A00,907817,Mehta; Ravindra L.,9994,0,9999,5
1746548224035,CLRE 252,A00,891864,Cuomo; Raphael Eduardo,9993,0,9999,6
1746548225060,CLRE 253,A00,891867,Vaida; Florin,9994,0,9999,5
1746548225060,CLRE 253,B00,907819,Staff,9999,0,9999,0
1746548226089,CLRE 259,A00,891868,Patel; Hemal,9998,0,9999,1
1746548227120,CLRE 260,A00,891872,Cuomo; Raphael Eduardo,9999,0,9999,0
1746548228146,CLRE 297,001,891888,Cuomo; Raphael Eduardo,9999,0,9999,0
1746548229173,CSE 191,A00,958773,Minnes Kemp; Mor Mia,9996,0,9999,3
1746548230196,CSE 197,001,959846,Minnes Kemp; Mor Mia,9990,0,9999,9
1746548231223,CSS 201S,A01,892054,Mignozzetti; Umberto,26,0,30,4
1746548232249,CSS 202S,A01,892056,Mignozzetti; Umberto,26,0,30,4
1746548233275,DSC 197,001,956898,Eldridge; Justin Matthew,9998,0,9999,1
1746548234301,DSC 297,001,958000,Mazumdar; Arya,9998,0,9999,1
1746548234301,DSC 297,002,959862,Wang; Yusu,9999,0,9999,0
1746548235329,EAP 100,A00,905686,Staff,9778,0,9999,221
1746548236357,ECE 45,A01,892618,Staff,0,0,65,65
1746548238409,ECE 111,A01,892719,Staff,4,0,65,61
1746548239436,ECE 197,001,957920,Mercier; Patrick Philip,9991,0,9999,8
1746548240464,ECON 178,A01,907814,Zhu; Ying,26,0,35,9
1746548241489,EDS 115,A00,895312,Staff,36,0,45,9
1746548242517,EDS 117,A01,895337,Staff,24,0,30,6
1746548243543,EDS 125,A00,895341,Jones; Gabrielle Anastasia,37,0,45,8
1746548244568,EDS 128A,A01,895459,Fargason; Sharon Gayle,44,0,45,1
1746548245595,EDS 128B,A01,895543,Pappas; Elizabeth,44,0,45,1
1746548246621,EDS 139,A00,897203,Pappas; Elizabeth,44,0,45,1
1746548246621,EDS 139,B00,897209,Fargason; Sharon Gayle,41,0,45,4
1746548247651,EDS 201,A00,895545,Staff,22,0,45,23
1746548248675,EDS 203,A01,895581,Halter; Christopher P.,22,0,45,23
1746548249702,EDS 204R,A01,895625,Heinzman; Erica M.,39,0,45,6
1746548249702,EDS 204R,B01,895693,Halter; Christopher P.,10,0,45,35
1746548250726,EDS 206R,A00,895694,Fargason; Sharon Gayle,1,0,30,29
1746548250726,EDS 206R,B00,895695,Choi; Bailey Miyeon,16,0,30,14
1746548251754,EDS 250,A00,895697,Hemans; Patricia Ann Benitez,22,0,45,23
1746548252778,EDS 281,A00,895701,Meyerott; Theresa Ann,1,0,15,14
1746548253803,EDS 284,A00,895736,Meyerott; Theresa Ann,1,0,15,14
1746548254828,EDS 286,A00,897210,Fine; Sarah,0,0,15,15
1746548255856,EDS 289C,A01,895770,Daly; Alan J.,15,0,15,0
1746548256882,EDS 290,A00,897211,Hofstetter; Carolyn,0,0,15,15
1746548257910,LIGM 5A,A00,896162,Fischer-Grunski; Eva K,13,0,20,7
1746548258935,LIGM 5B,A00,896260,Fischer-Grunski; Eva K,17,0,20,3
1746548259962,LIGM 5C,A00,896308,Fischer-Grunski; Eva K,18,0,20,2
1746548260990,LIIT 5AS,A00,896313,Carnelos; Chiara,18,0,20,2
1746548262019,LIIT 5BS,A00,896416,Carnelos; Chiara,20,0,20,0
1746548263047,LIIT 5CS,A00,896564,Carnelos; Chiara,20,0,20,0
1746548264072,LISP 5A,A00,896588,Munoz Sanchez; Alicia,3,0,20,17
1746548265102,LISP 5B,A00,896653,Munoz Sanchez; Alicia,7,0,20,13
1746548266134,LISP 5C,A00,896655,Munoz Sanchez; Alicia,0,1,20,20
1746548267158,MAE 197,001,957918,Kleissl; Jan,9996,0,9999,3
1746548267158,MAE 197,002,959806,Boechler; Nicholas Sebastia,9998,0,9999,1
1746548267158,MAE 197,003,959852,Mullin; Jennifer S,9998,0,9999,1
1746548268185,MATH 2,A01,957937,Staff,33,0,35,2
1746548269209,MATH 197,001,957876,Kedlaya; Kiran S.,9993,0,9999,6
1746548270236,MCWP 40,A00,892729,Duru; Nur,10,0,20,10
1746548270236,MCWP 40,B00,893304,Montejo; Carolina,14,0,20,6
1746548271264,MCWP 40R,A00,893757,Redela; Pamela Morgan,0,5,20,20
1746548272291,MCWP 50,A00,893758,Morshed; Michael James,0,0,20,20
1746548272291,MCWP 50,B00,893761,Bartulis; Jason Michael,17,0,20,3
1746548273319,MCWP 50R,A00,893766,Compas; Sean Matthew,0,1,20,20
1746548273319,MCWP 50R,B00,893769,Carter; Jennifer A,0,1,20,20
1746548273319,MCWP 50R,C00,893771,Krone; Jarret,0,3,20,20
1746548273319,MCWP 50R,D00,893772,Miller; Elizabeth Deen,0,0,20,20
1746548273319,MCWP 50R,E00,893775,Carter; Andrea L,0,1,20,20
1746548274347,MMW 11R,A01,892721,Herbst; Matthew,11,0,27,16
1746548274347,MMW 11R,A02,892722,Herbst; Matthew,0,0,0,3
1746548275372,MMW 12R,A01,892724,Herbst; Matthew,0,11,16,16
1746548275372,MMW 12R,A02,892725,Herbst; Matthew,0,10,16,16
1746548276400,MMW 13R,A01,892727,Staff,0,4,16,16
1746548276400,MMW 13R,A02,892728,Staff,0,4,16,16
1746548276400,MMW 13R,A03,958032,Staff,0,4,16,16
1746548276400,MMW 13R,A04,958033,Staff,0,4,16,16
1746548276400,MMW 13R,A05,958034,Staff,0,4,16,16
1746548277433,SIO 295LS,A00,894015,Staff,5,0,25,20
1746548278460,SIO 295S,A00,894020,Staff,5,0,25,20
1746548279490,SIOC 290S,B01,958918,Merrifield; Mark A,14,0,30,16
1746548280519,SIOC 291S,B01,958922,Gabriel; Corey John,14,0,30,16
1746548281546,SOCI 117,A01,895339,Staff,3,0,5,2
1746548282572,WES 237B,A00,894149,Staff,11,0,20,9
1746548284638,AESE 279B,A00,891859,Staff,13,0,35,22
1746548285664,AIP 197,001,891854,Vespa; Emanuel Ignacio,9999,0,9999,0
1746548286694,ANTH 289S,A00,891856,Gagneux; Pascal,12,0,12,0
1746548287718,BENG 196,001,957946,Engler; Adam J.,9996,0,9999,3
1746548288744,BISP 197,001,959851,Wilhelm; James E.,9998,0,9999,1
1746548289770,CAT 124RS,A01,956906,Staff,6,0,25,19
1746548290795,CAT 125RS,A01,922013,Staff,6,0,25,19
1746548291820,CLRE 250,A00,891860,Morris; Sheldon,9995,0,9999,4
1746548293871,CLRE 251R,A00,907817,Mehta; Ravindra L.,9994,0,9999,5
1746548294894,CLRE 252,A00,891864,Cuomo; Raphael Eduardo,9993,0,9999,6
1746548295921,CLRE 253,A00,891867,Vaida; Florin,9994,0,9999,5
1746548295921,CLRE 253,B00,907819,Staff,9999,0,9999,0
1746548296946,CLRE 259,A00,891868,Patel; Hemal,9998,0,9999,1
1746548297970,CLRE 260,A00,891872,Cuomo; Raphael Eduardo,9999,0,9999,0
1746548298995,CLRE 297,001,891888,Cuomo; Raphael Eduardo,9999,0,9999,0
1746548300021,CSE 191,A00,958773,Minnes Kemp; Mor Mia,9996,0,9999,3
1746548301048,CSE 197,001,959846,Minnes Kemp; Mor Mia,9990,0,9999,9
1746548302077,CSS 201S,A01,892054,Mignozzetti; Umberto,26,0,30,4
1746548303103,CSS 202S,A01,892056,Mignozzetti; Umberto,26,0,30,4
1746548304128,DSC 197,001,956898,Eldridge; Justin Matthew,9998,0,9999,1
1746548305154,DSC 297,001,958000,Mazumdar; Arya,9998,0,9999,1
1746548305154,DSC 297,002,959862,Wang; Yusu,9999,0,9999,0
1746548306178,EAP 100,A00,905686,Staff,9778,0,9999,221
1746548307207,ECE 45,A01,892618,Staff,0,0,65,65
1746548309259,ECE 111,A01,892719,Staff,4,0,65,61
1746548310285,ECE 197,001,957920,Mercier; Patrick Philip,9991,0,9999,8
1746548311311,ECON 178,A01,907814,Zhu; Ying,26,0,35,9
1746548312337,EDS 115,A00,895312,Staff,36,0,45,9
1746548313361,EDS 117,A01,895337,Staff,24,0,30,6
1746548314407,EDS 125,A00,895341,Jones; Gabrielle Anastasia,37,0,45,8
1746548315433,EDS 128A,A01,895459,Fargason; Sharon Gayle,44,0,45,1
1746548316459,EDS 128B,A01,895543,Pappas; Elizabeth,44,0,45,1
1746548317483,EDS 139,A00,897203,Pappas; Elizabeth,44,0,45,1
1746548317483,EDS 139,B00,897209,Fargason; Sharon Gayle,41,0,45,4
1746548318509,EDS 201,A00,895545,Staff,22,0,45,23
1746548319536,EDS 203,A01,895581,Halter; Christopher P.,22,0,45,23
1746548320563,EDS 204R,A01,895625,Heinzman; Erica M.,39,0,45,6
1746548320563,EDS 204R,B01,895693,Halter; Christopher P.,10,0,45,35
1746548321591,EDS 206R,A00,895694,Fargason; Sharon Gayle,1,0,30,29
1746548321591,EDS 206R,B00,895695,Choi; Bailey Miyeon,16,0,30,14
1746548322620,EDS 250,A00,895697,Hemans; Patricia Ann Benitez,22,0,45,23
1746548323645,EDS 281,A00,895701,Meyerott; Theresa Ann,1,0,15,14
1746548324669,EDS 284,A00,895736,Meyerott; Theresa Ann,1,0,15,14
1746548325700,EDS 286,A00,897210,Fine; Sarah,0,0,15,15
1746548326728,EDS 289C,A01,895770,Daly; Alan J.,15,0,15,0
1746548327753,EDS 290,A00,897211,Hofstetter; Carolyn,0,0,15,15
1746548328778,LIGM 5A,A00,896162,Fischer-Grunski; Eva K,13,0,20,7
1746548329805,LIGM 5B,A00,896260,Fischer-Grunski; Eva K,17,0,20,3
1746548330833,LIGM 5C,A00,896308,Fischer-Grunski; Eva K,18,0,20,2
1746548331858,LIIT 5AS,A00,896313,Carnelos; Chiara,18,0,20,2
1746548332884,LIIT 5BS,A00,896416,Carnelos; Chiara,20,0,20,0
1746548333911,LIIT 5CS,A00,896564,Carnelos; Chiara,20,0,20,0
1746548334936,LISP 5A,A00,896588,Munoz Sanchez; Alicia,3,0,20,17
1746548335962,LISP 5B,A00,896653,Munoz Sanchez; Alicia,7,0,20,13
1746548336987,LISP 5C,A00,896655,Munoz Sanchez; Alicia,0,1,20,20
1746548338014,MAE 197,001,957918,Kleissl; Jan,9996,0,9999,3
1746548338014,MAE 197,002,959806,Boechler; Nicholas Sebastia,9998,0,9999,1
1746548338014,MAE 197,003,959852,Mullin; Jennifer S,9998,0,9999,1
1746548339039,MATH 2,A01,957937,Staff,33,0,35,2
1746548340068,MATH 197,001,957876,Kedlaya; Kiran S.,9993,0,9999,6
1746548341095,MCWP 40,A00,892729,Duru; Nur,10,0,20,10
1746548341095,MCWP 40,B00,893304,Montejo; Carolina,14,0,20,6
1746548342120,MCWP 40R,A00,893757,Redela; Pamela Morgan,0,5,20,20
1746548343146,MCWP 50,A00,893758,Morshed; Michael James,0,0,20,20
1746548343146,MCWP 50,B00,893761,Bartulis; Jason Michael,17,0,20,3
1746548344177,MCWP 50R,A00,893766,Compas; Sean Matthew,0,1,20,20
1746548344177,MCWP 50R,B00,893769,Carter; Jennifer A,0,1,20,20
1746548344177,MCWP 50R,C00,893771,Krone; Jarret,0,3,20,20
1746548344177,MCWP 50R,D00,893772,Miller; Elizabeth Deen,0,0,20,20
1746548344177,MCWP 50R,E00,893775,Carter; Andrea L,0,1,20,20
1746548345201,MMW 11R,A01,892721,Herbst; Matthew,11,0,27,16
1746548345201,MMW 11R,A02,892722,Herbst; Matthew,0,0,0,3
1746548346230,MMW 12R,A01,892724,Herbst; Matthew,0,11,16,16
1746548346230,MMW 12R,A02,892725,Herbst; Matthew,0,10,16,16
1746548347254,MMW 13R,A01,892727,Staff,0,4,16,16
1746548347254,MMW 13R,A02,892728,Staff,0,4,16,16
1746548347254,MMW 13R,A03,958032,Staff,0,4,16,16
1746548347254,MMW 13R,A04,958033,Staff,0,4,16,16
1746548347254,MMW 13R,A05,958034,Staff,0,4,16,16
1746548348278,SIO 295LS,A00,894015,Staff,5,0,25,20
1746548349306,SIO 295S,A00,894020,Staff,5,0,25,20
1746548350333,SIOC 290S,B01,958918,Merrifield; Mark A,14,0,30,16
1746548351360,SIOC 291S,B01,958922,Gabriel; Corey John,14,0,30,16
1746548352384,SOCI 117,A01,895339,Staff,3,0,5,2
1746548353410,WES 237B,A00,894149,Staff,11,0,20,9
1746548355463,AESE 279B,A00,891859,Staff,13,0,35,22
1746548356486,AIP 197,001,891854,Vespa; Emanuel Ignacio,9999,0,9999,0
1746548357513,ANTH 289S,A00,891856,Gagneux; Pascal,12,0,12,0
1746548358541,BENG 196,001,957946,Engler; Adam J.,9996,0,9999,3
1746548359566,BISP 197,001,959851,Wilhelm; James E.,9998,0,9999,1
1746548360591,CAT 124RS,A01,956906,Staff,6,0,25,19
1746548361638,CAT 125RS,A01,922013,Staff,6,0,25,19
1746548362662,CLRE 250,A00,891860,Morris; Sheldon,9995,0,9999,4
1746548364714,CLRE 251R,A00,907817,Mehta; Ravindra L.,9994,0,9999,5
1746548365739,CLRE 252,A00,891864,Cuomo; Raphael Eduardo,9993,0,9999,6
1746548366763,CLRE 253,A00,891867,Vaida; Florin,9994,0,9999,5
1746548366763,CLRE 253,B00,907819,Staff,9999,0,9999,0
1746548367788,CLRE 259,A00,891868,Patel; Hemal,9998,0,9999,1
1746548368812,CLRE 260,A00,891872,Cuomo; Raphael Eduardo,9999,0,9999,0
1746548369848,CLRE 297,001,891888,Cuomo; Raphael Eduardo,9999,0,9999,0
1746548370876,CSE 191,A00,958773,Minnes Kemp; Mor Mia,9996,0,9999,3
1746548371903,CSE 197,001,959846,Minnes Kemp; Mor Mia,9990,0,9999,9
1746548372929,CSS 201S,A01,892054,Mignozzetti; Umberto,26,0,30,4
1746548373954,CSS 202S,A01,892056,Mignozzetti; Umberto,26,0,30,4
1746548374982,DSC 197,001,956898,Eldridge; Justin Matthew,9998,0,9999,1
1746548376007,DSC 297,001,958000,Mazumdar; Arya,9998,0,9999,1
1746548376007,DSC 297,002,959862,Wang; Yusu,9999,0,9999,0
1746548377031,EAP 100,A00,905686,Staff,9778,0,9999,221
1746548378058,ECE 45,A01,892618,Staff,0,0,65,65
1746548380109,ECE 111,A01,892719,Staff,4,0,65,61
1746548381133,ECE 197,001,957920,Mercier; Patrick Philip,9991,0,9999,8
1746548382162,ECON 178,A01,907814,Zhu; Ying,26,0,35,9
1746548383190,EDS 115,A00,895312,Staff,36,0,45,9
1746548384215,EDS 117,A01,895337,Staff,24,0,30,6
1746548385244,EDS 125,A00,895341,Jones; Gabrielle Anastasia,37,0,45,8
1746548386273,EDS 128A,A01,895459,Fargason; Sharon Gayle,44,0,45,1
1746548387299,EDS 128B,A01,895543,Pappas; Elizabeth,44,0,45,1
1746548388326,EDS 139,A00,897203,Pappas; Elizabeth,44,0,45,1
1746548388326,EDS 139,B00,897209,Fargason; Sharon Gayle,41,0,45,4
1746548389350,EDS 201,A00,895545,Staff,22,0,45,23
1746548390376,EDS 203,A01,895581,Halter; Christopher P.,22,0,45,23
1746548391401,EDS 204R,A01,895625,Heinzman; Erica M.,39,0,45,6
1746548391401,EDS 204R,B01,895693,Halter; Christopher P.,10,0,45,35
1746548392426,EDS 206R,A00,895694,Fargason; Sharon Gayle,1,0,30,29
1746548392426,EDS 206R,B00,895695,Choi; Bailey Miyeon,16,0,30,14
1746548393451,EDS 250,A00,895697,Hemans; Patricia Ann Benitez,22,0,45,23
1746548394478,EDS 281,A00,895701,Meyerott; Theresa Ann,1,0,15,14
1746548395503,EDS 284,A00,895736,Meyerott; Theresa Ann,1,0,15,14
1746548396531,EDS 286,A00,897210,Fine; Sarah,0,0,15,15
1746548397559,EDS 289C,A01,895770,Daly; Alan J.,15,0,15,0
1746548398587,EDS 290,A00,897211,Hofstetter; Carolyn,0,0,15,15
1746548399612,LIGM 5A,A00,896162,Fischer-Grunski; Eva K,13,0,20,7
1746548400636,LIGM 5B,A00,896260,Fischer-Grunski; Eva K,17,0,20,3
1746548401663,LIGM 5C,A00,896308,Fischer-Grunski; Eva K,18,0,20,2
1746548402688,LIIT 5AS,A00,896313,Carnelos; Chiara,18,0,20,2
1746548403715,LIIT 5BS,A00,896416,Carnelos; Chiara,20,0,20,0
1746548404742,LIIT 5CS,A00,896564,Carnelos; Chiara,20,0,20,0
1746548405766,LISP 5A,A00,896588,Munoz Sanchez; Alicia,3,0,20,17
1746548406790,LISP 5B,A00,896653,Munoz Sanchez; Alicia,7,0,20,13
1746548407816,LISP 5C,A00,896655,Munoz Sanchez; Alicia,0,1,20,20
1746548408844,MAE 197,001,957918,Kleissl; Jan,9996,0,9999,3
1746548408844,MAE 197,002,959806,Boechler; Nicholas Sebastia,9998,0,9999,1
1746548408844,MAE 197,003,959852,Mullin; Jennifer S,9998,0,9999,1
1746548409870,MATH 2,A01,957937,Staff,33,0,35,2
1746548410895,MATH 197,001,957876,Kedlaya; Kiran S.,9993,0,9999,6
1746548411920,MCWP 40,A00,892729,Duru; Nur,10,0,20,10
1746548411920,MCWP 40,B00,893304,Montejo; Carolina,14,0,20,6
1746548412948,MCWP 40R,A00,893757,Redela; Pamela Morgan,0,5,20,20
1746548413975,MCWP 50,A00,893758,Morshed; Michael James,0,0,20,20
1746548413975,MCWP 50,B00,893761,Bartulis; Jason Michael,17,0,20,3
1746548415007,MCWP 50R,A00,893766,Compas; Sean Matthew,0,1,20,20
1746548415007,MCWP 50R,B00,893769,Carter; Jennifer A,0,1,20,20
1746548415007,MCWP 50R,C00,893771,Krone; Jarret,0,3,20,20
1746548415007,MCWP 50R,D00,893772,Miller; Elizabeth Deen,0,0,20,20
1746548415007,MCWP 50R,E00,893775,Carter; Andrea L,0,1,20,20
1746548416032,MMW 11R,A01,892721,Herbst; Matthew,11,0,27,16
1746548416032,MMW 11R,A02,892722,Herbst; Matthew,0,0,0,3
1746548417058,MMW 12R,A01,892724,Herbst; Matthew,0,11,16,16
1746548417058,MMW 12R,A02,892725,Herbst; Matthew,0,10,16,16
1746548418084,MMW 13R,A01,892727,Staff,0,4,16,16
1746548418084,MMW 13R,A02,892728,Staff,0,4,16,16
1746548418084,MMW 13R,A03,958032,Staff,0,4,16,16
1746548418084,MMW 13R,A04,958033,Staff,0,4,16,16
1746548418084,MMW 13R,A05,958034,Staff,0,4,16,16
1746548419112,SIO 295LS,A00,894015,Staff,5,0,25,20
1746548420144,SIO 295S,A00,894020,Staff,5,0,25,20
1746548421172,SIOC 290S,B01,958918,Merrifield; Mark A,14,0,30,16
1746548422203,SIOC 291S,B01,958922,Gabriel; Corey John,14,0,30,16
1746548423229,SOCI 117,A01,895339,Staff,3,0,5,2
1746548424254,WES 237B,A00,894149,Staff,11,0,20,9
1746548426314,AESE 279B,A00,891859,Staff,13,0,35,22
1746548427343,AIP 197,001,891854,Vespa; Emanuel Ignacio,9999,0,9999,0
1746548428366,ANTH 289S,A00,891856,Gagneux; Pascal,12,0,12,0
1746548429392,BENG 196,001,957946,Engler; Adam J.,9996,0,9999,3
1746548430419,BISP 197,001,959851,Wilhelm; James E.,9998,0,9999,1
1746548431446,CAT 124RS,A01,956906,Staff,6,0,25,19
1746548432474,CAT 125RS,A01,922013,Staff,6,0,25,19
1746548433501,CLRE 250,A00,891860,Morris; Sheldon,9995,0,9999,4
1746548435552,CLRE 251R,A00,907817,Mehta; Ravindra L.,9994,0,9999,5
1746548436578,CLRE 252,A00,891864,Cuomo; Raphael Eduardo,9993,0,9999,6
1746548437606,CLRE 253,A00,891867,Vaida; Florin,9994,0,9999,5
1746548437606,CLRE 253,B00,907819,Staff,9999,0,9999,0
1746548438632,CLRE 259,A00,891868,Patel; Hemal,9998,0,9999,1
1746548439658,CLRE 260,A00,891872,Cuomo; Raphael Eduardo,9999,0,9999,0
1746548440682,CLRE 297,001,891888,Cuomo; Raphael Eduardo,9999,0,9999,0
1746548441710,CSE 191,A00,958773,Minnes Kemp; Mor Mia,9996,0,9999,3
1746548442735,CSE 197,001,959846,Minnes Kemp; Mor Mia,9990,0,9999,9
1746548443761,CSS 201S,A01,892054,Mignozzetti; Umberto,26,0,30,4
1746548444792,CSS 202S,A01,892056,Mignozzetti; Umberto,26,0,30,4
1746548445816,DSC 197,001,956898,Eldridge; Justin Matthew,9998,0,9999,1
1746548446841,DSC 297,001,958000,Mazumdar; Arya,9998,0,9999,1
1746548446841,DSC 297,002,959862,Wang; Yusu,9999,0,9999,0
1746548447866,EAP 100,A00,905686,Staff,9778,0,9999,221
1746548448892,ECE 45,A01,892618,Staff,0,0,65,65
1746548450946,ECE 111,A01,892719,Staff,4,0,65,61
1746548451970,ECE 197,001,957920,Mercier; Patrick Philip,9991,0,9999,8
1746548452995,ECON 178,A01,907814,Zhu; Ying,26,0,35,9
1746548454023,EDS 115,A00,895312,Staff,36,0,45,9
1746548455051,EDS 117,A01,895337,Staff,24,0,30,6
1746548456080,EDS 125,A00,895341,Jones; Gabrielle Anastasia,37,0,45,8
1746548457105,EDS 128A,A01,895459,Fargason; Sharon Gayle,44,0,45,1
1746548458131,EDS 128B,A01,895543,Pappas; Elizabeth,44,0,45,1
1746548459158,EDS 139,A00,897203,Pappas; Elizabeth,44,0,45,1
1746548459158,EDS 139,B00,897209,Fargason; Sharon Gayle,41,0,45,4
1746548460186,EDS 201,A00,895545,Staff,22,0,45,23
1746548461211,EDS 203,A01,895581,Halter; Christopher P.,22,0,45,23
1746548462239,EDS 204R,A01,895625,Heinzman; Erica M.,39,0,45,6
1746548462239,EDS 204R,B01,895693,Halter; Christopher P.,10,0,45,35
1746548463263,EDS 206R,A00,895694,Fargason; Sharon Gayle,1,0,30,29
1746548463263,EDS 206R,B00,895695,Choi; Bailey Miyeon,16,0,30,14
1746548464290,EDS 250,A00,895697,Hemans; Patricia Ann Benitez,22,0,45,23
1746548465318,EDS 281,A00,895701,Meyerott; Theresa Ann,1,0,15,14
1746548466346,EDS 284,A00,895736,Meyerott; Theresa Ann,1,0,15,14
1746548467372,EDS 286,A00,897210,Fine; Sarah,0,0,15,15
1746548468397,EDS 289C,A01,895770,Daly; Alan J.,15,0,15,0
1746548469422,EDS 290,A00,897211,Hofstetter; Carolyn,0,0,15,15
1746548470448,LIGM 5A,A00,896162,Fischer-Grunski; Eva K,13,0,20,7
1746548471471,LIGM 5B,A00,896260,Fischer-Grunski; Eva K,17,0,20,3
1746548472498,LIGM 5C,A00,896308,Fischer-Grunski; Eva K,18,0,20,2
1746548473526,LIIT 5AS,A00,896313,Carnelos; Chiara,18,0,20,2
1746548474555,LIIT 5BS,A00,896416,Carnelos; Chiara,20,0,20,0
1746548475585,LIIT 5CS,A00,896564,Carnelos; Chiara,20,0,20,0
1746548476611,LISP 5A,A00,896588,Munoz Sanchez; Alicia,3,0,20,17
1746548477639,LISP 5B,A00,896653,Munoz Sanchez; Alicia,7,0,20,13
1746548478667,LISP 5C,A00,896655,Munoz Sanchez; Alicia,0,1,20,20
1746548479691,MAE 197,001,957918,Kleissl; Jan,9996,0,9999,3
1746548479691,MAE 197,002,959806,Boechler; Nicholas Sebastia,9998,0,9999,1
1746548479691,MAE 197,003,959852,Mullin; Jennifer S,9998,0,9999,1
1746548480716,MATH 2,A01,957937,Staff,33,0,35,2
1746548481741,MATH 197,001,957876,Kedlaya; Kiran S.,9993,0,9999,6
1746548482766,MCWP 40,A00,892729,Duru; Nur,10,0,20,10
1746548482766,MCWP 40,B00,893304,Montejo; Carolina,14,0,20,6
1746548483791,MCWP 40R,A00,893757,Redela; Pamela Morgan,0,5,20,20
1746548484816,MCWP 50,A00,893758,Morshed; Michael James,0,0,20,20
1746548484816,MCWP 50,B00,893761,Bartulis; Jason Michael,17,0,20,3
1746548485842,MCWP 50R,A00,893766,Compas; Sean Matthew,0,1,20,20
1746548485842,MCWP 50R,B00,893769,Carter; Jennifer A,0,1,20,20
1746548485842,MCWP 50R,C00,893771,Krone; Jarret,0,3,20,20
1746548485842,MCWP 50R,D00,893772,Miller; Elizabeth Deen,0,0,20,20
1746548485842,MCWP 50R,E00,893775,Carter; Andrea L,0,1,20,20
1746548486869,MMW 11R,A01,892721,Herbst; Matthew,11,0,27,16
1746548486869,MMW 11R,A02,892722,Herbst; Matthew,0,0,0,3
1746548487896,MMW 12R,A01,892724,Herbst; Matthew,0,11,16,16
1746548487896,MMW 12R,A02,892725,Herbst; Matthew,0,10,16,16
1746548488920,MMW 13R,A01,892727,Staff,0,4,16,16
1746548488920,MMW 13R,A02,892728,Staff,0,4,16,16
1746548488920,MMW 13R,A03,958032,Staff,0,4,16,16
1746548488920,MMW 13R,A04,958033,Staff,0,4,16,16
1746548488920,MMW 13R,A05,958034,Staff,0,4,16,16
1746548489946,SIO 295LS,A00,894015,Staff,5,0,25,20
1746548490975,SIO 295S,A00,894020,Staff,5,0,25,20
1746548492001,SIOC 290S,B01,958918,Merrifield; Mark A,14,0,30,16
1746548493026,SIOC 291S,B01,958922,Gabriel; Corey John,14,0,30,16
1746548494055,SOCI 117,A01,895339,Staff,3,0,5,2
1746548495079,WES 237B,A00,894149,Staff,11,0,20,9
1746548497136,AESE 279B,A00,891859,Staff,13,0,35,22
1746548498188,AIP 197,001,891854,Vespa; Emanuel Ignacio,9999,0,9999,0
1746548499214,ANTH 289S,A00,891856,Gagneux; Pascal,12,0,12,0
1746548500239,BENG 196,001,957946,Engler; Adam J.,9996,0,9999,3
1746548501269,BISP 197,001,959851,Wilhelm; James E.,9998,0,9999,1
1746548502293,CAT 124RS,A01,956906,Staff,6,0,25,19
1746548503317,CAT 125RS,A01,922013,Staff,6,0,25,19
1746548504342,CLRE 250,A00,891860,Morris; Sheldon,9995,0,9999,4
1746548506397,CLRE 251R,A00,907817,Mehta; Ravindra L.,9994,0,9999,5
1746548507424,CLRE 252,A00,891864,Cuomo; Raphael Eduardo,9993,0,9999,6
1746548508450,CLRE 253,A00,891867,Vaida; Florin,9994,0,9999,5
1746548508450,CLRE 253,B00,907819,Staff,9999,0,9999,0
1746548509475,CLRE 259,A00,891868,Patel; Hemal,9998,0,9999,1
1746548510504,CLRE 260,A00,891872,Cuomo; Raphael Eduardo,9999,0,9999,0
1746548511527,CLRE 297,001,891888,Cuomo; Raphael Eduardo,9999,0,9999,0
1746548512551,CSE 191,A00,958773,Minnes Kemp; Mor Mia,9996,0,9999,3
1746548513579,CSE 197,001,959846,Minnes Kemp; Mor Mia,9990,0,9999,9
1746548514608,CSS 201S,A01,892054,Mignozzetti; Umberto,26,0,30,4
1746548515638,CSS 202S,A01,892056,Mignozzetti; Umberto,26,0,30,4
1746548516665,DSC 197,001,956898,Eldridge; Justin Matthew,9998,0,9999,1
1746548517690,DSC 297,001,958000,Mazumdar; Arya,9998,0,9999,1
1746548517690,DSC 297,002,959862,Wang; Yusu,9999,0,9999,0
1746548518717,EAP 100,A00,905686,Staff,9778,0,9999,221
1746548519747,ECE 45,A01,892618,Staff,0,0,65,65
1746548521798,ECE 111,A01,892719,Staff,4,0,65,61
1746548522828,ECE 197,001,957920,Mercier; Patrick Philip,9991,0,9999,8
1746548523853,ECON 178,A01,907814,Zhu; Ying,26,0,35,9
1746548524878,EDS 115,A00,895312,Staff,36,0,45,9
1746548525904,EDS 117,A01,895337,Staff,24,0,30,6
1746548526931,EDS 125,A00,895341,Jones; Gabrielle Anastasia,37,0,45,8
1746548527959,EDS 128A,A01,895459,Fargason; Sharon Gayle,44,0,45,1
1746548528987,EDS 128B,A01,895543,Pappas; Elizabeth,44,0,45,1
1746548530012,EDS 139,A00,897203,Pappas; Elizabeth,44,0,45,1
1746548530012,EDS 139,B00,897209,Fargason; Sharon Gayle,41,0,45,4
1746548531038,EDS 201,A00,895545,Staff,22,0,45,23
1746548532067,EDS 203,A01,895581,Halter; Christopher P.,22,0,45,23
1746548533097,EDS 204R,A01,895625,Heinzman; Erica M.,39,0,45,6
1746548533097,EDS 204R,B01,895693,Halter; Christopher P.,10,0,45,35
1746548534122,EDS 206R,A00,895694,Fargason; Sharon Gayle,1,0,30,29
1746548534122,EDS 206R,B00,895695,Choi; Bailey Miyeon,16,0,30,14
1746548535146,EDS 250,A00,895697,Hemans; Patricia Ann Benitez,22,0,45,23
1746548536175,EDS 281,A00,895701,Meyerott; Theresa Ann,1,0,15,14
1746548537204,EDS 284,A00,895736,Meyerott; Theresa Ann,1,0,15,14
1746548538232,EDS 286,A00,897210,Fine; Sarah,0,0,15,15
1746548539258,EDS 289C,A01,895770,Daly; Alan J.,15,0,15,0
1746548540283,EDS 290,A00,897211,Hofstetter; Carolyn,0,0,15,15
1746548541308,LIGM 5A,A00,896162,Fischer-Grunski; Eva K,13,0,20,7
1746548542337,LIGM 5B,A00,896260,Fischer-Grunski; Eva K,17,0,20,3
1746548543363,LIGM 5C,A00,896308,Fischer-Grunski; Eva K,18,0,20,2
1746548544390,LIIT 5AS,A00,896313,Carnelos; Chiara,18,0,20,2
1746548545416,LIIT 5BS,A00,896416,Carnelos; Chiara,20,0,20,0
1746548546444,LIIT 5CS,A00,896564,Carnelos; Chiara,20,0,20,0
1746548547469,LISP 5A,A00,896588,Munoz Sanchez; Alicia,3,0,20,17
1746548548505,LISP 5B,A00,896653,Munoz Sanchez; Alicia,7,0,20,13
1746548549531,LISP 5C,A00,896655,Munoz Sanchez; Alicia,0,1,20,20
1746548550556,MAE 197,001,957918,Kleissl; Jan,9996,0,9999,3
1746548550556,MAE 197,002,959806,Boechler; Nicholas Sebastia,9998,0,9999,1
1746548550556,MAE 197,003,959852,Mullin; Jennifer S,9998,0,9999,1
1746548551579,MATH 2,A01,957937,Staff,33,0,35,2
1746548552606,MATH 197,001,957876,Kedlaya; Kiran S.,9993,0,9999,6
1746548553635,MCWP 40,A00,892729,Duru; Nur,10,0,20,10
1746548553635,MCWP 40,B00,893304,Montejo; Carolina,14,0,20,6
1746548554664,MCWP 40R,A00,893757,Redela; Pamela Morgan,0,5,20,20
1746548555689,MCWP 50,A00,893758,Morshed; Michael James,0,0,20,20
1746548555689,MCWP 50,B00,893761,Bartulis; Jason Michael,17,0,20,3
1746548556718,MCWP 50R,A00,893766,Compas; Sean Matthew,0,1,20,20
1746548556718,MCWP 50R,B00,893769,Carter; Jennifer A,0,1,20,20
1746548556718,MCWP 50R,C00,893771,Krone; Jarret,0,3,20,20
1746548556718,MCWP 50R,D00,893772,Miller; Elizabeth Deen,0,0,20,20
1746548556718,MCWP 50R,E00,893775,Carter; Andrea L,0,1,20,20
1746548557743,MMW 11R,A01,892721,Herbst; Matthew,11,0,27,16
1746548557743,MMW 11R,A02,892722,Herbst; Matthew,0,0,0,3
1746548558767,MMW 12R,A01,892724,Herbst; Matthew,0,11,16,16
1746548558767,MMW 12R,A02,892725,Herbst; Matthew,0,10,16,16
1746548559793,MMW 13R,A01,892727,Staff,0,4,16,16
1746548559793,MMW 13R,A02,892728,Staff,0,4,16,16
1746548559793,MMW 13R,A03,958032,Staff,0,4,16,16
1746548559793,MMW 13R,A04,958033,Staff,0,4,16,16
1746548559793,MMW 13R,A05,958034,Staff,0,4,16,16
1746548560820,SIO 295LS,A00,894015,Staff,5,0,25,20
1746548561845,SIO 295S,A00,894020,Staff,5,0,25,20
1746548562874,SIOC 290S,B01,958918,Merrifield; Mark A,14,0,30,16
1746548563900,SIOC 291S,B01,958922,Gabriel; Corey John,14,0,30,16
1746548564926,SOCI 117,A01,895339,Staff,3,0,5,2
1746548565953,WES 237B,A00,894149,Staff,11,0,20,9
1746548568010,AESE 279B,A00,891859,Staff,13,0,35,22
1746548569034,AIP 197,001,891854,Vespa; Emanuel Ignacio,9999,0,9999,0
1746548570062,ANTH 289S,A00,891856,Gagneux; Pascal,12,0,12,0
1746548571089,BENG 196,001,957946,Engler; Adam J.,9996,0,9999,3
1746548572114,BISP 197,001,959851,Wilhelm; James E.,9998,0,9999,1
1746548573139,CAT 124RS,A01,956906,Staff,6,0,25,19
1746548574167,CAT 125RS,A01,922013,Staff,6,0,25,19
1746548575191,CLRE 250,A00,891860,Morris; Sheldon,9995,0,9999,4
1746548577243,CLRE 251R,A00,907817,Mehta; Ravindra L.,9994,0,9999,5
1746548578269,CLRE 252,A00,891864,Cuomo; Raphael Eduardo,9993,0,9999,6
1746548579294,CLRE 253,A00,891867,Vaida; Florin,9994,0,9999,5
1746548579294,CLRE 253,B00,907819,Staff,9999,0,9999,0
1746548580326,CLRE 259,A00,891868,Patel; Hemal,9998,0,9999,1
1746548581351,CLRE 260,A00,891872,Cuomo; Raphael Eduardo,9999,0,9999,0
1746548582377,CLRE 297,001,891888,Cuomo; Raphael Eduardo,9999,0,9999,0
1746548583403,CSE 191,A00,958773,Minnes Kemp; Mor Mia,9996,0,9999,3
1746548584428,CSE 197,001,959846,Minnes Kemp; Mor Mia,9990,0,9999,9
1746548585453,CSS 201S,A01,892054,Mignozzetti; Umberto,26,0,30,4
1746548586478,CSS 202S,A01,892056,Mignozzetti; Umberto,26,0,30,4
1746548587505,DSC 197,001,956898,Eldridge; Justin Matthew,9998,0,9999,1
1746548588530,DSC 297,001,958000,Mazumdar; Arya,9998,0,9999,1
1746548588530,DSC 297,002,959862,Wang; Yusu,9999,0,9999,0
1746548589556,EAP 100,A00,905686,Staff,9778,0,9999,221
1746548590581,ECE 45,A01,892618,Staff,0,0,65,65
1746548592632,ECE 111,A01,892719,Staff,4,0,65,61
1746548593659,ECE 197,001,957920,Mercier; Patrick Philip,9991,0,9999,8
1746548594688,ECON 178,A01,907814,Zhu; Ying,26,0,35,9
1746548595714,EDS 115,A00,895312,Staff,36,0,45,9
1746548596740,EDS 117,A01,895337,Staff,24,0,30,6
1746548597764,EDS 125,A00,895341,Jones; Gabrielle Anastasia,37,0,45,8
1746548598792,EDS 128A,A01,895459,Fargason; Sharon Gayle,44,0,45,1
1746548599818,EDS 128B,A01,895543,Pappas; Elizabeth,44,0,45,1
1746548600844,EDS 139,A00,897203,Pappas; Elizabeth,44,0,45,1
1746548600844,EDS 139,B00,897209,Fargason; Sharon Gayle,41,0,45,4
1746548601869,EDS 201,A00,895545,Staff,22,0,45,23
1746548602895,EDS 203,A01,895581,Halter; Christopher P.,22,0,45,23
1746548603920,EDS 204R,A01,895625,Heinzman; Erica M.,39,0,45,6
1746548603920,EDS 204R,B01,895693,Halter; Christopher P.,10,0,45,35
1746548604948,EDS 206R,A00,895694,Fargason; Sharon Gayle,1,0,30,29
1746548604948,EDS 206R,B00,895695,Choi; Bailey Miyeon,16,0,30,14
1746548605973,EDS 250,A00,895697,Hemans; Patricia Ann Benitez,22,0,45,23
1746548606997,EDS 281,A00,895701,Meyerott; Theresa Ann,1,0,15,14
1746548608029,EDS 284,A00,895736,Meyerott; Theresa Ann,1,0,15,14
1746548609054,EDS 286,A00,897210,Fine; Sarah,0,0,15,15
1746548610078,EDS 289C,A01,895770,Daly; Alan J.,15,0,15,0
1746548611102,EDS 290,A00,897211,Hofstetter; Carolyn,0,0,15,15
1746548612130,LIGM 5A,A00,896162,Fischer-Grunski; Eva K,13,0,20,7
1746548613194,LIGM 5B,A00,896260,Fischer-Grunski; Eva K,17,0,20,3
1746548614219,LIGM 5C,A00,896308,Fischer-Grunski; Eva K,18,0,20,2
1746548615244,LIIT 5AS,A00,896313,Carnelos; Chiara,18,0,20,2
1746548616269,LIIT 5BS,A00,896416,Carnelos; Chiara,20,0,20,0
1746548617294,LIIT 5CS,A00,896564,Carnelos; Chiara,20,0,20,0
1746548618322,LISP 5A,A00,896588,Munoz Sanchez; Alicia,3,0,20,17
1746548619351,LISP 5B,A00,896653,Munoz Sanchez; Alicia,7,0,20,13
1746548620378,LISP 5C,A00,896655,Munoz Sanchez; Alicia,0,1,20,20
1746548621405,MAE 197,001,957918,Kleissl; Jan,9996,0,9999,3
1746548621405,MAE 197,002,959806,Boechler; Nicholas Sebastia,9998,0,9999,1
1746548621405,MAE 197,003,959852,Mullin; Jennifer S,9998,0,9999,1
1746548622431,MATH 2,A01,957937,Staff,33,0,35,2
1746548623455,MATH 197,001,957876,Kedlaya; Kiran S.,9993,0,9999,6
1746548624487,MCWP 40,A00,892729,Duru; Nur,10,0,20,10
1746548624487,MCWP 40,B00,893304,Montejo; Carolina,14,0,20,6
1746548625511,MCWP 40R,A00,893757,Redela; Pamela Morgan,0,5,20,20
1746548626539,MCWP 50,A00,893758,Morshed; Michael James,0,0,20,20
1746548626539,MCWP 50,B00,893761,Bartulis; Jason Michael,17,0,20,3
1746548627569,MCWP 50R,A00,893766,Compas; Sean Matthew,0,1,20,20
1746548627569,MCWP 50R,B00,893769,Carter; Jennifer A,0,1,20,20
1746548627569,MCWP 50R,C00,893771,Krone; Jarret,0,3,20,20
1746548627569,MCWP 50R,D00,893772,Miller; Elizabeth Deen,0,0,20,20
1746548627569,MCWP 50R,E00,893775,Carter; Andrea L,0,1,20,20
1746548628598,MMW 11R,A01,892721,Herbst; Matthew,11,0,27,16
1746548628598,MMW 11R,A02,892722,Herbst; Matthew,0,0,0,3
1746548629626,MMW 12R,A01,892724,Herbst; Matthew,0,11,16,16
1746548629626,MMW 12R,A02,892725,Herbst; Matthew,0,10,16,16
1746548630651,MMW 13R,A01,892727,Staff,0,4,16,16
1746548630651,MMW 13R,A02,892728,Staff,0,4,16,16
1746548630651,MMW 13R,A03,958032,Staff,0,4,16,16
1746548630651,MMW 13R,A04,958033,Staff,0,4,16,16
1746548630651,MMW 13R,A05,958034,Staff,0,4,16,16
1746548631692,SIO 295LS,A00,894015,Staff,5,0,25,20
1746548632717,SIO 295S,A00,894020,Staff,5,0,25,20
1746548633746,SIOC 290S,B01,958918,Merrifield; Mark A,14,0,30,16
1746548634772,SIOC 291S,B01,958922,Gabriel; Corey John,14,0,30,16
1746548635798,SOCI 117,A01,895339,Staff,3,0,5,2
1746548636822,WES 237B,A00,894149,Staff,11,0,20,9
1746548638877,AESE 279B,A00,891859,Staff,13,0,35,22
1746548639902,AIP 197,001,891854,Vespa; Emanuel Ignacio,9999,0,9999,0
1746548640928,ANTH 289S,A00,891856,Gagneux; Pascal,12,0,12,0
1746548641951,BENG 196,001,957946,Engler; Adam J.,9996,0,9999,3
1746548642978,BISP 197,001,959851,Wilhelm; James E.,9998,0,9999,1
1746548644004,CAT 124RS,A01,956906,Staff,6,0,25,19
1746548645031,CAT 125RS,A01,922013,Staff,6,0,25,19
1746548646057,CLRE 250,A00,891860,Morris; Sheldon,9995,0,9999,4
1746548648109,CLRE 251R,A00,907817,Mehta; Ravindra L.,9994,0,9999,5
1746548649137,CLRE 252,A00,891864,Cuomo; Raphael Eduardo,9993,0,9999,6
1746548650164,CLRE 253,A00,891867,Vaida; Florin,9994,0,9999,5
1746548650164,CLRE 253,B00,907819,Staff,9999,0,9999,0
1746548651189,CLRE 259,A00,891868,Patel; Hemal,9998,0,9999,1
1746548652214,CLRE 260,A00,891872,Cuomo; Raphael Eduardo,9999,0,9999,0
1746548653238,CLRE 297,001,891888,Cuomo; Raphael Eduardo,9999,0,9999,0
1746548654265,CSE 191,A00,958773,Minnes Kemp; Mor Mia,9996,0,9999,3
1746548655293,CSE 197,001,959846,Minnes Kemp; Mor Mia,9990,0,9999,9
1746548656321,CSS 201S,A01,892054,Mignozzetti; Umberto,26,0,30,4
1746548657349,CSS 202S,A01,892056,Mignozzetti; Umberto,26,0,30,4
1746548658375,DSC 197,001,956898,Eldridge; Justin Matthew,9998,0,9999,1
1746548659401,DSC 297,001,958000,Mazumdar; Arya,9998,0,9999,1
1746548659401,DSC 297,002,959862,Wang; Yusu,9999,0,9999,0
1746548660425,EAP 100,A00,905686,Staff,9778,0,9999,221
1746548661450,ECE 45,A01,892618,Staff,0,0,65,65
1746548663501,ECE 111,A01,892719,Staff,4,0,65,61
1746548664528,ECE 197,001,957920,Mercier; Patrick Philip,9991,0,9999,8
1746548665557,ECON 178,A01,907814,Zhu; Ying,26,0,35,9
1746548666581,EDS 115,A00,895312,Staff,36,0,45,9
1746548667605,EDS 117,A01,895337,Staff,24,0,30,6
1746548668630,EDS 125,A00,895341,Jones; Gabrielle Anastasia,37,0,45,8
1746548669657,EDS 128A,A01,895459,Fargason; Sharon Gayle,44,0,45,1
1746548670682,EDS 128B,A01,895543,Pappas; Elizabeth,44,0,45,1
1746548671708,EDS 139,A00,897203,Pappas; Elizabeth,44,0,45,1
1746548671708,EDS 139,B00,897209,Fargason; Sharon Gayle,41,0,45,4
1746548672735,EDS 201,A00,895545,Staff,22,0,45,23
1746548673761,EDS 203,A01,895581,Halter; Christopher P.,22,0,45,23
1746548674785,EDS 204R,A01,895625,Heinzman; Erica M.,39,0,45,6
1746548674785,EDS 204R,B01,895693,Halter; Christopher P.,10,0,45,35
1746548675812,EDS 206R,A00,895694,Fargason; Sharon Gayle,1,0,30,29
1746548675812,EDS 206R,B00,895695,Choi; Bailey Miyeon,16,0,30,14
1746548676838,EDS 250,A00,895697,Hemans; Patricia Ann Benitez,22,0,45,23
1746548677866,EDS 281,A00,895701,Meyerott; Theresa Ann,1,0,15,14
1746548678891,EDS 284,A00,895736,Meyerott; Theresa Ann,1,0,15,14
1746548679917,EDS 286,A00,897210,Fine; Sarah,0,0,15,15
1746548680943,EDS 289C,A01,895770,Daly; Alan J.,15,0,15,0
1746548681966,EDS 290,A00,897211,Hofstetter; Carolyn,0,0,15,15
1746548682991,LIGM 5A,A00,896162,Fischer-Grunski; Eva K,13,0,20,7
1746548684016,LIGM 5B,A00,896260,Fischer-Grunski; Eva K,17,0,20,3
1746548685042,LIGM 5C,A00,896308,Fischer-Grunski; Eva K,18,0,20,2
1746548686066,LIIT 5AS,A00,896313,Carnelos; Chiara,18,0,20,2
1746548687094,LIIT 5BS,A00,896416,Carnelos; Chiara,20,0,20,0
1746548688122,LIIT 5CS,A00,896564,Carnelos; Chiara,20,0,20,0
1746548689147,LISP 5A,A00,896588,Munoz Sanchez; Alicia,3,0,20,17
1746548690175,LISP 5B,A00,896653,Munoz Sanchez; Alicia,7,0,20,13
1746548691201,LISP 5C,A00,896655,Munoz Sanchez; Alicia,0,1,20,20
1746548692227,MAE 197,001,957918,Kleissl; Jan,9996,0,9999,3
1746548692227,MAE 197,002,959806,Boechler; Nicholas Sebastia,9998,0,9999,1
1746548692227,MAE 197,003,959852,Mullin; Jennifer S,9998,0,9999,1
1746548693252,MATH 2,A01,957937,Staff,33,0,35,2
1746548694280,MATH 197,001,957876,Kedlaya; Kiran S.,9993,0,9999,6
1746548695304,MCWP 40,A00,892729,Duru; Nur,10,0,20,10
1746548695304,MCWP 40,B00,893304,Montejo; Carolina,14,0,20,6
1746548696333,MCWP 40R,A00,893757,Redela; Pamela Morgan,0,5,20,20
1746548697363,MCWP 50,A00,893758,Morshed; Michael James,0,0,20,20
1746548697363,MCWP 50,B00,893761,Bartulis; Jason Michael,17,0,20,3
1746548698386,MCWP 50R,A00,893766,Compas; Sean Matthew,0,1,20,20
1746548698386,MCWP 50R,B00,893769,Carter; Jennifer A,0,1,20,20
1746548698386,MCWP 50R,C00,893771,Krone; Jarret,0,3,20,20
1746548698386,MCWP 50R,D00,893772,Miller; Elizabeth Deen,0,0,20,20
1746548698386,MCWP 50R,E00,893775,Carter; Andrea L,0,1,20,20
1746548699413,MMW 11R,A01,892721,Herbst; Matthew,11,0,27,16
1746548699413,MMW 11R,A02,892722,Herbst; Matthew,0,0,0,3
1746548700442,MMW 12R,A01,892724,Herbst; Matthew,0,11,16,16
1746548700442,MMW 12R,A02,892725,Herbst; Matthew,0,10,16,16
1746548701465,MMW 13R,A01,892727,Staff,0,4,16,16
1746548701465,MMW 13R,A02,892728,Staff,0,4,16,16
1746548701465,MMW 13R,A03,958032,Staff,0,4,16,16
1746548701465,MMW 13R,A04,958033,Staff,0,4,16,16
1746548701465,MMW 13R,A05,958034,Staff,0,4,16,16
1746548702490,SIO 295LS,A00,894015,Staff,5,0,25,20
1746548703526,SIO 295S,A00,894020,Staff,5,0,25,20
1746548704554,SIOC 290S,B01,958918,Merrifield; Mark A,14,0,30,16
1746548705580,SIOC 291S,B01,958922,Gabriel; Corey John,14,0,30,16
1746548706608,SOCI 117,A01,895339,Staff,3,0,5,2
1746548707636,WES 237B,A00,894149,Staff,11,0,20,9
1746548709697,AESE 279B,A00,891859,Staff,13,0,35,22
1746548710725,AIP 197,001,891854,Vespa; Emanuel Ignacio,9999,0,9999,0
1746548711750,ANTH 289S,A00,891856,Gagneux; Pascal,12,0,12,0
1746548712778,BENG 196,001,957946,Engler; Adam J.,9996,0,9999,3
1746548713804,BISP 197,001,959851,Wilhelm; James E.,9998,0,9999,1
1746548714831,CAT 124RS,A01,956906,Staff,6,0,25,19
1746548715857,CAT 125RS,A01,922013,Staff,6,0,25,19
1746548716922,CLRE 250,A00,891860,Morris; Sheldon,9995,0,9999,4
1746548718976,CLRE 251R,A00,907817,Mehta; Ravindra L.,9994,0,9999,5
1746548720005,CLRE 252,A00,891864,Cuomo; Raphael Eduardo,9993,0,9999,6
1746548721035,CLRE 253,A00,891867,Vaida; Florin,9994,0,9999,5
1746548721035,CLRE 253,B00,907819,Staff,9999,0,9999,0
1746548722061,CLRE 259,A00,891868,Patel; Hemal,9998,0,9999,1
1746548723088,CLRE 260,A00,891872,Cuomo; Raphael Eduardo,9999,0,9999,0
1746548724114,CLRE 297,001,891888,Cuomo; Raphael Eduardo,9999,0,9999,0
1746548725352,CSE 191,A00,958773,Minnes Kemp; Mor Mia,9996,0,9999,3
1746548726379,CSE 197,001,959846,Minnes Kemp; Mor Mia,9990,0,9999,9
1746548727403,CSS 201S,A01,892054,Mignozzetti; Umberto,26,0,30,4
1746548728433,CSS 202S,A01,892056,Mignozzetti; Umberto,26,0,30,4
1746548729459,DSC 197,001,956898,Eldridge; Justin Matthew,9998,0,9999,1
1746548730487,DSC 297,001,958000,Mazumdar; Arya,9998,0,9999,1
1746548730487,DSC 297,002,959862,Wang; Yusu,9999,0,9999,0
1746548731512,EAP 100,A00,905686,Staff,9778,0,9999,221
1746548732543,ECE 45,A01,892618,Staff,0,0,65,65
1746548734595,ECE 111,A01,892719,Staff,4,0,65,61
1746548735622,ECE 197,001,957920,Mercier; Patrick Philip,9991,0,9999,8
1746548736649,ECON 178,A01,907814,Zhu; Ying,26,0,35,9
1746548737674,EDS 115,A00,895312,Staff,36,0,45,9
1746548738699,EDS 117,A01,895337,Staff,24,0,30,6
1746548739727,EDS 125,A00,895341,Jones; Gabrielle Anastasia,37,0,45,8
1746548740753,EDS 128A,A01,895459,Fargason; Sharon Gayle,44,0,45,1
1746548741780,EDS 128B,A01,895543,Pappas; Elizabeth,44,0,45,1
1746548742807,EDS 139,A00,897203,Pappas; Elizabeth,44,0,45,1
1746548742807,EDS 139,B00,897209,Fargason; Sharon Gayle,41,0,45,4
1746548743834,EDS 201,A00,895545,Staff,22,0,45,23
1746548744858,EDS 203,A01,895581,Halter; Christopher P.,22,0,45,23
1746548745883,EDS 204R,A01,895625,Heinzman; Erica M.,39,0,45,6
1746548745883,EDS 204R,B01,895693,Halter; Christopher P.,10,0,45,35
1746548746909,EDS 206R,A00,895694,Fargason; Sharon Gayle,1,0,30,29
1746548746909,EDS 206R,B00,895695,Choi; Bailey Miyeon,16,0,30,14
1746548747934,EDS 250,A00,895697,Hemans; Patricia Ann Benitez,22,0,45,23
1746548748961,EDS 281,A00,895701,Meyerott; Theresa Ann,1,0,15,14
1746548749992,EDS 284,A00,895736,Meyerott; Theresa Ann,1,0,15,14
1746548751019,EDS 286,A00,897210,Fine; Sarah,0,0,15,15
1746548752065,EDS 289C,A01,895770,Daly; Alan J.,15,0,15,0
1746548753093,EDS 290,A00,897211,Hofstetter; Carolyn,0,0,15,15
1746548754118,LIGM 5A,A00,896162,Fischer-Grunski; Eva K,13,0,20,7
1746548755150,LIGM 5B,A00,896260,Fischer-Grunski; Eva K,17,0,20,3
1746548756180,LIGM 5C,A00,896308,Fischer-Grunski; Eva K,18,0,20,2
1746548757207,LIIT 5AS,A00,896313,Carnelos; Chiara,18,0,20,2
1746548758232,LIIT 5BS,A00,896416,Carnelos; Chiara,20,0,20,0
1746548759262,LIIT 5CS,A00,896564,Carnelos; Chiara,20,0,20,0
1746548760289,LISP 5A,A00,896588,Munoz Sanchez; Alicia,3,0,20,17
1746548761313,LISP 5B,A00,896653,Munoz Sanchez; Alicia,7,0,20,13
1746548762339,LISP 5C,A00,896655,Munoz Sanchez; Alicia,0,1,20,20
1746548763367,MAE 197,001,957918,Kleissl; Jan,9996,0,9999,3
1746548763367,MAE 197,002,959806,Boechler; Nicholas Sebastia,9998,0,9999,1
1746548763367,MAE 197,003,959852,Mullin; Jennifer S,9998,0,9999,1
1746548764390,MATH 2,A01,957937,Staff,33,0,35,2
1746548765416,MATH 197,001,957876,Kedlaya; Kiran S.,9993,0,9999,6
1746548766440,MCWP 40,A00,892729,Duru; Nur,10,0,20,10
1746548766440,MCWP 40,B00,893304,Montejo; Carolina,14,0,20,6
1746548767465,MCWP 40R,A00,893757,Redela; Pamela Morgan,0,5,20,20
1746548768491,MCWP 50,A00,893758,Morshed; Michael James,0,0,20,20
1746548768491,MCWP 50,B00,893761,Bartulis; Jason Michael,17,0,20,3
1746548769517,MCWP 50R,A00,893766,Compas; Sean Matthew,0,1,20,20
1746548769517,MCWP 50R,B00,893769,Carter; Jennifer A,0,1,20,20
1746548769517,MCWP 50R,C00,893771,Krone; Jarret,0,3,20,20
1746548769517,MCWP 50R,D00,893772,Miller; Elizabeth Deen,0,0,20,20
1746548769517,MCWP 50R,E00,893775,Carter; Andrea L,0,1,20,20
1746548770544,MMW 11R,A01,892721,Herbst; Matthew,11,0,27,16
1746548770544,MMW 11R,A02,892722,Herbst; Matthew,0,0,0,3
1746548771568,MMW 12R,A01,892724,Herbst; Matthew,0,11,16,16
1746548771568,MMW 12R,A02,892725,Herbst; Matthew,0,10,16,16
1746548772596,MMW 13R,A01,892727,Staff,0,4,16,16
1746548772596,MMW 13R,A02,892728,Staff,0,4,16,16
1746548772596,MMW 13R,A03,958032,Staff,0,4,16,16
1746548772596,MMW 13R,A04,958033,Staff,0,4,16,16
1746548772596,MMW 13R,A05,958034,Staff,0,4,16,16
1746548773620,SIO 295LS,A00,894015,Staff,5,0,25,20
1746548774645,SIO 295S,A00,894020,Staff,5,0,25,20
1746548775671,SIOC 290S,B01,958918,Merrifield; Mark A,14,0,30,16
1746548776696,SIOC 291S,B01,958922,Gabriel; Corey John,14,0,30,16
1746548777722,SOCI 117,A01,895339,Staff,3,0,5,2
1746548778749,WES 237B,A00,894149,Staff,11,0,20,9
1746548780810,AESE 279B,A00,891859,Staff,13,0,35,22
1746548781836,AIP 197,001,891854,Vespa; Emanuel Ignacio,9999,0,9999,0
1746548782865,ANTH 289S,A00,891856,Gagneux; Pascal,12,0,12,0
1746548783889,BENG 196,001,957946,Engler; Adam J.,9996,0,9999,3
1746548784917,BISP 197,001,959851,Wilhelm; James E.,9998,0,9999,1
1746548785941,CAT 124RS,A01,956906,Staff,6,0,25,19
1746548786966,CAT 125RS,A01,922013,Staff,6,0,25,19
1746548787993,CLRE 250,A00,891860,Morris; Sheldon,9995,0,9999,4
1746548790044,CLRE 251R,A00,907817,Mehta; Ravindra L.,9994,0,9999,5
1746548791071,CLRE 252,A00,891864,Cuomo; Raphael Eduardo,9993,0,9999,6
1746548792095,CLRE 253,A00,891867,Vaida; Florin,9994,0,9999,5
1746548792095,CLRE 253,B00,907819,Staff,9999,0,9999,0
1746548793122,CLRE 259,A00,891868,Patel; Hemal,9998,0,9999,1
1746548794149,CLRE 260,A00,891872,Cuomo; Raphael Eduardo,9999,0,9999,0
1746548795175,CLRE 297,001,891888,Cuomo; Raphael Eduardo,9999,0,9999,0
1746548796202,CSE 191,A00,958773,Minnes Kemp; Mor Mia,9996,0,9999,3
1746548797229,CSE 197,001,959846,Minnes Kemp; Mor Mia,9990,0,9999,9
1746548798257,CSS 201S,A01,892054,Mignozzetti; Umberto,26,0,30,4
1746548799283,CSS 202S,A01,892056,Mignozzetti; Umberto,26,0,30,4
1746548800307,DSC 197,001,956898,Eldridge; Justin Matthew,9998,0,9999,1
1746548801335,DSC 297,001,958000,Mazumdar; Arya,9998,0,9999,1
1746548801335,DSC 297,002,959862,Wang; Yusu,9999,0,9999,0
1746548802363,EAP 100,A00,905686,Staff,9778,0,9999,221
1746548803389,ECE 45,A01,892618,Staff,0,0,65,65
1746548805441,ECE 111,A01,892719,Staff,4,0,65,61
1746548806468,ECE 197,001,957920,Mercier; Patrick Philip,9991,0,9999,8
1746548807494,ECON 178,A01,907814,Zhu; Ying,26,0,35,9
1746548808520,EDS 115,A00,895312,Staff,36,0,45,9
1746548809547,EDS 117,A01,895337,Staff,24,0,30,6
1746548810574,EDS 125,A00,895341,Jones; Gabrielle Anastasia,37,0,45,8
1746548811601,EDS 128A,A01,895459,Fargason; Sharon Gayle,44,0,45,1
1746548812626,EDS 128B,A01,895543,Pappas; Elizabeth,44,0,45,1
1746548813653,EDS 139,A00,897203,Pappas; Elizabeth,44,0,45,1
1746548813653,EDS 139,B00,897209,Fargason; Sharon Gayle,41,0,45,4
1746548814681,EDS 201,A00,895545,Staff,22,0,45,23
1746548815708,EDS 203,A01,895581,Halter; Christopher P.,22,0,45,23
1746548816735,EDS 204R,A01,895625,Heinzman; Erica M.,39,0,45,6
1746548816735,EDS 204R,B01,895693,Halter; Christopher P.,10,0,45,35
1746548817762,EDS 206R,A00,895694,Fargason; Sharon Gayle,1,0,30,29
1746548817762,EDS 206R,B00,895695,Choi; Bailey Miyeon,16,0,30,14
1746548818790,EDS 250,A00,895697,Hemans; Patricia Ann Benitez,22,0,45,23
1746548819814,EDS 281,A00,895701,Meyerott; Theresa Ann,1,0,15,14
1746548820839,EDS 284,A00,895736,Meyerott; Theresa Ann,1,0,15,14
1746548821864,EDS 286,A00,897210,Fine; Sarah,0,0,15,15
1746548822893,EDS 289C,A01,895770,Daly; Alan J.,15,0,15,0
1746548823917,EDS 290,A00,897211,Hofstetter; Carolyn,0,0,15,15
1746548824943,LIGM 5A,A00,896162,Fischer-Grunski; Eva K,13,0,20,7
1746548825968,LIGM 5B,A00,896260,Fischer-Grunski; Eva K,17,0,20,3
1746548826993,LIGM 5C,A00,896308,Fischer-Grunski; Eva K,18,0,20,2
1746548828019,LIIT 5AS,A00,896313,Carnelos; Chiara,18,0,20,2
1746548829043,LIIT 5BS,A00,896416,Carnelos; Chiara,20,0,20,0
1746548830073,LIIT 5CS,A00,896564,Carnelos; Chiara,20,0,20,0
1746548831102,LISP 5A,A00,896588,Munoz Sanchez; Alicia,3,0,20,17
1746548832126,LISP 5B,A00,896653,Munoz Sanchez; Alicia,7,0,20,13
1746548833153,LISP 5C,A00,896655,Munoz Sanchez; Alicia,0,1,20,20
1746548834181,MAE 197,001,957918,Kleissl; Jan,9996,0,9999,3
1746548834181,MAE 197,002,959806,Boechler; Nicholas Sebastia,9998,0,9999,1
1746548834181,MAE 197,003,959852,Mullin; Jennifer S,9998,0,9999,1
1746548835209,MATH 2,A01,957937,Staff,33,0,35,2
1746548836232,MATH 197,001,957876,Kedlaya; Kiran S.,9993,0,9999,6
1746548837258,MCWP 40,A00,892729,Duru; Nur,10,0,20,10
1746548837258,MCWP 40,B00,893304,Montejo; Carolina,14,0,20,6
1746548838285,MCWP 40R,A00,893757,Redela; Pamela Morgan,0,5,20,20
1746548839310,MCWP 50,A00,893758,Morshed; Michael James,0,0,20,20
1746548839310,MCWP 50,B00,893761,Bartulis; Jason Michael,17,0,20,3
1746548840337,MCWP 50R,A00,893766,Compas; Sean Matthew,0,1,20,20
1746548840337,MCWP 50R,B00,893769,Carter; Jennifer A,0,1,20,20
1746548840337,MCWP 50R,C00,893771,Krone; Jarret,0,3,20,20
1746548840337,MCWP 50R,D00,893772,Miller; Elizabeth Deen,0,0,20,20
1746548840337,MCWP 50R,E00,893775,Carter; Andrea L,0,1,20,20
1746548841364,MMW 11R,A01,892721,Herbst; Matthew,11,0,27,16
1746548841364,MMW 11R,A02,892722,Herbst; Matthew,0,0,0,3
1746548842399,MMW 12R,A01,892724,Herbst; Matthew,0,11,16,16
1746548842399,MMW 12R,A02,892725,Herbst; Matthew,0,10,16,16
1746548843426,MMW 13R,A01,892727,Staff,0,4,16,16
1746548843426,MMW 13R,A02,892728,Staff,0,4,16,16
1746548843426,MMW 13R,A03,958032,Staff,0,4,16,16
1746548843426,MMW 13R,A04,958033,Staff,0,4,16,16
1746548843426,MMW 13R,A05,958034,Staff,0,4,16,16
1746548844454,SIO 295LS,A00,894015,Staff,5,0,25,20
1746548845477,SIO 295S,A00,894020,Staff,5,0,25,20
1746548846502,SIOC 290S,B01,958918,Merrifield; Mark A,14,0,30,16
1746548847526,SIOC 291S,B01,958922,Gabriel; Corey John,14,0,30,16
1746548848550,SOCI 117,A01,895339,Staff,3,0,5,2
1746548849578,WES 237B,A00,894149,Staff,11,0,20,9
1746548851642,AESE 279B,A00,891859,Staff,13,0,35,22
1746548852670,AIP 197,001,891854,Vespa; Emanuel Ignacio,9999,0,9999,0
1746548853695,ANTH 289S,A00,891856,Gagneux; Pascal,12,0,12,0
1746548854722,BENG 196,001,957946,Engler; Adam J.,9996,0,9999,3
1746548855747,BISP 197,001,959851,Wilhelm; James E.,9998,0,9999,1
1746548856774,CAT 124RS,A01,956906,Staff,6,0,25,19
1746548857801,CAT 125RS,A01,922013,Staff,6,0,25,19
1746548858830,CLRE 250,A00,891860,Morris; Sheldon,9995,0,9999,4
1746548860894,CLRE 251R,A00,907817,Mehta; Ravindra L.,9994,0,9999,5
1746548861923,CLRE 252,A00,891864,Cuomo; Raphael Eduardo,9993,0,9999,6
1746548862950,CLRE 253,A00,891867,Vaida; Florin,9994,0,9999,5
1746548862950,CLRE 253,B00,907819,Staff,9999,0,9999,0
1746548863975,CLRE 259,A00,891868,Patel; Hemal,9998,0,9999,1
1746548865000,CLRE 260,A00,891872,Cuomo; Raphael Eduardo,9999,0,9999,0
1746548866027,CLRE 297,001,891888,Cuomo; Raphael Eduardo,9999,0,9999,0
1746548867054,CSE 191,A00,958773,Minnes Kemp; Mor Mia,9996,0,9999,3
1746548868078,CSE 197,001,959846,Minnes Kemp; Mor Mia,9990,0,9999,9
1746548869107,CSS 201S,A01,892054,Mignozzetti; Umberto,26,0,30,4
1746548870135,CSS 202S,A01,892056,Mignozzetti; Umberto,26,0,30,4
1746548871159,DSC 197,001,956898,Eldridge; Justin Matthew,9998,0,9999,1
1746548872183,DSC 297,001,958000,Mazumdar; Arya,9998,0,9999,1
1746548872183,DSC 297,002,959862,Wang; Yusu,9999,0,9999,0
1746548873209,EAP 100,A00,905686,Staff,9778,0,9999,221
1746548874238,ECE 45,A01,892618,Staff,0,0,65,65
1746548876290,ECE 111,A01,892719,Staff,4,0,65,61
1746548877317,ECE 197,001,957920,Mercier; Patrick Philip,9991,0,9999,8
1746548878342,ECON 178,A01,907814,Zhu; Ying,26,0,35,9
1746548879368,EDS 115,A00,895312,Staff,36,0,45,9
1746548880394,EDS 117,A01,895337,Staff,24,0,30,6
1746548881421,EDS 125,A00,895341,Jones; Gabrielle Anastasia,37,0,45,8
1746548882448,EDS 128A,A01,895459,Fargason; Sharon Gayle,44,0,45,1
1746548883473,EDS 128B,A01,895543,Pappas; Elizabeth,44,0,45,1
1746548884499,EDS 139,A00,897203,Pappas; Elizabeth,44,0,45,1
1746548884499,EDS 139,B00,897209,Fargason; Sharon Gayle,41,0,45,4
1746548885523,EDS 201,A00,895545,Staff,22,0,45,23
1746548886553,EDS 203,A01,895581,Halter; Christopher P.,22,0,45,23
1746548887581,EDS 204R,A01,895625,Heinzman; Erica M.,39,0,45,6
1746548887581,EDS 204R,B01,895693,Halter; Christopher P.,10,0,45,35
1746548888607,EDS 206R,A00,895694,Fargason; Sharon Gayle,1,0,30,29
1746548888607,EDS 206R,B00,895695,Choi; Bailey Miyeon,16,0,30,14
1746548889635,EDS 250,A00,895697,Hemans; Patricia Ann Benitez,22,0,45,23
1746548890660,EDS 281,A00,895701,Meyerott; Theresa Ann,1,0,15,14
1746548891687,EDS 284,A00,895736,Meyerott; Theresa Ann,1,0,15,14
1746548892710,EDS 286,A00,897210,Fine; Sarah,0,0,15,15
1746548893734,EDS 289C,A01,895770,Daly; Alan J.,15,0,15,0
1746548894761,EDS 290,A00,897211,Hofstetter; Carolyn,0,0,15,15
1746548895791,LIGM 5A,A00,896162,Fischer-Grunski; Eva K,13,0,20,7
1746548896819,LIGM 5B,A00,896260,Fischer-Grunski; Eva K,17,0,20,3
1746548897843,LIGM 5C,A00,896308,Fischer-Grunski; Eva K,18,0,20,2
1746548898867,LIIT 5AS,A00,896313,Carnelos; Chiara,18,0,20,2
1746548899893,LIIT 5BS,A00,896416,Carnelos; Chiara,20,0,20,0
1746548900918,LIIT 5CS,A00,896564,Carnelos; Chiara,20,0,20,0
1746548901945,LISP 5A,A00,896588,Munoz Sanchez; Alicia,3,0,20,17
1746548902971,LISP 5B,A00,896653,Munoz Sanchez; Alicia,7,0,20,13
1746548903994,LISP 5C,A00,896655,Munoz Sanchez; Alicia,0,1,20,20
1746548905023,MAE 197,001,957918,Kleissl; Jan,9996,0,9999,3
1746548905023,MAE 197,002,959806,Boechler; Nicholas Sebastia,9998,0,9999,1
1746548905023,MAE 197,003,959852,Mullin; Jennifer S,9998,0,9999,1
1746548906047,MATH 2,A01,957937,Staff,33,0,35,2
1746548907073,MATH 197,001,957876,Kedlaya; Kiran S.,9993,0,9999,6
1746548908097,MCWP 40,A00,892729,Duru; Nur,10,0,20,10
1746548908097,MCWP 40,B00,893304,Montejo; Carolina,14,0,20,6
1746548909123,MCWP 40R,A00,893757,Redela; Pamela Morgan,0,5,20,20
1746548910149,MCWP 50,A00,893758,Morshed; Michael James,0,0,20,20
1746548910149,MCWP 50,B00,893761,Bartulis; Jason Michael,17,0,20,3
1746548911175,MCWP 50R,A00,893766,Compas; Sean Matthew,0,1,20,20
1746548911175,MCWP 50R,B00,893769,Carter; Jennifer A,0,1,20,20
1746548911175,MCWP 50R,C00,893771,Krone; Jarret,0,3,20,20
1746548911175,MCWP 50R,D00,893772,Miller; Elizabeth Deen,0,0,20,20
1746548911175,MCWP 50R,E00,893775,Carter; Andrea L,0,1,20,20
1746548912205,MMW 11R,A01,892721,Herbst; Matthew,11,0,27,16
1746548912205,MMW 11R,A02,892722,Herbst; Matthew,0,0,0,3
1746548913229,MMW 12R,A01,892724,Herbst; Matthew,0,11,16,16
1746548913229,MMW 12R,A02,892725,Herbst; Matthew,0,10,16,16
1746548914254,MMW 13R,A01,892727,Staff,0,4,16,16
1746548914254,MMW 13R,A02,892728,Staff,0,4,16,16
1746548914254,MMW 13R,A03,958032,Staff,0,4,16,16
1746548914254,MMW 13R,A04,958033,Staff,0,4,16,16
1746548914254,MMW 13R,A05,958034,Staff,0,4,16,16
1746548915281,SIO 295LS,A00,894015,Staff,5,0,25,20
1746548916308,SIO 295S,A00,894020,Staff,5,0,25,20
1746548917333,SIOC 290S,B01,958918,Merrifield; Mark A,14,0,30,16
1746548918359,SIOC 291S,B01,958922,Gabriel; Corey John,14,0,30,16
1746548919384,SOCI 117,A01,895339,Staff,3,0,5,2
1746548920413,WES 237B,A00,894149,Staff,11,0,20,9
1746548922479,AESE 279B,A00,891859,Staff,13,0,35,22
1746548923507,AIP 197,001,891854,Vespa; Emanuel Ignacio,9999,0,9999,0
1746548924531,ANTH 289S,A00,891856,Gagneux; Pascal,12,0,12,0
1746548925556,BENG 196,001,957946,Engler; Adam J.,9996,0,9999,3
1746548926581,BISP 197,001,959851,Wilhelm; James E.,9998,0,9999,1
1746548927617,CAT 124RS,A01,956906,Staff,6,0,25,19
1746548928643,CAT 125RS,A01,922013,Staff,6,0,25,19
1746548929668,CLRE 250,A00,891860,Morris; Sheldon,9995,0,9999,4
1746548931725,CLRE 251R,A00,907817,Mehta; Ravindra L.,9994,0,9999,5
1746548932750,CLRE 252,A00,891864,Cuomo; Raphael Eduardo,9993,0,9999,6
1746548933774,CLRE 253,A00,891867,Vaida; Florin,9994,0,9999,5
1746548933774,CLRE 253,B00,907819,Staff,9999,0,9999,0
1746548934799,CLRE 259,A00,891868,Patel; Hemal,9998,0,9999,1
1746548935826,CLRE 260,A00,891872,Cuomo; Raphael Eduardo,9999,0,9999,0
1746548936855,CLRE 297,001,891888,Cuomo; Raphael Eduardo,9999,0,9999,0
1746548937879,CSE 191,A00,958773,Minnes Kemp; Mor Mia,9996,0,9999,3
1746548938906,CSE 197,001,959846,Minnes Kemp; Mor Mia,9990,0,9999,9
1746548939935,CSS 201S,A01,892054,Mignozzetti; Umberto,26,0,30,4
1746548940959,CSS 202S,A01,892056,Mignozzetti; Umberto,26,0,30,4
1746548941983,DSC 197,001,956898,Eldridge; Justin Matthew,9998,0,9999,1
1746548943010,DSC 297,001,958000,Mazumdar; Arya,9998,0,9999,1
1746548943010,DSC 297,002,959862,Wang; Yusu,9999,0,9999,0
1746548944035,EAP 100,A00,905686,Staff,9778,0,9999,221
1746548945063,ECE 45,A01,892618,Staff,0,0,65,65
1746548947117,ECE 111,A01,892719,Staff,4,0,65,61
1746548948140,ECE 197,001,957920,Mercier; Patrick Philip,9991,0,9999,8
1746548949170,ECON 178,A01,907814,Zhu; Ying,26,0,35,9
1746548950193,EDS 115,A00,895312,Staff,36,0,45,9
1746548951218,EDS 117,A01,895337,Staff,24,0,30,6
1746548952243,EDS 125,A00,895341,Jones; Gabrielle Anastasia,37,0,45,8
1746548953268,EDS 128A,A01,895459,Fargason; Sharon Gayle,44,0,45,1
1746548954296,EDS 128B,A01,895543,Pappas; Elizabeth,44,0,45,1
1746548955321,EDS 139,A00,897203,Pappas; Elizabeth,44,0,45,1
1746548955321,EDS 139,B00,897209,Fargason; Sharon Gayle,41,0,45,4
1746548956351,EDS 201,A00,895545,Staff,22,0,45,23
1746548957377,EDS 203,A01,895581,Halter; Christopher P.,22,0,45,23
1746548958400,EDS 204R,A01,895625,Heinzman; Erica M.,39,0,45,6
1746548958400,EDS 204R,B01,895693,Halter; Christopher P.,10,0,45,35
1746548959426,EDS 206R,A00,895694,Fargason; Sharon Gayle,1,0,30,29
1746548959426,EDS 206R,B00,895695,Choi; Bailey Miyeon,16,0,30,14
1746548960453,EDS 250,A00,895697,Hemans; Patricia Ann Benitez,22,0,45,23
1746548961479,EDS 281,A00,895701,Meyerott; Theresa Ann,1,0,15,14
1746548962504,EDS 284,A00,895736,Meyerott; Theresa Ann,1,0,15,14
1746548963530,EDS 286,A00,897210,Fine; Sarah,0,0,15,15
1746548964558,EDS 289C,A01,895770,Daly; Alan J.,15,0,15,0
1746548965582,EDS 290,A00,897211,Hofstetter; Carolyn,0,0,15,15
1746548966606,LIGM 5A,A00,896162,Fischer-Grunski; Eva K,13,0,20,7
1746548967630,LIGM 5B,A00,896260,Fischer-Grunski; Eva K,17,0,20,3
1746548968655,LIGM 5C,A00,896308,Fischer-Grunski; Eva K,18,0,20,2
1746548969681,LIIT 5AS,A00,896313,Carnelos; Chiara,18,0,20,2
1746548970708,LIIT 5BS,A00,896416,Carnelos; Chiara,20,0,20,0
1746548971733,LIIT 5CS,A00,896564,Carnelos; Chiara,20,0,20,0
1746548972758,LISP 5A,A00,896588,Munoz Sanchez; Alicia,3,0,20,17
1746548973785,LISP 5B,A00,896653,Munoz Sanchez; Alicia,7,0,20,13
1746548974808,LISP 5C,A00,896655,Munoz Sanchez; Alicia,0,1,20,20
1746548975837,MAE 197,001,957918,Kleissl; Jan,9996,0,9999,3
1746548975837,MAE 197,002,959806,Boechler; Nicholas Sebastia,9998,0,9999,1
1746548975837,MAE 197,003,959852,Mullin; Jennifer S,9998,0,9999,1
1746548976863,MATH 2,A01,957937,Staff,33,0,35,2
1746548977888,MATH 197,001,957876,Kedlaya; Kiran S.,9993,0,9999,6
1746548978916,MCWP 40,A00,892729,Duru; Nur,10,0,20,10
1746548978916,MCWP 40,B00,893304,Montejo; Carolina,14,0,20,6
1746548979941,MCWP 40R,A00,893757,Redela; Pamela Morgan,0,5,20,20
1746548980970,MCWP 50,A00,893758,Morshed; Michael James,0,0,20,20
1746548980970,MCWP 50,B00,893761,Bartulis; Jason Michael,17,0,20,3
1746548981998,MCWP 50R,A00,893766,Compas; Sean Matthew,0,1,20,20
1746548981998,MCWP 50R,B00,893769,Carter; Jennifer A,0,1,20,20
1746548981998,MCWP 50R,C00,893771,Krone; Jarret,0,3,20,20
1746548981998,MCWP 50R,D00,893772,Miller; Elizabeth Deen,0,0,20,20
1746548981998,MCWP 50R,E00,893775,Carter; Andrea L,0,1,20,20
1746548983023,MMW 11R,A01,892721,Herbst; Matthew,11,0,27,16
1746548983023,MMW 11R,A02,892722,Herbst; Matthew,0,0,0,3
1746548984047,MMW 12R,A01,892724,Herbst; Matthew,0,11,16,16
1746548984047,MMW 12R,A02,892725,Herbst; Matthew,0,10,16,16
1746548985073,MMW 13R,A01,892727,Staff,0,4,16,16
1746548985073,MMW 13R,A02,892728,Staff,0,4,16,16
1746548985073,MMW 13R,A03,958032,Staff,0,4,16,16
1746548985073,MMW 13R,A04,958033,Staff,0,4,16,16
1746548985073,MMW 13R,A05,958034,Staff,0,4,16,16
1746548986103,SIO 295LS,A00,894015,Staff,5,0,25,20
1746548987129,SIO 295S,A00,894020,Staff,5,0,25,20
1746548988159,SIOC 290S,B01,958918,Merrifield; Mark A,14,0,30,16
1746548989185,SIOC 291S,B01,958922,Gabriel; Corey John,14,0,30,16
1746548990211,SOCI 117,A01,895339,Staff,3,0,5,2
1746548991235,WES 237B,A00,894149,Staff,11,0,20,9
1746548993307,AESE 279B,A00,891859,Staff,13,0,35,22
1746548994334,AIP 197,001,891854,Vespa; Emanuel Ignacio,9999,0,9999,0
1746548995362,ANTH 289S,A00,891856,Gagneux; Pascal,12,0,12,0
1746548996388,BENG 196,001,957946,Engler; Adam J.,9996,0,9999,3
1746548997414,BISP 197,001,959851,Wilhelm; James E.,9998,0,9999,1
1746548998439,CAT 124RS,A01,956906,Staff,6,0,25,19
1746548999465,CAT 125RS,A01,922013,Staff,6,0,25,19
1746549000491,CLRE 250,A00,891860,Morris; Sheldon,9995,0,9999,4
1746549002545,CLRE 251R,A00,907817,Mehta; Ravindra L.,9994,0,9999,5
1746549003572,CLRE 252,A00,891864,Cuomo; Raphael Eduardo,9993,0,9999,6
1746549004599,CLRE 253,A00,891867,Vaida; Florin,9994,0,9999,5
1746549004599,CLRE 253,B00,907819,Staff,9999,0,9999,0
1746549005624,CLRE 259,A00,891868,Patel; Hemal,9998,0,9999,1
1746549006650,CLRE 260,A00,891872,Cuomo; Raphael Eduardo,9999,0,9999,0
1746549007678,CLRE 297,001,891888,Cuomo; Raphael Eduardo,9999,0,9999,0
1746549008704,CSE 191,A00,958773,Minnes Kemp; Mor Mia,9996,0,9999,3
1746549009731,CSE 197,001,959846,Minnes Kemp; Mor Mia,9990,0,9999,9
1746549010761,CSS 201S,A01,892054,Mignozzetti; Umberto,26,0,30,4
1746549011788,CSS 202S,A01,892056,Mignozzetti; Umberto,26,0,30,4
1746549012812,DSC 197,001,956898,Eldridge; Justin Matthew,9998,0,9999,1
1746549013840,DSC 297,001,958000,Mazumdar; Arya,9998,0,9999,1
1746549013840,DSC 297,002,959862,Wang; Yusu,9999,0,9999,0
1746549014864,EAP 100,A00,905686,Staff,9778,0,9999,221
1746549015891,ECE 45,A01,892618,Staff,0,0,65,65
1746549017943,ECE 111,A01,892719,Staff,4,0,65,61
1746549018970,ECE 197,001,957920,Mercier; Patrick Philip,9991,0,9999,8
1746549020003,ECON 178,A01,907814,Zhu; Ying,26,0,35,9
1746549021031,EDS 115,A00,895312,Staff,36,0,45,9
1746549022058,EDS 117,A01,895337,Staff,24,0,30,6
1746549023085,EDS 125,A00,895341,Jones; Gabrielle Anastasia,37,0,45,8
1746549024113,EDS 128A,A01,895459,Fargason; Sharon Gayle,44,0,45,1
1746549025142,EDS 128B,A01,895543,Pappas; Elizabeth,44,0,45,1
1746549026168,EDS 139,A00,897203,Pappas; Elizabeth,44,0,45,1
1746549026168,EDS 139,B00,897209,Fargason; Sharon Gayle,41,0,45,4
1746549027193,EDS 201,A00,895545,Staff,22,0,45,23
1746549028220,EDS 203,A01,895581,Halter; Christopher P.,22,0,45,23
1746549029246,EDS 204R,A01,895625,Heinzman; Erica M.,39,0,45,6
1746549029246,EDS 204R,B01,895693,Halter; Christopher P.,10,0,45,35
1746549030273,EDS 206R,A00,895694,Fargason; Sharon Gayle,1,0,30,29
1746549030273,EDS 206R,B00,895695,Choi; Bailey Miyeon,16,0,30,14
1746549031299,EDS 250,A00,895697,Hemans; Patricia Ann Benitez,22,0,45,23
1746549032328,EDS 281,A00,895701,Meyerott; Theresa Ann,1,0,15,14
1746549033355,EDS 284,A00,895736,Meyerott; Theresa Ann,1,0,15,14
1746549034380,EDS 286,A00,897210,Fine; Sarah,0,0,15,15
1746549035406,EDS 289C,A01,895770,Daly; Alan J.,15,0,15,0
1746549036436,EDS 290,A00,897211,Hofstetter; Carolyn,0,0,15,15
1746549037462,LIGM 5A,A00,896162,Fischer-Grunski; Eva K,13,0,20,7
1746549038488,LIGM 5B,A00,896260,Fischer-Grunski; Eva K,17,0,20,3
1746549039516,LIGM 5C,A00,896308,Fischer-Grunski; Eva K,18,0,20,2
1746549040545,LIIT 5AS,A00,896313,Carnelos; Chiara,18,0,20,2
1746549041574,LIIT 5BS,A00,896416,Carnelos; Chiara,20,0,20,0
1746549042602,LIIT 5CS,A00,896564,Carnelos; Chiara,20,0,20,0
1746549043628,LISP 5A,A00,896588,Munoz Sanchez; Alicia,3,0,20,17
1746549044656,LISP 5B,A00,896653,Munoz Sanchez; Alicia,7,0,20,13
1746549045682,LISP 5C,A00,896655,Munoz Sanchez; Alicia,0,1,20,20
1746549046708,MAE 197,001,957918,Kleissl; Jan,9996,0,9999,3
1746549046708,MAE 197,002,959806,Boechler; Nicholas Sebastia,9998,0,9999,1
1746549046708,MAE 197,003,959852,Mullin; Jennifer S,9998,0,9999,1
1746549047734,MATH 2,A01,957937,Staff,33,0,35,2
1746549048759,MATH 197,001,957876,Kedlaya; Kiran S.,9993,0,9999,6
1746549049784,MCWP 40,A00,892729,Duru; Nur,10,0,20,10
1746549049784,MCWP 40,B00,893304,Montejo; Carolina,14,0,20,6
1746549050809,MCWP 40R,A00,893757,Redela; Pamela Morgan,0,5,20,20
1746549051836,MCWP 50,A00,893758,Morshed; Michael James,0,0,20,20
1746549051836,MCWP 50,B00,893761,Bartulis; Jason Michael,17,0,20,3
1746549052867,MCWP 50R,A00,893766,Compas; Sean Matthew,0,1,20,20
1746549052867,MCWP 50R,B00,893769,Carter; Jennifer A,0,1,20,20
1746549052867,MCWP 50R,C00,893771,Krone; Jarret,0,3,20,20
1746549052867,MCWP 50R,D00,893772,Miller; Elizabeth Deen,0,0,20,20
1746549052867,MCWP 50R,E00,893775,Carter; Andrea L,0,1,20,20
1746549053891,MMW 11R,A01,892721,Herbst; Matthew,11,0,27,16
1746549053891,MMW 11R,A02,892722,Herbst; Matthew,0,0,0,3
1746549054916,MMW 12R,A01,892724,Herbst; Matthew,0,11,16,16
1746549054916,MMW 12R,A02,892725,Herbst; Matthew,0,10,16,16
1746549055941,MMW 13R,A01,892727,Staff,0,4,16,16
1746549055941,MMW 13R,A02,892728,Staff,0,4,16,16
1746549055941,MMW 13R,A03,958032,Staff,0,4,16,16
1746549055941,MMW 13R,A04,958033,Staff,0,4,16,16
1746549055941,MMW 13R,A05,958034,Staff,0,4,16,16
1746549056967,SIO 295LS,A00,894015,Staff,5,0,25,20
1746549057995,SIO 295S,A00,894020,Staff,5,0,25,20
1746549059023,SIOC 290S,B01,958918,Merrifield; Mark A,14,0,30,16
1746549060048,SIOC 291S,B01,958922,Gabriel; Corey John,14,0,30,16
1746549061072,SOCI 117,A01,895339,Staff,3,0,5,2
1746549062099,WES 237B,A00,894149,Staff,11,0,20,9
1746549064154,AESE 279B,A00,891859,Staff,13,0,35,22
1746549065183,AIP 197,001,891854,Vespa; Emanuel Ignacio,9999,0,9999,0
1746549066208,ANTH 289S,A00,891856,Gagneux; Pascal,12,0,12,0
1746549067233,BENG 196,001,957946,Engler; Adam J.,9996,0,9999,3
1746549068262,BISP 197,001,959851,Wilhelm; James E.,9998,0,9999,1
1746549069290,CAT 124RS,A01,956906,Staff,6,0,25,19
1746549070317,CAT 125RS,A01,922013,Staff,6,0,25,19
1746549071344,CLRE 250,A00,891860,Morris; Sheldon,9995,0,9999,4
1746549073400,CLRE 251R,A00,907817,Mehta; Ravindra L.,9994,0,9999,5
1746549074430,CLRE 252,A00,891864,Cuomo; Raphael Eduardo,9993,0,9999,6
1746549075457,CLRE 253,A00,891867,Vaida; Florin,9994,0,9999,5
1746549075457,CLRE 253,B00,907819,Staff,9999,0,9999,0
1746549076484,CLRE 259,A00,891868,Patel; Hemal,9998,0,9999,1
1746549077510,CLRE 260,A00,891872,Cuomo; Raphael Eduardo,9999,0,9999,0
1746549078534,CLRE 297,001,891888,Cuomo; Raphael Eduardo,9999,0,9999,0
1746549079559,CSE 191,A00,958773,Minnes Kemp; Mor Mia,9996,0,9999,3
1746549080584,CSE 197,001,959846,Minnes Kemp; Mor Mia,9990,0,9999,9
1746549081610,CSS 201S,A01,892054,Mignozzetti; Umberto,26,0,30,4
1746549082634,CSS 202S,A01,892056,Mignozzetti; Umberto,26,0,30,4
1746549083698,DSC 197,001,956898,Eldridge; Justin Matthew,9998,0,9999,1
1746549084722,DSC 297,001,958000,Mazumdar; Arya,9998,0,9999,1
1746549084722,DSC 297,002,959862,Wang; Yusu,9999,0,9999,0
1746549085748,EAP 100,A00,905686,Staff,9778,0,9999,221
1746549086773,ECE 45,A01,892618,Staff,0,0,65,65
1746549088824,ECE 111,A01,892719,Staff,4,0,65,61
1746549089852,ECE 197,001,957920,Mercier; Patrick Philip,9991,0,9999,8
1746549090877,ECON 178,A01,907814,Zhu; Ying,26,0,35,9
1746549091906,EDS 115,A00,895312,Staff,36,0,45,9
1746549092931,EDS 117,A01,895337,Staff,24,0,30,6
1746549093956,EDS 125,A00,895341,Jones; Gabrielle Anastasia,37,0,45,8
1746549094982,EDS 128A,A01,895459,Fargason; Sharon Gayle,44,0,45,1
1746549096006,EDS 128B,A01,895543,Pappas; Elizabeth,44,0,45,1
1746549097031,EDS 139,A00,897203,Pappas; Elizabeth,44,0,45,1
1746549097031,EDS 139,B00,897209,Fargason; Sharon Gayle,41,0,45,4
1746549098060,EDS 201,A00,895545,Staff,22,0,45,23
1746549099089,EDS 203,A01,895581,Halter; Christopher P.,22,0,45,23
1746549100113,EDS 204R,A01,895625,Heinzman; Erica M.,39,0,45,6
1746549100113,EDS 204R,B01,895693,Halter; Christopher P.,10,0,45,35
1746549101137,EDS 206R,A00,895694,Fargason; Sharon Gayle,1,0,30,29
1746549101137,EDS 206R,B00,895695,Choi; Bailey Miyeon,16,0,30,14
1746549102163,EDS 250,A00,895697,Hemans; Patricia Ann Benitez,22,0,45,23
1746549103190,EDS 281,A00,895701,Meyerott; Theresa Ann,1,0,15,14
1746549104217,EDS 284,A00,895736,Meyerott; Theresa Ann,1,0,15,14
1746549105243,EDS 286,A00,897210,Fine; Sarah,0,0,15,15
1746549106269,EDS 289C,A01,895770,Daly; Alan J.,15,0,15,0
1746549107295,EDS 290,A00,897211,Hofstetter; Carolyn,0,0,15,15
1746549108324,LIGM 5A,A00,896162,Fischer-Grunski; Eva K,13,0,20,7
1746549109352,LIGM 5B,A00,896260,Fischer-Grunski; Eva K,17,0,20,3
1746549110376,LIGM 5C,A00,896308,Fischer-Grunski; Eva K,18,0,20,2
1746549111405,LIIT 5AS,A00,896313,Carnelos; Chiara,18,0,20,2
1746549112434,LIIT 5BS,A00,896416,Carnelos; Chiara,20,0,20,0
1746549113462,LIIT 5CS,A00,896564,Carnelos; Chiara,20,0,20,0
1746549114486,LISP 5A,A00,896588,Munoz Sanchez; Alicia,3,0,20,17
1746549115533,LISP 5B,A00,896653,Munoz Sanchez; Alicia,7,0,20,13
1746549116563,LISP 5C,A00,896655,Munoz Sanchez; Alicia,0,1,20,20
1746549117588,MAE 197,001,957918,Kleissl; Jan,9996,0,9999,3
1746549117588,MAE 197,002,959806,Boechler; Nicholas Sebastia,9998,0,9999,1
1746549117588,MAE 197,003,959852,Mullin; Jennifer S,9998,0,9999,1
1746549118614,MATH 2,A01,957937,Staff,33,0,35,2
1746549119641,MATH 197,001,957876,Kedlaya; Kiran S.,9993,0,9999,6
1746549120667,MCWP 40,A00,892729,Duru; Nur,10,0,20,10
1746549120667,MCWP 40,B00,893304,Montejo; Carolina,14,0,20,6
1746549121697,MCWP 40R,A00,893757,Redela; Pamela Morgan,0,5,20,20
1746549122725,MCWP 50,A00,893758,Morshed; Michael James,0,0,20,20
1746549122725,MCWP 50,B00,893761,Bartulis; Jason Michael,17,0,20,3
1746549123751,MCWP 50R,A00,893766,Compas; Sean Matthew,0,1,20,20
1746549123751,MCWP 50R,B00,893769,Carter; Jennifer A,0,1,20,20
1746549123751,MCWP 50R,C00,893771,Krone; Jarret,0,3,20,20
1746549123751,MCWP 50R,D00,893772,Miller; Elizabeth Deen,0,0,20,20
1746549123751,MCWP 50R,E00,893775,Carter; Andrea L,0,1,20,20
1746549124780,MMW 11R,A01,892721,Herbst; Matthew,11,0,27,16
1746549124780,MMW 11R,A02,892722,Herbst; Matthew,0,0,0,3
1746549125805,MMW 12R,A01,892724,Herbst; Matthew,0,11,16,16
1746549125805,MMW 12R,A02,892725,Herbst; Matthew,0,10,16,16
1746549126833,MMW 13R,A01,892727,Staff,0,4,16,16
1746549126833,MMW 13R,A02,892728,Staff,0,4,16,16
1746549126833,MMW 13R,A03,958032,Staff,0,4,16,16
1746549126833,MMW 13R,A04,958033,Staff,0,4,16,16
1746549126833,MMW 13R,A05,958034,Staff,0,4,16,16
1746549127859,SIO 295LS,A00,894015,Staff,5,0,25,20
1746549128889,SIO 295S,A00,894020,Staff,5,0,25,20
1746549129914,SIOC 290S,B01,958918,Merrifield; Mark A,14,0,30,16
1746549130940,SIOC 291S,B01,958922,Gabriel; Corey John,14,0,30,16
1746549131967,SOCI 117,A01,895339,Staff,3,0,5,2
1746549132993,WES 237B,A00,894149,Staff,11,0,20,9
1746549135051,AESE 279B,A00,891859,Staff,13,0,35,22
1746549136078,AIP 197,001,891854,Vespa; Emanuel Ignacio,9999,0,9999,0
1746549137105,ANTH 289S,A00,891856,Gagneux; Pascal,12,0,12,0
1746549138132,BENG 196,001,957946,Engler; Adam J.,9996,0,9999,3
1746549139158,BISP 197,001,959851,Wilhelm; James E.,9998,0,9999,1
1746549140183,CAT 124RS,A01,956906,Staff,6,0,25,19
1746549141208,CAT 125RS,A01,922013,Staff,6,0,25,19
1746549142233,CLRE 250,A00,891860,Morris; Sheldon,9995,0,9999,4
1746549144287,CLRE 251R,A00,907817,Mehta; Ravindra L.,9994,0,9999,5
1746549145316,CLRE 252,A00,891864,Cuomo; Raphael Eduardo,9993,0,9999,6
1746549146345,CLRE 253,A00,891867,Vaida; Florin,9994,0,9999,5
1746549146345,CLRE 253,B00,907819,Staff,9999,0,9999,0
1746549147374,CLRE 259,A00,891868,Patel; Hemal,9998,0,9999,1
1746549148399,CLRE 260,A00,891872,Cuomo; Raphael Eduardo,9999,0,9999,0
1746549149425,CLRE 297,001,891888,Cuomo; Raphael Eduardo,9999,0,9999,0
1746549150453,CSE 191,A00,958773,Minnes Kemp; Mor Mia,9996,0,9999,3
1746549151479,CSE 197,001,959846,Minnes Kemp; Mor Mia,9990,0,9999,9
1746549152505,CSS 201S,A01,892054,Mignozzetti; Umberto,26,0,30,4
1746549153534,CSS 202S,A01,892056,Mignozzetti; Umberto,26,0,30,4
1746549154559,DSC 197,001,956898,Eldridge; Justin Matthew,9998,0,9999,1
1746549155584,DSC 297,001,958000,Mazumdar; Arya,9998,0,9999,1
1746549155584,DSC 297,002,959862,Wang; Yusu,9999,0,9999,0
1746549156608,EAP 100,A00,905686,Staff,9778,0,9999,221
1746549157637,ECE 45,A01,892618,Staff,0,0,65,65
1746549159690,ECE 111,A01,892719,Staff,4,0,65,61
1746549160716,ECE 197,001,957920,Mercier; Patrick Philip,9991,0,9999,8
1746549161743,ECON 178,A01,907814,Zhu; Ying,26,0,35,9
1746549162768,EDS 115,A00,895312,Staff,36,0,45,9
1746549163794,EDS 117,A01,895337,Staff,24,0,30,6
1746549164822,EDS 125,A00,895341,Jones; Gabrielle Anastasia,37,0,45,8
1746549165849,EDS 128A,A01,895459,Fargason; Sharon Gayle,44,0,45,1
1746549166876,EDS 128B,A01,895543,Pappas; Elizabeth,44,0,45,1
1746549167903,EDS 139,A00,897203,Pappas; Elizabeth,44,0,45,1
1746549167903,EDS 139,B00,897209,Fargason; Sharon Gayle,41,0,45,4
1746549168930,EDS 201,A00,895545,Staff,22,0,45,23
1746549169957,EDS 203,A01,895581,Halter; Christopher P.,22,0,45,23
1746549170983,EDS 204R,A01,895625,Heinzman; Erica M.,39,0,45,6
1746549170983,EDS 204R,B01,895693,Halter; Christopher P.,10,0,45,35
1746549172012,EDS 206R,A00,895694,Fargason; Sharon Gayle,1,0,30,29
1746549172012,EDS 206R,B00,895695,Choi; Bailey Miyeon,16,0,30,14
1746549173037,EDS 250,A00,895697,Hemans; Patricia Ann Benitez,22,0,45,23
1746549174065,EDS 281,A00,895701,Meyerott; Theresa Ann,1,0,15,14
1746549175089,EDS 284,A00,895736,Meyerott; Theresa Ann,1,0,15,14
1746549176117,EDS 286,A00,897210,Fine; Sarah,0,0,15,15
1746549177145,EDS 289C,A01,895770,Daly; Alan J.,15,0,15,0
1746549178170,EDS 290,A00,897211,Hofstetter; Carolyn,0,0,15,15
1746549179195,LIGM 5A,A00,896162,Fischer-Grunski; Eva K,13,0,20,7
1746549180225,LIGM 5B,A00,896260,Fischer-Grunski; Eva K,17,0,20,3
1746549181253,LIGM 5C,A00,896308,Fischer-Grunski; Eva K,18,0,20,2
1746549182278,LIIT 5AS,A00,896313,Carnelos; Chiara,18,0,20,2
1746549183306,LIIT 5BS,A00,896416,Carnelos; Chiara,20,0,20,0
1746549184329,LIIT 5CS,A00,896564,Carnelos; Chiara,20,0,20,0
1746549185355,LISP 5A,A00,896588,Munoz Sanchez; Alicia,3,0,20,17
1746549186381,LISP 5B,A00,896653,Munoz Sanchez; Alicia,7,0,20,13
1746549187406,LISP 5C,A00,896655,Munoz Sanchez; Alicia,0,1,20,20
1746549188430,MAE 197,001,957918,Kleissl; Jan,9996,0,9999,3
1746549188430,MAE 197,002,959806,Boechler; Nicholas Sebastia,9998,0,9999,1
1746549188430,MAE 197,003,959852,Mullin; Jennifer S,9998,0,9999,1
1746549189455,MATH 2,A01,957937,Staff,33,0,35,2
1746549190480,MATH 197,001,957876,Kedlaya; Kiran S.,9993,0,9999,6
1746549191505,MCWP 40,A00,892729,Duru; Nur,10,0,20,10
1746549191505,MCWP 40,B00,893304,Montejo; Carolina,14,0,20,6
1746549192531,MCWP 40R,A00,893757,Redela; Pamela Morgan,0,5,20,20
1746549193555,MCWP 50,A00,893758,Morshed; Michael James,0,0,20,20
1746549193555,MCWP 50,B00,893761,Bartulis; Jason Michael,17,0,20,3
1746549194585,MCWP 50R,A00,893766,Compas; Sean Matthew,0,1,20,20
1746549194585,MCWP 50R,B00,893769,Carter; Jennifer A,0,1,20,20
1746549194585,MCWP 50R,C00,893771,Krone; Jarret,0,3,20,20
1746549194585,MCWP 50R,D00,893772,Miller; Elizabeth Deen,0,0,20,20
1746549194585,MCWP 50R,E00,893775,Carter; Andrea L,0,1,20,20
1746549195610,MMW 11R,A01,892721,Herbst; Matthew,11,0,27,16
1746549195610,MMW 11R,A02,892722,Herbst; Matthew,0,0,0,3
1746549196638,MMW 12R,A01,892724,Herbst; Matthew,0,11,16,16
1746549196638,MMW 12R,A02,892725,Herbst; Matthew,0,10,16,16
1746549197663,MMW 13R,A01,892727,Staff,0,4,16,16
1746549197663,MMW 13R,A02,892728,Staff,0,4,16,16
1746549197663,MMW 13R,A03,958032,Staff,0,4,16,16
1746549197663,MMW 13R,A04,958033,Staff,0,4,16,16
1746549197663,MMW 13R,A05,958034,Staff,0,4,16,16
1746549198690,SIO 295LS,A00,894015,Staff,5,0,25,20
1746549199715,SIO 295S,A00,894020,Staff,5,0,25,20
1746549200740,SIOC 290S,B01,958918,Merrifield; Mark A,14,0,30,16
1746549201766,SIOC 291S,B01,958922,Gabriel; Corey John,14,0,30,16
1746549202794,SOCI 117,A01,895339,Staff,3,0,5,2
1746549203821,WES 237B,A00,894149,Staff,11,0,20,9
1746549205879,AESE 279B,A00,891859,Staff,13,0,35,22
1746549206906,AIP 197,001,891854,Vespa; Emanuel Ignacio,9999,0,9999,0
1746549207934,ANTH 289S,A00,891856,Gagneux; Pascal,12,0,12,0
1746549208960,BENG 196,001,957946,Engler; Adam J.,9996,0,9999,3
1746549209984,BISP 197,001,959851,Wilhelm; James E.,9998,0,9999,1
1746549211011,CAT 124RS,A01,956906,Staff,6,0,25,19
1746549212036,CAT 125RS,A01,922013,Staff,6,0,25,19
1746549213062,CLRE 250,A00,891860,Morris; Sheldon,9995,0,9999,4
1746549215111,CLRE 251R,A00,907817,Mehta; Ravindra L.,9994,0,9999,5
1746549216140,CLRE 252,A00,891864,Cuomo; Raphael Eduardo,9993,0,9999,6
1746549217169,CLRE 253,A00,891867,Vaida; Florin,9994,0,9999,5
1746549217169,CLRE 253,B00,907819,Staff,9999,0,9999,0
1746549218194,CLRE 259,A00,891868,Patel; Hemal,9998,0,9999,1
1746549219219,CLRE 260,A00,891872,Cuomo; Raphael Eduardo,9999,0,9999,0
1746549220246,CLRE 297,001,891888,Cuomo; Raphael Eduardo,9999,0,9999,0
1746549221272,CSE 191,A00,958773,Minnes Kemp; Mor Mia,9996,0,9999,3
1746549222295,CSE 197,001,959846,Minnes Kemp; Mor Mia,9990,0,9999,9
1746549223323,CSS 201S,A01,892054,Mignozzetti; Umberto,26,0,30,4
1746549224349,CSS 202S,A01,892056,Mignozzetti; Umberto,26,0,30,4
1746549225376,DSC 197,001,956898,Eldridge; Justin Matthew,9998,0,9999,1
1746549226400,DSC 297,001,958000,Mazumdar; Arya,9998,0,9999,1
1746549226400,DSC 297,002,959862,Wang; Yusu,9999,0,9999,0
1746549227425,EAP 100,A00,905686,Staff,9778,0,9999,221
1746549228450,ECE 45,A01,892618,Staff,0,0,65,65
1746549230501,ECE 111,A01,892719,Staff,4,0,65,61
1746549231525,ECE 197,001,957920,Mercier; Patrick Philip,9991,0,9999,8
1746549232551,ECON 178,A01,907814,Zhu; Ying,26,0,35,9
1746549233579,EDS 115,A00,895312,Staff,36,0,45,9
1746549234606,EDS 117,A01,895337,Staff,24,0,30,6
1746549235634,EDS 125,A00,895341,Jones; Gabrielle Anastasia,37,0,45,8
1746549236662,EDS 128A,A01,895459,Fargason; Sharon Gayle,44,0,45,1
1746549237687,EDS 128B,A01,895543,Pappas; Elizabeth,44,0,45,1
1746549238712,EDS 139,A00,897203,Pappas; Elizabeth,44,0,45,1
1746549238712,EDS 139,B00,897209,Fargason; Sharon Gayle,41,0,45,4
1746549239739,EDS 201,A00,895545,Staff,22,0,45,23
1746549240767,EDS 203,A01,895581,Halter; Christopher P.,22,0,45,23
1746549241791,EDS 204R,A01,895625,Heinzman; Erica M.,39,0,45,6
1746549241791,EDS 204R,B01,895693,Halter; Christopher P.,10,0,45,35
1746549242820,EDS 206R,A00,895694,Fargason; Sharon Gayle,1,0,30,29
1746549242820,EDS 206R,B00,895695,Choi; Bailey Miyeon,16,0,30,14
1746549243853,EDS 250,A00,895697,Hemans; Patricia Ann Benitez,22,0,45,23
1746549244877,EDS 281,A00,895701,Meyerott; Theresa Ann,1,0,15,14
1746549245902,EDS 284,A00,895736,Meyerott; Theresa Ann,1,0,15,14
1746549246929,EDS 286,A00,897210,Fine; Sarah,0,0,15,15
1746549247954,EDS 289C,A01,895770,Daly; Alan J.,15,0,15,0
1746549248978,EDS 290,A00,897211,Hofstetter; Carolyn,0,0,15,15
1746549250007,LIGM 5A,A00,896162,Fischer-Grunski; Eva K,13,0,20,7
1746549251031,LIGM 5B,A00,896260,Fischer-Grunski; Eva K,17,0,20,3
1746549252057,LIGM 5C,A00,896308,Fischer-Grunski; Eva K,18,0,20,2
1746549253084,LIIT 5AS,A00,896313,Carnelos; Chiara,18,0,20,2
1746549254110,LIIT 5BS,A00,896416,Carnelos; Chiara,20,0,20,0
1746549255136,LIIT 5CS,A00,896564,Carnelos; Chiara,20,0,20,0
1746549256164,LISP 5A,A00,896588,Munoz Sanchez; Alicia,3,0,20,17
1746549257194,LISP 5B,A00,896653,Munoz Sanchez; Alicia,7,0,20,13
1746549258219,LISP 5C,A00,896655,Munoz Sanchez; Alicia,0,1,20,20
1746549259245,MAE 197,001,957918,Kleissl; Jan,9996,0,9999,3
1746549259245,MAE 197,002,959806,Boechler; Nicholas Sebastia,9998,0,9999,1
1746549259245,MAE 197,003,959852,Mullin; Jennifer S,9998,0,9999,1
1746549260271,MATH 2,A01,957937,Staff,33,0,35,2
1746549261298,MATH 197,001,957876,Kedlaya; Kiran S.,9993,0,9999,6
1746549262323,MCWP 40,A00,892729,Duru; Nur,10,0,20,10
1746549262323,MCWP 40,B00,893304,Montejo; Carolina,14,0,20,6
1746549263351,MCWP 40R,A00,893757,Redela; Pamela Morgan,0,5,20,20
1746549264376,MCWP 50,A00,893758,Morshed; Michael James,0,0,20,20
1746549264376,MCWP 50,B00,893761,Bartulis; Jason Michael,17,0,20,3
1746549265405,MCWP 50R,A00,893766,Compas; Sean Matthew,0,1,20,20
1746549265405,MCWP 50R,B00,893769,Carter; Jennifer A,0,1,20,20
1746549265405,MCWP 50R,C00,893771,Krone; Jarret,0,3,20,20
1746549265405,MCWP 50R,D00,893772,Miller; Elizabeth Deen,0,0,20,20
1746549265405,MCWP 50R,E00,893775,Carter; Andrea L,0,1,20,20
1746549266430,MMW 11R,A01,892721,Herbst; Matthew,11,0,27,16
1746549266430,MMW 11R,A02,892722,Herbst; Matthew,0,0,0,3
1746549267455,MMW 12R,A01,892724,Herbst; Matthew,0,11,16,16
1746549267455,MMW 12R,A02,892725,Herbst; Matthew,0,10,16,16
1746549268483,MMW 13R,A01,892727,Staff,0,4,16,16
1746549268483,MMW 13R,A02,892728,Staff,0,4,16,16
1746549268483,MMW 13R,A03,958032,Staff,0,4,16,16
1746549268483,MMW 13R,A04,958033,Staff,0,4,16,16
1746549268483,MMW 13R,A05,958034,Staff,0,4,16,16
1746549269508,SIO 295LS,A00,894015,Staff,5,0,25,20
1746549270536,SIO 295S,A00,894020,Staff,5,0,25,20
1746549271561,SIOC 290S,B01,958918,Merrifield; Mark A,14,0,30,16
1746549272594,SIOC 291S,B01,958922,Gabriel; Corey John,14,0,30,16
1746549273620,SOCI 117,A01,895339,Staff,3,0,5,2
1746549274645,WES 237B,A00,894149,Staff,11,0,20,9
1746549276704,AESE 279B,A00,891859,Staff,13,0,35,22
1746549277730,AIP 197,001,891854,Vespa; Emanuel Ignacio,9999,0,9999,0
1746549278755,ANTH 289S,A00,891856,Gagneux; Pascal,12,0,12,0
1746549279781,BENG 196,001,957946,Engler; Adam J.,9996,0,9999,3
1746549280809,BISP 197,001,959851,Wilhelm; James E.,9998,0,9999,1
1746549281838,CAT 124RS,A01,956906,Staff,6,0,25,19
1746549282865,CAT 125RS,A01,922013,Staff,6,0,25,19
1746549283891,CLRE 250,A00,891860,Morris; Sheldon,9995,0,9999,4
1746549285939,CLRE 251R,A00,907817,Mehta; Ravindra L.,9994,0,9999,5
1746549286964,CLRE 252,A00,891864,Cuomo; Raphael Eduardo,9993,0,9999,6
1746549288010,CLRE 253,A00,891867,Vaida; Florin,9994,0,9999,5
1746549288010,CLRE 253,B00,907819,Staff,9999,0,9999,0
1746549289034,CLRE 259,A00,891868,Patel; Hemal,9998,0,9999,1
1746549290059,CLRE 260,A00,891872,Cuomo; Raphael Eduardo,9999,0,9999,0
1746549291083,CLRE 297,001,891888,Cuomo; Raphael Eduardo,9999,0,9999,0
1746549292109,CSE 191,A00,958773,Minnes Kemp; Mor Mia,9996,0,9999,3
1746549293135,CSE 197,001,959846,Minnes Kemp; Mor Mia,9990,0,9999,9
1746549294163,CSS 201S,A01,892054,Mignozzetti; Umberto,26,0,30,4
1746549295191,CSS 202S,A01,892056,Mignozzetti; Umberto,26,0,30,4
1746549296216,DSC 197,001,956898,Eldridge; Justin Matthew,9998,0,9999,1
1746549297240,DSC 297,001,958000,Mazumdar; Arya,9998,0,9999,1
1746549297240,DSC 297,002,959862,Wang; Yusu,9999,0,9999,0
1746549298267,EAP 100,A00,905686,Staff,9778,0,9999,221
1746549299291,ECE 45,A01,892618,Staff,0,0,65,65
1746549301338,ECE 111,A01,892719,Staff,4,0,65,61
1746549302362,ECE 197,001,957920,Mercier; Patrick Philip,9991,0,9999,8
1746549303386,ECON 178,A01,907814,Zhu; Ying,26,0,35,9
1746549304415,EDS 115,A00,895312,Staff,36,0,45,9
1746549305439,EDS 117,A01,895337,Staff,24,0,30,6
1746549306466,EDS 125,A00,895341,Jones; Gabrielle Anastasia,37,0,45,8
1746549307490,EDS 128A,A01,895459,Fargason; Sharon Gayle,44,0,45,1
1746549308519,EDS 128B,A01,895543,Pappas; Elizabeth,44,0,45,1
1746549309545,EDS 139,A00,897203,Pappas; Elizabeth,44,0,45,1
1746549309545,EDS 139,B00,897209,Fargason; Sharon Gayle,41,0,45,4
1746549310571,EDS 201,A00,895545,Staff,22,0,45,23
1746549311600,EDS 203,A01,895581,Halter; Christopher P.,22,0,45,23
1746549312623,EDS 204R,A01,895625,Heinzman; Erica M.,39,0,45,6
1746549312623,EDS 204R,B01,895693,Halter; Christopher P.,10,0,45,35
1746549313651,EDS 206R,A00,895694,Fargason; Sharon Gayle,1,0,30,29
1746549313651,EDS 206R,B00,895695,Choi; Bailey Miyeon,16,0,30,14
1746549314674,EDS 250,A00,895697,Hemans; Patricia Ann Benitez,22,0,45,23
1746549315699,EDS 281,A00,895701,Meyerott; Theresa Ann,1,0,15,14
1746549316723,EDS 284,A00,895736,Meyerott; Theresa Ann,1,0,15,14
1746549317750,EDS 286,A00,897210,Fine; Sarah,0,0,15,15
1746549318777,EDS 289C,A01,895770,Daly; Alan J.,15,0,15,0
1746549319806,EDS 290,A00,897211,Hofstetter; Carolyn,0,0,15,15
1746549320831,LIGM 5A,A00,896162,Fischer-Grunski; Eva K,13,0,20,7
1746549321860,LIGM 5B,A00,896260,Fischer-Grunski; Eva K,17,0,20,3
1746549322887,LIGM 5C,A00,896308,Fischer-Grunski; Eva K,18,0,20,2
1746549323912,LIIT 5AS,A00,896313,Carnelos; Chiara,18,0,20,2
1746549324939,LIIT 5BS,A00,896416,Carnelos; Chiara,20,0,20,0
1746549325968,LIIT 5CS,A00,896564,Carnelos; Chiara,20,0,20,0
1746549326995,LISP 5A,A00,896588,Munoz Sanchez; Alicia,3,0,20,17
1746549328022,LISP 5B,A00,896653,Munoz Sanchez; Alicia,7,0,20,13
1746549329050,LISP 5C,A00,896655,Munoz Sanchez; Alicia,0,1,20,20
1746549330079,MAE 197,001,957918,Kleissl; Jan,9996,0,9999,3
1746549330079,MAE 197,002,959806,Boechler; Nicholas Sebastia,9998,0,9999,1
1746549330079,MAE 197,003,959852,Mullin; Jennifer S,9998,0,9999,1
1746549331104,MATH 2,A01,957937,Staff,33,0,35,2
1746549332129,MATH 197,001,957876,Kedlaya; Kiran S.,9993,0,9999,6
1746549333156,MCWP 40,A00,892729,Duru; Nur,10,0,20,10
1746549333156,MCWP 40,B00,893304,Montejo; Carolina,14,0,20,6
1746549334184,MCWP 40R,A00,893757,Redela; Pamela Morgan,0,5,20,20
1746549335210,MCWP 50,A00,893758,Morshed; Michael James,0,0,20,20
1746549335210,MCWP 50,B00,893761,Bartulis; Jason Michael,17,0,20,3
1746549336237,MCWP 50R,A00,893766,Compas; Sean Matthew,0,1,20,20
1746549336237,MCWP 50R,B00,893769,Carter; Jennifer A,0,1,20,20
1746549336237,MCWP 50R,C00,893771,Krone; Jarret,0,3,20,20
1746549336237,MCWP 50R,D00,893772,Miller; Elizabeth Deen,0,0,20,20
1746549336237,MCWP 50R,E00,893775,Carter; Andrea L,0,1,20,20
1746549337263,MMW 11R,A01,892721,Herbst; Matthew,11,0,27,16
1746549337263,MMW 11R,A02,892722,Herbst; Matthew,0,0,0,3
1746549338290,MMW 12R,A01,892724,Herbst; Matthew,0,11,16,16
1746549338290,MMW 12R,A02,892725,Herbst; Matthew,0,10,16,16
1746549339315,MMW 13R,A01,892727,Staff,0,4,16,16
1746549339315,MMW 13R,A02,892728,Staff,0,4,16,16
1746549339315,MMW 13R,A03,958032,Staff,0,4,16,16
1746549339315,MMW 13R,A04,958033,Staff,0,4,16,16
1746549339315,MMW 13R,A05,958034,Staff,0,4,16,16
1746549340342,SIO 295LS,A00,894015,Staff,5,0,25,20
1746549341367,SIO 295S,A00,894020,Staff,5,0,25,20
1746549342407,SIOC 290S,B01,958918,Merrifield; Mark A,14,0,30,16
1746549343434,SIOC 291S,B01,958922,Gabriel; Corey John,14,0,30,16
1746549344466,SOCI 117,A01,895339,Staff,3,0,5,2
1746549345493,WES 237B,A00,894149,Staff,11,0,20,9
1746549347545,AESE 279B,A00,891859,Staff,13,0,35,22
1746549348572,AIP 197,001,891854,Vespa; Emanuel Ignacio,9999,0,9999,0
1746549349598,ANTH 289S,A00,891856,Gagneux; Pascal,12,0,12,0
1746549350622,BENG 196,001,957946,Engler; Adam J.,9996,0,9999,3
1746549351647,BISP 197,001,959851,Wilhelm; James E.,9998,0,9999,1
1746549352674,CAT 124RS,A01,956906,Staff,6,0,25,19
1746549353700,CAT 125RS,A01,922013,Staff,6,0,25,19
1746549354724,CLRE 250,A00,891860,Morris; Sheldon,9995,0,9999,4
1746549356777,CLRE 251R,A00,907817,Mehta; Ravindra L.,9994,0,9999,5
1746549357801,CLRE 252,A00,891864,Cuomo; Raphael Eduardo,9993,0,9999,6
1746549358825,CLRE 253,A00,891867,Vaida; Florin,9994,0,9999,5
1746549358825,CLRE 253,B00,907819,Staff,9999,0,9999,0
1746549359851,CLRE 259,A00,891868,Patel; Hemal,9998,0,9999,1
1746549360879,CLRE 260,A00,891872,Cuomo; Raphael Eduardo,9999,0,9999,0
1746549361904,CLRE 297,001,891888,Cuomo; Raphael Eduardo,9999,0,9999,0
1746549362932,CSE 191,A00,958773,Minnes Kemp; Mor Mia,9996,0,9999,3
1746549363959,CSE 197,001,959846,Minnes Kemp; Mor Mia,9990,0,9999,9
1746549364984,CSS 201S,A01,892054,Mignozzetti; Umberto,26,0,30,4
1746549366009,CSS 202S,A01,892056,Mignozzetti; Umberto,26,0,30,4
1746549367035,DSC 197,001,956898,Eldridge; Justin Matthew,9998,0,9999,1
1746549368061,DSC 297,001,958000,Mazumdar; Arya,9998,0,9999,1
1746549368061,DSC 297,002,959862,Wang; Yusu,9999,0,9999,0
1746549369086,EAP 100,A00,905686,Staff,9778,0,9999,221
1746549370117,ECE 45,A01,892618,Staff,0,0,65,65
1746549372172,ECE 111,A01,892719,Staff,4,0,65,61
1746549373198,ECE 197,001,957920,Mercier; Patrick Philip,9991,0,9999,8
1746549374229,ECON 178,A01,907814,Zhu; Ying,26,0,35,9
1746549375254,EDS 115,A00,895312,Staff,36,0,45,9
1746549376279,EDS 117,A01,895337,Staff,24,0,30,6
1746549377306,EDS 125,A00,895341,Jones; Gabrielle Anastasia,37,0,45,8
1746549378331,EDS 128A,A01,895459,Fargason; Sharon Gayle,44,0,45,1
1746549379357,EDS 128B,A01,895543,Pappas; Elizabeth,44,0,45,1
1746549380383,EDS 139,A00,897203,Pappas; Elizabeth,44,0,45,1
1746549380383,EDS 139,B00,897209,Fargason; Sharon Gayle,41,0,45,4
1746549381412,EDS 201,A00,895545,Staff,22,0,45,23
1746549382440,EDS 203,A01,895581,Halter; Christopher P.,22,0,45,23
1746549383465,EDS 204R,A01,895625,Heinzman; Erica M.,39,0,45,6
1746549383465,EDS 204R,B01,895693,Halter; Christopher P.,10,0,45,35
1746549384492,EDS 206R,A00,895694,Fargason; Sharon Gayle,1,0,30,29
1746549384492,EDS 206R,B00,895695,Choi; Bailey Miyeon,16,0,30,14
1746549385518,EDS 250,A00,895697,Hemans; Patricia Ann Benitez,22,0,45,23
1746549386545,EDS 281,A00,895701,Meyerott; Theresa Ann,1,0,15,14
1746549387571,EDS 284,A00,895736,Meyerott; Theresa Ann,1,0,15,14
1746549388599,EDS 286,A00,897210,Fine; Sarah,0,0,15,15
1746549389623,EDS 289C,A01,895770,Daly; Alan J.,15,0,15,0
1746549390652,EDS 290,A00,897211,Hofstetter; Carolyn,0,0,15,15
1746549391676,LIGM 5A,A00,896162,Fischer-Grunski; Eva K,13,0,20,7
1746549392708,LIGM 5B,A00,896260,Fischer-Grunski; Eva K,17,0,20,3
1746549393738,LIGM 5C,A00,896308,Fischer-Grunski; Eva K,18,0,20,2
1746549394764,LIIT 5AS,A00,896313,Carnelos; Chiara,18,0,20,2
1746549395792,LIIT 5BS,A00,896416,Carnelos; Chiara,20,0,20,0
1746549396816,LIIT 5CS,A00,896564,Carnelos; Chiara,20,0,20,0
1746549397840,LISP 5A,A00,896588,Munoz Sanchez; Alicia,3,0,20,17
1746549398866,LISP 5B,A00,896653,Munoz Sanchez; Alicia,7,0,20,13
1746549399891,LISP 5C,A00,896655,Munoz Sanchez; Alicia,0,1,20,20
1746549400918,MAE 197,001,957918,Kleissl; Jan,9996,0,9999,3
1746549400918,MAE 197,002,959806,Boechler; Nicholas Sebastia,9998,0,9999,1
1746549400918,MAE 197,003,959852,Mullin; Jennifer S,9998,0,9999,1
1746549401945,MATH 2,A01,957937,Staff,33,0,35,2
1746549402972,MATH 197,001,957876,Kedlaya; Kiran S.,9993,0,9999,6
1746549404000,MCWP 40,A00,892729,Duru; Nur,10,0,20,10
1746549404000,MCWP 40,B00,893304,Montejo; Carolina,14,0,20,6
1746549405028,MCWP 40R,A00,893757,Redela; Pamela Morgan,0,5,20,20
1746549406055,MCWP 50,A00,893758,Morshed; Michael James,0,0,20,20
1746549406055,MCWP 50,B00,893761,Bartulis; Jason Michael,17,0,20,3
1746549407080,MCWP 50R,A00,893766,Compas; Sean Matthew,0,1,20,20
1746549407080,MCWP 50R,B00,893769,Carter; Jennifer A,0,1,20,20
1746549407080,MCWP 50R,C00,893771,Krone; Jarret,0,3,20,20
1746549407080,MCWP 50R,D00,893772,Miller; Elizabeth Deen,0,0,20,20
1746549407080,MCWP 50R,E00,893775,Carter; Andrea L,0,1,20,20
1746549408108,MMW 11R,A01,892721,Herbst; Matthew,11,0,27,16
1746549408108,MMW 11R,A02,892722,Herbst; Matthew,0,0,0,3
1746549409133,MMW 12R,A01,892724,Herbst; Matthew,0,11,16,16
1746549409133,MMW 12R,A02,892725,Herbst; Matthew,0,10,16,16
1746549410160,MMW 13R,A01,892727,Staff,0,4,16,16
1746549410160,MMW 13R,A02,892728,Staff,0,4,16,16
1746549410160,MMW 13R,A03,958032,Staff,0,4,16,16
1746549410160,MMW 13R,A04,958033,Staff,0,4,16,16
1746549410160,MMW 13R,A05,958034,Staff,0,4,16,16
1746549411187,SIO 295LS,A00,894015,Staff,5,0,25,20
1746549412212,SIO 295S,A00,894020,Staff,5,0,25,20
1746549413236,SIOC 290S,B01,958918,Merrifield; Mark A,14,0,30,16
1746549414263,SIOC 291S,B01,958922,Gabriel; Corey John,14,0,30,16
1746549415291,SOCI 117,A01,895339,Staff,3,0,5,2
1746549416316,WES 237B,A00,894149,Staff,11,0,20,9
1746549418374,AESE 279B,A00,891859,Staff,13,0,35,22
1746549419401,AIP 197,001,891854,Vespa; Emanuel Ignacio,9999,0,9999,0
1746549420428,ANTH 289S,A00,891856,Gagneux; Pascal,12,0,12,0
1746549421460,BENG 196,001,957946,Engler; Adam J.,9996,0,9999,3
1746549422486,BISP 197,001,959851,Wilhelm; James E.,9998,0,9999,1
1746549423511,CAT 124RS,A01,956906,Staff,6,0,25,19
1746549424534,CAT 125RS,A01,922013,Staff,6,0,25,19
1746549425559,CLRE 250,A00,891860,Morris; Sheldon,9995,0,9999,4
1746549427652,CLRE 251R,A00,907817,Mehta; Ravindra L.,9994,0,9999,5
1746549428678,CLRE 252,A00,891864,Cuomo; Raphael Eduardo,9993,0,9999,6
1746549429704,CLRE 253,A00,891867,Vaida; Florin,9994,0,9999,5
1746549429704,CLRE 253,B00,907819,Staff,9999,0,9999,0
1746549430728,CLRE 259,A00,891868,Patel; Hemal,9998,0,9999,1
1746549431755,CLRE 260,A00,891872,Cuomo; Raphael Eduardo,9999,0,9999,0
1746549432782,CLRE 297,001,891888,Cuomo; Raphael Eduardo,9999,0,9999,0
1746549433807,CSE 191,A00,958773,Minnes Kemp; Mor Mia,9996,0,9999,3
1746549434833,CSE 197,001,959846,Minnes Kemp; Mor Mia,9990,0,9999,9
1746549435862,CSS 201S,A01,892054,Mignozzetti; Umberto,26,0,30,4
1746549436887,CSS 202S,A01,892056,Mignozzetti; Umberto,26,0,30,4
1746549437915,DSC 197,001,956898,Eldridge; Justin Matthew,9998,0,9999,1
1746549438941,DSC 297,001,958000,Mazumdar; Arya,9998,0,9999,1
1746549438941,DSC 297,002,959862,Wang; Yusu,9999,0,9999,0
1746549439968,EAP 100,A00,905686,Staff,9778,0,9999,221
1746549440995,ECE 45,A01,892618,Staff,0,0,65,65
1746549443048,ECE 111,A01,892719,Staff,4,0,65,61
1746549444074,ECE 197,001,957920,Mercier; Patrick Philip,9991,0,9999,8
1746549445102,ECON 178,A01,907814,Zhu; Ying,26,0,35,9
1746549446125,EDS 115,A00,895312,Staff,36,0,45,9
1746549447153,EDS 117,A01,895337,Staff,24,0,30,6
1746549448179,EDS 125,A00,895341,Jones; Gabrielle Anastasia,37,0,45,8
1746549449205,EDS 128A,A01,895459,Fargason; Sharon Gayle,44,0,45,1
1746549450230,EDS 128B,A01,895543,Pappas; Elizabeth,44,0,45,1
1746549451258,EDS 139,A00,897203,Pappas; Elizabeth,44,0,45,1
1746549451258,EDS 139,B00,897209,Fargason; Sharon Gayle,41,0,45,4
1746549452285,EDS 201,A00,895545,Staff,22,0,45,23
1746549453310,EDS 203,A01,895581,Halter; Christopher P.,22,0,45,23
1746549454337,EDS 204R,A01,895625,Heinzman; Erica M.,39,0,45,6
1746549454337,EDS 204R,B01,895693,Halter; Christopher P.,10,0,45,35
1746549455361,EDS 206R,A00,895694,Fargason; Sharon Gayle,1,0,30,29
1746549455361,EDS 206R,B00,895695,Choi; Bailey Miyeon,16,0,30,14
1746549456391,EDS 250,A00,895697,Hemans; Patricia Ann Benitez,22,0,45,23
1746549457415,EDS 281,A00,895701,Meyerott; Theresa Ann,1,0,15,14
1746549458442,EDS 284,A00,895736,Meyerott; Theresa Ann,1,0,15,14
1746549459469,EDS 286,A00,897210,Fine; Sarah,0,0,15,15
1746549460498,EDS 289C,A01,895770,Daly; Alan J.,15,0,15,0
1746549461522,EDS 290,A00,897211,Hofstetter; Carolyn,0,0,15,15
1746549462547,LIGM 5A,A00,896162,Fischer-Grunski; Eva K,13,0,20,7
1746549463575,LIGM 5B,A00,896260,Fischer-Grunski; Eva K,17,0,20,3
1746549464602,LIGM 5C,A00,896308,Fischer-Grunski; Eva K,18,0,20,2
1746549465627,LIIT 5AS,A00,896313,Carnelos; Chiara,18,0,20,2
1746549466657,LIIT 5BS,A00,896416,Carnelos; Chiara,20,0,20,0
1746549467685,LIIT 5CS,A00,896564,Carnelos; Chiara,20,0,20,0
1746549468710,LISP 5A,A00,896588,Munoz Sanchez; Alicia,3,0,20,17
1746549469734,LISP 5B,A00,896653,Munoz Sanchez; Alicia,7,0,20,13
1746549470759,LISP 5C,A00,896655,Munoz Sanchez; Alicia,0,1,20,20
1746549471784,MAE 197,001,957918,Kleissl; Jan,9996,0,9999,3
1746549471784,MAE 197,002,959806,Boechler; Nicholas Sebastia,9998,0,9999,1
1746549471784,MAE 197,003,959852,Mullin; Jennifer S,9998,0,9999,1
1746549472813,MATH 2,A01,957937,Staff,33,0,35,2
1746549473839,MATH 197,001,957876,Kedlaya; Kiran S.,9993,0,9999,6
1746549474868,MCWP 40,A00,892729,Duru; Nur,10,0,20,10
1746549474868,MCWP 40,B00,893304,Montejo; Carolina,14,0,20,6
1746549475893,MCWP 40R,A00,893757,Redela; Pamela Morgan,0,5,20,20
1746549476918,MCWP 50,A00,893758,Morshed; Michael James,0,0,20,20
1746549476918,MCWP 50,B00,893761,Bartulis; Jason Michael,17,0,20,3
1746549477947,MCWP 50R,A00,893766,Compas; Sean Matthew,0,1,20,20
1746549477947,MCWP 50R,B00,893769,Carter; Jennifer A,0,1,20,20
1746549477947,MCWP 50R,C00,893771,Krone; Jarret,0,3,20,20
1746549477947,MCWP 50R,D00,893772,Miller; Elizabeth Deen,0,0,20,20
1746549477947,MCWP 50R,E00,893775,Carter; Andrea L,0,1,20,20
1746549478971,MMW 11R,A01,892721,Herbst; Matthew,11,0,27,16
1746549478971,MMW 11R,A02,892722,Herbst; Matthew,0,0,0,3
1746549479996,MMW 12R,A01,892724,Herbst; Matthew,0,11,16,16
1746549479996,MMW 12R,A02,892725,Herbst; Matthew,0,10,16,16
1746549481026,MMW 13R,A01,892727,Staff,0,4,16,16
1746549481026,MMW 13R,A02,892728,Staff,0,4,16,16
1746549481026,MMW 13R,A03,958032,Staff,0,4,16,16
1746549481026,MMW 13R,A04,958033,Staff,0,4,16,16
1746549481026,MMW 13R,A05,958034,Staff,0,4,16,16
1746549482052,SIO 295LS,A00,894015,Staff,5,0,25,20
1746549483080,SIO 295S,A00,894020,Staff,5,0,25,20
1746549484106,SIOC 290S,B01,958918,Merrifield; Mark A,14,0,30,16
1746549485135,SIOC 291S,B01,958922,Gabriel; Corey John,14,0,30,16
1746549486161,SOCI 117,A01,895339,Staff,3,0,5,2
1746549487187,WES 237B,A00,894149,Staff,11,0,20,9
1746549489243,AESE 279B,A00,891859,Staff,13,0,35,22
1746549490269,AIP 197,001,891854,Vespa; Emanuel Ignacio,9999,0,9999,0
1746549491294,ANTH 289S,A00,891856,Gagneux; Pascal,12,0,12,0
1746549492319,BENG 196,001,957946,Engler; Adam J.,9996,0,9999,3
1746549493344,BISP 197,001,959851,Wilhelm; James E.,9998,0,9999,1
1746549494372,CAT 124RS,A01,956906,Staff,6,0,25,19
1746549495410,CAT 125RS,A01,922013,Staff,6,0,25,19
1746549496436,CLRE 250,A00,891860,Morris; Sheldon,9995,0,9999,4
1746549498488,CLRE 251R,A00,907817,Mehta; Ravindra L.,9994,0,9999,5
1746549499514,CLRE 252,A00,891864,Cuomo; Raphael Eduardo,9993,0,9999,6
1746549500539,CLRE 253,A00,891867,Vaida; Florin,9994,0,9999,5
1746549500539,CLRE 253,B00,907819,Staff,9999,0,9999,0
1746549501562,CLRE 259,A00,891868,Patel; Hemal,9998,0,9999,1
1746549502587,CLRE 260,A00,891872,Cuomo; Raphael Eduardo,9999,0,9999,0
1746549503612,CLRE 297,001,891888,Cuomo; Raphael Eduardo,9999,0,9999,0
1746549504636,CSE 191,A00,958773,Minnes Kemp; Mor Mia,9996,0,9999,3
1746549505661,CSE 197,001,959846,Minnes Kemp; Mor Mia,9990,0,9999,9
1746549506685,CSS 201S,A01,892054,Mignozzetti; Umberto,26,0,30,4
1746549507712,CSS 202S,A01,892056,Mignozzetti; Umberto,26,0,30,4
1746549508736,DSC 197,001,956898,Eldridge; Justin Matthew,9998,0,9999,1
1746549509761,DSC 297,001,958000,Mazumdar; Arya,9998,0,9999,1
1746549509761,DSC 297,002,959862,Wang; Yusu,9999,0,9999,0
1746549510787,EAP 100,A00,905686,Staff,9778,0,9999,221
1746549511814,ECE 45,A01,892618,Staff,0,0,65,65
1746549513865,ECE 111,A01,892719,Staff,4,0,65,61
1746549514891,ECE 197,001,957920,Mercier; Patrick Philip,9991,0,9999,8
1746549515919,ECON 178,A01,907814,Zhu; Ying,26,0,35,9
1746549516943,EDS 115,A00,895312,Staff,36,0,45,9
1746549517969,EDS 117,A01,895337,Staff,24,0,30,6
1746549518997,EDS 125,A00,895341,Jones; Gabrielle Anastasia,37,0,45,8
1746549520024,EDS 128A,A01,895459,Fargason; Sharon Gayle,44,0,45,1
1746549521054,EDS 128B,A01,895543,Pappas; Elizabeth,44,0,45,1
1746549522081,EDS 139,A00,897203,Pappas; Elizabeth,44,0,45,1
1746549522081,EDS 139,B00,897209,Fargason; Sharon Gayle,41,0,45,4
1746549523106,EDS 201,A00,895545,Staff,22,0,45,23
1746549524131,EDS 203,A01,895581,Halter; Christopher P.,22,0,45,23
1746549525158,EDS 204R,A01,895625,Heinzman; Erica M.,39,0,45,6
1746549525158,EDS 204R,B01,895693,Halter; Christopher P.,10,0,45,35
1746549526184,EDS 206R,A00,895694,Fargason; Sharon Gayle,1,0,30,29
1746549526184,EDS 206R,B00,895695,Choi; Bailey Miyeon,16,0,30,14
1746549527209,EDS 250,A00,895697,Hemans; Patricia Ann Benitez,22,0,45,23
1746549528236,EDS 281,A00,895701,Meyerott; Theresa Ann,1,0,15,14
1746549529265,EDS 284,A00,895736,Meyerott; Theresa Ann,1,0,15,14
1746549530289,EDS 286,A00,897210,Fine; Sarah,0,0,15,15
1746549531315,EDS 289C,A01,895770,Daly; Alan J.,15,0,15,0
1746549532344,EDS 290,A00,897211,Hofstetter; Carolyn,0,0,15,15
1746549533367,LIGM 5A,A00,896162,Fischer-Grunski; Eva K,13,0,20,7
1746549534391,LIGM 5B,A00,896260,Fischer-Grunski; Eva K,17,0,20,3
1746549535421,LIGM 5C,A00,896308,Fischer-Grunski; Eva K,18,0,20,2
1746549536447,LIIT 5AS,A00,896313,Carnelos; Chiara,18,0,20,2
1746549537472,LIIT 5BS,A00,896416,Carnelos; Chiara,20,0,20,0
1746549538498,LIIT 5CS,A00,896564,Carnelos; Chiara,20,0,20,0
1746549539528,LISP 5A,A00,896588,Munoz Sanchez; Alicia,3,0,20,17
1746549540558,LISP 5B,A00,896653,Munoz Sanchez; Alicia,7,0,20,13
1746549541584,LISP 5C,A00,896655,Munoz Sanchez; Alicia,0,1,20,20
1746549542614,MAE 197,001,957918,Kleissl; Jan,9996,0,9999,3
1746549542614,MAE 197,002,959806,Boechler; Nicholas Sebastia,9998,0,9999,1
1746549542614,MAE 197,003,959852,Mullin; Jennifer S,9998,0,9999,1
1746549543641,MATH 2,A01,957937,Staff,33,0,35,2
1746549544669,MATH 197,001,957876,Kedlaya; Kiran S.,9993,0,9999,6
1746549545693,MCWP 40,A00,892729,Duru; Nur,10,0,20,10
1746549545693,MCWP 40,B00,893304,Montejo; Carolina,14,0,20,6
1746549546719,MCWP 40R,A00,893757,Redela; Pamela Morgan,0,5,20,20
1746549547744,MCWP 50,A00,893758,Morshed; Michael James,0,0,20,20
1746549547744,MCWP 50,B00,893761,Bartulis; Jason Michael,17,0,20,3
1746549548775,MCWP 50R,A00,893766,Compas; Sean Matthew,0,1,20,20
1746549548775,MCWP 50R,B00,893769,Carter; Jennifer A,0,1,20,20
1746549548775,MCWP 50R,C00,893771,Krone; Jarret,0,3,20,20
1746549548775,MCWP 50R,D00,893772,Miller; Elizabeth Deen,0,0,20,20
1746549548775,MCWP 50R,E00,893775,Carter; Andrea L,0,1,20,20
1746549549799,MMW 11R,A01,892721,Herbst; Matthew,11,0,27,16
1746549549799,MMW 11R,A02,892722,Herbst; Matthew,0,0,0,3
1746549550824,MMW 12R,A01,892724,Herbst; Matthew,0,11,16,16
1746549550824,MMW 12R,A02,892725,Herbst; Matthew,0,10,16,16
1746549551848,MMW 13R,A01,892727,Staff,0,4,16,16
1746549551848,MMW 13R,A02,892728,Staff,0,4,16,16
1746549551848,MMW 13R,A03,958032,Staff,0,4,16,16
1746549551848,MMW 13R,A04,958033,Staff,0,4,16,16
1746549551848,MMW 13R,A05,958034,Staff,0,4,16,16
1746549552876,SIO 295LS,A00,894015,Staff,5,0,25,20
1746549553905,SIO 295S,A00,894020,Staff,5,0,25,20
1746549554933,SIOC 290S,B01,958918,Merrifield; Mark A,14,0,30,16
1746549555958,SIOC 291S,B01,958922,Gabriel; Corey John,14,0,30,16
1746549556984,SOCI 117,A01,895339,Staff,3,0,5,2
1746549558010,WES 237B,A00,894149,Staff,11,0,20,9
1746549560071,AESE 279B,A00,891859,Staff,13,0,35,22
1746549561099,AIP 197,001,891854,Vespa; Emanuel Ignacio,9999,0,9999,0
1746549562125,ANTH 289S,A00,891856,Gagneux; Pascal,12,0,12,0
1746549563154,BENG 196,001,957946,Engler; Adam J.,9996,0,9999,3
1746549564189,BISP 197,001,959851,Wilhelm; James E.,9998,0,9999,1
1746549565214,CAT 124RS,A01,956906,Staff,6,0,25,19
1746549566239,CAT 125RS,A01,922013,Staff,6,0,25,19
1746549567270,CLRE 250,A00,891860,Morris; Sheldon,9995,0,9999,4
1746549569323,CLRE 251R,A00,907817,Mehta; Ravindra L.,9994,0,9999,5
1746549570349,CLRE 252,A00,891864,Cuomo; Raphael Eduardo,9993,0,9999,6
1746549571373,CLRE 253,A00,891867,Vaida; Florin,9994,0,9999,5
1746549571373,CLRE 253,B00,907819,Staff,9999,0,9999,0
1746549572397,CLRE 259,A00,891868,Patel; Hemal,9998,0,9999,1
1746549573424,CLRE 260,A00,891872,Cuomo; Raphael Eduardo,9999,0,9999,0
1746549574449,CLRE 297,001,891888,Cuomo; Raphael Eduardo,9999,0,9999,0
1746549575476,CSE 191,A00,958773,Minnes Kemp; Mor Mia,9996,0,9999,3
1746549576499,CSE 197,001,959846,Minnes Kemp; Mor Mia,9990,0,9999,9
1746549577526,CSS 201S,A01,892054,Mignozzetti; Umberto,26,0,30,4
1746549578552,CSS 202S,A01,892056,Mignozzetti; Umberto,26,0,30,4
1746549579578,DSC 197,001,956898,Eldridge; Justin Matthew,9998,0,9999,1
1746549580603,DSC 297,001,958000,Mazumdar; Arya,9998,0,9999,1
1746549580603,DSC 297,002,959862,Wang; Yusu,9999,0,9999,0
1746549581627,EAP 100,A00,905686,Staff,9778,0,9999,221
1746549582654,ECE 45,A01,892618,Staff,0,0,65,65
1746549584706,ECE 111,A01,892719,Staff,4,0,65,61
1746549585732,ECE 197,001,957920,Mercier; Patrick Philip,9991,0,9999,8
1746549586759,ECON 178,A01,907814,Zhu; Ying,26,0,35,9
1746549587784,EDS 115,A00,895312,Staff,36,0,45,9
1746549588812,EDS 117,A01,895337,Staff,24,0,30,6
1746549589836,EDS 125,A00,895341,Jones; Gabrielle Anastasia,37,0,45,8
1746549590863,EDS 128A,A01,895459,Fargason; Sharon Gayle,44,0,45,1
1746549591891,EDS 128B,A01,895543,Pappas; Elizabeth,44,0,45,1
1746549592916,EDS 139,A00,897203,Pappas; Elizabeth,44,0,45,1
1746549592916,EDS 139,B00,897209,Fargason; Sharon Gayle,41,0,45,4
1746549593941,EDS 201,A00,895545,Staff,22,0,45,23
1746549594968,EDS 203,A01,895581,Halter; Christopher P.,22,0,45,23
1746549595997,EDS 204R,A01,895625,Heinzman; Erica M.,39,0,45,6
1746549595997,EDS 204R,B01,895693,Halter; Christopher P.,10,0,45,35
1746549597021,EDS 206R,A00,895694,Fargason; Sharon Gayle,1,0,30,29
1746549597021,EDS 206R,B00,895695,Choi; Bailey Miyeon,16,0,30,14
1746549598046,EDS 250,A00,895697,Hemans; Patricia Ann Benitez,22,0,45,23
1746549599072,EDS 281,A00,895701,Meyerott; Theresa Ann,1,0,15,14
1746549600097,EDS 284,A00,895736,Meyerott; Theresa Ann,1,0,15,14
1746549601126,EDS 286,A00,897210,Fine; Sarah,0,0,15,15
1746549602172,EDS 289C,A01,895770,Daly; Alan J.,15,0,15,0
1746549603201,EDS 290,A00,897211,Hofstetter; Carolyn,0,0,15,15
1746549604226,LIGM 5A,A00,896162,Fischer-Grunski; Eva K,13,0,20,7
1746549605253,LIGM 5B,A00,896260,Fischer-Grunski; Eva K,17,0,20,3
1746549606280,LIGM 5C,A00,896308,Fischer-Grunski; Eva K,18,0,20,2
1746549607305,LIIT 5AS,A00,896313,Carnelos; Chiara,18,0,20,2
1746549608331,LIIT 5BS,A00,896416,Carnelos; Chiara,20,0,20,0
1746549609355,LIIT 5CS,A00,896564,Carnelos; Chiara,20,0,20,0
1746549610381,LISP 5A,A00,896588,Munoz Sanchez; Alicia,3,0,20,17
1746549611408,LISP 5B,A00,896653,Munoz Sanchez; Alicia,7,0,20,13
1746549612436,LISP 5C,A00,896655,Munoz Sanchez; Alicia,0,1,20,20
1746549613461,MAE 197,001,957918,Kleissl; Jan,9996,0,9999,3
1746549613461,MAE 197,002,959806,Boechler; Nicholas Sebastia,9998,0,9999,1
1746549613461,MAE 197,003,959852,Mullin; Jennifer S,9998,0,9999,1
1746549614489,MATH 2,A01,957937,Staff,33,0,35,2
1746549615515,MATH 197,001,957876,Kedlaya; Kiran S.,9993,0,9999,6
1746549616541,MCWP 40,A00,892729,Duru; Nur,10,0,20,10
1746549616541,MCWP 40,B00,893304,Montejo; Carolina,14,0,20,6
1746549617565,MCWP 40R,A00,893757,Redela; Pamela Morgan,0,5,20,20
1746549618595,MCWP 50,A00,893758,Morshed; Michael James,0,0,20,20
1746549618595,MCWP 50,B00,893761,Bartulis; Jason Michael,17,0,20,3
1746549619624,MCWP 50R,A00,893766,Compas; Sean Matthew,0,1,20,20
1746549619624,MCWP 50R,B00,893769,Carter; Jennifer A,0,1,20,20
1746549619624,MCWP 50R,C00,893771,Krone; Jarret,0,3,20,20
1746549619624,MCWP 50R,D00,893772,Miller; Elizabeth Deen,0,0,20,20
1746549619624,MCWP 50R,E00,893775,Carter; Andrea L,0,1,20,20
1746549620652,MMW 11R,A01,892721,Herbst; Matthew,11,0,27,16
1746549620652,MMW 11R,A02,892722,Herbst; Matthew,0,0,0,3
1746549621682,MMW 12R,A01,892724,Herbst; Matthew,0,11,16,16
1746549621682,MMW 12R,A02,892725,Herbst; Matthew,0,10,16,16
1746549623133,MMW 13R,A01,892727,Staff,0,4,16,16
1746549623133,MMW 13R,A02,892728,Staff,0,4,16,16
1746549623133,MMW 13R,A03,958032,Staff,0,4,16,16
1746549623133,MMW 13R,A04,958033,Staff,0,4,16,16
1746549623133,MMW 13R,A05,958034,Staff,0,4,16,16
1746549624161,SIO 295LS,A00,894015,Staff,5,0,25,20
1746549625188,SIO 295S,A00,894020,Staff,5,0,25,20
1746549626215,SIOC 290S,B01,958918,Merrifield; Mark A,14,0,30,16
1746549627242,SIOC 291S,B01,958922,Gabriel; Corey John,14,0,30,16
1746549628269,SOCI 117,A01,895339,Staff,3,0,5,2
1746549629292,WES 237B,A00,894149,Staff,11,0,20,9
1746549631359,AESE 279B,A00,891859,Staff,13,0,35,22
1746549632385,AIP 197,001,891854,Vespa; Emanuel Ignacio,9999,0,9999,0
1746549633409,ANTH 289S,A00,891856,Gagneux; Pascal,12,0,12,0
1746549634436,BENG 196,001,957946,Engler; Adam J.,9996,0,9999,3
1746549635460,BISP 197,001,959851,Wilhelm; James E.,9998,0,9999,1
1746549636485,CAT 124RS,A01,956906,Staff,6,0,25,19
1746549637512,CAT 125RS,A01,922013,Staff,6,0,25,19
1746549638536,CLRE 250,A00,891860,Morris; Sheldon,9995,0,9999,4
1746549640584,CLRE 251R,A00,907817,Mehta; Ravindra L.,9994,0,9999,5
1746549641611,CLRE 252,A00,891864,Cuomo; Raphael Eduardo,9993,0,9999,6
1746549642641,CLRE 253,A00,891867,Vaida; Florin,9994,0,9999,5
1746549642641,CLRE 253,B00,907819,Staff,9999,0,9999,0
1746549643667,CLRE 259,A00,891868,Patel; Hemal,9998,0,9999,1
1746549644694,CLRE 260,A00,891872,Cuomo; Raphael Eduardo,9999,0,9999,0
1746549645720,CLRE 297,001,891888,Cuomo; Raphael Eduardo,9999,0,9999,0
1746549646756,CSE 191,A00,958773,Minnes Kemp; Mor Mia,9996,0,9999,3
1746549647780,CSE 197,001,959846,Minnes Kemp; Mor Mia,9990,0,9999,9
1746549648810,CSS 201S,A01,892054,Mignozzetti; Umberto,26,0,30,4
1746549649837,CSS 202S,A01,892056,Mignozzetti; Umberto,26,0,30,4
1746549650865,DSC 197,001,956898,Eldridge; Justin Matthew,9998,0,9999,1
1746549651894,DSC 297,001,958000,Mazumdar; Arya,9998,0,9999,1
1746549651894,DSC 297,002,959862,Wang; Yusu,9999,0,9999,0
1746549652921,EAP 100,A00,905686,Staff,9778,0,9999,221
1746549653949,ECE 45,A01,892618,Staff,0,0,65,65
1746549656005,ECE 111,A01,892719,Staff,4,0,65,61
1746549657029,ECE 197,001,957920,Mercier; Patrick Philip,9991,0,9999,8
1746549658054,ECON 178,A01,907814,Zhu; Ying,26,0,35,9
1746549659079,EDS 115,A00,895312,Staff,36,0,45,9
1746549660105,EDS 117,A01,895337,Staff,24,0,30,6
1746549661133,EDS 125,A00,895341,Jones; Gabrielle Anastasia,37,0,45,8
1746549662168,EDS 128A,A01,895459,Fargason; Sharon Gayle,44,0,45,1
1746549663195,EDS 128B,A01,895543,Pappas; Elizabeth,44,0,45,1
1746549664219,EDS 139,A00,897203,Pappas; Elizabeth,44,0,45,1
1746549664219,EDS 139,B00,897209,Fargason; Sharon Gayle,41,0,45,4
1746549665243,EDS 201,A00,895545,Staff,22,0,45,23
1746549666269,EDS 203,A01,895581,Halter; Christopher P.,22,0,45,23
1746549667293,EDS 204R,A01,895625,Heinzman; Erica M.,39,0,45,6
1746549667293,EDS 204R,B01,895693,Halter; Christopher P.,10,0,45,35
1746549668318,EDS 206R,A00,895694,Fargason; Sharon Gayle,1,0,30,29
1746549668318,EDS 206R,B00,895695,Choi; Bailey Miyeon,16,0,30,14
1746549669383,EDS 250,A00,895697,Hemans; Patricia Ann Benitez,22,0,45,23
1746549670408,EDS 281,A00,895701,Meyerott; Theresa Ann,1,0,15,14
1746549671433,EDS 284,A00,895736,Meyerott; Theresa Ann,1,0,15,14
1746549672460,EDS 286,A00,897210,Fine; Sarah,0,0,15,15
1746549673485,EDS 289C,A01,895770,Daly; Alan J.,15,0,15,0
1746549674510,EDS 290,A00,897211,Hofstetter; Carolyn,0,0,15,15
1746549675536,LIGM 5A,A00,896162,Fischer-Grunski; Eva K,13,0,20,7
1746549676561,LIGM 5B,A00,896260,Fischer-Grunski; Eva K,17,0,20,3
1746549677588,LIGM 5C,A00,896308,Fischer-Grunski; Eva K,18,0,20,2
1746549678618,LIIT 5AS,A00,896313,Carnelos; Chiara,18,0,20,2
1746549679644,LIIT 5BS,A00,896416,Carnelos; Chiara,20,0,20,0
1746549680669,LIIT 5CS,A00,896564,Carnelos; Chiara,20,0,20,0
1746549681696,LISP 5A,A00,896588,Munoz Sanchez; Alicia,3,0,20,17
1746549682723,LISP 5B,A00,896653,Munoz Sanchez; Alicia,7,0,20,13
1746549683748,LISP 5C,A00,896655,Munoz Sanchez; Alicia,0,1,20,20
1746549684775,MAE 197,001,957918,Kleissl; Jan,9996,0,9999,3
1746549684775,MAE 197,002,959806,Boechler; Nicholas Sebastia,9998,0,9999,1
1746549684775,MAE 197,003,959852,Mullin; Jennifer S,9998,0,9999,1
1746549685801,MATH 2,A01,957937,Staff,33,0,35,2
1746549686825,MATH 197,001,957876,Kedlaya; Kiran S.,9993,0,9999,6
1746549687852,MCWP 40,A00,892729,Duru; Nur,10,0,20,10
1746549687852,MCWP 40,B00,893304,Montejo; Carolina,14,0,20,6
1746549688880,MCWP 40R,A00,893757,Redela; Pamela Morgan,0,5,20,20
1746549689906,MCWP 50,A00,893758,Morshed; Michael James,0,0,20,20
1746549689906,MCWP 50,B00,893761,Bartulis; Jason Michael,17,0,20,3
1746549690932,MCWP 50R,A00,893766,Compas; Sean Matthew,0,1,20,20
1746549690932,MCWP 50R,B00,893769,Carter; Jennifer A,0,1,20,20
1746549690932,MCWP 50R,C00,893771,Krone; Jarret,0,3,20,20
1746549690932,MCWP 50R,D00,893772,Miller; Elizabeth Deen,0,0,20,20
1746549690932,MCWP 50R,E00,893775,Carter; Andrea L,0,1,20,20
1746549691957,MMW 11R,A01,892721,Herbst; Matthew,11,0,27,16
1746549691957,MMW 11R,A02,892722,Herbst; Matthew,0,0,0,3
1746549692982,MMW 12R,A01,892724,Herbst; Matthew,0,11,16,16
1746549692982,MMW 12R,A02,892725,Herbst; Matthew,0,10,16,16
1746549694013,MMW 13R,A01,892727,Staff,0,4,16,16
1746549694013,MMW 13R,A02,892728,Staff,0,4,16,16
1746549694013,MMW 13R,A03,958032,Staff,0,4,16,16
1746549694013,MMW 13R,A04,958033,Staff,0,4,16,16
1746549694013,MMW 13R,A05,958034,Staff,0,4,16,16
1746549695038,SIO 295LS,A00,894015,Staff,5,0,25,20
1746549696065,SIO 295S,A00,894020,Staff,5,0,25,20
1746549697095,SIOC 290S,B01,958918,Merrifield; Mark A,14,0,30,16
1746549698125,SIOC 291S,B01,958922,Gabriel; Corey John,14,0,30,16
1746549699150,SOCI 117,A01,895339,Staff,3,0,5,2
1746549700176,WES 237B,A00,894149,Staff,11,0,20,9
1746549702241,AESE 279B,A00,891859,Staff,13,0,35,22
1746549703269,AIP 197,001,891854,Vespa; Emanuel Ignacio,9999,0,9999,0
1746549704294,ANTH 289S,A00,891856,Gagneux; Pascal,12,0,12,0
1746549705319,BENG 196,001,957946,Engler; Adam J.,9996,0,9999,3
1746549706344,BISP 197,001,959851,Wilhelm; James E.,9998,0,9999,1
1746549707367,CAT 124RS,A01,956906,Staff,6,0,25,19
1746549708395,CAT 125RS,A01,922013,Staff,6,0,25,19
1746549709420,CLRE 250,A00,891860,Morris; Sheldon,9995,0,9999,4
1746549711471,CLRE 251R,A00,907817,Mehta; Ravindra L.,9994,0,9999,5
1746549712496,CLRE 252,A00,891864,Cuomo; Raphael Eduardo,9993,0,9999,6
1746549713523,CLRE 253,A00,891867,Vaida; Florin,9994,0,9999,5
1746549713523,CLRE 253,B00,907819,Staff,9999,0,9999,0
1746549714552,CLRE 259,A00,891868,Patel; Hemal,9998,0,9999,1
1746549715580,CLRE 260,A00,891872,Cuomo; Raphael Eduardo,9999,0,9999,0
1746549716609,CLRE 297,001,891888,Cuomo; Raphael Eduardo,9999,0,9999,0
1746549717636,CSE 191,A00,958773,Minnes Kemp; Mor Mia,9996,0,9999,3
1746549718663,CSE 197,001,959846,Minnes Kemp; Mor Mia,9990,0,9999,9
1746549719689,CSS 201S,A01,892054,Mignozzetti; Umberto,26,0,30,4
1746549720715,CSS 202S,A01,892056,Mignozzetti; Umberto,26,0,30,4
1746549721739,DSC 197,001,956898,Eldridge; Justin Matthew,9998,0,9999,1
1746549722763,DSC 297,001,958000,Mazumdar; Arya,9998,0,9999,1
1746549722763,DSC 297,002,959862,Wang; Yusu,9999,0,9999,0
1746549723790,EAP 100,A00,905686,Staff,9778,0,9999,221
1746549724818,ECE 45,A01,892618,Staff,0,0,65,65
1746549726869,ECE 111,A01,892719,Staff,4,0,65,61
1746549727894,ECE 197,001,957920,Mercier; Patrick Philip,9991,0,9999,8
1746549728920,ECON 178,A01,907814,Zhu; Ying,26,0,35,9
1746549729947,EDS 115,A00,895312,Staff,36,0,45,9
1746549730994,EDS 117,A01,895337,Staff,24,0,30,6
1746549732023,EDS 125,A00,895341,Jones; Gabrielle Anastasia,37,0,45,8
1746549733049,EDS 128A,A01,895459,Fargason; Sharon Gayle,44,0,45,1
1746549734076,EDS 128B,A01,895543,Pappas; Elizabeth,44,0,45,1
1746549735103,EDS 139,A00,897203,Pappas; Elizabeth,44,0,45,1
1746549735103,EDS 139,B00,897209,Fargason; Sharon Gayle,41,0,45,4
1746549736128,EDS 201,A00,895545,Staff,22,0,45,23
1746549737153,EDS 203,A01,895581,Halter; Christopher P.,22,0,45,23
1746549738182,EDS 204R,A01,895625,Heinzman; Erica M.,39,0,45,6
1746549738182,EDS 204R,B01,895693,Halter; Christopher P.,10,0,45,35
1746549739205,EDS 206R,A00,895694,Fargason; Sharon Gayle,1,0,30,29
1746549739205,EDS 206R,B00,895695,Choi; Bailey Miyeon,16,0,30,14
1746549740233,EDS 250,A00,895697,Hemans; Patricia Ann Benitez,22,0,45,23
1746549741260,EDS 281,A00,895701,Meyerott; Theresa Ann,1,0,15,14
1746549742283,EDS 284,A00,895736,Meyerott; Theresa Ann,1,0,15,14
1746549743308,EDS 286,A00,897210,Fine; Sarah,0,0,15,15
1746549744332,EDS 289C,A01,895770,Daly; Alan J.,15,0,15,0
1746549745359,EDS 290,A00,897211,Hofstetter; Carolyn,0,0,15,15
1746549746388,LIGM 5A,A00,896162,Fischer-Grunski; Eva K,13,0,20,7
1746549747413,LIGM 5B,A00,896260,Fischer-Grunski; Eva K,17,0,20,3
1746549748438,LIGM 5C,A00,896308,Fischer-Grunski; Eva K,18,0,20,2
1746549749465,LIIT 5AS,A00,896313,Carnelos; Chiara,18,0,20,2
1746549750490,LIIT 5BS,A00,896416,Carnelos; Chiara,20,0,20,0
1746549751519,LIIT 5CS,A00,896564,Carnelos; Chiara,20,0,20,0
1746549752544,LISP 5A,A00,896588,Munoz Sanchez; Alicia,3,0,20,17
1746549753575,LISP 5B,A00,896653,Munoz Sanchez; Alicia,7,0,20,13
1746549754600,LISP 5C,A00,896655,Munoz Sanchez; Alicia,0,1,20,20
1746549755628,MAE 197,001,957918,Kleissl; Jan,9996,0,9999,3
1746549755628,MAE 197,002,959806,Boechler; Nicholas Sebastia,9998,0,9999,1
1746549755628,MAE 197,003,959852,Mullin; Jennifer S,9998,0,9999,1
1746549756652,MATH 2,A01,957937,Staff,33,0,35,2
1746549757678,MATH 197,001,957876,Kedlaya; Kiran S.,9993,0,9999,6
1746549758707,MCWP 40,A00,892729,Duru; Nur,10,0,20,10
1746549758707,MCWP 40,B00,893304,Montejo; Carolina,14,0,20,6
1746549759735,MCWP 40R,A00,893757,Redela; Pamela Morgan,0,5,20,20
1746549760759,MCWP 50,A00,893758,Morshed; Michael James,0,0,20,20
1746549760759,MCWP 50,B00,893761,Bartulis; Jason Michael,17,0,20,3
1746549761785,MCWP 50R,A00,893766,Compas; Sean Matthew,0,1,20,20
1746549761785,MCWP 50R,B00,893769,Carter; Jennifer A,0,1,20,20
1746549761785,MCWP 50R,C00,893771,Krone; Jarret,0,3,20,20
1746549761785,MCWP 50R,D00,893772,Miller; Elizabeth Deen,0,0,20,20
1746549761785,MCWP 50R,E00,893775,Carter; Andrea L,0,1,20,20
1746549762810,MMW 11R,A01,892721,Herbst; Matthew,11,0,27,16
1746549762810,MMW 11R,A02,892722,Herbst; Matthew,0,0,0,3
1746549763834,MMW 12R,A01,892724,Herbst; Matthew,0,11,16,16
1746549763834,MMW 12R,A02,892725,Herbst; Matthew,0,10,16,16
1746549764859,MMW 13R,A01,892727,Staff,0,4,16,16
1746549764859,MMW 13R,A02,892728,Staff,0,4,16,16
1746549764859,MMW 13R,A03,958032,Staff,0,4,16,16
1746549764859,MMW 13R,A04,958033,Staff,0,4,16,16
1746549764859,MMW 13R,A05,958034,Staff,0,4,16,16
1746549765884,SIO 295LS,A00,894015,Staff,5,0,25,20
1746549766908,SIO 295S,A00,894020,Staff,5,0,25,20
1746549767933,SIOC 290S,B01,958918,Merrifield; Mark A,14,0,30,16
1746549768960,SIOC 291S,B01,958922,Gabriel; Corey John,14,0,30,16
1746549770002,SOCI 117,A01,895339,Staff,3,0,5,2
1746549771029,WES 237B,A00,894149,Staff,11,0,20,9
1746549773123,AESE 279B,A00,891859,Staff,13,0,35,22
1746549774147,AIP 197,001,891854,Vespa; Emanuel Ignacio,9999,0,9999,0
1746549775173,ANTH 289S,A00,891856,Gagneux; Pascal,12,0,12,0
1746549776200,BENG 196,001,957946,Engler; Adam J.,9996,0,9999,3
1746549777224,BISP 197,001,959851,Wilhelm; James E.,9998,0,9999,1
1746549778251,CAT 124RS,A01,956906,Staff,6,0,25,19
1746549779279,CAT 125RS,A01,922013,Staff,6,0,25,19
1746549780305,CLRE 250,A00,891860,Morris; Sheldon,9995,0,9999,4
1746549782355,CLRE 251R,A00,907817,Mehta; Ravindra L.,9994,0,9999,5
1746549783381,CLRE 252,A00,891864,Cuomo; Raphael Eduardo,9993,0,9999,6
1746549784406,CLRE 253,A00,891867,Vaida; Florin,9994,0,9999,5
1746549784406,CLRE 253,B00,907819,Staff,9999,0,9999,0
1746549785432,CLRE 259,A00,891868,Patel; Hemal,9998,0,9999,1
1746549786458,CLRE 260,A00,891872,Cuomo; Raphael Eduardo,9999,0,9999,0
1746549787485,CLRE 297,001,891888,Cuomo; Raphael Eduardo,9999,0,9999,0
1746549788513,CSE 191,A00,958773,Minnes Kemp; Mor Mia,9996,0,9999,3
1746549789539,CSE 197,001,959846,Minnes Kemp; Mor Mia,9990,0,9999,9
1746549790565,CSS 201S,A01,892054,Mignozzetti; Umberto,26,0,30,4
1746549791590,CSS 202S,A01,892056,Mignozzetti; Umberto,26,0,30,4
1746549792617,DSC 197,001,956898,Eldridge; Justin Matthew,9997,0,9999,2
1746549793644,DSC 297,001,958000,Mazumdar; Arya,9998,0,9999,1
1746549793644,DSC 297,002,959862,Wang; Yusu,9999,0,9999,0
1746549794668,EAP 100,A00,905686,Staff,9778,0,9999,221
1746549795695,ECE 45,A01,892618,Staff,0,0,65,65
1746549797746,ECE 111,A01,892719,Staff,4,0,65,61
1746549798772,ECE 197,001,957920,Mercier; Patrick Philip,9991,0,9999,8
1746549799796,ECON 178,A01,907814,Zhu; Ying,26,0,35,9
1746549800823,EDS 115,A00,895312,Staff,36,0,45,9
1746549801851,EDS 117,A01,895337,Staff,24,0,30,6
1746549802876,EDS 125,A00,895341,Jones; Gabrielle Anastasia,37,0,45,8
1746549803903,EDS 128A,A01,895459,Fargason; Sharon Gayle,44,0,45,1
1746549804930,EDS 128B,A01,895543,Pappas; Elizabeth,44,0,45,1
1746549805953,EDS 139,A00,897203,Pappas; Elizabeth,44,0,45,1
1746549805953,EDS 139,B00,897209,Fargason; Sharon Gayle,41,0,45,4
1746549806980,EDS 201,A00,895545,Staff,22,0,45,23
1746549808008,EDS 203,A01,895581,Halter; Christopher P.,22,0,45,23
1746549809036,EDS 204R,A01,895625,Heinzman; Erica M.,39,0,45,6
1746549809036,EDS 204R,B01,895693,Halter; Christopher P.,10,0,45,35
1746549810070,EDS 206R,A00,895694,Fargason; Sharon Gayle,1,0,30,29
1746549810070,EDS 206R,B00,895695,Choi; Bailey Miyeon,16,0,30,14
1746549811102,EDS 250,A00,895697,Hemans; Patricia Ann Benitez,22,0,45,23
1746549812127,EDS 281,A00,895701,Meyerott; Theresa Ann,1,0,15,14
1746549813153,EDS 284,A00,895736,Meyerott; Theresa Ann,1,0,15,14
1746549814179,EDS 286,A00,897210,Fine; Sarah,0,0,15,15
1746549815203,EDS 289C,A01,895770,Daly; Alan J.,15,0,15,0
1746549816232,EDS 290,A00,897211,Hofstetter; Carolyn,0,0,15,15
1746549817257,LIGM 5A,A00,896162,Fischer-Grunski; Eva K,13,0,20,7
1746549818285,LIGM 5B,A00,896260,Fischer-Grunski; Eva K,17,0,20,3
1746549819311,LIGM 5C,A00,896308,Fischer-Grunski; Eva K,18,0,20,2
1746549820335,LIIT 5AS,A00,896313,Carnelos; Chiara,18,0,20,2
1746549821360,LIIT 5BS,A00,896416,Carnelos; Chiara,20,0,20,0
1746549822389,LIIT 5CS,A00,896564,Carnelos; Chiara,20,0,20,0
1746549823413,LISP 5A,A00,896588,Munoz Sanchez; Alicia,3,0,20,17
1746549824437,LISP 5B,A00,896653,Munoz Sanchez; Alicia,7,0,20,13
1746549825462,LISP 5C,A00,896655,Munoz Sanchez; Alicia,0,1,20,20
1746549826487,MAE 197,001,957918,Kleissl; Jan,9996,0,9999,3
1746549826487,MAE 197,002,959806,Boechler; Nicholas Sebastia,9998,0,9999,1
1746549826487,MAE 197,003,959852,Mullin; Jennifer S,9998,0,9999,1
1746549827514,MATH 2,A01,957937,Staff,33,0,35,2
1746549828539,MATH 197,001,957876,Kedlaya; Kiran S.,9993,0,9999,6
1746549829565,MCWP 40,A00,892729,Duru; Nur,10,0,20,10
1746549829565,MCWP 40,B00,893304,Montejo; Carolina,14,0,20,6
1746549830591,MCWP 40R,A00,893757,Redela; Pamela Morgan,0,5,20,20
1746549831617,MCWP 50,A00,893758,Morshed; Michael James,0,0,20,20
1746549831617,MCWP 50,B00,893761,Bartulis; Jason Michael,17,0,20,3
1746549832642,MCWP 50R,A00,893766,Compas; Sean Matthew,0,1,20,20
1746549832642,MCWP 50R,B00,893769,Carter; Jennifer A,0,1,20,20
1746549832642,MCWP 50R,C00,893771,Krone; Jarret,0,3,20,20
1746549832642,MCWP 50R,D00,893772,Miller; Elizabeth Deen,0,0,20,20
1746549832642,MCWP 50R,E00,893775,Carter; Andrea L,0,1,20,20
1746549833669,MMW 11R,A01,892721,Herbst; Matthew,11,0,27,16
1746549833669,MMW 11R,A02,892722,Herbst; Matthew,0,0,0,3
1746549834695,MMW 12R,A01,892724,Herbst; Matthew,0,11,16,16
1746549834695,MMW 12R,A02,892725,Herbst; Matthew,0,10,16,16
1746549835721,MMW 13R,A01,892727,Staff,0,4,16,16
1746549835721,MMW 13R,A02,892728,Staff,0,4,16,16
1746549835721,MMW 13R,A03,958032,Staff,0,4,16,16
1746549835721,MMW 13R,A04,958033,Staff,0,4,16,16
1746549835721,MMW 13R,A05,958034,Staff,0,4,16,16
1746549836748,SIO 295LS,A00,894015,Staff,5,0,25,20
1746549837773,SIO 295S,A00,894020,Staff,5,0,25,20
1746549838798,SIOC 290S,B01,958918,Merrifield; Mark A,14,0,30,16
1746549839827,SIOC 291S,B01,958922,Gabriel; Corey John,14,0,30,16
1746549840851,SOCI 117,A01,895339,Staff,3,0,5,2
1746549841879,WES 237B,A00,894149,Staff,11,0,20,9
1746549843935,AESE 279B,A00,891859,Staff,13,0,35,22
1746549844961,AIP 197,001,891854,Vespa; Emanuel Ignacio,9999,0,9999,0
1746549845985,ANTH 289S,A00,891856,Gagneux; Pascal,12,0,12,0
1746549847012,BENG 196,001,957946,Engler; Adam J.,9996,0,9999,3
1746549848038,BISP 197,001,959851,Wilhelm; James E.,9998,0,9999,1
1746549849066,CAT 124RS,A01,956906,Staff,6,0,25,19
1746549850090,CAT 125RS,A01,922013,Staff,6,0,25,19
1746549851113,CLRE 250,A00,891860,Morris; Sheldon,9995,0,9999,4
1746549853162,CLRE 251R,A00,907817,Mehta; Ravindra L.,9994,0,9999,5
1746549854187,CLRE 252,A00,891864,Cuomo; Raphael Eduardo,9993,0,9999,6
1746549855213,CLRE 253,A00,891867,Vaida; Florin,9994,0,9999,5
1746549855213,CLRE 253,B00,907819,Staff,9999,0,9999,0
1746549856237,CLRE 259,A00,891868,Patel; Hemal,9998,0,9999,1
1746549857261,CLRE 260,A00,891872,Cuomo; Raphael Eduardo,9999,0,9999,0
1746549858286,CLRE 297,001,891888,Cuomo; Raphael Eduardo,9999,0,9999,0
1746549859310,CSE 191,A00,958773,Minnes Kemp; Mor Mia,9996,0,9999,3
1746549860335,CSE 197,001,959846,Minnes Kemp; Mor Mia,9990,0,9999,9
1746549861363,CSS 201S,A01,892054,Mignozzetti; Umberto,26,0,30,4
1746549862399,CSS 202S,A01,892056,Mignozzetti; Umberto,26,0,30,4
1746549863427,DSC 197,001,956898,Eldridge; Justin Matthew,9997,0,9999,2
1746549864451,DSC 297,001,958000,Mazumdar; Arya,9998,0,9999,1
1746549864451,DSC 297,002,959862,Wang; Yusu,9999,0,9999,0
1746549865478,EAP 100,A00,905686,Staff,9778,0,9999,221
1746549866507,ECE 45,A01,892618,Staff,0,0,65,65
1746549868558,ECE 111,A01,892719,Staff,4,0,65,61
1746549869585,ECE 197,001,957920,Mercier; Patrick Philip,9991,0,9999,8
1746549870614,ECON 178,A01,907814,Zhu; Ying,26,0,35,9
1746549871639,EDS 115,A00,895312,Staff,36,0,45,9
1746549872663,EDS 117,A01,895337,Staff,24,0,30,6
1746549873690,EDS 125,A00,895341,Jones; Gabrielle Anastasia,37,0,45,8
1746549874714,EDS 128A,A01,895459,Fargason; Sharon Gayle,44,0,45,1
1746549875740,EDS 128B,A01,895543,Pappas; Elizabeth,44,0,45,1
1746549876818,EDS 139,A00,897203,Pappas; Elizabeth,44,0,45,1
1746549876818,EDS 139,B00,897209,Fargason; Sharon Gayle,41,0,45,4
1746549877847,EDS 201,A00,895545,Staff,22,0,45,23
1746549878873,EDS 203,A01,895581,Halter; Christopher P.,22,0,45,23
1746549879900,EDS 204R,A01,895625,Heinzman; Erica M.,39,0,45,6
1746549879900,EDS 204R,B01,895693,Halter; Christopher P.,10,0,45,35
1746549880927,EDS 206R,A00,895694,Fargason; Sharon Gayle,1,0,30,29
1746549880927,EDS 206R,B00,895695,Choi; Bailey Miyeon,16,0,30,14
1746549881952,EDS 250,A00,895697,Hemans; Patricia Ann Benitez,22,0,45,23
1746549882979,EDS 281,A00,895701,Meyerott; Theresa Ann,1,0,15,14
1746549884005,EDS 284,A00,895736,Meyerott; Theresa Ann,1,0,15,14
1746549885030,EDS 286,A00,897210,Fine; Sarah,0,0,15,15
1746549886054,EDS 289C,A01,895770,Daly; Alan J.,15,0,15,0
1746549887081,EDS 290,A00,897211,Hofstetter; Carolyn,0,0,15,15
1746549888105,LIGM 5A,A00,896162,Fischer-Grunski; Eva K,13,0,20,7
1746549889131,LIGM 5B,A00,896260,Fischer-Grunski; Eva K,17,0,20,3
1746549890157,LIGM 5C,A00,896308,Fischer-Grunski; Eva K,18,0,20,2
1746549891181,LIIT 5AS,A00,896313,Carnelos; Chiara,18,0,20,2
1746549892210,LIIT 5BS,A00,896416,Carnelos; Chiara,20,0,20,0
1746549893237,LIIT 5CS,A00,896564,Carnelos; Chiara,20,0,20,0
1746549894264,LISP 5A,A00,896588,Munoz Sanchez; Alicia,3,0,20,17
1746549895289,LISP 5B,A00,896653,Munoz Sanchez; Alicia,7,0,20,13
1746549896313,LISP 5C,A00,896655,Munoz Sanchez; Alicia,0,1,20,20
1746549897337,MAE 197,001,957918,Kleissl; Jan,9996,0,9999,3
1746549897337,MAE 197,002,959806,Boechler; Nicholas Sebastia,9998,0,9999,1
1746549897337,MAE 197,003,959852,Mullin; Jennifer S,9998,0,9999,1
1746549898363,MATH 2,A01,957937,Staff,33,0,35,2
1746549899386,MATH 197,001,957876,Kedlaya; Kiran S.,9993,0,9999,6
1746549900411,MCWP 40,A00,892729,Duru; Nur,10,0,20,10
1746549900411,MCWP 40,B00,893304,Montejo; Carolina,14,0,20,6
1746549901436,MCWP 40R,A00,893757,Redela; Pamela Morgan,0,5,20,20
1746549902463,MCWP 50,A00,893758,Morshed; Michael James,0,0,20,20
1746549902463,MCWP 50,B00,893761,Bartulis; Jason Michael,17,0,20,3
1746549903488,MCWP 50R,A00,893766,Compas; Sean Matthew,0,1,20,20
1746549903488,MCWP 50R,B00,893769,Carter; Jennifer A,0,1,20,20
1746549903488,MCWP 50R,C00,893771,Krone; Jarret,0,3,20,20
1746549903488,MCWP 50R,D00,893772,Miller; Elizabeth Deen,0,0,20,20
1746549903488,MCWP 50R,E00,893775,Carter; Andrea L,0,1,20,20
1746549904513,MMW 11R,A01,892721,Herbst; Matthew,11,0,27,16
1746549904513,MMW 11R,A02,892722,Herbst; Matthew,0,0,0,3
1746549905539,MMW 12R,A01,892724,Herbst; Matthew,0,11,16,16
1746549905539,MMW 12R,A02,892725,Herbst; Matthew,0,10,16,16
1746549906565,MMW 13R,A01,892727,Staff,0,4,16,16
1746549906565,MMW 13R,A02,892728,Staff,0,4,16,16
1746549906565,MMW 13R,A03,958032,Staff,0,4,16,16
1746549906565,MMW 13R,A04,958033,Staff,0,4,16,16
1746549906565,MMW 13R,A05,958034,Staff,0,4,16,16
1746549907592,SIO 295LS,A00,894015,Staff,5,0,25,20
1746549908623,SIO 295S,A00,894020,Staff,5,0,25,20
1746549909650,SIOC 290S,B01,958918,Merrifield; Mark A,14,0,30,16
1746549910677,SIOC 291S,B01,958922,Gabriel; Corey John,14,0,30,16
1746549911702,SOCI 117,A01,895339,Staff,3,0,5,2
1746549912727,WES 237B,A00,894149,Staff,11,0,20,9
1746549914782,AESE 279B,A00,891859,Staff,13,0,35,22
1746549915807,AIP 197,001,891854,Vespa; Emanuel Ignacio,9999,0,9999,0
1746549916830,ANTH 289S,A00,891856,Gagneux; Pascal,12,0,12,0
1746549917854,BENG 196,001,957946,Engler; Adam J.,9996,0,9999,3
1746549918879,BISP 197,001,959851,Wilhelm; James E.,9998,0,9999,1
1746549919904,CAT 124RS,A01,956906,Staff,6,0,25,19
1746549920931,CAT 125RS,A01,922013,Staff,6,0,25,19
1746549921956,CLRE 250,A00,891860,Morris; Sheldon,9995,0,9999,4
1746549924005,CLRE 251R,A00,907817,Mehta; Ravindra L.,9994,0,9999,5
1746549925030,CLRE 252,A00,891864,Cuomo; Raphael Eduardo,9993,0,9999,6
1746549926059,CLRE 253,A00,891867,Vaida; Florin,9994,0,9999,5
1746549926059,CLRE 253,B00,907819,Staff,9999,0,9999,0
1746549927090,CLRE 259,A00,891868,Patel; Hemal,9998,0,9999,1
1746549928117,CLRE 260,A00,891872,Cuomo; Raphael Eduardo,9999,0,9999,0
1746549929143,CLRE 297,001,891888,Cuomo; Raphael Eduardo,9999,0,9999,0
1746549930169,CSE 191,A00,958773,Minnes Kemp; Mor Mia,9996,0,9999,3
1746549931193,CSE 197,001,959846,Minnes Kemp; Mor Mia,9990,0,9999,9
1746549932224,CSS 201S,A01,892054,Mignozzetti; Umberto,26,0,30,4
1746549933252,CSS 202S,A01,892056,Mignozzetti; Umberto,26,0,30,4
1746549934277,DSC 197,001,956898,Eldridge; Justin Matthew,9997,0,9999,2
1746549935300,DSC 297,001,958000,Mazumdar; Arya,9998,0,9999,1
1746549935300,DSC 297,002,959862,Wang; Yusu,9999,0,9999,0
1746549936323,EAP 100,A00,905686,Staff,9778,0,9999,221
1746549937348,ECE 45,A01,892618,Staff,0,0,65,65
1746549939397,ECE 111,A01,892719,Staff,4,0,65,61
1746549940420,ECE 197,001,957920,Mercier; Patrick Philip,9991,0,9999,8
1746549941447,ECON 178,A01,907814,Zhu; Ying,26,0,35,9
1746549942472,EDS 115,A00,895312,Staff,36,0,45,9
1746549943496,EDS 117,A01,895337,Staff,24,0,30,6
1746549944521,EDS 125,A00,895341,Jones; Gabrielle Anastasia,37,0,45,8
1746549945548,EDS 128A,A01,895459,Fargason; Sharon Gayle,44,0,45,1
1746549946576,EDS 128B,A01,895543,Pappas; Elizabeth,44,0,45,1
1746549947602,EDS 139,A00,897203,Pappas; Elizabeth,44,0,45,1
1746549947602,EDS 139,B00,897209,Fargason; Sharon Gayle,41,0,45,4
1746549948626,EDS 201,A00,895545,Staff,22,0,45,23
1746549949649,EDS 203,A01,895581,Halter; Christopher P.,22,0,45,23
1746549950673,EDS 204R,A01,895625,Heinzman; Erica M.,39,0,45,6
1746549950673,EDS 204R,B01,895693,Halter; Christopher P.,10,0,45,35
1746549951700,EDS 206R,A00,895694,Fargason; Sharon Gayle,1,0,30,29
1746549951700,EDS 206R,B00,895695,Choi; Bailey Miyeon,16,0,30,14
1746549952724,EDS 250,A00,895697,Hemans; Patricia Ann Benitez,22,0,45,23
1746549953747,EDS 281,A00,895701,Meyerott; Theresa Ann,1,0,15,14
1746549954775,EDS 284,A00,895736,Meyerott; Theresa Ann,1,0,15,14
1746549955804,EDS 286,A00,897210,Fine; Sarah,0,0,15,15
1746549956827,EDS 289C,A01,895770,Daly; Alan J.,15,0,15,0
1746549957852,EDS 290,A00,897211,Hofstetter; Carolyn,0,0,15,15
1746549958877,LIGM 5A,A00,896162,Fischer-Grunski; Eva K,13,0,20,7
1746549959904,LIGM 5B,A00,896260,Fischer-Grunski; Eva K,17,0,20,3
1746549960934,LIGM 5C,A00,896308,Fischer-Grunski; Eva K,18,0,20,2
1746549961962,LIIT 5AS,A00,896313,Carnelos; Chiara,18,0,20,2
1746549962988,LIIT 5BS,A00,896416,Carnelos; Chiara,20,0,20,0
1746549964015,LIIT 5CS,A00,896564,Carnelos; Chiara,20,0,20,0
1746549965042,LISP 5A,A00,896588,Munoz Sanchez; Alicia,3,0,20,17
1746549966065,LISP 5B,A00,896653,Munoz Sanchez; Alicia,7,0,20,13
1746549967092,LISP 5C,A00,896655,Munoz Sanchez; Alicia,0,1,20,20
1746549968118,MAE 197,001,957918,Kleissl; Jan,9996,0,9999,3
1746549968118,MAE 197,002,959806,Boechler; Nicholas Sebastia,9998,0,9999,1
1746549968118,MAE 197,003,959852,Mullin; Jennifer S,9998,0,9999,1
1746549969145,MATH 2,A01,957937,Staff,33,0,35,2
1746549970172,MATH 197,001,957876,Kedlaya; Kiran S.,9993,0,9999,6
1746549971197,MCWP 40,A00,892729,Duru; Nur,10,0,20,10
1746549971197,MCWP 40,B00,893304,Montejo; Carolina,14,0,20,6
1746549972225,MCWP 40R,A00,893757,Redela; Pamela Morgan,0,5,20,20
1746549973252,MCWP 50,A00,893758,Morshed; Michael James,0,0,20,20
1746549973252,MCWP 50,B00,893761,Bartulis; Jason Michael,17,0,20,3
1746549974278,MCWP 50R,A00,893766,Compas; Sean Matthew,0,1,20,20
1746549974278,MCWP 50R,B00,893769,Carter; Jennifer A,0,1,20,20
1746549974278,MCWP 50R,C00,893771,Krone; Jarret,0,3,20,20
1746549974278,MCWP 50R,D00,893772,Miller; Elizabeth Deen,0,0,20,20
1746549974278,MCWP 50R,E00,893775,Carter; Andrea L,0,1,20,20
1746549975306,MMW 11R,A01,892721,Herbst; Matthew,11,0,27,16
1746549975306,MMW 11R,A02,892722,Herbst; Matthew,0,0,0,3
1746549976331,MMW 12R,A01,892724,Herbst; Matthew,0,11,16,16
1746549976331,MMW 12R,A02,892725,Herbst; Matthew,0,10,16,16
1746549977357,MMW 13R,A01,892727,Staff,0,4,16,16
1746549977357,MMW 13R,A02,892728,Staff,0,4,16,16
1746549977357,MMW 13R,A03,958032,Staff,0,4,16,16
1746549977357,MMW 13R,A04,958033,Staff,0,4,16,16
1746549977357,MMW 13R,A05,958034,Staff,0,4,16,16
1746549978380,SIO 295LS,A00,894015,Staff,5,0,25,20
1746549979404,SIO 295S,A00,894020,Staff,5,0,25,20
1746549980433,SIOC 290S,B01,958918,Merrifield; Mark A,14,0,30,16
1746549981458,SIOC 291S,B01,958922,Gabriel; Corey John,14,0,30,16
1746549982483,SOCI 117,A01,895339,Staff,3,0,5,2
1746549983507,WES 237B,A00,894149,Staff,11,0,20,9
1746549985574,AESE 279B,A00,891859,Staff,13,0,35,22
1746549986598,AIP 197,001,891854,Vespa; Emanuel Ignacio,9999,0,9999,0
1746549987623,ANTH 289S,A00,891856,Gagneux; Pascal,12,0,12,0
1746549988648,BENG 196,001,957946,Engler; Adam J.,9996,0,9999,3
1746549989675,BISP 197,001,959851,Wilhelm; James E.,9998,0,9999,1
1746549990702,CAT 124RS,A01,956906,Staff,6,0,25,19
1746549991727,CAT 125RS,A01,922013,Staff,6,0,25,19
1746549992751,CLRE 250,A00,891860,Morris; Sheldon,9995,0,9999,4
1746549994800,CLRE 251R,A00,907817,Mehta; Ravindra L.,9994,0,9999,5
1746549995823,CLRE 252,A00,891864,Cuomo; Raphael Eduardo,9993,0,9999,6
1746549996846,CLRE 253,A00,891867,Vaida; Florin,9994,0,9999,5
1746549996846,CLRE 253,B00,907819,Staff,9999,0,9999,0
1746549997868,CLRE 259,A00,891868,Patel; Hemal,9998,0,9999,1
1746549998894,CLRE 260,A00,891872,Cuomo; Raphael Eduardo,9999,0,9999,0
1746549999921,CLRE 297,001,891888,Cuomo; Raphael Eduardo,9999,0,9999,0
1746550000947,CSE 191,A00,958773,Minnes Kemp; Mor Mia,9996,0,9999,3
1746550001972,CSE 197,001,959846,Minnes Kemp; Mor Mia,9990,0,9999,9
1746550003001,CSS 201S,A01,892054,Mignozzetti; Umberto,26,0,30,4
1746550004029,CSS 202S,A01,892056,Mignozzetti; Umberto,26,0,30,4
1746550005054,DSC 197,001,956898,Eldridge; Justin Matthew,9997,0,9999,2
1746550006082,DSC 297,001,958000,Mazumdar; Arya,9998,0,9999,1
1746550006082,DSC 297,002,959862,Wang; Yusu,9999,0,9999,0
1746550007106,EAP 100,A00,905686,Staff,9778,0,9999,221
1746550008130,ECE 45,A01,892618,Staff,0,0,65,65
1746550010180,ECE 111,A01,892719,Staff,4,0,65,61
1746550011204,ECE 197,001,957920,Mercier; Patrick Philip,9991,0,9999,8
1746550012233,ECON 178,A01,907814,Zhu; Ying,26,0,35,9
1746550013259,EDS 115,A00,895312,Staff,36,0,45,9
1746550014285,EDS 117,A01,895337,Staff,24,0,30,6
1746550015309,EDS 125,A00,895341,Jones; Gabrielle Anastasia,37,0,45,8
1746550016336,EDS 128A,A01,895459,Fargason; Sharon Gayle,44,0,45,1
1746550017363,EDS 128B,A01,895543,Pappas; Elizabeth,44,0,45,1
1746550018387,EDS 139,A00,897203,Pappas; Elizabeth,44,0,45,1
1746550018387,EDS 139,B00,897209,Fargason; Sharon Gayle,41,0,45,4
1746550019413,EDS 201,A00,895545,Staff,22,0,45,23
1746550020441,EDS 203,A01,895581,Halter; Christopher P.,22,0,45,23
1746550021468,EDS 204R,A01,895625,Heinzman; Erica M.,39,0,45,6
1746550021468,EDS 204R,B01,895693,Halter; Christopher P.,10,0,45,35
1746550022496,EDS 206R,A00,895694,Fargason; Sharon Gayle,1,0,30,29
1746550022496,EDS 206R,B00,895695,Choi; Bailey Miyeon,16,0,30,14
1746550023524,EDS 250,A00,895697,Hemans; Patricia Ann Benitez,22,0,45,23
1746550024553,EDS 281,A00,895701,Meyerott; Theresa Ann,1,0,15,14
1746550025579,EDS 284,A00,895736,Meyerott; Theresa Ann,1,0,15,14
1746550026603,EDS 286,A00,897210,Fine; Sarah,0,0,15,15
1746550027628,EDS 289C,A01,895770,Daly; Alan J.,15,0,15,0
1746550028655,EDS 290,A00,897211,Hofstetter; Carolyn,0,0,15,15
1746550029683,LIGM 5A,A00,896162,Fischer-Grunski; Eva K,13,0,20,7
1746550030714,LIGM 5B,A00,896260,Fischer-Grunski; Eva K,17,0,20,3
1746550031743,LIGM 5C,A00,896308,Fischer-Grunski; Eva K,18,0,20,2
1746550032770,LIIT 5AS,A00,896313,Carnelos; Chiara,18,0,20,2
1746550033795,LIIT 5BS,A00,896416,Carnelos; Chiara,20,0,20,0
1746550034822,LIIT 5CS,A00,896564,Carnelos; Chiara,20,0,20,0
1746550035851,LISP 5A,A00,896588,Munoz Sanchez; Alicia,3,0,20,17
1746550036880,LISP 5B,A00,896653,Munoz Sanchez; Alicia,7,0,20,13
1746550037907,LISP 5C,A00,896655,Munoz Sanchez; Alicia,0,1,20,20
1746550038935,MAE 197,001,957918,Kleissl; Jan,9996,0,9999,3
1746550038935,MAE 197,002,959806,Boechler; Nicholas Sebastia,9998,0,9999,1
1746550038935,MAE 197,003,959852,Mullin; Jennifer S,9998,0,9999,1
1746550039966,MATH 2,A01,957937,Staff,33,0,35,2
1746550040992,MATH 197,001,957876,Kedlaya; Kiran S.,9993,0,9999,6
1746550042021,MCWP 40,A00,892729,Duru; Nur,10,0,20,10
1746550042021,MCWP 40,B00,893304,Montejo; Carolina,14,0,20,6
1746550043046,MCWP 40R,A00,893757,Redela; Pamela Morgan,0,5,20,20
1746550044072,MCWP 50,A00,893758,Morshed; Michael James,0,0,20,20
1746550044072,MCWP 50,B00,893761,Bartulis; Jason Michael,17,0,20,3
1746550045099,MCWP 50R,A00,893766,Compas; Sean Matthew,0,1,20,20
1746550045099,MCWP 50R,B00,893769,Carter; Jennifer A,0,1,20,20
1746550045099,MCWP 50R,C00,893771,Krone; Jarret,0,3,20,20
1746550045099,MCWP 50R,D00,893772,Miller; Elizabeth Deen,0,0,20,20
1746550045099,MCWP 50R,E00,893775,Carter; Andrea L,0,1,20,20
1746550046129,MMW 11R,A01,892721,Herbst; Matthew,11,0,27,16
1746550046129,MMW 11R,A02,892722,Herbst; Matthew,0,0,0,3
1746550047155,MMW 12R,A01,892724,Herbst; Matthew,0,11,16,16
1746550047155,MMW 12R,A02,892725,Herbst; Matthew,0,10,16,16
1746550048180,MMW 13R,A01,892727,Staff,0,4,16,16
1746550048180,MMW 13R,A02,892728,Staff,0,4,16,16
1746550048180,MMW 13R,A03,958032,Staff,0,4,16,16
1746550048180,MMW 13R,A04,958033,Staff,0,4,16,16
1746550048180,MMW 13R,A05,958034,Staff,0,4,16,16
1746550049207,SIO 295LS,A00,894015,Staff,5,0,25,20
1746550050238,SIO 295S,A00,894020,Staff,5,0,25,20
1746550051263,SIOC 290S,B01,958918,Merrifield; Mark A,14,0,30,16
1746550052290,SIOC 291S,B01,958922,Gabriel; Corey John,14,0,30,16
1746550053317,SOCI 117,A01,895339,Staff,3,0,5,2
1746550054341,WES 237B,A00,894149,Staff,11,0,20,9
1746550056396,AESE 279B,A00,891859,Staff,13,0,35,22
1746550057423,AIP 197,001,891854,Vespa; Emanuel Ignacio,9999,0,9999,0
1746550058447,ANTH 289S,A00,891856,Gagneux; Pascal,12,0,12,0
1746550059474,BENG 196,001,957946,Engler; Adam J.,9996,0,9999,3
1746550060498,BISP 197,001,959851,Wilhelm; James E.,9998,0,9999,1
1746550061522,CAT 124RS,A01,956906,Staff,6,0,25,19
1746550062548,CAT 125RS,A01,922013,Staff,6,0,25,19
1746550063572,CLRE 250,A00,891860,Morris; Sheldon,9995,0,9999,4
1746550065624,CLRE 251R,A00,907817,Mehta; Ravindra L.,9994,0,9999,5
1746550066652,CLRE 252,A00,891864,Cuomo; Raphael Eduardo,9993,0,9999,6
1746550067678,CLRE 253,A00,891867,Vaida; Florin,9994,0,9999,5
1746550067678,CLRE 253,B00,907819,Staff,9999,0,9999,0
1746550068706,CLRE 259,A00,891868,Patel; Hemal,9998,0,9999,1
1746550069733,CLRE 260,A00,891872,Cuomo; Raphael Eduardo,9999,0,9999,0
1746550070761,CLRE 297,001,891888,Cuomo; Raphael Eduardo,9999,0,9999,0
1746550071787,CSE 191,A00,958773,Minnes Kemp; Mor Mia,9996,0,9999,3
1746550072811,CSE 197,001,959846,Minnes Kemp; Mor Mia,9990,0,9999,9
1746550073835,CSS 201S,A01,892054,Mignozzetti; Umberto,26,0,30,4
1746550074874,CSS 202S,A01,892056,Mignozzetti; Umberto,26,0,30,4
1746550075898,DSC 197,001,956898,Eldridge; Justin Matthew,9997,0,9999,2
1746550076922,DSC 297,001,958000,Mazumdar; Arya,9998,0,9999,1
1746550076922,DSC 297,002,959862,Wang; Yusu,9999,0,9999,0
1746550077946,EAP 100,A00,905686,Staff,9778,0,9999,221
1746550078975,ECE 45,A01,892618,Staff,0,0,65,65
1746550081028,ECE 111,A01,892719,Staff,4,0,65,61
1746550082052,ECE 197,001,957920,Mercier; Patrick Philip,9991,0,9999,8
1746550083077,ECON 178,A01,907814,Zhu; Ying,26,0,35,9
1746550084105,EDS 115,A00,895312,Staff,36,0,45,9
1746550085129,EDS 117,A01,895337,Staff,24,0,30,6
1746550086155,EDS 125,A00,895341,Jones; Gabrielle Anastasia,37,0,45,8
1746550087180,EDS 128A,A01,895459,Fargason; Sharon Gayle,44,0,45,1
1746550088205,EDS 128B,A01,895543,Pappas; Elizabeth,44,0,45,1
1746550089232,EDS 139,A00,897203,Pappas; Elizabeth,44,0,45,1
1746550089232,EDS 139,B00,897209,Fargason; Sharon Gayle,41,0,45,4
1746550090256,EDS 201,A00,895545,Staff,22,0,45,23
1746550091300,EDS 203,A01,895581,Halter; Christopher P.,22,0,45,23
1746550092325,EDS 204R,A01,895625,Heinzman; Erica M.,39,0,45,6
1746550092325,EDS 204R,B01,895693,Halter; Christopher P.,10,0,45,35
1746550093351,EDS 206R,A00,895694,Fargason; Sharon Gayle,1,0,30,29
1746550093351,EDS 206R,B00,895695,Choi; Bailey Miyeon,16,0,30,14
1746550094376,EDS 250,A00,895697,Hemans; Patricia Ann Benitez,22,0,45,23
1746550095403,EDS 281,A00,895701,Meyerott; Theresa Ann,1,0,15,14
1746550096427,EDS 284,A00,895736,Meyerott; Theresa Ann,1,0,15,14
1746550097453,EDS 286,A00,897210,Fine; Sarah,0,0,15,15
1746550098477,EDS 289C,A01,895770,Daly; Alan J.,15,0,15,0
1746550099504,EDS 290,A00,897211,Hofstetter; Carolyn,0,0,15,15
1746550100528,LIGM 5A,A00,896162,Fischer-Grunski; Eva K,13,0,20,7
1746550101556,LIGM 5B,A00,896260,Fischer-Grunski; Eva K,17,0,20,3
1746550102582,LIGM 5C,A00,896308,Fischer-Grunski; Eva K,18,0,20,2
1746550103608,LIIT 5AS,A00,896313,Carnelos; Chiara,18,0,20,2
1746550104633,LIIT 5BS,A00,896416,Carnelos; Chiara,20,0,20,0
1746550105659,LIIT 5CS,A00,896564,Carnelos; Chiara,20,0,20,0
1746550106686,LISP 5A,A00,896588,Munoz Sanchez; Alicia,3,0,20,17
1746550107711,LISP 5B,A00,896653,Munoz Sanchez; Alicia,7,0,20,13
1746550108738,LISP 5C,A00,896655,Munoz Sanchez; Alicia,0,1,20,20
1746550109769,MAE 197,001,957918,Kleissl; Jan,9996,0,9999,3
1746550109769,MAE 197,002,959806,Boechler; Nicholas Sebastia,9998,0,9999,1
1746550109769,MAE 197,003,959852,Mullin; Jennifer S,9998,0,9999,1
1746550110794,MATH 2,A01,957937,Staff,33,0,35,2
1746550111820,MATH 197,001,957876,Kedlaya; Kiran S.,9993,0,9999,6
1746550112845,MCWP 40,A00,892729,Duru; Nur,10,0,20,10
1746550112845,MCWP 40,B00,893304,Montejo; Carolina,14,0,20,6
1746550113869,MCWP 40R,A00,893757,Redela; Pamela Morgan,0,5,20,20
1746550114896,MCWP 50,A00,893758,Morshed; Michael James,0,0,20,20
1746550114896,MCWP 50,B00,893761,Bartulis; Jason Michael,17,0,20,3
1746550115922,MCWP 50R,A00,893766,Compas; Sean Matthew,0,1,20,20
1746550115922,MCWP 50R,B00,893769,Carter; Jennifer A,0,1,20,20
1746550115922,MCWP 50R,C00,893771,Krone; Jarret,0,3,20,20
1746550115922,MCWP 50R,D00,893772,Miller; Elizabeth Deen,0,0,20,20
1746550115922,MCWP 50R,E00,893775,Carter; Andrea L,0,1,20,20
1746550116949,MMW 11R,A01,892721,Herbst; Matthew,11,0,27,16
1746550116949,MMW 11R,A02,892722,Herbst; Matthew,0,0,0,3
1746550117976,MMW 12R,A01,892724,Herbst; Matthew,0,11,16,16
1746550117976,MMW 12R,A02,892725,Herbst; Matthew,0,10,16,16
1746550119005,MMW 13R,A01,892727,Staff,0,4,16,16
1746550119005,MMW 13R,A02,892728,Staff,0,4,16,16
1746550119005,MMW 13R,A03,958032,Staff,0,4,16,16
1746550119005,MMW 13R,A04,958033,Staff,0,4,16,16
1746550119005,MMW 13R,A05,958034,Staff,0,4,16,16
1746550120031,SIO 295LS,A00,894015,Staff,5,0,25,20
1746550121056,SIO 295S,A00,894020,Staff,5,0,25,20
1746550122083,SIOC 290S,B01,958918,Merrifield; Mark A,14,0,30,16
1746550123114,SIOC 291S,B01,958922,Gabriel; Corey John,14,0,30,16
1746550124139,SOCI 117,A01,895339,Staff,3,0,5,2
1746550125164,WES 237B,A00,894149,Staff,11,0,20,9
1746550127228,AESE 279B,A00,891859,Staff,13,0,35,22
1746550128258,AIP 197,001,891854,Vespa; Emanuel Ignacio,9999,0,9999,0
1746550129282,ANTH 289S,A00,891856,Gagneux; Pascal,12,0,12,0
1746550130306,BENG 196,001,957946,Engler; Adam J.,9996,0,9999,3
1746550131336,BISP 197,001,959851,Wilhelm; James E.,9998,0,9999,1
1746550132360,CAT 124RS,A01,956906,Staff,6,0,25,19
1746550133384,CAT 125RS,A01,922013,Staff,6,0,25,19
1746550134412,CLRE 250,A00,891860,Morris; Sheldon,9995,0,9999,4
1746550136461,CLRE 251R,A00,907817,Mehta; Ravindra L.,9994,0,9999,5
1746550137486,CLRE 252,A00,891864,Cuomo; Raphael Eduardo,9993,0,9999,6
1746550138514,CLRE 253,A00,891867,Vaida; Florin,9994,0,9999,5
1746550138514,CLRE 253,B00,907819,Staff,9999,0,9999,0
1746550139541,CLRE 259,A00,891868,Patel; Hemal,9998,0,9999,1
1746550140568,CLRE 260,A00,891872,Cuomo; Raphael Eduardo,9999,0,9999,0
1746550141591,CLRE 297,001,891888,Cuomo; Raphael Eduardo,9999,0,9999,0
1746550142619,CSE 191,A00,958773,Minnes Kemp; Mor Mia,9996,0,9999,3
1746550143646,CSE 197,001,959846,Minnes Kemp; Mor Mia,9990,0,9999,9
1746550144673,CSS 201S,A01,892054,Mignozzetti; Umberto,26,0,30,4
1746550145698,CSS 202S,A01,892056,Mignozzetti; Umberto,26,0,30,4
1746550146723,DSC 197,001,956898,Eldridge; Justin Matthew,9997,0,9999,2
1746550147749,DSC 297,001,958000,Mazumdar; Arya,9998,0,9999,1
1746550147749,DSC 297,002,959862,Wang; Yusu,9999,0,9999,0
1746550148773,EAP 100,A00,905686,Staff,9778,0,9999,221
1746550149803,ECE 45,A01,892618,Staff,0,0,65,65
1746550151856,ECE 111,A01,892719,Staff,4,0,65,61
1746550152885,ECE 197,001,957920,Mercier; Patrick Philip,9991,0,9999,8
1746550153911,ECON 178,A01,907814,Zhu; Ying,26,0,35,9
1746550154935,EDS 115,A00,895312,Staff,36,0,45,9
1746550155960,EDS 117,A01,895337,Staff,24,0,30,6
1746550156985,EDS 125,A00,895341,Jones; Gabrielle Anastasia,37,0,45,8
1746550158011,EDS 128A,A01,895459,Fargason; Sharon Gayle,44,0,45,1
1746550159037,EDS 128B,A01,895543,Pappas; Elizabeth,44,0,45,1
1746550160067,EDS 139,A00,897203,Pappas; Elizabeth,44,0,45,1
1746550160067,EDS 139,B00,897209,Fargason; Sharon Gayle,41,0,45,4
1746550161091,EDS 201,A00,895545,Staff,22,0,45,23
1746550162116,EDS 203,A01,895581,Halter; Christopher P.,22,0,45,23
1746550163143,EDS 204R,A01,895625,Heinzman; Erica M.,39,0,45,6
1746550163143,EDS 204R,B01,895693,Halter; Christopher P.,10,0,45,35
1746550164171,EDS 206R,A00,895694,Fargason; Sharon Gayle,1,0,30,29
1746550164171,EDS 206R,B00,895695,Choi; Bailey Miyeon,16,0,30,14
1746550165195,EDS 250,A00,895697,Hemans; Patricia Ann Benitez,22,0,45,23
1746550166219,EDS 281,A00,895701,Meyerott; Theresa Ann,1,0,15,14
1746550167244,EDS 284,A00,895736,Meyerott; Theresa Ann,1,0,15,14
1746550168270,EDS 286,A00,897210,Fine; Sarah,0,0,15,15
1746550169297,EDS 289C,A01,895770,Daly; Alan J.,15,0,15,0
1746550170324,EDS 290,A00,897211,Hofstetter; Carolyn,0,0,15,15
1746550171348,LIGM 5A,A00,896162,Fischer-Grunski; Eva K,13,0,20,7
1746550172372,LIGM 5B,A00,896260,Fischer-Grunski; Eva K,17,0,20,3
1746550173401,LIGM 5C,A00,896308,Fischer-Grunski; Eva K,18,0,20,2
1746550174424,LIIT 5AS,A00,896313,Carnelos; Chiara,18,0,20,2
1746550175454,LIIT 5BS,A00,896416,Carnelos; Chiara,20,0,20,0
1746550176480,LIIT 5CS,A00,896564,Carnelos; Chiara,20,0,20,0
1746550177510,LISP 5A,A00,896588,Munoz Sanchez; Alicia,3,0,20,17
1746550178540,LISP 5B,A00,896653,Munoz Sanchez; Alicia,7,0,20,13
1746550179565,LISP 5C,A00,896655,Munoz Sanchez; Alicia,0,1,20,20
1746550180593,MAE 197,001,957918,Kleissl; Jan,9996,0,9999,3
1746550180593,MAE 197,002,959806,Boechler; Nicholas Sebastia,9998,0,9999,1
1746550180593,MAE 197,003,959852,Mullin; Jennifer S,9998,0,9999,1
1746550181618,MATH 2,A01,957937,Staff,33,0,35,2
1746550182644,MATH 197,001,957876,Kedlaya; Kiran S.,9993,0,9999,6
1746550183669,MCWP 40,A00,892729,Duru; Nur,10,0,20,10
1746550183669,MCWP 40,B00,893304,Montejo; Carolina,14,0,20,6
1746550184696,MCWP 40R,A00,893757,Redela; Pamela Morgan,0,5,20,20
1746550185724,MCWP 50,A00,893758,Morshed; Michael James,0,0,20,20
1746550185724,MCWP 50,B00,893761,Bartulis; Jason Michael,17,0,20,3
1746550186754,MCWP 50R,A00,893766,Compas; Sean Matthew,0,1,20,20
1746550186754,MCWP 50R,B00,893769,Carter; Jennifer A,0,1,20,20
1746550186754,MCWP 50R,C00,893771,Krone; Jarret,0,3,20,20
1746550186754,MCWP 50R,D00,893772,Miller; Elizabeth Deen,0,0,20,20
1746550186754,MCWP 50R,E00,893775,Carter; Andrea L,0,1,20,20
1746550187783,MMW 11R,A01,892721,Herbst; Matthew,11,0,27,16
1746550187783,MMW 11R,A02,892722,Herbst; Matthew,0,0,0,3
1746550188810,MMW 12R,A01,892724,Herbst; Matthew,0,11,16,16
1746550188810,MMW 12R,A02,892725,Herbst; Matthew,0,10,16,16
1746550189839,MMW 13R,A01,892727,Staff,0,4,16,16
1746550189839,MMW 13R,A02,892728,Staff,0,4,16,16
1746550189839,MMW 13R,A03,958032,Staff,0,4,16,16
1746550189839,MMW 13R,A04,958033,Staff,0,4,16,16
1746550189839,MMW 13R,A05,958034,Staff,0,4,16,16
1746550190864,SIO 295LS,A00,894015,Staff,5,0,25,20
1746550191889,SIO 295S,A00,894020,Staff,5,0,25,20
1746550192915,SIOC 290S,B01,958918,Merrifield; Mark A,14,0,30,16
1746550193945,SIOC 291S,B01,958922,Gabriel; Corey John,14,0,30,16
1746550194973,SOCI 117,A01,895339,Staff,3,0,5,2
1746550195998,WES 237B,A00,894149,Staff,11,0,20,9
1746550198064,AESE 279B,A00,891859,Staff,13,0,35,22
1746550199087,AIP 197,001,891854,Vespa; Emanuel Ignacio,9999,0,9999,0
1746550200130,ANTH 289S,A00,891856,Gagneux; Pascal,12,0,12,0
1746550201157,BENG 196,001,957946,Engler; Adam J.,9996,0,9999,3
1746550202185,BISP 197,001,959851,Wilhelm; James E.,9998,0,9999,1
1746550203210,CAT 124RS,A01,956906,Staff,6,0,25,19
1746550204237,CAT 125RS,A01,922013,Staff,6,0,25,19
1746550205263,CLRE 250,A00,891860,Morris; Sheldon,9995,0,9999,4
1746550207317,CLRE 251R,A00,907817,Mehta; Ravindra L.,9994,0,9999,5
1746550208344,CLRE 252,A00,891864,Cuomo; Raphael Eduardo,9993,0,9999,6
1746550209369,CLRE 253,A00,891867,Vaida; Florin,9994,0,9999,5
1746550209369,CLRE 253,B00,907819,Staff,9999,0,9999,0
1746550210398,CLRE 259,A00,891868,Patel; Hemal,9998,0,9999,1
1746550211424,CLRE 260,A00,891872,Cuomo; Raphael Eduardo,9999,0,9999,0
1746550212449,CLRE 297,001,891888,Cuomo; Raphael Eduardo,9999,0,9999,0
1746550213476,CSE 191,A00,958773,Minnes Kemp; Mor Mia,9996,0,9999,3
1746550214502,CSE 197,001,959846,Minnes Kemp; Mor Mia,9990,0,9999,9
1746550215529,CSS 201S,A01,892054,Mignozzetti; Umberto,26,0,30,4
1746550216554,CSS 202S,A01,892056,Mignozzetti; Umberto,26,0,30,4
1746550217579,DSC 197,001,956898,Eldridge; Justin Matthew,9997,0,9999,2
1746550218604,DSC 297,001,958000,Mazumdar; Arya,9998,0,9999,1
1746550218604,DSC 297,002,959862,Wang; Yusu,9999,0,9999,0
1746550219632,EAP 100,A00,905686,Staff,9778,0,9999,221
1746550220656,ECE 45,A01,892618,Staff,0,0,65,65
1746550222709,ECE 111,A01,892719,Staff,4,0,65,61
1746550223737,ECE 197,001,957920,Mercier; Patrick Philip,9991,0,9999,8
1746550224762,ECON 178,A01,907814,Zhu; Ying,26,0,35,9
1746550225787,EDS 115,A00,895312,Staff,36,0,45,9
1746550226812,EDS 117,A01,895337,Staff,24,0,30,6
1746550227836,EDS 125,A00,895341,Jones; Gabrielle Anastasia,37,0,45,8
1746550228862,EDS 128A,A01,895459,Fargason; Sharon Gayle,44,0,45,1
1746550229886,EDS 128B,A01,895543,Pappas; Elizabeth,44,0,45,1
1746550230910,EDS 139,A00,897203,Pappas; Elizabeth,44,0,45,1
1746550230910,EDS 139,B00,897209,Fargason; Sharon Gayle,41,0,45,4
1746550231934,EDS 201,A00,895545,Staff,22,0,45,23
1746550232961,EDS 203,A01,895581,Halter; Christopher P.,22,0,45,23
1746550233988,EDS 204R,A01,895625,Heinzman; Erica M.,39,0,45,6
1746550233988,EDS 204R,B01,895693,Halter; Christopher P.,10,0,45,35
1746550235019,EDS 206R,A00,895694,Fargason; Sharon Gayle,1,0,30,29
1746550235019,EDS 206R,B00,895695,Choi; Bailey Miyeon,16,0,30,14
1746550236044,EDS 250,A00,895697,Hemans; Patricia Ann Benitez,22,0,45,23
1746550237071,EDS 281,A00,895701,Meyerott; Theresa Ann,1,0,15,14
1746550238097,EDS 284,A00,895736,Meyerott; Theresa Ann,1,0,15,14
1746550239126,EDS 286,A00,897210,Fine; Sarah,0,0,15,15
1746550240151,EDS 289C,A01,895770,Daly; Alan J.,15,0,15,0
1746550241181,EDS 290,A00,897211,Hofstetter; Carolyn,0,0,15,15
1746550242206,LIGM 5A,A00,896162,Fischer-Grunski; Eva K,13,0,20,7
1746550243246,LIGM 5B,A00,896260,Fischer-Grunski; Eva K,17,0,20,3
1746550244276,LIGM 5C,A00,896308,Fischer-Grunski; Eva K,18,0,20,2
1746550245305,LIIT 5AS,A00,896313,Carnelos; Chiara,18,0,20,2
1746550246339,LIIT 5BS,A00,896416,Carnelos; Chiara,20,0,20,0
1746550247366,LIIT 5CS,A00,896564,Carnelos; Chiara,20,0,20,0
1746550248392,LISP 5A,A00,896588,Munoz Sanchez; Alicia,3,0,20,17
1746550249420,LISP 5B,A00,896653,Munoz Sanchez; Alicia,7,0,20,13
1746550250445,LISP 5C,A00,896655,Munoz Sanchez; Alicia,0,1,20,20
1746550251470,MAE 197,001,957918,Kleissl; Jan,9996,0,9999,3
1746550251470,MAE 197,002,959806,Boechler; Nicholas Sebastia,9998,0,9999,1
1746550251470,MAE 197,003,959852,Mullin; Jennifer S,9998,0,9999,1
1746550252494,MATH 2,A01,957937,Staff,33,0,35,2
1746550253519,MATH 197,001,957876,Kedlaya; Kiran S.,9993,0,9999,6
1746550254548,MCWP 40,A00,892729,Duru; Nur,10,0,20,10
1746550254548,MCWP 40,B00,893304,Montejo; Carolina,14,0,20,6
1746550255576,MCWP 40R,A00,893757,Redela; Pamela Morgan,0,5,20,20
1746550256600,MCWP 50,A00,893758,Morshed; Michael James,0,0,20,20
1746550256600,MCWP 50,B00,893761,Bartulis; Jason Michael,17,0,20,3
1746550257630,MCWP 50R,A00,893766,Compas; Sean Matthew,0,1,20,20
1746550257630,MCWP 50R,B00,893769,Carter; Jennifer A,0,1,20,20
1746550257630,MCWP 50R,C00,893771,Krone; Jarret,0,3,20,20
1746550257630,MCWP 50R,D00,893772,Miller; Elizabeth Deen,0,0,20,20
1746550257630,MCWP 50R,E00,893775,Carter; Andrea L,0,1,20,20
1746550258656,MMW 11R,A01,892721,Herbst; Matthew,11,0,27,16
1746550258656,MMW 11R,A02,892722,Herbst; Matthew,0,0,0,3
1746550259684,MMW 12R,A01,892724,Herbst; Matthew,0,11,16,16
1746550259684,MMW 12R,A02,892725,Herbst; Matthew,0,10,16,16
1746550260708,MMW 13R,A01,892727,Staff,0,4,16,16
1746550260708,MMW 13R,A02,892728,Staff,0,4,16,16
1746550260708,MMW 13R,A03,958032,Staff,0,4,16,16
1746550260708,MMW 13R,A04,958033,Staff,0,4,16,16
1746550260708,MMW 13R,A05,958034,Staff,0,4,16,16
1746550261733,SIO 295LS,A00,894015,Staff,5,0,25,20
1746550262760,SIO 295S,A00,894020,Staff,5,0,25,20
1746550263784,SIOC 290S,B01,958918,Merrifield; Mark A,14,0,30,16
1746550264814,SIOC 291S,B01,958922,Gabriel; Corey John,14,0,30,16
1746550265841,SOCI 117,A01,895339,Staff,3,0,5,2
1746550266866,WES 237B,A00,894149,Staff,11,0,20,9
1746550268922,AESE 279B,A00,891859,Staff,13,0,35,22
1746550269946,AIP 197,001,891854,Vespa; Emanuel Ignacio,9999,0,9999,0
1746550270970,ANTH 289S,A00,891856,Gagneux; Pascal,12,0,12,0
1746550271999,BENG 196,001,957946,Engler; Adam J.,9996,0,9999,3
1746550273025,BISP 197,001,959851,Wilhelm; James E.,9998,0,9999,1
1746550274050,CAT 124RS,A01,956906,Staff,6,0,25,19
1746550275073,CAT 125RS,A01,922013,Staff,6,0,25,19
1746550276103,CLRE 250,A00,891860,Morris; Sheldon,9995,0,9999,4
1746550278160,CLRE 251R,A00,907817,Mehta; Ravindra L.,9994,0,9999,5
1746550279189,CLRE 252,A00,891864,Cuomo; Raphael Eduardo,9993,0,9999,6
1746550280214,CLRE 253,A00,891867,Vaida; Florin,9994,0,9999,5
1746550280214,CLRE 253,B00,907819,Staff,9999,0,9999,0
1746550281240,CLRE 259,A00,891868,Patel; Hemal,9998,0,9999,1
1746550282269,CLRE 260,A00,891872,Cuomo; Raphael Eduardo,9999,0,9999,0
1746550283296,CLRE 297,001,891888,Cuomo; Raphael Eduardo,9999,0,9999,0
1746550284320,CSE 191,A00,958773,Minnes Kemp; Mor Mia,9996,0,9999,3
1746550285347,CSE 197,001,959846,Minnes Kemp; Mor Mia,9990,0,9999,9
1746550286370,CSS 201S,A01,892054,Mignozzetti; Umberto,26,0,30,4
1746550287396,CSS 202S,A01,892056,Mignozzetti; Umberto,26,0,30,4
1746550288419,DSC 197,001,956898,Eldridge; Justin Matthew,9997,0,9999,2
1746550289442,DSC 297,001,958000,Mazumdar; Arya,9998,0,9999,1
1746550289442,DSC 297,002,959862,Wang; Yusu,9999,0,9999,0
1746550290465,EAP 100,A00,905686,Staff,9778,0,9999,221
1746550291491,ECE 45,A01,892618,Staff,0,0,65,65
1746550293541,ECE 111,A01,892719,Staff,4,0,65,61
1746550294564,ECE 197,001,957920,Mercier; Patrick Philip,9991,0,9999,8
1746550295590,ECON 178,A01,907814,Zhu; Ying,26,0,35,9
1746550296614,EDS 115,A00,895312,Staff,36,0,45,9
1746550297641,EDS 117,A01,895337,Staff,24,0,30,6
1746550298670,EDS 125,A00,895341,Jones; Gabrielle Anastasia,37,0,45,8
1746550299694,EDS 128A,A01,895459,Fargason; Sharon Gayle,44,0,45,1
1746550300725,EDS 128B,A01,895543,Pappas; Elizabeth,44,0,45,1
1746550301749,EDS 139,A00,897203,Pappas; Elizabeth,44,0,45,1
1746550301749,EDS 139,B00,897209,Fargason; Sharon Gayle,41,0,45,4
1746550302778,EDS 201,A00,895545,Staff,22,0,45,23
1746550303805,EDS 203,A01,895581,Halter; Christopher P.,22,0,45,23
1746550304831,EDS 204R,A01,895625,Heinzman; Erica M.,39,0,45,6
1746550304831,EDS 204R,B01,895693,Halter; Christopher P.,10,0,45,35
1746550305857,EDS 206R,A00,895694,Fargason; Sharon Gayle,1,0,30,29
1746550305857,EDS 206R,B00,895695,Choi; Bailey Miyeon,16,0,30,14
1746550306882,EDS 250,A00,895697,Hemans; Patricia Ann Benitez,22,0,45,23
1746550307908,EDS 281,A00,895701,Meyerott; Theresa Ann,1,0,15,14
1746550308935,EDS 284,A00,895736,Meyerott; Theresa Ann,1,0,15,14
1746550309965,EDS 286,A00,897210,Fine; Sarah,0,0,15,15
1746550310993,EDS 289C,A01,895770,Daly; Alan J.,15,0,15,0
1746550312020,EDS 290,A00,897211,Hofstetter; Carolyn,0,0,15,15
1746550313047,LIGM 5A,A00,896162,Fischer-Grunski; Eva K,13,0,20,7
1746550314074,LIGM 5B,A00,896260,Fischer-Grunski; Eva K,17,0,20,3
1746550315101,LIGM 5C,A00,896308,Fischer-Grunski; Eva K,18,0,20,2
1746550316127,LIIT 5AS,A00,896313,Carnelos; Chiara,18,0,20,2
1746550317151,LIIT 5BS,A00,896416,Carnelos; Chiara,20,0,20,0
1746550318179,LIIT 5CS,A00,896564,Carnelos; Chiara,20,0,20,0
1746550319204,LISP 5A,A00,896588,Munoz Sanchez; Alicia,3,0,20,17
1746550320232,LISP 5B,A00,896653,Munoz Sanchez; Alicia,7,0,20,13
1746550321259,LISP 5C,A00,896655,Munoz Sanchez; Alicia,0,1,20,20
1746550322284,MAE 197,001,957918,Kleissl; Jan,9996,0,9999,3
1746550322284,MAE 197,002,959806,Boechler; Nicholas Sebastia,9998,0,9999,1
1746550322284,MAE 197,003,959852,Mullin; Jennifer S,9998,0,9999,1
1746550323313,MATH 2,A01,957937,Staff,33,0,35,2
1746550324336,MATH 197,001,957876,Kedlaya; Kiran S.,9993,0,9999,6
1746550325362,MCWP 40,A00,892729,Duru; Nur,10,0,20,10
1746550325362,MCWP 40,B00,893304,Montejo; Carolina,14,0,20,6
1746550326390,MCWP 40R,A00,893757,Redela; Pamela Morgan,0,5,20,20
1746550327419,MCWP 50,A00,893758,Morshed; Michael James,0,0,20,20
1746550327419,MCWP 50,B00,893761,Bartulis; Jason Michael,17,0,20,3
1746550328446,MCWP 50R,A00,893766,Compas; Sean Matthew,0,1,20,20
1746550328446,MCWP 50R,B00,893769,Carter; Jennifer A,0,1,20,20
1746550328446,MCWP 50R,C00,893771,Krone; Jarret,0,3,20,20
1746550328446,MCWP 50R,D00,893772,Miller; Elizabeth Deen,0,0,20,20
1746550328446,MCWP 50R,E00,893775,Carter; Andrea L,0,1,20,20
1746550329472,MMW 11R,A01,892721,Herbst; Matthew,11,0,27,16
1746550329472,MMW 11R,A02,892722,Herbst; Matthew,0,0,0,3
1746550330500,MMW 12R,A01,892724,Herbst; Matthew,0,11,16,16
1746550330500,MMW 12R,A02,892725,Herbst; Matthew,0,10,16,16
1746550331526,MMW 13R,A01,892727,Staff,0,4,16,16
1746550331526,MMW 13R,A02,892728,Staff,0,4,16,16
1746550331526,MMW 13R,A03,958032,Staff,0,4,16,16
1746550331526,MMW 13R,A04,958033,Staff,0,4,16,16
1746550331526,MMW 13R,A05,958034,Staff,0,4,16,16
1746550332551,SIO 295LS,A00,894015,Staff,5,0,25,20
1746550333580,SIO 295S,A00,894020,Staff,5,0,25,20
1746550334609,SIOC 290S,B01,958918,Merrifield; Mark A,14,0,30,16
1746550335640,SIOC 291S,B01,958922,Gabriel; Corey John,14,0,30,16
1746550336666,SOCI 117,A01,895339,Staff,3,0,5,2
1746550337692,WES 237B,A00,894149,Staff,11,0,20,9
1746550339759,AESE 279B,A00,891859,Staff,13,0,35,22
1746550340783,AIP 197,001,891854,Vespa; Emanuel Ignacio,9999,0,9999,0
1746550341808,ANTH 289S,A00,891856,Gagneux; Pascal,12,0,12,0
1746550342832,BENG 196,001,957946,Engler; Adam J.,9996,0,9999,3
1746550343861,BISP 197,001,959851,Wilhelm; James E.,9998,0,9999,1
1746550344900,CAT 124RS,A01,956906,Staff,6,0,25,19
1746550345927,CAT 125RS,A01,922013,Staff,6,0,25,19
1746550346954,CLRE 250,A00,891860,Morris; Sheldon,9995,0,9999,4
1746550349006,CLRE 251R,A00,907817,Mehta; Ravindra L.,9994,0,9999,5
1746550350032,CLRE 252,A00,891864,Cuomo; Raphael Eduardo,9993,0,9999,6
1746550351056,CLRE 253,A00,891867,Vaida; Florin,9994,0,9999,5
1746550351056,CLRE 253,B00,907819,Staff,9999,0,9999,0
1746550352084,CLRE 259,A00,891868,Patel; Hemal,9998,0,9999,1
1746550353107,CLRE 260,A00,891872,Cuomo; Raphael Eduardo,9999,0,9999,0
1746550354135,CLRE 297,001,891888,Cuomo; Raphael Eduardo,9999,0,9999,0
1746550355162,CSE 191,A00,958773,Minnes Kemp; Mor Mia,9996,0,9999,3
1746550356187,CSE 197,001,959846,Minnes Kemp; Mor Mia,9990,0,9999,9
1746550357212,CSS 201S,A01,892054,Mignozzetti; Umberto,26,0,30,4
1746550358239,CSS 202S,A01,892056,Mignozzetti; Umberto,26,0,30,4
1746550359264,DSC 197,001,956898,Eldridge; Justin Matthew,9997,0,9999,2
1746550360291,DSC 297,001,958000,Mazumdar; Arya,9998,0,9999,1
1746550360291,DSC 297,002,959862,Wang; Yusu,9999,0,9999,0
1746550361319,EAP 100,A00,905686,Staff,9778,0,9999,221
1746550362345,ECE 45,A01,892618,Staff,0,0,65,65
1746550364403,ECE 111,A01,892719,Staff,4,0,65,61
1746550365433,ECE 197,001,957920,Mercier; Patrick Philip,9991,0,9999,8
1746550366486,ECON 178,A01,907814,Zhu; Ying,26,0,35,9
1746550367517,EDS 115,A00,895312,Staff,36,0,45,9
1746550368542,EDS 117,A01,895337,Staff,24,0,30,6
1746550369566,EDS 125,A00,895341,Jones; Gabrielle Anastasia,37,0,45,8
1746550370595,EDS 128A,A01,895459,Fargason; Sharon Gayle,44,0,45,1
1746550371619,EDS 128B,A01,895543,Pappas; Elizabeth,44,0,45,1
1746550372645,EDS 139,A00,897203,Pappas; Elizabeth,44,0,45,1
1746550372645,EDS 139,B00,897209,Fargason; Sharon Gayle,41,0,45,4
1746550373673,EDS 201,A00,895545,Staff,22,0,45,23
1746550374697,EDS 203,A01,895581,Halter; Christopher P.,22,0,45,23
1746550375725,EDS 204R,A01,895625,Heinzman; Erica M.,39,0,45,6
1746550375725,EDS 204R,B01,895693,Halter; Christopher P.,10,0,45,35
1746550376754,EDS 206R,A00,895694,Fargason; Sharon Gayle,1,0,30,29
1746550376754,EDS 206R,B00,895695,Choi; Bailey Miyeon,16,0,30,14
1746550377778,EDS 250,A00,895697,Hemans; Patricia Ann Benitez,22,0,45,23
1746550378806,EDS 281,A00,895701,Meyerott; Theresa Ann,1,0,15,14
1746550379832,EDS 284,A00,895736,Meyerott; Theresa Ann,1,0,15,14
1746550380858,EDS 286,A00,897210,Fine; Sarah,0,0,15,15
1746550381889,EDS 289C,A01,895770,Daly; Alan J.,15,0,15,0
1746550382913,EDS 290,A00,897211,Hofstetter; Carolyn,0,0,15,15
1746550383944,LIGM 5A,A00,896162,Fischer-Grunski; Eva K,13,0,20,7
1746550384970,LIGM 5B,A00,896260,Fischer-Grunski; Eva K,17,0,20,3
1746550385996,LIGM 5C,A00,896308,Fischer-Grunski; Eva K,18,0,20,2
1746550387021,LIIT 5AS,A00,896313,Carnelos; Chiara,18,0,20,2
1746550388047,LIIT 5BS,A00,896416,Carnelos; Chiara,20,0,20,0
1746550389075,LIIT 5CS,A00,896564,Carnelos; Chiara,20,0,20,0
1746550390102,LISP 5A,A00,896588,Munoz Sanchez; Alicia,3,0,20,17
1746550391130,LISP 5B,A00,896653,Munoz Sanchez; Alicia,7,0,20,13
1746550392158,LISP 5C,A00,896655,Munoz Sanchez; Alicia,0,1,20,20
1746550393184,MAE 197,001,957918,Kleissl; Jan,9996,0,9999,3
1746550393184,MAE 197,002,959806,Boechler; Nicholas Sebastia,9998,0,9999,1
1746550393184,MAE 197,003,959852,Mullin; Jennifer S,9998,0,9999,1
1746550394211,MATH 2,A01,957937,Staff,33,0,35,2
1746550395236,MATH 197,001,957876,Kedlaya; Kiran S.,9993,0,9999,6
1746550396261,MCWP 40,A00,892729,Duru; Nur,10,0,20,10
1746550396261,MCWP 40,B00,893304,Montejo; Carolina,14,0,20,6
1746550397285,MCWP 40R,A00,893757,Redela; Pamela Morgan,0,5,20,20
1746550398313,MCWP 50,A00,893758,Morshed; Michael James,0,0,20,20
1746550398313,MCWP 50,B00,893761,Bartulis; Jason Michael,17,0,20,3
1746550399342,MCWP 50R,A00,893766,Compas; Sean Matthew,0,1,20,20
1746550399342,MCWP 50R,B00,893769,Carter; Jennifer A,0,1,20,20
1746550399342,MCWP 50R,C00,893771,Krone; Jarret,0,3,20,20
1746550399342,MCWP 50R,D00,893772,Miller; Elizabeth Deen,0,0,20,20
1746550399342,MCWP 50R,E00,893775,Carter; Andrea L,0,1,20,20
1746550400370,MMW 11R,A01,892721,Herbst; Matthew,11,0,27,16
1746550400370,MMW 11R,A02,892722,Herbst; Matthew,0,0,0,3
1746550401395,MMW 12R,A01,892724,Herbst; Matthew,0,11,16,16
1746550401395,MMW 12R,A02,892725,Herbst; Matthew,0,10,16,16
1746550402424,MMW 13R,A01,892727,Staff,0,4,16,16
1746550402424,MMW 13R,A02,892728,Staff,0,4,16,16
1746550402424,MMW 13R,A03,958032,Staff,0,4,16,16
1746550402424,MMW 13R,A04,958033,Staff,0,4,16,16
1746550402424,MMW 13R,A05,958034,Staff,0,4,16,16
1746550403456,SIO 295LS,A00,894015,Staff,5,0,25,20
1746550404481,SIO 295S,A00,894020,Staff,5,0,25,20
1746550405505,SIOC 290S,B01,958918,Merrifield; Mark A,14,0,30,16
1746550406533,SIOC 291S,B01,958922,Gabriel; Corey John,14,0,30,16
1746550407559,SOCI 117,A01,895339,Staff,3,0,5,2
1746550408587,WES 237B,A00,894149,Staff,11,0,20,9
1746550410658,AESE 279B,A00,891859,Staff,13,0,35,22
1746550411682,AIP 197,001,891854,Vespa; Emanuel Ignacio,9999,0,9999,0
1746550412708,ANTH 289S,A00,891856,Gagneux; Pascal,12,0,12,0
1746550413733,BENG 196,001,957946,Engler; Adam J.,9996,0,9999,3
1746550414758,BISP 197,001,959851,Wilhelm; James E.,9998,0,9999,1
1746550415783,CAT 124RS,A01,956906,Staff,6,0,25,19
1746550416808,CAT 125RS,A01,922013,Staff,6,0,25,19
1746550417836,CLRE 250,A00,891860,Morris; Sheldon,9995,0,9999,4
1746550419889,CLRE 251R,A00,907817,Mehta; Ravindra L.,9994,0,9999,5
1746550420914,CLRE 252,A00,891864,Cuomo; Raphael Eduardo,9993,0,9999,6
1746550421942,CLRE 253,A00,891867,Vaida; Florin,9994,0,9999,5
1746550421942,CLRE 253,B00,907819,Staff,9999,0,9999,0
1746550422971,CLRE 259,A00,891868,Patel; Hemal,9998,0,9999,1
1746550423998,CLRE 260,A00,891872,Cuomo; Raphael Eduardo,9999,0,9999,0
1746550425022,CLRE 297,001,891888,Cuomo; Raphael Eduardo,9999,0,9999,0
1746550426049,CSE 191,A00,958773,Minnes Kemp; Mor Mia,9996,0,9999,3
1746550427075,CSE 197,001,959846,Minnes Kemp; Mor Mia,9990,0,9999,9
1746550428101,CSS 201S,A01,892054,Mignozzetti; Umberto,26,0,30,4
1746550429129,CSS 202S,A01,892056,Mignozzetti; Umberto,26,0,30,4
1746550430156,DSC 197,001,956898,Eldridge; Justin Matthew,9997,0,9999,2
1746550431184,DSC 297,001,958000,Mazumdar; Arya,9998,0,9999,1
1746550431184,DSC 297,002,959862,Wang; Yusu,9999,0,9999,0
1746550432207,EAP 100,A00,905686,Staff,9778,0,9999,221
1746550433235,ECE 45,A01,892618,Staff,0,0,65,65
1746550435288,ECE 111,A01,892719,Staff,4,0,65,61
1746550436313,ECE 197,001,957920,Mercier; Patrick Philip,9991,0,9999,8
1746550437342,ECON 178,A01,907814,Zhu; Ying,26,0,35,9
1746550438366,EDS 115,A00,895312,Staff,36,0,45,9
1746550439394,EDS 117,A01,895337,Staff,24,0,30,6
1746550440420,EDS 125,A00,895341,Jones; Gabrielle Anastasia,37,0,45,8
1746550441449,EDS 128A,A01,895459,Fargason; Sharon Gayle,44,0,45,1
1746550442475,EDS 128B,A01,895543,Pappas; Elizabeth,44,0,45,1
1746550443500,EDS 139,A00,897203,Pappas; Elizabeth,44,0,45,1
1746550443500,EDS 139,B00,897209,Fargason; Sharon Gayle,41,0,45,4
1746550444527,EDS 201,A00,895545,Staff,22,0,45,23
1746550445603,EDS 203,A01,895581,Halter; Christopher P.,22,0,45,23
1746550446627,EDS 204R,A01,895625,Heinzman; Erica M.,39,0,45,6
1746550446627,EDS 204R,B01,895693,Halter; Christopher P.,10,0,45,35
1746550447655,EDS 206R,A00,895694,Fargason; Sharon Gayle,1,0,30,29
1746550447655,EDS 206R,B00,895695,Choi; Bailey Miyeon,16,0,30,14
1746550448681,EDS 250,A00,895697,Hemans; Patricia Ann Benitez,22,0,45,23
1746550449707,EDS 281,A00,895701,Meyerott; Theresa Ann,1,0,15,14
1746550450732,EDS 284,A00,895736,Meyerott; Theresa Ann,1,0,15,14
1746550451757,EDS 286,A00,897210,Fine; Sarah,0,0,15,15
1746550452782,EDS 289C,A01,895770,Daly; Alan J.,15,0,15,0
1746550453807,EDS 290,A00,897211,Hofstetter; Carolyn,0,0,15,15
1746550454836,LIGM 5A,A00,896162,Fischer-Grunski; Eva K,13,0,20,7
1746550455861,LIGM 5B,A00,896260,Fischer-Grunski; Eva K,17,0,20,3
1746550456891,LIGM 5C,A00,896308,Fischer-Grunski; Eva K,18,0,20,2
1746550457916,LIIT 5AS,A00,896313,Carnelos; Chiara,18,0,20,2
1746550458942,LIIT 5BS,A00,896416,Carnelos; Chiara,20,0,20,0
1746550459969,LIIT 5CS,A00,896564,Carnelos; Chiara,20,0,20,0
1746550460995,LISP 5A,A00,896588,Munoz Sanchez; Alicia,3,0,20,17
1746550462023,LISP 5B,A00,896653,Munoz Sanchez; Alicia,7,0,20,13
1746550463055,LISP 5C,A00,896655,Munoz Sanchez; Alicia,0,1,20,20
1746550464083,MAE 197,001,957918,Kleissl; Jan,9996,0,9999,3
1746550464083,MAE 197,002,959806,Boechler; Nicholas Sebastia,9998,0,9999,1
1746550464083,MAE 197,003,959852,Mullin; Jennifer S,9998,0,9999,1
1746550465110,MATH 2,A01,957937,Staff,33,0,35,2
1746550466135,MATH 197,001,957876,Kedlaya; Kiran S.,9993,0,9999,6
1746550467161,MCWP 40,A00,892729,Duru; Nur,10,0,20,10
1746550467161,MCWP 40,B00,893304,Montejo; Carolina,14,0,20,6
1746550468187,MCWP 40R,A00,893757,Redela; Pamela Morgan,0,5,20,20
1746550469215,MCWP 50,A00,893758,Morshed; Michael James,0,0,20,20
1746550469215,MCWP 50,B00,893761,Bartulis; Jason Michael,17,0,20,3
1746550470244,MCWP 50R,A00,893766,Compas; Sean Matthew,0,1,20,20
1746550470244,MCWP 50R,B00,893769,Carter; Jennifer A,0,1,20,20
1746550470244,MCWP 50R,C00,893771,Krone; Jarret,0,3,20,20
1746550470244,MCWP 50R,D00,893772,Miller; Elizabeth Deen,0,0,20,20
1746550470244,MCWP 50R,E00,893775,Carter; Andrea L,0,1,20,20
1746550471269,MMW 11R,A01,892721,Herbst; Matthew,11,0,27,16
1746550471269,MMW 11R,A02,892722,Herbst; Matthew,0,0,0,3
1746550472294,MMW 12R,A01,892724,Herbst; Matthew,0,11,16,16
1746550472294,MMW 12R,A02,892725,Herbst; Matthew,0,10,16,16
1746550473319,MMW 13R,A01,892727,Staff,0,4,16,16
1746550473319,MMW 13R,A02,892728,Staff,0,4,16,16
1746550473319,MMW 13R,A03,958032,Staff,0,4,16,16
1746550473319,MMW 13R,A04,958033,Staff,0,4,16,16
1746550473319,MMW 13R,A05,958034,Staff,0,4,16,16
1746550474345,SIO 295LS,A00,894015,Staff,5,0,25,20
1746550475370,SIO 295S,A00,894020,Staff,5,0,25,20
1746550476401,SIOC 290S,B01,958918,Merrifield; Mark A,14,0,30,16
1746550477425,SIOC 291S,B01,958922,Gabriel; Corey John,14,0,30,16
1746550478450,SOCI 117,A01,895339,Staff,3,0,5,2
1746550479490,WES 237B,A00,894149,Staff,11,0,20,9
1746550481554,AESE 279B,A00,891859,Staff,13,0,35,22
1746550482580,AIP 197,001,891854,Vespa; Emanuel Ignacio,9999,0,9999,0
1746550483605,ANTH 289S,A00,891856,Gagneux; Pascal,12,0,12,0
1746550484631,BENG 196,001,957946,Engler; Adam J.,9996,0,9999,3
1746550485657,BISP 197,001,959851,Wilhelm; James E.,9998,0,9999,1
1746550486681,CAT 124RS,A01,956906,Staff,6,0,25,19
1746550487708,CAT 125RS,A01,922013,Staff,6,0,25,19
1746550488732,CLRE 250,A00,891860,Morris; Sheldon,9995,0,9999,4
1746550490781,CLRE 251R,A00,907817,Mehta; Ravindra L.,9994,0,9999,5
1746550491809,CLRE 252,A00,891864,Cuomo; Raphael Eduardo,9993,0,9999,6
1746550492835,CLRE 253,A00,891867,Vaida; Florin,9994,0,9999,5
1746550492835,CLRE 253,B00,907819,Staff,9999,0,9999,0
1746550493862,CLRE 259,A00,891868,Patel; Hemal,9998,0,9999,1
1746550494892,CLRE 260,A00,891872,Cuomo; Raphael Eduardo,9999,0,9999,0
1746550495918,CLRE 297,001,891888,Cuomo; Raphael Eduardo,9999,0,9999,0
1746550496942,CSE 191,A00,958773,Minnes Kemp; Mor Mia,9996,0,9999,3
1746550497967,CSE 197,001,959846,Minnes Kemp; Mor Mia,9990,0,9999,9
1746550499000,CSS 201S,A01,892054,Mignozzetti; Umberto,26,0,30,4
1746550500030,CSS 202S,A01,892056,Mignozzetti; Umberto,26,0,30,4
1746550501055,DSC 197,001,956898,Eldridge; Justin Matthew,9997,0,9999,2
1746550502080,DSC 297,001,958000,Mazumdar; Arya,9998,0,9999,1
1746550502080,DSC 297,002,959862,Wang; Yusu,9999,0,9999,0
1746550503107,EAP 100,A00,905686,Staff,9778,0,9999,221
1746550504136,ECE 45,A01,892618,Staff,0,0,65,65
1746550506189,ECE 111,A01,892719,Staff,4,0,65,61
1746550507212,ECE 197,001,957920,Mercier; Patrick Philip,9991,0,9999,8
1746550508236,ECON 178,A01,907814,Zhu; Ying,26,0,35,9
1746550509260,EDS 115,A00,895312,Staff,36,0,45,9
1746550510284,EDS 117,A01,895337,Staff,24,0,30,6
1746550511311,EDS 125,A00,895341,Jones; Gabrielle Anastasia,37,0,45,8
1746550512337,EDS 128A,A01,895459,Fargason; Sharon Gayle,44,0,45,1
1746550513362,EDS 128B,A01,895543,Pappas; Elizabeth,44,0,45,1
1746550514386,EDS 139,A00,897203,Pappas; Elizabeth,44,0,45,1
1746550514386,EDS 139,B00,897209,Fargason; Sharon Gayle,41,0,45,4
1746550515410,EDS 201,A00,895545,Staff,22,0,45,23
1746550516434,EDS 203,A01,895581,Halter; Christopher P.,22,0,45,23
1746550517458,EDS 204R,A01,895625,Heinzman; Erica M.,39,0,45,6
1746550517458,EDS 204R,B01,895693,Halter; Christopher P.,10,0,45,35
1746550518482,EDS 206R,A00,895694,Fargason; Sharon Gayle,1,0,30,29
1746550518482,EDS 206R,B00,895695,Choi; Bailey Miyeon,16,0,30,14
1746550519505,EDS 250,A00,895697,Hemans; Patricia Ann Benitez,22,0,45,23
1746550520531,EDS 281,A00,895701,Meyerott; Theresa Ann,1,0,15,14
1746550521557,EDS 284,A00,895736,Meyerott; Theresa Ann,1,0,15,14
1746550522582,EDS 286,A00,897210,Fine; Sarah,0,0,15,15
1746550523608,EDS 289C,A01,895770,Daly; Alan J.,15,0,15,0
1746550524635,EDS 290,A00,897211,Hofstetter; Carolyn,0,0,15,15
1746550525660,LIGM 5A,A00,896162,Fischer-Grunski; Eva K,13,0,20,7
1746550526685,LIGM 5B,A00,896260,Fischer-Grunski; Eva K,17,0,20,3
1746550527713,LIGM 5C,A00,896308,Fischer-Grunski; Eva K,18,0,20,2
1746550528740,LIIT 5AS,A00,896313,Carnelos; Chiara,18,0,20,2
1746550529767,LIIT 5BS,A00,896416,Carnelos; Chiara,20,0,20,0
1746550530795,LIIT 5CS,A00,896564,Carnelos; Chiara,20,0,20,0
1746550531820,LISP 5A,A00,896588,Munoz Sanchez; Alicia,3,0,20,17
1746550532847,LISP 5B,A00,896653,Munoz Sanchez; Alicia,7,0,20,13
1746550533876,LISP 5C,A00,896655,Munoz Sanchez; Alicia,0,1,20,20
1746550534904,MAE 197,001,957918,Kleissl; Jan,9996,0,9999,3
1746550534904,MAE 197,002,959806,Boechler; Nicholas Sebastia,9998,0,9999,1
1746550534904,MAE 197,003,959852,Mullin; Jennifer S,9998,0,9999,1
1746550535929,MATH 2,A01,957937,Staff,33,0,35,2
1746550536957,MATH 197,001,957876,Kedlaya; Kiran S.,9993,0,9999,6
1746550537982,MCWP 40,A00,892729,Duru; Nur,10,0,20,10
1746550537982,MCWP 40,B00,893304,Montejo; Carolina,14,0,20,6
1746550539008,MCWP 40R,A00,893757,Redela; Pamela Morgan,0,5,20,20
1746550540036,MCWP 50,A00,893758,Morshed; Michael James,0,0,20,20
1746550540036,MCWP 50,B00,893761,Bartulis; Jason Michael,17,0,20,3
1746550541063,MCWP 50R,A00,893766,Compas; Sean Matthew,0,1,20,20
1746550541063,MCWP 50R,B00,893769,Carter; Jennifer A,0,1,20,20
1746550541063,MCWP 50R,C00,893771,Krone; Jarret,0,3,20,20
1746550541063,MCWP 50R,D00,893772,Miller; Elizabeth Deen,0,0,20,20
1746550541063,MCWP 50R,E00,893775,Carter; Andrea L,0,1,20,20
1746550542154,MMW 11R,A01,892721,Herbst; Matthew,11,0,27,16
1746550542154,MMW 11R,A02,892722,Herbst; Matthew,0,0,0,3
1746550543182,MMW 12R,A01,892724,Herbst; Matthew,0,11,16,16
1746550543182,MMW 12R,A02,892725,Herbst; Matthew,0,10,16,16
1746550544214,MMW 13R,A01,892727,Staff,0,4,16,16
1746550544214,MMW 13R,A02,892728,Staff,0,4,16,16
1746550544214,MMW 13R,A03,958032,Staff,0,4,16,16
1746550544214,MMW 13R,A04,958033,Staff,0,4,16,16
1746550544214,MMW 13R,A05,958034,Staff,0,4,16,16
1746550545238,SIO 295LS,A00,894015,Staff,5,0,25,20
1746550546267,SIO 295S,A00,894020,Staff,5,0,25,20
1746550547295,SIOC 290S,B01,958918,Merrifield; Mark A,14,0,30,16
1746550548320,SIOC 291S,B01,958922,Gabriel; Corey John,14,0,30,16
1746550549346,SOCI 117,A01,895339,Staff,3,0,5,2
1746550550373,WES 237B,A00,894149,Staff,11,0,20,9
1746550552436,AESE 279B,A00,891859,Staff,13,0,35,22
1746550553461,AIP 197,001,891854,Vespa; Emanuel Ignacio,9999,0,9999,0
1746550554486,ANTH 289S,A00,891856,Gagneux; Pascal,12,0,12,0
1746550555509,BENG 196,001,957946,Engler; Adam J.,9996,0,9999,3
1746550556535,BISP 197,001,959851,Wilhelm; James E.,9998,0,9999,1
1746550557559,CAT 124RS,A01,956906,Staff,6,0,25,19
1746550558585,CAT 125RS,A01,922013,Staff,6,0,25,19
1746550559611,CLRE 250,A00,891860,Morris; Sheldon,9995,0,9999,4
1746550561660,CLRE 251R,A00,907817,Mehta; Ravindra L.,9994,0,9999,5
1746550562690,CLRE 252,A00,891864,Cuomo; Raphael Eduardo,9993,0,9999,6
1746550563715,CLRE 253,A00,891867,Vaida; Florin,9994,0,9999,5
1746550563715,CLRE 253,B00,907819,Staff,9999,0,9999,0
1746550564738,CLRE 259,A00,891868,Patel; Hemal,9998,0,9999,1
1746550565766,CLRE 260,A00,891872,Cuomo; Raphael Eduardo,9999,0,9999,0
1746550566790,CLRE 297,001,891888,Cuomo; Raphael Eduardo,9999,0,9999,0
1746550567818,CSE 191,A00,958773,Minnes Kemp; Mor Mia,9996,0,9999,3
1746550568842,CSE 197,001,959846,Minnes Kemp; Mor Mia,9990,0,9999,9
1746550569869,CSS 201S,A01,892054,Mignozzetti; Umberto,26,0,30,4
1746550570895,CSS 202S,A01,892056,Mignozzetti; Umberto,26,0,30,4
1746550571920,DSC 197,001,956898,Eldridge; Justin Matthew,9997,0,9999,2
1746550572948,DSC 297,001,958000,Mazumdar; Arya,9998,0,9999,1
1746550572948,DSC 297,002,959862,Wang; Yusu,9998,0,9999,1
1746550573976,EAP 100,A00,905686,Staff,9778,0,9999,221
1746550575011,ECE 45,A01,892618,Staff,0,0,65,65
1746550577075,ECE 111,A01,892719,Staff,4,0,65,61
1746550578101,ECE 197,001,957920,Mercier; Patrick Philip,9991,0,9999,8
1746550579128,ECON 178,A01,907814,Zhu; Ying,26,0,35,9
1746550580153,EDS 115,A00,895312,Staff,36,0,45,9
1746550581176,EDS 117,A01,895337,Staff,24,0,30,6
1746550582205,EDS 125,A00,895341,Jones; Gabrielle Anastasia,37,0,45,8
1746550583233,EDS 128A,A01,895459,Fargason; Sharon Gayle,44,0,45,1
1746550584258,EDS 128B,A01,895543,Pappas; Elizabeth,44,0,45,1
1746550585302,EDS 139,A00,897203,Pappas; Elizabeth,44,0,45,1
1746550585302,EDS 139,B00,897209,Fargason; Sharon Gayle,41,0,45,4
1746550586330,EDS 201,A00,895545,Staff,22,0,45,23
1746550587354,EDS 203,A01,895581,Halter; Christopher P.,22,0,45,23
1746550588386,EDS 204R,A01,895625,Heinzman; Erica M.,39,0,45,6
1746550588386,EDS 204R,B01,895693,Halter; Christopher P.,10,0,45,35
1746550589414,EDS 206R,A00,895694,Fargason; Sharon Gayle,1,0,30,29
1746550589414,EDS 206R,B00,895695,Choi; Bailey Miyeon,16,0,30,14
1746550590439,EDS 250,A00,895697,Hemans; Patricia Ann Benitez,22,0,45,23
1746550591467,EDS 281,A00,895701,Meyerott; Theresa Ann,1,0,15,14
1746550592494,EDS 284,A00,895736,Meyerott; Theresa Ann,1,0,15,14
1746550593520,EDS 286,A00,897210,Fine; Sarah,0,0,15,15
1746550594543,EDS 289C,A01,895770,Daly; Alan J.,15,0,15,0
1746550595568,EDS 290,A00,897211,Hofstetter; Carolyn,0,0,15,15
1746550596595,LIGM 5A,A00,896162,Fischer-Grunski; Eva K,13,0,20,7
1746550597622,LIGM 5B,A00,896260,Fischer-Grunski; Eva K,17,0,20,3
1746550598650,LIGM 5C,A00,896308,Fischer-Grunski; Eva K,18,0,20,2
1746550599675,LIIT 5AS,A00,896313,Carnelos; Chiara,18,0,20,2
1746550600703,LIIT 5BS,A00,896416,Carnelos; Chiara,20,0,20,0
1746550601729,LIIT 5CS,A00,896564,Carnelos; Chiara,20,0,20,0
1746550602754,LISP 5A,A00,896588,Munoz Sanchez; Alicia,3,0,20,17
1746550603786,LISP 5B,A00,896653,Munoz Sanchez; Alicia,7,0,20,13
1746550604811,LISP 5C,A00,896655,Munoz Sanchez; Alicia,0,1,20,20
1746550605836,MAE 197,001,957918,Kleissl; Jan,9996,0,9999,3
1746550605836,MAE 197,002,959806,Boechler; Nicholas Sebastia,9998,0,9999,1
1746550605836,MAE 197,003,959852,Mullin; Jennifer S,9998,0,9999,1
1746550606861,MATH 2,A01,957937,Staff,33,0,35,2
1746550607888,MATH 197,001,957876,Kedlaya; Kiran S.,9993,0,9999,6
1746550608913,MCWP 40,A00,892729,Duru; Nur,10,0,20,10
1746550608913,MCWP 40,B00,893304,Montejo; Carolina,14,0,20,6
1746550609940,MCWP 40R,A00,893757,Redela; Pamela Morgan,0,5,20,20
1746550610970,MCWP 50,A00,893758,Morshed; Michael James,0,0,20,20
1746550610970,MCWP 50,B00,893761,Bartulis; Jason Michael,17,0,20,3
1746550611999,MCWP 50R,A00,893766,Compas; Sean Matthew,0,1,20,20
1746550611999,MCWP 50R,B00,893769,Carter; Jennifer A,0,1,20,20
1746550611999,MCWP 50R,C00,893771,Krone; Jarret,0,3,20,20
1746550611999,MCWP 50R,D00,893772,Miller; Elizabeth Deen,0,0,20,20
1746550611999,MCWP 50R,E00,893775,Carter; Andrea L,0,1,20,20
1746550613026,MMW 11R,A01,892721,Herbst; Matthew,11,0,27,16
1746550613026,MMW 11R,A02,892722,Herbst; Matthew,0,0,0,3
1746550614050,MMW 12R,A01,892724,Herbst; Matthew,0,11,16,16
1746550614050,MMW 12R,A02,892725,Herbst; Matthew,0,10,16,16
1746550615075,MMW 13R,A01,892727,Staff,0,4,16,16
1746550615075,MMW 13R,A02,892728,Staff,0,4,16,16
1746550615075,MMW 13R,A03,958032,Staff,0,4,16,16
1746550615075,MMW 13R,A04,958033,Staff,0,4,16,16
1746550615075,MMW 13R,A05,958034,Staff,0,4,16,16
1746550616099,SIO 295LS,A00,894015,Staff,5,0,25,20
1746550617126,SIO 295S,A00,894020,Staff,5,0,25,20
1746550618151,SIOC 290S,B01,958918,Merrifield; Mark A,14,0,30,16
1746550619178,SIOC 291S,B01,958922,Gabriel; Corey John,14,0,30,16
1746550620203,SOCI 117,A01,895339,Staff,3,0,5,2
1746550621228,WES 237B,A00,894149,Staff,11,0,20,9
1746550623308,AESE 279B,A00,891859,Staff,13,0,35,22
1746550624334,AIP 197,001,891854,Vespa; Emanuel Ignacio,9999,0,9999,0
1746550625360,ANTH 289S,A00,891856,Gagneux; Pascal,12,0,12,0
1746550626383,BENG 196,001,957946,Engler; Adam J.,9996,0,9999,3
1746550627410,BISP 197,001,959851,Wilhelm; James E.,9998,0,9999,1
1746550628434,CAT 124RS,A01,956906,Staff,6,0,25,19
1746550629461,CAT 125RS,A01,922013,Staff,6,0,25,19
1746550630485,CLRE 250,A00,891860,Morris; Sheldon,9995,0,9999,4
1746550632538,CLRE 251R,A00,907817,Mehta; Ravindra L.,9994,0,9999,5
1746550633565,CLRE 252,A00,891864,Cuomo; Raphael Eduardo,9993,0,9999,6
1746550634591,CLRE 253,A00,891867,Vaida; Florin,9994,0,9999,5
1746550634591,CLRE 253,B00,907819,Staff,9999,0,9999,0
1746550635617,CLRE 259,A00,891868,Patel; Hemal,9998,0,9999,1
1746550636643,CLRE 260,A00,891872,Cuomo; Raphael Eduardo,9999,0,9999,0
1746550637671,CLRE 297,001,891888,Cuomo; Raphael Eduardo,9999,0,9999,0
1746550638697,CSE 191,A00,958773,Minnes Kemp; Mor Mia,9996,0,9999,3
1746550639721,CSE 197,001,959846,Minnes Kemp; Mor Mia,9990,0,9999,9
1746550640746,CSS 201S,A01,892054,Mignozzetti; Umberto,26,0,30,4
1746550641777,CSS 202S,A01,892056,Mignozzetti; Umberto,26,0,30,4
1746550642802,DSC 197,001,956898,Eldridge; Justin Matthew,9997,0,9999,2
1746550643825,DSC 297,001,958000,Mazumdar; Arya,9998,0,9999,1
1746550643825,DSC 297,002,959862,Wang; Yusu,9998,0,9999,1
1746550644848,EAP 100,A00,905686,Staff,9778,0,9999,221
1746550645877,ECE 45,A01,892618,Staff,0,0,65,65
1746550647922,ECE 111,A01,892719,Staff,4,0,65,61
1746550648947,ECE 197,001,957920,Mercier; Patrick Philip,9991,0,9999,8
1746550649973,ECON 178,A01,907814,Zhu; Ying,26,0,35,9
1746550651000,EDS 115,A00,895312,Staff,36,0,45,9
1746550652039,EDS 117,A01,895337,Staff,24,0,30,6
1746550653063,EDS 125,A00,895341,Jones; Gabrielle Anastasia,37,0,45,8
1746550654089,EDS 128A,A01,895459,Fargason; Sharon Gayle,44,0,45,1
1746550655114,EDS 128B,A01,895543,Pappas; Elizabeth,44,0,45,1
1746550656141,EDS 139,A00,897203,Pappas; Elizabeth,44,0,45,1
1746550656141,EDS 139,B00,897209,Fargason; Sharon Gayle,41,0,45,4
1746550657166,EDS 201,A00,895545,Staff,22,0,45,23
1746550658192,EDS 203,A01,895581,Halter; Christopher P.,22,0,45,23
1746550659219,EDS 204R,A01,895625,Heinzman; Erica M.,39,0,45,6
1746550659219,EDS 204R,B01,895693,Halter; Christopher P.,10,0,45,35
1746550660244,EDS 206R,A00,895694,Fargason; Sharon Gayle,1,0,30,29
1746550660244,EDS 206R,B00,895695,Choi; Bailey Miyeon,16,0,30,14
1746550661269,EDS 250,A00,895697,Hemans; Patricia Ann Benitez,22,0,45,23
1746550662294,EDS 281,A00,895701,Meyerott; Theresa Ann,1,0,15,14
1746550663321,EDS 284,A00,895736,Meyerott; Theresa Ann,1,0,15,14
1746550664349,EDS 286,A00,897210,Fine; Sarah,0,0,15,15
1746550665375,EDS 289C,A01,895770,Daly; Alan J.,15,0,15,0
1746550666399,EDS 290,A00,897211,Hofstetter; Carolyn,0,0,15,15
1746550667423,LIGM 5A,A00,896162,Fischer-Grunski; Eva K,13,0,20,7
1746550668449,LIGM 5B,A00,896260,Fischer-Grunski; Eva K,17,0,20,3
1746550669476,LIGM 5C,A00,896308,Fischer-Grunski; Eva K,18,0,20,2
1746550670502,LIIT 5AS,A00,896313,Carnelos; Chiara,18,0,20,2
1746550671526,LIIT 5BS,A00,896416,Carnelos; Chiara,20,0,20,0
1746550672556,LIIT 5CS,A00,896564,Carnelos; Chiara,20,0,20,0
1746550673581,LISP 5A,A00,896588,Munoz Sanchez; Alicia,3,0,20,17
1746550674607,LISP 5B,A00,896653,Munoz Sanchez; Alicia,7,0,20,13
1746550675632,LISP 5C,A00,896655,Munoz Sanchez; Alicia,0,1,20,20
1746550676656,MAE 197,001,957918,Kleissl; Jan,9996,0,9999,3
1746550676656,MAE 197,002,959806,Boechler; Nicholas Sebastia,9998,0,9999,1
1746550676656,MAE 197,003,959852,Mullin; Jennifer S,9998,0,9999,1
1746550677682,MATH 2,A01,957937,Staff,33,0,35,2
1746550678710,MATH 197,001,957876,Kedlaya; Kiran S.,9993,0,9999,6
1746550679738,MCWP 40,A00,892729,Duru; Nur,10,0,20,10
1746550679738,MCWP 40,B00,893304,Montejo; Carolina,14,0,20,6
1746550680763,MCWP 40R,A00,893757,Redela; Pamela Morgan,0,5,20,20
1746550681817,MCWP 50,A00,893758,Morshed; Michael James,0,0,20,20
1746550681817,MCWP 50,B00,893761,Bartulis; Jason Michael,17,0,20,3
1746550682841,MCWP 50R,A00,893766,Compas; Sean Matthew,0,1,20,20
1746550682841,MCWP 50R,B00,893769,Carter; Jennifer A,0,1,20,20
1746550682841,MCWP 50R,C00,893771,Krone; Jarret,0,3,20,20
1746550682841,MCWP 50R,D00,893772,Miller; Elizabeth Deen,0,0,20,20
1746550682841,MCWP 50R,E00,893775,Carter; Andrea L,0,1,20,20
1746550683865,MMW 11R,A01,892721,Herbst; Matthew,11,0,27,16
1746550683865,MMW 11R,A02,892722,Herbst; Matthew,0,0,0,3
1746550684891,MMW 12R,A01,892724,Herbst; Matthew,0,11,16,16
1746550684891,MMW 12R,A02,892725,Herbst; Matthew,0,10,16,16
1746550685918,MMW 13R,A01,892727,Staff,0,4,16,16
1746550685918,MMW 13R,A02,892728,Staff,0,4,16,16
1746550685918,MMW 13R,A03,958032,Staff,0,4,16,16
1746550685918,MMW 13R,A04,958033,Staff,0,4,16,16
1746550685918,MMW 13R,A05,958034,Staff,0,4,16,16
1746550686945,SIO 295LS,A00,894015,Staff,5,0,25,20
1746550687972,SIO 295S,A00,894020,Staff,5,0,25,20
1746550688997,SIOC 290S,B01,958918,Merrifield; Mark A,14,0,30,16
1746550690030,SIOC 291S,B01,958922,Gabriel; Corey John,14,0,30,16
1746550691056,SOCI 117,A01,895339,Staff,3,0,5,2
1746550692079,WES 237B,A00,894149,Staff,11,0,20,9
1746550694145,AESE 279B,A00,891859,Staff,13,0,35,22
1746550695173,AIP 197,001,891854,Vespa; Emanuel Ignacio,9999,0,9999,0
1746550696200,ANTH 289S,A00,891856,Gagneux; Pascal,12,0,12,0
1746550697224,BENG 196,001,957946,Engler; Adam J.,9996,0,9999,3
1746550698249,BISP 197,001,959851,Wilhelm; James E.,9998,0,9999,1
1746550699277,CAT 124RS,A01,956906,Staff,6,0,25,19
1746550700302,CAT 125RS,A01,922013,Staff,6,0,25,19
1746550701328,CLRE 250,A00,891860,Morris; Sheldon,9995,0,9999,4
1746550703380,CLRE 251R,A00,907817,Mehta; Ravindra L.,9994,0,9999,5
1746550704408,CLRE 252,A00,891864,Cuomo; Raphael Eduardo,9993,0,9999,6
1746550705436,CLRE 253,A00,891867,Vaida; Florin,9994,0,9999,5
1746550705436,CLRE 253,B00,907819,Staff,9999,0,9999,0
1746550706461,CLRE 259,A00,891868,Patel; Hemal,9998,0,9999,1
1746550707485,CLRE 260,A00,891872,Cuomo; Raphael Eduardo,9999,0,9999,0
1746550708508,CLRE 297,001,891888,Cuomo; Raphael Eduardo,9999,0,9999,0
1746550709531,CSE 191,A00,958773,Minnes Kemp; Mor Mia,9996,0,9999,3
1746550710557,CSE 197,001,959846,Minnes Kemp; Mor Mia,9990,0,9999,9
1746550711581,CSS 201S,A01,892054,Mignozzetti; Umberto,26,0,30,4
1746550712608,CSS 202S,A01,892056,Mignozzetti; Umberto,26,0,30,4
1746550713633,DSC 197,001,956898,Eldridge; Justin Matthew,9997,0,9999,2
1746550714656,DSC 297,001,958000,Mazumdar; Arya,9998,0,9999,1
1746550714656,DSC 297,002,959862,Wang; Yusu,9998,0,9999,1
1746550715680,EAP 100,A00,905686,Staff,9778,0,9999,221
1746550716705,ECE 45,A01,892618,Staff,0,0,65,65
1746550718757,ECE 111,A01,892719,Staff,4,0,65,61
1746550719780,ECE 197,001,957920,Mercier; Patrick Philip,9991,0,9999,8
1746550720808,ECON 178,A01,907814,Zhu; Ying,26,0,35,9
1746550721831,EDS 115,A00,895312,Staff,36,0,45,9
1746550722856,EDS 117,A01,895337,Staff,24,0,30,6
1746550723883,EDS 125,A00,895341,Jones; Gabrielle Anastasia,37,0,45,8
1746550724907,EDS 128A,A01,895459,Fargason; Sharon Gayle,44,0,45,1
1746550725936,EDS 128B,A01,895543,Pappas; Elizabeth,44,0,45,1
1746550726962,EDS 139,A00,897203,Pappas; Elizabeth,44,0,45,1
1746550726962,EDS 139,B00,897209,Fargason; Sharon Gayle,41,0,45,4
1746550727987,EDS 201,A00,895545,Staff,22,0,45,23
1746550729014,EDS 203,A01,895581,Halter; Christopher P.,22,0,45,23
1746550730039,EDS 204R,A01,895625,Heinzman; Erica M.,39,0,45,6
1746550730039,EDS 204R,B01,895693,Halter; Christopher P.,10,0,45,35
1746550731065,EDS 206R,A00,895694,Fargason; Sharon Gayle,1,0,30,29
1746550731065,EDS 206R,B00,895695,Choi; Bailey Miyeon,16,0,30,14
1746550732095,EDS 250,A00,895697,Hemans; Patricia Ann Benitez,22,0,45,23
1746550733119,EDS 281,A00,895701,Meyerott; Theresa Ann,1,0,15,14
1746550734143,EDS 284,A00,895736,Meyerott; Theresa Ann,1,0,15,14
1746550735169,EDS 286,A00,897210,Fine; Sarah,0,0,15,15
1746550736197,EDS 289C,A01,895770,Daly; Alan J.,15,0,15,0
1746550737222,EDS 290,A00,897211,Hofstetter; Carolyn,0,0,15,15
1746550738246,LIGM 5A,A00,896162,Fischer-Grunski; Eva K,13,0,20,7
1746550739273,LIGM 5B,A00,896260,Fischer-Grunski; Eva K,17,0,20,3
1746550740298,LIGM 5C,A00,896308,Fischer-Grunski; Eva K,18,0,20,2
1746550741323,LIIT 5AS,A00,896313,Carnelos; Chiara,18,0,20,2
1746550742347,LIIT 5BS,A00,896416,Carnelos; Chiara,20,0,20,0
1746550743377,LIIT 5CS,A00,896564,Carnelos; Chiara,20,0,20,0
1746550744405,LISP 5A,A00,896588,Munoz Sanchez; Alicia,3,0,20,17
1746550745431,LISP 5B,A00,896653,Munoz Sanchez; Alicia,7,0,20,13
1746550746455,LISP 5C,A00,896655,Munoz Sanchez; Alicia,0,1,20,20
1746550747483,MAE 197,001,957918,Kleissl; Jan,9996,0,9999,3
1746550747483,MAE 197,002,959806,Boechler; Nicholas Sebastia,9998,0,9999,1
1746550747483,MAE 197,003,959852,Mullin; Jennifer S,9998,0,9999,1
1746550748510,MATH 2,A01,957937,Staff,33,0,35,2
1746550749535,MATH 197,001,957876,Kedlaya; Kiran S.,9993,0,9999,6
1746550750561,MCWP 40,A00,892729,Duru; Nur,10,0,20,10
1746550750561,MCWP 40,B00,893304,Montejo; Carolina,14,0,20,6
1746550751586,MCWP 40R,A00,893757,Redela; Pamela Morgan,0,5,20,20
1746550752615,MCWP 50,A00,893758,Morshed; Michael James,0,0,20,20
1746550752615,MCWP 50,B00,893761,Bartulis; Jason Michael,17,0,20,3
1746550753644,MCWP 50R,A00,893766,Compas; Sean Matthew,0,1,20,20
1746550753644,MCWP 50R,B00,893769,Carter; Jennifer A,0,1,20,20
1746550753644,MCWP 50R,C00,893771,Krone; Jarret,0,3,20,20
1746550753644,MCWP 50R,D00,893772,Miller; Elizabeth Deen,0,0,20,20
1746550753644,MCWP 50R,E00,893775,Carter; Andrea L,0,1,20,20
1746550754669,MMW 11R,A01,892721,Herbst; Matthew,11,0,27,16
1746550754669,MMW 11R,A02,892722,Herbst; Matthew,0,0,0,3
1746550755694,MMW 12R,A01,892724,Herbst; Matthew,0,11,16,16
1746550755694,MMW 12R,A02,892725,Herbst; Matthew,0,10,16,16
1746550756720,MMW 13R,A01,892727,Staff,0,4,16,16
1746550756720,MMW 13R,A02,892728,Staff,0,4,16,16
1746550756720,MMW 13R,A03,958032,Staff,0,4,16,16
1746550756720,MMW 13R,A04,958033,Staff,0,4,16,16
1746550756720,MMW 13R,A05,958034,Staff,0,4,16,16
1746550757747,SIO 295LS,A00,894015,Staff,5,0,25,20
1746550758772,SIO 295S,A00,894020,Staff,5,0,25,20
1746550759797,SIOC 290S,B01,958918,Merrifield; Mark A,14,0,30,16
1746550760823,SIOC 291S,B01,958922,Gabriel; Corey John,14,0,30,16
1746550761848,SOCI 117,A01,895339,Staff,3,0,5,2
1746550762875,WES 237B,A00,894149,Staff,11,0,20,9
1746550764935,AESE 279B,A00,891859,Staff,13,0,35,22
1746550765960,AIP 197,001,891854,Vespa; Emanuel Ignacio,9999,0,9999,0
1746550766986,ANTH 289S,A00,891856,Gagneux; Pascal,12,0,12,0
1746550768012,BENG 196,001,957946,Engler; Adam J.,9996,0,9999,3
1746550769039,BISP 197,001,959851,Wilhelm; James E.,9998,0,9999,1
1746550770067,CAT 124RS,A01,956906,Staff,6,0,25,19
1746550771092,CAT 125RS,A01,922013,Staff,6,0,25,19
1746550772118,CLRE 250,A00,891860,Morris; Sheldon,9995,0,9999,4
1746550774174,CLRE 251R,A00,907817,Mehta; Ravindra L.,9994,0,9999,5
1746550775201,CLRE 252,A00,891864,Cuomo; Raphael Eduardo,9993,0,9999,6
1746550776226,CLRE 253,A00,891867,Vaida; Florin,9994,0,9999,5
1746550776226,CLRE 253,B00,907819,Staff,9999,0,9999,0
1746550777250,CLRE 259,A00,891868,Patel; Hemal,9998,0,9999,1
1746550778277,CLRE 260,A00,891872,Cuomo; Raphael Eduardo,9999,0,9999,0
1746550779303,CLRE 297,001,891888,Cuomo; Raphael Eduardo,9999,0,9999,0
1746550780329,CSE 191,A00,958773,Minnes Kemp; Mor Mia,9996,0,9999,3
1746550781355,CSE 197,001,959846,Minnes Kemp; Mor Mia,9990,0,9999,9
1746550782380,CSS 201S,A01,892054,Mignozzetti; Umberto,26,0,30,4
1746550783409,CSS 202S,A01,892056,Mignozzetti; Umberto,26,0,30,4
1746550784433,DSC 197,001,956898,Eldridge; Justin Matthew,9997,0,9999,2
1746550785457,DSC 297,001,958000,Mazumdar; Arya,9998,0,9999,1
1746550785457,DSC 297,002,959862,Wang; Yusu,9998,0,9999,1
1746550786484,EAP 100,A00,905686,Staff,9778,0,9999,221
1746550787511,ECE 45,A01,892618,Staff,0,0,65,65
1746550789565,ECE 111,A01,892719,Staff,4,0,65,61
1746550790594,ECE 197,001,957920,Mercier; Patrick Philip,9991,0,9999,8
1746550791623,ECON 178,A01,907814,Zhu; Ying,26,0,35,9
1746550792647,EDS 115,A00,895312,Staff,36,0,45,9
1746550793671,EDS 117,A01,895337,Staff,24,0,30,6
1746550794698,EDS 125,A00,895341,Jones; Gabrielle Anastasia,37,0,45,8
1746550795752,EDS 128A,A01,895459,Fargason; Sharon Gayle,44,0,45,1
1746550796779,EDS 128B,A01,895543,Pappas; Elizabeth,44,0,45,1
1746550797803,EDS 139,A00,897203,Pappas; Elizabeth,44,0,45,1
1746550797803,EDS 139,B00,897209,Fargason; Sharon Gayle,41,0,45,4
1746550798828,EDS 201,A00,895545,Staff,22,0,45,23
1746550799855,EDS 203,A01,895581,Halter; Christopher P.,22,0,45,23
1746550800879,EDS 204R,A01,895625,Heinzman; Erica M.,39,0,45,6
1746550800879,EDS 204R,B01,895693,Halter; Christopher P.,10,0,45,35
1746550801904,EDS 206R,A00,895694,Fargason; Sharon Gayle,1,0,30,29
1746550801904,EDS 206R,B00,895695,Choi; Bailey Miyeon,16,0,30,14
1746550802933,EDS 250,A00,895697,Hemans; Patricia Ann Benitez,22,0,45,23
1746550803960,EDS 281,A00,895701,Meyerott; Theresa Ann,1,0,15,14
1746550804988,EDS 284,A00,895736,Meyerott; Theresa Ann,1,0,15,14
1746550806015,EDS 286,A00,897210,Fine; Sarah,0,0,15,15
1746550807040,EDS 289C,A01,895770,Daly; Alan J.,15,0,15,0
1746550808068,EDS 290,A00,897211,Hofstetter; Carolyn,0,0,15,15
1746550809093,LIGM 5A,A00,896162,Fischer-Grunski; Eva K,13,0,20,7
1746550810121,LIGM 5B,A00,896260,Fischer-Grunski; Eva K,17,0,20,3
1746550811148,LIGM 5C,A00,896308,Fischer-Grunski; Eva K,18,0,20,2
1746550812174,LIIT 5AS,A00,896313,Carnelos; Chiara,18,0,20,2
1746550813199,LIIT 5BS,A00,896416,Carnelos; Chiara,20,0,20,0
1746550814226,LIIT 5CS,A00,896564,Carnelos; Chiara,20,0,20,0
1746550815252,LISP 5A,A00,896588,Munoz Sanchez; Alicia,3,0,20,17
1746550816281,LISP 5B,A00,896653,Munoz Sanchez; Alicia,7,0,20,13
1746550817310,LISP 5C,A00,896655,Munoz Sanchez; Alicia,0,1,20,20
1746550818335,MAE 197,001,957918,Kleissl; Jan,9996,0,9999,3
1746550818335,MAE 197,002,959806,Boechler; Nicholas Sebastia,9998,0,9999,1
1746550818335,MAE 197,003,959852,Mullin; Jennifer S,9998,0,9999,1
1746550819358,MATH 2,A01,957937,Staff,33,0,35,2
1746550820387,MATH 197,001,957876,Kedlaya; Kiran S.,9993,0,9999,6
1746550821413,MCWP 40,A00,892729,Duru; Nur,10,0,20,10
1746550821413,MCWP 40,B00,893304,Montejo; Carolina,14,0,20,6
1746550822450,MCWP 40R,A00,893757,Redela; Pamela Morgan,0,5,20,20
1746550823475,MCWP 50,A00,893758,Morshed; Michael James,0,0,20,20
1746550823475,MCWP 50,B00,893761,Bartulis; Jason Michael,17,0,20,3
1746550824499,MCWP 50R,A00,893766,Compas; Sean Matthew,0,1,20,20
1746550824499,MCWP 50R,B00,893769,Carter; Jennifer A,0,1,20,20
1746550824499,MCWP 50R,C00,893771,Krone; Jarret,0,3,20,20
1746550824499,MCWP 50R,D00,893772,Miller; Elizabeth Deen,0,0,20,20
1746550824499,MCWP 50R,E00,893775,Carter; Andrea L,0,1,20,20
1746550825529,MMW 11R,A01,892721,Herbst; Matthew,11,0,27,16
1746550825529,MMW 11R,A02,892722,Herbst; Matthew,0,0,0,3
1746550826575,MMW 12R,A01,892724,Herbst; Matthew,0,11,16,16
1746550826575,MMW 12R,A02,892725,Herbst; Matthew,0,10,16,16
1746550827603,MMW 13R,A01,892727,Staff,0,4,16,16
1746550827603,MMW 13R,A02,892728,Staff,0,4,16,16
1746550827603,MMW 13R,A03,958032,Staff,0,4,16,16
1746550827603,MMW 13R,A04,958033,Staff,0,4,16,16
1746550827603,MMW 13R,A05,958034,Staff,0,4,16,16
1746550828628,SIO 295LS,A00,894015,Staff,5,0,25,20
1746550829652,SIO 295S,A00,894020,Staff,5,0,25,20
1746550830676,SIOC 290S,B01,958918,Merrifield; Mark A,14,0,30,16
1746550831704,SIOC 291S,B01,958922,Gabriel; Corey John,14,0,30,16
1746550832729,SOCI 117,A01,895339,Staff,3,0,5,2
1746550833753,WES 237B,A00,894149,Staff,11,0,20,9
1746550835820,AESE 279B,A00,891859,Staff,13,0,35,22
1746550836845,AIP 197,001,891854,Vespa; Emanuel Ignacio,9999,0,9999,0
1746550837870,ANTH 289S,A00,891856,Gagneux; Pascal,12,0,12,0
1746550838898,BENG 196,001,957946,Engler; Adam J.,9996,0,9999,3
1746550839922,BISP 197,001,959851,Wilhelm; James E.,9998,0,9999,1
1746550840947,CAT 124RS,A01,956906,Staff,6,0,25,19
1746550841972,CAT 125RS,A01,922013,Staff,6,0,25,19
1746550842997,CLRE 250,A00,891860,Morris; Sheldon,9995,0,9999,4
1746550845045,CLRE 251R,A00,907817,Mehta; Ravindra L.,9994,0,9999,5
1746550846072,CLRE 252,A00,891864,Cuomo; Raphael Eduardo,9993,0,9999,6
1746550847098,CLRE 253,A00,891867,Vaida; Florin,9994,0,9999,5
1746550847098,CLRE 253,B00,907819,Staff,9999,0,9999,0
1746550848122,CLRE 259,A00,891868,Patel; Hemal,9998,0,9999,1
1746550849147,CLRE 260,A00,891872,Cuomo; Raphael Eduardo,9999,0,9999,0
1746550850170,CLRE 297,001,891888,Cuomo; Raphael Eduardo,9999,0,9999,0
1746550851194,CSE 191,A00,958773,Minnes Kemp; Mor Mia,9996,0,9999,3
1746550852219,CSE 197,001,959846,Minnes Kemp; Mor Mia,9990,0,9999,9
1746550853249,CSS 201S,A01,892054,Mignozzetti; Umberto,26,0,30,4
1746550854277,CSS 202S,A01,892056,Mignozzetti; Umberto,26,0,30,4
1746550855301,DSC 197,001,956898,Eldridge; Justin Matthew,9997,0,9999,2
1746550856330,DSC 297,001,958000,Mazumdar; Arya,9998,0,9999,1
1746550856330,DSC 297,002,959862,Wang; Yusu,9998,0,9999,1
1746550857356,EAP 100,A00,905686,Staff,9778,0,9999,221
1746550858382,ECE 45,A01,892618,Staff,0,0,65,65
1746550860439,ECE 111,A01,892719,Staff,4,0,65,61
1746550861465,ECE 197,001,957920,Mercier; Patrick Philip,9991,0,9999,8
1746550862493,ECON 178,A01,907814,Zhu; Ying,26,0,35,9
1746550863522,EDS 115,A00,895312,Staff,36,0,45,9
1746550864550,EDS 117,A01,895337,Staff,24,0,30,6
1746550865575,EDS 125,A00,895341,Jones; Gabrielle Anastasia,37,0,45,8
1746550866600,EDS 128A,A01,895459,Fargason; Sharon Gayle,44,0,45,1
1746550867627,EDS 128B,A01,895543,Pappas; Elizabeth,44,0,45,1
1746550868654,EDS 139,A00,897203,Pappas; Elizabeth,44,0,45,1
1746550868654,EDS 139,B00,897209,Fargason; Sharon Gayle,41,0,45,4
1746550869678,EDS 201,A00,895545,Staff,22,0,45,23
1746550870708,EDS 203,A01,895581,Halter; Christopher P.,22,0,45,23
1746550871737,EDS 204R,A01,895625,Heinzman; Erica M.,39,0,45,6
1746550871737,EDS 204R,B01,895693,Halter; Christopher P.,10,0,45,35
1746550872763,EDS 206R,A00,895694,Fargason; Sharon Gayle,1,0,30,29
1746550872763,EDS 206R,B00,895695,Choi; Bailey Miyeon,16,0,30,14
1746550873790,EDS 250,A00,895697,Hemans; Patricia Ann Benitez,22,0,45,23
1746550874815,EDS 281,A00,895701,Meyerott; Theresa Ann,1,0,15,14
1746550875841,EDS 284,A00,895736,Meyerott; Theresa Ann,1,0,15,14
1746550876866,EDS 286,A00,897210,Fine; Sarah,0,0,15,15
1746550877892,EDS 289C,A01,895770,Daly; Alan J.,15,0,15,0
1746550878917,EDS 290,A00,897211,Hofstetter; Carolyn,0,0,15,15
1746550879941,LIGM 5A,A00,896162,Fischer-Grunski; Eva K,13,0,20,7
1746550880970,LIGM 5B,A00,896260,Fischer-Grunski; Eva K,17,0,20,3
1746550882000,LIGM 5C,A00,896308,Fischer-Grunski; Eva K,18,0,20,2
1746550883029,LIIT 5AS,A00,896313,Carnelos; Chiara,18,0,20,2
1746550884053,LIIT 5BS,A00,896416,Carnelos; Chiara,20,0,20,0
1746550885086,LIIT 5CS,A00,896564,Carnelos; Chiara,20,0,20,0
1746550886117,LISP 5A,A00,896588,Munoz Sanchez; Alicia,3,0,20,17
1746550887142,LISP 5B,A00,896653,Munoz Sanchez; Alicia,7,0,20,13
1746550888168,LISP 5C,A00,896655,Munoz Sanchez; Alicia,0,1,20,20
1746550889201,MAE 197,001,957918,Kleissl; Jan,9996,0,9999,3
1746550889201,MAE 197,002,959806,Boechler; Nicholas Sebastia,9998,0,9999,1
1746550889201,MAE 197,003,959852,Mullin; Jennifer S,9998,0,9999,1
1746550890225,MATH 2,A01,957937,Staff,33,0,35,2
1746550891250,MATH 197,001,957876,Kedlaya; Kiran S.,9993,0,9999,6
1746550892277,MCWP 40,A00,892729,Duru; Nur,10,0,20,10
1746550892277,MCWP 40,B00,893304,Montejo; Carolina,14,0,20,6
1746550893305,MCWP 40R,A00,893757,Redela; Pamela Morgan,0,5,20,20
1746550894330,MCWP 50,A00,893758,Morshed; Michael James,0,0,20,20
1746550894330,MCWP 50,B00,893761,Bartulis; Jason Michael,17,0,20,3
1746550895360,MCWP 50R,A00,893766,Compas; Sean Matthew,0,1,20,20
1746550895360,MCWP 50R,B00,893769,Carter; Jennifer A,0,1,20,20
1746550895360,MCWP 50R,C00,893771,Krone; Jarret,0,3,20,20
1746550895360,MCWP 50R,D00,893772,Miller; Elizabeth Deen,0,0,20,20
1746550895360,MCWP 50R,E00,893775,Carter; Andrea L,0,1,20,20
1746550896383,MMW 11R,A01,892721,Herbst; Matthew,11,0,27,16
1746550896383,MMW 11R,A02,892722,Herbst; Matthew,0,0,0,3
1746550897408,MMW 12R,A01,892724,Herbst; Matthew,0,11,16,16
1746550897408,MMW 12R,A02,892725,Herbst; Matthew,0,10,16,16
1746550898433,MMW 13R,A01,892727,Staff,0,4,16,16
1746550898433,MMW 13R,A02,892728,Staff,0,4,16,16
1746550898433,MMW 13R,A03,958032,Staff,0,4,16,16
1746550898433,MMW 13R,A04,958033,Staff,0,4,16,16
1746550898433,MMW 13R,A05,958034,Staff,0,4,16,16
1746550899460,SIO 295LS,A00,894015,Staff,5,0,25,20
1746550900485,SIO 295S,A00,894020,Staff,5,0,25,20
1746550901512,SIOC 290S,B01,958918,Merrifield; Mark A,14,0,30,16
1746550902538,SIOC 291S,B01,958922,Gabriel; Corey John,14,0,30,16
1746550903565,SOCI 117,A01,895339,Staff,3,0,5,2
1746550904593,WES 237B,A00,894149,Staff,11,0,20,9
1746550906654,AESE 279B,A00,891859,Staff,13,0,35,22
1746550907682,AIP 197,001,891854,Vespa; Emanuel Ignacio,9999,0,9999,0
1746550908706,ANTH 289S,A00,891856,Gagneux; Pascal,12,0,12,0
1746550909730,BENG 196,001,957946,Engler; Adam J.,9996,0,9999,3
1746550910754,BISP 197,001,959851,Wilhelm; James E.,9998,0,9999,1
1746550911782,CAT 124RS,A01,956906,Staff,6,0,25,19
1746550912805,CAT 125RS,A01,922013,Staff,6,0,25,19
1746550913831,CLRE 250,A00,891860,Morris; Sheldon,9995,0,9999,4
1746550915882,CLRE 251R,A00,907817,Mehta; Ravindra L.,9994,0,9999,5
1746550916907,CLRE 252,A00,891864,Cuomo; Raphael Eduardo,9993,0,9999,6
1746550917937,CLRE 253,A00,891867,Vaida; Florin,9994,0,9999,5
1746550917937,CLRE 253,B00,907819,Staff,9999,0,9999,0
1746550918961,CLRE 259,A00,891868,Patel; Hemal,9998,0,9999,1
1746550919988,CLRE 260,A00,891872,Cuomo; Raphael Eduardo,9999,0,9999,0
1746550921015,CLRE 297,001,891888,Cuomo; Raphael Eduardo,9999,0,9999,0
1746550922042,CSE 191,A00,958773,Minnes Kemp; Mor Mia,9996,0,9999,3
1746550923066,CSE 197,001,959846,Minnes Kemp; Mor Mia,9990,0,9999,9
1746550924096,CSS 201S,A01,892054,Mignozzetti; Umberto,26,0,30,4
1746550925122,CSS 202S,A01,892056,Mignozzetti; Umberto,26,0,30,4
1746550926148,DSC 197,001,956898,Eldridge; Justin Matthew,9997,0,9999,2
1746550927175,DSC 297,001,958000,Mazumdar; Arya,9998,0,9999,1
1746550927175,DSC 297,002,959862,Wang; Yusu,9998,0,9999,1
1746550928201,EAP 100,A00,905686,Staff,9778,0,9999,221
1746550929233,ECE 45,A01,892618,Staff,0,0,65,65
1746550931289,ECE 111,A01,892719,Staff,4,0,65,61
1746550932314,ECE 197,001,957920,Mercier; Patrick Philip,9991,0,9999,8
1746550933344,ECON 178,A01,907814,Zhu; Ying,26,0,35,9
1746550934373,EDS 115,A00,895312,Staff,36,0,45,9
1746550935399,EDS 117,A01,895337,Staff,24,0,30,6
1746550936426,EDS 125,A00,895341,Jones; Gabrielle Anastasia,37,0,45,8
1746550937451,EDS 128A,A01,895459,Fargason; Sharon Gayle,44,0,45,1
1746550938478,EDS 128B,A01,895543,Pappas; Elizabeth,44,0,45,1
1746550939506,EDS 139,A00,897203,Pappas; Elizabeth,44,0,45,1
1746550939506,EDS 139,B00,897209,Fargason; Sharon Gayle,41,0,45,4
1746550940531,EDS 201,A00,895545,Staff,22,0,45,23
1746550941556,EDS 203,A01,895581,Halter; Christopher P.,22,0,45,23
1746550942586,EDS 204R,A01,895625,Heinzman; Erica M.,39,0,45,6
1746550942586,EDS 204R,B01,895693,Halter; Christopher P.,10,0,45,35
1746550943612,EDS 206R,A00,895694,Fargason; Sharon Gayle,1,0,30,29
1746550943612,EDS 206R,B00,895695,Choi; Bailey Miyeon,16,0,30,14
1746550944637,EDS 250,A00,895697,Hemans; Patricia Ann Benitez,22,0,45,23
1746550945664,EDS 281,A00,895701,Meyerott; Theresa Ann,1,0,15,14
1746550946689,EDS 284,A00,895736,Meyerott; Theresa Ann,1,0,15,14
1746550947715,EDS 286,A00,897210,Fine; Sarah,0,0,15,15
1746550948739,EDS 289C,A01,895770,Daly; Alan J.,15,0,15,0
1746550949767,EDS 290,A00,897211,Hofstetter; Carolyn,0,0,15,15
1746550950793,LIGM 5A,A00,896162,Fischer-Grunski; Eva K,13,0,20,7
1746550951823,LIGM 5B,A00,896260,Fischer-Grunski; Eva K,17,0,20,3
1746550952850,LIGM 5C,A00,896308,Fischer-Grunski; Eva K,18,0,20,2
1746550953875,LIIT 5AS,A00,896313,Carnelos; Chiara,18,0,20,2
1746550954901,LIIT 5BS,A00,896416,Carnelos; Chiara,20,0,20,0
1746550955929,LIIT 5CS,A00,896564,Carnelos; Chiara,20,0,20,0
1746550956957,LISP 5A,A00,896588,Munoz Sanchez; Alicia,3,0,20,17
1746550957982,LISP 5B,A00,896653,Munoz Sanchez; Alicia,7,0,20,13
1746550959007,LISP 5C,A00,896655,Munoz Sanchez; Alicia,0,1,20,20
1746550960032,MAE 197,001,957918,Kleissl; Jan,9996,0,9999,3
1746550960032,MAE 197,002,959806,Boechler; Nicholas Sebastia,9998,0,9999,1
1746550960032,MAE 197,003,959852,Mullin; Jennifer S,9998,0,9999,1
1746550961059,MATH 2,A01,957937,Staff,33,0,35,2
1746550962087,MATH 197,001,957876,Kedlaya; Kiran S.,9993,0,9999,6
1746550963113,MCWP 40,A00,892729,Duru; Nur,10,0,20,10
1746550963113,MCWP 40,B00,893304,Montejo; Carolina,14,0,20,6
1746550964140,MCWP 40R,A00,893757,Redela; Pamela Morgan,0,5,20,20
1746550965168,MCWP 50,A00,893758,Morshed; Michael James,0,0,20,20
1746550965168,MCWP 50,B00,893761,Bartulis; Jason Michael,17,0,20,3
1746550966195,MCWP 50R,A00,893766,Compas; Sean Matthew,0,1,20,20
1746550966195,MCWP 50R,B00,893769,Carter; Jennifer A,0,1,20,20
1746550966195,MCWP 50R,C00,893771,Krone; Jarret,0,3,20,20
1746550966195,MCWP 50R,D00,893772,Miller; Elizabeth Deen,0,0,20,20
1746550966195,MCWP 50R,E00,893775,Carter; Andrea L,0,1,20,20
1746550967224,MMW 11R,A01,892721,Herbst; Matthew,11,0,27,16
1746550967224,MMW 11R,A02,892722,Herbst; Matthew,0,0,0,3
1746550968248,MMW 12R,A01,892724,Herbst; Matthew,0,11,16,16
1746550968248,MMW 12R,A02,892725,Herbst; Matthew,0,10,16,16
1746550969274,MMW 13R,A01,892727,Staff,0,4,16,16
1746550969274,MMW 13R,A02,892728,Staff,0,4,16,16
1746550969274,MMW 13R,A03,958032,Staff,0,4,16,16
1746550969274,MMW 13R,A04,958033,Staff,0,4,16,16
1746550969274,MMW 13R,A05,958034,Staff,0,4,16,16
1746550970298,SIO 295LS,A00,894015,Staff,5,0,25,20
1746550971325,SIO 295S,A00,894020,Staff,5,0,25,20
1746550972354,SIOC 290S,B01,958918,Merrifield; Mark A,14,0,30,16
1746550973384,SIOC 291S,B01,958922,Gabriel; Corey John,14,0,30,16
1746550974411,SOCI 117,A01,895339,Staff,3,0,5,2
1746550975436,WES 237B,A00,894149,Staff,11,0,20,9
1746550977493,AESE 279B,A00,891859,Staff,13,0,35,22
1746550978516,AIP 197,001,891854,Vespa; Emanuel Ignacio,9999,0,9999,0
1746550979539,ANTH 289S,A00,891856,Gagneux; Pascal,12,0,12,0
1746550980567,BENG 196,001,957946,Engler; Adam J.,9996,0,9999,3
1746550981592,BISP 197,001,959851,Wilhelm; James E.,9998,0,9999,1
1746550982620,CAT 124RS,A01,956906,Staff,6,0,25,19
1746550983647,CAT 125RS,A01,922013,Staff,6,0,25,19
1746550984675,CLRE 250,A00,891860,Morris; Sheldon,9995,0,9999,4
1746550986733,CLRE 251R,A00,907817,Mehta; Ravindra L.,9994,0,9999,5
1746550987758,CLRE 252,A00,891864,Cuomo; Raphael Eduardo,9993,0,9999,6
1746550988787,CLRE 253,A00,891867,Vaida; Florin,9994,0,9999,5
1746550988787,CLRE 253,B00,907819,Staff,9999,0,9999,0
1746550989814,CLRE 259,A00,891868,Patel; Hemal,9998,0,9999,1
1746550990839,CLRE 260,A00,891872,Cuomo; Raphael Eduardo,9999,0,9999,0
1746550991865,CLRE 297,001,891888,Cuomo; Raphael Eduardo,9999,0,9999,0
1746550992895,CSE 191,A00,958773,Minnes Kemp; Mor Mia,9996,0,9999,3
1746550993919,CSE 197,001,959846,Minnes Kemp; Mor Mia,9990,0,9999,9
1746550994950,CSS 201S,A01,892054,Mignozzetti; Umberto,26,0,30,4
1746550995977,CSS 202S,A01,892056,Mignozzetti; Umberto,26,0,30,4
1746550997000,DSC 197,001,956898,Eldridge; Justin Matthew,9997,0,9999,2
1746550998025,DSC 297,001,958000,Mazumdar; Arya,9998,0,9999,1
1746550998025,DSC 297,002,959862,Wang; Yusu,9998,0,9999,1
1746550999052,EAP 100,A00,905686,Staff,9778,0,9999,221
1746551000078,ECE 45,A01,892618,Staff,0,0,65,65
1746551002127,ECE 111,A01,892719,Staff,4,0,65,61
1746551003154,ECE 197,001,957920,Mercier; Patrick Philip,9991,0,9999,8
1746551004184,ECON 178,A01,907814,Zhu; Ying,26,0,35,9
1746551005213,EDS 115,A00,895312,Staff,36,0,45,9
1746551006241,EDS 117,A01,895337,Staff,24,0,30,6
1746551007268,EDS 125,A00,895341,Jones; Gabrielle Anastasia,37,0,45,8
1746551008299,EDS 128A,A01,895459,Fargason; Sharon Gayle,44,0,45,1
1746551009327,EDS 128B,A01,895543,Pappas; Elizabeth,44,0,45,1
1746551010351,EDS 139,A00,897203,Pappas; Elizabeth,44,0,45,1
1746551010351,EDS 139,B00,897209,Fargason; Sharon Gayle,41,0,45,4
1746551011377,EDS 201,A00,895545,Staff,22,0,45,23
1746551012402,EDS 203,A01,895581,Halter; Christopher P.,22,0,45,23
1746551013430,EDS 204R,A01,895625,Heinzman; Erica M.,39,0,45,6
1746551013430,EDS 204R,B01,895693,Halter; Christopher P.,10,0,45,35
1746551014465,EDS 206R,A00,895694,Fargason; Sharon Gayle,1,0,30,29
1746551014465,EDS 206R,B00,895695,Choi; Bailey Miyeon,16,0,30,14
1746551015489,EDS 250,A00,895697,Hemans; Patricia Ann Benitez,22,0,45,23
1746551016515,EDS 281,A00,895701,Meyerott; Theresa Ann,1,0,15,14
1746551017542,EDS 284,A00,895736,Meyerott; Theresa Ann,1,0,15,14
1746551018567,EDS 286,A00,897210,Fine; Sarah,0,0,15,15
1746551019592,EDS 289C,A01,895770,Daly; Alan J.,15,0,15,0
1746551020617,EDS 290,A00,897211,Hofstetter; Carolyn,0,0,15,15
1746551021643,LIGM 5A,A00,896162,Fischer-Grunski; Eva K,13,0,20,7
1746551022674,LIGM 5B,A00,896260,Fischer-Grunski; Eva K,17,0,20,3
1746551023699,LIGM 5C,A00,896308,Fischer-Grunski; Eva K,18,0,20,2
1746551024725,LIIT 5AS,A00,896313,Carnelos; Chiara,18,0,20,2
1746551025749,LIIT 5BS,A00,896416,Carnelos; Chiara,20,0,20,0
1746551026779,LIIT 5CS,A00,896564,Carnelos; Chiara,20,0,20,0
1746551027803,LISP 5A,A00,896588,Munoz Sanchez; Alicia,3,0,20,17
1746551028828,LISP 5B,A00,896653,Munoz Sanchez; Alicia,7,0,20,13
1746551029858,LISP 5C,A00,896655,Munoz Sanchez; Alicia,0,1,20,20
1746551030884,MAE 197,001,957918,Kleissl; Jan,9996,0,9999,3
1746551030884,MAE 197,002,959806,Boechler; Nicholas Sebastia,9998,0,9999,1
1746551030884,MAE 197,003,959852,Mullin; Jennifer S,9998,0,9999,1
1746551031909,MATH 2,A01,957937,Staff,33,0,35,2
1746551032936,MATH 197,001,957876,Kedlaya; Kiran S.,9993,0,9999,6
1746551033966,MCWP 40,A00,892729,Duru; Nur,10,0,20,10
1746551033966,MCWP 40,B00,893304,Montejo; Carolina,14,0,20,6
1746551034997,MCWP 40R,A00,893757,Redela; Pamela Morgan,0,5,20,20
1746551036022,MCWP 50,A00,893758,Morshed; Michael James,0,0,20,20
1746551036022,MCWP 50,B00,893761,Bartulis; Jason Michael,17,0,20,3
1746551037051,MCWP 50R,A00,893766,Compas; Sean Matthew,0,1,20,20
1746551037051,MCWP 50R,B00,893769,Carter; Jennifer A,0,1,20,20
1746551037051,MCWP 50R,C00,893771,Krone; Jarret,0,3,20,20
1746551037051,MCWP 50R,D00,893772,Miller; Elizabeth Deen,0,0,20,20
1746551037051,MCWP 50R,E00,893775,Carter; Andrea L,0,1,20,20
1746551038076,MMW 11R,A01,892721,Herbst; Matthew,11,0,27,16
1746551038076,MMW 11R,A02,892722,Herbst; Matthew,0,0,0,3
1746551039106,MMW 12R,A01,892724,Herbst; Matthew,0,11,16,16
1746551039106,MMW 12R,A02,892725,Herbst; Matthew,0,10,16,16
1746551040131,MMW 13R,A01,892727,Staff,0,4,16,16
1746551040131,MMW 13R,A02,892728,Staff,0,4,16,16
1746551040131,MMW 13R,A03,958032,Staff,0,4,16,16
1746551040131,MMW 13R,A04,958033,Staff,0,4,16,16
1746551040131,MMW 13R,A05,958034,Staff,0,4,16,16
1746551041157,SIO 295LS,A00,894015,Staff,5,0,25,20
1746551042180,SIO 295S,A00,894020,Staff,5,0,25,20
1746551043209,SIOC 290S,B01,958918,Merrifield; Mark A,14,0,30,16
1746551044233,SIOC 291S,B01,958922,Gabriel; Corey John,14,0,30,16
1746551045259,SOCI 117,A01,895339,Staff,3,0,5,2
1746551046283,WES 237B,A00,894149,Staff,11,0,20,9
1746551048346,AESE 279B,A00,891859,Staff,13,0,35,22
1746551049371,AIP 197,001,891854,Vespa; Emanuel Ignacio,9999,0,9999,0
1746551050396,ANTH 289S,A00,891856,Gagneux; Pascal,12,0,12,0
1746551051420,BENG 196,001,957946,Engler; Adam J.,9996,0,9999,3
1746551052444,BISP 197,001,959851,Wilhelm; James E.,9998,0,9999,1
1746551053469,CAT 124RS,A01,956906,Staff,6,0,25,19
1746551054494,CAT 125RS,A01,922013,Staff,6,0,25,19
1746551055523,CLRE 250,A00,891860,Morris; Sheldon,9995,0,9999,4
1746551057573,CLRE 251R,A00,907817,Mehta; Ravindra L.,9994,0,9999,5
1746551058596,CLRE 252,A00,891864,Cuomo; Raphael Eduardo,9993,0,9999,6
1746551059622,CLRE 253,A00,891867,Vaida; Florin,9994,0,9999,5
1746551059622,CLRE 253,B00,907819,Staff,9999,0,9999,0
1746551060655,CLRE 259,A00,891868,Patel; Hemal,9998,0,9999,1
1746551061680,CLRE 260,A00,891872,Cuomo; Raphael Eduardo,9999,0,9999,0
1746551062708,CLRE 297,001,891888,Cuomo; Raphael Eduardo,9999,0,9999,0
1746551063731,CSE 191,A00,958773,Minnes Kemp; Mor Mia,9996,0,9999,3
1746551064760,CSE 197,001,959846,Minnes Kemp; Mor Mia,9990,0,9999,9
1746551065843,CSS 201S,A01,892054,Mignozzetti; Umberto,26,0,30,4
1746551066869,CSS 202S,A01,892056,Mignozzetti; Umberto,26,0,30,4
1746551067895,DSC 197,001,956898,Eldridge; Justin Matthew,9997,0,9999,2
1746551068920,DSC 297,001,958000,Mazumdar; Arya,9998,0,9999,1
1746551068920,DSC 297,002,959862,Wang; Yusu,9998,0,9999,1
1746551069946,EAP 100,A00,905686,Staff,9778,0,9999,221
1746551070971,ECE 45,A01,892618,Staff,0,0,65,65
1746551073023,ECE 111,A01,892719,Staff,4,0,65,61
1746551074052,ECE 197,001,957920,Mercier; Patrick Philip,9991,0,9999,8
1746551075078,ECON 178,A01,907814,Zhu; Ying,26,0,35,9
1746551076114,EDS 115,A00,895312,Staff,36,0,45,9
1746551077147,EDS 117,A01,895337,Staff,24,0,30,6
1746551078174,EDS 125,A00,895341,Jones; Gabrielle Anastasia,37,0,45,8
1746551079201,EDS 128A,A01,895459,Fargason; Sharon Gayle,44,0,45,1
1746551080227,EDS 128B,A01,895543,Pappas; Elizabeth,44,0,45,1
1746551081253,EDS 139,A00,897203,Pappas; Elizabeth,44,0,45,1
1746551081253,EDS 139,B00,897209,Fargason; Sharon Gayle,41,0,45,4
1746551082278,EDS 201,A00,895545,Staff,22,0,45,23
1746551083303,EDS 203,A01,895581,Halter; Christopher P.,22,0,45,23
1746551084329,EDS 204R,A01,895625,Heinzman; Erica M.,39,0,45,6
1746551084329,EDS 204R,B01,895693,Halter; Christopher P.,10,0,45,35
1746551085355,EDS 206R,A00,895694,Fargason; Sharon Gayle,1,0,30,29
1746551085355,EDS 206R,B00,895695,Choi; Bailey Miyeon,16,0,30,14
1746551086380,EDS 250,A00,895697,Hemans; Patricia Ann Benitez,22,0,45,23
1746551087408,EDS 281,A00,895701,Meyerott; Theresa Ann,1,0,15,14
1746551088433,EDS 284,A00,895736,Meyerott; Theresa Ann,1,0,15,14
1746551089462,EDS 286,A00,897210,Fine; Sarah,0,0,15,15
1746551090489,EDS 289C,A01,895770,Daly; Alan J.,15,0,15,0
1746551091518,EDS 290,A00,897211,Hofstetter; Carolyn,0,0,15,15
1746551092541,LIGM 5A,A00,896162,Fischer-Grunski; Eva K,13,0,20,7
1746551093571,LIGM 5B,A00,896260,Fischer-Grunski; Eva K,17,0,20,3
1746551094598,LIGM 5C,A00,896308,Fischer-Grunski; Eva K,18,0,20,2
1746551095623,LIIT 5AS,A00,896313,Carnelos; Chiara,18,0,20,2
1746551096652,LIIT 5BS,A00,896416,Carnelos; Chiara,20,0,20,0
1746551097677,LIIT 5CS,A00,896564,Carnelos; Chiara,20,0,20,0
1746551098703,LISP 5A,A00,896588,Munoz Sanchez; Alicia,3,0,20,17
1746551099733,LISP 5B,A00,896653,Munoz Sanchez; Alicia,7,0,20,13
1746551100761,LISP 5C,A00,896655,Munoz Sanchez; Alicia,0,1,20,20
1746551101794,MAE 197,001,957918,Kleissl; Jan,9996,0,9999,3
1746551101794,MAE 197,002,959806,Boechler; Nicholas Sebastia,9998,0,9999,1
1746551101794,MAE 197,003,959852,Mullin; Jennifer S,9998,0,9999,1
1746551102817,MATH 2,A01,957937,Staff,33,0,35,2
1746551103842,MATH 197,001,957876,Kedlaya; Kiran S.,9993,0,9999,6
1746551104870,MCWP 40,A00,892729,Duru; Nur,10,0,20,10
1746551104870,MCWP 40,B00,893304,Montejo; Carolina,14,0,20,6
1746551105894,MCWP 40R,A00,893757,Redela; Pamela Morgan,0,5,20,20
1746551106922,MCWP 50,A00,893758,Morshed; Michael James,0,0,20,20
1746551106922,MCWP 50,B00,893761,Bartulis; Jason Michael,17,0,20,3
1746551107949,MCWP 50R,A00,893766,Compas; Sean Matthew,0,1,20,20
1746551107949,MCWP 50R,B00,893769,Carter; Jennifer A,0,1,20,20
1746551107949,MCWP 50R,C00,893771,Krone; Jarret,0,3,20,20
1746551107949,MCWP 50R,D00,893772,Miller; Elizabeth Deen,0,0,20,20
1746551107949,MCWP 50R,E00,893775,Carter; Andrea L,0,1,20,20
1746551108983,MMW 11R,A01,892721,Herbst; Matthew,11,0,27,16
1746551108983,MMW 11R,A02,892722,Herbst; Matthew,0,0,0,3
1746551110010,MMW 12R,A01,892724,Herbst; Matthew,0,11,16,16
1746551110010,MMW 12R,A02,892725,Herbst; Matthew,0,10,16,16
1746551111041,MMW 13R,A01,892727,Staff,0,4,16,16
1746551111041,MMW 13R,A02,892728,Staff,0,4,16,16
1746551111041,MMW 13R,A03,958032,Staff,0,4,16,16
1746551111041,MMW 13R,A04,958033,Staff,0,4,16,16
1746551111041,MMW 13R,A05,958034,Staff,0,4,16,16
1746551112065,SIO 295LS,A00,894015,Staff,5,0,25,20
1746551113090,SIO 295S,A00,894020,Staff,5,0,25,20
1746551114117,SIOC 290S,B01,958918,Merrifield; Mark A,14,0,30,16
1746551115142,SIOC 291S,B01,958922,Gabriel; Corey John,14,0,30,16
1746551116188,SOCI 117,A01,895339,Staff,3,0,5,2
1746551117213,WES 237B,A00,894149,Staff,11,0,20,9
1746551119270,AESE 279B,A00,891859,Staff,13,0,35,22
1746551120295,AIP 197,001,891854,Vespa; Emanuel Ignacio,9999,0,9999,0
1746551121321,ANTH 289S,A00,891856,Gagneux; Pascal,12,0,12,0
1746551122346,BENG 196,001,957946,Engler; Adam J.,9996,0,9999,3
1746551123373,BISP 197,001,959851,Wilhelm; James E.,9998,0,9999,1
1746551124401,CAT 124RS,A01,956906,Staff,6,0,25,19
1746551125427,CAT 125RS,A01,922013,Staff,6,0,25,19
1746551126452,CLRE 250,A00,891860,Morris; Sheldon,9995,0,9999,4
1746551128501,CLRE 251R,A00,907817,Mehta; Ravindra L.,9994,0,9999,5
1746551129528,CLRE 252,A00,891864,Cuomo; Raphael Eduardo,9993,0,9999,6
1746551130553,CLRE 253,A00,891867,Vaida; Florin,9994,0,9999,5
1746551130553,CLRE 253,B00,907819,Staff,9999,0,9999,0
1746551131580,CLRE 259,A00,891868,Patel; Hemal,9998,0,9999,1
1746551132605,CLRE 260,A00,891872,Cuomo; Raphael Eduardo,9999,0,9999,0
1746551133631,CLRE 297,001,891888,Cuomo; Raphael Eduardo,9999,0,9999,0
1746551134655,CSE 191,A00,958773,Minnes Kemp; Mor Mia,9996,0,9999,3
1746551135680,CSE 197,001,959846,Minnes Kemp; Mor Mia,9990,0,9999,9
1746551136703,CSS 201S,A01,892054,Mignozzetti; Umberto,26,0,30,4
1746551137728,CSS 202S,A01,892056,Mignozzetti; Umberto,26,0,30,4
1746551138753,DSC 197,001,956898,Eldridge; Justin Matthew,9997,0,9999,2
1746551139777,DSC 297,001,958000,Mazumdar; Arya,9998,0,9999,1
1746551139777,DSC 297,002,959862,Wang; Yusu,9998,0,9999,1
1746551140802,EAP 100,A00,905686,Staff,9778,0,9999,221
1746551141825,ECE 45,A01,892618,Staff,0,0,65,65
1746551143876,ECE 111,A01,892719,Staff,4,0,65,61
1746551144900,ECE 197,001,957920,Mercier; Patrick Philip,9991,0,9999,8
1746551145925,ECON 178,A01,907814,Zhu; Ying,26,0,35,9
1746551146953,EDS 115,A00,895312,Staff,36,0,45,9
1746551147977,EDS 117,A01,895337,Staff,24,0,30,6
1746551149005,EDS 125,A00,895341,Jones; Gabrielle Anastasia,37,0,45,8
1746551150035,EDS 128A,A01,895459,Fargason; Sharon Gayle,44,0,45,1
1746551151058,EDS 128B,A01,895543,Pappas; Elizabeth,44,0,45,1
1746551152082,EDS 139,A00,897203,Pappas; Elizabeth,44,0,45,1
1746551152082,EDS 139,B00,897209,Fargason; Sharon Gayle,41,0,45,4
1746551153111,EDS 201,A00,895545,Staff,22,0,45,23
1746551154141,EDS 203,A01,895581,Halter; Christopher P.,22,0,45,23
1746551155169,EDS 204R,A01,895625,Heinzman; Erica M.,39,0,45,6
1746551155169,EDS 204R,B01,895693,Halter; Christopher P.,10,0,45,35
1746551156194,EDS 206R,A00,895694,Fargason; Sharon Gayle,1,0,30,29
1746551156194,EDS 206R,B00,895695,Choi; Bailey Miyeon,16,0,30,14
1746551157219,EDS 250,A00,895697,Hemans; Patricia Ann Benitez,22,0,45,23
1746551158249,EDS 281,A00,895701,Meyerott; Theresa Ann,1,0,15,14
1746551159276,EDS 284,A00,895736,Meyerott; Theresa Ann,1,0,15,14
1746551160300,EDS 286,A00,897210,Fine; Sarah,0,0,15,15
1746551161326,EDS 289C,A01,895770,Daly; Alan J.,15,0,15,0
1746551162358,EDS 290,A00,897211,Hofstetter; Carolyn,0,0,15,15
1746551163385,LIGM 5A,A00,896162,Fischer-Grunski; Eva K,13,0,20,7
1746551164412,LIGM 5B,A00,896260,Fischer-Grunski; Eva K,17,0,20,3
1746551165439,LIGM 5C,A00,896308,Fischer-Grunski; Eva K,18,0,20,2
1746551166467,LIIT 5AS,A00,896313,Carnelos; Chiara,18,0,20,2
1746551167492,LIIT 5BS,A00,896416,Carnelos; Chiara,20,0,20,0
1746551168516,LIIT 5CS,A00,896564,Carnelos; Chiara,20,0,20,0
1746551169553,LISP 5A,A00,896588,Munoz Sanchez; Alicia,3,0,20,17
1746551170578,LISP 5B,A00,896653,Munoz Sanchez; Alicia,7,0,20,13
1746551171604,LISP 5C,A00,896655,Munoz Sanchez; Alicia,0,1,20,20
1746551172685,MAE 197,001,957918,Kleissl; Jan,9996,0,9999,3
1746551172685,MAE 197,002,959806,Boechler; Nicholas Sebastia,9998,0,9999,1
1746551172685,MAE 197,003,959852,Mullin; Jennifer S,9998,0,9999,1
1746551173711,MATH 2,A01,957937,Staff,33,0,35,2
1746551174739,MATH 197,001,957876,Kedlaya; Kiran S.,9993,0,9999,6
1746551175764,MCWP 40,A00,892729,Duru; Nur,10,0,20,10
1746551175764,MCWP 40,B00,893304,Montejo; Carolina,14,0,20,6
1746551176789,MCWP 40R,A00,893757,Redela; Pamela Morgan,0,5,20,20
1746551177814,MCWP 50,A00,893758,Morshed; Michael James,0,0,20,20
1746551177814,MCWP 50,B00,893761,Bartulis; Jason Michael,17,0,20,3
1746551178841,MCWP 50R,A00,893766,Compas; Sean Matthew,0,1,20,20
1746551178841,MCWP 50R,B00,893769,Carter; Jennifer A,0,1,20,20
1746551178841,MCWP 50R,C00,893771,Krone; Jarret,0,3,20,20
1746551178841,MCWP 50R,D00,893772,Miller; Elizabeth Deen,0,0,20,20
1746551178841,MCWP 50R,E00,893775,Carter; Andrea L,0,1,20,20
1746551179868,MMW 11R,A01,892721,Herbst; Matthew,11,0,27,16
1746551179868,MMW 11R,A02,892722,Herbst; Matthew,0,0,0,3
1746551180895,MMW 12R,A01,892724,Herbst; Matthew,0,11,16,16
1746551180895,MMW 12R,A02,892725,Herbst; Matthew,0,10,16,16
1746551181921,MMW 13R,A01,892727,Staff,0,4,16,16
1746551181921,MMW 13R,A02,892728,Staff,0,4,16,16
1746551181921,MMW 13R,A03,958032,Staff,0,4,16,16
1746551181921,MMW 13R,A04,958033,Staff,0,4,16,16
1746551181921,MMW 13R,A05,958034,Staff,0,4,16,16
1746551182949,SIO 295LS,A00,894015,Staff,5,0,25,20
1746551183977,SIO 295S,A00,894020,Staff,5,0,25,20
1746551185003,SIOC 290S,B01,958918,Merrifield; Mark A,14,0,30,16
1746551186033,SIOC 291S,B01,958922,Gabriel; Corey John,14,0,30,16
1746551187060,SOCI 117,A01,895339,Staff,3,0,5,2
1746551188085,WES 237B,A00,894149,Staff,11,0,20,9
1746551190154,AESE 279B,A00,891859,Staff,13,0,35,22
1746551191181,AIP 197,001,891854,Vespa; Emanuel Ignacio,9999,0,9999,0
1746551192208,ANTH 289S,A00,891856,Gagneux; Pascal,12,0,12,0
1746551193240,BENG 196,001,957946,Engler; Adam J.,9996,0,9999,3
1746551194267,BISP 197,001,959851,Wilhelm; James E.,9998,0,9999,1
1746551195303,CAT 124RS,A01,956906,Staff,6,0,25,19
1746551196327,CAT 125RS,A01,922013,Staff,6,0,25,19
1746551197422,CLRE 250,A00,891860,Morris; Sheldon,9995,0,9999,4
1746551199474,CLRE 251R,A00,907817,Mehta; Ravindra L.,9994,0,9999,5
1746551200497,CLRE 252,A00,891864,Cuomo; Raphael Eduardo,9993,0,9999,6
1746551201523,CLRE 253,A00,891867,Vaida; Florin,9994,0,9999,5
1746551201523,CLRE 253,B00,907819,Staff,9999,0,9999,0
1746551202549,CLRE 259,A00,891868,Patel; Hemal,9998,0,9999,1
1746551203575,CLRE 260,A00,891872,Cuomo; Raphael Eduardo,9999,0,9999,0
1746551204604,CLRE 297,001,891888,Cuomo; Raphael Eduardo,9999,0,9999,0
1746551205667,CSE 191,A00,958773,Minnes Kemp; Mor Mia,9996,0,9999,3
1746551206695,CSE 197,001,959846,Minnes Kemp; Mor Mia,9990,0,9999,9
1746551207723,CSS 201S,A01,892054,Mignozzetti; Umberto,26,0,30,4
1746551208748,CSS 202S,A01,892056,Mignozzetti; Umberto,26,0,30,4
1746551209775,DSC 197,001,956898,Eldridge; Justin Matthew,9997,0,9999,2
1746551210801,DSC 297,001,958000,Mazumdar; Arya,9998,0,9999,1
1746551210801,DSC 297,002,959862,Wang; Yusu,9998,0,9999,1
1746551211825,EAP 100,A00,905686,Staff,9778,0,9999,221
1746551212855,ECE 45,A01,892618,Staff,0,0,65,65
1746551214909,ECE 111,A01,892719,Staff,4,0,65,61
1746551215934,ECE 197,001,957920,Mercier; Patrick Philip,9991,0,9999,8
1746551216961,ECON 178,A01,907814,Zhu; Ying,26,0,35,9
1746551217989,EDS 115,A00,895312,Staff,35,0,45,10
1746551219014,EDS 117,A01,895337,Staff,24,0,30,6
1746551220040,EDS 125,A00,895341,Jones; Gabrielle Anastasia,37,0,45,8
1746551221066,EDS 128A,A01,895459,Fargason; Sharon Gayle,44,0,45,1
1746551222091,EDS 128B,A01,895543,Pappas; Elizabeth,44,0,45,1
1746551223118,EDS 139,A00,897203,Pappas; Elizabeth,44,0,45,1
1746551223118,EDS 139,B00,897209,Fargason; Sharon Gayle,41,0,45,4
1746551224145,EDS 201,A00,895545,Staff,22,0,45,23
1746551225171,EDS 203,A01,895581,Halter; Christopher P.,22,0,45,23
1746551226239,EDS 204R,A01,895625,Heinzman; Erica M.,39,0,45,6
1746551226239,EDS 204R,B01,895693,Halter; Christopher P.,10,0,45,35
1746551227266,EDS 206R,A00,895694,Fargason; Sharon Gayle,1,0,30,29
1746551227266,EDS 206R,B00,895695,Choi; Bailey Miyeon,16,0,30,14
1746551228295,EDS 250,A00,895697,Hemans; Patricia Ann Benitez,22,0,45,23
1746551229322,EDS 281,A00,895701,Meyerott; Theresa Ann,1,0,15,14
1746551230348,EDS 284,A00,895736,Meyerott; Theresa Ann,1,0,15,14
1746551231374,EDS 286,A00,897210,Fine; Sarah,0,0,15,15
1746551232398,EDS 289C,A01,895770,Daly; Alan J.,15,0,15,0
1746551233425,EDS 290,A00,897211,Hofstetter; Carolyn,0,0,15,15
1746551234450,LIGM 5A,A00,896162,Fischer-Grunski; Eva K,13,0,20,7
1746551235476,LIGM 5B,A00,896260,Fischer-Grunski; Eva K,17,0,20,3
1746551236502,LIGM 5C,A00,896308,Fischer-Grunski; Eva K,18,0,20,2
1746551237530,LIIT 5AS,A00,896313,Carnelos; Chiara,18,0,20,2
1746551238555,LIIT 5BS,A00,896416,Carnelos; Chiara,20,0,20,0
1746551239580,LIIT 5CS,A00,896564,Carnelos; Chiara,20,0,20,0
1746551240605,LISP 5A,A00,896588,Munoz Sanchez; Alicia,3,0,20,17
1746551241633,LISP 5B,A00,896653,Munoz Sanchez; Alicia,7,0,20,13
1746551242661,LISP 5C,A00,896655,Munoz Sanchez; Alicia,0,1,20,20
1746551243686,MAE 197,001,957918,Kleissl; Jan,9996,0,9999,3
1746551243686,MAE 197,002,959806,Boechler; Nicholas Sebastia,9998,0,9999,1
1746551243686,MAE 197,003,959852,Mullin; Jennifer S,9998,0,9999,1
1746551244715,MATH 2,A01,957937,Staff,33,0,35,2
1746551245742,MATH 197,001,957876,Kedlaya; Kiran S.,9993,0,9999,6
1746551246768,MCWP 40,A00,892729,Duru; Nur,10,0,20,10
1746551246768,MCWP 40,B00,893304,Montejo; Carolina,14,0,20,6
1746551247794,MCWP 40R,A00,893757,Redela; Pamela Morgan,0,5,20,20
1746551248820,MCWP 50,A00,893758,Morshed; Michael James,0,0,20,20
1746551248820,MCWP 50,B00,893761,Bartulis; Jason Michael,17,0,20,3
1746551249845,MCWP 50R,A00,893766,Compas; Sean Matthew,0,1,20,20
1746551249845,MCWP 50R,B00,893769,Carter; Jennifer A,0,1,20,20
1746551249845,MCWP 50R,C00,893771,Krone; Jarret,0,3,20,20
1746551249845,MCWP 50R,D00,893772,Miller; Elizabeth Deen,0,0,20,20
1746551249845,MCWP 50R,E00,893775,Carter; Andrea L,0,1,20,20
1746551250878,MMW 11R,A01,892721,Herbst; Matthew,11,0,27,16
1746551250878,MMW 11R,A02,892722,Herbst; Matthew,0,0,0,3
1746551251903,MMW 12R,A01,892724,Herbst; Matthew,0,11,16,16
1746551251903,MMW 12R,A02,892725,Herbst; Matthew,0,10,16,16
1746551252927,MMW 13R,A01,892727,Staff,0,4,16,16
1746551252927,MMW 13R,A02,892728,Staff,0,4,16,16
1746551252927,MMW 13R,A03,958032,Staff,0,4,16,16
1746551252927,MMW 13R,A04,958033,Staff,0,4,16,16
1746551252927,MMW 13R,A05,958034,Staff,0,4,16,16
1746551253952,SIO 295LS,A00,894015,Staff,5,0,25,20
1746551254980,SIO 295S,A00,894020,Staff,5,0,25,20
1746551256009,SIOC 290S,B01,958918,Merrifield; Mark A,14,0,30,16
1746551257033,SIOC 291S,B01,958922,Gabriel; Corey John,14,0,30,16
1746551258059,SOCI 117,A01,895339,Staff,3,0,5,2
1746551259086,WES 237B,A00,894149,Staff,11,0,20,9
1746551261142,AESE 279B,A00,891859,Staff,13,0,35,22
1746551262166,AIP 197,001,891854,Vespa; Emanuel Ignacio,9999,0,9999,0
1746551263192,ANTH 289S,A00,891856,Gagneux; Pascal,12,0,12,0
1746551264216,BENG 196,001,957946,Engler; Adam J.,9996,0,9999,3
1746551265241,BISP 197,001,959851,Wilhelm; James E.,9998,0,9999,1
1746551266265,CAT 124RS,A01,956906,Staff,6,0,25,19
1746551267291,CAT 125RS,A01,922013,Staff,6,0,25,19
1746551268316,CLRE 250,A00,891860,Morris; Sheldon,9995,0,9999,4
1746551270365,CLRE 251R,A00,907817,Mehta; Ravindra L.,9994,0,9999,5
1746551271390,CLRE 252,A00,891864,Cuomo; Raphael Eduardo,9993,0,9999,6
1746551272414,CLRE 253,A00,891867,Vaida; Florin,9994,0,9999,5
1746551272414,CLRE 253,B00,907819,Staff,9999,0,9999,0
1746551273438,CLRE 259,A00,891868,Patel; Hemal,9998,0,9999,1
1746551274466,CLRE 260,A00,891872,Cuomo; Raphael Eduardo,9999,0,9999,0
1746551275491,CLRE 297,001,891888,Cuomo; Raphael Eduardo,9999,0,9999,0
1746551276517,CSE 191,A00,958773,Minnes Kemp; Mor Mia,9996,0,9999,3
1746551277545,CSE 197,001,959846,Minnes Kemp; Mor Mia,9990,0,9999,9
1746551278571,CSS 201S,A01,892054,Mignozzetti; Umberto,26,0,30,4
1746551279596,CSS 202S,A01,892056,Mignozzetti; Umberto,26,0,30,4
1746551280621,DSC 197,001,956898,Eldridge; Justin Matthew,9997,0,9999,2
1746551281646,DSC 297,001,958000,Mazumdar; Arya,9998,0,9999,1
1746551281646,DSC 297,002,959862,Wang; Yusu,9998,0,9999,1
1746551282671,EAP 100,A00,905686,Staff,9778,0,9999,221
1746551283699,ECE 45,A01,892618,Staff,0,0,65,65
1746551285750,ECE 111,A01,892719,Staff,4,0,65,61
1746551286774,ECE 197,001,957920,Mercier; Patrick Philip,9991,0,9999,8
1746551287803,ECON 178,A01,907814,Zhu; Ying,26,0,35,9
1746551288832,EDS 115,A00,895312,Staff,35,0,45,10
1746551289858,EDS 117,A01,895337,Staff,23,0,30,7
1746551290886,EDS 125,A00,895341,Jones; Gabrielle Anastasia,36,0,45,9
1746551291913,EDS 128A,A01,895459,Fargason; Sharon Gayle,44,0,45,1
1746551292938,EDS 128B,A01,895543,Pappas; Elizabeth,44,0,45,1
1746551293962,EDS 139,A00,897203,Pappas; Elizabeth,44,0,45,1
1746551293962,EDS 139,B00,897209,Fargason; Sharon Gayle,41,0,45,4
1746551294991,EDS 201,A00,895545,Staff,22,0,45,23
1746551296020,EDS 203,A01,895581,Halter; Christopher P.,22,0,45,23
1746551297045,EDS 204R,A01,895625,Heinzman; Erica M.,39,0,45,6
1746551297045,EDS 204R,B01,895693,Halter; Christopher P.,10,0,45,35
1746551298072,EDS 206R,A00,895694,Fargason; Sharon Gayle,1,0,30,29
1746551298072,EDS 206R,B00,895695,Choi; Bailey Miyeon,16,0,30,14
1746551299102,EDS 250,A00,895697,Hemans; Patricia Ann Benitez,22,0,45,23
1746551300129,EDS 281,A00,895701,Meyerott; Theresa Ann,1,0,15,14
1746551301155,EDS 284,A00,895736,Meyerott; Theresa Ann,1,0,15,14
1746551302184,EDS 286,A00,897210,Fine; Sarah,0,0,15,15
1746551303210,EDS 289C,A01,895770,Daly; Alan J.,15,0,15,0
1746551304236,EDS 290,A00,897211,Hofstetter; Carolyn,0,0,15,15
1746551305265,LIGM 5A,A00,896162,Fischer-Grunski; Eva K,13,0,20,7
1746551306290,LIGM 5B,A00,896260,Fischer-Grunski; Eva K,17,0,20,3
1746551307317,LIGM 5C,A00,896308,Fischer-Grunski; Eva K,18,0,20,2
1746551308345,LIIT 5AS,A00,896313,Carnelos; Chiara,18,0,20,2
1746551309427,LIIT 5BS,A00,896416,Carnelos; Chiara,20,0,20,0
1746551310451,LIIT 5CS,A00,896564,Carnelos; Chiara,20,0,20,0
1746551311476,LISP 5A,A00,896588,Munoz Sanchez; Alicia,3,0,20,17
1746551312504,LISP 5B,A00,896653,Munoz Sanchez; Alicia,7,0,20,13
1746551313531,LISP 5C,A00,896655,Munoz Sanchez; Alicia,0,1,20,20
1746551314556,MAE 197,001,957918,Kleissl; Jan,9996,0,9999,3
1746551314556,MAE 197,002,959806,Boechler; Nicholas Sebastia,9998,0,9999,1
1746551314556,MAE 197,003,959852,Mullin; Jennifer S,9998,0,9999,1
1746551315581,MATH 2,A01,957937,Staff,33,0,35,2
1746551316605,MATH 197,001,957876,Kedlaya; Kiran S.,9993,0,9999,6
1746551317634,MCWP 40,A00,892729,Duru; Nur,10,0,20,10
1746551317634,MCWP 40,B00,893304,Montejo; Carolina,14,0,20,6
1746551318659,MCWP 40R,A00,893757,Redela; Pamela Morgan,0,5,20,20
1746551319687,MCWP 50,A00,893758,Morshed; Michael James,0,0,20,20
1746551319687,MCWP 50,B00,893761,Bartulis; Jason Michael,17,0,20,3
1746551320713,MCWP 50R,A00,893766,Compas; Sean Matthew,0,1,20,20
1746551320713,MCWP 50R,B00,893769,Carter; Jennifer A,0,1,20,20
1746551320713,MCWP 50R,C00,893771,Krone; Jarret,0,3,20,20
1746551320713,MCWP 50R,D00,893772,Miller; Elizabeth Deen,0,0,20,20
1746551320713,MCWP 50R,E00,893775,Carter; Andrea L,0,1,20,20
1746551321739,MMW 11R,A01,892721,Herbst; Matthew,11,0,27,16
1746551321739,MMW 11R,A02,892722,Herbst; Matthew,0,0,0,3
1746551322763,MMW 12R,A01,892724,Herbst; Matthew,0,11,16,16
1746551322763,MMW 12R,A02,892725,Herbst; Matthew,0,10,16,16
1746551323792,MMW 13R,A01,892727,Staff,0,4,16,16
1746551323792,MMW 13R,A02,892728,Staff,0,4,16,16
1746551323792,MMW 13R,A03,958032,Staff,0,4,16,16
1746551323792,MMW 13R,A04,958033,Staff,0,4,16,16
1746551323792,MMW 13R,A05,958034,Staff,0,4,16,16
1746551324817,SIO 295LS,A00,894015,Staff,5,0,25,20
1746551325844,SIO 295S,A00,894020,Staff,5,0,25,20
1746551326873,SIOC 290S,B01,958918,Merrifield; Mark A,14,0,30,16
1746551327908,SIOC 291S,B01,958922,Gabriel; Corey John,14,0,30,16
1746551328932,SOCI 117,A01,895339,Staff,3,0,5,2
1746551329960,WES 237B,A00,894149,Staff,11,0,20,9
1746551332030,AESE 279B,A00,891859,Staff,13,0,35,22
1746551333055,AIP 197,001,891854,Vespa; Emanuel Ignacio,9999,0,9999,0
1746551334080,ANTH 289S,A00,891856,Gagneux; Pascal,12,0,12,0
1746551335104,BENG 196,001,957946,Engler; Adam J.,9996,0,9999,3
1746551336134,BISP 197,001,959851,Wilhelm; James E.,9998,0,9999,1
1746551337158,CAT 124RS,A01,956906,Staff,6,0,25,19
1746551338184,CAT 125RS,A01,922013,Staff,6,0,25,19
1746551339209,CLRE 250,A00,891860,Morris; Sheldon,9995,0,9999,4
1746551341264,CLRE 251R,A00,907817,Mehta; Ravindra L.,9994,0,9999,5
1746551342292,CLRE 252,A00,891864,Cuomo; Raphael Eduardo,9993,0,9999,6
1746551343318,CLRE 253,A00,891867,Vaida; Florin,9994,0,9999,5
1746551343318,CLRE 253,B00,907819,Staff,9999,0,9999,0
1746551344348,CLRE 259,A00,891868,Patel; Hemal,9998,0,9999,1
1746551345376,CLRE 260,A00,891872,Cuomo; Raphael Eduardo,9999,0,9999,0
1746551346402,CLRE 297,001,891888,Cuomo; Raphael Eduardo,9999,0,9999,0
1746551347426,CSE 191,A00,958773,Minnes Kemp; Mor Mia,9996,0,9999,3
1746551348452,CSE 197,001,959846,Minnes Kemp; Mor Mia,9990,0,9999,9
1746551349484,CSS 201S,A01,892054,Mignozzetti; Umberto,26,0,30,4
1746551350513,CSS 202S,A01,892056,Mignozzetti; Umberto,26,0,30,4
1746551351540,DSC 197,001,956898,Eldridge; Justin Matthew,9997,0,9999,2
1746551352567,DSC 297,001,958000,Mazumdar; Arya,9998,0,9999,1
1746551352567,DSC 297,002,959862,Wang; Yusu,9998,0,9999,1
1746551353592,EAP 100,A00,905686,Staff,9778,0,9999,221
1746551354619,ECE 45,A01,892618,Staff,0,0,65,65
1746551356669,ECE 111,A01,892719,Staff,4,0,65,61
1746551357694,ECE 197,001,957920,Mercier; Patrick Philip,9991,0,9999,8
1746551358720,ECON 178,A01,907814,Zhu; Ying,26,0,35,9
1746551359745,EDS 115,A00,895312,Staff,35,0,45,10
1746551360771,EDS 117,A01,895337,Staff,23,0,30,7
1746551361799,EDS 125,A00,895341,Jones; Gabrielle Anastasia,36,0,45,9
1746551362828,EDS 128A,A01,895459,Fargason; Sharon Gayle,44,0,45,1
1746551363858,EDS 128B,A01,895543,Pappas; Elizabeth,44,0,45,1
1746551364885,EDS 139,A00,897203,Pappas; Elizabeth,44,0,45,1
1746551364885,EDS 139,B00,897209,Fargason; Sharon Gayle,41,0,45,4
1746551365911,EDS 201,A00,895545,Staff,22,0,45,23
1746551366935,EDS 203,A01,895581,Halter; Christopher P.,22,0,45,23
1746551367961,EDS 204R,A01,895625,Heinzman; Erica M.,39,0,45,6
1746551367961,EDS 204R,B01,895693,Halter; Christopher P.,10,0,45,35
1746551368987,EDS 206R,A00,895694,Fargason; Sharon Gayle,1,0,30,29
1746551368987,EDS 206R,B00,895695,Choi; Bailey Miyeon,16,0,30,14
1746551370012,EDS 250,A00,895697,Hemans; Patricia Ann Benitez,22,0,45,23
1746551371037,EDS 281,A00,895701,Meyerott; Theresa Ann,1,0,15,14
1746551372062,EDS 284,A00,895736,Meyerott; Theresa Ann,1,0,15,14
1746551373087,EDS 286,A00,897210,Fine; Sarah,0,0,15,15
1746551374112,EDS 289C,A01,895770,Daly; Alan J.,15,0,15,0
1746551375138,EDS 290,A00,897211,Hofstetter; Carolyn,0,0,15,15
1746551376165,LIGM 5A,A00,896162,Fischer-Grunski; Eva K,13,0,20,7
1746551377189,LIGM 5B,A00,896260,Fischer-Grunski; Eva K,17,0,20,3
1746551378216,LIGM 5C,A00,896308,Fischer-Grunski; Eva K,18,0,20,2
1746551379245,LIIT 5AS,A00,896313,Carnelos; Chiara,18,0,20,2
1746551380270,LIIT 5BS,A00,896416,Carnelos; Chiara,20,0,20,0
1746551381300,LIIT 5CS,A00,896564,Carnelos; Chiara,20,0,20,0
1746551382329,LISP 5A,A00,896588,Munoz Sanchez; Alicia,3,0,20,17
1746551383355,LISP 5B,A00,896653,Munoz Sanchez; Alicia,7,0,20,13
1746551384381,LISP 5C,A00,896655,Munoz Sanchez; Alicia,0,1,20,20
1746551385409,MAE 197,001,957918,Kleissl; Jan,9996,0,9999,3
1746551385409,MAE 197,002,959806,Boechler; Nicholas Sebastia,9998,0,9999,1
1746551385409,MAE 197,003,959852,Mullin; Jennifer S,9998,0,9999,1
1746551386434,MATH 2,A01,957937,Staff,33,0,35,2
1746551387458,MATH 197,001,957876,Kedlaya; Kiran S.,9993,0,9999,6
1746551388486,MCWP 40,A00,892729,Duru; Nur,10,0,20,10
1746551388486,MCWP 40,B00,893304,Montejo; Carolina,14,0,20,6
1746551389515,MCWP 40R,A00,893757,Redela; Pamela Morgan,0,5,20,20
1746551390540,MCWP 50,A00,893758,Morshed; Michael James,0,0,20,20
1746551390540,MCWP 50,B00,893761,Bartulis; Jason Michael,17,0,20,3
1746551391569,MCWP 50R,A00,893766,Compas; Sean Matthew,0,1,20,20
1746551391569,MCWP 50R,B00,893769,Carter; Jennifer A,0,1,20,20
1746551391569,MCWP 50R,C00,893771,Krone; Jarret,0,3,20,20
1746551391569,MCWP 50R,D00,893772,Miller; Elizabeth Deen,0,0,20,20
1746551391569,MCWP 50R,E00,893775,Carter; Andrea L,0,1,20,20
1746551392595,MMW 11R,A01,892721,Herbst; Matthew,11,0,27,16
1746551392595,MMW 11R,A02,892722,Herbst; Matthew,0,0,0,3
1746551393621,MMW 12R,A01,892724,Herbst; Matthew,0,11,16,16
1746551393621,MMW 12R,A02,892725,Herbst; Matthew,0,10,16,16
1746551394649,MMW 13R,A01,892727,Staff,0,4,16,16
1746551394649,MMW 13R,A02,892728,Staff,0,4,16,16
1746551394649,MMW 13R,A03,958032,Staff,0,4,16,16
1746551394649,MMW 13R,A04,958033,Staff,0,4,16,16
1746551394649,MMW 13R,A05,958034,Staff,0,4,16,16
1746551395675,SIO 295LS,A00,894015,Staff,5,0,25,20
1746551396701,SIO 295S,A00,894020,Staff,5,0,25,20
1746551397729,SIOC 290S,B01,958918,Merrifield; Mark A,14,0,30,16
1746551398755,SIOC 291S,B01,958922,Gabriel; Corey John,14,0,30,16
1746551399781,SOCI 117,A01,895339,Staff,3,0,5,2
1746551400808,WES 237B,A00,894149,Staff,11,0,20,9
1746551402869,AESE 279B,A00,891859,Staff,13,0,35,22
1746551403898,AIP 197,001,891854,Vespa; Emanuel Ignacio,9999,0,9999,0
1746551404922,ANTH 289S,A00,891856,Gagneux; Pascal,12,0,12,0
1746551405947,BENG 196,001,957946,Engler; Adam J.,9996,0,9999,3
1746551406972,BISP 197,001,959851,Wilhelm; James E.,9998,0,9999,1
1746551407996,CAT 124RS,A01,956906,Staff,6,0,25,19
1746551409022,CAT 125RS,A01,922013,Staff,6,0,25,19
1746551410051,CLRE 250,A00,891860,Morris; Sheldon,9995,0,9999,4
1746551412108,CLRE 251R,A00,907817,Mehta; Ravindra L.,9994,0,9999,5
1746551413173,CLRE 252,A00,891864,Cuomo; Raphael Eduardo,9993,0,9999,6
1746551414198,CLRE 253,A00,891867,Vaida; Florin,9994,0,9999,5
1746551414198,CLRE 253,B00,907819,Staff,9999,0,9999,0
1746551415222,CLRE 259,A00,891868,Patel; Hemal,9998,0,9999,1
1746551416253,CLRE 260,A00,891872,Cuomo; Raphael Eduardo,9999,0,9999,0
1746551417279,CLRE 297,001,891888,Cuomo; Raphael Eduardo,9999,0,9999,0
1746551418306,CSE 191,A00,958773,Minnes Kemp; Mor Mia,9996,0,9999,3
1746551419330,CSE 197,001,959846,Minnes Kemp; Mor Mia,9990,0,9999,9
1746551420360,CSS 201S,A01,892054,Mignozzetti; Umberto,26,0,30,4
1746551421386,CSS 202S,A01,892056,Mignozzetti; Umberto,26,0,30,4
1746551422426,DSC 197,001,956898,Eldridge; Justin Matthew,9997,0,9999,2
1746551423454,DSC 297,001,958000,Mazumdar; Arya,9998,0,9999,1
1746551423454,DSC 297,002,959862,Wang; Yusu,9998,0,9999,1
1746551424479,EAP 100,A00,905686,Staff,9778,0,9999,221
1746551425510,ECE 45,A01,892618,Staff,0,0,65,65
1746551427561,ECE 111,A01,892719,Staff,4,0,65,61
1746551428586,ECE 197,001,957920,Mercier; Patrick Philip,9991,0,9999,8
1746551429611,ECON 178,A01,907814,Zhu; Ying,26,0,35,9
1746551430638,EDS 115,A00,895312,Staff,35,0,45,10
1746551431663,EDS 117,A01,895337,Staff,23,0,30,7
1746551432687,EDS 125,A00,895341,Jones; Gabrielle Anastasia,36,0,45,9
1746551433714,EDS 128A,A01,895459,Fargason; Sharon Gayle,44,0,45,1
1746551434740,EDS 128B,A01,895543,Pappas; Elizabeth,44,0,45,1
1746551435765,EDS 139,A00,897203,Pappas; Elizabeth,44,0,45,1
1746551435765,EDS 139,B00,897209,Fargason; Sharon Gayle,41,0,45,4
1746551436796,EDS 201,A00,895545,Staff,22,0,45,23
1746551437825,EDS 203,A01,895581,Halter; Christopher P.,22,0,45,23
1746551438851,EDS 204R,A01,895625,Heinzman; Erica M.,39,0,45,6
1746551438851,EDS 204R,B01,895693,Halter; Christopher P.,10,0,45,35
1746551439877,EDS 206R,A00,895694,Fargason; Sharon Gayle,1,0,30,29
1746551439877,EDS 206R,B00,895695,Choi; Bailey Miyeon,16,0,30,14
1746551440901,EDS 250,A00,895697,Hemans; Patricia Ann Benitez,22,0,45,23
1746551441925,EDS 281,A00,895701,Meyerott; Theresa Ann,1,0,15,14
1746551442950,EDS 284,A00,895736,Meyerott; Theresa Ann,1,0,15,14
1746551443977,EDS 286,A00,897210,Fine; Sarah,0,0,15,15
1746551445005,EDS 289C,A01,895770,Daly; Alan J.,15,0,15,0
1746551446029,EDS 290,A00,897211,Hofstetter; Carolyn,0,0,15,15
1746551447053,LIGM 5A,A00,896162,Fischer-Grunski; Eva K,13,0,20,7
1746551448084,LIGM 5B,A00,896260,Fischer-Grunski; Eva K,17,0,20,3
1746551449114,LIGM 5C,A00,896308,Fischer-Grunski; Eva K,18,0,20,2
1746551450142,LIIT 5AS,A00,896313,Carnelos; Chiara,18,0,20,2
1746551451170,LIIT 5BS,A00,896416,Carnelos; Chiara,20,0,20,0
1746551452199,LIIT 5CS,A00,896564,Carnelos; Chiara,20,0,20,0
1746551453223,LISP 5A,A00,896588,Munoz Sanchez; Alicia,3,0,20,17
1746551454250,LISP 5B,A00,896653,Munoz Sanchez; Alicia,7,0,20,13
1746551455279,LISP 5C,A00,896655,Munoz Sanchez; Alicia,0,1,20,20
1746551456304,MAE 197,001,957918,Kleissl; Jan,9996,0,9999,3
1746551456304,MAE 197,002,959806,Boechler; Nicholas Sebastia,9998,0,9999,1
1746551456304,MAE 197,003,959852,Mullin; Jennifer S,9998,0,9999,1
1746551457331,MATH 2,A01,957937,Staff,33,0,35,2
1746551458358,MATH 197,001,957876,Kedlaya; Kiran S.,9993,0,9999,6
1746551459384,MCWP 40,A00,892729,Duru; Nur,10,0,20,10
1746551459384,MCWP 40,B00,893304,Montejo; Carolina,14,0,20,6
1746551460410,MCWP 40R,A00,893757,Redela; Pamela Morgan,0,5,20,20
1746551461438,MCWP 50,A00,893758,Morshed; Michael James,0,0,20,20
1746551461438,MCWP 50,B00,893761,Bartulis; Jason Michael,17,0,20,3
1746551462468,MCWP 50R,A00,893766,Compas; Sean Matthew,0,1,20,20
1746551462468,MCWP 50R,B00,893769,Carter; Jennifer A,0,1,20,20
1746551462468,MCWP 50R,C00,893771,Krone; Jarret,0,3,20,20
1746551462468,MCWP 50R,D00,893772,Miller; Elizabeth Deen,0,0,20,20
1746551462468,MCWP 50R,E00,893775,Carter; Andrea L,0,1,20,20
1746551463495,MMW 11R,A01,892721,Herbst; Matthew,11,0,27,16
1746551463495,MMW 11R,A02,892722,Herbst; Matthew,0,0,0,3
1746551464520,MMW 12R,A01,892724,Herbst; Matthew,0,11,16,16
1746551464520,MMW 12R,A02,892725,Herbst; Matthew,0,10,16,16
1746551465545,MMW 13R,A01,892727,Staff,0,4,16,16
1746551465545,MMW 13R,A02,892728,Staff,0,4,16,16
1746551465545,MMW 13R,A03,958032,Staff,0,4,16,16
1746551465545,MMW 13R,A04,958033,Staff,0,4,16,16
1746551465545,MMW 13R,A05,958034,Staff,0,4,16,16
1746551466570,SIO 295LS,A00,894015,Staff,5,0,25,20
1746551467598,SIO 295S,A00,894020,Staff,5,0,25,20
1746551468623,SIOC 290S,B01,958918,Merrifield; Mark A,14,0,30,16
1746551469649,SIOC 291S,B01,958922,Gabriel; Corey John,14,0,30,16
1746551470674,SOCI 117,A01,895339,Staff,3,0,5,2
1746551471699,WES 237B,A00,894149,Staff,11,0,20,9
1746551473758,AESE 279B,A00,891859,Staff,13,0,35,22
1746551474784,AIP 197,001,891854,Vespa; Emanuel Ignacio,9999,0,9999,0
1746551475808,ANTH 289S,A00,891856,Gagneux; Pascal,12,0,12,0
1746551476835,BENG 196,001,957946,Engler; Adam J.,9996,0,9999,3
1746551477861,BISP 197,001,959851,Wilhelm; James E.,9998,0,9999,1
1746551478888,CAT 124RS,A01,956906,Staff,6,0,25,19
1746551479913,CAT 125RS,A01,922013,Staff,6,0,25,19
1746551480941,CLRE 250,A00,891860,Morris; Sheldon,9995,0,9999,4
1746551482992,CLRE 251R,A00,907817,Mehta; Ravindra L.,9994,0,9999,5
1746551484016,CLRE 252,A00,891864,Cuomo; Raphael Eduardo,9993,0,9999,6
1746551485042,CLRE 253,A00,891867,Vaida; Florin,9994,0,9999,5
1746551485042,CLRE 253,B00,907819,Staff,9999,0,9999,0
1746551486069,CLRE 259,A00,891868,Patel; Hemal,9998,0,9999,1
1746551487095,CLRE 260,A00,891872,Cuomo; Raphael Eduardo,9999,0,9999,0
1746551488119,CLRE 297,001,891888,Cuomo; Raphael Eduardo,9999,0,9999,0
1746551489146,CSE 191,A00,958773,Minnes Kemp; Mor Mia,9996,0,9999,3
1746551490172,CSE 197,001,959846,Minnes Kemp; Mor Mia,9990,0,9999,9
1746551491199,CSS 201S,A01,892054,Mignozzetti; Umberto,26,0,30,4
1746551492225,CSS 202S,A01,892056,Mignozzetti; Umberto,26,0,30,4
1746551493250,DSC 197,001,956898,Eldridge; Justin Matthew,9997,0,9999,2
1746551494274,DSC 297,001,958000,Mazumdar; Arya,9998,0,9999,1
1746551494274,DSC 297,002,959862,Wang; Yusu,9998,0,9999,1
1746551495300,EAP 100,A00,905686,Staff,9778,0,9999,221
1746551496325,ECE 45,A01,892618,Staff,0,0,65,65
1746551498377,ECE 111,A01,892719,Staff,4,0,65,61
1746551499402,ECE 197,001,957920,Mercier; Patrick Philip,9991,0,9999,8
1746551500430,ECON 178,A01,907814,Zhu; Ying,26,0,35,9
1746551501455,EDS 115,A00,895312,Staff,35,0,45,10
1746551502482,EDS 117,A01,895337,Staff,23,0,30,7
1746551503507,EDS 125,A00,895341,Jones; Gabrielle Anastasia,36,0,45,9
1746551504531,EDS 128A,A01,895459,Fargason; Sharon Gayle,44,0,45,1
1746551505556,EDS 128B,A01,895543,Pappas; Elizabeth,44,0,45,1
1746551506585,EDS 139,A00,897203,Pappas; Elizabeth,44,0,45,1
1746551506585,EDS 139,B00,897209,Fargason; Sharon Gayle,41,0,45,4
1746551507609,EDS 201,A00,895545,Staff,22,0,45,23
1746551508632,EDS 203,A01,895581,Halter; Christopher P.,22,0,45,23
1746551509657,EDS 204R,A01,895625,Heinzman; Erica M.,39,0,45,6
1746551509657,EDS 204R,B01,895693,Halter; Christopher P.,10,0,45,35
1746551510683,EDS 206R,A00,895694,Fargason; Sharon Gayle,1,0,30,29
1746551510683,EDS 206R,B00,895695,Choi; Bailey Miyeon,16,0,30,14
1746551511708,EDS 250,A00,895697,Hemans; Patricia Ann Benitez,22,0,45,23
1746551512731,EDS 281,A00,895701,Meyerott; Theresa Ann,1,0,15,14
1746551513755,EDS 284,A00,895736,Meyerott; Theresa Ann,1,0,15,14
1746551514780,EDS 286,A00,897210,Fine; Sarah,0,0,15,15
1746551515807,EDS 289C,A01,895770,Daly; Alan J.,15,0,15,0
1746551516872,EDS 290,A00,897211,Hofstetter; Carolyn,0,0,15,15
1746551517901,LIGM 5A,A00,896162,Fischer-Grunski; Eva K,13,0,20,7
1746551518926,LIGM 5B,A00,896260,Fischer-Grunski; Eva K,17,0,20,3
1746551519951,LIGM 5C,A00,896308,Fischer-Grunski; Eva K,18,0,20,2
1746551520976,LIIT 5AS,A00,896313,Carnelos; Chiara,18,0,20,2
1746551522005,LIIT 5BS,A00,896416,Carnelos; Chiara,20,0,20,0
1746551523031,LIIT 5CS,A00,896564,Carnelos; Chiara,20,0,20,0
1746551524060,LISP 5A,A00,896588,Munoz Sanchez; Alicia,3,0,20,17
1746551525085,LISP 5B,A00,896653,Munoz Sanchez; Alicia,7,0,20,13
1746551526112,LISP 5C,A00,896655,Munoz Sanchez; Alicia,0,1,20,20
1746551527140,MAE 197,001,957918,Kleissl; Jan,9996,0,9999,3
1746551527140,MAE 197,002,959806,Boechler; Nicholas Sebastia,9998,0,9999,1
1746551527140,MAE 197,003,959852,Mullin; Jennifer S,9998,0,9999,1
1746551528164,MATH 2,A01,957937,Staff,33,0,35,2
1746551529189,MATH 197,001,957876,Kedlaya; Kiran S.,9993,0,9999,6
1746551530216,MCWP 40,A00,892729,Duru; Nur,10,0,20,10
1746551530216,MCWP 40,B00,893304,Montejo; Carolina,14,0,20,6
1746551531244,MCWP 40R,A00,893757,Redela; Pamela Morgan,0,5,20,20
1746551532270,MCWP 50,A00,893758,Morshed; Michael James,0,0,20,20
1746551532270,MCWP 50,B00,893761,Bartulis; Jason Michael,17,0,20,3
1746551533295,MCWP 50R,A00,893766,Compas; Sean Matthew,0,1,20,20
1746551533295,MCWP 50R,B00,893769,Carter; Jennifer A,0,1,20,20
1746551533295,MCWP 50R,C00,893771,Krone; Jarret,0,3,20,20
1746551533295,MCWP 50R,D00,893772,Miller; Elizabeth Deen,0,0,20,20
1746551533295,MCWP 50R,E00,893775,Carter; Andrea L,0,1,20,20
1746551534319,MMW 11R,A01,892721,Herbst; Matthew,11,0,27,16
1746551534319,MMW 11R,A02,892722,Herbst; Matthew,0,0,0,3
1746551535346,MMW 12R,A01,892724,Herbst; Matthew,0,11,16,16
1746551535346,MMW 12R,A02,892725,Herbst; Matthew,0,10,16,16
1746551536371,MMW 13R,A01,892727,Staff,0,4,16,16
1746551536371,MMW 13R,A02,892728,Staff,0,4,16,16
1746551536371,MMW 13R,A03,958032,Staff,0,4,16,16
1746551536371,MMW 13R,A04,958033,Staff,0,4,16,16
1746551536371,MMW 13R,A05,958034,Staff,0,4,16,16
1746551537397,SIO 295LS,A00,894015,Staff,5,0,25,20
1746551538426,SIO 295S,A00,894020,Staff,5,0,25,20
1746551539455,SIOC 290S,B01,958918,Merrifield; Mark A,14,0,30,16
1746551540487,SIOC 291S,B01,958922,Gabriel; Corey John,14,0,30,16
1746551541513,SOCI 117,A01,895339,Staff,3,0,5,2
1746551542538,WES 237B,A00,894149,Staff,11,0,20,9
1746551544597,AESE 279B,A00,891859,Staff,13,0,35,22
1746551545629,AIP 197,001,891854,Vespa; Emanuel Ignacio,9999,0,9999,0
1746551546655,ANTH 289S,A00,891856,Gagneux; Pascal,12,0,12,0
1746551547679,BENG 196,001,957946,Engler; Adam J.,9996,0,9999,3
1746551548709,BISP 197,001,959851,Wilhelm; James E.,9998,0,9999,1
1746551549736,CAT 124RS,A01,956906,Staff,6,0,25,19
1746551550764,CAT 125RS,A01,922013,Staff,6,0,25,19
1746551551789,CLRE 250,A00,891860,Morris; Sheldon,9995,0,9999,4
1746551553839,CLRE 251R,A00,907817,Mehta; Ravindra L.,9994,0,9999,5
1746551554864,CLRE 252,A00,891864,Cuomo; Raphael Eduardo,9993,0,9999,6
1746551555892,CLRE 253,A00,891867,Vaida; Florin,9994,0,9999,5
1746551555892,CLRE 253,B00,907819,Staff,9999,0,9999,0
1746551556919,CLRE 259,A00,891868,Patel; Hemal,9998,0,9999,1
1746551557943,CLRE 260,A00,891872,Cuomo; Raphael Eduardo,9999,0,9999,0
1746551558972,CLRE 297,001,891888,Cuomo; Raphael Eduardo,9999,0,9999,0
1746551560000,CSE 191,A00,958773,Minnes Kemp; Mor Mia,9996,0,9999,3
1746551561024,CSE 197,001,959846,Minnes Kemp; Mor Mia,9990,0,9999,9
1746551562050,CSS 201S,A01,892054,Mignozzetti; Umberto,26,0,30,4
1746551563077,CSS 202S,A01,892056,Mignozzetti; Umberto,26,0,30,4
1746551564104,DSC 197,001,956898,Eldridge; Justin Matthew,9997,0,9999,2
1746551565130,DSC 297,001,958000,Mazumdar; Arya,9998,0,9999,1
1746551565130,DSC 297,002,959862,Wang; Yusu,9998,0,9999,1
1746551566153,EAP 100,A00,905686,Staff,9778,0,9999,221
1746551567181,ECE 45,A01,892618,Staff,0,0,65,65
1746551569235,ECE 111,A01,892719,Staff,4,0,65,61
1746551570261,ECE 197,001,957920,Mercier; Patrick Philip,9991,0,9999,8
1746551571287,ECON 178,A01,907814,Zhu; Ying,26,0,35,9
1746551572315,EDS 115,A00,895312,Staff,35,0,45,10
1746551573339,EDS 117,A01,895337,Staff,23,0,30,7
1746551574365,EDS 125,A00,895341,Jones; Gabrielle Anastasia,36,0,45,9
1746551575390,EDS 128A,A01,895459,Fargason; Sharon Gayle,44,0,45,1
1746551576416,EDS 128B,A01,895543,Pappas; Elizabeth,44,0,45,1
1746551577441,EDS 139,A00,897203,Pappas; Elizabeth,44,0,45,1
1746551577441,EDS 139,B00,897209,Fargason; Sharon Gayle,41,0,45,4
1746551578469,EDS 201,A00,895545,Staff,22,0,45,23
1746551579497,EDS 203,A01,895581,Halter; Christopher P.,22,0,45,23
1746551580521,EDS 204R,A01,895625,Heinzman; Erica M.,39,0,45,6
1746551580521,EDS 204R,B01,895693,Halter; Christopher P.,10,0,45,35
1746551581546,EDS 206R,A00,895694,Fargason; Sharon Gayle,1,0,30,29
1746551581546,EDS 206R,B00,895695,Choi; Bailey Miyeon,16,0,30,14
1746551582575,EDS 250,A00,895697,Hemans; Patricia Ann Benitez,22,0,45,23
1746551583601,EDS 281,A00,895701,Meyerott; Theresa Ann,1,0,15,14
1746551584626,EDS 284,A00,895736,Meyerott; Theresa Ann,1,0,15,14
1746551585653,EDS 286,A00,897210,Fine; Sarah,0,0,15,15
1746551586677,EDS 289C,A01,895770,Daly; Alan J.,15,0,15,0
1746551587702,EDS 290,A00,897211,Hofstetter; Carolyn,0,0,15,15
1746551588727,LIGM 5A,A00,896162,Fischer-Grunski; Eva K,13,0,20,7
1746551589755,LIGM 5B,A00,896260,Fischer-Grunski; Eva K,17,0,20,3
1746551590783,LIGM 5C,A00,896308,Fischer-Grunski; Eva K,18,0,20,2
1746551591809,LIIT 5AS,A00,896313,Carnelos; Chiara,18,0,20,2
1746551592835,LIIT 5BS,A00,896416,Carnelos; Chiara,20,0,20,0
1746551593863,LIIT 5CS,A00,896564,Carnelos; Chiara,20,0,20,0
1746551594888,LISP 5A,A00,896588,Munoz Sanchez; Alicia,3,0,20,17
1746551595915,LISP 5B,A00,896653,Munoz Sanchez; Alicia,7,0,20,13
1746551596939,LISP 5C,A00,896655,Munoz Sanchez; Alicia,0,1,20,20
1746551597965,MAE 197,001,957918,Kleissl; Jan,9996,0,9999,3
1746551597965,MAE 197,002,959806,Boechler; Nicholas Sebastia,9998,0,9999,1
1746551597965,MAE 197,003,959852,Mullin; Jennifer S,9998,0,9999,1
1746551598994,MATH 2,A01,957937,Staff,33,0,35,2
1746551600019,MATH 197,001,957876,Kedlaya; Kiran S.,9993,0,9999,6
1746551601043,MCWP 40,A00,892729,Duru; Nur,10,0,20,10
1746551601043,MCWP 40,B00,893304,Montejo; Carolina,14,0,20,6
1746551602070,MCWP 40R,A00,893757,Redela; Pamela Morgan,0,5,20,20
1746551603100,MCWP 50,A00,893758,Morshed; Michael James,0,0,20,20
1746551603100,MCWP 50,B00,893761,Bartulis; Jason Michael,17,0,20,3
1746551604124,MCWP 50R,A00,893766,Compas; Sean Matthew,0,1,20,20
1746551604124,MCWP 50R,B00,893769,Carter; Jennifer A,0,1,20,20
1746551604124,MCWP 50R,C00,893771,Krone; Jarret,0,3,20,20
1746551604124,MCWP 50R,D00,893772,Miller; Elizabeth Deen,0,0,20,20
1746551604124,MCWP 50R,E00,893775,Carter; Andrea L,0,1,20,20
1746551605149,MMW 11R,A01,892721,Herbst; Matthew,11,0,27,16
1746551605149,MMW 11R,A02,892722,Herbst; Matthew,0,0,0,3
1746551606172,MMW 12R,A01,892724,Herbst; Matthew,0,11,16,16
1746551606172,MMW 12R,A02,892725,Herbst; Matthew,0,10,16,16
1746551607200,MMW 13R,A01,892727,Staff,0,4,16,16
1746551607200,MMW 13R,A02,892728,Staff,0,4,16,16
1746551607200,MMW 13R,A03,958032,Staff,0,4,16,16
1746551607200,MMW 13R,A04,958033,Staff,0,4,16,16
1746551607200,MMW 13R,A05,958034,Staff,0,4,16,16
1746551608225,SIO 295LS,A00,894015,Staff,5,0,25,20
1746551609252,SIO 295S,A00,894020,Staff,5,0,25,20
1746551610277,SIOC 290S,B01,958918,Merrifield; Mark A,14,0,30,16
1746551611302,SIOC 291S,B01,958922,Gabriel; Corey John,14,0,30,16
1746551612328,SOCI 117,A01,895339,Staff,3,0,5,2
1746551613352,WES 237B,A00,894149,Staff,11,0,20,9
1746551615405,AESE 279B,A00,891859,Staff,13,0,35,22
1746551616434,AIP 197,001,891854,Vespa; Emanuel Ignacio,9999,0,9999,0
1746551617464,ANTH 289S,A00,891856,Gagneux; Pascal,12,0,12,0
1746551618491,BENG 196,001,957946,Engler; Adam J.,9996,0,9999,3
1746551619518,BISP 197,001,959851,Wilhelm; James E.,9998,0,9999,1
1746551620581,CAT 124RS,A01,956906,Staff,6,0,25,19
1746551621607,CAT 125RS,A01,922013,Staff,6,0,25,19
1746551622636,CLRE 250,A00,891860,Morris; Sheldon,9995,0,9999,4
1746551624689,CLRE 251R,A00,907817,Mehta; Ravindra L.,9994,0,9999,5
1746551625715,CLRE 252,A00,891864,Cuomo; Raphael Eduardo,9993,0,9999,6
1746551626739,CLRE 253,A00,891867,Vaida; Florin,9994,0,9999,5
1746551626739,CLRE 253,B00,907819,Staff,9999,0,9999,0
1746551627766,CLRE 259,A00,891868,Patel; Hemal,9998,0,9999,1
1746551628792,CLRE 260,A00,891872,Cuomo; Raphael Eduardo,9999,0,9999,0
1746551629817,CLRE 297,001,891888,Cuomo; Raphael Eduardo,9999,0,9999,0
1746551630841,CSE 191,A00,958773,Minnes Kemp; Mor Mia,9996,0,9999,3
1746551631867,CSE 197,001,959846,Minnes Kemp; Mor Mia,9990,0,9999,9
1746551632892,CSS 201S,A01,892054,Mignozzetti; Umberto,26,0,30,4
1746551633919,CSS 202S,A01,892056,Mignozzetti; Umberto,26,0,30,4
1746551634945,DSC 197,001,956898,Eldridge; Justin Matthew,9997,0,9999,2
1746551635973,DSC 297,001,958000,Mazumdar; Arya,9998,0,9999,1
1746551635973,DSC 297,002,959862,Wang; Yusu,9998,0,9999,1
1746551636997,EAP 100,A00,905686,Staff,9778,0,9999,221
1746551638028,ECE 45,A01,892618,Staff,0,0,65,65
1746551640080,ECE 111,A01,892719,Staff,4,0,65,61
1746551641105,ECE 197,001,957920,Mercier; Patrick Philip,9991,0,9999,8
1746551642183,ECON 178,A01,907814,Zhu; Ying,26,0,35,9
1746551643207,EDS 115,A00,895312,Staff,35,0,45,10
1746551644234,EDS 117,A01,895337,Staff,23,0,30,7
1746551645259,EDS 125,A00,895341,Jones; Gabrielle Anastasia,36,0,45,9
1746551646284,EDS 128A,A01,895459,Fargason; Sharon Gayle,44,0,45,1
1746551647312,EDS 128B,A01,895543,Pappas; Elizabeth,44,0,45,1
1746551648337,EDS 139,A00,897203,Pappas; Elizabeth,44,0,45,1
1746551648337,EDS 139,B00,897209,Fargason; Sharon Gayle,41,0,45,4
1746551649362,EDS 201,A00,895545,Staff,22,0,45,23
1746551650391,EDS 203,A01,895581,Halter; Christopher P.,22,0,45,23
1746551651415,EDS 204R,A01,895625,Heinzman; Erica M.,39,0,45,6
1746551651415,EDS 204R,B01,895693,Halter; Christopher P.,10,0,45,35
1746551652440,EDS 206R,A00,895694,Fargason; Sharon Gayle,1,0,30,29
1746551652440,EDS 206R,B00,895695,Choi; Bailey Miyeon,16,0,30,14
1746551653464,EDS 250,A00,895697,Hemans; Patricia Ann Benitez,22,0,45,23
1746551654489,EDS 281,A00,895701,Meyerott; Theresa Ann,1,0,15,14
1746551655515,EDS 284,A00,895736,Meyerott; Theresa Ann,1,0,15,14
1746551656539,EDS 286,A00,897210,Fine; Sarah,0,0,15,15
1746551657564,EDS 289C,A01,895770,Daly; Alan J.,15,0,15,0
1746551658590,EDS 290,A00,897211,Hofstetter; Carolyn,0,0,15,15
1746551659613,LIGM 5A,A00,896162,Fischer-Grunski; Eva K,13,0,20,7
1746551660644,LIGM 5B,A00,896260,Fischer-Grunski; Eva K,17,0,20,3
1746551661670,LIGM 5C,A00,896308,Fischer-Grunski; Eva K,18,0,20,2
1746551662696,LIIT 5AS,A00,896313,Carnelos; Chiara,18,0,20,2
1746551663723,LIIT 5BS,A00,896416,Carnelos; Chiara,20,0,20,0
1746551664746,LIIT 5CS,A00,896564,Carnelos; Chiara,20,0,20,0
1746551665774,LISP 5A,A00,896588,Munoz Sanchez; Alicia,3,0,20,17
1746551666800,LISP 5B,A00,896653,Munoz Sanchez; Alicia,7,0,20,13
1746551667823,LISP 5C,A00,896655,Munoz Sanchez; Alicia,0,1,20,20
1746551668849,MAE 197,001,957918,Kleissl; Jan,9996,0,9999,3
1746551668849,MAE 197,002,959806,Boechler; Nicholas Sebastia,9998,0,9999,1
1746551668849,MAE 197,003,959852,Mullin; Jennifer S,9998,0,9999,1
1746551669874,MATH 2,A01,957937,Staff,33,0,35,2
1746551670900,MATH 197,001,957876,Kedlaya; Kiran S.,9993,0,9999,6
1746551671926,MCWP 40,A00,892729,Duru; Nur,10,0,20,10
1746551671926,MCWP 40,B00,893304,Montejo; Carolina,14,0,20,6
1746551672950,MCWP 40R,A00,893757,Redela; Pamela Morgan,0,5,20,20
1746551673976,MCWP 50,A00,893758,Morshed; Michael James,0,0,20,20
1746551673976,MCWP 50,B00,893761,Bartulis; Jason Michael,17,0,20,3
1746551675003,MCWP 50R,A00,893766,Compas; Sean Matthew,0,1,20,20
1746551675003,MCWP 50R,B00,893769,Carter; Jennifer A,0,1,20,20
1746551675003,MCWP 50R,C00,893771,Krone; Jarret,0,3,20,20
1746551675003,MCWP 50R,D00,893772,Miller; Elizabeth Deen,0,0,20,20
1746551675003,MCWP 50R,E00,893775,Carter; Andrea L,0,1,20,20
1746551676028,MMW 11R,A01,892721,Herbst; Matthew,11,0,27,16
1746551676028,MMW 11R,A02,892722,Herbst; Matthew,0,0,0,3
1746551677053,MMW 12R,A01,892724,Herbst; Matthew,0,11,16,16
1746551677053,MMW 12R,A02,892725,Herbst; Matthew,0,10,16,16
1746551678079,MMW 13R,A01,892727,Staff,0,4,16,16
1746551678079,MMW 13R,A02,892728,Staff,0,4,16,16
1746551678079,MMW 13R,A03,958032,Staff,0,4,16,16
1746551678079,MMW 13R,A04,958033,Staff,0,4,16,16
1746551678079,MMW 13R,A05,958034,Staff,0,4,16,16
1746551679106,SIO 295LS,A00,894015,Staff,5,0,25,20
1746551680133,SIO 295S,A00,894020,Staff,5,0,25,20
1746551681161,SIOC 290S,B01,958918,Merrifield; Mark A,14,0,30,16
1746551682186,SIOC 291S,B01,958922,Gabriel; Corey John,14,0,30,16
1746551683211,SOCI 117,A01,895339,Staff,3,0,5,2
1746551684237,WES 237B,A00,894149,Staff,11,0,20,9
1746551686302,AESE 279B,A00,891859,Staff,13,0,35,22
1746551687331,AIP 197,001,891854,Vespa; Emanuel Ignacio,9999,0,9999,0
1746551688358,ANTH 289S,A00,891856,Gagneux; Pascal,12,0,12,0
1746551689382,BENG 196,001,957946,Engler; Adam J.,9996,0,9999,3
1746551690410,BISP 197,001,959851,Wilhelm; James E.,9998,0,9999,1
1746551691436,CAT 124RS,A01,956906,Staff,6,0,25,19
1746551692462,CAT 125RS,A01,922013,Staff,6,0,25,19
1746551693487,CLRE 250,A00,891860,Morris; Sheldon,9995,0,9999,4
1746551695537,CLRE 251R,A00,907817,Mehta; Ravindra L.,9994,0,9999,5
1746551696563,CLRE 252,A00,891864,Cuomo; Raphael Eduardo,9993,0,9999,6
1746551697589,CLRE 253,A00,891867,Vaida; Florin,9994,0,9999,5
1746551697589,CLRE 253,B00,907819,Staff,9999,0,9999,0
1746551698614,CLRE 259,A00,891868,Patel; Hemal,9998,0,9999,1
1746551699642,CLRE 260,A00,891872,Cuomo; Raphael Eduardo,9999,0,9999,0
1746551700668,CLRE 297,001,891888,Cuomo; Raphael Eduardo,9999,0,9999,0
1746551701694,CSE 191,A00,958773,Minnes Kemp; Mor Mia,9996,0,9999,3
1746551702719,CSE 197,001,959846,Minnes Kemp; Mor Mia,9990,0,9999,9
1746551703747,CSS 201S,A01,892054,Mignozzetti; Umberto,26,0,30,4
1746551704772,CSS 202S,A01,892056,Mignozzetti; Umberto,26,0,30,4
1746551705796,DSC 197,001,956898,Eldridge; Justin Matthew,9997,0,9999,2
1746551706820,DSC 297,001,958000,Mazumdar; Arya,9998,0,9999,1
1746551706820,DSC 297,002,959862,Wang; Yusu,9998,0,9999,1
1746551707848,EAP 100,A00,905686,Staff,9778,0,9999,221
1746551708872,ECE 45,A01,892618,Staff,0,0,65,65
1746551710921,ECE 111,A01,892719,Staff,4,0,65,61
1746551711947,ECE 197,001,957920,Mercier; Patrick Philip,9991,0,9999,8
1746551712972,ECON 178,A01,907814,Zhu; Ying,26,0,35,9
1746551713996,EDS 115,A00,895312,Staff,35,0,45,10
1746551715023,EDS 117,A01,895337,Staff,23,0,30,7
1746551716050,EDS 125,A00,895341,Jones; Gabrielle Anastasia,36,0,45,9
1746551717079,EDS 128A,A01,895459,Fargason; Sharon Gayle,44,0,45,1
1746551718107,EDS 128B,A01,895543,Pappas; Elizabeth,44,0,45,1
1746551719133,EDS 139,A00,897203,Pappas; Elizabeth,44,0,45,1
1746551719133,EDS 139,B00,897209,Fargason; Sharon Gayle,41,0,45,4
1746551720158,EDS 201,A00,895545,Staff,22,0,45,23
1746551721184,EDS 203,A01,895581,Halter; Christopher P.,22,0,45,23
1746551722210,EDS 204R,A01,895625,Heinzman; Erica M.,39,0,45,6
1746551722210,EDS 204R,B01,895693,Halter; Christopher P.,10,0,45,35
1746551723235,EDS 206R,A00,895694,Fargason; Sharon Gayle,1,0,30,29
1746551723235,EDS 206R,B00,895695,Choi; Bailey Miyeon,16,0,30,14
1746551724264,EDS 250,A00,895697,Hemans; Patricia Ann Benitez,22,0,45,23
1746551725289,EDS 281,A00,895701,Meyerott; Theresa Ann,1,0,15,14
1746551726313,EDS 284,A00,895736,Meyerott; Theresa Ann,1,0,15,14
1746551727341,EDS 286,A00,897210,Fine; Sarah,0,0,15,15
1746551728367,EDS 289C,A01,895770,Daly; Alan J.,15,0,15,0
1746551729391,EDS 290,A00,897211,Hofstetter; Carolyn,0,0,15,15
1746551730416,LIGM 5A,A00,896162,Fischer-Grunski; Eva K,13,0,20,7
1746551731440,LIGM 5B,A00,896260,Fischer-Grunski; Eva K,17,0,20,3
1746551732467,LIGM 5C,A00,896308,Fischer-Grunski; Eva K,18,0,20,2
1746551733496,LIIT 5AS,A00,896313,Carnelos; Chiara,18,0,20,2
1746551734524,LIIT 5BS,A00,896416,Carnelos; Chiara,20,0,20,0
1746551735550,LIIT 5CS,A00,896564,Carnelos; Chiara,20,0,20,0
1746551736575,LISP 5A,A00,896588,Munoz Sanchez; Alicia,3,0,20,17
1746551737604,LISP 5B,A00,896653,Munoz Sanchez; Alicia,7,0,20,13
1746551738630,LISP 5C,A00,896655,Munoz Sanchez; Alicia,0,1,20,20
1746551739658,MAE 197,001,957918,Kleissl; Jan,9996,0,9999,3
1746551739658,MAE 197,002,959806,Boechler; Nicholas Sebastia,9998,0,9999,1
1746551739658,MAE 197,003,959852,Mullin; Jennifer S,9998,0,9999,1
1746551740684,MATH 2,A01,957937,Staff,33,0,35,2
1746551741708,MATH 197,001,957876,Kedlaya; Kiran S.,9993,0,9999,6
1746551742734,MCWP 40,A00,892729,Duru; Nur,10,0,20,10
1746551742734,MCWP 40,B00,893304,Montejo; Carolina,14,0,20,6
1746551743762,MCWP 40R,A00,893757,Redela; Pamela Morgan,0,5,20,20
1746551744789,MCWP 50,A00,893758,Morshed; Michael James,0,0,20,20
1746551744789,MCWP 50,B00,893761,Bartulis; Jason Michael,17,0,20,3
1746551745816,MCWP 50R,A00,893766,Compas; Sean Matthew,0,1,20,20
1746551745816,MCWP 50R,B00,893769,Carter; Jennifer A,0,1,20,20
1746551745816,MCWP 50R,C00,893771,Krone; Jarret,0,3,20,20
1746551745816,MCWP 50R,D00,893772,Miller; Elizabeth Deen,0,0,20,20
1746551745816,MCWP 50R,E00,893775,Carter; Andrea L,0,1,20,20
1746551746842,MMW 11R,A01,892721,Herbst; Matthew,11,0,27,16
1746551746842,MMW 11R,A02,892722,Herbst; Matthew,0,0,0,3
1746551747869,MMW 12R,A01,892724,Herbst; Matthew,0,11,16,16
1746551747869,MMW 12R,A02,892725,Herbst; Matthew,0,10,16,16
1746551748895,MMW 13R,A01,892727,Staff,0,4,16,16
1746551748895,MMW 13R,A02,892728,Staff,0,4,16,16
1746551748895,MMW 13R,A03,958032,Staff,0,4,16,16
1746551748895,MMW 13R,A04,958033,Staff,0,4,16,16
1746551748895,MMW 13R,A05,958034,Staff,0,4,16,16
1746551749919,SIO 295LS,A00,894015,Staff,5,0,25,20
1746551750943,SIO 295S,A00,894020,Staff,5,0,25,20
1746551751969,SIOC 290S,B01,958918,Merrifield; Mark A,14,0,30,16
1746551752994,SIOC 291S,B01,958922,Gabriel; Corey John,14,0,30,16
1746551754017,SOCI 117,A01,895339,Staff,3,0,5,2
1746551755042,WES 237B,A00,894149,Staff,11,0,20,9
1746551757101,AESE 279B,A00,891859,Staff,13,0,35,22
1746551758128,AIP 197,001,891854,Vespa; Emanuel Ignacio,9999,0,9999,0
1746551759158,ANTH 289S,A00,891856,Gagneux; Pascal,12,0,12,0
1746551760186,BENG 196,001,957946,Engler; Adam J.,9996,0,9999,3
1746551761213,BISP 197,001,959851,Wilhelm; James E.,9998,0,9999,1
1746551762237,CAT 124RS,A01,956906,Staff,6,0,25,19
1746551763263,CAT 125RS,A01,922013,Staff,6,0,25,19
1746551764288,CLRE 250,A00,891860,Morris; Sheldon,9995,0,9999,4
1746551766341,CLRE 251R,A00,907817,Mehta; Ravindra L.,9994,0,9999,5
1746551767369,CLRE 252,A00,891864,Cuomo; Raphael Eduardo,9993,0,9999,6
1746551768395,CLRE 253,A00,891867,Vaida; Florin,9994,0,9999,5
1746551768395,CLRE 253,B00,907819,Staff,9999,0,9999,0
1746551769423,CLRE 259,A00,891868,Patel; Hemal,9998,0,9999,1
1746551770447,CLRE 260,A00,891872,Cuomo; Raphael Eduardo,9999,0,9999,0
1746551771473,CLRE 297,001,891888,Cuomo; Raphael Eduardo,9999,0,9999,0
1746551772541,CSE 191,A00,958773,Minnes Kemp; Mor Mia,9996,0,9999,3
1746551773567,CSE 197,001,959846,Minnes Kemp; Mor Mia,9990,0,9999,9
1746551774592,CSS 201S,A01,892054,Mignozzetti; Umberto,26,0,30,4
1746551775622,CSS 202S,A01,892056,Mignozzetti; Umberto,26,0,30,4
1746551776647,DSC 197,001,956898,Eldridge; Justin Matthew,9997,0,9999,2
1746551777673,DSC 297,001,958000,Mazumdar; Arya,9998,0,9999,1
1746551777673,DSC 297,002,959862,Wang; Yusu,9998,0,9999,1
1746551778701,EAP 100,A00,905686,Staff,9778,0,9999,221
1746551779728,ECE 45,A01,892618,Staff,0,0,65,65
1746551781779,ECE 111,A01,892719,Staff,4,0,65,61
1746551782806,ECE 197,001,957920,Mercier; Patrick Philip,9991,0,9999,8
1746551783833,ECON 178,A01,907814,Zhu; Ying,26,0,35,9
1746551784860,EDS 115,A00,895312,Staff,35,0,45,10
1746551785885,EDS 117,A01,895337,Staff,23,0,30,7
1746551786910,EDS 125,A00,895341,Jones; Gabrielle Anastasia,36,0,45,9
1746551787938,EDS 128A,A01,895459,Fargason; Sharon Gayle,44,0,45,1
1746551788966,EDS 128B,A01,895543,Pappas; Elizabeth,44,0,45,1
1746551790001,EDS 139,A00,897203,Pappas; Elizabeth,44,0,45,1
1746551790001,EDS 139,B00,897209,Fargason; Sharon Gayle,41,0,45,4
1746551791026,EDS 201,A00,895545,Staff,22,0,45,23
1746551792052,EDS 203,A01,895581,Halter; Christopher P.,22,0,45,23
1746551793077,EDS 204R,A01,895625,Heinzman; Erica M.,39,0,45,6
1746551793077,EDS 204R,B01,895693,Halter; Christopher P.,10,0,45,35
1746551794104,EDS 206R,A00,895694,Fargason; Sharon Gayle,1,0,30,29
1746551794104,EDS 206R,B00,895695,Choi; Bailey Miyeon,16,0,30,14
1746551795132,EDS 250,A00,895697,Hemans; Patricia Ann Benitez,22,0,45,23
1746551796157,EDS 281,A00,895701,Meyerott; Theresa Ann,1,0,15,14
1746551797180,EDS 284,A00,895736,Meyerott; Theresa Ann,1,0,15,14
1746551798207,EDS 286,A00,897210,Fine; Sarah,0,0,15,15
1746551799232,EDS 289C,A01,895770,Daly; Alan J.,15,0,15,0
1746551800258,EDS 290,A00,897211,Hofstetter; Carolyn,0,0,15,15
1746551801282,LIGM 5A,A00,896162,Fischer-Grunski; Eva K,13,0,20,7
1746551802306,LIGM 5B,A00,896260,Fischer-Grunski; Eva K,17,0,20,3
1746551803334,LIGM 5C,A00,896308,Fischer-Grunski; Eva K,18,0,20,2
1746551804360,LIIT 5AS,A00,896313,Carnelos; Chiara,18,0,20,2
1746551805388,LIIT 5BS,A00,896416,Carnelos; Chiara,20,0,20,0
1746551806412,LIIT 5CS,A00,896564,Carnelos; Chiara,20,0,20,0
1746551807439,LISP 5A,A00,896588,Munoz Sanchez; Alicia,3,0,20,17
1746551808464,LISP 5B,A00,896653,Munoz Sanchez; Alicia,7,0,20,13
1746551809489,LISP 5C,A00,896655,Munoz Sanchez; Alicia,0,1,20,20
1746551810514,MAE 197,001,957918,Kleissl; Jan,9996,0,9999,3
1746551810514,MAE 197,002,959806,Boechler; Nicholas Sebastia,9998,0,9999,1
1746551810514,MAE 197,003,959852,Mullin; Jennifer S,9998,0,9999,1
1746551811538,MATH 2,A01,957937,Staff,33,0,35,2
1746551812562,MATH 197,001,957876,Kedlaya; Kiran S.,9993,0,9999,6
1746551813587,MCWP 40,A00,892729,Duru; Nur,10,0,20,10
1746551813587,MCWP 40,B00,893304,Montejo; Carolina,14,0,20,6
1746551814613,MCWP 40R,A00,893757,Redela; Pamela Morgan,0,5,20,20
1746551815638,MCWP 50,A00,893758,Morshed; Michael James,0,0,20,20
1746551815638,MCWP 50,B00,893761,Bartulis; Jason Michael,17,0,20,3
1746551816667,MCWP 50R,A00,893766,Compas; Sean Matthew,0,1,20,20
1746551816667,MCWP 50R,B00,893769,Carter; Jennifer A,0,1,20,20
1746551816667,MCWP 50R,C00,893771,Krone; Jarret,0,3,20,20
1746551816667,MCWP 50R,D00,893772,Miller; Elizabeth Deen,0,0,20,20
1746551816667,MCWP 50R,E00,893775,Carter; Andrea L,0,1,20,20
1746551817693,MMW 11R,A01,892721,Herbst; Matthew,11,0,27,16
1746551817693,MMW 11R,A02,892722,Herbst; Matthew,0,0,0,3
1746551818719,MMW 12R,A01,892724,Herbst; Matthew,0,11,16,16
1746551818719,MMW 12R,A02,892725,Herbst; Matthew,0,10,16,16
1746551819745,MMW 13R,A01,892727,Staff,0,4,16,16
1746551819745,MMW 13R,A02,892728,Staff,0,4,16,16
1746551819745,MMW 13R,A03,958032,Staff,0,4,16,16
1746551819745,MMW 13R,A04,958033,Staff,0,4,16,16
1746551819745,MMW 13R,A05,958034,Staff,0,4,16,16
1746551820772,SIO 295LS,A00,894015,Staff,5,0,25,20
1746551821797,SIO 295S,A00,894020,Staff,5,0,25,20
1746551822823,SIOC 290S,B01,958918,Merrifield; Mark A,14,0,30,16
1746551823848,SIOC 291S,B01,958922,Gabriel; Corey John,14,0,30,16
1746551824873,SOCI 117,A01,895339,Staff,3,0,5,2
1746551825900,WES 237B,A00,894149,Staff,11,0,20,9
1746551827967,AESE 279B,A00,891859,Staff,13,0,35,22
1746551828993,AIP 197,001,891854,Vespa; Emanuel Ignacio,9999,0,9999,0
1746551830018,ANTH 289S,A00,891856,Gagneux; Pascal,12,0,12,0
1746551831042,BENG 196,001,957946,Engler; Adam J.,9996,0,9999,3
1746551832069,BISP 197,001,959851,Wilhelm; James E.,9998,0,9999,1
1746551833096,CAT 124RS,A01,956906,Staff,6,0,25,19
1746551834120,CAT 125RS,A01,922013,Staff,6,0,25,19
1746551835146,CLRE 250,A00,891860,Morris; Sheldon,9995,0,9999,4
1746551837200,CLRE 251R,A00,907817,Mehta; Ravindra L.,9994,0,9999,5
1746551838740,CLRE 252,A00,891864,Cuomo; Raphael Eduardo,9993,0,9999,6
1746551839767,CLRE 253,A00,891867,Vaida; Florin,9994,0,9999,5
1746551839767,CLRE 253,B00,907819,Staff,9999,0,9999,0
1746551840795,CLRE 259,A00,891868,Patel; Hemal,9998,0,9999,1
1746551841821,CLRE 260,A00,891872,Cuomo; Raphael Eduardo,9999,0,9999,0
1746551842845,CLRE 297,001,891888,Cuomo; Raphael Eduardo,9999,0,9999,0
1746551843871,CSE 191,A00,958773,Minnes Kemp; Mor Mia,9996,0,9999,3
1746551844898,CSE 197,001,959846,Minnes Kemp; Mor Mia,9990,0,9999,9
1746551845926,CSS 201S,A01,892054,Mignozzetti; Umberto,26,0,30,4
1746551846954,CSS 202S,A01,892056,Mignozzetti; Umberto,26,0,30,4
1746551847980,DSC 197,001,956898,Eldridge; Justin Matthew,9997,0,9999,2
1746551849005,DSC 297,001,958000,Mazumdar; Arya,9998,0,9999,1
1746551849005,DSC 297,002,959862,Wang; Yusu,9998,0,9999,1
1746551850030,EAP 100,A00,905686,Staff,9778,0,9999,221
1746551851056,ECE 45,A01,892618,Staff,0,0,65,65
1746551853108,ECE 111,A01,892719,Staff,4,0,65,61
1746551854133,ECE 197,001,957920,Mercier; Patrick Philip,9991,0,9999,8
1746551855162,ECON 178,A01,907814,Zhu; Ying,26,0,35,9
1746551856189,EDS 115,A00,895312,Staff,35,0,45,10
1746551857215,EDS 117,A01,895337,Staff,23,0,30,7
1746551858242,EDS 125,A00,895341,Jones; Gabrielle Anastasia,36,0,45,9
1746551859269,EDS 128A,A01,895459,Fargason; Sharon Gayle,44,0,45,1
1746551860298,EDS 128B,A01,895543,Pappas; Elizabeth,44,0,45,1
1746551861327,EDS 139,A00,897203,Pappas; Elizabeth,44,0,45,1
1746551861327,EDS 139,B00,897209,Fargason; Sharon Gayle,41,0,45,4
1746551862352,EDS 201,A00,895545,Staff,22,0,45,23
1746551863377,EDS 203,A01,895581,Halter; Christopher P.,22,0,45,23
1746551864405,EDS 204R,A01,895625,Heinzman; Erica M.,39,0,45,6
1746551864405,EDS 204R,B01,895693,Halter; Christopher P.,10,0,45,35
1746551865429,EDS 206R,A00,895694,Fargason; Sharon Gayle,1,0,30,29
1746551865429,EDS 206R,B00,895695,Choi; Bailey Miyeon,16,0,30,14
1746551866453,EDS 250,A00,895697,Hemans; Patricia Ann Benitez,22,0,45,23
1746551867480,EDS 281,A00,895701,Meyerott; Theresa Ann,1,0,15,14
1746551868505,EDS 284,A00,895736,Meyerott; Theresa Ann,1,0,15,14
1746551869531,EDS 286,A00,897210,Fine; Sarah,0,0,15,15
1746551870558,EDS 289C,A01,895770,Daly; Alan J.,15,0,15,0
1746551871583,EDS 290,A00,897211,Hofstetter; Carolyn,0,0,15,15
1746551872607,LIGM 5A,A00,896162,Fischer-Grunski; Eva K,13,0,20,7
1746551873632,LIGM 5B,A00,896260,Fischer-Grunski; Eva K,17,0,20,3
1746551874661,LIGM 5C,A00,896308,Fischer-Grunski; Eva K,18,0,20,2
1746551875687,LIIT 5AS,A00,896313,Carnelos; Chiara,18,0,20,2
1746551876716,LIIT 5BS,A00,896416,Carnelos; Chiara,20,0,20,0
1746551877740,LIIT 5CS,A00,896564,Carnelos; Chiara,20,0,20,0
1746551878769,LISP 5A,A00,896588,Munoz Sanchez; Alicia,3,0,20,17
1746551879793,LISP 5B,A00,896653,Munoz Sanchez; Alicia,7,0,20,13
1746551880821,LISP 5C,A00,896655,Munoz Sanchez; Alicia,0,1,20,20
1746551881848,MAE 197,001,957918,Kleissl; Jan,9996,0,9999,3
1746551881848,MAE 197,002,959806,Boechler; Nicholas Sebastia,9998,0,9999,1
1746551881848,MAE 197,003,959852,Mullin; Jennifer S,9998,0,9999,1
1746551882876,MATH 2,A01,957937,Staff,33,0,35,2
1746551883903,MATH 197,001,957876,Kedlaya; Kiran S.,9993,0,9999,6
1746551884929,MCWP 40,A00,892729,Duru; Nur,10,0,20,10
1746551884929,MCWP 40,B00,893304,Montejo; Carolina,14,0,20,6
1746551885953,MCWP 40R,A00,893757,Redela; Pamela Morgan,0,5,20,20
1746551886981,MCWP 50,A00,893758,Morshed; Michael James,0,0,20,20
1746551886981,MCWP 50,B00,893761,Bartulis; Jason Michael,17,0,20,3
1746551888007,MCWP 50R,A00,893766,Compas; Sean Matthew,0,1,20,20
1746551888007,MCWP 50R,B00,893769,Carter; Jennifer A,0,1,20,20
1746551888007,MCWP 50R,C00,893771,Krone; Jarret,0,3,20,20
1746551888007,MCWP 50R,D00,893772,Miller; Elizabeth Deen,0,0,20,20
1746551888007,MCWP 50R,E00,893775,Carter; Andrea L,0,1,20,20
1746551889034,MMW 11R,A01,892721,Herbst; Matthew,11,0,27,16
1746551889034,MMW 11R,A02,892722,Herbst; Matthew,0,0,0,3
1746551890060,MMW 12R,A01,892724,Herbst; Matthew,0,11,16,16
1746551890060,MMW 12R,A02,892725,Herbst; Matthew,0,10,16,16
1746551891088,MMW 13R,A01,892727,Staff,0,4,16,16
1746551891088,MMW 13R,A02,892728,Staff,0,4,16,16
1746551891088,MMW 13R,A03,958032,Staff,0,4,16,16
1746551891088,MMW 13R,A04,958033,Staff,0,4,16,16
1746551891088,MMW 13R,A05,958034,Staff,0,4,16,16
1746551892112,SIO 295LS,A00,894015,Staff,5,0,25,20
1746551893137,SIO 295S,A00,894020,Staff,5,0,25,20
1746551894162,SIOC 290S,B01,958918,Merrifield; Mark A,14,0,30,16
1746551895188,SIOC 291S,B01,958922,Gabriel; Corey John,14,0,30,16
1746551896214,SOCI 117,A01,895339,Staff,3,0,5,2
1746551897238,WES 237B,A00,894149,Staff,11,0,20,9
1746551899303,AESE 279B,A00,891859,Staff,13,0,35,22
1746551900329,AIP 197,001,891854,Vespa; Emanuel Ignacio,9999,0,9999,0
1746551901358,ANTH 289S,A00,891856,Gagneux; Pascal,12,0,12,0
1746551902382,BENG 196,001,957946,Engler; Adam J.,9996,0,9999,3
1746551903407,BISP 197,001,959851,Wilhelm; James E.,9998,0,9999,1
1746551904434,CAT 124RS,A01,956906,Staff,6,0,25,19
1746551905464,CAT 125RS,A01,922013,Staff,6,0,25,19
1746551906487,CLRE 250,A00,891860,Morris; Sheldon,9995,0,9999,4
1746551908539,CLRE 251R,A00,907817,Mehta; Ravindra L.,9994,0,9999,5
1746551909562,CLRE 252,A00,891864,Cuomo; Raphael Eduardo,9993,0,9999,6
1746551910589,CLRE 253,A00,891867,Vaida; Florin,9994,0,9999,5
1746551910589,CLRE 253,B00,907819,Staff,9999,0,9999,0
1746551911616,CLRE 259,A00,891868,Patel; Hemal,9998,0,9999,1
1746551912642,CLRE 260,A00,891872,Cuomo; Raphael Eduardo,9999,0,9999,0
1746551913666,CLRE 297,001,891888,Cuomo; Raphael Eduardo,9999,0,9999,0
1746551914692,CSE 191,A00,958773,Minnes Kemp; Mor Mia,9996,0,9999,3
1746551915719,CSE 197,001,959846,Minnes Kemp; Mor Mia,9990,0,9999,9
1746551916748,CSS 201S,A01,892054,Mignozzetti; Umberto,26,0,30,4
1746551917774,CSS 202S,A01,892056,Mignozzetti; Umberto,26,0,30,4
1746551918798,DSC 197,001,956898,Eldridge; Justin Matthew,9997,0,9999,2
1746551919823,DSC 297,001,958000,Mazumdar; Arya,9998,0,9999,1
1746551919823,DSC 297,002,959862,Wang; Yusu,9998,0,9999,1
1746551920850,EAP 100,A00,905686,Staff,9778,0,9999,221
1746551921876,ECE 45,A01,892618,Staff,0,0,65,65
1746551923935,ECE 111,A01,892719,Staff,4,0,65,61
1746551924961,ECE 197,001,957920,Mercier; Patrick Philip,9991,0,9999,8
1746551925987,ECON 178,A01,907814,Zhu; Ying,26,0,35,9
1746551927013,EDS 115,A00,895312,Staff,35,0,45,10
1746551928040,EDS 117,A01,895337,Staff,23,0,30,7
1746551929066,EDS 125,A00,895341,Jones; Gabrielle Anastasia,36,0,45,9
1746551930100,EDS 128A,A01,895459,Fargason; Sharon Gayle,44,0,45,1
1746551931127,EDS 128B,A01,895543,Pappas; Elizabeth,44,0,45,1
1746551932152,EDS 139,A00,897203,Pappas; Elizabeth,44,0,45,1
1746551932152,EDS 139,B00,897209,Fargason; Sharon Gayle,41,0,45,4
1746551933177,EDS 201,A00,895545,Staff,22,0,45,23
1746551934206,EDS 203,A01,895581,Halter; Christopher P.,22,0,45,23
1746551935235,EDS 204R,A01,895625,Heinzman; Erica M.,39,0,45,6
1746551935235,EDS 204R,B01,895693,Halter; Christopher P.,10,0,45,35
1746551936260,EDS 206R,A00,895694,Fargason; Sharon Gayle,1,0,30,29
1746551936260,EDS 206R,B00,895695,Choi; Bailey Miyeon,16,0,30,14
1746551937286,EDS 250,A00,895697,Hemans; Patricia Ann Benitez,22,0,45,23
1746551938313,EDS 281,A00,895701,Meyerott; Theresa Ann,1,0,15,14
1746551939337,EDS 284,A00,895736,Meyerott; Theresa Ann,1,0,15,14
1746551940362,EDS 286,A00,897210,Fine; Sarah,0,0,15,15
1746551941387,EDS 289C,A01,895770,Daly; Alan J.,15,0,15,0
1746551942411,EDS 290,A00,897211,Hofstetter; Carolyn,0,0,15,15
1746551943436,LIGM 5A,A00,896162,Fischer-Grunski; Eva K,13,0,20,7
1746551944459,LIGM 5B,A00,896260,Fischer-Grunski; Eva K,17,0,20,3
1746551945527,LIGM 5C,A00,896308,Fischer-Grunski; Eva K,18,0,20,2
1746551946554,LIIT 5AS,A00,896313,Carnelos; Chiara,18,0,20,2
1746551947579,LIIT 5BS,A00,896416,Carnelos; Chiara,20,0,20,0
1746551948606,LIIT 5CS,A00,896564,Carnelos; Chiara,20,0,20,0
1746551949633,LISP 5A,A00,896588,Munoz Sanchez; Alicia,3,0,20,17
1746551950657,LISP 5B,A00,896653,Munoz Sanchez; Alicia,7,0,20,13
1746551951683,LISP 5C,A00,896655,Munoz Sanchez; Alicia,0,1,20,20
1746551952711,MAE 197,001,957918,Kleissl; Jan,9996,0,9999,3
1746551952711,MAE 197,002,959806,Boechler; Nicholas Sebastia,9998,0,9999,1
1746551952711,MAE 197,003,959852,Mullin; Jennifer S,9998,0,9999,1
1746551953736,MATH 2,A01,957937,Staff,33,0,35,2
1746551954760,MATH 197,001,957876,Kedlaya; Kiran S.,9993,0,9999,6
1746551955788,MCWP 40,A00,892729,Duru; Nur,10,0,20,10
1746551955788,MCWP 40,B00,893304,Montejo; Carolina,14,0,20,6
1746551956836,MCWP 40R,A00,893757,Redela; Pamela Morgan,0,5,20,20
1746551957864,MCWP 50,A00,893758,Morshed; Michael James,0,0,20,20
1746551957864,MCWP 50,B00,893761,Bartulis; Jason Michael,17,0,20,3
1746551958892,MCWP 50R,A00,893766,Compas; Sean Matthew,0,1,20,20
1746551958892,MCWP 50R,B00,893769,Carter; Jennifer A,0,1,20,20
1746551958892,MCWP 50R,C00,893771,Krone; Jarret,0,3,20,20
1746551958892,MCWP 50R,D00,893772,Miller; Elizabeth Deen,0,0,20,20
1746551958892,MCWP 50R,E00,893775,Carter; Andrea L,0,1,20,20
1746551959917,MMW 11R,A01,892721,Herbst; Matthew,11,0,27,16
1746551959917,MMW 11R,A02,892722,Herbst; Matthew,0,0,0,3
1746551960945,MMW 12R,A01,892724,Herbst; Matthew,0,11,16,16
1746551960945,MMW 12R,A02,892725,Herbst; Matthew,0,10,16,16
1746551961970,MMW 13R,A01,892727,Staff,0,4,16,16
1746551961970,MMW 13R,A02,892728,Staff,0,4,16,16
1746551961970,MMW 13R,A03,958032,Staff,0,4,16,16
1746551961970,MMW 13R,A04,958033,Staff,0,4,16,16
1746551961970,MMW 13R,A05,958034,Staff,0,4,16,16
1746551962994,SIO 295LS,A00,894015,Staff,5,0,25,20
1746551964019,SIO 295S,A00,894020,Staff,5,0,25,20
1746551965045,SIOC 290S,B01,958918,Merrifield; Mark A,14,0,30,16
1746551966074,SIOC 291S,B01,958922,Gabriel; Corey John,14,0,30,16
1746551967102,SOCI 117,A01,895339,Staff,3,0,5,2
1746551968127,WES 237B,A00,894149,Staff,11,0,20,9
1746551970189,AESE 279B,A00,891859,Staff,13,0,35,22
1746551971217,AIP 197,001,891854,Vespa; Emanuel Ignacio,9999,0,9999,0
1746551972241,ANTH 289S,A00,891856,Gagneux; Pascal,12,0,12,0
1746551973268,BENG 196,001,957946,Engler; Adam J.,9996,0,9999,3
1746551974293,BISP 197,001,959851,Wilhelm; James E.,9998,0,9999,1
1746551975321,CAT 124RS,A01,956906,Staff,6,0,25,19
1746551976346,CAT 125RS,A01,922013,Staff,6,0,25,19
1746551977370,CLRE 250,A00,891860,Morris; Sheldon,9995,0,9999,4
1746551979423,CLRE 251R,A00,907817,Mehta; Ravindra L.,9994,0,9999,5
1746551980453,CLRE 252,A00,891864,Cuomo; Raphael Eduardo,9993,0,9999,6
1746551981485,CLRE 253,A00,891867,Vaida; Florin,9994,0,9999,5
1746551981485,CLRE 253,B00,907819,Staff,9999,0,9999,0
1746551982510,CLRE 259,A00,891868,Patel; Hemal,9998,0,9999,1
1746551983538,CLRE 260,A00,891872,Cuomo; Raphael Eduardo,9999,0,9999,0
1746551984562,CLRE 297,001,891888,Cuomo; Raphael Eduardo,9999,0,9999,0
1746551985590,CSE 191,A00,958773,Minnes Kemp; Mor Mia,9996,0,9999,3
1746551986617,CSE 197,001,959846,Minnes Kemp; Mor Mia,9990,0,9999,9
1746551987641,CSS 201S,A01,892054,Mignozzetti; Umberto,26,0,30,4
1746551988669,CSS 202S,A01,892056,Mignozzetti; Umberto,26,0,30,4
1746551989693,DSC 197,001,956898,Eldridge; Justin Matthew,9997,0,9999,2
1746551990716,DSC 297,001,958000,Mazumdar; Arya,9998,0,9999,1
1746551990716,DSC 297,002,959862,Wang; Yusu,9998,0,9999,1
1746551991740,EAP 100,A00,905686,Staff,9778,0,9999,221
1746551992769,ECE 45,A01,892618,Staff,0,0,65,65
1746551994821,ECE 111,A01,892719,Staff,4,0,65,61
1746551995847,ECE 197,001,957920,Mercier; Patrick Philip,9991,0,9999,8
1746551996874,ECON 178,A01,907814,Zhu; Ying,26,0,35,9
1746551997901,EDS 115,A00,895312,Staff,35,0,45,10
1746551998928,EDS 117,A01,895337,Staff,23,0,30,7
1746551999955,EDS 125,A00,895341,Jones; Gabrielle Anastasia,36,0,45,9
1746552000984,EDS 128A,A01,895459,Fargason; Sharon Gayle,44,0,45,1
1746552002009,EDS 128B,A01,895543,Pappas; Elizabeth,44,0,45,1
1746552003034,EDS 139,A00,897203,Pappas; Elizabeth,44,0,45,1
1746552003034,EDS 139,B00,897209,Fargason; Sharon Gayle,41,0,45,4
1746552004059,EDS 201,A00,895545,Staff,22,0,45,23
1746552005087,EDS 203,A01,895581,Halter; Christopher P.,22,0,45,23
1746552006113,EDS 204R,A01,895625,Heinzman; Erica M.,39,0,45,6
1746552006113,EDS 204R,B01,895693,Halter; Christopher P.,10,0,45,35
1746552007141,EDS 206R,A00,895694,Fargason; Sharon Gayle,1,0,30,29
1746552007141,EDS 206R,B00,895695,Choi; Bailey Miyeon,16,0,30,14
1746552008166,EDS 250,A00,895697,Hemans; Patricia Ann Benitez,22,0,45,23
1746552009193,EDS 281,A00,895701,Meyerott; Theresa Ann,1,0,15,14
1746552010217,EDS 284,A00,895736,Meyerott; Theresa Ann,1,0,15,14
1746552011244,EDS 286,A00,897210,Fine; Sarah,0,0,15,15
1746552012270,EDS 289C,A01,895770,Daly; Alan J.,15,0,15,0
1746552013294,EDS 290,A00,897211,Hofstetter; Carolyn,0,0,15,15
1746552014320,LIGM 5A,A00,896162,Fischer-Grunski; Eva K,13,0,20,7
1746552015344,LIGM 5B,A00,896260,Fischer-Grunski; Eva K,17,0,20,3
1746552016368,LIGM 5C,A00,896308,Fischer-Grunski; Eva K,18,0,20,2
1746552017393,LIIT 5AS,A00,896313,Carnelos; Chiara,18,0,20,2
1746552018418,LIIT 5BS,A00,896416,Carnelos; Chiara,20,0,20,0
1746552019448,LIIT 5CS,A00,896564,Carnelos; Chiara,20,0,20,0
1746552020477,LISP 5A,A00,896588,Munoz Sanchez; Alicia,3,0,20,17
1746552021503,LISP 5B,A00,896653,Munoz Sanchez; Alicia,7,0,20,13
1746552022529,LISP 5C,A00,896655,Munoz Sanchez; Alicia,0,1,20,20
1746552023555,MAE 197,001,957918,Kleissl; Jan,9996,0,9999,3
1746552023555,MAE 197,002,959806,Boechler; Nicholas Sebastia,9998,0,9999,1
1746552023555,MAE 197,003,959852,Mullin; Jennifer S,9998,0,9999,1
1746552024580,MATH 2,A01,957937,Staff,33,0,35,2
1746552025606,MATH 197,001,957876,Kedlaya; Kiran S.,9993,0,9999,6
1746552026631,MCWP 40,A00,892729,Duru; Nur,10,0,20,10
1746552026631,MCWP 40,B00,893304,Montejo; Carolina,14,0,20,6
1746552027657,MCWP 40R,A00,893757,Redela; Pamela Morgan,0,5,20,20
1746552028682,MCWP 50,A00,893758,Morshed; Michael James,0,0,20,20
1746552028682,MCWP 50,B00,893761,Bartulis; Jason Michael,17,0,20,3
1746552029708,MCWP 50R,A00,893766,Compas; Sean Matthew,0,1,20,20
1746552029708,MCWP 50R,B00,893769,Carter; Jennifer A,0,1,20,20
1746552029708,MCWP 50R,C00,893771,Krone; Jarret,0,3,20,20
1746552029708,MCWP 50R,D00,893772,Miller; Elizabeth Deen,0,0,20,20
1746552029708,MCWP 50R,E00,893775,Carter; Andrea L,0,1,20,20
1746552030733,MMW 11R,A01,892721,Herbst; Matthew,11,0,27,16
1746552030733,MMW 11R,A02,892722,Herbst; Matthew,0,0,0,3
1746552031759,MMW 12R,A01,892724,Herbst; Matthew,0,11,16,16
1746552031759,MMW 12R,A02,892725,Herbst; Matthew,0,10,16,16
1746552032786,MMW 13R,A01,892727,Staff,0,4,16,16
1746552032786,MMW 13R,A02,892728,Staff,0,4,16,16
1746552032786,MMW 13R,A03,958032,Staff,0,4,16,16
1746552032786,MMW 13R,A04,958033,Staff,0,4,16,16
1746552032786,MMW 13R,A05,958034,Staff,0,4,16,16
1746552033814,SIO 295LS,A00,894015,Staff,5,0,25,20
1746552034839,SIO 295S,A00,894020,Staff,5,0,25,20
1746552035865,SIOC 290S,B01,958918,Merrifield; Mark A,14,0,30,16
1746552036892,SIOC 291S,B01,958922,Gabriel; Corey John,14,0,30,16
1746552037916,SOCI 117,A01,895339,Staff,3,0,5,2
1746552038941,WES 237B,A00,894149,Staff,11,0,20,9
1746552041009,AESE 279B,A00,891859,Staff,13,0,35,22
1746552042036,AIP 197,001,891854,Vespa; Emanuel Ignacio,9999,0,9999,0
1746552043061,ANTH 289S,A00,891856,Gagneux; Pascal,12,0,12,0
1746552044085,BENG 196,001,957946,Engler; Adam J.,9996,0,9999,3
1746552045110,BISP 197,001,959851,Wilhelm; James E.,9998,0,9999,1
1746552046138,CAT 124RS,A01,956906,Staff,6,0,25,19
1746552047165,CAT 125RS,A01,922013,Staff,6,0,25,19
1746552048190,CLRE 250,A00,891860,Morris; Sheldon,9995,0,9999,4
1746552050296,CLRE 251R,A00,907817,Mehta; Ravindra L.,9994,0,9999,5
1746552051320,CLRE 252,A00,891864,Cuomo; Raphael Eduardo,9993,0,9999,6
1746552052344,CLRE 253,A00,891867,Vaida; Florin,9994,0,9999,5
1746552052344,CLRE 253,B00,907819,Staff,9999,0,9999,0
1746552053370,CLRE 259,A00,891868,Patel; Hemal,9998,0,9999,1
1746552054396,CLRE 260,A00,891872,Cuomo; Raphael Eduardo,9999,0,9999,0
1746552055421,CLRE 297,001,891888,Cuomo; Raphael Eduardo,9999,0,9999,0
1746552056447,CSE 191,A00,958773,Minnes Kemp; Mor Mia,9996,0,9999,3
1746552057473,CSE 197,001,959846,Minnes Kemp; Mor Mia,9990,0,9999,9
1746552058498,CSS 201S,A01,892054,Mignozzetti; Umberto,26,0,30,4
1746552059525,CSS 202S,A01,892056,Mignozzetti; Umberto,26,0,30,4
1746552060553,DSC 197,001,956898,Eldridge; Justin Matthew,9997,0,9999,2
1746552061579,DSC 297,001,958000,Mazumdar; Arya,9998,0,9999,1
1746552061579,DSC 297,002,959862,Wang; Yusu,9998,0,9999,1
1746552062607,EAP 100,A00,905686,Staff,9778,0,9999,221
1746552063634,ECE 45,A01,892618,Staff,0,0,65,65
1746552065684,ECE 111,A01,892719,Staff,4,0,65,61
1746552066708,ECE 197,001,957920,Mercier; Patrick Philip,9991,0,9999,8
1746552067820,ECON 178,A01,907814,Zhu; Ying,26,0,35,9
1746552068846,EDS 115,A00,895312,Staff,35,0,45,10
1746552069873,EDS 117,A01,895337,Staff,23,0,30,7
1746552070899,EDS 125,A00,895341,Jones; Gabrielle Anastasia,36,0,45,9
1746552071926,EDS 128A,A01,895459,Fargason; Sharon Gayle,44,0,45,1
1746552072950,EDS 128B,A01,895543,Pappas; Elizabeth,44,0,45,1
1746552073976,EDS 139,A00,897203,Pappas; Elizabeth,44,0,45,1
1746552073976,EDS 139,B00,897209,Fargason; Sharon Gayle,41,0,45,4
1746552075002,EDS 201,A00,895545,Staff,22,0,45,23
1746552076027,EDS 203,A01,895581,Halter; Christopher P.,22,0,45,23
1746552077055,EDS 204R,A01,895625,Heinzman; Erica M.,39,0,45,6
1746552077055,EDS 204R,B01,895693,Halter; Christopher P.,10,0,45,35
1746552078081,EDS 206R,A00,895694,Fargason; Sharon Gayle,1,0,30,29
1746552078081,EDS 206R,B00,895695,Choi; Bailey Miyeon,16,0,30,14
1746552079106,EDS 250,A00,895697,Hemans; Patricia Ann Benitez,22,0,45,23
1746552080130,EDS 281,A00,895701,Meyerott; Theresa Ann,1,0,15,14
1746552081157,EDS 284,A00,895736,Meyerott; Theresa Ann,1,0,15,14
1746552082181,EDS 286,A00,897210,Fine; Sarah,0,0,15,15
1746552083208,EDS 289C,A01,895770,Daly; Alan J.,15,0,15,0
1746552084234,EDS 290,A00,897211,Hofstetter; Carolyn,0,0,15,15
1746552085259,LIGM 5A,A00,896162,Fischer-Grunski; Eva K,13,0,20,7
1746552086286,LIGM 5B,A00,896260,Fischer-Grunski; Eva K,17,0,20,3
1746552087311,LIGM 5C,A00,896308,Fischer-Grunski; Eva K,18,0,20,2
1746552088335,LIIT 5AS,A00,896313,Carnelos; Chiara,18,0,20,2
1746552089363,LIIT 5BS,A00,896416,Carnelos; Chiara,20,0,20,0
1746552090387,LIIT 5CS,A00,896564,Carnelos; Chiara,20,0,20,0
1746552091415,LISP 5A,A00,896588,Munoz Sanchez; Alicia,3,0,20,17
1746552092443,LISP 5B,A00,896653,Munoz Sanchez; Alicia,7,0,20,13
1746552093472,LISP 5C,A00,896655,Munoz Sanchez; Alicia,0,1,20,20
1746552094498,MAE 197,001,957918,Kleissl; Jan,9996,0,9999,3
1746552094498,MAE 197,002,959806,Boechler; Nicholas Sebastia,9998,0,9999,1
1746552094498,MAE 197,003,959852,Mullin; Jennifer S,9998,0,9999,1
1746552095524,MATH 2,A01,957937,Staff,33,0,35,2
1746552096549,MATH 197,001,957876,Kedlaya; Kiran S.,9993,0,9999,6
1746552097577,MCWP 40,A00,892729,Duru; Nur,10,0,20,10
1746552097577,MCWP 40,B00,893304,Montejo; Carolina,14,0,20,6
1746552098602,MCWP 40R,A00,893757,Redela; Pamela Morgan,0,5,20,20
1746552099627,MCWP 50,A00,893758,Morshed; Michael James,0,0,20,20
1746552099627,MCWP 50,B00,893761,Bartulis; Jason Michael,17,0,20,3
1746552100653,MCWP 50R,A00,893766,Compas; Sean Matthew,0,1,20,20
1746552100653,MCWP 50R,B00,893769,Carter; Jennifer A,0,1,20,20
1746552100653,MCWP 50R,C00,893771,Krone; Jarret,0,3,20,20
1746552100653,MCWP 50R,D00,893772,Miller; Elizabeth Deen,0,0,20,20
1746552100653,MCWP 50R,E00,893775,Carter; Andrea L,0,1,20,20
1746552101679,MMW 11R,A01,892721,Herbst; Matthew,11,0,27,16
1746552101679,MMW 11R,A02,892722,Herbst; Matthew,0,0,0,3
1746552102703,MMW 12R,A01,892724,Herbst; Matthew,0,11,16,16
1746552102703,MMW 12R,A02,892725,Herbst; Matthew,0,10,16,16
1746552103731,MMW 13R,A01,892727,Staff,0,4,16,16
1746552103731,MMW 13R,A02,892728,Staff,0,4,16,16
1746552103731,MMW 13R,A03,958032,Staff,0,4,16,16
1746552103731,MMW 13R,A04,958033,Staff,0,4,16,16
1746552103731,MMW 13R,A05,958034,Staff,0,4,16,16
1746552104756,SIO 295LS,A00,894015,Staff,5,0,25,20
1746552105782,SIO 295S,A00,894020,Staff,5,0,25,20
1746552106810,SIOC 290S,B01,958918,Merrifield; Mark A,14,0,30,16
1746552107836,SIOC 291S,B01,958922,Gabriel; Corey John,14,0,30,16
1746552108863,SOCI 117,A01,895339,Staff,3,0,5,2
1746552109886,WES 237B,A00,894149,Staff,11,0,20,9
1746552111980,AESE 279B,A00,891859,Staff,13,0,35,22
1746552113006,AIP 197,001,891854,Vespa; Emanuel Ignacio,9999,0,9999,0
1746552114032,ANTH 289S,A00,891856,Gagneux; Pascal,12,0,12,0
1746552115060,BENG 196,001,957946,Engler; Adam J.,9996,0,9999,3
1746552116086,BISP 197,001,959851,Wilhelm; James E.,9998,0,9999,1
1746552117111,CAT 124RS,A01,956906,Staff,6,0,25,19
1746552118136,CAT 125RS,A01,922013,Staff,6,0,25,19
1746552119163,CLRE 250,A00,891860,Morris; Sheldon,9995,0,9999,4
1746552121219,CLRE 251R,A00,907817,Mehta; Ravindra L.,9994,0,9999,5
1746552122246,CLRE 252,A00,891864,Cuomo; Raphael Eduardo,9993,0,9999,6
1746552123270,CLRE 253,A00,891867,Vaida; Florin,9994,0,9999,5
1746552123270,CLRE 253,B00,907819,Staff,9999,0,9999,0
1746552124296,CLRE 259,A00,891868,Patel; Hemal,9998,0,9999,1
1746552125322,CLRE 260,A00,891872,Cuomo; Raphael Eduardo,9999,0,9999,0
1746552126350,CLRE 297,001,891888,Cuomo; Raphael Eduardo,9999,0,9999,0
1746552127377,CSE 191,A00,958773,Minnes Kemp; Mor Mia,9996,0,9999,3
1746552128401,CSE 197,001,959846,Minnes Kemp; Mor Mia,9990,0,9999,9
1746552129430,CSS 201S,A01,892054,Mignozzetti; Umberto,26,0,30,4
1746552130454,CSS 202S,A01,892056,Mignozzetti; Umberto,26,0,30,4
1746552131479,DSC 197,001,956898,Eldridge; Justin Matthew,9997,0,9999,2
1746552132504,DSC 297,001,958000,Mazumdar; Arya,9998,0,9999,1
1746552132504,DSC 297,002,959862,Wang; Yusu,9998,0,9999,1
1746552133528,EAP 100,A00,905686,Staff,9778,0,9999,221
1746552134556,ECE 45,A01,892618,Staff,0,0,65,65
1746552136608,ECE 111,A01,892719,Staff,4,0,65,61
1746552137635,ECE 197,001,957920,Mercier; Patrick Philip,9991,0,9999,8
1746552138662,ECON 178,A01,907814,Zhu; Ying,26,0,35,9
1746552139687,EDS 115,A00,895312,Staff,35,0,45,10
1746552140714,EDS 117,A01,895337,Staff,23,0,30,7
1746552141741,EDS 125,A00,895341,Jones; Gabrielle Anastasia,36,0,45,9
1746552142768,EDS 128A,A01,895459,Fargason; Sharon Gayle,44,0,45,1
1746552143798,EDS 128B,A01,895543,Pappas; Elizabeth,44,0,45,1
1746552144826,EDS 139,A00,897203,Pappas; Elizabeth,44,0,45,1
1746552144826,EDS 139,B00,897209,Fargason; Sharon Gayle,41,0,45,4
1746552145850,EDS 201,A00,895545,Staff,22,0,45,23
1746552146875,EDS 203,A01,895581,Halter; Christopher P.,22,0,45,23
1746552147900,EDS 204R,A01,895625,Heinzman; Erica M.,39,0,45,6
1746552147900,EDS 204R,B01,895693,Halter; Christopher P.,10,0,45,35
1746552148925,EDS 206R,A00,895694,Fargason; Sharon Gayle,1,0,30,29
1746552148925,EDS 206R,B00,895695,Choi; Bailey Miyeon,16,0,30,14
1746552149954,EDS 250,A00,895697,Hemans; Patricia Ann Benitez,22,0,45,23
1746552150981,EDS 281,A00,895701,Meyerott; Theresa Ann,1,0,15,14
1746552152005,EDS 284,A00,895736,Meyerott; Theresa Ann,1,0,15,14
1746552153073,EDS 286,A00,897210,Fine; Sarah,0,0,15,15
1746552154099,EDS 289C,A01,895770,Daly; Alan J.,15,0,15,0
1746552155123,EDS 290,A00,897211,Hofstetter; Carolyn,0,0,15,15
1746552156153,LIGM 5A,A00,896162,Fischer-Grunski; Eva K,13,0,20,7
1746552157178,LIGM 5B,A00,896260,Fischer-Grunski; Eva K,17,0,20,3
1746552158205,LIGM 5C,A00,896308,Fischer-Grunski; Eva K,18,0,20,2
1746552159234,LIIT 5AS,A00,896313,Carnelos; Chiara,18,0,20,2
1746552160262,LIIT 5BS,A00,896416,Carnelos; Chiara,20,0,20,0
1746552161289,LIIT 5CS,A00,896564,Carnelos; Chiara,20,0,20,0
1746552162315,LISP 5A,A00,896588,Munoz Sanchez; Alicia,3,0,20,17
1746552163339,LISP 5B,A00,896653,Munoz Sanchez; Alicia,7,0,20,13
1746552164370,LISP 5C,A00,896655,Munoz Sanchez; Alicia,0,1,20,20
1746552165394,MAE 197,001,957918,Kleissl; Jan,9996,0,9999,3
1746552165394,MAE 197,002,959806,Boechler; Nicholas Sebastia,9998,0,9999,1
1746552165394,MAE 197,003,959852,Mullin; Jennifer S,9998,0,9999,1
1746552166421,MATH 2,A01,957937,Staff,33,0,35,2
1746552167446,MATH 197,001,957876,Kedlaya; Kiran S.,9993,0,9999,6
1746552168473,MCWP 40,A00,892729,Duru; Nur,10,0,20,10
1746552168473,MCWP 40,B00,893304,Montejo; Carolina,14,0,20,6
1746552169504,MCWP 40R,A00,893757,Redela; Pamela Morgan,0,5,20,20
1746552170534,MCWP 50,A00,893758,Morshed; Michael James,0,0,20,20
1746552170534,MCWP 50,B00,893761,Bartulis; Jason Michael,17,0,20,3
1746552171562,MCWP 50R,A00,893766,Compas; Sean Matthew,0,1,20,20
1746552171562,MCWP 50R,B00,893769,Carter; Jennifer A,0,1,20,20
1746552171562,MCWP 50R,C00,893771,Krone; Jarret,0,3,20,20
1746552171562,MCWP 50R,D00,893772,Miller; Elizabeth Deen,0,0,20,20
1746552171562,MCWP 50R,E00,893775,Carter; Andrea L,0,1,20,20
1746552172587,MMW 11R,A01,892721,Herbst; Matthew,11,0,27,16
1746552172587,MMW 11R,A02,892722,Herbst; Matthew,0,0,0,3
1746552173616,MMW 12R,A01,892724,Herbst; Matthew,0,11,16,16
1746552173616,MMW 12R,A02,892725,Herbst; Matthew,0,10,16,16
1746552174642,MMW 13R,A01,892727,Staff,0,4,16,16
1746552174642,MMW 13R,A02,892728,Staff,0,4,16,16
1746552174642,MMW 13R,A03,958032,Staff,0,4,16,16
1746552174642,MMW 13R,A04,958033,Staff,0,4,16,16
1746552174642,MMW 13R,A05,958034,Staff,0,4,16,16
1746552175670,SIO 295LS,A00,894015,Staff,5,0,25,20
1746552176695,SIO 295S,A00,894020,Staff,5,0,25,20
1746552177723,SIOC 290S,B01,958918,Merrifield; Mark A,14,0,30,16
1746552178750,SIOC 291S,B01,958922,Gabriel; Corey John,14,0,30,16
1746552179777,SOCI 117,A01,895339,Staff,3,0,5,2
1746552180802,WES 237B,A00,894149,Staff,11,0,20,9
1746552182872,AESE 279B,A00,891859,Staff,13,0,35,22
1746552183898,AIP 197,001,891854,Vespa; Emanuel Ignacio,9999,0,9999,0
1746552184924,ANTH 289S,A00,891856,Gagneux; Pascal,12,0,12,0
1746552185949,BENG 196,001,957946,Engler; Adam J.,9996,0,9999,3
1746552186973,BISP 197,001,959851,Wilhelm; James E.,9998,0,9999,1
1746552188000,CAT 124RS,A01,956906,Staff,6,0,25,19
1746552189025,CAT 125RS,A01,922013,Staff,6,0,25,19
1746552190051,CLRE 250,A00,891860,Morris; Sheldon,9995,0,9999,4
1746552192101,CLRE 251R,A00,907817,Mehta; Ravindra L.,9994,0,9999,5
1746552193127,CLRE 252,A00,891864,Cuomo; Raphael Eduardo,9993,0,9999,6
1746552194151,CLRE 253,A00,891867,Vaida; Florin,9994,0,9999,5
1746552194151,CLRE 253,B00,907819,Staff,9999,0,9999,0
1746552195179,CLRE 259,A00,891868,Patel; Hemal,9998,0,9999,1
1746552196204,CLRE 260,A00,891872,Cuomo; Raphael Eduardo,9999,0,9999,0
1746552197228,CLRE 297,001,891888,Cuomo; Raphael Eduardo,9999,0,9999,0
1746552198255,CSE 191,A00,958773,Minnes Kemp; Mor Mia,9996,0,9999,3
1746552199282,CSE 197,001,959846,Minnes Kemp; Mor Mia,9990,0,9999,9
1746552200306,CSS 201S,A01,892054,Mignozzetti; Umberto,26,0,30,4
1746552201332,CSS 202S,A01,892056,Mignozzetti; Umberto,26,0,30,4
1746552202357,DSC 197,001,956898,Eldridge; Justin Matthew,9997,0,9999,2
1746552203382,DSC 297,001,958000,Mazumdar; Arya,9998,0,9999,1
1746552203382,DSC 297,002,959862,Wang; Yusu,9998,0,9999,1
1746552204407,EAP 100,A00,905686,Staff,9778,0,9999,221
1746552205441,ECE 45,A01,892618,Staff,0,0,65,65
1746552207493,ECE 111,A01,892719,Staff,4,0,65,61
1746552208521,ECE 197,001,957920,Mercier; Patrick Philip,9991,0,9999,8
1746552209550,ECON 178,A01,907814,Zhu; Ying,26,0,35,9
1746552210577,EDS 115,A00,895312,Staff,35,0,45,10
1746552211603,EDS 117,A01,895337,Staff,23,0,30,7
1746552212629,EDS 125,A00,895341,Jones; Gabrielle Anastasia,36,0,45,9
1746552213657,EDS 128A,A01,895459,Fargason; Sharon Gayle,44,0,45,1
1746552214684,EDS 128B,A01,895543,Pappas; Elizabeth,44,0,45,1
1746552215710,EDS 139,A00,897203,Pappas; Elizabeth,44,0,45,1
1746552215710,EDS 139,B00,897209,Fargason; Sharon Gayle,41,0,45,4
1746552216734,EDS 201,A00,895545,Staff,22,0,45,23
1746552217762,EDS 203,A01,895581,Halter; Christopher P.,22,0,45,23
1746552218786,EDS 204R,A01,895625,Heinzman; Erica M.,39,0,45,6
1746552218786,EDS 204R,B01,895693,Halter; Christopher P.,10,0,45,35
1746552219811,EDS 206R,A00,895694,Fargason; Sharon Gayle,1,0,30,29
1746552219811,EDS 206R,B00,895695,Choi; Bailey Miyeon,16,0,30,14
1746552220835,EDS 250,A00,895697,Hemans; Patricia Ann Benitez,22,0,45,23
1746552221860,EDS 281,A00,895701,Meyerott; Theresa Ann,1,0,15,14
1746552222886,EDS 284,A00,895736,Meyerott; Theresa Ann,1,0,15,14
1746552223913,EDS 286,A00,897210,Fine; Sarah,0,0,15,15
1746552224938,EDS 289C,A01,895770,Daly; Alan J.,15,0,15,0
1746552225977,EDS 290,A00,897211,Hofstetter; Carolyn,0,0,15,15
1746552227089,LIGM 5A,A00,896162,Fischer-Grunski; Eva K,13,0,20,7
1746552228112,LIGM 5B,A00,896260,Fischer-Grunski; Eva K,17,0,20,3
1746552229138,LIGM 5C,A00,896308,Fischer-Grunski; Eva K,18,0,20,2
1746552230163,LIIT 5AS,A00,896313,Carnelos; Chiara,18,0,20,2
1746552231190,LIIT 5BS,A00,896416,Carnelos; Chiara,20,0,20,0
1746552232215,LIIT 5CS,A00,896564,Carnelos; Chiara,20,0,20,0
1746552233239,LISP 5A,A00,896588,Munoz Sanchez; Alicia,3,0,20,17
1746552234267,LISP 5B,A00,896653,Munoz Sanchez; Alicia,7,0,20,13
1746552235295,LISP 5C,A00,896655,Munoz Sanchez; Alicia,0,1,20,20
1746552236319,MAE 197,001,957918,Kleissl; Jan,9996,0,9999,3
1746552236319,MAE 197,002,959806,Boechler; Nicholas Sebastia,9998,0,9999,1
1746552236319,MAE 197,003,959852,Mullin; Jennifer S,9998,0,9999,1
1746552237345,MATH 2,A01,957937,Staff,33,0,35,2
1746552238370,MATH 197,001,957876,Kedlaya; Kiran S.,9993,0,9999,6
1746552239399,MCWP 40,A00,892729,Duru; Nur,10,0,20,10
1746552239399,MCWP 40,B00,893304,Montejo; Carolina,14,0,20,6
1746552240427,MCWP 40R,A00,893757,Redela; Pamela Morgan,0,5,20,20
1746552241450,MCWP 50,A00,893758,Morshed; Michael James,0,0,20,20
1746552241450,MCWP 50,B00,893761,Bartulis; Jason Michael,17,0,20,3
1746552242483,MCWP 50R,A00,893766,Compas; Sean Matthew,0,1,20,20
1746552242483,MCWP 50R,B00,893769,Carter; Jennifer A,0,1,20,20
1746552242483,MCWP 50R,C00,893771,Krone; Jarret,0,3,20,20
1746552242483,MCWP 50R,D00,893772,Miller; Elizabeth Deen,0,0,20,20
1746552242483,MCWP 50R,E00,893775,Carter; Andrea L,0,1,20,20
1746552243510,MMW 11R,A01,892721,Herbst; Matthew,11,0,27,16
1746552243510,MMW 11R,A02,892722,Herbst; Matthew,0,0,0,3
1746552244535,MMW 12R,A01,892724,Herbst; Matthew,0,11,16,16
1746552244535,MMW 12R,A02,892725,Herbst; Matthew,0,10,16,16
1746552245561,MMW 13R,A01,892727,Staff,0,4,16,16
1746552245561,MMW 13R,A02,892728,Staff,0,4,16,16
1746552245561,MMW 13R,A03,958032,Staff,0,4,16,16
1746552245561,MMW 13R,A04,958033,Staff,0,4,16,16
1746552245561,MMW 13R,A05,958034,Staff,0,4,16,16
1746552246586,SIO 295LS,A00,894015,Staff,5,0,25,20
1746552247611,SIO 295S,A00,894020,Staff,5,0,25,20
1746552248639,SIOC 290S,B01,958918,Merrifield; Mark A,14,0,30,16
1746552249665,SIOC 291S,B01,958922,Gabriel; Corey John,14,0,30,16
1746552250692,SOCI 117,A01,895339,Staff,3,0,5,2
1746552251716,WES 237B,A00,894149,Staff,11,0,20,9
1746552253788,AESE 279B,A00,891859,Staff,13,0,35,22
1746552254816,AIP 197,001,891854,Vespa; Emanuel Ignacio,9999,0,9999,0
1746552255845,ANTH 289S,A00,891856,Gagneux; Pascal,12,0,12,0
1746552256910,BENG 196,001,957946,Engler; Adam J.,9996,0,9999,3
1746552257936,BISP 197,001,959851,Wilhelm; James E.,9998,0,9999,1
1746552258962,CAT 124RS,A01,956906,Staff,6,0,25,19
1746552259988,CAT 125RS,A01,922013,Staff,6,0,25,19
1746552261013,CLRE 250,A00,891860,Morris; Sheldon,9995,0,9999,4
1746552263140,CLRE 251R,A00,907817,Mehta; Ravindra L.,9994,0,9999,5
1746552264163,CLRE 252,A00,891864,Cuomo; Raphael Eduardo,9993,0,9999,6
1746552265189,CLRE 253,A00,891867,Vaida; Florin,9994,0,9999,5
1746552265189,CLRE 253,B00,907819,Staff,9999,0,9999,0
1746552266213,CLRE 259,A00,891868,Patel; Hemal,9998,0,9999,1
1746552267239,CLRE 260,A00,891872,Cuomo; Raphael Eduardo,9999,0,9999,0
1746552268268,CLRE 297,001,891888,Cuomo; Raphael Eduardo,9999,0,9999,0
1746552269295,CSE 191,A00,958773,Minnes Kemp; Mor Mia,9996,0,9999,3
1746552270320,CSE 197,001,959846,Minnes Kemp; Mor Mia,9990,0,9999,9
1746552271348,CSS 201S,A01,892054,Mignozzetti; Umberto,26,0,30,4
1746552272374,CSS 202S,A01,892056,Mignozzetti; Umberto,26,0,30,4
1746552273398,DSC 197,001,956898,Eldridge; Justin Matthew,9997,0,9999,2
1746552274423,DSC 297,001,958000,Mazumdar; Arya,9998,0,9999,1
1746552274423,DSC 297,002,959862,Wang; Yusu,9998,0,9999,1
1746552275447,EAP 100,A00,905686,Staff,9778,0,9999,221
1746552276473,ECE 45,A01,892618,Staff,0,0,65,65
1746552278528,ECE 111,A01,892719,Staff,4,0,65,61
1746552279553,ECE 197,001,957920,Mercier; Patrick Philip,9991,0,9999,8
1746552280581,ECON 178,A01,907814,Zhu; Ying,26,0,35,9
1746552281609,EDS 115,A00,895312,Staff,35,0,45,10
1746552282638,EDS 117,A01,895337,Staff,23,0,30,7
1746552283662,EDS 125,A00,895341,Jones; Gabrielle Anastasia,36,0,45,9
1746552284692,EDS 128A,A01,895459,Fargason; Sharon Gayle,44,0,45,1
1746552285717,EDS 128B,A01,895543,Pappas; Elizabeth,44,0,45,1
1746552286746,EDS 139,A00,897203,Pappas; Elizabeth,44,0,45,1
1746552286746,EDS 139,B00,897209,Fargason; Sharon Gayle,41,0,45,4
1746552287773,EDS 201,A00,895545,Staff,22,0,45,23
1746552288800,EDS 203,A01,895581,Halter; Christopher P.,22,0,45,23
1746552289825,EDS 204R,A01,895625,Heinzman; Erica M.,39,0,45,6
1746552289825,EDS 204R,B01,895693,Halter; Christopher P.,10,0,45,35
1746552290852,EDS 206R,A00,895694,Fargason; Sharon Gayle,1,0,30,29
1746552290852,EDS 206R,B00,895695,Choi; Bailey Miyeon,16,0,30,14
1746552291878,EDS 250,A00,895697,Hemans; Patricia Ann Benitez,22,0,45,23
1746552292905,EDS 281,A00,895701,Meyerott; Theresa Ann,1,0,15,14
1746552293933,EDS 284,A00,895736,Meyerott; Theresa Ann,1,0,15,14
1746552294957,EDS 286,A00,897210,Fine; Sarah,0,0,15,15
1746552295983,EDS 289C,A01,895770,Daly; Alan J.,15,0,15,0
1746552297009,EDS 290,A00,897211,Hofstetter; Carolyn,0,0,15,15
1746552298035,LIGM 5A,A00,896162,Fischer-Grunski; Eva K,13,0,20,7
1746552299066,LIGM 5B,A00,896260,Fischer-Grunski; Eva K,17,0,20,3
1746552300094,LIGM 5C,A00,896308,Fischer-Grunski; Eva K,18,0,20,2
1746552301125,LIIT 5AS,A00,896313,Carnelos; Chiara,18,0,20,2
1746552302150,LIIT 5BS,A00,896416,Carnelos; Chiara,20,0,20,0
1746552303175,LIIT 5CS,A00,896564,Carnelos; Chiara,20,0,20,0
1746552304203,LISP 5A,A00,896588,Munoz Sanchez; Alicia,3,0,20,17
1746552305230,LISP 5B,A00,896653,Munoz Sanchez; Alicia,7,0,20,13
1746552306257,LISP 5C,A00,896655,Munoz Sanchez; Alicia,0,1,20,20
1746552307287,MAE 197,001,957918,Kleissl; Jan,9996,0,9999,3
1746552307287,MAE 197,002,959806,Boechler; Nicholas Sebastia,9998,0,9999,1
1746552307287,MAE 197,003,959852,Mullin; Jennifer S,9998,0,9999,1
1746552308312,MATH 2,A01,957937,Staff,33,0,35,2
1746552309338,MATH 197,001,957876,Kedlaya; Kiran S.,9993,0,9999,6
1746552310362,MCWP 40,A00,892729,Duru; Nur,10,0,20,10
1746552310362,MCWP 40,B00,893304,Montejo; Carolina,14,0,20,6
1746552311388,MCWP 40R,A00,893757,Redela; Pamela Morgan,0,5,20,20
1746552312427,MCWP 50,A00,893758,Morshed; Michael James,0,0,20,20
1746552312427,MCWP 50,B00,893761,Bartulis; Jason Michael,17,0,20,3
1746552313451,MCWP 50R,A00,893766,Compas; Sean Matthew,0,1,20,20
1746552313451,MCWP 50R,B00,893769,Carter; Jennifer A,0,1,20,20
1746552313451,MCWP 50R,C00,893771,Krone; Jarret,0,3,20,20
1746552313451,MCWP 50R,D00,893772,Miller; Elizabeth Deen,0,0,20,20
1746552313451,MCWP 50R,E00,893775,Carter; Andrea L,0,1,20,20
1746552314476,MMW 11R,A01,892721,Herbst; Matthew,11,0,27,16
1746552314476,MMW 11R,A02,892722,Herbst; Matthew,0,0,0,3
1746552315505,MMW 12R,A01,892724,Herbst; Matthew,0,11,16,16
1746552315505,MMW 12R,A02,892725,Herbst; Matthew,0,10,16,16
1746552316530,MMW 13R,A01,892727,Staff,0,4,16,16
1746552316530,MMW 13R,A02,892728,Staff,0,4,16,16
1746552316530,MMW 13R,A03,958032,Staff,0,4,16,16
1746552316530,MMW 13R,A04,958033,Staff,0,4,16,16
1746552316530,MMW 13R,A05,958034,Staff,0,4,16,16
1746552317561,SIO 295LS,A00,894015,Staff,5,0,25,20
1746552318588,SIO 295S,A00,894020,Staff,5,0,25,20
1746552319613,SIOC 290S,B01,958918,Merrifield; Mark A,14,0,30,16
1746552320637,SIOC 291S,B01,958922,Gabriel; Corey John,14,0,30,16
1746552321661,SOCI 117,A01,895339,Staff,3,0,5,2
1746552322685,WES 237B,A00,894149,Staff,11,0,20,9
1746552324742,AESE 279B,A00,891859,Staff,13,0,35,22
1746552325767,AIP 197,001,891854,Vespa; Emanuel Ignacio,9999,0,9999,0
1746552326792,ANTH 289S,A00,891856,Gagneux; Pascal,12,0,12,0
1746552327820,BENG 196,001,957946,Engler; Adam J.,9996,0,9999,3
1746552328847,BISP 197,001,959851,Wilhelm; James E.,9998,0,9999,1
1746552329873,CAT 124RS,A01,956906,Staff,6,0,25,19
1746552330901,CAT 125RS,A01,922013,Staff,6,0,25,19
1746552331927,CLRE 250,A00,891860,Morris; Sheldon,9995,0,9999,4
1746552333978,CLRE 251R,A00,907817,Mehta; Ravindra L.,9994,0,9999,5
1746552335006,CLRE 252,A00,891864,Cuomo; Raphael Eduardo,9993,0,9999,6
1746552336051,CLRE 253,A00,891867,Vaida; Florin,9994,0,9999,5
1746552336051,CLRE 253,B00,907819,Staff,9999,0,9999,0
1746552337077,CLRE 259,A00,891868,Patel; Hemal,9998,0,9999,1
1746552338100,CLRE 260,A00,891872,Cuomo; Raphael Eduardo,9999,0,9999,0
1746552339126,CLRE 297,001,891888,Cuomo; Raphael Eduardo,9999,0,9999,0
1746552340151,CSE 191,A00,958773,Minnes Kemp; Mor Mia,9995,0,9999,4
1746552341173,CSE 197,001,959846,Minnes Kemp; Mor Mia,9990,0,9999,9
1746552342198,CSS 201S,A01,892054,Mignozzetti; Umberto,26,0,30,4
1746552343222,CSS 202S,A01,892056,Mignozzetti; Umberto,26,0,30,4
1746552344247,DSC 197,001,956898,Eldridge; Justin Matthew,9997,0,9999,2
1746552345270,DSC 297,001,958000,Mazumdar; Arya,9998,0,9999,1
1746552345270,DSC 297,002,959862,Wang; Yusu,9998,0,9999,1
1746552346297,EAP 100,A00,905686,Staff,9778,0,9999,221
1746552347321,ECE 45,A01,892618,Staff,0,0,65,65
1746552349371,ECE 111,A01,892719,Staff,4,0,65,61
1746552350395,ECE 197,001,957920,Mercier; Patrick Philip,9991,0,9999,8
1746552351418,ECON 178,A01,907814,Zhu; Ying,26,0,35,9
1746552352445,EDS 115,A00,895312,Staff,35,0,45,10
1746552353471,EDS 117,A01,895337,Staff,23,0,30,7
1746552354499,EDS 125,A00,895341,Jones; Gabrielle Anastasia,36,0,45,9
1746552355524,EDS 128A,A01,895459,Fargason; Sharon Gayle,44,0,45,1
1746552356552,EDS 128B,A01,895543,Pappas; Elizabeth,44,0,45,1
1746552357578,EDS 139,A00,897203,Pappas; Elizabeth,44,0,45,1
1746552357578,EDS 139,B00,897209,Fargason; Sharon Gayle,41,0,45,4
1746552358605,EDS 201,A00,895545,Staff,22,0,45,23
1746552359634,EDS 203,A01,895581,Halter; Christopher P.,22,0,45,23
1746552360661,EDS 204R,A01,895625,Heinzman; Erica M.,39,0,45,6
1746552360661,EDS 204R,B01,895693,Halter; Christopher P.,10,0,45,35
1746552361692,EDS 206R,A00,895694,Fargason; Sharon Gayle,1,0,30,29
1746552361692,EDS 206R,B00,895695,Choi; Bailey Miyeon,16,0,30,14
1746552362718,EDS 250,A00,895697,Hemans; Patricia Ann Benitez,22,0,45,23
1746552363745,EDS 281,A00,895701,Meyerott; Theresa Ann,1,0,15,14
1746552364768,EDS 284,A00,895736,Meyerott; Theresa Ann,1,0,15,14
1746552365796,EDS 286,A00,897210,Fine; Sarah,0,0,15,15
1746552366824,EDS 289C,A01,895770,Daly; Alan J.,15,0,15,0
1746552367848,EDS 290,A00,897211,Hofstetter; Carolyn,0,0,15,15
1746552368877,LIGM 5A,A00,896162,Fischer-Grunski; Eva K,13,0,20,7
1746552369906,LIGM 5B,A00,896260,Fischer-Grunski; Eva K,17,0,20,3
1746552370930,LIGM 5C,A00,896308,Fischer-Grunski; Eva K,18,0,20,2
1746552371956,LIIT 5AS,A00,896313,Carnelos; Chiara,18,0,20,2
1746552372982,LIIT 5BS,A00,896416,Carnelos; Chiara,20,0,20,0
1746552374010,LIIT 5CS,A00,896564,Carnelos; Chiara,20,0,20,0
1746552375039,LISP 5A,A00,896588,Munoz Sanchez; Alicia,3,0,20,17
1746552376063,LISP 5B,A00,896653,Munoz Sanchez; Alicia,7,0,20,13
1746552377092,LISP 5C,A00,896655,Munoz Sanchez; Alicia,0,1,20,20
1746552378119,MAE 197,001,957918,Kleissl; Jan,9996,0,9999,3
1746552378119,MAE 197,002,959806,Boechler; Nicholas Sebastia,9998,0,9999,1
1746552378119,MAE 197,003,959852,Mullin; Jennifer S,9998,0,9999,1
1746552379144,MATH 2,A01,957937,Staff,33,0,35,2
1746552380176,MATH 197,001,957876,Kedlaya; Kiran S.,9993,0,9999,6
1746552381201,MCWP 40,A00,892729,Duru; Nur,10,0,20,10
1746552381201,MCWP 40,B00,893304,Montejo; Carolina,14,0,20,6
1746552382247,MCWP 40R,A00,893757,Redela; Pamela Morgan,0,5,20,20
1746552383270,MCWP 50,A00,893758,Morshed; Michael James,0,0,20,20
1746552383270,MCWP 50,B00,893761,Bartulis; Jason Michael,17,0,20,3
1746552384298,MCWP 50R,A00,893766,Compas; Sean Matthew,0,1,20,20
1746552384298,MCWP 50R,B00,893769,Carter; Jennifer A,0,1,20,20
1746552384298,MCWP 50R,C00,893771,Krone; Jarret,0,3,20,20
1746552384298,MCWP 50R,D00,893772,Miller; Elizabeth Deen,0,0,20,20
1746552384298,MCWP 50R,E00,893775,Carter; Andrea L,0,1,20,20
1746552385324,MMW 11R,A01,892721,Herbst; Matthew,11,0,27,16
1746552385324,MMW 11R,A02,892722,Herbst; Matthew,0,0,0,3
1746552386350,MMW 12R,A01,892724,Herbst; Matthew,0,11,16,16
1746552386350,MMW 12R,A02,892725,Herbst; Matthew,0,10,16,16
1746552387377,MMW 13R,A01,892727,Staff,0,4,16,16
1746552387377,MMW 13R,A02,892728,Staff,0,4,16,16
1746552387377,MMW 13R,A03,958032,Staff,0,4,16,16
1746552387377,MMW 13R,A04,958033,Staff,0,4,16,16
1746552387377,MMW 13R,A05,958034,Staff,0,4,16,16
1746552388401,SIO 295LS,A00,894015,Staff,5,0,25,20
1746552389428,SIO 295S,A00,894020,Staff,5,0,25,20
1746552390453,SIOC 290S,B01,958918,Merrifield; Mark A,14,0,30,16
1746552391481,SIOC 291S,B01,958922,Gabriel; Corey John,14,0,30,16
1746552392505,SOCI 117,A01,895339,Staff,3,0,5,2
1746552393530,WES 237B,A00,894149,Staff,11,0,20,9
1746552395597,AESE 279B,A00,891859,Staff,13,0,35,22
1746552396621,AIP 197,001,891854,Vespa; Emanuel Ignacio,9999,0,9999,0
1746552397648,ANTH 289S,A00,891856,Gagneux; Pascal,12,0,12,0
1746552398672,BENG 196,001,957946,Engler; Adam J.,9996,0,9999,3
1746552399695,BISP 197,001,959851,Wilhelm; James E.,9998,0,9999,1
1746552400720,CAT 124RS,A01,956906,Staff,6,0,25,19
1746552401746,CAT 125RS,A01,922013,Staff,6,0,25,19
1746552402771,CLRE 250,A00,891860,Morris; Sheldon,9995,0,9999,4
1746552404826,CLRE 251R,A00,907817,Mehta; Ravindra L.,9994,0,9999,5
1746552405852,CLRE 252,A00,891864,Cuomo; Raphael Eduardo,9993,0,9999,6
1746552406877,CLRE 253,A00,891867,Vaida; Florin,9994,0,9999,5
1746552406877,CLRE 253,B00,907819,Staff,9999,0,9999,0
1746552407900,CLRE 259,A00,891868,Patel; Hemal,9998,0,9999,1
1746552408941,CLRE 260,A00,891872,Cuomo; Raphael Eduardo,9999,0,9999,0
1746552409965,CLRE 297,001,891888,Cuomo; Raphael Eduardo,9999,0,9999,0
1746552410992,CSE 191,A00,958773,Minnes Kemp; Mor Mia,9995,0,9999,4
1746552412022,CSE 197,001,959846,Minnes Kemp; Mor Mia,9990,0,9999,9
1746552413048,CSS 201S,A01,892054,Mignozzetti; Umberto,26,0,30,4
1746552414074,CSS 202S,A01,892056,Mignozzetti; Umberto,26,0,30,4
1746552415097,DSC 197,001,956898,Eldridge; Justin Matthew,9997,0,9999,2
1746552428712,DSC 297,001,958000,Mazumdar; Arya,9998,0,9999,1
1746552428712,DSC 297,002,959862,Wang; Yusu,9998,0,9999,1
1746552429739,EAP 100,A00,905686,Staff,9778,0,9999,221
1746552430766,ECE 45,A01,892618,Staff,0,0,65,65
1746552432819,ECE 111,A01,892719,Staff,4,0,65,61
1746552433843,ECE 197,001,957920,Mercier; Patrick Philip,9991,0,9999,8
1746552434875,ECON 178,A01,907814,Zhu; Ying,26,0,35,9
1746552435897,EDS 115,A00,895312,Staff,35,0,45,10
1746552436924,EDS 117,A01,895337,Staff,23,0,30,7
1746552437951,EDS 125,A00,895341,Jones; Gabrielle Anastasia,36,0,45,9
1746552438980,EDS 128A,A01,895459,Fargason; Sharon Gayle,44,0,45,1
1746552440007,EDS 128B,A01,895543,Pappas; Elizabeth,44,0,45,1
1746552441033,EDS 139,A00,897203,Pappas; Elizabeth,44,0,45,1
1746552441033,EDS 139,B00,897209,Fargason; Sharon Gayle,41,0,45,4
1746552442112,EDS 201,A00,895545,Staff,22,0,45,23
1746552443139,EDS 203,A01,895581,Halter; Christopher P.,22,0,45,23
1746552444164,EDS 204R,A01,895625,Heinzman; Erica M.,39,0,45,6
1746552444164,EDS 204R,B01,895693,Halter; Christopher P.,10,0,45,35
1746552445190,EDS 206R,A00,895694,Fargason; Sharon Gayle,1,0,30,29
1746552445190,EDS 206R,B00,895695,Choi; Bailey Miyeon,16,0,30,14
1746552446213,EDS 250,A00,895697,Hemans; Patricia Ann Benitez,22,0,45,23
1746552447238,EDS 281,A00,895701,Meyerott; Theresa Ann,1,0,15,14
1746552448262,EDS 284,A00,895736,Meyerott; Theresa Ann,1,0,15,14
1746552449287,EDS 286,A00,897210,Fine; Sarah,0,0,15,15
1746552450312,EDS 289C,A01,895770,Daly; Alan J.,15,0,15,0
1746552451338,EDS 290,A00,897211,Hofstetter; Carolyn,0,0,15,15
1746552452366,LIGM 5A,A00,896162,Fischer-Grunski; Eva K,13,0,20,7
1746552453392,LIGM 5B,A00,896260,Fischer-Grunski; Eva K,17,0,20,3
1746552454422,LIGM 5C,A00,896308,Fischer-Grunski; Eva K,18,0,20,2
1746552455449,LIIT 5AS,A00,896313,Carnelos; Chiara,18,0,20,2
1746552456474,LIIT 5BS,A00,896416,Carnelos; Chiara,20,0,20,0
1746552457499,LIIT 5CS,A00,896564,Carnelos; Chiara,20,0,20,0
1746552458528,LISP 5A,A00,896588,Munoz Sanchez; Alicia,3,0,20,17
1746552459556,LISP 5B,A00,896653,Munoz Sanchez; Alicia,7,0,20,13
1746552460583,LISP 5C,A00,896655,Munoz Sanchez; Alicia,0,1,20,20
1746552461611,MAE 197,001,957918,Kleissl; Jan,9996,0,9999,3
1746552461611,MAE 197,002,959806,Boechler; Nicholas Sebastia,9998,0,9999,1
1746552461611,MAE 197,003,959852,Mullin; Jennifer S,9998,0,9999,1
1746552462634,MATH 2,A01,957937,Staff,33,0,35,2
1746552463659,MATH 197,001,957876,Kedlaya; Kiran S.,9993,0,9999,6
1746552464685,MCWP 40,A00,892729,Duru; Nur,10,0,20,10
1746552464685,MCWP 40,B00,893304,Montejo; Carolina,14,0,20,6
1746552465711,MCWP 40R,A00,893757,Redela; Pamela Morgan,0,5,20,20
1746552466739,MCWP 50,A00,893758,Morshed; Michael James,0,0,20,20
1746552466739,MCWP 50,B00,893761,Bartulis; Jason Michael,17,0,20,3
1746552467764,MCWP 50R,A00,893766,Compas; Sean Matthew,0,1,20,20
1746552467764,MCWP 50R,B00,893769,Carter; Jennifer A,0,1,20,20
1746552467764,MCWP 50R,C00,893771,Krone; Jarret,0,3,20,20
1746552467764,MCWP 50R,D00,893772,Miller; Elizabeth Deen,0,0,20,20
1746552467764,MCWP 50R,E00,893775,Carter; Andrea L,0,1,20,20
1746552468789,MMW 11R,A01,892721,Herbst; Matthew,11,0,27,16
1746552468789,MMW 11R,A02,892722,Herbst; Matthew,0,0,0,3
1746552469816,MMW 12R,A01,892724,Herbst; Matthew,0,11,16,16
1746552469816,MMW 12R,A02,892725,Herbst; Matthew,0,10,16,16
1746552470841,MMW 13R,A01,892727,Staff,0,4,16,16
1746552470841,MMW 13R,A02,892728,Staff,0,4,16,16
1746552470841,MMW 13R,A03,958032,Staff,0,4,16,16
1746552470841,MMW 13R,A04,958033,Staff,0,4,16,16
1746552470841,MMW 13R,A05,958034,Staff,0,4,16,16
1746552471868,SIO 295LS,A00,894015,Staff,5,0,25,20
1746552472896,SIO 295S,A00,894020,Staff,5,0,25,20
1746552473927,SIOC 290S,B01,958918,Merrifield; Mark A,14,0,30,16
1746552474978,SIOC 291S,B01,958922,Gabriel; Corey John,14,0,30,16
1746552476005,SOCI 117,A01,895339,Staff,3,0,5,2
1746552477029,WES 237B,A00,894149,Staff,11,0,20,9
1746552479095,AESE 279B,A00,891859,Staff,13,0,35,22
1746552480120,AIP 197,001,891854,Vespa; Emanuel Ignacio,9999,0,9999,0
1746552481145,ANTH 289S,A00,891856,Gagneux; Pascal,12,0,12,0
1746552482169,BENG 196,001,957946,Engler; Adam J.,9996,0,9999,3
1746552483193,BISP 197,001,959851,Wilhelm; James E.,9998,0,9999,1
1746552484215,CAT 124RS,A01,956906,Staff,6,0,25,19
1746552485240,CAT 125RS,A01,922013,Staff,6,0,25,19
1746552486265,CLRE 250,A00,891860,Morris; Sheldon,9995,0,9999,4
1746552488319,CLRE 251R,A00,907817,Mehta; Ravindra L.,9994,0,9999,5
1746552489346,CLRE 252,A00,891864,Cuomo; Raphael Eduardo,9993,0,9999,6
1746552490372,CLRE 253,A00,891867,Vaida; Florin,9994,0,9999,5
1746552490372,CLRE 253,B00,907819,Staff,9999,0,9999,0
1746552491395,CLRE 259,A00,891868,Patel; Hemal,9998,0,9999,1
1746552492426,CLRE 260,A00,891872,Cuomo; Raphael Eduardo,9999,0,9999,0
1746552493452,CLRE 297,001,891888,Cuomo; Raphael Eduardo,9999,0,9999,0
1746552494480,CSE 191,A00,958773,Minnes Kemp; Mor Mia,9995,0,9999,4
1746552495503,CSE 197,001,959846,Minnes Kemp; Mor Mia,9990,0,9999,9
1746552496527,CSS 201S,A01,892054,Mignozzetti; Umberto,26,0,30,4
1746552497554,CSS 202S,A01,892056,Mignozzetti; Umberto,26,0,30,4
1746552498578,DSC 197,001,956898,Eldridge; Justin Matthew,9997,0,9999,2
1746552499601,DSC 297,001,958000,Mazumdar; Arya,9998,0,9999,1
1746552499601,DSC 297,002,959862,Wang; Yusu,9998,0,9999,1
1746552500625,EAP 100,A00,905686,Staff,9778,0,9999,221
1746552501650,ECE 45,A01,892618,Staff,0,0,65,65
1746552503700,ECE 111,A01,892719,Staff,4,0,65,61
1746552504724,ECE 197,001,957920,Mercier; Patrick Philip,9991,0,9999,8
1746552505751,ECON 178,A01,907814,Zhu; Ying,26,0,35,9
1746552506774,EDS 115,A00,895312,Staff,35,0,45,10
1746552507797,EDS 117,A01,895337,Staff,23,0,30,7
1746552508826,EDS 125,A00,895341,Jones; Gabrielle Anastasia,36,0,45,9
1746552509853,EDS 128A,A01,895459,Fargason; Sharon Gayle,44,0,45,1
1746552510881,EDS 128B,A01,895543,Pappas; Elizabeth,44,0,45,1
1746552511905,EDS 139,A00,897203,Pappas; Elizabeth,44,0,45,1
1746552511905,EDS 139,B00,897209,Fargason; Sharon Gayle,41,0,45,4
1746552512932,EDS 201,A00,895545,Staff,22,0,45,23
1746552513962,EDS 203,A01,895581,Halter; Christopher P.,22,0,45,23
1746552514985,EDS 204R,A01,895625,Heinzman; Erica M.,39,0,45,6
1746552514985,EDS 204R,B01,895693,Halter; Christopher P.,10,0,45,35
1746552516008,EDS 206R,A00,895694,Fargason; Sharon Gayle,1,0,30,29
1746552516008,EDS 206R,B00,895695,Choi; Bailey Miyeon,16,0,30,14
1746552517032,EDS 250,A00,895697,Hemans; Patricia Ann Benitez,22,0,45,23
1746552518057,EDS 281,A00,895701,Meyerott; Theresa Ann,1,0,15,14
1746552519085,EDS 284,A00,895736,Meyerott; Theresa Ann,1,0,15,14
1746552520114,EDS 286,A00,897210,Fine; Sarah,0,0,15,15
1746552521141,EDS 289C,A01,895770,Daly; Alan J.,15,0,15,0
1746552522167,EDS 290,A00,897211,Hofstetter; Carolyn,0,0,15,15
1746552523194,LIGM 5A,A00,896162,Fischer-Grunski; Eva K,13,0,20,7
1746552524218,LIGM 5B,A00,896260,Fischer-Grunski; Eva K,17,0,20,3
1746552525242,LIGM 5C,A00,896308,Fischer-Grunski; Eva K,18,0,20,2
1746552526268,LIIT 5AS,A00,896313,Carnelos; Chiara,18,0,20,2
1746552527296,LIIT 5BS,A00,896416,Carnelos; Chiara,20,0,20,0
1746552528323,LIIT 5CS,A00,896564,Carnelos; Chiara,20,0,20,0
1746552529348,LISP 5A,A00,896588,Munoz Sanchez; Alicia,3,0,20,17
1746552530373,LISP 5B,A00,896653,Munoz Sanchez; Alicia,7,0,20,13
1746552531397,LISP 5C,A00,896655,Munoz Sanchez; Alicia,0,1,20,20
1746552532426,MAE 197,001,957918,Kleissl; Jan,9996,0,9999,3
1746552532426,MAE 197,002,959806,Boechler; Nicholas Sebastia,9998,0,9999,1
1746552532426,MAE 197,003,959852,Mullin; Jennifer S,9998,0,9999,1
1746552533452,MATH 2,A01,957937,Staff,33,0,35,2
1746552534480,MATH 197,001,957876,Kedlaya; Kiran S.,9993,0,9999,6
1746552535507,MCWP 40,A00,892729,Duru; Nur,10,0,20,10
1746552535507,MCWP 40,B00,893304,Montejo; Carolina,14,0,20,6
1746552536533,MCWP 40R,A00,893757,Redela; Pamela Morgan,0,5,20,20
1746552537558,MCWP 50,A00,893758,Morshed; Michael James,0,0,20,20
1746552537558,MCWP 50,B00,893761,Bartulis; Jason Michael,17,0,20,3
1746552538583,MCWP 50R,A00,893766,Compas; Sean Matthew,0,1,20,20
1746552538583,MCWP 50R,B00,893769,Carter; Jennifer A,0,1,20,20
1746552538583,MCWP 50R,C00,893771,Krone; Jarret,0,3,20,20
1746552538583,MCWP 50R,D00,893772,Miller; Elizabeth Deen,0,0,20,20
1746552538583,MCWP 50R,E00,893775,Carter; Andrea L,0,1,20,20
1746552539611,MMW 11R,A01,892721,Herbst; Matthew,11,0,27,16
1746552539611,MMW 11R,A02,892722,Herbst; Matthew,0,0,0,3
1746552540637,MMW 12R,A01,892724,Herbst; Matthew,0,11,16,16
1746552540637,MMW 12R,A02,892725,Herbst; Matthew,0,10,16,16
1746552541664,MMW 13R,A01,892727,Staff,0,4,16,16
1746552541664,MMW 13R,A02,892728,Staff,0,4,16,16
1746552541664,MMW 13R,A03,958032,Staff,0,4,16,16
1746552541664,MMW 13R,A04,958033,Staff,0,4,16,16
1746552541664,MMW 13R,A05,958034,Staff,0,4,16,16
1746552542694,SIO 295LS,A00,894015,Staff,5,0,25,20
1746552543721,SIO 295S,A00,894020,Staff,5,0,25,20
1746552544747,SIOC 290S,B01,958918,Merrifield; Mark A,14,0,30,16
1746552545775,SIOC 291S,B01,958922,Gabriel; Corey John,14,0,30,16
1746552546803,SOCI 117,A01,895339,Staff,3,0,5,2
1746552547827,WES 237B,A00,894149,Staff,11,0,20,9
1746552549891,AESE 279B,A00,891859,Staff,13,0,35,22
1746552550916,AIP 197,001,891854,Vespa; Emanuel Ignacio,9999,0,9999,0
1746552551941,ANTH 289S,A00,891856,Gagneux; Pascal,12,0,12,0
1746552552968,BENG 196,001,957946,Engler; Adam J.,9996,0,9999,3
1746552553993,BISP 197,001,959851,Wilhelm; James E.,9998,0,9999,1
1746552555022,CAT 124RS,A01,956906,Staff,6,0,25,19
1746552556051,CAT 125RS,A01,922013,Staff,6,0,25,19
1746552557076,CLRE 250,A00,891860,Morris; Sheldon,9995,0,9999,4
1746552559129,CLRE 251R,A00,907817,Mehta; Ravindra L.,9994,0,9999,5
1746552560154,CLRE 252,A00,891864,Cuomo; Raphael Eduardo,9993,0,9999,6
1746552561178,CLRE 253,A00,891867,Vaida; Florin,9994,0,9999,5
1746552561178,CLRE 253,B00,907819,Staff,9999,0,9999,0
1746552562206,CLRE 259,A00,891868,Patel; Hemal,9998,0,9999,1
1746552563233,CLRE 260,A00,891872,Cuomo; Raphael Eduardo,9999,0,9999,0
1746552564261,CLRE 297,001,891888,Cuomo; Raphael Eduardo,9999,0,9999,0
1746552565289,CSE 191,A00,958773,Minnes Kemp; Mor Mia,9995,0,9999,4
1746552566315,CSE 197,001,959846,Minnes Kemp; Mor Mia,9990,0,9999,9
1746552567342,CSS 201S,A01,892054,Mignozzetti; Umberto,26,0,30,4
1746552568366,CSS 202S,A01,892056,Mignozzetti; Umberto,26,0,30,4
1746552569393,DSC 197,001,956898,Eldridge; Justin Matthew,9997,0,9999,2
1746552570418,DSC 297,001,958000,Mazumdar; Arya,9998,0,9999,1
1746552570418,DSC 297,002,959862,Wang; Yusu,9998,0,9999,1
1746552571445,EAP 100,A00,905686,Staff,9778,0,9999,221
1746552572474,ECE 45,A01,892618,Staff,0,0,65,65
1746552574523,ECE 111,A01,892719,Staff,4,0,65,61
1746552575553,ECE 197,001,957920,Mercier; Patrick Philip,9991,0,9999,8
1746552576581,ECON 178,A01,907814,Zhu; Ying,26,0,35,9
1746552577606,EDS 115,A00,895312,Staff,35,0,45,10
1746552578634,EDS 117,A01,895337,Staff,23,0,30,7
1746552579661,EDS 125,A00,895341,Jones; Gabrielle Anastasia,36,0,45,9
1746552580687,EDS 128A,A01,895459,Fargason; Sharon Gayle,44,0,45,1
1746552581711,EDS 128B,A01,895543,Pappas; Elizabeth,44,0,45,1
1746552582739,EDS 139,A00,897203,Pappas; Elizabeth,44,0,45,1
1746552582739,EDS 139,B00,897209,Fargason; Sharon Gayle,41,0,45,4
1746552583763,EDS 201,A00,895545,Staff,22,0,45,23
1746552584790,EDS 203,A01,895581,Halter; Christopher P.,22,0,45,23
1746552585817,EDS 204R,A01,895625,Heinzman; Erica M.,39,0,45,6
1746552585817,EDS 204R,B01,895693,Halter; Christopher P.,10,0,45,35
1746552586842,EDS 206R,A00,895694,Fargason; Sharon Gayle,1,0,30,29
1746552586842,EDS 206R,B00,895695,Choi; Bailey Miyeon,16,0,30,14
1746552587868,EDS 250,A00,895697,Hemans; Patricia Ann Benitez,22,0,45,23
1746552588895,EDS 281,A00,895701,Meyerott; Theresa Ann,1,0,15,14
1746552589921,EDS 284,A00,895736,Meyerott; Theresa Ann,1,0,15,14
1746552590948,EDS 286,A00,897210,Fine; Sarah,0,0,15,15
1746552591973,EDS 289C,A01,895770,Daly; Alan J.,15,0,15,0
1746552592999,EDS 290,A00,897211,Hofstetter; Carolyn,0,0,15,15
1746552594029,LIGM 5A,A00,896162,Fischer-Grunski; Eva K,13,0,20,7
1746552595054,LIGM 5B,A00,896260,Fischer-Grunski; Eva K,17,0,20,3
1746552596082,LIGM 5C,A00,896308,Fischer-Grunski; Eva K,18,0,20,2
1746552597110,LIIT 5AS,A00,896313,Carnelos; Chiara,18,0,20,2
1746552598140,LIIT 5BS,A00,896416,Carnelos; Chiara,20,0,20,0
1746552599167,LIIT 5CS,A00,896564,Carnelos; Chiara,20,0,20,0
1746552600194,LISP 5A,A00,896588,Munoz Sanchez; Alicia,3,0,20,17
1746552601220,LISP 5B,A00,896653,Munoz Sanchez; Alicia,7,0,20,13
1746552602263,LISP 5C,A00,896655,Munoz Sanchez; Alicia,0,1,20,20
1746552603291,MAE 197,001,957918,Kleissl; Jan,9996,0,9999,3
1746552603291,MAE 197,002,959806,Boechler; Nicholas Sebastia,9998,0,9999,1
1746552603291,MAE 197,003,959852,Mullin; Jennifer S,9998,0,9999,1
1746552604318,MATH 2,A01,957937,Staff,33,0,35,2
1746552605347,MATH 197,001,957876,Kedlaya; Kiran S.,9993,0,9999,6
1746552606375,MCWP 40,A00,892729,Duru; Nur,10,0,20,10
1746552606375,MCWP 40,B00,893304,Montejo; Carolina,14,0,20,6
1746552607401,MCWP 40R,A00,893757,Redela; Pamela Morgan,0,5,20,20
1746552608425,MCWP 50,A00,893758,Morshed; Michael James,0,0,20,20
1746552608425,MCWP 50,B00,893761,Bartulis; Jason Michael,17,0,20,3
1746552609450,MCWP 50R,A00,893766,Compas; Sean Matthew,0,1,20,20
1746552609450,MCWP 50R,B00,893769,Carter; Jennifer A,0,1,20,20
1746552609450,MCWP 50R,C00,893771,Krone; Jarret,0,3,20,20
1746552609450,MCWP 50R,D00,893772,Miller; Elizabeth Deen,0,0,20,20
1746552609450,MCWP 50R,E00,893775,Carter; Andrea L,0,1,20,20
1746552610474,MMW 11R,A01,892721,Herbst; Matthew,11,0,27,16
1746552610474,MMW 11R,A02,892722,Herbst; Matthew,0,0,0,3
1746552611501,MMW 12R,A01,892724,Herbst; Matthew,0,11,16,16
1746552611501,MMW 12R,A02,892725,Herbst; Matthew,0,10,16,16
1746552612529,MMW 13R,A01,892727,Staff,0,4,16,16
1746552612529,MMW 13R,A02,892728,Staff,0,4,16,16
1746552612529,MMW 13R,A03,958032,Staff,0,4,16,16
1746552612529,MMW 13R,A04,958033,Staff,0,4,16,16
1746552612529,MMW 13R,A05,958034,Staff,0,4,16,16
1746552613554,SIO 295LS,A00,894015,Staff,5,0,25,20
1746552614579,SIO 295S,A00,894020,Staff,5,0,25,20
1746552615604,SIOC 290S,B01,958918,Merrifield; Mark A,14,0,30,16
1746552616631,SIOC 291S,B01,958922,Gabriel; Corey John,14,0,30,16
1746552617658,SOCI 117,A01,895339,Staff,3,0,5,2
1746552618681,WES 237B,A00,894149,Staff,11,0,20,9
1746552620742,AESE 279B,A00,891859,Staff,13,0,35,22
1746552621767,AIP 197,001,891854,Vespa; Emanuel Ignacio,9999,0,9999,0
1746552622790,ANTH 289S,A00,891856,Gagneux; Pascal,12,0,12,0
1746552623816,BENG 196,001,957946,Engler; Adam J.,9996,0,9999,3
1746552624840,BISP 197,001,959851,Wilhelm; James E.,9998,0,9999,1
1746552625866,CAT 124RS,A01,956906,Staff,6,0,25,19
1746552626895,CAT 125RS,A01,922013,Staff,6,0,25,19
1746552627921,CLRE 250,A00,891860,Morris; Sheldon,9995,0,9999,4
1746552629974,CLRE 251R,A00,907817,Mehta; Ravindra L.,9994,0,9999,5
1746552631002,CLRE 252,A00,891864,Cuomo; Raphael Eduardo,9993,0,9999,6
1746552632028,CLRE 253,A00,891867,Vaida; Florin,9994,0,9999,5
1746552632028,CLRE 253,B00,907819,Staff,9999,0,9999,0
1746552633054,CLRE 259,A00,891868,Patel; Hemal,9998,0,9999,1
1746552634078,CLRE 260,A00,891872,Cuomo; Raphael Eduardo,9999,0,9999,0
1746552635105,CLRE 297,001,891888,Cuomo; Raphael Eduardo,9999,0,9999,0
1746552636133,CSE 191,A00,958773,Minnes Kemp; Mor Mia,9995,0,9999,4
1746552637160,CSE 197,001,959846,Minnes Kemp; Mor Mia,9990,0,9999,9
1746552638190,CSS 201S,A01,892054,Mignozzetti; Umberto,26,0,30,4
1746552639219,CSS 202S,A01,892056,Mignozzetti; Umberto,26,0,30,4
1746552640246,DSC 197,001,956898,Eldridge; Justin Matthew,9997,0,9999,2
1746552641273,DSC 297,001,958000,Mazumdar; Arya,9998,0,9999,1
1746552641273,DSC 297,002,959862,Wang; Yusu,9998,0,9999,1
1746552642298,EAP 100,A00,905686,Staff,9778,0,9999,221
1746552643324,ECE 45,A01,892618,Staff,0,0,65,65
1746552645376,ECE 111,A01,892719,Staff,4,0,65,61
1746552646404,ECE 197,001,957920,Mercier; Patrick Philip,9991,0,9999,8
1746552647431,ECON 178,A01,907814,Zhu; Ying,26,0,35,9
1746552648458,EDS 115,A00,895312,Staff,35,0,45,10
1746552649486,EDS 117,A01,895337,Staff,23,0,30,7
1746552650516,EDS 125,A00,895341,Jones; Gabrielle Anastasia,36,0,45,9
1746552651544,EDS 128A,A01,895459,Fargason; Sharon Gayle,44,0,45,1
1746552652570,EDS 128B,A01,895543,Pappas; Elizabeth,44,0,45,1
1746552653595,EDS 139,A00,897203,Pappas; Elizabeth,44,0,45,1
1746552653595,EDS 139,B00,897209,Fargason; Sharon Gayle,41,0,45,4
1746552654619,EDS 201,A00,895545,Staff,22,0,45,23
1746552655646,EDS 203,A01,895581,Halter; Christopher P.,22,0,45,23
1746552656671,EDS 204R,A01,895625,Heinzman; Erica M.,39,0,45,6
1746552656671,EDS 204R,B01,895693,Halter; Christopher P.,10,0,45,35
1746552657698,EDS 206R,A00,895694,Fargason; Sharon Gayle,1,0,30,29
1746552657698,EDS 206R,B00,895695,Choi; Bailey Miyeon,16,0,30,14
1746552658724,EDS 250,A00,895697,Hemans; Patricia Ann Benitez,22,0,45,23
1746552659752,EDS 281,A00,895701,Meyerott; Theresa Ann,1,0,15,14
1746552660782,EDS 284,A00,895736,Meyerott; Theresa Ann,1,0,15,14
1746552661807,EDS 286,A00,897210,Fine; Sarah,0,0,15,15
1746552662834,EDS 289C,A01,895770,Daly; Alan J.,15,0,15,0
1746552663863,EDS 290,A00,897211,Hofstetter; Carolyn,0,0,15,15
1746552664895,LIGM 5A,A00,896162,Fischer-Grunski; Eva K,13,0,20,7
1746552665920,LIGM 5B,A00,896260,Fischer-Grunski; Eva K,17,0,20,3
1746552666945,LIGM 5C,A00,896308,Fischer-Grunski; Eva K,18,0,20,2
1746552667971,LIIT 5AS,A00,896313,Carnelos; Chiara,18,0,20,2
1746552668997,LIIT 5BS,A00,896416,Carnelos; Chiara,20,0,20,0
1746552670039,LIIT 5CS,A00,896564,Carnelos; Chiara,20,0,20,0
1746552671064,LISP 5A,A00,896588,Munoz Sanchez; Alicia,3,0,20,17
1746552672089,LISP 5B,A00,896653,Munoz Sanchez; Alicia,7,0,20,13
1746552673114,LISP 5C,A00,896655,Munoz Sanchez; Alicia,0,1,20,20
1746552674142,MAE 197,001,957918,Kleissl; Jan,9996,0,9999,3
1746552674142,MAE 197,002,959806,Boechler; Nicholas Sebastia,9998,0,9999,1
1746552674142,MAE 197,003,959852,Mullin; Jennifer S,9998,0,9999,1
1746552675167,MATH 2,A01,957937,Staff,33,0,35,2
1746552676195,MATH 197,001,957876,Kedlaya; Kiran S.,9993,0,9999,6
1746552677223,MCWP 40,A00,892729,Duru; Nur,10,0,20,10
1746552677223,MCWP 40,B00,893304,Montejo; Carolina,14,0,20,6
1746552678248,MCWP 40R,A00,893757,Redela; Pamela Morgan,0,5,20,20
1746552679275,MCWP 50,A00,893758,Morshed; Michael James,0,0,20,20
1746552679275,MCWP 50,B00,893761,Bartulis; Jason Michael,17,0,20,3
1746552680302,MCWP 50R,A00,893766,Compas; Sean Matthew,0,1,20,20
1746552680302,MCWP 50R,B00,893769,Carter; Jennifer A,0,1,20,20
1746552680302,MCWP 50R,C00,893771,Krone; Jarret,0,3,20,20
1746552680302,MCWP 50R,D00,893772,Miller; Elizabeth Deen,0,0,20,20
1746552680302,MCWP 50R,E00,893775,Carter; Andrea L,0,1,20,20
1746552681330,MMW 11R,A01,892721,Herbst; Matthew,11,0,27,16
1746552681330,MMW 11R,A02,892722,Herbst; Matthew,0,0,0,3
1746552682356,MMW 12R,A01,892724,Herbst; Matthew,0,11,16,16
1746552682356,MMW 12R,A02,892725,Herbst; Matthew,0,10,16,16
1746552683384,MMW 13R,A01,892727,Staff,0,4,16,16
1746552683384,MMW 13R,A02,892728,Staff,0,4,16,16
1746552683384,MMW 13R,A03,958032,Staff,0,4,16,16
1746552683384,MMW 13R,A04,958033,Staff,0,4,16,16
1746552683384,MMW 13R,A05,958034,Staff,0,4,16,16
1746552684410,SIO 295LS,A00,894015,Staff,5,0,25,20
1746552685441,SIO 295S,A00,894020,Staff,5,0,25,20
1746552686467,SIOC 290S,B01,958918,Merrifield; Mark A,14,0,30,16
1746552687496,SIOC 291S,B01,958922,Gabriel; Corey John,14,0,30,16
1746552688525,SOCI 117,A01,895339,Staff,3,0,5,2
1746552689551,WES 237B,A00,894149,Staff,11,0,20,9
1746552691618,AESE 279B,A00,891859,Staff,13,0,35,22
1746552692641,AIP 197,001,891854,Vespa; Emanuel Ignacio,9999,0,9999,0
1746552693666,ANTH 289S,A00,891856,Gagneux; Pascal,12,0,12,0
1746552694693,BENG 196,001,957946,Engler; Adam J.,9996,0,9999,3
1746552695718,BISP 197,001,959851,Wilhelm; James E.,9998,0,9999,1
1746552696744,CAT 124RS,A01,956906,Staff,6,0,25,19
1746552697771,CAT 125RS,A01,922013,Staff,6,0,25,19
1746552698798,CLRE 250,A00,891860,Morris; Sheldon,9995,0,9999,4
1746552700853,CLRE 251R,A00,907817,Mehta; Ravindra L.,9994,0,9999,5
1746552701879,CLRE 252,A00,891864,Cuomo; Raphael Eduardo,9993,0,9999,6
1746552702909,CLRE 253,A00,891867,Vaida; Florin,9994,0,9999,5
1746552702909,CLRE 253,B00,907819,Staff,9999,0,9999,0
1746552703936,CLRE 259,A00,891868,Patel; Hemal,9998,0,9999,1
1746552704964,CLRE 260,A00,891872,Cuomo; Raphael Eduardo,9999,0,9999,0
1746552705991,CLRE 297,001,891888,Cuomo; Raphael Eduardo,9999,0,9999,0
1746552707014,CSE 191,A00,958773,Minnes Kemp; Mor Mia,9995,0,9999,4
1746552708042,CSE 197,001,959846,Minnes Kemp; Mor Mia,9990,0,9999,9
1746552709066,CSS 201S,A01,892054,Mignozzetti; Umberto,26,0,30,4
1746552710091,CSS 202S,A01,892056,Mignozzetti; Umberto,26,0,30,4
1746552711117,DSC 197,001,956898,Eldridge; Justin Matthew,9997,0,9999,2
1746552712144,DSC 297,001,958000,Mazumdar; Arya,9998,0,9999,1
1746552712144,DSC 297,002,959862,Wang; Yusu,9998,0,9999,1
1746552713169,EAP 100,A00,905686,Staff,9778,0,9999,221
1746552714195,ECE 45,A01,892618,Staff,0,0,65,65
1746552716246,ECE 111,A01,892719,Staff,4,0,65,61
1746552717271,ECE 197,001,957920,Mercier; Patrick Philip,9991,0,9999,8
1746552718295,ECON 178,A01,907814,Zhu; Ying,26,0,35,9
1746552719322,EDS 115,A00,895312,Staff,35,0,45,10
1746552720347,EDS 117,A01,895337,Staff,23,0,30,7
1746552721375,EDS 125,A00,895341,Jones; Gabrielle Anastasia,36,0,45,9
1746552722401,EDS 128A,A01,895459,Fargason; Sharon Gayle,44,0,45,1
1746552723428,EDS 128B,A01,895543,Pappas; Elizabeth,44,0,45,1
1746552724466,EDS 139,A00,897203,Pappas; Elizabeth,44,0,45,1
1746552724466,EDS 139,B00,897209,Fargason; Sharon Gayle,41,0,45,4
1746552725493,EDS 201,A00,895545,Staff,22,0,45,23
1746552726524,EDS 203,A01,895581,Halter; Christopher P.,22,0,45,23
1746552727550,EDS 204R,A01,895625,Heinzman; Erica M.,39,0,45,6
1746552727550,EDS 204R,B01,895693,Halter; Christopher P.,10,0,45,35
1746552728577,EDS 206R,A00,895694,Fargason; Sharon Gayle,1,0,30,29
1746552728577,EDS 206R,B00,895695,Choi; Bailey Miyeon,16,0,30,14
1746552729605,EDS 250,A00,895697,Hemans; Patricia Ann Benitez,22,0,45,23
1746552730630,EDS 281,A00,895701,Meyerott; Theresa Ann,1,0,15,14
1746552731655,EDS 284,A00,895736,Meyerott; Theresa Ann,1,0,15,14
1746552732681,EDS 286,A00,897210,Fine; Sarah,0,0,15,15
1746552733711,EDS 289C,A01,895770,Daly; Alan J.,15,0,15,0
1746552734738,EDS 290,A00,897211,Hofstetter; Carolyn,0,0,15,15
1746552735762,LIGM 5A,A00,896162,Fischer-Grunski; Eva K,13,0,20,7
1746552736787,LIGM 5B,A00,896260,Fischer-Grunski; Eva K,17,0,20,3
1746552737814,LIGM 5C,A00,896308,Fischer-Grunski; Eva K,18,0,20,2
1746552738838,LIIT 5AS,A00,896313,Carnelos; Chiara,18,0,20,2
1746552739864,LIIT 5BS,A00,896416,Carnelos; Chiara,20,0,20,0
1746552740889,LIIT 5CS,A00,896564,Carnelos; Chiara,20,0,20,0
1746552741914,LISP 5A,A00,896588,Munoz Sanchez; Alicia,3,0,20,17
1746552742940,LISP 5B,A00,896653,Munoz Sanchez; Alicia,7,0,20,13
1746552743969,LISP 5C,A00,896655,Munoz Sanchez; Alicia,0,1,20,20
1746552744995,MAE 197,001,957918,Kleissl; Jan,9996,0,9999,3
1746552744995,MAE 197,002,959806,Boechler; Nicholas Sebastia,9998,0,9999,1
1746552744995,MAE 197,003,959852,Mullin; Jennifer S,9998,0,9999,1
1746552746024,MATH 2,A01,957937,Staff,33,0,35,2
1746552747051,MATH 197,001,957876,Kedlaya; Kiran S.,9993,0,9999,6
1746552748079,MCWP 40,A00,892729,Duru; Nur,10,0,20,10
1746552748079,MCWP 40,B00,893304,Montejo; Carolina,14,0,20,6
1746552749104,MCWP 40R,A00,893757,Redela; Pamela Morgan,0,5,20,20
1746552750132,MCWP 50,A00,893758,Morshed; Michael James,0,0,20,20
1746552750132,MCWP 50,B00,893761,Bartulis; Jason Michael,17,0,20,3
1746552751163,MCWP 50R,A00,893766,Compas; Sean Matthew,0,1,20,20
1746552751163,MCWP 50R,B00,893769,Carter; Jennifer A,0,1,20,20
1746552751163,MCWP 50R,C00,893771,Krone; Jarret,0,3,20,20
1746552751163,MCWP 50R,D00,893772,Miller; Elizabeth Deen,0,0,20,20
1746552751163,MCWP 50R,E00,893775,Carter; Andrea L,0,1,20,20
1746552752187,MMW 11R,A01,892721,Herbst; Matthew,11,0,27,16
1746552752187,MMW 11R,A02,892722,Herbst; Matthew,0,0,0,3
1746552753213,MMW 12R,A01,892724,Herbst; Matthew,0,11,16,16
1746552753213,MMW 12R,A02,892725,Herbst; Matthew,0,10,16,16
1746552754242,MMW 13R,A01,892727,Staff,0,4,16,16
1746552754242,MMW 13R,A02,892728,Staff,0,4,16,16
1746552754242,MMW 13R,A03,958032,Staff,0,4,16,16
1746552754242,MMW 13R,A04,958033,Staff,0,4,16,16
1746552754242,MMW 13R,A05,958034,Staff,0,4,16,16
1746552755266,SIO 295LS,A00,894015,Staff,5,0,25,20
1746552756291,SIO 295S,A00,894020,Staff,5,0,25,20
1746552757320,SIOC 290S,B01,958918,Merrifield; Mark A,14,0,30,16
1746552758347,SIOC 291S,B01,958922,Gabriel; Corey John,14,0,30,16
1746552759371,SOCI 117,A01,895339,Staff,3,0,5,2
1746552760396,WES 237B,A00,894149,Staff,11,0,20,9
1746552762464,AESE 279B,A00,891859,Staff,13,0,35,22
1746552763490,AIP 197,001,891854,Vespa; Emanuel Ignacio,9999,0,9999,0
1746552764517,ANTH 289S,A00,891856,Gagneux; Pascal,12,0,12,0
1746552765545,BENG 196,001,957946,Engler; Adam J.,9996,0,9999,3
1746552766571,BISP 197,001,959851,Wilhelm; James E.,9998,0,9999,1
1746552767600,CAT 124RS,A01,956906,Staff,6,0,25,19
1746552768623,CAT 125RS,A01,922013,Staff,6,0,25,19
1746552769648,CLRE 250,A00,891860,Morris; Sheldon,9995,0,9999,4
1746552771697,CLRE 251R,A00,907817,Mehta; Ravindra L.,9994,0,9999,5
1746552772721,CLRE 252,A00,891864,Cuomo; Raphael Eduardo,9993,0,9999,6
1746552773748,CLRE 253,A00,891867,Vaida; Florin,9994,0,9999,5
1746552773748,CLRE 253,B00,907819,Staff,9999,0,9999,0
1746552774776,CLRE 259,A00,891868,Patel; Hemal,9998,0,9999,1
1746552775799,CLRE 260,A00,891872,Cuomo; Raphael Eduardo,9999,0,9999,0
1746552776826,CLRE 297,001,891888,Cuomo; Raphael Eduardo,9999,0,9999,0
1746552777850,CSE 191,A00,958773,Minnes Kemp; Mor Mia,9995,0,9999,4
1746552778897,CSE 197,001,959846,Minnes Kemp; Mor Mia,9990,0,9999,9
1746552779923,CSS 201S,A01,892054,Mignozzetti; Umberto,26,0,30,4
1746552780951,CSS 202S,A01,892056,Mignozzetti; Umberto,26,0,30,4
1746552781973,DSC 197,001,956898,Eldridge; Justin Matthew,9997,0,9999,2
1746552782997,DSC 297,001,958000,Mazumdar; Arya,9998,0,9999,1
1746552782997,DSC 297,002,959862,Wang; Yusu,9998,0,9999,1
1746552784022,EAP 100,A00,905686,Staff,9778,0,9999,221
1746552785052,ECE 45,A01,892618,Staff,0,0,65,65
1746552787100,ECE 111,A01,892719,Staff,4,0,65,61
1746552788125,ECE 197,001,957920,Mercier; Patrick Philip,9991,0,9999,8
1746552789152,ECON 178,A01,907814,Zhu; Ying,26,0,35,9
1746552790187,EDS 115,A00,895312,Staff,35,0,45,10
1746552791212,EDS 117,A01,895337,Staff,23,0,30,7
1746552792239,EDS 125,A00,895341,Jones; Gabrielle Anastasia,36,0,45,9
1746552793262,EDS 128A,A01,895459,Fargason; Sharon Gayle,44,0,45,1
1746552794284,EDS 128B,A01,895543,Pappas; Elizabeth,44,0,45,1
1746552795308,EDS 139,A00,897203,Pappas; Elizabeth,44,0,45,1
1746552795308,EDS 139,B00,897209,Fargason; Sharon Gayle,41,0,45,4
1746552796330,EDS 201,A00,895545,Staff,22,0,45,23
1746552797358,EDS 203,A01,895581,Halter; Christopher P.,22,0,45,23
1746552798386,EDS 204R,A01,895625,Heinzman; Erica M.,39,0,45,6
1746552798386,EDS 204R,B01,895693,Halter; Christopher P.,10,0,45,35
1746552799411,EDS 206R,A00,895694,Fargason; Sharon Gayle,1,0,30,29
1746552799411,EDS 206R,B00,895695,Choi; Bailey Miyeon,16,0,30,14
1746552800435,EDS 250,A00,895697,Hemans; Patricia Ann Benitez,22,0,45,23
1746552801462,EDS 281,A00,895701,Meyerott; Theresa Ann,1,0,15,14
1746552802486,EDS 284,A00,895736,Meyerott; Theresa Ann,1,0,15,14
1746552803515,EDS 286,A00,897210,Fine; Sarah,0,0,15,15
1746552804540,EDS 289C,A01,895770,Daly; Alan J.,15,0,15,0
1746552805576,EDS 290,A00,897211,Hofstetter; Carolyn,0,0,15,15
1746552806603,LIGM 5A,A00,896162,Fischer-Grunski; Eva K,13,0,20,7
1746552807627,LIGM 5B,A00,896260,Fischer-Grunski; Eva K,17,0,20,3
1746552808652,LIGM 5C,A00,896308,Fischer-Grunski; Eva K,18,0,20,2
1746552809674,LIIT 5AS,A00,896313,Carnelos; Chiara,18,0,20,2
1746552810704,LIIT 5BS,A00,896416,Carnelos; Chiara,20,0,20,0
1746552811732,LIIT 5CS,A00,896564,Carnelos; Chiara,20,0,20,0
1746552812758,LISP 5A,A00,896588,Munoz Sanchez; Alicia,3,0,20,17
1746552813786,LISP 5B,A00,896653,Munoz Sanchez; Alicia,7,0,20,13
1746552814812,LISP 5C,A00,896655,Munoz Sanchez; Alicia,0,1,20,20
1746552815839,MAE 197,001,957918,Kleissl; Jan,9996,0,9999,3
1746552815839,MAE 197,002,959806,Boechler; Nicholas Sebastia,9998,0,9999,1
1746552815839,MAE 197,003,959852,Mullin; Jennifer S,9998,0,9999,1
1746552816863,MATH 2,A01,957937,Staff,33,0,35,2
1746552817886,MATH 197,001,957876,Kedlaya; Kiran S.,9993,0,9999,6
1746552818911,MCWP 40,A00,892729,Duru; Nur,10,0,20,10
1746552818911,MCWP 40,B00,893304,Montejo; Carolina,14,0,20,6
1746552819935,MCWP 40R,A00,893757,Redela; Pamela Morgan,0,5,20,20
1746552820959,MCWP 50,A00,893758,Morshed; Michael James,0,0,20,20
1746552820959,MCWP 50,B00,893761,Bartulis; Jason Michael,17,0,20,3
1746552821989,MCWP 50R,A00,893766,Compas; Sean Matthew,0,1,20,20
1746552821989,MCWP 50R,B00,893769,Carter; Jennifer A,0,1,20,20
1746552821989,MCWP 50R,C00,893771,Krone; Jarret,0,3,20,20
1746552821989,MCWP 50R,D00,893772,Miller; Elizabeth Deen,0,0,20,20
1746552821989,MCWP 50R,E00,893775,Carter; Andrea L,0,1,20,20
1746552823014,MMW 11R,A01,892721,Herbst; Matthew,11,0,27,16
1746552823014,MMW 11R,A02,892722,Herbst; Matthew,0,0,0,3
1746552824041,MMW 12R,A01,892724,Herbst; Matthew,0,11,16,16
1746552824041,MMW 12R,A02,892725,Herbst; Matthew,0,10,16,16
1746552825066,MMW 13R,A01,892727,Staff,0,4,16,16
1746552825066,MMW 13R,A02,892728,Staff,0,4,16,16
1746552825066,MMW 13R,A03,958032,Staff,0,4,16,16
1746552825066,MMW 13R,A04,958033,Staff,0,4,16,16
1746552825066,MMW 13R,A05,958034,Staff,0,4,16,16
1746552826093,SIO 295LS,A00,894015,Staff,5,0,25,20
1746552827122,SIO 295S,A00,894020,Staff,5,0,25,20
1746552828151,SIOC 290S,B01,958918,Merrifield; Mark A,14,0,30,16
1746552829177,SIOC 291S,B01,958922,Gabriel; Corey John,14,0,30,16
1746552830205,SOCI 117,A01,895339,Staff,3,0,5,2
1746552831231,WES 237B,A00,894149,Staff,11,0,20,9
1746552833297,AESE 279B,A00,891859,Staff,13,0,35,22
1746552834321,AIP 197,001,891854,Vespa; Emanuel Ignacio,9999,0,9999,0
1746552835345,ANTH 289S,A00,891856,Gagneux; Pascal,12,0,12,0
1746552836370,BENG 196,001,957946,Engler; Adam J.,9996,0,9999,3
1746552837393,BISP 197,001,959851,Wilhelm; James E.,9998,0,9999,1
1746552838419,CAT 124RS,A01,956906,Staff,6,0,25,19
1746552839442,CAT 125RS,A01,922013,Staff,6,0,25,19
1746552840468,CLRE 250,A00,891860,Morris; Sheldon,9995,0,9999,4
1746552842518,CLRE 251R,A00,907817,Mehta; Ravindra L.,9994,0,9999,5
1746552843545,CLRE 252,A00,891864,Cuomo; Raphael Eduardo,9993,0,9999,6
1746552844575,CLRE 253,A00,891867,Vaida; Florin,9994,0,9999,5
1746552844575,CLRE 253,B00,907819,Staff,9999,0,9999,0
1746552845604,CLRE 259,A00,891868,Patel; Hemal,9998,0,9999,1
1746552846633,CLRE 260,A00,891872,Cuomo; Raphael Eduardo,9999,0,9999,0
1746552847660,CLRE 297,001,891888,Cuomo; Raphael Eduardo,9999,0,9999,0
1746552848688,CSE 191,A00,958773,Minnes Kemp; Mor Mia,9995,0,9999,4
1746552849714,CSE 197,001,959846,Minnes Kemp; Mor Mia,9990,0,9999,9
1746552850740,CSS 201S,A01,892054,Mignozzetti; Umberto,26,0,30,4
1746552851771,CSS 202S,A01,892056,Mignozzetti; Umberto,26,0,30,4
1746552852797,DSC 197,001,956898,Eldridge; Justin Matthew,9997,0,9999,2
1746552853820,DSC 297,001,958000,Mazumdar; Arya,9998,0,9999,1
1746552853820,DSC 297,002,959862,Wang; Yusu,9998,0,9999,1
1746552854850,EAP 100,A00,905686,Staff,9778,0,9999,221
1746552855880,ECE 45,A01,892618,Staff,0,0,65,65
1746552857932,ECE 111,A01,892719,Staff,4,0,65,61
1746552858968,ECE 197,001,957920,Mercier; Patrick Philip,9991,0,9999,8
1746552859997,ECON 178,A01,907814,Zhu; Ying,26,0,35,9
1746552861021,EDS 115,A00,895312,Staff,35,0,45,10
1746552862047,EDS 117,A01,895337,Staff,23,0,30,7
1746552863070,EDS 125,A00,895341,Jones; Gabrielle Anastasia,36,0,45,9
1746552864093,EDS 128A,A01,895459,Fargason; Sharon Gayle,44,0,45,1
1746552865119,EDS 128B,A01,895543,Pappas; Elizabeth,44,0,45,1
1746552866141,EDS 139,A00,897203,Pappas; Elizabeth,44,0,45,1
1746552866141,EDS 139,B00,897209,Fargason; Sharon Gayle,41,0,45,4
1746552867165,EDS 201,A00,895545,Staff,22,0,45,23
1746552868190,EDS 203,A01,895581,Halter; Christopher P.,22,0,45,23
1746552869220,EDS 204R,A01,895625,Heinzman; Erica M.,39,0,45,6
1746552869220,EDS 204R,B01,895693,Halter; Christopher P.,10,0,45,35
1746552870249,EDS 206R,A00,895694,Fargason; Sharon Gayle,1,0,30,29
1746552870249,EDS 206R,B00,895695,Choi; Bailey Miyeon,16,0,30,14
1746552871278,EDS 250,A00,895697,Hemans; Patricia Ann Benitez,22,0,45,23
1746552872304,EDS 281,A00,895701,Meyerott; Theresa Ann,1,0,15,14
1746552873328,EDS 284,A00,895736,Meyerott; Theresa Ann,1,0,15,14
1746552874355,EDS 286,A00,897210,Fine; Sarah,0,0,15,15
1746552875384,EDS 289C,A01,895770,Daly; Alan J.,15,0,15,0
1746552876412,EDS 290,A00,897211,Hofstetter; Carolyn,0,0,15,15
1746552877436,LIGM 5A,A00,896162,Fischer-Grunski; Eva K,13,0,20,7
1746552878462,LIGM 5B,A00,896260,Fischer-Grunski; Eva K,17,0,20,3
1746552879488,LIGM 5C,A00,896308,Fischer-Grunski; Eva K,18,0,20,2
1746552880513,LIIT 5AS,A00,896313,Carnelos; Chiara,18,0,20,2
1746552881542,LIIT 5BS,A00,896416,Carnelos; Chiara,20,0,20,0
1746552882570,LIIT 5CS,A00,896564,Carnelos; Chiara,20,0,20,0
1746552883596,LISP 5A,A00,896588,Munoz Sanchez; Alicia,3,0,20,17
1746552884623,LISP 5B,A00,896653,Munoz Sanchez; Alicia,7,0,20,13
1746552885647,LISP 5C,A00,896655,Munoz Sanchez; Alicia,0,1,20,20
1746552886672,MAE 197,001,957918,Kleissl; Jan,9996,0,9999,3
1746552886672,MAE 197,002,959806,Boechler; Nicholas Sebastia,9998,0,9999,1
1746552886672,MAE 197,003,959852,Mullin; Jennifer S,9998,0,9999,1
1746552887698,MATH 2,A01,957937,Staff,33,0,35,2
1746552888723,MATH 197,001,957876,Kedlaya; Kiran S.,9993,0,9999,6
1746552889749,MCWP 40,A00,892729,Duru; Nur,10,0,20,10
1746552889749,MCWP 40,B00,893304,Montejo; Carolina,14,0,20,6
1746552890774,MCWP 40R,A00,893757,Redela; Pamela Morgan,0,5,20,20
1746552891802,MCWP 50,A00,893758,Morshed; Michael James,0,0,20,20
1746552891802,MCWP 50,B00,893761,Bartulis; Jason Michael,17,0,20,3
1746552892827,MCWP 50R,A00,893766,Compas; Sean Matthew,0,1,20,20
1746552892827,MCWP 50R,B00,893769,Carter; Jennifer A,0,1,20,20
1746552892827,MCWP 50R,C00,893771,Krone; Jarret,0,3,20,20
1746552892827,MCWP 50R,D00,893772,Miller; Elizabeth Deen,0,0,20,20
1746552892827,MCWP 50R,E00,893775,Carter; Andrea L,0,1,20,20
1746552893856,MMW 11R,A01,892721,Herbst; Matthew,11,0,27,16
1746552893856,MMW 11R,A02,892722,Herbst; Matthew,0,0,0,3
1746552894883,MMW 12R,A01,892724,Herbst; Matthew,0,11,16,16
1746552894883,MMW 12R,A02,892725,Herbst; Matthew,0,10,16,16
1746552895908,MMW 13R,A01,892727,Staff,0,4,16,16
1746552895908,MMW 13R,A02,892728,Staff,0,4,16,16
1746552895908,MMW 13R,A03,958032,Staff,0,4,16,16
1746552895908,MMW 13R,A04,958033,Staff,0,4,16,16
1746552895908,MMW 13R,A05,958034,Staff,0,4,16,16
1746552896936,SIO 295LS,A00,894015,Staff,5,0,25,20
1746552897963,SIO 295S,A00,894020,Staff,5,0,25,20
1746552898992,SIOC 290S,B01,958918,Merrifield; Mark A,14,0,30,16
1746552900019,SIOC 291S,B01,958922,Gabriel; Corey John,14,0,30,16
1746552901049,SOCI 117,A01,895339,Staff,3,0,5,2
1746552902083,WES 237B,A00,894149,Staff,11,0,20,9
1746552904148,AESE 279B,A00,891859,Staff,13,0,35,22
1746552905174,AIP 197,001,891854,Vespa; Emanuel Ignacio,9999,0,9999,0
1746552906200,ANTH 289S,A00,891856,Gagneux; Pascal,12,0,12,0
1746552907226,BENG 196,001,957946,Engler; Adam J.,9996,0,9999,3
1746552908250,BISP 197,001,959851,Wilhelm; James E.,9998,0,9999,1
1746552909276,CAT 124RS,A01,956906,Staff,6,0,25,19
1746552910300,CAT 125RS,A01,922013,Staff,6,0,25,19
1746552911326,CLRE 250,A00,891860,Morris; Sheldon,9995,0,9999,4
1746552913379,CLRE 251R,A00,907817,Mehta; Ravindra L.,9994,0,9999,5
1746552914404,CLRE 252,A00,891864,Cuomo; Raphael Eduardo,9993,0,9999,6
1746552915429,CLRE 253,A00,891867,Vaida; Florin,9994,0,9999,5
1746552915429,CLRE 253,B00,907819,Staff,9999,0,9999,0
1746552916457,CLRE 259,A00,891868,Patel; Hemal,9998,0,9999,1
1746552917484,CLRE 260,A00,891872,Cuomo; Raphael Eduardo,9999,0,9999,0
1746552918509,CLRE 297,001,891888,Cuomo; Raphael Eduardo,9999,0,9999,0
1746552919534,CSE 191,A00,958773,Minnes Kemp; Mor Mia,9995,0,9999,4
1746552920562,CSE 197,001,959846,Minnes Kemp; Mor Mia,9990,0,9999,9
1746552921586,CSS 201S,A01,892054,Mignozzetti; Umberto,26,0,30,4
1746552922615,CSS 202S,A01,892056,Mignozzetti; Umberto,26,0,30,4
1746552923641,DSC 197,001,956898,Eldridge; Justin Matthew,9997,0,9999,2
1746552924666,DSC 297,001,958000,Mazumdar; Arya,9998,0,9999,1
1746552924666,DSC 297,002,959862,Wang; Yusu,9998,0,9999,1
1746552925690,EAP 100,A00,905686,Staff,9778,0,9999,221
1746552926717,ECE 45,A01,892618,Staff,0,0,65,65
1746552928769,ECE 111,A01,892719,Staff,4,0,65,61
1746552929797,ECE 197,001,957920,Mercier; Patrick Philip,9991,0,9999,8
1746552930823,ECON 178,A01,907814,Zhu; Ying,26,0,35,9
1746552931846,EDS 115,A00,895312,Staff,35,0,45,10
1746552932874,EDS 117,A01,895337,Staff,23,0,30,7
1746552933899,EDS 125,A00,895341,Jones; Gabrielle Anastasia,36,0,45,9
1746552934929,EDS 128A,A01,895459,Fargason; Sharon Gayle,44,0,45,1
1746552935957,EDS 128B,A01,895543,Pappas; Elizabeth,44,0,45,1
1746552936981,EDS 139,A00,897203,Pappas; Elizabeth,44,0,45,1
1746552936981,EDS 139,B00,897209,Fargason; Sharon Gayle,41,0,45,4
1746552938009,EDS 201,A00,895545,Staff,22,0,45,23
1746552939036,EDS 203,A01,895581,Halter; Christopher P.,22,0,45,23
1746552940066,EDS 204R,A01,895625,Heinzman; Erica M.,39,0,45,6
1746552940066,EDS 204R,B01,895693,Halter; Christopher P.,10,0,45,35
1746552941089,EDS 206R,A00,895694,Fargason; Sharon Gayle,1,0,30,29
1746552941089,EDS 206R,B00,895695,Choi; Bailey Miyeon,16,0,30,14
1746552942116,EDS 250,A00,895697,Hemans; Patricia Ann Benitez,22,0,45,23
1746552943140,EDS 281,A00,895701,Meyerott; Theresa Ann,1,0,15,14
1746552944166,EDS 284,A00,895736,Meyerott; Theresa Ann,1,0,15,14
1746552945195,EDS 286,A00,897210,Fine; Sarah,0,0,15,15
1746552946220,EDS 289C,A01,895770,Daly; Alan J.,15,0,15,0
1746552947248,EDS 290,A00,897211,Hofstetter; Carolyn,0,0,15,15
1746552948274,LIGM 5A,A00,896162,Fischer-Grunski; Eva K,13,0,20,7
1746552949300,LIGM 5B,A00,896260,Fischer-Grunski; Eva K,17,0,20,3
1746552950324,LIGM 5C,A00,896308,Fischer-Grunski; Eva K,18,0,20,2
1746552951355,LIIT 5AS,A00,896313,Carnelos; Chiara,18,0,20,2
1746552952384,LIIT 5BS,A00,896416,Carnelos; Chiara,20,0,20,0
1746552953411,LIIT 5CS,A00,896564,Carnelos; Chiara,20,0,20,0
1746552954437,LISP 5A,A00,896588,Munoz Sanchez; Alicia,3,0,20,17
1746552955461,LISP 5B,A00,896653,Munoz Sanchez; Alicia,7,0,20,13
1746552956487,LISP 5C,A00,896655,Munoz Sanchez; Alicia,0,1,20,20
1746552957510,MAE 197,001,957918,Kleissl; Jan,9996,0,9999,3
1746552957510,MAE 197,002,959806,Boechler; Nicholas Sebastia,9998,0,9999,1
1746552957510,MAE 197,003,959852,Mullin; Jennifer S,9998,0,9999,1
1746552958538,MATH 2,A01,957937,Staff,33,0,35,2
1746552959565,MATH 197,001,957876,Kedlaya; Kiran S.,9993,0,9999,6
1746552960593,MCWP 40,A00,892729,Duru; Nur,10,0,20,10
1746552960593,MCWP 40,B00,893304,Montejo; Carolina,14,0,20,6
1746552961621,MCWP 40R,A00,893757,Redela; Pamela Morgan,0,5,20,20
1746552962646,MCWP 50,A00,893758,Morshed; Michael James,0,0,20,20
1746552962646,MCWP 50,B00,893761,Bartulis; Jason Michael,17,0,20,3
1746552963675,MCWP 50R,A00,893766,Compas; Sean Matthew,0,1,20,20
1746552963675,MCWP 50R,B00,893769,Carter; Jennifer A,0,1,20,20
1746552963675,MCWP 50R,C00,893771,Krone; Jarret,0,3,20,20
1746552963675,MCWP 50R,D00,893772,Miller; Elizabeth Deen,0,0,20,20
1746552963675,MCWP 50R,E00,893775,Carter; Andrea L,0,1,20,20
1746552964703,MMW 11R,A01,892721,Herbst; Matthew,11,0,27,16
1746552964703,MMW 11R,A02,892722,Herbst; Matthew,0,0,0,3
1746552965727,MMW 12R,A01,892724,Herbst; Matthew,0,11,16,16
1746552965727,MMW 12R,A02,892725,Herbst; Matthew,0,10,16,16
1746552966755,MMW 13R,A01,892727,Staff,0,4,16,16
1746552966755,MMW 13R,A02,892728,Staff,0,4,16,16
1746552966755,MMW 13R,A03,958032,Staff,0,4,16,16
1746552966755,MMW 13R,A04,958033,Staff,0,4,16,16
1746552966755,MMW 13R,A05,958034,Staff,0,4,16,16
1746552967780,SIO 295LS,A00,894015,Staff,5,0,25,20
1746552968806,SIO 295S,A00,894020,Staff,5,0,25,20
1746552969835,SIOC 290S,B01,958918,Merrifield; Mark A,14,0,30,16
1746552970862,SIOC 291S,B01,958922,Gabriel; Corey John,14,0,30,16
1746552971886,SOCI 117,A01,895339,Staff,3,0,5,2
1746552972913,WES 237B,A00,894149,Staff,11,0,20,9
1746552974977,AESE 279B,A00,891859,Staff,13,0,35,22
1746552976024,AIP 197,001,891854,Vespa; Emanuel Ignacio,9999,0,9999,0
1746552977047,ANTH 289S,A00,891856,Gagneux; Pascal,12,0,12,0
1746552978072,BENG 196,001,957946,Engler; Adam J.,9996,0,9999,3
1746552979097,BISP 197,001,959851,Wilhelm; James E.,9998,0,9999,1
1746552980125,CAT 124RS,A01,956906,Staff,6,0,25,19
1746552981150,CAT 125RS,A01,922013,Staff,6,0,25,19
1746552982177,CLRE 250,A00,891860,Morris; Sheldon,9995,0,9999,4
1746552984227,CLRE 251R,A00,907817,Mehta; Ravindra L.,9994,0,9999,5
1746552985251,CLRE 252,A00,891864,Cuomo; Raphael Eduardo,9993,0,9999,6
1746552986275,CLRE 253,A00,891867,Vaida; Florin,9994,0,9999,5
1746552986275,CLRE 253,B00,907819,Staff,9999,0,9999,0
1746552987298,CLRE 259,A00,891868,Patel; Hemal,9998,0,9999,1
1746552988325,CLRE 260,A00,891872,Cuomo; Raphael Eduardo,9999,0,9999,0
1746552989348,CLRE 297,001,891888,Cuomo; Raphael Eduardo,9999,0,9999,0
1746552990376,CSE 191,A00,958773,Minnes Kemp; Mor Mia,9995,0,9999,4
1746552991402,CSE 197,001,959846,Minnes Kemp; Mor Mia,9990,0,9999,9
1746552992426,CSS 201S,A01,892054,Mignozzetti; Umberto,26,0,30,4
1746552993455,CSS 202S,A01,892056,Mignozzetti; Umberto,26,0,30,4
1746552994477,DSC 197,001,956898,Eldridge; Justin Matthew,9997,0,9999,2
1746552995500,DSC 297,001,958000,Mazumdar; Arya,9998,0,9999,1
1746552995500,DSC 297,002,959862,Wang; Yusu,9998,0,9999,1
1746552996527,EAP 100,A00,905686,Staff,9778,0,9999,221
1746552997556,ECE 45,A01,892618,Staff,0,0,65,65
1746552999608,ECE 111,A01,892719,Staff,4,0,65,61
1746553000636,ECE 197,001,957920,Mercier; Patrick Philip,9991,0,9999,8
1746553001662,ECON 178,A01,907814,Zhu; Ying,26,0,35,9
1746553002690,EDS 115,A00,895312,Staff,35,0,45,10
1746553003718,EDS 117,A01,895337,Staff,23,0,30,7
1746553004745,EDS 125,A00,895341,Jones; Gabrielle Anastasia,36,0,45,9
1746553005773,EDS 128A,A01,895459,Fargason; Sharon Gayle,44,0,45,1
1746553006802,EDS 128B,A01,895543,Pappas; Elizabeth,44,0,45,1
1746553007831,EDS 139,A00,897203,Pappas; Elizabeth,44,0,45,1
1746553007831,EDS 139,B00,897209,Fargason; Sharon Gayle,41,0,45,4
1746553008858,EDS 201,A00,895545,Staff,22,0,45,23
1746553009885,EDS 203,A01,895581,Halter; Christopher P.,22,0,45,23
1746553010914,EDS 204R,A01,895625,Heinzman; Erica M.,39,0,45,6
1746553010914,EDS 204R,B01,895693,Halter; Christopher P.,10,0,45,35
1746553011942,EDS 206R,A00,895694,Fargason; Sharon Gayle,1,0,30,29
1746553011942,EDS 206R,B00,895695,Choi; Bailey Miyeon,16,0,30,14
1746553012971,EDS 250,A00,895697,Hemans; Patricia Ann Benitez,22,0,45,23
1746553013994,EDS 281,A00,895701,Meyerott; Theresa Ann,1,0,15,14
1746553015020,EDS 284,A00,895736,Meyerott; Theresa Ann,1,0,15,14
1746553016048,EDS 286,A00,897210,Fine; Sarah,0,0,15,15
1746553017074,EDS 289C,A01,895770,Daly; Alan J.,15,0,15,0
1746553018100,EDS 290,A00,897211,Hofstetter; Carolyn,0,0,15,15
1746553019131,LIGM 5A,A00,896162,Fischer-Grunski; Eva K,13,0,20,7
1746553020160,LIGM 5B,A00,896260,Fischer-Grunski; Eva K,17,0,20,3
1746553021186,LIGM 5C,A00,896308,Fischer-Grunski; Eva K,18,0,20,2
1746553022215,LIIT 5AS,A00,896313,Carnelos; Chiara,18,0,20,2
1746553023240,LIIT 5BS,A00,896416,Carnelos; Chiara,20,0,20,0
1746553024269,LIIT 5CS,A00,896564,Carnelos; Chiara,20,0,20,0
1746553025292,LISP 5A,A00,896588,Munoz Sanchez; Alicia,3,0,20,17
1746553026318,LISP 5B,A00,896653,Munoz Sanchez; Alicia,7,0,20,13
1746553027345,LISP 5C,A00,896655,Munoz Sanchez; Alicia,0,1,20,20
1746553028372,MAE 197,001,957918,Kleissl; Jan,9996,0,9999,3
1746553028372,MAE 197,002,959806,Boechler; Nicholas Sebastia,9998,0,9999,1
1746553028372,MAE 197,003,959852,Mullin; Jennifer S,9998,0,9999,1
1746553029397,MATH 2,A01,957937,Staff,33,0,35,2
1746553030423,MATH 197,001,957876,Kedlaya; Kiran S.,9993,0,9999,6
1746553031449,MCWP 40,A00,892729,Duru; Nur,10,0,20,10
1746553031449,MCWP 40,B00,893304,Montejo; Carolina,14,0,20,6
1746553032476,MCWP 40R,A00,893757,Redela; Pamela Morgan,0,5,20,20
1746553033501,MCWP 50,A00,893758,Morshed; Michael James,0,0,20,20
1746553033501,MCWP 50,B00,893761,Bartulis; Jason Michael,17,0,20,3
1746553034528,MCWP 50R,A00,893766,Compas; Sean Matthew,0,1,20,20
1746553034528,MCWP 50R,B00,893769,Carter; Jennifer A,0,1,20,20
1746553034528,MCWP 50R,C00,893771,Krone; Jarret,0,3,20,20
1746553034528,MCWP 50R,D00,893772,Miller; Elizabeth Deen,0,0,20,20
1746553034528,MCWP 50R,E00,893775,Carter; Andrea L,0,1,20,20
1746553035556,MMW 11R,A01,892721,Herbst; Matthew,11,0,27,16
1746553035556,MMW 11R,A02,892722,Herbst; Matthew,0,0,0,3
1746553036580,MMW 12R,A01,892724,Herbst; Matthew,0,11,16,16
1746553036580,MMW 12R,A02,892725,Herbst; Matthew,0,10,16,16
1746553037606,MMW 13R,A01,892727,Staff,0,4,16,16
1746553037606,MMW 13R,A02,892728,Staff,0,4,16,16
1746553037606,MMW 13R,A03,958032,Staff,0,4,16,16
1746553037606,MMW 13R,A04,958033,Staff,0,4,16,16
1746553037606,MMW 13R,A05,958034,Staff,0,4,16,16
1746553038635,SIO 295LS,A00,894015,Staff,5,0,25,20
1746553039664,SIO 295S,A00,894020,Staff,5,0,25,20
1746553040689,SIOC 290S,B01,958918,Merrifield; Mark A,14,0,30,16
1746553041719,SIOC 291S,B01,958922,Gabriel; Corey John,14,0,30,16
1746553042745,SOCI 117,A01,895339,Staff,3,0,5,2
1746553043772,WES 237B,A00,894149,Staff,11,0,20,9
1746553045837,AESE 279B,A00,891859,Staff,13,0,35,22
1746553046864,AIP 197,001,891854,Vespa; Emanuel Ignacio,9999,0,9999,0
1746553047890,ANTH 289S,A00,891856,Gagneux; Pascal,12,0,12,0
1746553048917,BENG 196,001,957946,Engler; Adam J.,9996,0,9999,3
1746553049940,BISP 197,001,959851,Wilhelm; James E.,9998,0,9999,1
1746553050964,CAT 124RS,A01,956906,Staff,6,0,25,19
1746553051989,CAT 125RS,A01,922013,Staff,6,0,25,19
1746553053015,CLRE 250,A00,891860,Morris; Sheldon,9995,0,9999,4
1746553055063,CLRE 251R,A00,907817,Mehta; Ravindra L.,9994,0,9999,5
1746553056088,CLRE 252,A00,891864,Cuomo; Raphael Eduardo,9993,0,9999,6
1746553057116,CLRE 253,A00,891867,Vaida; Florin,9994,0,9999,5
1746553057116,CLRE 253,B00,907819,Staff,9999,0,9999,0
1746553058139,CLRE 259,A00,891868,Patel; Hemal,9998,0,9999,1
1746553059163,CLRE 260,A00,891872,Cuomo; Raphael Eduardo,9999,0,9999,0
1746553060191,CLRE 297,001,891888,Cuomo; Raphael Eduardo,9999,0,9999,0
1746553061216,CSE 191,A00,958773,Minnes Kemp; Mor Mia,9995,0,9999,4
1746553062241,CSE 197,001,959846,Minnes Kemp; Mor Mia,9990,0,9999,9
1746553063265,CSS 201S,A01,892054,Mignozzetti; Umberto,26,0,30,4
1746553064291,CSS 202S,A01,892056,Mignozzetti; Umberto,26,0,30,4
1746553065317,DSC 197,001,956898,Eldridge; Justin Matthew,9997,0,9999,2
1746553066363,DSC 297,001,958000,Mazumdar; Arya,9998,0,9999,1
1746553066363,DSC 297,002,959862,Wang; Yusu,9998,0,9999,1
1746553067388,EAP 100,A00,905686,Staff,9778,0,9999,221
1746553068415,ECE 45,A01,892618,Staff,0,0,65,65
1746553070469,ECE 111,A01,892719,Staff,4,0,65,61
1746553071496,ECE 197,001,957920,Mercier; Patrick Philip,9991,0,9999,8
1746553072524,ECON 178,A01,907814,Zhu; Ying,26,0,35,9
1746553073548,EDS 115,A00,895312,Staff,35,0,45,10
1746553074573,EDS 117,A01,895337,Staff,23,0,30,7
1746553075598,EDS 125,A00,895341,Jones; Gabrielle Anastasia,36,0,45,9
1746553076622,EDS 128A,A01,895459,Fargason; Sharon Gayle,44,0,45,1
1746553077646,EDS 128B,A01,895543,Pappas; Elizabeth,44,0,45,1
1746553078673,EDS 139,A00,897203,Pappas; Elizabeth,44,0,45,1
1746553078673,EDS 139,B00,897209,Fargason; Sharon Gayle,41,0,45,4
1746553079699,EDS 201,A00,895545,Staff,22,0,45,23
1746553080723,EDS 203,A01,895581,Halter; Christopher P.,22,0,45,23
1746553081750,EDS 204R,A01,895625,Heinzman; Erica M.,39,0,45,6
1746553081750,EDS 204R,B01,895693,Halter; Christopher P.,10,0,45,35
1746553082778,EDS 206R,A00,895694,Fargason; Sharon Gayle,1,0,30,29
1746553082778,EDS 206R,B00,895695,Choi; Bailey Miyeon,16,0,30,14
1746553083807,EDS 250,A00,895697,Hemans; Patricia Ann Benitez,22,0,45,23
1746553084834,EDS 281,A00,895701,Meyerott; Theresa Ann,1,0,15,14
1746553085862,EDS 284,A00,895736,Meyerott; Theresa Ann,1,0,15,14
1746553086889,EDS 286,A00,897210,Fine; Sarah,0,0,15,15
1746553087914,EDS 289C,A01,895770,Daly; Alan J.,15,0,15,0
1746553088939,EDS 290,A00,897211,Hofstetter; Carolyn,0,0,15,15
1746553089971,LIGM 5A,A00,896162,Fischer-Grunski; Eva K,13,0,20,7
1746553091020,LIGM 5B,A00,896260,Fischer-Grunski; Eva K,17,0,20,3
1746553092046,LIGM 5C,A00,896308,Fischer-Grunski; Eva K,18,0,20,2
1746553093072,LIIT 5AS,A00,896313,Carnelos; Chiara,18,0,20,2
1746553094096,LIIT 5BS,A00,896416,Carnelos; Chiara,20,0,20,0
1746553095122,LIIT 5CS,A00,896564,Carnelos; Chiara,20,0,20,0
1746553096146,LISP 5A,A00,896588,Munoz Sanchez; Alicia,3,0,20,17
1746553097171,LISP 5B,A00,896653,Munoz Sanchez; Alicia,7,0,20,13
1746553098196,LISP 5C,A00,896655,Munoz Sanchez; Alicia,0,1,20,20
1746553099223,MAE 197,001,957918,Kleissl; Jan,9996,0,9999,3
1746553099223,MAE 197,002,959806,Boechler; Nicholas Sebastia,9998,0,9999,1
1746553099223,MAE 197,003,959852,Mullin; Jennifer S,9998,0,9999,1
1746553100250,MATH 2,A01,957937,Staff,33,0,35,2
1746553101284,MATH 197,001,957876,Kedlaya; Kiran S.,9993,0,9999,6
1746553102308,MCWP 40,A00,892729,Duru; Nur,10,0,20,10
1746553102308,MCWP 40,B00,893304,Montejo; Carolina,14,0,20,6
1746553103333,MCWP 40R,A00,893757,Redela; Pamela Morgan,0,5,20,20
1746553104360,MCWP 50,A00,893758,Morshed; Michael James,0,0,20,20
1746553104360,MCWP 50,B00,893761,Bartulis; Jason Michael,17,0,20,3
1746553105387,MCWP 50R,A00,893766,Compas; Sean Matthew,0,1,20,20
1746553105387,MCWP 50R,B00,893769,Carter; Jennifer A,0,1,20,20
1746553105387,MCWP 50R,C00,893771,Krone; Jarret,0,3,20,20
1746553105387,MCWP 50R,D00,893772,Miller; Elizabeth Deen,0,0,20,20
1746553105387,MCWP 50R,E00,893775,Carter; Andrea L,0,1,20,20
1746553106410,MMW 11R,A01,892721,Herbst; Matthew,11,0,27,16
1746553106410,MMW 11R,A02,892722,Herbst; Matthew,0,0,0,3
1746553107445,MMW 12R,A01,892724,Herbst; Matthew,0,11,16,16
1746553107445,MMW 12R,A02,892725,Herbst; Matthew,0,10,16,16
1746553108470,MMW 13R,A01,892727,Staff,0,4,16,16
1746553108470,MMW 13R,A02,892728,Staff,0,4,16,16
1746553108470,MMW 13R,A03,958032,Staff,0,4,16,16
1746553108470,MMW 13R,A04,958033,Staff,0,4,16,16
1746553108470,MMW 13R,A05,958034,Staff,0,4,16,16
1746553109495,SIO 295LS,A00,894015,Staff,5,0,25,20
1746553110519,SIO 295S,A00,894020,Staff,5,0,25,20
1746553111543,SIOC 290S,B01,958918,Merrifield; Mark A,14,0,30,16
1746553112568,SIOC 291S,B01,958922,Gabriel; Corey John,14,0,30,16
1746553113594,SOCI 117,A01,895339,Staff,3,0,5,2
1746553114618,WES 237B,A00,894149,Staff,11,0,20,9
1746553116677,AESE 279B,A00,891859,Staff,13,0,35,22
1746553117700,AIP 197,001,891854,Vespa; Emanuel Ignacio,9999,0,9999,0
1746553118724,ANTH 289S,A00,891856,Gagneux; Pascal,12,0,12,0
1746553119750,BENG 196,001,957946,Engler; Adam J.,9996,0,9999,3
1746553120778,BISP 197,001,959851,Wilhelm; James E.,9998,0,9999,1
1746553121804,CAT 124RS,A01,956906,Staff,6,0,25,19
1746553122831,CAT 125RS,A01,922013,Staff,6,0,25,19
1746553123860,CLRE 250,A00,891860,Morris; Sheldon,9995,0,9999,4
1746553125909,CLRE 251R,A00,907817,Mehta; Ravindra L.,9994,0,9999,5
1746553126933,CLRE 252,A00,891864,Cuomo; Raphael Eduardo,9993,0,9999,6
1746553127960,CLRE 253,A00,891867,Vaida; Florin,9994,0,9999,5
1746553127960,CLRE 253,B00,907819,Staff,9999,0,9999,0
1746553128985,CLRE 259,A00,891868,Patel; Hemal,9998,0,9999,1
1746553130017,CLRE 260,A00,891872,Cuomo; Raphael Eduardo,9999,0,9999,0
1746553131043,CLRE 297,001,891888,Cuomo; Raphael Eduardo,9999,0,9999,0
1746553132070,CSE 191,A00,958773,Minnes Kemp; Mor Mia,9995,0,9999,4
1746553133097,CSE 197,001,959846,Minnes Kemp; Mor Mia,9990,0,9999,9
1746553134128,CSS 201S,A01,892054,Mignozzetti; Umberto,26,0,30,4
1746553135155,CSS 202S,A01,892056,Mignozzetti; Umberto,26,0,30,4
1746553136182,DSC 197,001,956898,Eldridge; Justin Matthew,9997,0,9999,2
1746553137210,DSC 297,001,958000,Mazumdar; Arya,9998,0,9999,1
1746553137210,DSC 297,002,959862,Wang; Yusu,9998,0,9999,1
1746553138236,EAP 100,A00,905686,Staff,9778,0,9999,221
1746553139264,ECE 45,A01,892618,Staff,0,0,65,65
1746553141320,ECE 111,A01,892719,Staff,4,0,65,61
1746553142348,ECE 197,001,957920,Mercier; Patrick Philip,9991,0,9999,8
1746553143375,ECON 178,A01,907814,Zhu; Ying,26,0,35,9
1746553144402,EDS 115,A00,895312,Staff,35,0,45,10
1746553145431,EDS 117,A01,895337,Staff,23,0,30,7
1746553146458,EDS 125,A00,895341,Jones; Gabrielle Anastasia,36,0,45,9
1746553147483,EDS 128A,A01,895459,Fargason; Sharon Gayle,44,0,45,1
1746553148507,EDS 128B,A01,895543,Pappas; Elizabeth,44,0,45,1
1746553149535,EDS 139,A00,897203,Pappas; Elizabeth,44,0,45,1
1746553149535,EDS 139,B00,897209,Fargason; Sharon Gayle,41,0,45,4
1746553150560,EDS 201,A00,895545,Staff,22,0,45,23
1746553151589,EDS 203,A01,895581,Halter; Christopher P.,22,0,45,23
1746553152618,EDS 204R,A01,895625,Heinzman; Erica M.,39,0,45,6
1746553152618,EDS 204R,B01,895693,Halter; Christopher P.,10,0,45,35
1746553153645,EDS 206R,A00,895694,Fargason; Sharon Gayle,1,0,30,29
1746553153645,EDS 206R,B00,895695,Choi; Bailey Miyeon,16,0,30,14
1746553154671,EDS 250,A00,895697,Hemans; Patricia Ann Benitez,22,0,45,23
1746553155697,EDS 281,A00,895701,Meyerott; Theresa Ann,1,0,15,14
1746553156723,EDS 284,A00,895736,Meyerott; Theresa Ann,1,0,15,14
1746553157751,EDS 286,A00,897210,Fine; Sarah,0,0,15,15
1746553158778,EDS 289C,A01,895770,Daly; Alan J.,15,0,15,0
1746553159803,EDS 290,A00,897211,Hofstetter; Carolyn,0,0,15,15
1746553160830,LIGM 5A,A00,896162,Fischer-Grunski; Eva K,13,0,20,7
1746553161856,LIGM 5B,A00,896260,Fischer-Grunski; Eva K,17,0,20,3
1746553162883,LIGM 5C,A00,896308,Fischer-Grunski; Eva K,18,0,20,2
1746553163910,LIIT 5AS,A00,896313,Carnelos; Chiara,18,0,20,2
1746553164934,LIIT 5BS,A00,896416,Carnelos; Chiara,20,0,20,0
1746553165963,LIIT 5CS,A00,896564,Carnelos; Chiara,20,0,20,0
1746553167001,LISP 5A,A00,896588,Munoz Sanchez; Alicia,3,0,20,17
1746553168027,LISP 5B,A00,896653,Munoz Sanchez; Alicia,7,0,20,13
1746553169052,LISP 5C,A00,896655,Munoz Sanchez; Alicia,0,1,20,20
1746553170077,MAE 197,001,957918,Kleissl; Jan,9996,0,9999,3
1746553170077,MAE 197,002,959806,Boechler; Nicholas Sebastia,9998,0,9999,1
1746553170077,MAE 197,003,959852,Mullin; Jennifer S,9998,0,9999,1
1746553171101,MATH 2,A01,957937,Staff,33,0,35,2
1746553172126,MATH 197,001,957876,Kedlaya; Kiran S.,9993,0,9999,6
1746553173151,MCWP 40,A00,892729,Duru; Nur,10,0,20,10
1746553173151,MCWP 40,B00,893304,Montejo; Carolina,14,0,20,6
1746553174198,MCWP 40R,A00,893757,Redela; Pamela Morgan,0,5,20,20
1746553175226,MCWP 50,A00,893758,Morshed; Michael James,0,0,20,20
1746553175226,MCWP 50,B00,893761,Bartulis; Jason Michael,17,0,20,3
1746553176256,MCWP 50R,A00,893766,Compas; Sean Matthew,0,1,20,20
1746553176256,MCWP 50R,B00,893769,Carter; Jennifer A,0,1,20,20
1746553176256,MCWP 50R,C00,893771,Krone; Jarret,0,3,20,20
1746553176256,MCWP 50R,D00,893772,Miller; Elizabeth Deen,0,0,20,20
1746553176256,MCWP 50R,E00,893775,Carter; Andrea L,0,1,20,20
1746553177284,MMW 11R,A01,892721,Herbst; Matthew,11,0,27,16
1746553177284,MMW 11R,A02,892722,Herbst; Matthew,0,0,0,3
1746553178310,MMW 12R,A01,892724,Herbst; Matthew,0,11,16,16
1746553178310,MMW 12R,A02,892725,Herbst; Matthew,0,10,16,16
1746553179334,MMW 13R,A01,892727,Staff,0,4,16,16
1746553179334,MMW 13R,A02,892728,Staff,0,4,16,16
1746553179334,MMW 13R,A03,958032,Staff,0,4,16,16
1746553179334,MMW 13R,A04,958033,Staff,0,4,16,16
1746553179334,MMW 13R,A05,958034,Staff,0,4,16,16
1746553180358,SIO 295LS,A00,894015,Staff,5,0,25,20
1746553181386,SIO 295S,A00,894020,Staff,5,0,25,20
1746553182415,SIOC 290S,B01,958918,Merrifield; Mark A,14,0,30,16
1746553183441,SIOC 291S,B01,958922,Gabriel; Corey John,14,0,30,16
1746553184465,SOCI 117,A01,895339,Staff,3,0,5,2
1746553185491,WES 237B,A00,894149,Staff,11,0,20,9
1746553187559,AESE 279B,A00,891859,Staff,13,0,35,22
1746553188586,AIP 197,001,891854,Vespa; Emanuel Ignacio,9999,0,9999,0
1746553189613,ANTH 289S,A00,891856,Gagneux; Pascal,12,0,12,0
1746553190636,BENG 196,001,957946,Engler; Adam J.,9996,0,9999,3
1746553191661,BISP 197,001,959851,Wilhelm; James E.,9998,0,9999,1
1746553192685,CAT 124RS,A01,956906,Staff,6,0,25,19
1746553193710,CAT 125RS,A01,922013,Staff,6,0,25,19
1746553194736,CLRE 250,A00,891860,Morris; Sheldon,9995,0,9999,4
1746553196787,CLRE 251R,A00,907817,Mehta; Ravindra L.,9994,0,9999,5
1746553197813,CLRE 252,A00,891864,Cuomo; Raphael Eduardo,9993,0,9999,6
1746553198842,CLRE 253,A00,891867,Vaida; Florin,9994,0,9999,5
1746553198842,CLRE 253,B00,907819,Staff,9999,0,9999,0
1746553199870,CLRE 259,A00,891868,Patel; Hemal,9998,0,9999,1
1746553200897,CLRE 260,A00,891872,Cuomo; Raphael Eduardo,9999,0,9999,0
1746553201923,CLRE 297,001,891888,Cuomo; Raphael Eduardo,9999,0,9999,0
1746553202952,CSE 191,A00,958773,Minnes Kemp; Mor Mia,9995,0,9999,4
1746553203988,CSE 197,001,959846,Minnes Kemp; Mor Mia,9990,0,9999,9
1746553205017,CSS 201S,A01,892054,Mignozzetti; Umberto,26,0,30,4
1746553206047,CSS 202S,A01,892056,Mignozzetti; Umberto,26,0,30,4
1746553207074,DSC 197,001,956898,Eldridge; Justin Matthew,9997,0,9999,2
1746553208103,DSC 297,001,958000,Mazumdar; Arya,9998,0,9999,1
1746553208103,DSC 297,002,959862,Wang; Yusu,9998,0,9999,1
1746553209133,EAP 100,A00,905686,Staff,9778,0,9999,221
1746553210159,ECE 45,A01,892618,Staff,0,0,65,65
1746553212210,ECE 111,A01,892719,Staff,4,0,65,61
1746553213234,ECE 197,001,957920,Mercier; Patrick Philip,9991,0,9999,8
1746553214260,ECON 178,A01,907814,Zhu; Ying,26,0,35,9
1746553215284,EDS 115,A00,895312,Staff,35,0,45,10
1746553216311,EDS 117,A01,895337,Staff,23,0,30,7
1746553217338,EDS 125,A00,895341,Jones; Gabrielle Anastasia,36,0,45,9
1746553218367,EDS 128A,A01,895459,Fargason; Sharon Gayle,44,0,45,1
1746553219393,EDS 128B,A01,895543,Pappas; Elizabeth,44,0,45,1
1746553220420,EDS 139,A00,897203,Pappas; Elizabeth,44,0,45,1
1746553220420,EDS 139,B00,897209,Fargason; Sharon Gayle,41,0,45,4
1746553221445,EDS 201,A00,895545,Staff,22,0,45,23
1746553222475,EDS 203,A01,895581,Halter; Christopher P.,22,0,45,23
1746553223501,EDS 204R,A01,895625,Heinzman; Erica M.,39,0,45,6
1746553223501,EDS 204R,B01,895693,Halter; Christopher P.,10,0,45,35
1746553224528,EDS 206R,A00,895694,Fargason; Sharon Gayle,1,0,30,29
1746553224528,EDS 206R,B00,895695,Choi; Bailey Miyeon,16,0,30,14
1746553225553,EDS 250,A00,895697,Hemans; Patricia Ann Benitez,22,0,45,23
1746553226579,EDS 281,A00,895701,Meyerott; Theresa Ann,1,0,15,14
1746553227606,EDS 284,A00,895736,Meyerott; Theresa Ann,1,0,15,14
1746553228634,EDS 286,A00,897210,Fine; Sarah,0,0,15,15
1746553229661,EDS 289C,A01,895770,Daly; Alan J.,15,0,15,0
1746553230687,EDS 290,A00,897211,Hofstetter; Carolyn,0,0,15,15
1746553231713,LIGM 5A,A00,896162,Fischer-Grunski; Eva K,13,0,20,7
1746553232738,LIGM 5B,A00,896260,Fischer-Grunski; Eva K,17,0,20,3
1746553233768,LIGM 5C,A00,896308,Fischer-Grunski; Eva K,18,0,20,2
1746553234793,LIIT 5AS,A00,896313,Carnelos; Chiara,18,0,20,2
1746553235821,LIIT 5BS,A00,896416,Carnelos; Chiara,20,0,20,0
1746553236851,LIIT 5CS,A00,896564,Carnelos; Chiara,20,0,20,0
1746553237879,LISP 5A,A00,896588,Munoz Sanchez; Alicia,3,0,20,17
1746553238909,LISP 5B,A00,896653,Munoz Sanchez; Alicia,7,0,20,13
1746553239936,LISP 5C,A00,896655,Munoz Sanchez; Alicia,0,1,20,20
1746553240961,MAE 197,001,957918,Kleissl; Jan,9996,0,9999,3
1746553240961,MAE 197,002,959806,Boechler; Nicholas Sebastia,9998,0,9999,1
1746553240961,MAE 197,003,959852,Mullin; Jennifer S,9998,0,9999,1
1746553241985,MATH 2,A01,957937,Staff,33,0,35,2
1746553243034,MATH 197,001,957876,Kedlaya; Kiran S.,9993,0,9999,6
1746553244062,MCWP 40,A00,892729,Duru; Nur,10,0,20,10
1746553244062,MCWP 40,B00,893304,Montejo; Carolina,14,0,20,6
1746553245089,MCWP 40R,A00,893757,Redela; Pamela Morgan,0,5,20,20
1746553246113,MCWP 50,A00,893758,Morshed; Michael James,0,0,20,20
1746553246113,MCWP 50,B00,893761,Bartulis; Jason Michael,17,0,20,3
1746553247139,MCWP 50R,A00,893766,Compas; Sean Matthew,0,1,20,20
1746553247139,MCWP 50R,B00,893769,Carter; Jennifer A,0,1,20,20
1746553247139,MCWP 50R,C00,893771,Krone; Jarret,0,3,20,20
1746553247139,MCWP 50R,D00,893772,Miller; Elizabeth Deen,0,0,20,20
1746553247139,MCWP 50R,E00,893775,Carter; Andrea L,0,1,20,20
1746553248165,MMW 11R,A01,892721,Herbst; Matthew,11,0,27,16
1746553248165,MMW 11R,A02,892722,Herbst; Matthew,0,0,0,3
1746553249189,MMW 12R,A01,892724,Herbst; Matthew,0,11,16,16
1746553249189,MMW 12R,A02,892725,Herbst; Matthew,0,10,16,16
1746553250217,MMW 13R,A01,892727,Staff,0,4,16,16
1746553250217,MMW 13R,A02,892728,Staff,0,4,16,16
1746553250217,MMW 13R,A03,958032,Staff,0,4,16,16
1746553250217,MMW 13R,A04,958033,Staff,0,4,16,16
1746553250217,MMW 13R,A05,958034,Staff,0,4,16,16
1746553251243,SIO 295LS,A00,894015,Staff,5,0,25,20
1746553252267,SIO 295S,A00,894020,Staff,5,0,25,20
1746553253293,SIOC 290S,B01,958918,Merrifield; Mark A,14,0,30,16
1746553254318,SIOC 291S,B01,958922,Gabriel; Corey John,14,0,30,16
1746553255342,SOCI 117,A01,895339,Staff,3,0,5,2
1746553256368,WES 237B,A00,894149,Staff,11,0,20,9
1746553258433,AESE 279B,A00,891859,Staff,13,0,35,22
1746553259461,AIP 197,001,891854,Vespa; Emanuel Ignacio,9999,0,9999,0
1746553260500,ANTH 289S,A00,891856,Gagneux; Pascal,12,0,12,0
1746553261524,BENG 196,001,957946,Engler; Adam J.,9996,0,9999,3
1746553262549,BISP 197,001,959851,Wilhelm; James E.,9998,0,9999,1
1746553263574,CAT 124RS,A01,956906,Staff,6,0,25,19
1746553264601,CAT 125RS,A01,922013,Staff,6,0,25,19
1746553265625,CLRE 250,A00,891860,Morris; Sheldon,9995,0,9999,4
1746553267680,CLRE 251R,A00,907817,Mehta; Ravindra L.,9994,0,9999,5
1746553268707,CLRE 252,A00,891864,Cuomo; Raphael Eduardo,9993,0,9999,6
1746553269732,CLRE 253,A00,891867,Vaida; Florin,9994,0,9999,5
1746553269732,CLRE 253,B00,907819,Staff,9999,0,9999,0
1746553270756,CLRE 259,A00,891868,Patel; Hemal,9998,0,9999,1
1746553271782,CLRE 260,A00,891872,Cuomo; Raphael Eduardo,9999,0,9999,0
1746553272809,CLRE 297,001,891888,Cuomo; Raphael Eduardo,9999,0,9999,0
1746553273834,CSE 191,A00,958773,Minnes Kemp; Mor Mia,9995,0,9999,4
1746553274858,CSE 197,001,959846,Minnes Kemp; Mor Mia,9990,0,9999,9
1746553275883,CSS 201S,A01,892054,Mignozzetti; Umberto,26,0,30,4
1746553276910,CSS 202S,A01,892056,Mignozzetti; Umberto,26,0,30,4
1746553277935,DSC 197,001,956898,Eldridge; Justin Matthew,9997,0,9999,2
1746553278959,DSC 297,001,958000,Mazumdar; Arya,9998,0,9999,1
1746553278959,DSC 297,002,959862,Wang; Yusu,9998,0,9999,1
1746553279986,EAP 100,A00,905686,Staff,9778,0,9999,221
1746553281013,ECE 45,A01,892618,Staff,0,0,65,65
1746553283068,ECE 111,A01,892719,Staff,4,0,65,61
1746553284097,ECE 197,001,957920,Mercier; Patrick Philip,9991,0,9999,8
1746553285123,ECON 178,A01,907814,Zhu; Ying,26,0,35,9
1746553286146,EDS 115,A00,895312,Staff,35,0,45,10
1746553287173,EDS 117,A01,895337,Staff,23,0,30,7
1746553288198,EDS 125,A00,895341,Jones; Gabrielle Anastasia,36,0,45,9
1746553289225,EDS 128A,A01,895459,Fargason; Sharon Gayle,44,0,45,1
1746553290254,EDS 128B,A01,895543,Pappas; Elizabeth,44,0,45,1
1746553291282,EDS 139,A00,897203,Pappas; Elizabeth,44,0,45,1
1746553291282,EDS 139,B00,897209,Fargason; Sharon Gayle,41,0,45,4
1746553292308,EDS 201,A00,895545,Staff,22,0,45,23
1746553293333,EDS 203,A01,895581,Halter; Christopher P.,22,0,45,23
1746553294361,EDS 204R,A01,895625,Heinzman; Erica M.,39,0,45,6
1746553294361,EDS 204R,B01,895693,Halter; Christopher P.,10,0,45,35
1746553295384,EDS 206R,A00,895694,Fargason; Sharon Gayle,1,0,30,29
1746553295384,EDS 206R,B00,895695,Choi; Bailey Miyeon,16,0,30,14
1746553296408,EDS 250,A00,895697,Hemans; Patricia Ann Benitez,22,0,45,23
1746553297435,EDS 281,A00,895701,Meyerott; Theresa Ann,1,0,15,14
1746553298459,EDS 284,A00,895736,Meyerott; Theresa Ann,1,0,15,14
1746553299483,EDS 286,A00,897210,Fine; Sarah,0,0,15,15
1746553300508,EDS 289C,A01,895770,Daly; Alan J.,15,0,15,0
1746553301537,EDS 290,A00,897211,Hofstetter; Carolyn,0,0,15,15
1746553302563,LIGM 5A,A00,896162,Fischer-Grunski; Eva K,13,0,20,7
1746553303590,LIGM 5B,A00,896260,Fischer-Grunski; Eva K,17,0,20,3
1746553304618,LIGM 5C,A00,896308,Fischer-Grunski; Eva K,18,0,20,2
1746553305646,LIIT 5AS,A00,896313,Carnelos; Chiara,18,0,20,2
1746553306671,LIIT 5BS,A00,896416,Carnelos; Chiara,20,0,20,0
1746553307757,LIIT 5CS,A00,896564,Carnelos; Chiara,20,0,20,0
1746553308783,LISP 5A,A00,896588,Munoz Sanchez; Alicia,3,0,20,17
1746553309810,LISP 5B,A00,896653,Munoz Sanchez; Alicia,7,0,20,13
1746553310840,LISP 5C,A00,896655,Munoz Sanchez; Alicia,0,1,20,20
1746553311864,MAE 197,001,957918,Kleissl; Jan,9996,0,9999,3
1746553311864,MAE 197,002,959806,Boechler; Nicholas Sebastia,9998,0,9999,1
1746553311864,MAE 197,003,959852,Mullin; Jennifer S,9998,0,9999,1
1746553312890,MATH 2,A01,957937,Staff,33,0,35,2
1746553313914,MATH 197,001,957876,Kedlaya; Kiran S.,9993,0,9999,6
1746553314939,MCWP 40,A00,892729,Duru; Nur,10,0,20,10
1746553314939,MCWP 40,B00,893304,Montejo; Carolina,14,0,20,6
1746553315966,MCWP 40R,A00,893757,Redela; Pamela Morgan,0,5,20,20
1746553316994,MCWP 50,A00,893758,Morshed; Michael James,0,0,20,20
1746553316994,MCWP 50,B00,893761,Bartulis; Jason Michael,17,0,20,3
1746553318024,MCWP 50R,A00,893766,Compas; Sean Matthew,0,1,20,20
1746553318024,MCWP 50R,B00,893769,Carter; Jennifer A,0,1,20,20
1746553318024,MCWP 50R,C00,893771,Krone; Jarret,0,3,20,20
1746553318024,MCWP 50R,D00,893772,Miller; Elizabeth Deen,0,0,20,20
1746553318024,MCWP 50R,E00,893775,Carter; Andrea L,0,1,20,20
1746553319050,MMW 11R,A01,892721,Herbst; Matthew,11,0,27,16
1746553319050,MMW 11R,A02,892722,Herbst; Matthew,0,0,0,3
1746553320074,MMW 12R,A01,892724,Herbst; Matthew,0,11,16,16
1746553320074,MMW 12R,A02,892725,Herbst; Matthew,0,10,16,16
1746553321104,MMW 13R,A01,892727,Staff,0,4,16,16
1746553321104,MMW 13R,A02,892728,Staff,0,4,16,16
1746553321104,MMW 13R,A03,958032,Staff,0,4,16,16
1746553321104,MMW 13R,A04,958033,Staff,0,4,16,16
1746553321104,MMW 13R,A05,958034,Staff,0,4,16,16
1746553322133,SIO 295LS,A00,894015,Staff,5,0,25,20
1746553323161,SIO 295S,A00,894020,Staff,5,0,25,20
1746553324187,SIOC 290S,B01,958918,Merrifield; Mark A,14,0,30,16
1746553325214,SIOC 291S,B01,958922,Gabriel; Corey John,14,0,30,16
1746553326240,SOCI 117,A01,895339,Staff,3,0,5,2
1746553327268,WES 237B,A00,894149,Staff,11,0,20,9
1746553329338,AESE 279B,A00,891859,Staff,13,0,35,22
1746553330364,AIP 197,001,891854,Vespa; Emanuel Ignacio,9999,0,9999,0
1746553331389,ANTH 289S,A00,891856,Gagneux; Pascal,12,0,12,0
1746553332423,BENG 196,001,957946,Engler; Adam J.,9996,0,9999,3
1746553333449,BISP 197,001,959851,Wilhelm; James E.,9998,0,9999,1
1746553334477,CAT 124RS,A01,956906,Staff,6,0,25,19
1746553335504,CAT 125RS,A01,922013,Staff,6,0,25,19
1746553336528,CLRE 250,A00,891860,Morris; Sheldon,9995,0,9999,4
1746553338580,CLRE 251R,A00,907817,Mehta; Ravindra L.,9994,0,9999,5
1746553339604,CLRE 252,A00,891864,Cuomo; Raphael Eduardo,9993,0,9999,6
1746553340630,CLRE 253,A00,891867,Vaida; Florin,9994,0,9999,5
1746553340630,CLRE 253,B00,907819,Staff,9999,0,9999,0
1746553341655,CLRE 259,A00,891868,Patel; Hemal,9998,0,9999,1
1746553342682,CLRE 260,A00,891872,Cuomo; Raphael Eduardo,9999,0,9999,0
1746553343707,CLRE 297,001,891888,Cuomo; Raphael Eduardo,9999,0,9999,0
1746553344733,CSE 191,A00,958773,Minnes Kemp; Mor Mia,9995,0,9999,4
1746553345756,CSE 197,001,959846,Minnes Kemp; Mor Mia,9990,0,9999,9
1746553346780,CSS 201S,A01,892054,Mignozzetti; Umberto,26,0,30,4
1746553347805,CSS 202S,A01,892056,Mignozzetti; Umberto,26,0,30,4
1746553348832,DSC 197,001,956898,Eldridge; Justin Matthew,9997,0,9999,2
1746553349859,DSC 297,001,958000,Mazumdar; Arya,9998,0,9999,1
1746553349859,DSC 297,002,959862,Wang; Yusu,9998,0,9999,1
1746553350886,EAP 100,A00,905686,Staff,9778,0,9999,221
1746553351915,ECE 45,A01,892618,Staff,0,0,65,65
1746553353963,ECE 111,A01,892719,Staff,4,0,65,61
1746553354990,ECE 197,001,957920,Mercier; Patrick Philip,9991,0,9999,8
1746553356015,ECON 178,A01,907814,Zhu; Ying,26,0,35,9
1746553357039,EDS 115,A00,895312,Staff,35,0,45,10
1746553358083,EDS 117,A01,895337,Staff,23,0,30,7
1746553359109,EDS 125,A00,895341,Jones; Gabrielle Anastasia,36,0,45,9
1746553360134,EDS 128A,A01,895459,Fargason; Sharon Gayle,44,0,45,1
1746553361159,EDS 128B,A01,895543,Pappas; Elizabeth,44,0,45,1
1746553362182,EDS 139,A00,897203,Pappas; Elizabeth,44,0,45,1
1746553362182,EDS 139,B00,897209,Fargason; Sharon Gayle,41,0,45,4
1746553363207,EDS 201,A00,895545,Staff,22,0,45,23
1746553364235,EDS 203,A01,895581,Halter; Christopher P.,22,0,45,23
1746553365260,EDS 204R,A01,895625,Heinzman; Erica M.,39,0,45,6
1746553365260,EDS 204R,B01,895693,Halter; Christopher P.,10,0,45,35
1746553366286,EDS 206R,A00,895694,Fargason; Sharon Gayle,1,0,30,29
1746553366286,EDS 206R,B00,895695,Choi; Bailey Miyeon,16,0,30,14
1746553367691,EDS 250,A00,895697,Hemans; Patricia Ann Benitez,22,0,45,23
1746553368718,EDS 281,A00,895701,Meyerott; Theresa Ann,1,0,15,14
1746553369746,EDS 284,A00,895736,Meyerott; Theresa Ann,1,0,15,14
1746553370774,EDS 286,A00,897210,Fine; Sarah,0,0,15,15
1746553371800,EDS 289C,A01,895770,Daly; Alan J.,15,0,15,0
1746553372829,EDS 290,A00,897211,Hofstetter; Carolyn,0,0,15,15
1746553373855,LIGM 5A,A00,896162,Fischer-Grunski; Eva K,13,0,20,7
1746553374885,LIGM 5B,A00,896260,Fischer-Grunski; Eva K,17,0,20,3
1746553375910,LIGM 5C,A00,896308,Fischer-Grunski; Eva K,18,0,20,2
1746553376937,LIIT 5AS,A00,896313,Carnelos; Chiara,18,0,20,2
1746553377965,LIIT 5BS,A00,896416,Carnelos; Chiara,20,0,20,0
1746553378994,LIIT 5CS,A00,896564,Carnelos; Chiara,20,0,20,0
1746553380021,LISP 5A,A00,896588,Munoz Sanchez; Alicia,3,0,20,17
1746553381047,LISP 5B,A00,896653,Munoz Sanchez; Alicia,7,0,20,13
1746553382078,LISP 5C,A00,896655,Munoz Sanchez; Alicia,0,1,20,20
1746553383107,MAE 197,001,957918,Kleissl; Jan,9996,0,9999,3
1746553383107,MAE 197,002,959806,Boechler; Nicholas Sebastia,9998,0,9999,1
1746553383107,MAE 197,003,959852,Mullin; Jennifer S,9998,0,9999,1
1746553384133,MATH 2,A01,957937,Staff,33,0,35,2
1746553385161,MATH 197,001,957876,Kedlaya; Kiran S.,9993,0,9999,6
1746553386186,MCWP 40,A00,892729,Duru; Nur,10,0,20,10
1746553386186,MCWP 40,B00,893304,Montejo; Carolina,14,0,20,6
1746553387213,MCWP 40R,A00,893757,Redela; Pamela Morgan,0,5,20,20
1746553388239,MCWP 50,A00,893758,Morshed; Michael James,0,0,20,20
1746553388239,MCWP 50,B00,893761,Bartulis; Jason Michael,17,0,20,3
1746553389270,MCWP 50R,A00,893766,Compas; Sean Matthew,0,1,20,20
1746553389270,MCWP 50R,B00,893769,Carter; Jennifer A,0,1,20,20
1746553389270,MCWP 50R,C00,893771,Krone; Jarret,0,3,20,20
1746553389270,MCWP 50R,D00,893772,Miller; Elizabeth Deen,0,0,20,20
1746553389270,MCWP 50R,E00,893775,Carter; Andrea L,0,1,20,20
1746553390296,MMW 11R,A01,892721,Herbst; Matthew,11,0,27,16
1746553390296,MMW 11R,A02,892722,Herbst; Matthew,0,0,0,3
1746553391324,MMW 12R,A01,892724,Herbst; Matthew,0,11,16,16
1746553391324,MMW 12R,A02,892725,Herbst; Matthew,0,10,16,16
1746553392347,MMW 13R,A01,892727,Staff,0,4,16,16
1746553392347,MMW 13R,A02,892728,Staff,0,4,16,16
1746553392347,MMW 13R,A03,958032,Staff,0,4,16,16
1746553392347,MMW 13R,A04,958033,Staff,0,4,16,16
1746553392347,MMW 13R,A05,958034,Staff,0,4,16,16
1746553393376,SIO 295LS,A00,894015,Staff,5,0,25,20
1746553394403,SIO 295S,A00,894020,Staff,5,0,25,20
1746553395430,SIOC 290S,B01,958918,Merrifield; Mark A,14,0,30,16
1746553396454,SIOC 291S,B01,958922,Gabriel; Corey John,14,0,30,16
1746553397479,SOCI 117,A01,895339,Staff,3,0,5,2
1746553398507,WES 237B,A00,894149,Staff,11,0,20,9
1746553400570,AESE 279B,A00,891859,Staff,13,0,35,22
1746553401598,AIP 197,001,891854,Vespa; Emanuel Ignacio,9999,0,9999,0
1746553402626,ANTH 289S,A00,891856,Gagneux; Pascal,12,0,12,0
1746553403652,BENG 196,001,957946,Engler; Adam J.,9996,0,9999,3
1746553404677,BISP 197,001,959851,Wilhelm; James E.,9998,0,9999,1
1746553405706,CAT 124RS,A01,956906,Staff,6,0,25,19
1746553406734,CAT 125RS,A01,922013,Staff,6,0,25,19
1746553407762,CLRE 250,A00,891860,Morris; Sheldon,9995,0,9999,4
1746553409815,CLRE 251R,A00,907817,Mehta; Ravindra L.,9994,0,9999,5
1746553410840,CLRE 252,A00,891864,Cuomo; Raphael Eduardo,9993,0,9999,6
1746553411867,CLRE 253,A00,891867,Vaida; Florin,9994,0,9999,5
1746553411867,CLRE 253,B00,907819,Staff,9999,0,9999,0
1746553412892,CLRE 259,A00,891868,Patel; Hemal,9998,0,9999,1
1746553413918,CLRE 260,A00,891872,Cuomo; Raphael Eduardo,9999,0,9999,0
1746553414943,CLRE 297,001,891888,Cuomo; Raphael Eduardo,9999,0,9999,0
1746553415968,CSE 191,A00,958773,Minnes Kemp; Mor Mia,9995,0,9999,4
1746553416993,CSE 197,001,959846,Minnes Kemp; Mor Mia,9990,0,9999,9
1746553418024,CSS 201S,A01,892054,Mignozzetti; Umberto,26,0,30,4
1746553419054,CSS 202S,A01,892056,Mignozzetti; Umberto,26,0,30,4
1746553420080,DSC 197,001,956898,Eldridge; Justin Matthew,9997,0,9999,2
1746553421106,DSC 297,001,958000,Mazumdar; Arya,9998,0,9999,1
1746553421106,DSC 297,002,959862,Wang; Yusu,9998,0,9999,1
1746553422136,EAP 100,A00,905686,Staff,9778,0,9999,221
1746553423165,ECE 45,A01,892618,Staff,0,0,65,65
1746553425215,ECE 111,A01,892719,Staff,4,0,65,61
1746553426243,ECE 197,001,957920,Mercier; Patrick Philip,9991,0,9999,8
1746553427268,ECON 178,A01,907814,Zhu; Ying,26,0,35,9
1746553428292,EDS 115,A00,895312,Staff,35,0,45,10
1746553429319,EDS 117,A01,895337,Staff,23,0,30,7
1746553430351,EDS 125,A00,895341,Jones; Gabrielle Anastasia,36,0,45,9
1746553431379,EDS 128A,A01,895459,Fargason; Sharon Gayle,44,0,45,1
1746553432409,EDS 128B,A01,895543,Pappas; Elizabeth,44,0,45,1
1746553433433,EDS 139,A00,897203,Pappas; Elizabeth,44,0,45,1
1746553433433,EDS 139,B00,897209,Fargason; Sharon Gayle,41,0,45,4
1746553434457,EDS 201,A00,895545,Staff,22,0,45,23
1746553435482,EDS 203,A01,895581,Halter; Christopher P.,22,0,45,23
1746553436505,EDS 204R,A01,895625,Heinzman; Erica M.,39,0,45,6
1746553436505,EDS 204R,B01,895693,Halter; Christopher P.,10,0,45,35
1746553437536,EDS 206R,A00,895694,Fargason; Sharon Gayle,1,0,30,29
1746553437536,EDS 206R,B00,895695,Choi; Bailey Miyeon,16,0,30,14
1746553438563,EDS 250,A00,895697,Hemans; Patricia Ann Benitez,22,0,45,23
1746553439589,EDS 281,A00,895701,Meyerott; Theresa Ann,1,0,15,14
1746553440618,EDS 284,A00,895736,Meyerott; Theresa Ann,1,0,15,14
1746553441649,EDS 286,A00,897210,Fine; Sarah,0,0,15,15
1746553442677,EDS 289C,A01,895770,Daly; Alan J.,15,0,15,0
1746553443703,EDS 290,A00,897211,Hofstetter; Carolyn,0,0,15,15
1746553444730,LIGM 5A,A00,896162,Fischer-Grunski; Eva K,13,0,20,7
1746553445761,LIGM 5B,A00,896260,Fischer-Grunski; Eva K,17,0,20,3
1746553446788,LIGM 5C,A00,896308,Fischer-Grunski; Eva K,18,0,20,2
1746553447812,LIIT 5AS,A00,896313,Carnelos; Chiara,18,0,20,2
1746553448837,LIIT 5BS,A00,896416,Carnelos; Chiara,20,0,20,0
1746553449867,LIIT 5CS,A00,896564,Carnelos; Chiara,20,0,20,0
1746553450892,LISP 5A,A00,896588,Munoz Sanchez; Alicia,3,0,20,17
1746553451921,LISP 5B,A00,896653,Munoz Sanchez; Alicia,7,0,20,13
1746553452946,LISP 5C,A00,896655,Munoz Sanchez; Alicia,0,1,20,20
1746553453972,MAE 197,001,957918,Kleissl; Jan,9996,0,9999,3
1746553453972,MAE 197,002,959806,Boechler; Nicholas Sebastia,9998,0,9999,1
1746553453972,MAE 197,003,959852,Mullin; Jennifer S,9998,0,9999,1
1746553455037,MATH 2,A01,957937,Staff,33,0,35,2
1746553456063,MATH 197,001,957876,Kedlaya; Kiran S.,9993,0,9999,6
1746553457091,MCWP 40,A00,892729,Duru; Nur,10,0,20,10
1746553457091,MCWP 40,B00,893304,Montejo; Carolina,14,0,20,6
1746553458131,MCWP 40R,A00,893757,Redela; Pamela Morgan,0,5,20,20
1746553459155,MCWP 50,A00,893758,Morshed; Michael James,0,0,20,20
1746553459155,MCWP 50,B00,893761,Bartulis; Jason Michael,17,0,20,3
1746553460179,MCWP 50R,A00,893766,Compas; Sean Matthew,0,1,20,20
1746553460179,MCWP 50R,B00,893769,Carter; Jennifer A,0,1,20,20
1746553460179,MCWP 50R,C00,893771,Krone; Jarret,0,3,20,20
1746553460179,MCWP 50R,D00,893772,Miller; Elizabeth Deen,0,0,20,20
1746553460179,MCWP 50R,E00,893775,Carter; Andrea L,0,1,20,20
1746553461204,MMW 11R,A01,892721,Herbst; Matthew,11,0,27,16
1746553461204,MMW 11R,A02,892722,Herbst; Matthew,0,0,0,3
1746553462231,MMW 12R,A01,892724,Herbst; Matthew,0,11,16,16
1746553462231,MMW 12R,A02,892725,Herbst; Matthew,0,10,16,16
1746553463256,MMW 13R,A01,892727,Staff,0,4,16,16
1746553463256,MMW 13R,A02,892728,Staff,0,4,16,16
1746553463256,MMW 13R,A03,958032,Staff,0,4,16,16
1746553463256,MMW 13R,A04,958033,Staff,0,4,16,16
1746553463256,MMW 13R,A05,958034,Staff,0,4,16,16
1746553464283,SIO 295LS,A00,894015,Staff,5,0,25,20
1746553465311,SIO 295S,A00,894020,Staff,5,0,25,20
1746553466339,SIOC 290S,B01,958918,Merrifield; Mark A,14,0,30,16
1746553467367,SIOC 291S,B01,958922,Gabriel; Corey John,14,0,30,16
1746553468393,SOCI 117,A01,895339,Staff,3,0,5,2
1746553469418,WES 237B,A00,894149,Staff,11,0,20,9
1746553471472,AESE 279B,A00,891859,Staff,13,0,35,22
1746553472496,AIP 197,001,891854,Vespa; Emanuel Ignacio,9999,0,9999,0
1746553473519,ANTH 289S,A00,891856,Gagneux; Pascal,12,0,12,0
1746553474546,BENG 196,001,957946,Engler; Adam J.,9996,0,9999,3
1746553475569,BISP 197,001,959851,Wilhelm; James E.,9998,0,9999,1
1746553476597,CAT 124RS,A01,956906,Staff,6,0,25,19
1746553477624,CAT 125RS,A01,922013,Staff,6,0,25,19
1746553478651,CLRE 250,A00,891860,Morris; Sheldon,9995,0,9999,4
1746553480701,CLRE 251R,A00,907817,Mehta; Ravindra L.,9994,0,9999,5
1746553481727,CLRE 252,A00,891864,Cuomo; Raphael Eduardo,9993,0,9999,6
1746553482754,CLRE 253,A00,891867,Vaida; Florin,9994,0,9999,5
1746553482754,CLRE 253,B00,907819,Staff,9999,0,9999,0
1746553483779,CLRE 259,A00,891868,Patel; Hemal,9998,0,9999,1
1746553484805,CLRE 260,A00,891872,Cuomo; Raphael Eduardo,9999,0,9999,0
1746553485832,CLRE 297,001,891888,Cuomo; Raphael Eduardo,9999,0,9999,0
1746553486857,CSE 191,A00,958773,Minnes Kemp; Mor Mia,9995,0,9999,4
1746553487884,CSE 197,001,959846,Minnes Kemp; Mor Mia,9990,0,9999,9
1746553488911,CSS 201S,A01,892054,Mignozzetti; Umberto,26,0,30,4
1746553489940,CSS 202S,A01,892056,Mignozzetti; Umberto,26,0,30,4
1746553490966,DSC 197,001,956898,Eldridge; Justin Matthew,9997,0,9999,2
1746553491994,DSC 297,001,958000,Mazumdar; Arya,9998,0,9999,1
1746553491994,DSC 297,002,959862,Wang; Yusu,9998,0,9999,1
1746553493018,EAP 100,A00,905686,Staff,9778,0,9999,221
1746553494047,ECE 45,A01,892618,Staff,0,0,65,65
1746553496095,ECE 111,A01,892719,Staff,4,0,65,61
1746553497123,ECE 197,001,957920,Mercier; Patrick Philip,9991,0,9999,8
1746553498148,ECON 178,A01,907814,Zhu; Ying,26,0,35,9
1746553499176,EDS 115,A00,895312,Staff,35,0,45,10
1746553500203,EDS 117,A01,895337,Staff,23,0,30,7
1746553501227,EDS 125,A00,895341,Jones; Gabrielle Anastasia,36,0,45,9
1746553502251,EDS 128A,A01,895459,Fargason; Sharon Gayle,44,0,45,1
1746553503279,EDS 128B,A01,895543,Pappas; Elizabeth,44,0,45,1
1746553504305,EDS 139,A00,897203,Pappas; Elizabeth,44,0,45,1
1746553504305,EDS 139,B00,897209,Fargason; Sharon Gayle,41,0,45,4
1746553505331,EDS 201,A00,895545,Staff,22,0,45,23
1746553506355,EDS 203,A01,895581,Halter; Christopher P.,22,0,45,23
1746553507382,EDS 204R,A01,895625,Heinzman; Erica M.,39,0,45,6
1746553507382,EDS 204R,B01,895693,Halter; Christopher P.,10,0,45,35
1746553508408,EDS 206R,A00,895694,Fargason; Sharon Gayle,1,0,30,29
1746553508408,EDS 206R,B00,895695,Choi; Bailey Miyeon,16,0,30,14
1746553509437,EDS 250,A00,895697,Hemans; Patricia Ann Benitez,22,0,45,23
1746553510460,EDS 281,A00,895701,Meyerott; Theresa Ann,1,0,15,14
1746553511486,EDS 284,A00,895736,Meyerott; Theresa Ann,1,0,15,14
1746553512516,EDS 286,A00,897210,Fine; Sarah,0,0,15,15
1746553513541,EDS 289C,A01,895770,Daly; Alan J.,15,0,15,0
1746553514565,EDS 290,A00,897211,Hofstetter; Carolyn,0,0,15,15
1746553515590,LIGM 5A,A00,896162,Fischer-Grunski; Eva K,13,0,20,7
1746553516613,LIGM 5B,A00,896260,Fischer-Grunski; Eva K,17,0,20,3
1746553517641,LIGM 5C,A00,896308,Fischer-Grunski; Eva K,18,0,20,2
1746553518667,LIIT 5AS,A00,896313,Carnelos; Chiara,18,0,20,2
1746553519692,LIIT 5BS,A00,896416,Carnelos; Chiara,20,0,20,0
1746553520721,LIIT 5CS,A00,896564,Carnelos; Chiara,20,0,20,0
1746553521747,LISP 5A,A00,896588,Munoz Sanchez; Alicia,3,0,20,17
1746553522772,LISP 5B,A00,896653,Munoz Sanchez; Alicia,7,0,20,13
1746553523798,LISP 5C,A00,896655,Munoz Sanchez; Alicia,0,1,20,20
1746553524825,MAE 197,001,957918,Kleissl; Jan,9996,0,9999,3
1746553524825,MAE 197,002,959806,Boechler; Nicholas Sebastia,9998,0,9999,1
1746553524825,MAE 197,003,959852,Mullin; Jennifer S,9998,0,9999,1
1746553525853,MATH 2,A01,957937,Staff,33,0,35,2
1746553526881,MATH 197,001,957876,Kedlaya; Kiran S.,9993,0,9999,6
1746553527907,MCWP 40,A00,892729,Duru; Nur,10,0,20,10
1746553527907,MCWP 40,B00,893304,Montejo; Carolina,14,0,20,6
1746553528932,MCWP 40R,A00,893757,Redela; Pamela Morgan,0,5,20,20
1746553529956,MCWP 50,A00,893758,Morshed; Michael James,0,0,20,20
1746553529956,MCWP 50,B00,893761,Bartulis; Jason Michael,17,0,20,3
1746553530982,MCWP 50R,A00,893766,Compas; Sean Matthew,0,1,20,20
1746553530982,MCWP 50R,B00,893769,Carter; Jennifer A,0,1,20,20
1746553530982,MCWP 50R,C00,893771,Krone; Jarret,0,3,20,20
1746553530982,MCWP 50R,D00,893772,Miller; Elizabeth Deen,0,0,20,20
1746553530982,MCWP 50R,E00,893775,Carter; Andrea L,0,1,20,20
1746553532008,MMW 11R,A01,892721,Herbst; Matthew,11,0,27,16
1746553532008,MMW 11R,A02,892722,Herbst; Matthew,0,0,0,3
1746553533034,MMW 12R,A01,892724,Herbst; Matthew,0,11,16,16
1746553533034,MMW 12R,A02,892725,Herbst; Matthew,0,10,16,16
1746553534058,MMW 13R,A01,892727,Staff,0,4,16,16
1746553534058,MMW 13R,A02,892728,Staff,0,4,16,16
1746553534058,MMW 13R,A03,958032,Staff,0,4,16,16
1746553534058,MMW 13R,A04,958033,Staff,0,4,16,16
1746553534058,MMW 13R,A05,958034,Staff,0,4,16,16
1746553535085,SIO 295LS,A00,894015,Staff,5,0,25,20
1746553536109,SIO 295S,A00,894020,Staff,5,0,25,20
1746553537138,SIOC 290S,B01,958918,Merrifield; Mark A,14,0,30,16
1746553538164,SIOC 291S,B01,958922,Gabriel; Corey John,14,0,30,16
1746553539191,SOCI 117,A01,895339,Staff,3,0,5,2
1746553540215,WES 237B,A00,894149,Staff,11,0,20,9
1746553542280,AESE 279B,A00,891859,Staff,13,0,35,22
1746553543305,AIP 197,001,891854,Vespa; Emanuel Ignacio,9999,0,9999,0
1746553544332,ANTH 289S,A00,891856,Gagneux; Pascal,12,0,12,0
1746553545356,BENG 196,001,957946,Engler; Adam J.,9996,0,9999,3
1746553546379,BISP 197,001,959851,Wilhelm; James E.,9998,0,9999,1
1746553547405,CAT 124RS,A01,956906,Staff,6,0,25,19
1746553548429,CAT 125RS,A01,922013,Staff,6,0,25,19
1746553549454,CLRE 250,A00,891860,Morris; Sheldon,9995,0,9999,4
1746553551503,CLRE 251R,A00,907817,Mehta; Ravindra L.,9994,0,9999,5
1746553552527,CLRE 252,A00,891864,Cuomo; Raphael Eduardo,9993,0,9999,6
1746553553552,CLRE 253,A00,891867,Vaida; Florin,9994,0,9999,5
1746553553552,CLRE 253,B00,907819,Staff,9999,0,9999,0
1746553554580,CLRE 259,A00,891868,Patel; Hemal,9998,0,9999,1
1746553555605,CLRE 260,A00,891872,Cuomo; Raphael Eduardo,9999,0,9999,0
1746553556631,CLRE 297,001,891888,Cuomo; Raphael Eduardo,9999,0,9999,0
1746553557655,CSE 191,A00,958773,Minnes Kemp; Mor Mia,9995,0,9999,4
1746553558679,CSE 197,001,959846,Minnes Kemp; Mor Mia,9990,0,9999,9
1746553559705,CSS 201S,A01,892054,Mignozzetti; Umberto,26,0,30,4
1746553560732,CSS 202S,A01,892056,Mignozzetti; Umberto,26,0,30,4
1746553561758,DSC 197,001,956898,Eldridge; Justin Matthew,9997,0,9999,2
1746553562787,DSC 297,001,958000,Mazumdar; Arya,9998,0,9999,1
1746553562787,DSC 297,002,959862,Wang; Yusu,9998,0,9999,1
1746553563815,EAP 100,A00,905686,Staff,9778,0,9999,221
1746553564841,ECE 45,A01,892618,Staff,0,0,65,65
1746553566895,ECE 111,A01,892719,Staff,4,0,65,61
1746553567925,ECE 197,001,957920,Mercier; Patrick Philip,9991,0,9999,8
1746553568950,ECON 178,A01,907814,Zhu; Ying,26,0,35,9
1746553569979,EDS 115,A00,895312,Staff,35,0,45,10
1746553571006,EDS 117,A01,895337,Staff,23,0,30,7
1746553572034,EDS 125,A00,895341,Jones; Gabrielle Anastasia,36,0,45,9
1746553573064,EDS 128A,A01,895459,Fargason; Sharon Gayle,44,0,45,1
1746553574090,EDS 128B,A01,895543,Pappas; Elizabeth,44,0,45,1
1746553575119,EDS 139,A00,897203,Pappas; Elizabeth,44,0,45,1
1746553575119,EDS 139,B00,897209,Fargason; Sharon Gayle,41,0,45,4
1746553576145,EDS 201,A00,895545,Staff,22,0,45,23
1746553577173,EDS 203,A01,895581,Halter; Christopher P.,22,0,45,23
1746553578209,EDS 204R,A01,895625,Heinzman; Erica M.,39,0,45,6
1746553578209,EDS 204R,B01,895693,Halter; Christopher P.,10,0,45,35
1746553579234,EDS 206R,A00,895694,Fargason; Sharon Gayle,1,0,30,29
1746553579234,EDS 206R,B00,895695,Choi; Bailey Miyeon,16,0,30,14
1746553580259,EDS 250,A00,895697,Hemans; Patricia Ann Benitez,22,0,45,23
1746553581286,EDS 281,A00,895701,Meyerott; Theresa Ann,1,0,15,14
1746553582312,EDS 284,A00,895736,Meyerott; Theresa Ann,1,0,15,14
1746553583339,EDS 286,A00,897210,Fine; Sarah,0,0,15,15
1746553584365,EDS 289C,A01,895770,Daly; Alan J.,15,0,15,0
1746553585391,EDS 290,A00,897211,Hofstetter; Carolyn,0,0,15,15
1746553586420,LIGM 5A,A00,896162,Fischer-Grunski; Eva K,13,0,20,7
1746553587447,LIGM 5B,A00,896260,Fischer-Grunski; Eva K,17,0,20,3
1746553588474,LIGM 5C,A00,896308,Fischer-Grunski; Eva K,18,0,20,2
1746553589499,LIIT 5AS,A00,896313,Carnelos; Chiara,18,0,20,2
1746553590526,LIIT 5BS,A00,896416,Carnelos; Chiara,20,0,20,0
1746553591550,LIIT 5CS,A00,896564,Carnelos; Chiara,20,0,20,0
1746553592580,LISP 5A,A00,896588,Munoz Sanchez; Alicia,3,0,20,17
1746553593610,LISP 5B,A00,896653,Munoz Sanchez; Alicia,7,0,20,13
1746553594638,LISP 5C,A00,896655,Munoz Sanchez; Alicia,0,1,20,20
1746553595663,MAE 197,001,957918,Kleissl; Jan,9996,0,9999,3
1746553595663,MAE 197,002,959806,Boechler; Nicholas Sebastia,9998,0,9999,1
1746553595663,MAE 197,003,959852,Mullin; Jennifer S,9998,0,9999,1
1746553596689,MATH 2,A01,957937,Staff,33,0,35,2
1746553597715,MATH 197,001,957876,Kedlaya; Kiran S.,9993,0,9999,6
1746553598739,MCWP 40,A00,892729,Duru; Nur,10,0,20,10
1746553598739,MCWP 40,B00,893304,Montejo; Carolina,14,0,20,6
1746553599767,MCWP 40R,A00,893757,Redela; Pamela Morgan,0,5,20,20
1746553600794,MCWP 50,A00,893758,Morshed; Michael James,0,0,20,20
1746553600794,MCWP 50,B00,893761,Bartulis; Jason Michael,17,0,20,3
1746553601818,MCWP 50R,A00,893766,Compas; Sean Matthew,0,1,20,20
1746553601818,MCWP 50R,B00,893769,Carter; Jennifer A,0,1,20,20
1746553601818,MCWP 50R,C00,893771,Krone; Jarret,0,3,20,20
1746553601818,MCWP 50R,D00,893772,Miller; Elizabeth Deen,0,0,20,20
1746553601818,MCWP 50R,E00,893775,Carter; Andrea L,0,1,20,20
1746553602843,MMW 11R,A01,892721,Herbst; Matthew,11,0,27,16
1746553602843,MMW 11R,A02,892722,Herbst; Matthew,0,0,0,3
1746553603869,MMW 12R,A01,892724,Herbst; Matthew,0,11,16,16
1746553603869,MMW 12R,A02,892725,Herbst; Matthew,0,10,16,16
1746553604896,MMW 13R,A01,892727,Staff,0,4,16,16
1746553604896,MMW 13R,A02,892728,Staff,0,4,16,16
1746553604896,MMW 13R,A03,958032,Staff,0,4,16,16
1746553604896,MMW 13R,A04,958033,Staff,0,4,16,16
1746553604896,MMW 13R,A05,958034,Staff,0,4,16,16
1746553605922,SIO 295LS,A00,894015,Staff,5,0,25,20
1746553606948,SIO 295S,A00,894020,Staff,5,0,25,20
1746553607974,SIOC 290S,B01,958918,Merrifield; Mark A,14,0,30,16
1746553609000,SIOC 291S,B01,958922,Gabriel; Corey John,14,0,30,16
1746553610027,SOCI 117,A01,895339,Staff,3,0,5,2
1746553611053,WES 237B,A00,894149,Staff,11,0,20,9
1746553613115,AESE 279B,A00,891859,Staff,13,0,35,22
1746553614141,AIP 197,001,891854,Vespa; Emanuel Ignacio,9999,0,9999,0
1746553615166,ANTH 289S,A00,891856,Gagneux; Pascal,12,0,12,0
1746553616192,BENG 196,001,957946,Engler; Adam J.,9996,0,9999,3
1746553617221,BISP 197,001,959851,Wilhelm; James E.,9998,0,9999,1
1746553618248,CAT 124RS,A01,956906,Staff,6,0,25,19
1746553619274,CAT 125RS,A01,922013,Staff,6,0,25,19
1746553620302,CLRE 250,A00,891860,Morris; Sheldon,9995,0,9999,4
1746553622357,CLRE 251R,A00,907817,Mehta; Ravindra L.,9994,0,9999,5
1746553623382,CLRE 252,A00,891864,Cuomo; Raphael Eduardo,9993,0,9999,6
1746553624411,CLRE 253,A00,891867,Vaida; Florin,9994,0,9999,5
1746553624411,CLRE 253,B00,907819,Staff,9999,0,9999,0
1746553625436,CLRE 259,A00,891868,Patel; Hemal,9998,0,9999,1
1746553626464,CLRE 260,A00,891872,Cuomo; Raphael Eduardo,9999,0,9999,0
1746553627489,CLRE 297,001,891888,Cuomo; Raphael Eduardo,9999,0,9999,0
1746553628515,CSE 191,A00,958773,Minnes Kemp; Mor Mia,9995,0,9999,4
1746553629541,CSE 197,001,959846,Minnes Kemp; Mor Mia,9990,0,9999,9
1746553630574,CSS 201S,A01,892054,Mignozzetti; Umberto,26,0,30,4
1746553631604,CSS 202S,A01,892056,Mignozzetti; Umberto,26,0,30,4
1746553632628,DSC 197,001,956898,Eldridge; Justin Matthew,9997,0,9999,2
1746553633654,DSC 297,001,958000,Mazumdar; Arya,9998,0,9999,1
1746553633654,DSC 297,002,959862,Wang; Yusu,9998,0,9999,1
1746553634680,EAP 100,A00,905686,Staff,9778,0,9999,221
1746553635705,ECE 45,A01,892618,Staff,0,0,65,65
1746553637758,ECE 111,A01,892719,Staff,4,0,65,61
1746553638783,ECE 197,001,957920,Mercier; Patrick Philip,9991,0,9999,8
1746553639809,ECON 178,A01,907814,Zhu; Ying,26,0,35,9
1746553640835,EDS 115,A00,895312,Staff,35,0,45,10
1746553641860,EDS 117,A01,895337,Staff,23,0,30,7
1746553642886,EDS 125,A00,895341,Jones; Gabrielle Anastasia,36,0,45,9
1746553643911,EDS 128A,A01,895459,Fargason; Sharon Gayle,44,0,45,1
1746553644936,EDS 128B,A01,895543,Pappas; Elizabeth,44,0,45,1
1746553645963,EDS 139,A00,897203,Pappas; Elizabeth,44,0,45,1
1746553645963,EDS 139,B00,897209,Fargason; Sharon Gayle,41,0,45,4
1746553646991,EDS 201,A00,895545,Staff,22,0,45,23
1746553648016,EDS 203,A01,895581,Halter; Christopher P.,22,0,45,23
1746553649044,EDS 204R,A01,895625,Heinzman; Erica M.,39,0,45,6
1746553649044,EDS 204R,B01,895693,Halter; Christopher P.,10,0,45,35
1746553650068,EDS 206R,A00,895694,Fargason; Sharon Gayle,1,0,30,29
1746553650068,EDS 206R,B00,895695,Choi; Bailey Miyeon,16,0,30,14
1746553651094,EDS 250,A00,895697,Hemans; Patricia Ann Benitez,22,0,45,23
1746553652124,EDS 281,A00,895701,Meyerott; Theresa Ann,1,0,15,14
1746553653148,EDS 284,A00,895736,Meyerott; Theresa Ann,1,0,15,14
1746553654175,EDS 286,A00,897210,Fine; Sarah,0,0,15,15
1746553655202,EDS 289C,A01,895770,Daly; Alan J.,15,0,15,0
1746553656227,EDS 290,A00,897211,Hofstetter; Carolyn,0,0,15,15
1746553657253,LIGM 5A,A00,896162,Fischer-Grunski; Eva K,13,0,20,7
1746553658279,LIGM 5B,A00,896260,Fischer-Grunski; Eva K,17,0,20,3
1746553659303,LIGM 5C,A00,896308,Fischer-Grunski; Eva K,18,0,20,2
1746553660330,LIIT 5AS,A00,896313,Carnelos; Chiara,18,0,20,2
1746553661360,LIIT 5BS,A00,896416,Carnelos; Chiara,20,0,20,0
1746553662388,LIIT 5CS,A00,896564,Carnelos; Chiara,20,0,20,0
1746553663413,LISP 5A,A00,896588,Munoz Sanchez; Alicia,3,0,20,17
1746553664438,LISP 5B,A00,896653,Munoz Sanchez; Alicia,7,0,20,13
1746553665467,LISP 5C,A00,896655,Munoz Sanchez; Alicia,0,1,20,20
1746553666491,MAE 197,001,957918,Kleissl; Jan,9996,0,9999,3
1746553666491,MAE 197,002,959806,Boechler; Nicholas Sebastia,9998,0,9999,1
1746553666491,MAE 197,003,959852,Mullin; Jennifer S,9998,0,9999,1
1746553667518,MATH 2,A01,957937,Staff,33,0,35,2
1746553668546,MATH 197,001,957876,Kedlaya; Kiran S.,9993,0,9999,6
1746553669573,MCWP 40,A00,892729,Duru; Nur,10,0,20,10
1746553669573,MCWP 40,B00,893304,Montejo; Carolina,14,0,20,6
1746553670600,MCWP 40R,A00,893757,Redela; Pamela Morgan,0,5,20,20
1746553671626,MCWP 50,A00,893758,Morshed; Michael James,0,0,20,20
1746553671626,MCWP 50,B00,893761,Bartulis; Jason Michael,17,0,20,3
1746553672653,MCWP 50R,A00,893766,Compas; Sean Matthew,0,1,20,20
1746553672653,MCWP 50R,B00,893769,Carter; Jennifer A,0,1,20,20
1746553672653,MCWP 50R,C00,893771,Krone; Jarret,0,3,20,20
1746553672653,MCWP 50R,D00,893772,Miller; Elizabeth Deen,0,0,20,20
1746553672653,MCWP 50R,E00,893775,Carter; Andrea L,0,1,20,20
1746553673680,MMW 11R,A01,892721,Herbst; Matthew,11,0,27,16
1746553673680,MMW 11R,A02,892722,Herbst; Matthew,0,0,0,3
1746553674704,MMW 12R,A01,892724,Herbst; Matthew,0,11,16,16
1746553674704,MMW 12R,A02,892725,Herbst; Matthew,0,10,16,16
1746553675732,MMW 13R,A01,892727,Staff,0,4,16,16
1746553675732,MMW 13R,A02,892728,Staff,0,4,16,16
1746553675732,MMW 13R,A03,958032,Staff,0,4,16,16
1746553675732,MMW 13R,A04,958033,Staff,0,4,16,16
1746553675732,MMW 13R,A05,958034,Staff,0,4,16,16
1746553676760,SIO 295LS,A00,894015,Staff,5,0,25,20
1746553677789,SIO 295S,A00,894020,Staff,5,0,25,20
1746553678815,SIOC 290S,B01,958918,Merrifield; Mark A,14,0,30,16
1746553679841,SIOC 291S,B01,958922,Gabriel; Corey John,14,0,30,16
1746553680865,SOCI 117,A01,895339,Staff,3,0,5,2
1746553681891,WES 237B,A00,894149,Staff,11,0,20,9
1746553683950,AESE 279B,A00,891859,Staff,13,0,35,22
1746553684977,AIP 197,001,891854,Vespa; Emanuel Ignacio,9999,0,9999,0
1746553686001,ANTH 289S,A00,891856,Gagneux; Pascal,12,0,12,0
1746553687027,BENG 196,001,957946,Engler; Adam J.,9996,0,9999,3
1746553688054,BISP 197,001,959851,Wilhelm; James E.,9998,0,9999,1
1746553689078,CAT 124RS,A01,956906,Staff,6,0,25,19
1746553690101,CAT 125RS,A01,922013,Staff,6,0,25,19
1746553691129,CLRE 250,A00,891860,Morris; Sheldon,9995,0,9999,4
1746553693181,CLRE 251R,A00,907817,Mehta; Ravindra L.,9994,0,9999,5
1746553694205,CLRE 252,A00,891864,Cuomo; Raphael Eduardo,9993,0,9999,6
1746553695230,CLRE 253,A00,891867,Vaida; Florin,9994,0,9999,5
1746553695230,CLRE 253,B00,907819,Staff,9999,0,9999,0
1746553696294,CLRE 259,A00,891868,Patel; Hemal,9998,0,9999,1
1746553697318,CLRE 260,A00,891872,Cuomo; Raphael Eduardo,9999,0,9999,0
1746553698341,CLRE 297,001,891888,Cuomo; Raphael Eduardo,9999,0,9999,0
1746553699365,CSE 191,A00,958773,Minnes Kemp; Mor Mia,9995,0,9999,4
1746553700392,CSE 197,001,959846,Minnes Kemp; Mor Mia,9990,0,9999,9
1746553701418,CSS 201S,A01,892054,Mignozzetti; Umberto,26,0,30,4
1746553702443,CSS 202S,A01,892056,Mignozzetti; Umberto,26,0,30,4
1746553703470,DSC 197,001,956898,Eldridge; Justin Matthew,9997,0,9999,2
1746553704495,DSC 297,001,958000,Mazumdar; Arya,9998,0,9999,1
1746553704495,DSC 297,002,959862,Wang; Yusu,9998,0,9999,1
1746553705521,EAP 100,A00,905686,Staff,9778,0,9999,221
1746553706546,ECE 45,A01,892618,Staff,0,0,65,65
1746553708604,ECE 111,A01,892719,Staff,4,0,65,61
1746553709632,ECE 197,001,957920,Mercier; Patrick Philip,9991,0,9999,8
1746553710658,ECON 178,A01,907814,Zhu; Ying,26,0,35,9
1746553711684,EDS 115,A00,895312,Staff,35,0,45,10
1746553712715,EDS 117,A01,895337,Staff,23,0,30,7
1746553713742,EDS 125,A00,895341,Jones; Gabrielle Anastasia,36,0,45,9
1746553714768,EDS 128A,A01,895459,Fargason; Sharon Gayle,44,0,45,1
1746553715793,EDS 128B,A01,895543,Pappas; Elizabeth,44,0,45,1
1746553716823,EDS 139,A00,897203,Pappas; Elizabeth,44,0,45,1
1746553716823,EDS 139,B00,897209,Fargason; Sharon Gayle,41,0,45,4
1746553717849,EDS 201,A00,895545,Staff,22,0,45,23
1746553718875,EDS 203,A01,895581,Halter; Christopher P.,22,0,45,23
1746553719901,EDS 204R,A01,895625,Heinzman; Erica M.,39,0,45,6
1746553719901,EDS 204R,B01,895693,Halter; Christopher P.,10,0,45,35
1746553720934,EDS 206R,A00,895694,Fargason; Sharon Gayle,1,0,30,29
1746553720934,EDS 206R,B00,895695,Choi; Bailey Miyeon,16,0,30,14
1746553721959,EDS 250,A00,895697,Hemans; Patricia Ann Benitez,22,0,45,23
1746553722986,EDS 281,A00,895701,Meyerott; Theresa Ann,1,0,15,14
1746553724011,EDS 284,A00,895736,Meyerott; Theresa Ann,1,0,15,14
1746553725036,EDS 286,A00,897210,Fine; Sarah,0,0,15,15
1746553726061,EDS 289C,A01,895770,Daly; Alan J.,15,0,15,0
1746553727090,EDS 290,A00,897211,Hofstetter; Carolyn,0,0,15,15
1746553728120,LIGM 5A,A00,896162,Fischer-Grunski; Eva K,13,0,20,7
1746553729144,LIGM 5B,A00,896260,Fischer-Grunski; Eva K,17,0,20,3
1746553730174,LIGM 5C,A00,896308,Fischer-Grunski; Eva K,18,0,20,2
1746553731202,LIIT 5AS,A00,896313,Carnelos; Chiara,18,0,20,2
1746553732230,LIIT 5BS,A00,896416,Carnelos; Chiara,20,0,20,0
1746553733255,LIIT 5CS,A00,896564,Carnelos; Chiara,20,0,20,0
1746553734281,LISP 5A,A00,896588,Munoz Sanchez; Alicia,3,0,20,17
1746553735308,LISP 5B,A00,896653,Munoz Sanchez; Alicia,7,0,20,13
1746553736332,LISP 5C,A00,896655,Munoz Sanchez; Alicia,0,1,20,20
1746553737357,MAE 197,001,957918,Kleissl; Jan,9996,0,9999,3
1746553737357,MAE 197,002,959806,Boechler; Nicholas Sebastia,9998,0,9999,1
1746553737357,MAE 197,003,959852,Mullin; Jennifer S,9998,0,9999,1
1746553738381,MATH 2,A01,957937,Staff,33,0,35,2
1746553739408,MATH 197,001,957876,Kedlaya; Kiran S.,9993,0,9999,6
1746553740437,MCWP 40,A00,892729,Duru; Nur,10,0,20,10
1746553740437,MCWP 40,B00,893304,Montejo; Carolina,14,0,20,6
1746553741464,MCWP 40R,A00,893757,Redela; Pamela Morgan,0,5,20,20
1746553742487,MCWP 50,A00,893758,Morshed; Michael James,0,0,20,20
1746553742487,MCWP 50,B00,893761,Bartulis; Jason Michael,17,0,20,3
1746553743516,MCWP 50R,A00,893766,Compas; Sean Matthew,0,1,20,20
1746553743516,MCWP 50R,B00,893769,Carter; Jennifer A,0,1,20,20
1746553743516,MCWP 50R,C00,893771,Krone; Jarret,0,3,20,20
1746553743516,MCWP 50R,D00,893772,Miller; Elizabeth Deen,0,0,20,20
1746553743516,MCWP 50R,E00,893775,Carter; Andrea L,0,1,20,20
1746553744544,MMW 11R,A01,892721,Herbst; Matthew,11,0,27,16
1746553744544,MMW 11R,A02,892722,Herbst; Matthew,0,0,0,3
1746553745574,MMW 12R,A01,892724,Herbst; Matthew,0,11,16,16
1746553745574,MMW 12R,A02,892725,Herbst; Matthew,0,10,16,16
1746553746599,MMW 13R,A01,892727,Staff,0,4,16,16
1746553746599,MMW 13R,A02,892728,Staff,0,4,16,16
1746553746599,MMW 13R,A03,958032,Staff,0,4,16,16
1746553746599,MMW 13R,A04,958033,Staff,0,4,16,16
1746553746599,MMW 13R,A05,958034,Staff,0,4,16,16
1746553747625,SIO 295LS,A00,894015,Staff,5,0,25,20
1746553748650,SIO 295S,A00,894020,Staff,5,0,25,20
1746553749678,SIOC 290S,B01,958918,Merrifield; Mark A,14,0,30,16
1746553750793,SIOC 291S,B01,958922,Gabriel; Corey John,14,0,30,16
1746553751818,SOCI 117,A01,895339,Staff,3,0,5,2
1746553752843,WES 237B,A00,894149,Staff,11,0,20,9
1746553754909,AESE 279B,A00,891859,Staff,13,0,35,22
1746553755932,AIP 197,001,891854,Vespa; Emanuel Ignacio,9999,0,9999,0
1746553756958,ANTH 289S,A00,891856,Gagneux; Pascal,12,0,12,0
1746553757986,BENG 196,001,957946,Engler; Adam J.,9996,0,9999,3
1746553759009,BISP 197,001,959851,Wilhelm; James E.,9998,0,9999,1
1746553760036,CAT 124RS,A01,956906,Staff,6,0,25,19
1746553761061,CAT 125RS,A01,922013,Staff,6,0,25,19
1746553762089,CLRE 250,A00,891860,Morris; Sheldon,9995,0,9999,4
1746553764144,CLRE 251R,A00,907817,Mehta; Ravindra L.,9994,0,9999,5
1746553765170,CLRE 252,A00,891864,Cuomo; Raphael Eduardo,9993,0,9999,6
1746553766197,CLRE 253,A00,891867,Vaida; Florin,9994,0,9999,5
1746553766197,CLRE 253,B00,907819,Staff,9999,0,9999,0
1746553767223,CLRE 259,A00,891868,Patel; Hemal,9998,0,9999,1
1746553768249,CLRE 260,A00,891872,Cuomo; Raphael Eduardo,9999,0,9999,0
1746553769274,CLRE 297,001,891888,Cuomo; Raphael Eduardo,9999,0,9999,0
1746553770299,CSE 191,A00,958773,Minnes Kemp; Mor Mia,9995,0,9999,4
1746553771327,CSE 197,001,959846,Minnes Kemp; Mor Mia,9990,0,9999,9
1746553772356,CSS 201S,A01,892054,Mignozzetti; Umberto,26,0,30,4
1746553773381,CSS 202S,A01,892056,Mignozzetti; Umberto,26,0,30,4
1746553774407,DSC 197,001,956898,Eldridge; Justin Matthew,9997,0,9999,2
1746553775431,DSC 297,001,958000,Mazumdar; Arya,9998,0,9999,1
1746553775431,DSC 297,002,959862,Wang; Yusu,9998,0,9999,1
1746553776457,EAP 100,A00,905686,Staff,9778,0,9999,221
1746553777487,ECE 45,A01,892618,Staff,0,0,65,65
1746553779538,ECE 111,A01,892719,Staff,4,0,65,61
1746553780566,ECE 197,001,957920,Mercier; Patrick Philip,9991,0,9999,8
1746553781590,ECON 178,A01,907814,Zhu; Ying,26,0,35,9
1746553782616,EDS 115,A00,895312,Staff,35,0,45,10
1746553783640,EDS 117,A01,895337,Staff,23,0,30,7
1746553784665,EDS 125,A00,895341,Jones; Gabrielle Anastasia,36,0,45,9
1746553785690,EDS 128A,A01,895459,Fargason; Sharon Gayle,44,0,45,1
1746553786715,EDS 128B,A01,895543,Pappas; Elizabeth,44,0,45,1
1746553787742,EDS 139,A00,897203,Pappas; Elizabeth,44,0,45,1
1746553787742,EDS 139,B00,897209,Fargason; Sharon Gayle,41,0,45,4
1746553788768,EDS 201,A00,895545,Staff,22,0,45,23
1746553789794,EDS 203,A01,895581,Halter; Christopher P.,22,0,45,23
1746553790823,EDS 204R,A01,895625,Heinzman; Erica M.,39,0,45,6
1746553790823,EDS 204R,B01,895693,Halter; Christopher P.,10,0,45,35
1746553791850,EDS 206R,A00,895694,Fargason; Sharon Gayle,1,0,30,29
1746553791850,EDS 206R,B00,895695,Choi; Bailey Miyeon,16,0,30,14
1746553792875,EDS 250,A00,895697,Hemans; Patricia Ann Benitez,22,0,45,23
1746553793902,EDS 281,A00,895701,Meyerott; Theresa Ann,1,0,15,14
1746553794926,EDS 284,A00,895736,Meyerott; Theresa Ann,1,0,15,14
1746553795951,EDS 286,A00,897210,Fine; Sarah,0,0,15,15
1746553796977,EDS 289C,A01,895770,Daly; Alan J.,15,0,15,0
1746553798003,EDS 290,A00,897211,Hofstetter; Carolyn,0,0,15,15
1746553799033,LIGM 5A,A00,896162,Fischer-Grunski; Eva K,13,0,20,7
1746553800058,LIGM 5B,A00,896260,Fischer-Grunski; Eva K,17,0,20,3
1746553801086,LIGM 5C,A00,896308,Fischer-Grunski; Eva K,18,0,20,2
1746553802115,LIIT 5AS,A00,896313,Carnelos; Chiara,18,0,20,2
1746553803142,LIIT 5BS,A00,896416,Carnelos; Chiara,20,0,20,0
1746553804171,LIIT 5CS,A00,896564,Carnelos; Chiara,20,0,20,0
1746553805199,LISP 5A,A00,896588,Munoz Sanchez; Alicia,3,0,20,17
1746553806226,LISP 5B,A00,896653,Munoz Sanchez; Alicia,7,0,20,13
1746553807258,LISP 5C,A00,896655,Munoz Sanchez; Alicia,0,1,20,20
1746553808284,MAE 197,001,957918,Kleissl; Jan,9996,0,9999,3
1746553808284,MAE 197,002,959806,Boechler; Nicholas Sebastia,9998,0,9999,1
1746553808284,MAE 197,003,959852,Mullin; Jennifer S,9998,0,9999,1
1746553809313,MATH 2,A01,957937,Staff,33,0,35,2
1746553810337,MATH 197,001,957876,Kedlaya; Kiran S.,9993,0,9999,6
1746553811369,MCWP 40,A00,892729,Duru; Nur,10,0,20,10
1746553811369,MCWP 40,B00,893304,Montejo; Carolina,14,0,20,6
1746553812411,MCWP 40R,A00,893757,Redela; Pamela Morgan,0,5,20,20
1746553813436,MCWP 50,A00,893758,Morshed; Michael James,0,0,20,20
1746553813436,MCWP 50,B00,893761,Bartulis; Jason Michael,17,0,20,3
1746553814461,MCWP 50R,A00,893766,Compas; Sean Matthew,0,1,20,20
1746553814461,MCWP 50R,B00,893769,Carter; Jennifer A,0,1,20,20
1746553814461,MCWP 50R,C00,893771,Krone; Jarret,0,3,20,20
1746553814461,MCWP 50R,D00,893772,Miller; Elizabeth Deen,0,0,20,20
1746553814461,MCWP 50R,E00,893775,Carter; Andrea L,0,1,20,20
1746553815486,MMW 11R,A01,892721,Herbst; Matthew,11,0,27,16
1746553815486,MMW 11R,A02,892722,Herbst; Matthew,0,0,0,3
1746553816510,MMW 12R,A01,892724,Herbst; Matthew,0,11,16,16
1746553816510,MMW 12R,A02,892725,Herbst; Matthew,0,10,16,16
1746553817537,MMW 13R,A01,892727,Staff,0,4,16,16
1746553817537,MMW 13R,A02,892728,Staff,0,4,16,16
1746553817537,MMW 13R,A03,958032,Staff,0,4,16,16
1746553817537,MMW 13R,A04,958033,Staff,0,4,16,16
1746553817537,MMW 13R,A05,958034,Staff,0,4,16,16
1746553818561,SIO 295LS,A00,894015,Staff,5,0,25,20
1746553819586,SIO 295S,A00,894020,Staff,5,0,25,20
1746553820611,SIOC 290S,B01,958918,Merrifield; Mark A,14,0,30,16
1746553821637,SIOC 291S,B01,958922,Gabriel; Corey John,14,0,30,16
1746553822666,SOCI 117,A01,895339,Staff,3,0,5,2
1746553823694,WES 237B,A00,894149,Staff,11,0,20,9
1746553825974,AESE 279B,A00,891859,Staff,13,0,35,22
1746553827000,AIP 197,001,891854,Vespa; Emanuel Ignacio,9999,0,9999,0
1746553828025,ANTH 289S,A00,891856,Gagneux; Pascal,12,0,12,0
1746553829053,BENG 196,001,957946,Engler; Adam J.,9996,0,9999,3
1746553830077,BISP 197,001,959851,Wilhelm; James E.,9998,0,9999,1
1746553831102,CAT 124RS,A01,956906,Staff,6,0,25,19
1746553832125,CAT 125RS,A01,922013,Staff,6,0,25,19
1746553833149,CLRE 250,A00,891860,Morris; Sheldon,9995,0,9999,4
1746553835201,CLRE 251R,A00,907817,Mehta; Ravindra L.,9994,0,9999,5
1746553836226,CLRE 252,A00,891864,Cuomo; Raphael Eduardo,9993,0,9999,6
1746553837253,CLRE 253,A00,891867,Vaida; Florin,9994,0,9999,5
1746553837253,CLRE 253,B00,907819,Staff,9999,0,9999,0
1746553838282,CLRE 259,A00,891868,Patel; Hemal,9998,0,9999,1
1746553839307,CLRE 260,A00,891872,Cuomo; Raphael Eduardo,9999,0,9999,0
1746553840332,CLRE 297,001,891888,Cuomo; Raphael Eduardo,9999,0,9999,0
1746553841357,CSE 191,A00,958773,Minnes Kemp; Mor Mia,9995,0,9999,4
1746553842384,CSE 197,001,959846,Minnes Kemp; Mor Mia,9990,0,9999,9
1746553843413,CSS 201S,A01,892054,Mignozzetti; Umberto,26,0,30,4
1746553844439,CSS 202S,A01,892056,Mignozzetti; Umberto,26,0,30,4
1746553845465,DSC 197,001,956898,Eldridge; Justin Matthew,9997,0,9999,2
1746553846494,DSC 297,001,958000,Mazumdar; Arya,9998,0,9999,1
1746553846494,DSC 297,002,959862,Wang; Yusu,9998,0,9999,1
1746553847558,EAP 100,A00,905686,Staff,9778,0,9999,221
1746553848584,ECE 45,A01,892618,Staff,0,0,65,65
1746553850635,ECE 111,A01,892719,Staff,4,0,65,61
1746553851664,ECE 197,001,957920,Mercier; Patrick Philip,9991,0,9999,8
1746553852690,ECON 178,A01,907814,Zhu; Ying,26,0,35,9
1746553853715,EDS 115,A00,895312,Staff,35,0,45,10
1746553854742,EDS 117,A01,895337,Staff,23,0,30,7
1746553855768,EDS 125,A00,895341,Jones; Gabrielle Anastasia,36,0,45,9
1746553856794,EDS 128A,A01,895459,Fargason; Sharon Gayle,44,0,45,1
1746553857818,EDS 128B,A01,895543,Pappas; Elizabeth,44,0,45,1
1746553858844,EDS 139,A00,897203,Pappas; Elizabeth,44,0,45,1
1746553858844,EDS 139,B00,897209,Fargason; Sharon Gayle,41,0,45,4
1746553859872,EDS 201,A00,895545,Staff,22,0,45,23
1746553860897,EDS 203,A01,895581,Halter; Christopher P.,22,0,45,23
1746553861926,EDS 204R,A01,895625,Heinzman; Erica M.,39,0,45,6
1746553861926,EDS 204R,B01,895693,Halter; Christopher P.,10,0,45,35
1746553862953,EDS 206R,A00,895694,Fargason; Sharon Gayle,1,0,30,29
1746553862953,EDS 206R,B00,895695,Choi; Bailey Miyeon,16,0,30,14
1746553863981,EDS 250,A00,895697,Hemans; Patricia Ann Benitez,22,0,45,23
1746553865012,EDS 281,A00,895701,Meyerott; Theresa Ann,1,0,15,14
1746553866037,EDS 284,A00,895736,Meyerott; Theresa Ann,1,0,15,14
1746553867062,EDS 286,A00,897210,Fine; Sarah,0,0,15,15
1746553868086,EDS 289C,A01,895770,Daly; Alan J.,15,0,15,0
1746553869112,EDS 290,A00,897211,Hofstetter; Carolyn,0,0,15,15
1746553870139,LIGM 5A,A00,896162,Fischer-Grunski; Eva K,13,0,20,7
1746553871166,LIGM 5B,A00,896260,Fischer-Grunski; Eva K,17,0,20,3
1746553872191,LIGM 5C,A00,896308,Fischer-Grunski; Eva K,18,0,20,2
1746553873217,LIIT 5AS,A00,896313,Carnelos; Chiara,18,0,20,2
1746553874244,LIIT 5BS,A00,896416,Carnelos; Chiara,20,0,20,0
1746553875269,LIIT 5CS,A00,896564,Carnelos; Chiara,20,0,20,0
1746553876297,LISP 5A,A00,896588,Munoz Sanchez; Alicia,3,0,20,17
1746553877322,LISP 5B,A00,896653,Munoz Sanchez; Alicia,7,0,20,13
1746553878351,LISP 5C,A00,896655,Munoz Sanchez; Alicia,0,1,20,20
1746553879377,MAE 197,001,957918,Kleissl; Jan,9996,0,9999,3
1746553879377,MAE 197,002,959806,Boechler; Nicholas Sebastia,9998,0,9999,1
1746553879377,MAE 197,003,959852,Mullin; Jennifer S,9998,0,9999,1
1746553880401,MATH 2,A01,957937,Staff,33,0,35,2
1746553881430,MATH 197,001,957876,Kedlaya; Kiran S.,9993,0,9999,6
1746553882459,MCWP 40,A00,892729,Duru; Nur,10,0,20,10
1746553882459,MCWP 40,B00,893304,Montejo; Carolina,14,0,20,6
1746553883498,MCWP 40R,A00,893757,Redela; Pamela Morgan,0,5,20,20
1746553884523,MCWP 50,A00,893758,Morshed; Michael James,0,0,20,20
1746553884523,MCWP 50,B00,893761,Bartulis; Jason Michael,17,0,20,3
1746553885549,MCWP 50R,A00,893766,Compas; Sean Matthew,0,1,20,20
1746553885549,MCWP 50R,B00,893769,Carter; Jennifer A,0,1,20,20
1746553885549,MCWP 50R,C00,893771,Krone; Jarret,0,3,20,20
1746553885549,MCWP 50R,D00,893772,Miller; Elizabeth Deen,0,0,20,20
1746553885549,MCWP 50R,E00,893775,Carter; Andrea L,0,1,20,20
1746553886576,MMW 11R,A01,892721,Herbst; Matthew,11,0,27,16
1746553886576,MMW 11R,A02,892722,Herbst; Matthew,0,0,0,3
1746553887603,MMW 12R,A01,892724,Herbst; Matthew,0,11,16,16
1746553887603,MMW 12R,A02,892725,Herbst; Matthew,0,10,16,16
1746553888629,MMW 13R,A01,892727,Staff,0,4,16,16
1746553888629,MMW 13R,A02,892728,Staff,0,4,16,16
1746553888629,MMW 13R,A03,958032,Staff,0,4,16,16
1746553888629,MMW 13R,A04,958033,Staff,0,4,16,16
1746553888629,MMW 13R,A05,958034,Staff,0,4,16,16
1746553889653,SIO 295LS,A00,894015,Staff,5,0,25,20
1746553890677,SIO 295S,A00,894020,Staff,5,0,25,20
1746553891703,SIOC 290S,B01,958918,Merrifield; Mark A,14,0,30,16
1746553892732,SIOC 291S,B01,958922,Gabriel; Corey John,14,0,30,16
1746553893757,SOCI 117,A01,895339,Staff,3,0,5,2
1746553894784,WES 237B,A00,894149,Staff,11,0,20,9
1746553896846,AESE 279B,A00,891859,Staff,13,0,35,22
1746553897874,AIP 197,001,891854,Vespa; Emanuel Ignacio,9999,0,9999,0
1746553898900,ANTH 289S,A00,891856,Gagneux; Pascal,12,0,12,0
1746553899924,BENG 196,001,957946,Engler; Adam J.,9996,0,9999,3
1746553900953,BISP 197,001,959851,Wilhelm; James E.,9998,0,9999,1
1746553901977,CAT 124RS,A01,956906,Staff,6,0,25,19
1746553903004,CAT 125RS,A01,922013,Staff,6,0,25,19
1746553904032,CLRE 250,A00,891860,Morris; Sheldon,9995,0,9999,4
1746553906084,CLRE 251R,A00,907817,Mehta; Ravindra L.,9994,0,9999,5
1746553907109,CLRE 252,A00,891864,Cuomo; Raphael Eduardo,9993,0,9999,6
1746553908137,CLRE 253,A00,891867,Vaida; Florin,9994,0,9999,5
1746553908137,CLRE 253,B00,907819,Staff,9999,0,9999,0
1746553909163,CLRE 259,A00,891868,Patel; Hemal,9998,0,9999,1
1746553910187,CLRE 260,A00,891872,Cuomo; Raphael Eduardo,9999,0,9999,0
1746553911214,CLRE 297,001,891888,Cuomo; Raphael Eduardo,9999,0,9999,0
1746553912240,CSE 191,A00,958773,Minnes Kemp; Mor Mia,9995,0,9999,4
1746553913267,CSE 197,001,959846,Minnes Kemp; Mor Mia,9990,0,9999,9
1746553914295,CSS 201S,A01,892054,Mignozzetti; Umberto,26,0,30,4
1746553915324,CSS 202S,A01,892056,Mignozzetti; Umberto,26,0,30,4
1746553916354,DSC 197,001,956898,Eldridge; Justin Matthew,9997,0,9999,2
1746553917378,DSC 297,001,958000,Mazumdar; Arya,9998,0,9999,1
1746553917378,DSC 297,002,959862,Wang; Yusu,9998,0,9999,1
1746553918402,EAP 100,A00,905686,Staff,9778,0,9999,221
1746553919426,ECE 45,A01,892618,Staff,0,0,65,65
1746553921475,ECE 111,A01,892719,Staff,4,0,65,61
1746553922500,ECE 197,001,957920,Mercier; Patrick Philip,9991,0,9999,8
1746553923524,ECON 178,A01,907814,Zhu; Ying,26,0,35,9
1746553924550,EDS 115,A00,895312,Staff,35,0,45,10
1746553925575,EDS 117,A01,895337,Staff,23,0,30,7
1746553926606,EDS 125,A00,895341,Jones; Gabrielle Anastasia,36,0,45,9
1746553927632,EDS 128A,A01,895459,Fargason; Sharon Gayle,44,0,45,1
1746553928661,EDS 128B,A01,895543,Pappas; Elizabeth,44,0,45,1
1746553929687,EDS 139,A00,897203,Pappas; Elizabeth,44,0,45,1
1746553929687,EDS 139,B00,897209,Fargason; Sharon Gayle,41,0,45,4
1746553930713,EDS 201,A00,895545,Staff,22,0,45,23
1746553931738,EDS 203,A01,895581,Halter; Christopher P.,22,0,45,23
1746553932765,EDS 204R,A01,895625,Heinzman; Erica M.,39,0,45,6
1746553932765,EDS 204R,B01,895693,Halter; Christopher P.,10,0,45,35
1746553933793,EDS 206R,A00,895694,Fargason; Sharon Gayle,1,0,30,29
1746553933793,EDS 206R,B00,895695,Choi; Bailey Miyeon,16,0,30,14
1746553934818,EDS 250,A00,895697,Hemans; Patricia Ann Benitez,22,0,45,23
1746553935844,EDS 281,A00,895701,Meyerott; Theresa Ann,1,0,15,14
1746553936868,EDS 284,A00,895736,Meyerott; Theresa Ann,1,0,15,14
1746553937896,EDS 286,A00,897210,Fine; Sarah,0,0,15,15
1746553938924,EDS 289C,A01,895770,Daly; Alan J.,15,0,15,0
1746553939950,EDS 290,A00,897211,Hofstetter; Carolyn,0,0,15,15
1746553940977,LIGM 5A,A00,896162,Fischer-Grunski; Eva K,13,0,20,7
1746553942002,LIGM 5B,A00,896260,Fischer-Grunski; Eva K,17,0,20,3
1746553943030,LIGM 5C,A00,896308,Fischer-Grunski; Eva K,18,0,20,2
1746553944057,LIIT 5AS,A00,896313,Carnelos; Chiara,18,0,20,2
1746553945082,LIIT 5BS,A00,896416,Carnelos; Chiara,20,0,20,0
1746553946109,LIIT 5CS,A00,896564,Carnelos; Chiara,20,0,20,0
1746553947138,LISP 5A,A00,896588,Munoz Sanchez; Alicia,3,0,20,17
1746553948163,LISP 5B,A00,896653,Munoz Sanchez; Alicia,7,0,20,13
1746553949188,LISP 5C,A00,896655,Munoz Sanchez; Alicia,0,1,20,20
1746553950213,MAE 197,001,957918,Kleissl; Jan,9996,0,9999,3
1746553950213,MAE 197,002,959806,Boechler; Nicholas Sebastia,9998,0,9999,1
1746553950213,MAE 197,003,959852,Mullin; Jennifer S,9998,0,9999,1
1746553951291,MATH 2,A01,957937,Staff,33,0,35,2
1746553952316,MATH 197,001,957876,Kedlaya; Kiran S.,9993,0,9999,6
1746553953341,MCWP 40,A00,892729,Duru; Nur,10,0,20,10
1746553953341,MCWP 40,B00,893304,Montejo; Carolina,14,0,20,6
1746553954367,MCWP 40R,A00,893757,Redela; Pamela Morgan,0,5,20,20
1746553955392,MCWP 50,A00,893758,Morshed; Michael James,0,0,20,20
1746553955392,MCWP 50,B00,893761,Bartulis; Jason Michael,17,0,20,3
1746553956417,MCWP 50R,A00,893766,Compas; Sean Matthew,0,1,20,20
1746553956417,MCWP 50R,B00,893769,Carter; Jennifer A,0,1,20,20
1746553956417,MCWP 50R,C00,893771,Krone; Jarret,0,3,20,20
1746553956417,MCWP 50R,D00,893772,Miller; Elizabeth Deen,0,0,20,20
1746553956417,MCWP 50R,E00,893775,Carter; Andrea L,0,1,20,20
1746553957443,MMW 11R,A01,892721,Herbst; Matthew,11,0,27,16
1746553957443,MMW 11R,A02,892722,Herbst; Matthew,0,0,0,3
1746553958469,MMW 12R,A01,892724,Herbst; Matthew,0,11,16,16
1746553958469,MMW 12R,A02,892725,Herbst; Matthew,0,10,16,16
1746553959493,MMW 13R,A01,892727,Staff,0,4,16,16
1746553959493,MMW 13R,A02,892728,Staff,0,4,16,16
1746553959493,MMW 13R,A03,958032,Staff,0,4,16,16
1746553959493,MMW 13R,A04,958033,Staff,0,4,16,16
1746553959493,MMW 13R,A05,958034,Staff,0,4,16,16
1746553960519,SIO 295LS,A00,894015,Staff,5,0,25,20
1746553961546,SIO 295S,A00,894020,Staff,5,0,25,20
1746553962574,SIOC 290S,B01,958918,Merrifield; Mark A,14,0,30,16
1746553963600,SIOC 291S,B01,958922,Gabriel; Corey John,14,0,30,16
1746553964625,SOCI 117,A01,895339,Staff,3,0,5,2
1746553965651,WES 237B,A00,894149,Staff,11,0,20,9
1746553967719,AESE 279B,A00,891859,Staff,13,0,35,22
1746553968745,AIP 197,001,891854,Vespa; Emanuel Ignacio,9999,0,9999,0
1746553969770,ANTH 289S,A00,891856,Gagneux; Pascal,12,0,12,0
1746553970794,BENG 196,001,957946,Engler; Adam J.,9996,0,9999,3
1746553971821,BISP 197,001,959851,Wilhelm; James E.,9998,0,9999,1
1746553972845,CAT 124RS,A01,956906,Staff,6,0,25,19
1746553973871,CAT 125RS,A01,922013,Staff,6,0,25,19
1746553974897,CLRE 250,A00,891860,Morris; Sheldon,9995,0,9999,4
1746553976947,CLRE 251R,A00,907817,Mehta; Ravindra L.,9994,0,9999,5
1746553977973,CLRE 252,A00,891864,Cuomo; Raphael Eduardo,9993,0,9999,6
1746553979001,CLRE 253,A00,891867,Vaida; Florin,9994,0,9999,5
1746553979001,CLRE 253,B00,907819,Staff,9999,0,9999,0
1746553980029,CLRE 259,A00,891868,Patel; Hemal,9998,0,9999,1
1746553981056,CLRE 260,A00,891872,Cuomo; Raphael Eduardo,9999,0,9999,0
1746553982081,CLRE 297,001,891888,Cuomo; Raphael Eduardo,9999,0,9999,0
1746553983107,CSE 191,A00,958773,Minnes Kemp; Mor Mia,9995,0,9999,4
1746553984134,CSE 197,001,959846,Minnes Kemp; Mor Mia,9990,0,9999,9
1746553985162,CSS 201S,A01,892054,Mignozzetti; Umberto,26,0,30,4
1746553986193,CSS 202S,A01,892056,Mignozzetti; Umberto,26,0,30,4
1746553987217,DSC 197,001,956898,Eldridge; Justin Matthew,9997,0,9999,2
1746553988242,DSC 297,001,958000,Mazumdar; Arya,9998,0,9999,1
1746553988242,DSC 297,002,959862,Wang; Yusu,9998,0,9999,1
1746553989267,EAP 100,A00,905686,Staff,9778,0,9999,221
1746553990295,ECE 45,A01,892618,Staff,0,0,65,65
1746553992344,ECE 111,A01,892719,Staff,4,0,65,61
1746553993368,ECE 197,001,957920,Mercier; Patrick Philip,9991,0,9999,8
1746553994397,ECON 178,A01,907814,Zhu; Ying,26,0,35,9
1746553995421,EDS 115,A00,895312,Staff,35,0,45,10
1746553996449,EDS 117,A01,895337,Staff,23,0,30,7
1746553997474,EDS 125,A00,895341,Jones; Gabrielle Anastasia,36,0,45,9
1746553998499,EDS 128A,A01,895459,Fargason; Sharon Gayle,44,0,45,1
1746553999524,EDS 128B,A01,895543,Pappas; Elizabeth,44,0,45,1
1746554000548,EDS 139,A00,897203,Pappas; Elizabeth,44,0,45,1
1746554000548,EDS 139,B00,897209,Fargason; Sharon Gayle,41,0,45,4
1746554001575,EDS 201,A00,895545,Staff,22,0,45,23
1746554002600,EDS 203,A01,895581,Halter; Christopher P.,22,0,45,23
1746554003625,EDS 204R,A01,895625,Heinzman; Erica M.,39,0,45,6
1746554003625,EDS 204R,B01,895693,Halter; Christopher P.,10,0,45,35
1746554004649,EDS 206R,A00,895694,Fargason; Sharon Gayle,1,0,30,29
1746554004649,EDS 206R,B00,895695,Choi; Bailey Miyeon,16,0,30,14
1746554005676,EDS 250,A00,895697,Hemans; Patricia Ann Benitez,22,0,45,23
1746554006699,EDS 281,A00,895701,Meyerott; Theresa Ann,1,0,15,14
1746554007725,EDS 284,A00,895736,Meyerott; Theresa Ann,1,0,15,14
1746554008755,EDS 286,A00,897210,Fine; Sarah,0,0,15,15
1746554009780,EDS 289C,A01,895770,Daly; Alan J.,15,0,15,0
1746554010806,EDS 290,A00,897211,Hofstetter; Carolyn,0,0,15,15
1746554011836,LIGM 5A,A00,896162,Fischer-Grunski; Eva K,13,0,20,7
1746554012863,LIGM 5B,A00,896260,Fischer-Grunski; Eva K,17,0,20,3
1746554013890,LIGM 5C,A00,896308,Fischer-Grunski; Eva K,18,0,20,2
1746554014919,LIIT 5AS,A00,896313,Carnelos; Chiara,18,0,20,2
1746554015946,LIIT 5BS,A00,896416,Carnelos; Chiara,20,0,20,0
1746554016972,LIIT 5CS,A00,896564,Carnelos; Chiara,20,0,20,0
1746554017997,LISP 5A,A00,896588,Munoz Sanchez; Alicia,3,0,20,17
1746554019025,LISP 5B,A00,896653,Munoz Sanchez; Alicia,7,0,20,13
1746554020053,LISP 5C,A00,896655,Munoz Sanchez; Alicia,0,1,20,20
1746554021079,MAE 197,001,957918,Kleissl; Jan,9996,0,9999,3
1746554021079,MAE 197,002,959806,Boechler; Nicholas Sebastia,9998,0,9999,1
1746554021079,MAE 197,003,959852,Mullin; Jennifer S,9998,0,9999,1
1746554022106,MATH 2,A01,957937,Staff,33,0,35,2
1746554023132,MATH 197,001,957876,Kedlaya; Kiran S.,9993,0,9999,6
1746554024158,MCWP 40,A00,892729,Duru; Nur,10,0,20,10
1746554024158,MCWP 40,B00,893304,Montejo; Carolina,14,0,20,6
1746554025186,MCWP 40R,A00,893757,Redela; Pamela Morgan,0,5,20,20
1746554026213,MCWP 50,A00,893758,Morshed; Michael James,0,0,20,20
1746554026213,MCWP 50,B00,893761,Bartulis; Jason Michael,17,0,20,3
1746554027239,MCWP 50R,A00,893766,Compas; Sean Matthew,0,1,20,20
1746554027239,MCWP 50R,B00,893769,Carter; Jennifer A,0,1,20,20
1746554027239,MCWP 50R,C00,893771,Krone; Jarret,0,3,20,20
1746554027239,MCWP 50R,D00,893772,Miller; Elizabeth Deen,0,0,20,20
1746554027239,MCWP 50R,E00,893775,Carter; Andrea L,0,1,20,20
1746554028267,MMW 11R,A01,892721,Herbst; Matthew,11,0,27,16
1746554028267,MMW 11R,A02,892722,Herbst; Matthew,0,0,0,3
1746554029293,MMW 12R,A01,892724,Herbst; Matthew,0,11,16,16
1746554029293,MMW 12R,A02,892725,Herbst; Matthew,0,10,16,16
1746554030320,MMW 13R,A01,892727,Staff,0,4,16,16
1746554030320,MMW 13R,A02,892728,Staff,0,4,16,16
1746554030320,MMW 13R,A03,958032,Staff,0,4,16,16
1746554030320,MMW 13R,A04,958033,Staff,0,4,16,16
1746554030320,MMW 13R,A05,958034,Staff,0,4,16,16
1746554031347,SIO 295LS,A00,894015,Staff,5,0,25,20
1746554032371,SIO 295S,A00,894020,Staff,5,0,25,20
1746554033399,SIOC 290S,B01,958918,Merrifield; Mark A,14,0,30,16
1746554034430,SIOC 291S,B01,958922,Gabriel; Corey John,14,0,30,16
1746554035457,SOCI 117,A01,895339,Staff,3,0,5,2
1746554036483,WES 237B,A00,894149,Staff,11,0,20,9
1746554038553,AESE 279B,A00,891859,Staff,13,0,35,22
1746554039580,AIP 197,001,891854,Vespa; Emanuel Ignacio,9999,0,9999,0
1746554040605,ANTH 289S,A00,891856,Gagneux; Pascal,12,0,12,0
1746554041630,BENG 196,001,957946,Engler; Adam J.,9996,0,9999,3
1746554042655,BISP 197,001,959851,Wilhelm; James E.,9998,0,9999,1
1746554043682,CAT 124RS,A01,956906,Staff,6,0,25,19
1746554044709,CAT 125RS,A01,922013,Staff,6,0,25,19
1746554045736,CLRE 250,A00,891860,Morris; Sheldon,9995,0,9999,4
1746554047786,CLRE 251R,A00,907817,Mehta; Ravindra L.,9994,0,9999,5
1746554048812,CLRE 252,A00,891864,Cuomo; Raphael Eduardo,9993,0,9999,6
1746554049841,CLRE 253,A00,891867,Vaida; Florin,9994,0,9999,5
1746554049841,CLRE 253,B00,907819,Staff,9999,0,9999,0
1746554050866,CLRE 259,A00,891868,Patel; Hemal,9998,0,9999,1
1746554051892,CLRE 260,A00,891872,Cuomo; Raphael Eduardo,9999,0,9999,0
1746554052915,CLRE 297,001,891888,Cuomo; Raphael Eduardo,9999,0,9999,0
1746554053940,CSE 191,A00,958773,Minnes Kemp; Mor Mia,9995,0,9999,4
1746554054969,CSE 197,001,959846,Minnes Kemp; Mor Mia,9990,0,9999,9
1746554055996,CSS 201S,A01,892054,Mignozzetti; Umberto,26,0,30,4
1746554057023,CSS 202S,A01,892056,Mignozzetti; Umberto,26,0,30,4
1746554058049,DSC 197,001,956898,Eldridge; Justin Matthew,9997,0,9999,2
1746554059077,DSC 297,001,958000,Mazumdar; Arya,9998,0,9999,1
1746554059077,DSC 297,002,959862,Wang; Yusu,9998,0,9999,1
1746554060102,EAP 100,A00,905686,Staff,9778,0,9999,221
1746554061132,ECE 45,A01,892618,Staff,0,0,65,65
1746554063184,ECE 111,A01,892719,Staff,4,0,65,61
1746554064208,ECE 197,001,957920,Mercier; Patrick Philip,9991,0,9999,8
1746554065236,ECON 178,A01,907814,Zhu; Ying,26,0,35,9
1746554066263,EDS 115,A00,895312,Staff,35,0,45,10
1746554067291,EDS 117,A01,895337,Staff,23,0,30,7
1746554068315,EDS 125,A00,895341,Jones; Gabrielle Anastasia,36,0,45,9
1746554069343,EDS 128A,A01,895459,Fargason; Sharon Gayle,44,0,45,1
1746554070373,EDS 128B,A01,895543,Pappas; Elizabeth,44,0,45,1
1746554071399,EDS 139,A00,897203,Pappas; Elizabeth,44,0,45,1
1746554071399,EDS 139,B00,897209,Fargason; Sharon Gayle,41,0,45,4
1746554072429,EDS 201,A00,895545,Staff,22,0,45,23
1746554073453,EDS 203,A01,895581,Halter; Christopher P.,22,0,45,23
1746554074478,EDS 204R,A01,895625,Heinzman; Erica M.,39,0,45,6
1746554074478,EDS 204R,B01,895693,Halter; Christopher P.,10,0,45,35
1746554075506,EDS 206R,A00,895694,Fargason; Sharon Gayle,1,0,30,29
1746554075506,EDS 206R,B00,895695,Choi; Bailey Miyeon,16,0,30,14
1746554076531,EDS 250,A00,895697,Hemans; Patricia Ann Benitez,22,0,45,23
1746554077556,EDS 281,A00,895701,Meyerott; Theresa Ann,1,0,15,14
1746554078582,EDS 284,A00,895736,Meyerott; Theresa Ann,1,0,15,14
1746554079607,EDS 286,A00,897210,Fine; Sarah,0,0,15,15
1746554080632,EDS 289C,A01,895770,Daly; Alan J.,15,0,15,0
1746554081657,EDS 290,A00,897211,Hofstetter; Carolyn,0,0,15,15
1746554082686,LIGM 5A,A00,896162,Fischer-Grunski; Eva K,13,0,20,7
1746554083713,LIGM 5B,A00,896260,Fischer-Grunski; Eva K,17,0,20,3
1746554084738,LIGM 5C,A00,896308,Fischer-Grunski; Eva K,18,0,20,2
1746554085767,LIIT 5AS,A00,896313,Carnelos; Chiara,18,0,20,2
1746554086790,LIIT 5BS,A00,896416,Carnelos; Chiara,20,0,20,0
1746554087819,LIIT 5CS,A00,896564,Carnelos; Chiara,20,0,20,0
1746554088848,LISP 5A,A00,896588,Munoz Sanchez; Alicia,3,0,20,17
1746554089877,LISP 5B,A00,896653,Munoz Sanchez; Alicia,7,0,20,13
1746554090903,LISP 5C,A00,896655,Munoz Sanchez; Alicia,0,1,20,20
1746554091933,MAE 197,001,957918,Kleissl; Jan,9996,0,9999,3
1746554091933,MAE 197,002,959806,Boechler; Nicholas Sebastia,9998,0,9999,1
1746554091933,MAE 197,003,959852,Mullin; Jennifer S,9998,0,9999,1
1746554092958,MATH 2,A01,957937,Staff,33,0,35,2
1746554093983,MATH 197,001,957876,Kedlaya; Kiran S.,9993,0,9999,6
1746554095008,MCWP 40,A00,892729,Duru; Nur,10,0,20,10
1746554095008,MCWP 40,B00,893304,Montejo; Carolina,14,0,20,6
1746554096032,MCWP 40R,A00,893757,Redela; Pamela Morgan,0,5,20,20
1746554097059,MCWP 50,A00,893758,Morshed; Michael James,0,0,20,20
1746554097059,MCWP 50,B00,893761,Bartulis; Jason Michael,17,0,20,3
1746554098086,MCWP 50R,A00,893766,Compas; Sean Matthew,0,1,20,20
1746554098086,MCWP 50R,B00,893769,Carter; Jennifer A,0,1,20,20
1746554098086,MCWP 50R,C00,893771,Krone; Jarret,0,3,20,20
1746554098086,MCWP 50R,D00,893772,Miller; Elizabeth Deen,0,0,20,20
1746554098086,MCWP 50R,E00,893775,Carter; Andrea L,0,1,20,20
1746554099121,MMW 11R,A01,892721,Herbst; Matthew,11,0,27,16
1746554099121,MMW 11R,A02,892722,Herbst; Matthew,0,0,0,3
1746554100146,MMW 12R,A01,892724,Herbst; Matthew,0,11,16,16
1746554100146,MMW 12R,A02,892725,Herbst; Matthew,0,10,16,16
1746554101171,MMW 13R,A01,892727,Staff,0,4,16,16
1746554101171,MMW 13R,A02,892728,Staff,0,4,16,16
1746554101171,MMW 13R,A03,958032,Staff,0,4,16,16
1746554101171,MMW 13R,A04,958033,Staff,0,4,16,16
1746554101171,MMW 13R,A05,958034,Staff,0,4,16,16
1746554102199,SIO 295LS,A00,894015,Staff,5,0,25,20
1746554103224,SIO 295S,A00,894020,Staff,5,0,25,20
1746554104251,SIOC 290S,B01,958918,Merrifield; Mark A,14,0,30,16
1746554105277,SIOC 291S,B01,958922,Gabriel; Corey John,14,0,30,16
1746554106303,SOCI 117,A01,895339,Staff,3,0,5,2
1746554107328,WES 237B,A00,894149,Staff,11,0,20,9
1746554109389,AESE 279B,A00,891859,Staff,13,0,35,22
1746554110416,AIP 197,001,891854,Vespa; Emanuel Ignacio,9999,0,9999,0
1746554111443,ANTH 289S,A00,891856,Gagneux; Pascal,12,0,12,0
1746554112469,BENG 196,001,957946,Engler; Adam J.,9996,0,9999,3
1746554113499,BISP 197,001,959851,Wilhelm; James E.,9998,0,9999,1
1746554114526,CAT 124RS,A01,956906,Staff,6,0,25,19
1746554115552,CAT 125RS,A01,922013,Staff,6,0,25,19
1746554116630,CLRE 250,A00,891860,Morris; Sheldon,9995,0,9999,4
1746554118684,CLRE 251R,A00,907817,Mehta; Ravindra L.,9994,0,9999,5
1746554119709,CLRE 252,A00,891864,Cuomo; Raphael Eduardo,9993,0,9999,6
1746554120737,CLRE 253,A00,891867,Vaida; Florin,9994,0,9999,5
1746554120737,CLRE 253,B00,907819,Staff,9999,0,9999,0
1746554121762,CLRE 259,A00,891868,Patel; Hemal,9998,0,9999,1
1746554122787,CLRE 260,A00,891872,Cuomo; Raphael Eduardo,9999,0,9999,0
1746554123812,CLRE 297,001,891888,Cuomo; Raphael Eduardo,9999,0,9999,0
1746554124839,CSE 191,A00,958773,Minnes Kemp; Mor Mia,9995,0,9999,4
1746554125863,CSE 197,001,959846,Minnes Kemp; Mor Mia,9990,0,9999,9
1746554126894,CSS 201S,A01,892054,Mignozzetti; Umberto,26,0,30,4
1746554127923,CSS 202S,A01,892056,Mignozzetti; Umberto,26,0,30,4
1746554128946,DSC 197,001,956898,Eldridge; Justin Matthew,9997,0,9999,2
1746554129974,DSC 297,001,958000,Mazumdar; Arya,9998,0,9999,1
1746554129974,DSC 297,002,959862,Wang; Yusu,9998,0,9999,1
1746554130998,EAP 100,A00,905686,Staff,9778,0,9999,221
1746554132025,ECE 45,A01,892618,Staff,0,0,65,65
1746554134076,ECE 111,A01,892719,Staff,4,0,65,61
1746554135102,ECE 197,001,957920,Mercier; Patrick Philip,9991,0,9999,8
1746554136126,ECON 178,A01,907814,Zhu; Ying,26,0,35,9
1746554137151,EDS 115,A00,895312,Staff,35,0,45,10
1746554138176,EDS 117,A01,895337,Staff,23,0,30,7
1746554139201,EDS 125,A00,895341,Jones; Gabrielle Anastasia,36,0,45,9
1746554140227,EDS 128A,A01,895459,Fargason; Sharon Gayle,44,0,45,1
1746554141253,EDS 128B,A01,895543,Pappas; Elizabeth,44,0,45,1
1746554142279,EDS 139,A00,897203,Pappas; Elizabeth,44,0,45,1
1746554142279,EDS 139,B00,897209,Fargason; Sharon Gayle,41,0,45,4
1746554143304,EDS 201,A00,895545,Staff,22,0,45,23
1746554144329,EDS 203,A01,895581,Halter; Christopher P.,22,0,45,23
1746554145356,EDS 204R,A01,895625,Heinzman; Erica M.,39,0,45,6
1746554145356,EDS 204R,B01,895693,Halter; Christopher P.,10,0,45,35
1746554146380,EDS 206R,A00,895694,Fargason; Sharon Gayle,1,0,30,29
1746554146380,EDS 206R,B00,895695,Choi; Bailey Miyeon,16,0,30,14
1746554147408,EDS 250,A00,895697,Hemans; Patricia Ann Benitez,22,0,45,23
1746554148434,EDS 281,A00,895701,Meyerott; Theresa Ann,1,0,15,14
1746554149458,EDS 284,A00,895736,Meyerott; Theresa Ann,1,0,15,14
1746554150482,EDS 286,A00,897210,Fine; Sarah,0,0,15,15
1746554151507,EDS 289C,A01,895770,Daly; Alan J.,15,0,15,0
1746554152534,EDS 290,A00,897211,Hofstetter; Carolyn,0,0,15,15
1746554153560,LIGM 5A,A00,896162,Fischer-Grunski; Eva K,13,0,20,7
1746554154585,LIGM 5B,A00,896260,Fischer-Grunski; Eva K,17,0,20,3
1746554155613,LIGM 5C,A00,896308,Fischer-Grunski; Eva K,18,0,20,2
1746554156638,LIIT 5AS,A00,896313,Carnelos; Chiara,18,0,20,2
1746554157664,LIIT 5BS,A00,896416,Carnelos; Chiara,20,0,20,0
1746554158706,LIIT 5CS,A00,896564,Carnelos; Chiara,20,0,20,0
1746554159734,LISP 5A,A00,896588,Munoz Sanchez; Alicia,3,0,20,17
1746554160759,LISP 5B,A00,896653,Munoz Sanchez; Alicia,7,0,20,13
1746554161785,LISP 5C,A00,896655,Munoz Sanchez; Alicia,0,1,20,20
1746554162810,MAE 197,001,957918,Kleissl; Jan,9996,0,9999,3
1746554162810,MAE 197,002,959806,Boechler; Nicholas Sebastia,9998,0,9999,1
1746554162810,MAE 197,003,959852,Mullin; Jennifer S,9998,0,9999,1
1746554163837,MATH 2,A01,957937,Staff,33,0,35,2
1746554164860,MATH 197,001,957876,Kedlaya; Kiran S.,9993,0,9999,6
1746554165886,MCWP 40,A00,892729,Duru; Nur,10,0,20,10
1746554165886,MCWP 40,B00,893304,Montejo; Carolina,14,0,20,6
1746554166912,MCWP 40R,A00,893757,Redela; Pamela Morgan,0,5,20,20
1746554167941,MCWP 50,A00,893758,Morshed; Michael James,0,0,20,20
1746554167941,MCWP 50,B00,893761,Bartulis; Jason Michael,17,0,20,3
1746554168972,MCWP 50R,A00,893766,Compas; Sean Matthew,0,1,20,20
1746554168972,MCWP 50R,B00,893769,Carter; Jennifer A,0,1,20,20
1746554168972,MCWP 50R,C00,893771,Krone; Jarret,0,3,20,20
1746554168972,MCWP 50R,D00,893772,Miller; Elizabeth Deen,0,0,20,20
1746554168972,MCWP 50R,E00,893775,Carter; Andrea L,0,1,20,20
1746554170007,MMW 11R,A01,892721,Herbst; Matthew,11,0,27,16
1746554170007,MMW 11R,A02,892722,Herbst; Matthew,0,0,0,3
1746554171035,MMW 12R,A01,892724,Herbst; Matthew,0,11,16,16
1746554171035,MMW 12R,A02,892725,Herbst; Matthew,0,10,16,16
1746554172062,MMW 13R,A01,892727,Staff,0,4,16,16
1746554172062,MMW 13R,A02,892728,Staff,0,4,16,16
1746554172062,MMW 13R,A03,958032,Staff,0,4,16,16
1746554172062,MMW 13R,A04,958033,Staff,0,4,16,16
1746554172062,MMW 13R,A05,958034,Staff,0,4,16,16
1746554173088,SIO 295LS,A00,894015,Staff,5,0,25,20
1746554174113,SIO 295S,A00,894020,Staff,5,0,25,20
1746554175137,SIOC 290S,B01,958918,Merrifield; Mark A,14,0,30,16
1746554176166,SIOC 291S,B01,958922,Gabriel; Corey John,14,0,30,16
1746554177191,SOCI 117,A01,895339,Staff,3,0,5,2
1746554178218,WES 237B,A00,894149,Staff,11,0,20,9
1746554180279,AESE 279B,A00,891859,Staff,13,0,35,22
1746554181316,AIP 197,001,891854,Vespa; Emanuel Ignacio,9999,0,9999,0
1746554182341,ANTH 289S,A00,891856,Gagneux; Pascal,12,0,12,0
1746554183369,BENG 196,001,957946,Engler; Adam J.,9996,0,9999,3
1746554184396,BISP 197,001,959851,Wilhelm; James E.,9998,0,9999,1
1746554185425,CAT 124RS,A01,956906,Staff,6,0,25,19
1746554186451,CAT 125RS,A01,922013,Staff,6,0,25,19
1746554187478,CLRE 250,A00,891860,Morris; Sheldon,9995,0,9999,4
1746554189530,CLRE 251R,A00,907817,Mehta; Ravindra L.,9994,0,9999,5
1746554190555,CLRE 252,A00,891864,Cuomo; Raphael Eduardo,9993,0,9999,6
1746554191580,CLRE 253,A00,891867,Vaida; Florin,9994,0,9999,5
1746554191580,CLRE 253,B00,907819,Staff,9999,0,9999,0
1746554192607,CLRE 259,A00,891868,Patel; Hemal,9998,0,9999,1
1746554193632,CLRE 260,A00,891872,Cuomo; Raphael Eduardo,9999,0,9999,0
1746554194659,CLRE 297,001,891888,Cuomo; Raphael Eduardo,9999,0,9999,0
1746554195686,CSE 191,A00,958773,Minnes Kemp; Mor Mia,9995,0,9999,4
1746554196713,CSE 197,001,959846,Minnes Kemp; Mor Mia,9990,0,9999,9
1746554197741,CSS 201S,A01,892054,Mignozzetti; Umberto,26,0,30,4
1746554198767,CSS 202S,A01,892056,Mignozzetti; Umberto,26,0,30,4
1746554199792,DSC 197,001,956898,Eldridge; Justin Matthew,9997,0,9999,2
1746554200820,DSC 297,001,958000,Mazumdar; Arya,9998,0,9999,1
1746554200820,DSC 297,002,959862,Wang; Yusu,9998,0,9999,1
1746554201844,EAP 100,A00,905686,Staff,9778,0,9999,221
1746554202872,ECE 45,A01,892618,Staff,0,0,65,65
1746554204920,ECE 111,A01,892719,Staff,4,0,65,61
1746554205947,ECE 197,001,957920,Mercier; Patrick Philip,9991,0,9999,8
1746554206972,ECON 178,A01,907814,Zhu; Ying,26,0,35,9
1746554207998,EDS 115,A00,895312,Staff,35,0,45,10
1746554209024,EDS 117,A01,895337,Staff,23,0,30,7
1746554210049,EDS 125,A00,895341,Jones; Gabrielle Anastasia,36,0,45,9
1746554211074,EDS 128A,A01,895459,Fargason; Sharon Gayle,44,0,45,1
1746554212103,EDS 128B,A01,895543,Pappas; Elizabeth,44,0,45,1
1746554213126,EDS 139,A00,897203,Pappas; Elizabeth,44,0,45,1
1746554213126,EDS 139,B00,897209,Fargason; Sharon Gayle,41,0,45,4
1746554214152,EDS 201,A00,895545,Staff,22,0,45,23
1746554215176,EDS 203,A01,895581,Halter; Christopher P.,22,0,45,23
1746554216205,EDS 204R,A01,895625,Heinzman; Erica M.,39,0,45,6
1746554216205,EDS 204R,B01,895693,Halter; Christopher P.,10,0,45,35
1746554217232,EDS 206R,A00,895694,Fargason; Sharon Gayle,1,0,30,29
1746554217232,EDS 206R,B00,895695,Choi; Bailey Miyeon,16,0,30,14
1746554218258,EDS 250,A00,895697,Hemans; Patricia Ann Benitez,22,0,45,23
1746554219287,EDS 281,A00,895701,Meyerott; Theresa Ann,1,0,15,14
1746554220354,EDS 284,A00,895736,Meyerott; Theresa Ann,1,0,15,14
1746554221380,EDS 286,A00,897210,Fine; Sarah,0,0,15,15
1746554222417,EDS 289C,A01,895770,Daly; Alan J.,15,0,15,0
1746554223442,EDS 290,A00,897211,Hofstetter; Carolyn,0,0,15,15
1746554224465,LIGM 5A,A00,896162,Fischer-Grunski; Eva K,13,0,20,7
1746554225491,LIGM 5B,A00,896260,Fischer-Grunski; Eva K,17,0,20,3
1746554226516,LIGM 5C,A00,896308,Fischer-Grunski; Eva K,18,0,20,2
1746554227541,LIIT 5AS,A00,896313,Carnelos; Chiara,18,0,20,2
1746554228570,LIIT 5BS,A00,896416,Carnelos; Chiara,20,0,20,0
1746554229594,LIIT 5CS,A00,896564,Carnelos; Chiara,20,0,20,0
1746554230619,LISP 5A,A00,896588,Munoz Sanchez; Alicia,3,0,20,17
1746554231648,LISP 5B,A00,896653,Munoz Sanchez; Alicia,7,0,20,13
1746554232674,LISP 5C,A00,896655,Munoz Sanchez; Alicia,0,1,20,20
1746554233699,MAE 197,001,957918,Kleissl; Jan,9996,0,9999,3
1746554233699,MAE 197,002,959806,Boechler; Nicholas Sebastia,9998,0,9999,1
1746554233699,MAE 197,003,959852,Mullin; Jennifer S,9998,0,9999,1
1746554234724,MATH 2,A01,957937,Staff,33,0,35,2
1746554235749,MATH 197,001,957876,Kedlaya; Kiran S.,9993,0,9999,6
1746554236776,MCWP 40,A00,892729,Duru; Nur,10,0,20,10
1746554236776,MCWP 40,B00,893304,Montejo; Carolina,14,0,20,6
1746554237803,MCWP 40R,A00,893757,Redela; Pamela Morgan,0,5,20,20
1746554238831,MCWP 50,A00,893758,Morshed; Michael James,0,0,20,20
1746554238831,MCWP 50,B00,893761,Bartulis; Jason Michael,17,0,20,3
1746554239856,MCWP 50R,A00,893766,Compas; Sean Matthew,0,1,20,20
1746554239856,MCWP 50R,B00,893769,Carter; Jennifer A,0,1,20,20
1746554239856,MCWP 50R,C00,893771,Krone; Jarret,0,3,20,20
1746554239856,MCWP 50R,D00,893772,Miller; Elizabeth Deen,0,0,20,20
1746554239856,MCWP 50R,E00,893775,Carter; Andrea L,0,1,20,20
1746554240887,MMW 11R,A01,892721,Herbst; Matthew,11,0,27,16
1746554240887,MMW 11R,A02,892722,Herbst; Matthew,0,0,0,3
1746554241912,MMW 12R,A01,892724,Herbst; Matthew,0,11,16,16
1746554241912,MMW 12R,A02,892725,Herbst; Matthew,0,10,16,16
1746554242941,MMW 13R,A01,892727,Staff,0,4,16,16
1746554242941,MMW 13R,A02,892728,Staff,0,4,16,16
1746554242941,MMW 13R,A03,958032,Staff,0,4,16,16
1746554242941,MMW 13R,A04,958033,Staff,0,4,16,16
1746554242941,MMW 13R,A05,958034,Staff,0,4,16,16
1746554243969,SIO 295LS,A00,894015,Staff,5,0,25,20
1746554244995,SIO 295S,A00,894020,Staff,5,0,25,20
1746554246020,SIOC 290S,B01,958918,Merrifield; Mark A,14,0,30,16
1746554247050,SIOC 291S,B01,958922,Gabriel; Corey John,14,0,30,16
1746554248075,SOCI 117,A01,895339,Staff,3,0,5,2
1746554249102,WES 237B,A00,894149,Staff,11,0,20,9
1746554251172,AESE 279B,A00,891859,Staff,13,0,35,22
1746554252198,AIP 197,001,891854,Vespa; Emanuel Ignacio,9999,0,9999,0
1746554253223,ANTH 289S,A00,891856,Gagneux; Pascal,12,0,12,0
1746554254247,BENG 196,001,957946,Engler; Adam J.,9996,0,9999,3
1746554255272,BISP 197,001,959851,Wilhelm; James E.,9998,0,9999,1
1746554256295,CAT 124RS,A01,956906,Staff,6,0,25,19
1746554257320,CAT 125RS,A01,922013,Staff,6,0,25,19
1746554258347,CLRE 250,A00,891860,Morris; Sheldon,9995,0,9999,4
1746554260400,CLRE 251R,A00,907817,Mehta; Ravindra L.,9994,0,9999,5
1746554261428,CLRE 252,A00,891864,Cuomo; Raphael Eduardo,9993,0,9999,6
1746554262453,CLRE 253,A00,891867,Vaida; Florin,9994,0,9999,5
1746554262453,CLRE 253,B00,907819,Staff,9999,0,9999,0
1746554263478,CLRE 259,A00,891868,Patel; Hemal,9998,0,9999,1
1746554264505,CLRE 260,A00,891872,Cuomo; Raphael Eduardo,9999,0,9999,0
1746554265530,CLRE 297,001,891888,Cuomo; Raphael Eduardo,9999,0,9999,0
1746554266555,CSE 191,A00,958773,Minnes Kemp; Mor Mia,9995,0,9999,4
1746554267578,CSE 197,001,959846,Minnes Kemp; Mor Mia,9990,0,9999,9
1746554268608,CSS 201S,A01,892054,Mignozzetti; Umberto,26,0,30,4
1746554269635,CSS 202S,A01,892056,Mignozzetti; Umberto,26,0,30,4
1746554270660,DSC 197,001,956898,Eldridge; Justin Matthew,9997,0,9999,2
1746554271689,DSC 297,001,958000,Mazumdar; Arya,9998,0,9999,1
1746554271689,DSC 297,002,959862,Wang; Yusu,9998,0,9999,1
1746554272717,EAP 100,A00,905686,Staff,9778,0,9999,221
1746554273742,ECE 45,A01,892618,Staff,0,0,65,65
1746554275793,ECE 111,A01,892719,Staff,4,0,65,61
1746554276818,ECE 197,001,957920,Mercier; Patrick Philip,9991,0,9999,8
1746554277842,ECON 178,A01,907814,Zhu; Ying,26,0,35,9
1746554278869,EDS 115,A00,895312,Staff,35,0,45,10
1746554279894,EDS 117,A01,895337,Staff,23,0,30,7
1746554280922,EDS 125,A00,895341,Jones; Gabrielle Anastasia,36,0,45,9
1746554281950,EDS 128A,A01,895459,Fargason; Sharon Gayle,44,0,45,1
1746554282977,EDS 128B,A01,895543,Pappas; Elizabeth,44,0,45,1
1746554284004,EDS 139,A00,897203,Pappas; Elizabeth,44,0,45,1
1746554284004,EDS 139,B00,897209,Fargason; Sharon Gayle,41,0,45,4
1746554285028,EDS 201,A00,895545,Staff,22,0,45,23
1746554286052,EDS 203,A01,895581,Halter; Christopher P.,22,0,45,23
1746554287077,EDS 204R,A01,895625,Heinzman; Erica M.,39,0,45,6
1746554287077,EDS 204R,B01,895693,Halter; Christopher P.,10,0,45,35
1746554288105,EDS 206R,A00,895694,Fargason; Sharon Gayle,1,0,30,29
1746554288105,EDS 206R,B00,895695,Choi; Bailey Miyeon,16,0,30,14
1746554289167,EDS 250,A00,895697,Hemans; Patricia Ann Benitez,22,0,45,23
1746554290193,EDS 281,A00,895701,Meyerott; Theresa Ann,1,0,15,14
1746554291221,EDS 284,A00,895736,Meyerott; Theresa Ann,1,0,15,14
1746554292244,EDS 286,A00,897210,Fine; Sarah,0,0,15,15
1746554293269,EDS 289C,A01,895770,Daly; Alan J.,15,0,15,0
1746554294295,EDS 290,A00,897211,Hofstetter; Carolyn,0,0,15,15
1746554295322,LIGM 5A,A00,896162,Fischer-Grunski; Eva K,13,0,20,7
1746554296353,LIGM 5B,A00,896260,Fischer-Grunski; Eva K,17,0,20,3
1746554297379,LIGM 5C,A00,896308,Fischer-Grunski; Eva K,18,0,20,2
1746554298408,LIIT 5AS,A00,896313,Carnelos; Chiara,18,0,20,2
1746554299435,LIIT 5BS,A00,896416,Carnelos; Chiara,20,0,20,0
1746554300464,LIIT 5CS,A00,896564,Carnelos; Chiara,20,0,20,0
1746554301493,LISP 5A,A00,896588,Munoz Sanchez; Alicia,3,0,20,17
1746554302522,LISP 5B,A00,896653,Munoz Sanchez; Alicia,7,0,20,13
1746554303550,LISP 5C,A00,896655,Munoz Sanchez; Alicia,0,1,20,20
1746554304575,MAE 197,001,957918,Kleissl; Jan,9996,0,9999,3
1746554304575,MAE 197,002,959806,Boechler; Nicholas Sebastia,9998,0,9999,1
1746554304575,MAE 197,003,959852,Mullin; Jennifer S,9998,0,9999,1
1746554305601,MATH 2,A01,957937,Staff,33,0,35,2
1746554306624,MATH 197,001,957876,Kedlaya; Kiran S.,9993,0,9999,6
1746554307649,MCWP 40,A00,892729,Duru; Nur,10,0,20,10
1746554307649,MCWP 40,B00,893304,Montejo; Carolina,14,0,20,6
1746554308676,MCWP 40R,A00,893757,Redela; Pamela Morgan,0,5,20,20
1746554309700,MCWP 50,A00,893758,Morshed; Michael James,0,0,20,20
1746554309700,MCWP 50,B00,893761,Bartulis; Jason Michael,17,0,20,3
1746554310724,MCWP 50R,A00,893766,Compas; Sean Matthew,0,1,20,20
1746554310724,MCWP 50R,B00,893769,Carter; Jennifer A,0,1,20,20
1746554310724,MCWP 50R,C00,893771,Krone; Jarret,0,3,20,20
1746554310724,MCWP 50R,D00,893772,Miller; Elizabeth Deen,0,0,20,20
1746554310724,MCWP 50R,E00,893775,Carter; Andrea L,0,1,20,20
1746554311751,MMW 11R,A01,892721,Herbst; Matthew,11,0,27,16
1746554311751,MMW 11R,A02,892722,Herbst; Matthew,0,0,0,3
1746554312778,MMW 12R,A01,892724,Herbst; Matthew,0,11,16,16
1746554312778,MMW 12R,A02,892725,Herbst; Matthew,0,10,16,16
1746554313805,MMW 13R,A01,892727,Staff,0,4,16,16
1746554313805,MMW 13R,A02,892728,Staff,0,4,16,16
1746554313805,MMW 13R,A03,958032,Staff,0,4,16,16
1746554313805,MMW 13R,A04,958033,Staff,0,4,16,16
1746554313805,MMW 13R,A05,958034,Staff,0,4,16,16
1746554314830,SIO 295LS,A00,894015,Staff,5,0,25,20
1746554315857,SIO 295S,A00,894020,Staff,5,0,25,20
1746554316881,SIOC 290S,B01,958918,Merrifield; Mark A,14,0,30,16
1746554317907,SIOC 291S,B01,958922,Gabriel; Corey John,14,0,30,16
1746554318933,SOCI 117,A01,895339,Staff,3,0,5,2
1746554319960,WES 237B,A00,894149,Staff,11,0,20,9
1746554322025,AESE 279B,A00,891859,Staff,13,0,35,22
1746554323049,AIP 197,001,891854,Vespa; Emanuel Ignacio,9999,0,9999,0
1746554324118,ANTH 289S,A00,891856,Gagneux; Pascal,12,0,12,0
1746554325145,BENG 196,001,957946,Engler; Adam J.,9996,0,9999,3
1746554326172,BISP 197,001,959851,Wilhelm; James E.,9998,0,9999,1
1746554327196,CAT 124RS,A01,956906,Staff,6,0,25,19
1746554328224,CAT 125RS,A01,922013,Staff,6,0,25,19
1746554329250,CLRE 250,A00,891860,Morris; Sheldon,9995,0,9999,4
1746554331301,CLRE 251R,A00,907817,Mehta; Ravindra L.,9994,0,9999,5
1746554332324,CLRE 252,A00,891864,Cuomo; Raphael Eduardo,9993,0,9999,6
1746554333352,CLRE 253,A00,891867,Vaida; Florin,9994,0,9999,5
1746554333352,CLRE 253,B00,907819,Staff,9999,0,9999,0
1746554334380,CLRE 259,A00,891868,Patel; Hemal,9998,0,9999,1
1746554335406,CLRE 260,A00,891872,Cuomo; Raphael Eduardo,9999,0,9999,0
1746554336432,CLRE 297,001,891888,Cuomo; Raphael Eduardo,9999,0,9999,0
1746554337456,CSE 191,A00,958773,Minnes Kemp; Mor Mia,9995,0,9999,4
1746554338479,CSE 197,001,959846,Minnes Kemp; Mor Mia,9990,0,9999,9
1746554339505,CSS 201S,A01,892054,Mignozzetti; Umberto,26,0,30,4
1746554340531,CSS 202S,A01,892056,Mignozzetti; Umberto,26,0,30,4
1746554341555,DSC 197,001,956898,Eldridge; Justin Matthew,9997,0,9999,2
1746554342580,DSC 297,001,958000,Mazumdar; Arya,9998,0,9999,1
1746554342580,DSC 297,002,959862,Wang; Yusu,9998,0,9999,1
1746554343605,EAP 100,A00,905686,Staff,9778,0,9999,221
1746554344631,ECE 45,A01,892618,Staff,0,0,65,65
1746554346680,ECE 111,A01,892719,Staff,4,0,65,61
1746554347707,ECE 197,001,957920,Mercier; Patrick Philip,9991,0,9999,8
1746554348736,ECON 178,A01,907814,Zhu; Ying,26,0,35,9
1746554349761,EDS 115,A00,895312,Staff,35,0,45,10
1746554350786,EDS 117,A01,895337,Staff,23,0,30,7
1746554351811,EDS 125,A00,895341,Jones; Gabrielle Anastasia,36,0,45,9
1746554352835,EDS 128A,A01,895459,Fargason; Sharon Gayle,44,0,45,1
1746554353863,EDS 128B,A01,895543,Pappas; Elizabeth,44,0,45,1
1746554354889,EDS 139,A00,897203,Pappas; Elizabeth,44,0,45,1
1746554354889,EDS 139,B00,897209,Fargason; Sharon Gayle,41,0,45,4
1746554355914,EDS 201,A00,895545,Staff,22,0,45,23
1746554356939,EDS 203,A01,895581,Halter; Christopher P.,22,0,45,23
1746554357964,EDS 204R,A01,895625,Heinzman; Erica M.,39,0,45,6
1746554357964,EDS 204R,B01,895693,Halter; Christopher P.,10,0,45,35
1746554358989,EDS 206R,A00,895694,Fargason; Sharon Gayle,1,0,30,29
1746554358989,EDS 206R,B00,895695,Choi; Bailey Miyeon,16,0,30,14
1746554360016,EDS 250,A00,895697,Hemans; Patricia Ann Benitez,22,0,45,23
1746554361043,EDS 281,A00,895701,Meyerott; Theresa Ann,1,0,15,14
1746554362069,EDS 284,A00,895736,Meyerott; Theresa Ann,1,0,15,14
1746554363093,EDS 286,A00,897210,Fine; Sarah,0,0,15,15
1746554364119,EDS 289C,A01,895770,Daly; Alan J.,15,0,15,0
1746554365145,EDS 290,A00,897211,Hofstetter; Carolyn,0,0,15,15
1746554366171,LIGM 5A,A00,896162,Fischer-Grunski; Eva K,13,0,20,7
1746554367196,LIGM 5B,A00,896260,Fischer-Grunski; Eva K,17,0,20,3
1746554368223,LIGM 5C,A00,896308,Fischer-Grunski; Eva K,18,0,20,2
1746554369248,LIIT 5AS,A00,896313,Carnelos; Chiara,18,0,20,2
1746554370274,LIIT 5BS,A00,896416,Carnelos; Chiara,20,0,20,0
1746554371299,LIIT 5CS,A00,896564,Carnelos; Chiara,20,0,20,0
1746554372327,LISP 5A,A00,896588,Munoz Sanchez; Alicia,3,0,20,17
1746554373355,LISP 5B,A00,896653,Munoz Sanchez; Alicia,7,0,20,13
1746554374383,LISP 5C,A00,896655,Munoz Sanchez; Alicia,0,1,20,20
1746554375409,MAE 197,001,957918,Kleissl; Jan,9996,0,9999,3
1746554375409,MAE 197,002,959806,Boechler; Nicholas Sebastia,9998,0,9999,1
1746554375409,MAE 197,003,959852,Mullin; Jennifer S,9998,0,9999,1
1746554376435,MATH 2,A01,957937,Staff,33,0,35,2
1746554377463,MATH 197,001,957876,Kedlaya; Kiran S.,9993,0,9999,6
1746554378487,MCWP 40,A00,892729,Duru; Nur,10,0,20,10
1746554378487,MCWP 40,B00,893304,Montejo; Carolina,14,0,20,6
1746554379512,MCWP 40R,A00,893757,Redela; Pamela Morgan,0,5,20,20
1746554380537,MCWP 50,A00,893758,Morshed; Michael James,0,0,20,20
1746554380537,MCWP 50,B00,893761,Bartulis; Jason Michael,17,0,20,3
1746554381565,MCWP 50R,A00,893766,Compas; Sean Matthew,0,1,20,20
1746554381565,MCWP 50R,B00,893769,Carter; Jennifer A,0,1,20,20
1746554381565,MCWP 50R,C00,893771,Krone; Jarret,0,3,20,20
1746554381565,MCWP 50R,D00,893772,Miller; Elizabeth Deen,0,0,20,20
1746554381565,MCWP 50R,E00,893775,Carter; Andrea L,0,1,20,20
1746554382589,MMW 11R,A01,892721,Herbst; Matthew,11,0,27,16
1746554382589,MMW 11R,A02,892722,Herbst; Matthew,0,0,0,3
1746554383617,MMW 12R,A01,892724,Herbst; Matthew,0,11,16,16
1746554383617,MMW 12R,A02,892725,Herbst; Matthew,0,10,16,16
1746554384645,MMW 13R,A01,892727,Staff,0,4,16,16
1746554384645,MMW 13R,A02,892728,Staff,0,4,16,16
1746554384645,MMW 13R,A03,958032,Staff,0,4,16,16
1746554384645,MMW 13R,A04,958033,Staff,0,4,16,16
1746554384645,MMW 13R,A05,958034,Staff,0,4,16,16
1746554385674,SIO 295LS,A00,894015,Staff,5,0,25,20
1746554386701,SIO 295S,A00,894020,Staff,5,0,25,20
1746554387726,SIOC 290S,B01,958918,Merrifield; Mark A,14,0,30,16
1746554388752,SIOC 291S,B01,958922,Gabriel; Corey John,14,0,30,16
1746554389776,SOCI 117,A01,895339,Staff,3,0,5,2
1746554390802,WES 237B,A00,894149,Staff,11,0,20,9
1746554392866,AESE 279B,A00,891859,Staff,13,0,35,22
1746554393894,AIP 197,001,891854,Vespa; Emanuel Ignacio,9999,0,9999,0
1746554394918,ANTH 289S,A00,891856,Gagneux; Pascal,12,0,12,0
1746554395943,BENG 196,001,957946,Engler; Adam J.,9996,0,9999,3
1746554396969,BISP 197,001,959851,Wilhelm; James E.,9998,0,9999,1
1746554397996,CAT 124RS,A01,956906,Staff,6,0,25,19
1746554399020,CAT 125RS,A01,922013,Staff,6,0,25,19
1746554400045,CLRE 250,A00,891860,Morris; Sheldon,9995,0,9999,4
1746554402097,CLRE 251R,A00,907817,Mehta; Ravindra L.,9994,0,9999,5
1746554403123,CLRE 252,A00,891864,Cuomo; Raphael Eduardo,9993,0,9999,6
1746554404148,CLRE 253,A00,891867,Vaida; Florin,9994,0,9999,5
1746554404148,CLRE 253,B00,907819,Staff,9999,0,9999,0
1746554405174,CLRE 259,A00,891868,Patel; Hemal,9998,0,9999,1
1746554406200,CLRE 260,A00,891872,Cuomo; Raphael Eduardo,9999,0,9999,0
1746554407224,CLRE 297,001,891888,Cuomo; Raphael Eduardo,9999,0,9999,0
1746554408251,CSE 191,A00,958773,Minnes Kemp; Mor Mia,9995,0,9999,4
1746554409276,CSE 197,001,959846,Minnes Kemp; Mor Mia,9990,0,9999,9
1746554410302,CSS 201S,A01,892054,Mignozzetti; Umberto,26,0,30,4
1746554411326,CSS 202S,A01,892056,Mignozzetti; Umberto,26,0,30,4
1746554412354,DSC 197,001,956898,Eldridge; Justin Matthew,9997,0,9999,2
1746554413380,DSC 297,001,958000,Mazumdar; Arya,9998,0,9999,1
1746554413380,DSC 297,002,959862,Wang; Yusu,9998,0,9999,1
1746554414407,EAP 100,A00,905686,Staff,9778,0,9999,221
1746554415434,ECE 45,A01,892618,Staff,0,0,65,65
1746554417485,ECE 111,A01,892719,Staff,4,0,65,61
1746554418509,ECE 197,001,957920,Mercier; Patrick Philip,9991,0,9999,8
1746554419532,ECON 178,A01,907814,Zhu; Ying,26,0,35,9
1746554420558,EDS 115,A00,895312,Staff,35,0,45,10
1746554421584,EDS 117,A01,895337,Staff,23,0,30,7
1746554422610,EDS 125,A00,895341,Jones; Gabrielle Anastasia,36,0,45,9
1746554423635,EDS 128A,A01,895459,Fargason; Sharon Gayle,44,0,45,1
1746554424666,EDS 128B,A01,895543,Pappas; Elizabeth,44,0,45,1
1746554425689,EDS 139,A00,897203,Pappas; Elizabeth,44,0,45,1
1746554425689,EDS 139,B00,897209,Fargason; Sharon Gayle,41,0,45,4
1746554426714,EDS 201,A00,895545,Staff,22,0,45,23
1746554427782,EDS 203,A01,895581,Halter; Christopher P.,22,0,45,23
1746554428806,EDS 204R,A01,895625,Heinzman; Erica M.,39,0,45,6
1746554428806,EDS 204R,B01,895693,Halter; Christopher P.,10,0,45,35
1746554429834,EDS 206R,A00,895694,Fargason; Sharon Gayle,1,0,30,29
1746554429834,EDS 206R,B00,895695,Choi; Bailey Miyeon,16,0,30,14
1746554430863,EDS 250,A00,895697,Hemans; Patricia Ann Benitez,22,0,45,23
1746554431892,EDS 281,A00,895701,Meyerott; Theresa Ann,1,0,15,14
1746554432918,EDS 284,A00,895736,Meyerott; Theresa Ann,1,0,15,14
1746554433942,EDS 286,A00,897210,Fine; Sarah,0,0,15,15
1746554434967,EDS 289C,A01,895770,Daly; Alan J.,15,0,15,0
1746554435992,EDS 290,A00,897211,Hofstetter; Carolyn,0,0,15,15
1746554437017,LIGM 5A,A00,896162,Fischer-Grunski; Eva K,13,0,20,7
1746554438046,LIGM 5B,A00,896260,Fischer-Grunski; Eva K,17,0,20,3
1746554439073,LIGM 5C,A00,896308,Fischer-Grunski; Eva K,18,0,20,2
1746554440103,LIIT 5AS,A00,896313,Carnelos; Chiara,18,0,20,2
1746554441131,LIIT 5BS,A00,896416,Carnelos; Chiara,20,0,20,0
1746554442156,LIIT 5CS,A00,896564,Carnelos; Chiara,20,0,20,0
1746554443183,LISP 5A,A00,896588,Munoz Sanchez; Alicia,3,0,20,17
1746554444211,LISP 5B,A00,896653,Munoz Sanchez; Alicia,7,0,20,13
1746554445236,LISP 5C,A00,896655,Munoz Sanchez; Alicia,0,1,20,20
1746554446264,MAE 197,001,957918,Kleissl; Jan,9996,0,9999,3
1746554446264,MAE 197,002,959806,Boechler; Nicholas Sebastia,9998,0,9999,1
1746554446264,MAE 197,003,959852,Mullin; Jennifer S,9998,0,9999,1
1746554447288,MATH 2,A01,957937,Staff,33,0,35,2
1746554448313,MATH 197,001,957876,Kedlaya; Kiran S.,9993,0,9999,6
1746554449341,MCWP 40,A00,892729,Duru; Nur,10,0,20,10
1746554449341,MCWP 40,B00,893304,Montejo; Carolina,14,0,20,6
1746554450366,MCWP 40R,A00,893757,Redela; Pamela Morgan,0,5,20,20
1746554451392,MCWP 50,A00,893758,Morshed; Michael James,0,0,20,20
1746554451392,MCWP 50,B00,893761,Bartulis; Jason Michael,17,0,20,3
1746554452427,MCWP 50R,A00,893766,Compas; Sean Matthew,0,1,20,20
1746554452427,MCWP 50R,B00,893769,Carter; Jennifer A,0,1,20,20
1746554452427,MCWP 50R,C00,893771,Krone; Jarret,0,3,20,20
1746554452427,MCWP 50R,D00,893772,Miller; Elizabeth Deen,0,0,20,20
1746554452427,MCWP 50R,E00,893775,Carter; Andrea L,0,1,20,20
1746554453453,MMW 11R,A01,892721,Herbst; Matthew,11,0,27,16
1746554453453,MMW 11R,A02,892722,Herbst; Matthew,0,0,0,3
1746554454481,MMW 12R,A01,892724,Herbst; Matthew,0,11,16,16
1746554454481,MMW 12R,A02,892725,Herbst; Matthew,0,10,16,16
1746554455508,MMW 13R,A01,892727,Staff,0,4,16,16
1746554455508,MMW 13R,A02,892728,Staff,0,4,16,16
1746554455508,MMW 13R,A03,958032,Staff,0,4,16,16
1746554455508,MMW 13R,A04,958033,Staff,0,4,16,16
1746554455508,MMW 13R,A05,958034,Staff,0,4,16,16
1746554456535,SIO 295LS,A00,894015,Staff,5,0,25,20
1746554457563,SIO 295S,A00,894020,Staff,5,0,25,20
1746554458592,SIOC 290S,B01,958918,Merrifield; Mark A,14,0,30,16
1746554459643,SIOC 291S,B01,958922,Gabriel; Corey John,14,0,30,16
1746554460680,SOCI 117,A01,895339,Staff,3,0,5,2
1746554461707,WES 237B,A00,894149,Staff,11,0,20,9
1746554463776,AESE 279B,A00,891859,Staff,13,0,35,22
1746554464804,AIP 197,001,891854,Vespa; Emanuel Ignacio,9999,0,9999,0
1746554465831,ANTH 289S,A00,891856,Gagneux; Pascal,12,0,12,0
1746554466856,BENG 196,001,957946,Engler; Adam J.,9996,0,9999,3
1746554467880,BISP 197,001,959851,Wilhelm; James E.,9998,0,9999,1
1746554468908,CAT 124RS,A01,956906,Staff,6,0,25,19
1746554469933,CAT 125RS,A01,922013,Staff,6,0,25,19
1746554470961,CLRE 250,A00,891860,Morris; Sheldon,9995,0,9999,4
1746554473014,CLRE 251R,A00,907817,Mehta; Ravindra L.,9994,0,9999,5
1746554474039,CLRE 252,A00,891864,Cuomo; Raphael Eduardo,9993,0,9999,6
1746554475067,CLRE 253,A00,891867,Vaida; Florin,9994,0,9999,5
1746554475067,CLRE 253,B00,907819,Staff,9999,0,9999,0
1746554476093,CLRE 259,A00,891868,Patel; Hemal,9998,0,9999,1
1746554477118,CLRE 260,A00,891872,Cuomo; Raphael Eduardo,9999,0,9999,0
1746554478141,CLRE 297,001,891888,Cuomo; Raphael Eduardo,9999,0,9999,0
1746554479166,CSE 191,A00,958773,Minnes Kemp; Mor Mia,9995,0,9999,4
1746554480193,CSE 197,001,959846,Minnes Kemp; Mor Mia,9990,0,9999,9
1746554481221,CSS 201S,A01,892054,Mignozzetti; Umberto,26,0,30,4
1746554482246,CSS 202S,A01,892056,Mignozzetti; Umberto,26,0,30,4
1746554483269,DSC 197,001,956898,Eldridge; Justin Matthew,9997,0,9999,2
1746554484296,DSC 297,001,958000,Mazumdar; Arya,9998,0,9999,1
1746554484296,DSC 297,002,959862,Wang; Yusu,9998,0,9999,1
1746554485321,EAP 100,A00,905686,Staff,9778,0,9999,221
1746554486370,ECE 45,A01,892618,Staff,0,0,65,65
1746554488420,ECE 111,A01,892719,Staff,4,0,65,61
1746554489446,ECE 197,001,957920,Mercier; Patrick Philip,9991,0,9999,8
1746554490471,ECON 178,A01,907814,Zhu; Ying,26,0,35,9
1746554491497,EDS 115,A00,895312,Staff,35,0,45,10
1746554492522,EDS 117,A01,895337,Staff,23,0,30,7
1746554493546,EDS 125,A00,895341,Jones; Gabrielle Anastasia,36,0,45,9
1746554494571,EDS 128A,A01,895459,Fargason; Sharon Gayle,44,0,45,1
1746554495601,EDS 128B,A01,895543,Pappas; Elizabeth,44,0,45,1
1746554496627,EDS 139,A00,897203,Pappas; Elizabeth,44,0,45,1
1746554496627,EDS 139,B00,897209,Fargason; Sharon Gayle,41,0,45,4
1746554497654,EDS 201,A00,895545,Staff,22,0,45,23
1746554498678,EDS 203,A01,895581,Halter; Christopher P.,22,0,45,23
1746554499703,EDS 204R,A01,895625,Heinzman; Erica M.,39,0,45,6
1746554499703,EDS 204R,B01,895693,Halter; Christopher P.,10,0,45,35
1746554500730,EDS 206R,A00,895694,Fargason; Sharon Gayle,1,0,30,29
1746554500730,EDS 206R,B00,895695,Choi; Bailey Miyeon,16,0,30,14
1746554501758,EDS 250,A00,895697,Hemans; Patricia Ann Benitez,22,0,45,23
1746554502783,EDS 281,A00,895701,Meyerott; Theresa Ann,1,0,15,14
1746554503807,EDS 284,A00,895736,Meyerott; Theresa Ann,1,0,15,14
1746554504834,EDS 286,A00,897210,Fine; Sarah,0,0,15,15
1746554505862,EDS 289C,A01,895770,Daly; Alan J.,15,0,15,0
1746554506888,EDS 290,A00,897211,Hofstetter; Carolyn,0,0,15,15
1746554507913,LIGM 5A,A00,896162,Fischer-Grunski; Eva K,13,0,20,7
1746554508937,LIGM 5B,A00,896260,Fischer-Grunski; Eva K,17,0,20,3
1746554509965,LIGM 5C,A00,896308,Fischer-Grunski; Eva K,18,0,20,2
1746554510991,LIIT 5AS,A00,896313,Carnelos; Chiara,18,0,20,2
1746554512019,LIIT 5BS,A00,896416,Carnelos; Chiara,20,0,20,0
1746554513049,LIIT 5CS,A00,896564,Carnelos; Chiara,20,0,20,0
1746554514077,LISP 5A,A00,896588,Munoz Sanchez; Alicia,3,0,20,17
1746554515104,LISP 5B,A00,896653,Munoz Sanchez; Alicia,7,0,20,13
1746554516134,LISP 5C,A00,896655,Munoz Sanchez; Alicia,0,1,20,20
1746554517161,MAE 197,001,957918,Kleissl; Jan,9996,0,9999,3
1746554517161,MAE 197,002,959806,Boechler; Nicholas Sebastia,9998,0,9999,1
1746554517161,MAE 197,003,959852,Mullin; Jennifer S,9998,0,9999,1
1746554518188,MATH 2,A01,957937,Staff,33,0,35,2
1746554519213,MATH 197,001,957876,Kedlaya; Kiran S.,9993,0,9999,6
1746554520241,MCWP 40,A00,892729,Duru; Nur,10,0,20,10
1746554520241,MCWP 40,B00,893304,Montejo; Carolina,14,0,20,6
1746554521268,MCWP 40R,A00,893757,Redela; Pamela Morgan,0,5,20,20
1746554522297,MCWP 50,A00,893758,Morshed; Michael James,0,0,20,20
1746554522297,MCWP 50,B00,893761,Bartulis; Jason Michael,17,0,20,3
1746554523323,MCWP 50R,A00,893766,Compas; Sean Matthew,0,1,20,20
1746554523323,MCWP 50R,B00,893769,Carter; Jennifer A,0,1,20,20
1746554523323,MCWP 50R,C00,893771,Krone; Jarret,0,3,20,20
1746554523323,MCWP 50R,D00,893772,Miller; Elizabeth Deen,0,0,20,20
1746554523323,MCWP 50R,E00,893775,Carter; Andrea L,0,1,20,20
1746554524346,MMW 11R,A01,892721,Herbst; Matthew,11,0,27,16
1746554524346,MMW 11R,A02,892722,Herbst; Matthew,0,0,0,3
1746554525372,MMW 12R,A01,892724,Herbst; Matthew,0,11,16,16
1746554525372,MMW 12R,A02,892725,Herbst; Matthew,0,10,16,16
1746554526399,MMW 13R,A01,892727,Staff,0,4,16,16
1746554526399,MMW 13R,A02,892728,Staff,0,4,16,16
1746554526399,MMW 13R,A03,958032,Staff,0,4,16,16
1746554526399,MMW 13R,A04,958033,Staff,0,4,16,16
1746554526399,MMW 13R,A05,958034,Staff,0,4,16,16
1746554527422,SIO 295LS,A00,894015,Staff,5,0,25,20
1746554528449,SIO 295S,A00,894020,Staff,5,0,25,20
1746554529475,SIOC 290S,B01,958918,Merrifield; Mark A,14,0,30,16
1746554530503,SIOC 291S,B01,958922,Gabriel; Corey John,14,0,30,16
1746554531566,SOCI 117,A01,895339,Staff,3,0,5,2
1746554532592,WES 237B,A00,894149,Staff,11,0,20,9
1746554534661,AESE 279B,A00,891859,Staff,13,0,35,22
1746554535688,AIP 197,001,891854,Vespa; Emanuel Ignacio,9999,0,9999,0
1746554536712,ANTH 289S,A00,891856,Gagneux; Pascal,12,0,12,0
1746554537737,BENG 196,001,957946,Engler; Adam J.,9996,0,9999,3
1746554538763,BISP 197,001,959851,Wilhelm; James E.,9998,0,9999,1
1746554539787,CAT 124RS,A01,956906,Staff,6,0,25,19
1746554540814,CAT 125RS,A01,922013,Staff,6,0,25,19
1746554541839,CLRE 250,A00,891860,Morris; Sheldon,9995,0,9999,4
1746554543890,CLRE 251R,A00,907817,Mehta; Ravindra L.,9994,0,9999,5
1746554544918,CLRE 252,A00,891864,Cuomo; Raphael Eduardo,9993,0,9999,6
1746554545943,CLRE 253,A00,891867,Vaida; Florin,9994,0,9999,5
1746554545943,CLRE 253,B00,907819,Staff,9999,0,9999,0
1746554546968,CLRE 259,A00,891868,Patel; Hemal,9998,0,9999,1
1746554547993,CLRE 260,A00,891872,Cuomo; Raphael Eduardo,9999,0,9999,0
1746554549038,CLRE 297,001,891888,Cuomo; Raphael Eduardo,9999,0,9999,0
1746554550062,CSE 191,A00,958773,Minnes Kemp; Mor Mia,9995,0,9999,4
1746554551087,CSE 197,001,959846,Minnes Kemp; Mor Mia,9990,0,9999,9
1746554552112,CSS 201S,A01,892054,Mignozzetti; Umberto,26,0,30,4
1746554553139,CSS 202S,A01,892056,Mignozzetti; Umberto,26,0,30,4
1746554554164,DSC 197,001,956898,Eldridge; Justin Matthew,9997,0,9999,2
1746554555188,DSC 297,001,958000,Mazumdar; Arya,9998,0,9999,1
1746554555188,DSC 297,002,959862,Wang; Yusu,9998,0,9999,1
1746554556215,EAP 100,A00,905686,Staff,9778,0,9999,221
1746554557240,ECE 45,A01,892618,Staff,0,0,65,65
1746554559292,ECE 111,A01,892719,Staff,4,0,65,61
1746554560320,ECE 197,001,957920,Mercier; Patrick Philip,9991,0,9999,8
1746554561351,ECON 178,A01,907814,Zhu; Ying,26,0,35,9
1746554562375,EDS 115,A00,895312,Staff,35,0,45,10
1746554563402,EDS 117,A01,895337,Staff,23,0,30,7
1746554564433,EDS 125,A00,895341,Jones; Gabrielle Anastasia,36,0,45,9
1746554565457,EDS 128A,A01,895459,Fargason; Sharon Gayle,44,0,45,1
1746554566484,EDS 128B,A01,895543,Pappas; Elizabeth,44,0,45,1
1746554567508,EDS 139,A00,897203,Pappas; Elizabeth,44,0,45,1
1746554567508,EDS 139,B00,897209,Fargason; Sharon Gayle,41,0,45,4
1746554568532,EDS 201,A00,895545,Staff,22,0,45,23
1746554569558,EDS 203,A01,895581,Halter; Christopher P.,22,0,45,23
1746554570582,EDS 204R,A01,895625,Heinzman; Erica M.,39,0,45,6
1746554570582,EDS 204R,B01,895693,Halter; Christopher P.,10,0,45,35
1746554571610,EDS 206R,A00,895694,Fargason; Sharon Gayle,1,0,30,29
1746554571610,EDS 206R,B00,895695,Choi; Bailey Miyeon,16,0,30,14
1746554572634,EDS 250,A00,895697,Hemans; Patricia Ann Benitez,22,0,45,23
1746554573661,EDS 281,A00,895701,Meyerott; Theresa Ann,1,0,15,14
1746554574688,EDS 284,A00,895736,Meyerott; Theresa Ann,1,0,15,14
1746554575713,EDS 286,A00,897210,Fine; Sarah,0,0,15,15
1746554576740,EDS 289C,A01,895770,Daly; Alan J.,15,0,15,0
1746554577766,EDS 290,A00,897211,Hofstetter; Carolyn,0,0,15,15
1746554578793,LIGM 5A,A00,896162,Fischer-Grunski; Eva K,13,0,20,7
1746554579821,LIGM 5B,A00,896260,Fischer-Grunski; Eva K,17,0,20,3
1746554580845,LIGM 5C,A00,896308,Fischer-Grunski; Eva K,18,0,20,2
1746554581873,LIIT 5AS,A00,896313,Carnelos; Chiara,18,0,20,2
1746554582901,LIIT 5BS,A00,896416,Carnelos; Chiara,20,0,20,0
1746554583928,LIIT 5CS,A00,896564,Carnelos; Chiara,20,0,20,0
1746554584954,LISP 5A,A00,896588,Munoz Sanchez; Alicia,3,0,20,17
1746554585979,LISP 5B,A00,896653,Munoz Sanchez; Alicia,7,0,20,13
1746554587007,LISP 5C,A00,896655,Munoz Sanchez; Alicia,0,1,20,20
1746554588035,MAE 197,001,957918,Kleissl; Jan,9996,0,9999,3
1746554588035,MAE 197,002,959806,Boechler; Nicholas Sebastia,9998,0,9999,1
1746554588035,MAE 197,003,959852,Mullin; Jennifer S,9998,0,9999,1
1746554589060,MATH 2,A01,957937,Staff,33,0,35,2
1746554590086,MATH 197,001,957876,Kedlaya; Kiran S.,9993,0,9999,6
1746554591111,MCWP 40,A00,892729,Duru; Nur,10,0,20,10
1746554591111,MCWP 40,B00,893304,Montejo; Carolina,14,0,20,6
1746554592139,MCWP 40R,A00,893757,Redela; Pamela Morgan,0,5,20,20
1746554593164,MCWP 50,A00,893758,Morshed; Michael James,0,0,20,20
1746554593164,MCWP 50,B00,893761,Bartulis; Jason Michael,17,0,20,3
1746554594190,MCWP 50R,A00,893766,Compas; Sean Matthew,0,1,20,20
1746554594190,MCWP 50R,B00,893769,Carter; Jennifer A,0,1,20,20
1746554594190,MCWP 50R,C00,893771,Krone; Jarret,0,3,20,20
1746554594190,MCWP 50R,D00,893772,Miller; Elizabeth Deen,0,0,20,20
1746554594190,MCWP 50R,E00,893775,Carter; Andrea L,0,1,20,20
1746554595217,MMW 11R,A01,892721,Herbst; Matthew,11,0,27,16
1746554595217,MMW 11R,A02,892722,Herbst; Matthew,0,0,0,3
1746554596250,MMW 12R,A01,892724,Herbst; Matthew,0,11,16,16
1746554596250,MMW 12R,A02,892725,Herbst; Matthew,0,10,16,16
1746554597278,MMW 13R,A01,892727,Staff,0,4,16,16
1746554597278,MMW 13R,A02,892728,Staff,0,4,16,16
1746554597278,MMW 13R,A03,958032,Staff,0,4,16,16
1746554597278,MMW 13R,A04,958033,Staff,0,4,16,16
1746554597278,MMW 13R,A05,958034,Staff,0,4,16,16
1746554598302,SIO 295LS,A00,894015,Staff,5,0,25,20
1746554599327,SIO 295S,A00,894020,Staff,5,0,25,20
1746554600357,SIOC 290S,B01,958918,Merrifield; Mark A,14,0,30,16
1746554601383,SIOC 291S,B01,958922,Gabriel; Corey John,14,0,30,16
1746554602410,SOCI 117,A01,895339,Staff,3,0,5,2
1746554603437,WES 237B,A00,894149,Staff,11,0,20,9
1746554605494,AESE 279B,A00,891859,Staff,13,0,35,22
1746554606517,AIP 197,001,891854,Vespa; Emanuel Ignacio,9999,0,9999,0
1746554607542,ANTH 289S,A00,891856,Gagneux; Pascal,12,0,12,0
1746554608568,BENG 196,001,957946,Engler; Adam J.,9996,0,9999,3
1746554609596,BISP 197,001,959851,Wilhelm; James E.,9998,0,9999,1
1746554610624,CAT 124RS,A01,956906,Staff,6,0,25,19
1746554611650,CAT 125RS,A01,922013,Staff,6,0,25,19
1746554612686,CLRE 250,A00,891860,Morris; Sheldon,9995,0,9999,4
1746554614734,CLRE 251R,A00,907817,Mehta; Ravindra L.,9994,0,9999,5
1746554615759,CLRE 252,A00,891864,Cuomo; Raphael Eduardo,9993,0,9999,6
1746554616789,CLRE 253,A00,891867,Vaida; Florin,9994,0,9999,5
1746554616789,CLRE 253,B00,907819,Staff,9999,0,9999,0
1746554617815,CLRE 259,A00,891868,Patel; Hemal,9998,0,9999,1
1746554618843,CLRE 260,A00,891872,Cuomo; Raphael Eduardo,9999,0,9999,0
1746554619868,CLRE 297,001,891888,Cuomo; Raphael Eduardo,9999,0,9999,0
1746554620893,CSE 191,A00,958773,Minnes Kemp; Mor Mia,9995,0,9999,4
1746554621917,CSE 197,001,959846,Minnes Kemp; Mor Mia,9990,0,9999,9
1746554622942,CSS 201S,A01,892054,Mignozzetti; Umberto,26,0,30,4
1746554623967,CSS 202S,A01,892056,Mignozzetti; Umberto,26,0,30,4
1746554624992,DSC 197,001,956898,Eldridge; Justin Matthew,9997,0,9999,2
1746554626019,DSC 297,001,958000,Mazumdar; Arya,9998,0,9999,1
1746554626019,DSC 297,002,959862,Wang; Yusu,9998,0,9999,1
1746554627045,EAP 100,A00,905686,Staff,9778,0,9999,221
1746554628083,ECE 45,A01,892618,Staff,0,0,65,65
1746554630135,ECE 111,A01,892719,Staff,4,0,65,61
1746554631160,ECE 197,001,957920,Mercier; Patrick Philip,9991,0,9999,8
1746554632188,ECON 178,A01,907814,Zhu; Ying,26,0,35,9
1746554633214,EDS 115,A00,895312,Staff,35,0,45,10
1746554634241,EDS 117,A01,895337,Staff,23,0,30,7
1746554635321,EDS 125,A00,895341,Jones; Gabrielle Anastasia,36,0,45,9
1746554636346,EDS 128A,A01,895459,Fargason; Sharon Gayle,44,0,45,1
1746554637370,EDS 128B,A01,895543,Pappas; Elizabeth,44,0,45,1
1746554638398,EDS 139,A00,897203,Pappas; Elizabeth,44,0,45,1
1746554638398,EDS 139,B00,897209,Fargason; Sharon Gayle,41,0,45,4
1746554639425,EDS 201,A00,895545,Staff,22,0,45,23
1746554640451,EDS 203,A01,895581,Halter; Christopher P.,22,0,45,23
1746554641479,EDS 204R,A01,895625,Heinzman; Erica M.,39,0,45,6
1746554641479,EDS 204R,B01,895693,Halter; Christopher P.,10,0,45,35
1746554642504,EDS 206R,A00,895694,Fargason; Sharon Gayle,1,0,30,29
1746554642504,EDS 206R,B00,895695,Choi; Bailey Miyeon,16,0,30,14
1746554643529,EDS 250,A00,895697,Hemans; Patricia Ann Benitez,22,0,45,23
1746554644554,EDS 281,A00,895701,Meyerott; Theresa Ann,1,0,15,14
1746554645578,EDS 284,A00,895736,Meyerott; Theresa Ann,1,0,15,14
1746554646605,EDS 286,A00,897210,Fine; Sarah,0,0,15,15
1746554647630,EDS 289C,A01,895770,Daly; Alan J.,15,0,15,0
1746554648654,EDS 290,A00,897211,Hofstetter; Carolyn,0,0,15,15
1746554649685,LIGM 5A,A00,896162,Fischer-Grunski; Eva K,13,0,20,7
1746554650710,LIGM 5B,A00,896260,Fischer-Grunski; Eva K,17,0,20,3
1746554651738,LIGM 5C,A00,896308,Fischer-Grunski; Eva K,18,0,20,2
1746554652763,LIIT 5AS,A00,896313,Carnelos; Chiara,18,0,20,2
1746554653789,LIIT 5BS,A00,896416,Carnelos; Chiara,20,0,20,0
1746554654815,LIIT 5CS,A00,896564,Carnelos; Chiara,20,0,20,0
1746554655842,LISP 5A,A00,896588,Munoz Sanchez; Alicia,3,0,20,17
1746554656868,LISP 5B,A00,896653,Munoz Sanchez; Alicia,7,0,20,13
1746554657901,LISP 5C,A00,896655,Munoz Sanchez; Alicia,0,1,20,20
1746554658929,MAE 197,001,957918,Kleissl; Jan,9996,0,9999,3
1746554658929,MAE 197,002,959806,Boechler; Nicholas Sebastia,9998,0,9999,1
1746554658929,MAE 197,003,959852,Mullin; Jennifer S,9998,0,9999,1
1746554659958,MATH 2,A01,957937,Staff,33,0,35,2
1746554660985,MATH 197,001,957876,Kedlaya; Kiran S.,9993,0,9999,6
1746554662011,MCWP 40,A00,892729,Duru; Nur,10,0,20,10
1746554662011,MCWP 40,B00,893304,Montejo; Carolina,14,0,20,6
1746554663039,MCWP 40R,A00,893757,Redela; Pamela Morgan,0,5,20,20
1746554664068,MCWP 50,A00,893758,Morshed; Michael James,0,0,20,20
1746554664068,MCWP 50,B00,893761,Bartulis; Jason Michael,17,0,20,3
1746554665095,MCWP 50R,A00,893766,Compas; Sean Matthew,0,1,20,20
1746554665095,MCWP 50R,B00,893769,Carter; Jennifer A,0,1,20,20
1746554665095,MCWP 50R,C00,893771,Krone; Jarret,0,3,20,20
1746554665095,MCWP 50R,D00,893772,Miller; Elizabeth Deen,0,0,20,20
1746554665095,MCWP 50R,E00,893775,Carter; Andrea L,0,1,20,20
1746554666121,MMW 11R,A01,892721,Herbst; Matthew,11,0,27,16
1746554666121,MMW 11R,A02,892722,Herbst; Matthew,0,0,0,3
1746554667145,MMW 12R,A01,892724,Herbst; Matthew,0,11,16,16
1746554667145,MMW 12R,A02,892725,Herbst; Matthew,0,10,16,16
1746554668170,MMW 13R,A01,892727,Staff,0,4,16,16
1746554668170,MMW 13R,A02,892728,Staff,0,4,16,16
1746554668170,MMW 13R,A03,958032,Staff,0,4,16,16
1746554668170,MMW 13R,A04,958033,Staff,0,4,16,16
1746554668170,MMW 13R,A05,958034,Staff,0,4,16,16
1746554669194,SIO 295LS,A00,894015,Staff,5,0,25,20
1746554670219,SIO 295S,A00,894020,Staff,5,0,25,20
1746554671248,SIOC 290S,B01,958918,Merrifield; Mark A,14,0,30,16
1746554672272,SIOC 291S,B01,958922,Gabriel; Corey John,14,0,30,16
1746554673301,SOCI 117,A01,895339,Staff,3,0,5,2
1746554674327,WES 237B,A00,894149,Staff,11,0,20,9
1746554676395,AESE 279B,A00,891859,Staff,13,0,35,22
1746554677419,AIP 197,001,891854,Vespa; Emanuel Ignacio,9999,0,9999,0
1746554678446,ANTH 289S,A00,891856,Gagneux; Pascal,12,0,12,0
1746554679472,BENG 196,001,957946,Engler; Adam J.,9996,0,9999,3
1746554680496,BISP 197,001,959851,Wilhelm; James E.,9998,0,9999,1
1746554681519,CAT 124RS,A01,956906,Staff,6,0,25,19
1746554682545,CAT 125RS,A01,922013,Staff,6,0,25,19
1746554683570,CLRE 250,A00,891860,Morris; Sheldon,9995,0,9999,4
1746554685620,CLRE 251R,A00,907817,Mehta; Ravindra L.,9994,0,9999,5
1746554686646,CLRE 252,A00,891864,Cuomo; Raphael Eduardo,9993,0,9999,6
1746554687672,CLRE 253,A00,891867,Vaida; Florin,9994,0,9999,5
1746554687672,CLRE 253,B00,907819,Staff,9999,0,9999,0
1746554688696,CLRE 259,A00,891868,Patel; Hemal,9998,0,9999,1
1746554689723,CLRE 260,A00,891872,Cuomo; Raphael Eduardo,9999,0,9999,0
1746554690748,CLRE 297,001,891888,Cuomo; Raphael Eduardo,9999,0,9999,0
1746554691772,CSE 191,A00,958773,Minnes Kemp; Mor Mia,9995,0,9999,4
1746554692796,CSE 197,001,959846,Minnes Kemp; Mor Mia,9990,0,9999,9
1746554693822,CSS 201S,A01,892054,Mignozzetti; Umberto,26,0,30,4
1746554694850,CSS 202S,A01,892056,Mignozzetti; Umberto,26,0,30,4
1746554695875,DSC 197,001,956898,Eldridge; Justin Matthew,9997,0,9999,2
1746554696902,DSC 297,001,958000,Mazumdar; Arya,9998,0,9999,1
1746554696902,DSC 297,002,959862,Wang; Yusu,9998,0,9999,1
1746554697927,EAP 100,A00,905686,Staff,9778,0,9999,221
1746554698955,ECE 45,A01,892618,Staff,0,0,65,65
1746554701009,ECE 111,A01,892719,Staff,4,0,65,61
1746554702036,ECE 197,001,957920,Mercier; Patrick Philip,9991,0,9999,8
1746554703067,ECON 178,A01,907814,Zhu; Ying,26,0,35,9
1746554704092,EDS 115,A00,895312,Staff,35,0,45,10
1746554705116,EDS 117,A01,895337,Staff,23,0,30,7
1746554706140,EDS 125,A00,895341,Jones; Gabrielle Anastasia,36,0,45,9
1746554707169,EDS 128A,A01,895459,Fargason; Sharon Gayle,44,0,45,1
1746554708193,EDS 128B,A01,895543,Pappas; Elizabeth,44,0,45,1
1746554709219,EDS 139,A00,897203,Pappas; Elizabeth,44,0,45,1
1746554709219,EDS 139,B00,897209,Fargason; Sharon Gayle,41,0,45,4
1746554710246,EDS 201,A00,895545,Staff,22,0,45,23
1746554711271,EDS 203,A01,895581,Halter; Christopher P.,22,0,45,23
1746554712298,EDS 204R,A01,895625,Heinzman; Erica M.,39,0,45,6
1746554712298,EDS 204R,B01,895693,Halter; Christopher P.,10,0,45,35
1746554713323,EDS 206R,A00,895694,Fargason; Sharon Gayle,1,0,30,29
1746554713323,EDS 206R,B00,895695,Choi; Bailey Miyeon,16,0,30,14
1746554714350,EDS 250,A00,895697,Hemans; Patricia Ann Benitez,22,0,45,23
1746554715376,EDS 281,A00,895701,Meyerott; Theresa Ann,1,0,15,14
1746554716400,EDS 284,A00,895736,Meyerott; Theresa Ann,1,0,15,14
1746554717425,EDS 286,A00,897210,Fine; Sarah,0,0,15,15
1746554718448,EDS 289C,A01,895770,Daly; Alan J.,15,0,15,0
1746554719473,EDS 290,A00,897211,Hofstetter; Carolyn,0,0,15,15
1746554720498,LIGM 5A,A00,896162,Fischer-Grunski; Eva K,13,0,20,7
1746554721526,LIGM 5B,A00,896260,Fischer-Grunski; Eva K,17,0,20,3
1746554722555,LIGM 5C,A00,896308,Fischer-Grunski; Eva K,18,0,20,2
1746554723792,LIIT 5AS,A00,896313,Carnelos; Chiara,18,0,20,2
1746554725036,LIIT 5BS,A00,896416,Carnelos; Chiara,20,0,20,0
1746554726065,LIIT 5CS,A00,896564,Carnelos; Chiara,20,0,20,0
1746554727091,LISP 5A,A00,896588,Munoz Sanchez; Alicia,3,0,20,17
1746554728117,LISP 5B,A00,896653,Munoz Sanchez; Alicia,7,0,20,13
1746554729184,LISP 5C,A00,896655,Munoz Sanchez; Alicia,0,1,20,20
1746554730210,MAE 197,001,957918,Kleissl; Jan,9996,0,9999,3
1746554730210,MAE 197,002,959806,Boechler; Nicholas Sebastia,9998,0,9999,1
1746554730210,MAE 197,003,959852,Mullin; Jennifer S,9998,0,9999,1
1746554731236,MATH 2,A01,957937,Staff,33,0,35,2
1746554732260,MATH 197,001,957876,Kedlaya; Kiran S.,9993,0,9999,6
1746554733286,MCWP 40,A00,892729,Duru; Nur,10,0,20,10
1746554733286,MCWP 40,B00,893304,Montejo; Carolina,14,0,20,6
1746554734310,MCWP 40R,A00,893757,Redela; Pamela Morgan,0,5,20,20
1746554735337,MCWP 50,A00,893758,Morshed; Michael James,0,0,20,20
1746554735337,MCWP 50,B00,893761,Bartulis; Jason Michael,17,0,20,3
1746554736363,MCWP 50R,A00,893766,Compas; Sean Matthew,0,1,20,20
1746554736363,MCWP 50R,B00,893769,Carter; Jennifer A,0,1,20,20
1746554736363,MCWP 50R,C00,893771,Krone; Jarret,0,3,20,20
1746554736363,MCWP 50R,D00,893772,Miller; Elizabeth Deen,0,0,20,20
1746554736363,MCWP 50R,E00,893775,Carter; Andrea L,0,1,20,20
1746554737389,MMW 11R,A01,892721,Herbst; Matthew,11,0,27,16
1746554737389,MMW 11R,A02,892722,Herbst; Matthew,0,0,0,3
1746554738413,MMW 12R,A01,892724,Herbst; Matthew,0,11,16,16
1746554738413,MMW 12R,A02,892725,Herbst; Matthew,0,10,16,16
1746554739478,MMW 13R,A01,892727,Staff,0,4,16,16
1746554739478,MMW 13R,A02,892728,Staff,0,4,16,16
1746554739478,MMW 13R,A03,958032,Staff,0,4,16,16
1746554739478,MMW 13R,A04,958033,Staff,0,4,16,16
1746554739478,MMW 13R,A05,958034,Staff,0,4,16,16
1746554740506,SIO 295LS,A00,894015,Staff,5,0,25,20
1746554741532,SIO 295S,A00,894020,Staff,5,0,25,20
1746554742562,SIOC 290S,B01,958918,Merrifield; Mark A,14,0,30,16
1746554743585,SIOC 291S,B01,958922,Gabriel; Corey John,14,0,30,16
1746554744613,SOCI 117,A01,895339,Staff,3,0,5,2
1746554745640,WES 237B,A00,894149,Staff,11,0,20,9
1746554747703,AESE 279B,A00,891859,Staff,13,0,35,22
1746554748727,AIP 197,001,891854,Vespa; Emanuel Ignacio,9999,0,9999,0
1746554749757,ANTH 289S,A00,891856,Gagneux; Pascal,12,0,12,0
1746554750782,BENG 196,001,957946,Engler; Adam J.,9996,0,9999,3
1746554751807,BISP 197,001,959851,Wilhelm; James E.,9998,0,9999,1
1746554752832,CAT 124RS,A01,956906,Staff,6,0,25,19
1746554753858,CAT 125RS,A01,922013,Staff,6,0,25,19
1746554754882,CLRE 250,A00,891860,Morris; Sheldon,9995,0,9999,4
1746554756934,CLRE 251R,A00,907817,Mehta; Ravindra L.,9994,0,9999,5
1746554757958,CLRE 252,A00,891864,Cuomo; Raphael Eduardo,9993,0,9999,6
1746554758984,CLRE 253,A00,891867,Vaida; Florin,9994,0,9999,5
1746554758984,CLRE 253,B00,907819,Staff,9999,0,9999,0
1746554760011,CLRE 259,A00,891868,Patel; Hemal,9998,0,9999,1
1746554761034,CLRE 260,A00,891872,Cuomo; Raphael Eduardo,9999,0,9999,0
1746554762059,CLRE 297,001,891888,Cuomo; Raphael Eduardo,9999,0,9999,0
1746554763083,CSE 191,A00,958773,Minnes Kemp; Mor Mia,9995,0,9999,4
1746554764109,CSE 197,001,959846,Minnes Kemp; Mor Mia,9990,0,9999,9
1746554765135,CSS 201S,A01,892054,Mignozzetti; Umberto,26,0,30,4
1746554766163,CSS 202S,A01,892056,Mignozzetti; Umberto,26,0,30,4
1746554767187,DSC 197,001,956898,Eldridge; Justin Matthew,9997,0,9999,2
1746554768216,DSC 297,001,958000,Mazumdar; Arya,9998,0,9999,1
1746554768216,DSC 297,002,959862,Wang; Yusu,9998,0,9999,1
1746554769240,EAP 100,A00,905686,Staff,9778,0,9999,221
1746554770267,ECE 45,A01,892618,Staff,0,0,65,65
1746554772385,ECE 111,A01,892719,Staff,4,0,65,61
1746554773410,ECE 197,001,957920,Mercier; Patrick Philip,9991,0,9999,8
1746554774435,ECON 178,A01,907814,Zhu; Ying,26,0,35,9
1746554775466,EDS 115,A00,895312,Staff,35,0,45,10
1746554776491,EDS 117,A01,895337,Staff,23,0,30,7
1746554777517,EDS 125,A00,895341,Jones; Gabrielle Anastasia,36,0,45,9
1746554778547,EDS 128A,A01,895459,Fargason; Sharon Gayle,44,0,45,1
1746554779574,EDS 128B,A01,895543,Pappas; Elizabeth,44,0,45,1
1746554780603,EDS 139,A00,897203,Pappas; Elizabeth,44,0,45,1
1746554780603,EDS 139,B00,897209,Fargason; Sharon Gayle,41,0,45,4
1746554781629,EDS 201,A00,895545,Staff,22,0,45,23
1746554782659,EDS 203,A01,895581,Halter; Christopher P.,22,0,45,23
1746554783684,EDS 204R,A01,895625,Heinzman; Erica M.,39,0,45,6
1746554783684,EDS 204R,B01,895693,Halter; Christopher P.,10,0,45,35
1746554784710,EDS 206R,A00,895694,Fargason; Sharon Gayle,1,0,30,29
1746554784710,EDS 206R,B00,895695,Choi; Bailey Miyeon,16,0,30,14
1746554785738,EDS 250,A00,895697,Hemans; Patricia Ann Benitez,22,0,45,23
1746554786765,EDS 281,A00,895701,Meyerott; Theresa Ann,1,0,15,14
1746554787792,EDS 284,A00,895736,Meyerott; Theresa Ann,1,0,15,14
1746554788820,EDS 286,A00,897210,Fine; Sarah,0,0,15,15
1746554789844,EDS 289C,A01,895770,Daly; Alan J.,15,0,15,0
1746554790872,EDS 290,A00,897211,Hofstetter; Carolyn,0,0,15,15
1746554791897,LIGM 5A,A00,896162,Fischer-Grunski; Eva K,13,0,20,7
1746554792922,LIGM 5B,A00,896260,Fischer-Grunski; Eva K,17,0,20,3
1746554793948,LIGM 5C,A00,896308,Fischer-Grunski; Eva K,18,0,20,2
1746554794976,LIIT 5AS,A00,896313,Carnelos; Chiara,18,0,20,2
1746554796000,LIIT 5BS,A00,896416,Carnelos; Chiara,20,0,20,0
1746554797027,LIIT 5CS,A00,896564,Carnelos; Chiara,20,0,20,0
1746554798056,LISP 5A,A00,896588,Munoz Sanchez; Alicia,3,0,20,17
1746554799084,LISP 5B,A00,896653,Munoz Sanchez; Alicia,7,0,20,13
1746554800108,LISP 5C,A00,896655,Munoz Sanchez; Alicia,0,1,20,20
1746554801134,MAE 197,001,957918,Kleissl; Jan,9996,0,9999,3
1746554801134,MAE 197,002,959806,Boechler; Nicholas Sebastia,9998,0,9999,1
1746554801134,MAE 197,003,959852,Mullin; Jennifer S,9998,0,9999,1
1746554802159,MATH 2,A01,957937,Staff,33,0,35,2
1746554803185,MATH 197,001,957876,Kedlaya; Kiran S.,9993,0,9999,6
1746554804209,MCWP 40,A00,892729,Duru; Nur,10,0,20,10
1746554804209,MCWP 40,B00,893304,Montejo; Carolina,14,0,20,6
1746554805233,MCWP 40R,A00,893757,Redela; Pamela Morgan,0,5,20,20
1746554806257,MCWP 50,A00,893758,Morshed; Michael James,0,0,20,20
1746554806257,MCWP 50,B00,893761,Bartulis; Jason Michael,17,0,20,3
1746554807281,MCWP 50R,A00,893766,Compas; Sean Matthew,0,1,20,20
1746554807281,MCWP 50R,B00,893769,Carter; Jennifer A,0,1,20,20
1746554807281,MCWP 50R,C00,893771,Krone; Jarret,0,3,20,20
1746554807281,MCWP 50R,D00,893772,Miller; Elizabeth Deen,0,0,20,20
1746554807281,MCWP 50R,E00,893775,Carter; Andrea L,0,1,20,20
1746554808310,MMW 11R,A01,892721,Herbst; Matthew,11,0,27,16
1746554808310,MMW 11R,A02,892722,Herbst; Matthew,0,0,0,3
1746554809335,MMW 12R,A01,892724,Herbst; Matthew,0,11,16,16
1746554809335,MMW 12R,A02,892725,Herbst; Matthew,0,10,16,16
1746554810364,MMW 13R,A01,892727,Staff,0,4,16,16
1746554810364,MMW 13R,A02,892728,Staff,0,4,16,16
1746554810364,MMW 13R,A03,958032,Staff,0,4,16,16
1746554810364,MMW 13R,A04,958033,Staff,0,4,16,16
1746554810364,MMW 13R,A05,958034,Staff,0,4,16,16
1746554811391,SIO 295LS,A00,894015,Staff,5,0,25,20
1746554812423,SIO 295S,A00,894020,Staff,5,0,25,20
1746554813448,SIOC 290S,B01,958918,Merrifield; Mark A,14,0,30,16
1746554814474,SIOC 291S,B01,958922,Gabriel; Corey John,14,0,30,16
1746554815502,SOCI 117,A01,895339,Staff,3,0,5,2
1746554816525,WES 237B,A00,894149,Staff,11,0,20,9
1746554818590,AESE 279B,A00,891859,Staff,13,0,35,22
1746554819614,AIP 197,001,891854,Vespa; Emanuel Ignacio,9999,0,9999,0
1746554820642,ANTH 289S,A00,891856,Gagneux; Pascal,12,0,12,0
1746554821670,BENG 196,001,957946,Engler; Adam J.,9996,0,9999,3
1746554822717,BISP 197,001,959851,Wilhelm; James E.,9998,0,9999,1
1746554823743,CAT 124RS,A01,956906,Staff,6,0,25,19
1746554824771,CAT 125RS,A01,922013,Staff,6,0,25,19
1746554825794,CLRE 250,A00,891860,Morris; Sheldon,9995,0,9999,4
1746554827843,CLRE 251R,A00,907817,Mehta; Ravindra L.,9994,0,9999,5
1746554828873,CLRE 252,A00,891864,Cuomo; Raphael Eduardo,9993,0,9999,6
1746554829898,CLRE 253,A00,891867,Vaida; Florin,9994,0,9999,5
1746554829898,CLRE 253,B00,907819,Staff,9999,0,9999,0
1746554830925,CLRE 259,A00,891868,Patel; Hemal,9998,0,9999,1
1746554831949,CLRE 260,A00,891872,Cuomo; Raphael Eduardo,9999,0,9999,0
1746554832976,CLRE 297,001,891888,Cuomo; Raphael Eduardo,9999,0,9999,0
1746554834002,CSE 191,A00,958773,Minnes Kemp; Mor Mia,9995,0,9999,4
1746554835027,CSE 197,001,959846,Minnes Kemp; Mor Mia,9990,0,9999,9
1746554836050,CSS 201S,A01,892054,Mignozzetti; Umberto,26,0,30,4
1746554837075,CSS 202S,A01,892056,Mignozzetti; Umberto,26,0,30,4
1746554838099,DSC 197,001,956898,Eldridge; Justin Matthew,9997,0,9999,2
1746554839124,DSC 297,001,958000,Mazumdar; Arya,9998,0,9999,1
1746554839124,DSC 297,002,959862,Wang; Yusu,9998,0,9999,1
1746554840148,EAP 100,A00,905686,Staff,9778,0,9999,221
1746554841174,ECE 45,A01,892618,Staff,0,0,65,65
1746554843227,ECE 111,A01,892719,Staff,4,0,65,61
1746554844251,ECE 197,001,957920,Mercier; Patrick Philip,9991,0,9999,8
1746554845276,ECON 178,A01,907814,Zhu; Ying,26,0,35,9
1746554846302,EDS 115,A00,895312,Staff,35,0,45,10
1746554847329,EDS 117,A01,895337,Staff,23,0,30,7
1746554848355,EDS 125,A00,895341,Jones; Gabrielle Anastasia,36,0,45,9
1746554849381,EDS 128A,A01,895459,Fargason; Sharon Gayle,44,0,45,1
1746554850410,EDS 128B,A01,895543,Pappas; Elizabeth,44,0,45,1
1746554851437,EDS 139,A00,897203,Pappas; Elizabeth,44,0,45,1
1746554851437,EDS 139,B00,897209,Fargason; Sharon Gayle,41,0,45,4
1746554852463,EDS 201,A00,895545,Staff,22,0,45,23
1746554853490,EDS 203,A01,895581,Halter; Christopher P.,22,0,45,23
1746554854517,EDS 204R,A01,895625,Heinzman; Erica M.,39,0,45,6
1746554854517,EDS 204R,B01,895693,Halter; Christopher P.,10,0,45,35
1746554855544,EDS 206R,A00,895694,Fargason; Sharon Gayle,1,0,30,29
1746554855544,EDS 206R,B00,895695,Choi; Bailey Miyeon,16,0,30,14
1746554856573,EDS 250,A00,895697,Hemans; Patricia Ann Benitez,22,0,45,23
1746554857599,EDS 281,A00,895701,Meyerott; Theresa Ann,1,0,15,14
1746554858626,EDS 284,A00,895736,Meyerott; Theresa Ann,1,0,15,14
1746554859654,EDS 286,A00,897210,Fine; Sarah,0,0,15,15
1746554860679,EDS 289C,A01,895770,Daly; Alan J.,15,0,15,0
1746554861704,EDS 290,A00,897211,Hofstetter; Carolyn,0,0,15,15
1746554862754,LIGM 5A,A00,896162,Fischer-Grunski; Eva K,13,0,20,7
1746554863783,LIGM 5B,A00,896260,Fischer-Grunski; Eva K,17,0,20,3
1746554864808,LIGM 5C,A00,896308,Fischer-Grunski; Eva K,18,0,20,2
1746554865836,LIIT 5AS,A00,896313,Carnelos; Chiara,18,0,20,2
1746554866860,LIIT 5BS,A00,896416,Carnelos; Chiara,20,0,20,0
1746554867884,LIIT 5CS,A00,896564,Carnelos; Chiara,20,0,20,0
1746554868913,LISP 5A,A00,896588,Munoz Sanchez; Alicia,3,0,20,17
1746554869941,LISP 5B,A00,896653,Munoz Sanchez; Alicia,7,0,20,13
1746554870966,LISP 5C,A00,896655,Munoz Sanchez; Alicia,0,1,20,20
1746554871992,MAE 197,001,957918,Kleissl; Jan,9996,0,9999,3
1746554871992,MAE 197,002,959806,Boechler; Nicholas Sebastia,9998,0,9999,1
1746554871992,MAE 197,003,959852,Mullin; Jennifer S,9998,0,9999,1
1746554873016,MATH 2,A01,957937,Staff,33,0,35,2
1746554874041,MATH 197,001,957876,Kedlaya; Kiran S.,9993,0,9999,6
1746554875071,MCWP 40,A00,892729,Duru; Nur,10,0,20,10
1746554875071,MCWP 40,B00,893304,Montejo; Carolina,14,0,20,6
1746554876096,MCWP 40R,A00,893757,Redela; Pamela Morgan,0,5,20,20
1746554877120,MCWP 50,A00,893758,Morshed; Michael James,0,0,20,20
1746554877120,MCWP 50,B00,893761,Bartulis; Jason Michael,17,0,20,3
1746554878146,MCWP 50R,A00,893766,Compas; Sean Matthew,0,1,20,20
1746554878146,MCWP 50R,B00,893769,Carter; Jennifer A,0,1,20,20
1746554878146,MCWP 50R,C00,893771,Krone; Jarret,0,3,20,20
1746554878146,MCWP 50R,D00,893772,Miller; Elizabeth Deen,0,0,20,20
1746554878146,MCWP 50R,E00,893775,Carter; Andrea L,0,1,20,20
1746554879171,MMW 11R,A01,892721,Herbst; Matthew,11,0,27,16
1746554879171,MMW 11R,A02,892722,Herbst; Matthew,0,0,0,3
1746554880195,MMW 12R,A01,892724,Herbst; Matthew,0,11,16,16
1746554880195,MMW 12R,A02,892725,Herbst; Matthew,0,10,16,16
1746554881224,MMW 13R,A01,892727,Staff,0,4,16,16
1746554881224,MMW 13R,A02,892728,Staff,0,4,16,16
1746554881224,MMW 13R,A03,958032,Staff,0,4,16,16
1746554881224,MMW 13R,A04,958033,Staff,0,4,16,16
1746554881224,MMW 13R,A05,958034,Staff,0,4,16,16
1746554882253,SIO 295LS,A00,894015,Staff,5,0,25,20
1746554883291,SIO 295S,A00,894020,Staff,5,0,25,20
1746554884315,SIOC 290S,B01,958918,Merrifield; Mark A,14,0,30,16
1746554885343,SIOC 291S,B01,958922,Gabriel; Corey John,14,0,30,16
1746554886367,SOCI 117,A01,895339,Staff,3,0,5,2
1746554887394,WES 237B,A00,894149,Staff,11,0,20,9
1746554889458,AESE 279B,A00,891859,Staff,13,0,35,22
1746554890482,AIP 197,001,891854,Vespa; Emanuel Ignacio,9999,0,9999,0
1746554891506,ANTH 289S,A00,891856,Gagneux; Pascal,12,0,12,0
1746554892530,BENG 196,001,957946,Engler; Adam J.,9996,0,9999,3
1746554893557,BISP 197,001,959851,Wilhelm; James E.,9998,0,9999,1
1746554894582,CAT 124RS,A01,956906,Staff,6,0,25,19
1746554895607,CAT 125RS,A01,922013,Staff,6,0,25,19
1746554896632,CLRE 250,A00,891860,Morris; Sheldon,9995,0,9999,4
1746554898686,CLRE 251R,A00,907817,Mehta; Ravindra L.,9994,0,9999,5
1746554899711,CLRE 252,A00,891864,Cuomo; Raphael Eduardo,9993,0,9999,6
1746554900749,CLRE 253,A00,891867,Vaida; Florin,9994,0,9999,5
1746554900749,CLRE 253,B00,907819,Staff,9999,0,9999,0
1746554901773,CLRE 259,A00,891868,Patel; Hemal,9998,0,9999,1
1746554902801,CLRE 260,A00,891872,Cuomo; Raphael Eduardo,9999,0,9999,0
1746554903825,CLRE 297,001,891888,Cuomo; Raphael Eduardo,9999,0,9999,0
1746554904852,CSE 191,A00,958773,Minnes Kemp; Mor Mia,9995,0,9999,4
1746554905877,CSE 197,001,959846,Minnes Kemp; Mor Mia,9990,0,9999,9
1746554906901,CSS 201S,A01,892054,Mignozzetti; Umberto,26,0,30,4
1746554907930,CSS 202S,A01,892056,Mignozzetti; Umberto,26,0,30,4
1746554908955,DSC 197,001,956898,Eldridge; Justin Matthew,9997,0,9999,2
1746554909999,DSC 297,001,958000,Mazumdar; Arya,9998,0,9999,1
1746554909999,DSC 297,002,959862,Wang; Yusu,9998,0,9999,1
1746554911025,EAP 100,A00,905686,Staff,9778,0,9999,221
1746554912050,ECE 45,A01,892618,Staff,0,0,65,65
1746554914097,ECE 111,A01,892719,Staff,4,0,65,61
1746554915122,ECE 197,001,957920,Mercier; Patrick Philip,9991,0,9999,8
1746554916149,ECON 178,A01,907814,Zhu; Ying,26,0,35,9
1746554917174,EDS 115,A00,895312,Staff,35,0,45,10
1746554918201,EDS 117,A01,895337,Staff,23,0,30,7
1746554919227,EDS 125,A00,895341,Jones; Gabrielle Anastasia,36,0,45,9
1746554920253,EDS 128A,A01,895459,Fargason; Sharon Gayle,44,0,45,1
1746554921282,EDS 128B,A01,895543,Pappas; Elizabeth,44,0,45,1
1746554922307,EDS 139,A00,897203,Pappas; Elizabeth,44,0,45,1
1746554922307,EDS 139,B00,897209,Fargason; Sharon Gayle,41,0,45,4
1746554923333,EDS 201,A00,895545,Staff,22,0,45,23
1746554924361,EDS 203,A01,895581,Halter; Christopher P.,22,0,45,23
1746554925390,EDS 204R,A01,895625,Heinzman; Erica M.,39,0,45,6
1746554925390,EDS 204R,B01,895693,Halter; Christopher P.,10,0,45,35
1746554926414,EDS 206R,A00,895694,Fargason; Sharon Gayle,1,0,30,29
1746554926414,EDS 206R,B00,895695,Choi; Bailey Miyeon,16,0,30,14
1746554927437,EDS 250,A00,895697,Hemans; Patricia Ann Benitez,22,0,45,23
1746554928463,EDS 281,A00,895701,Meyerott; Theresa Ann,1,0,15,14
1746554929490,EDS 284,A00,895736,Meyerott; Theresa Ann,1,0,15,14
1746554930516,EDS 286,A00,897210,Fine; Sarah,0,0,15,15
1746554931542,EDS 289C,A01,895770,Daly; Alan J.,15,0,15,0
1746554932567,EDS 290,A00,897211,Hofstetter; Carolyn,0,0,15,15
1746554933594,LIGM 5A,A00,896162,Fischer-Grunski; Eva K,13,0,20,7
1746554934621,LIGM 5B,A00,896260,Fischer-Grunski; Eva K,17,0,20,3
1746554935647,LIGM 5C,A00,896308,Fischer-Grunski; Eva K,18,0,20,2
1746554936672,LIIT 5AS,A00,896313,Carnelos; Chiara,18,0,20,2
1746554937698,LIIT 5BS,A00,896416,Carnelos; Chiara,20,0,20,0
1746554938722,LIIT 5CS,A00,896564,Carnelos; Chiara,20,0,20,0
1746554939752,LISP 5A,A00,896588,Munoz Sanchez; Alicia,3,0,20,17
1746554940777,LISP 5B,A00,896653,Munoz Sanchez; Alicia,7,0,20,13
1746554941805,LISP 5C,A00,896655,Munoz Sanchez; Alicia,0,1,20,20
1746554942837,MAE 197,001,957918,Kleissl; Jan,9996,0,9999,3
1746554942837,MAE 197,002,959806,Boechler; Nicholas Sebastia,9998,0,9999,1
1746554942837,MAE 197,003,959852,Mullin; Jennifer S,9998,0,9999,1
1746554943864,MATH 2,A01,957937,Staff,33,0,35,2
1746554944892,MATH 197,001,957876,Kedlaya; Kiran S.,9993,0,9999,6
1746554945921,MCWP 40,A00,892729,Duru; Nur,10,0,20,10
1746554945921,MCWP 40,B00,893304,Montejo; Carolina,14,0,20,6
1746554946950,MCWP 40R,A00,893757,Redela; Pamela Morgan,0,5,20,20
1746554947979,MCWP 50,A00,893758,Morshed; Michael James,0,0,20,20
1746554947979,MCWP 50,B00,893761,Bartulis; Jason Michael,17,0,20,3
1746554949005,MCWP 50R,A00,893766,Compas; Sean Matthew,0,1,20,20
1746554949005,MCWP 50R,B00,893769,Carter; Jennifer A,0,1,20,20
1746554949005,MCWP 50R,C00,893771,Krone; Jarret,0,3,20,20
1746554949005,MCWP 50R,D00,893772,Miller; Elizabeth Deen,0,0,20,20
1746554949005,MCWP 50R,E00,893775,Carter; Andrea L,0,1,20,20
1746554950034,MMW 11R,A01,892721,Herbst; Matthew,11,0,27,16
1746554950034,MMW 11R,A02,892722,Herbst; Matthew,0,0,0,3
1746554951062,MMW 12R,A01,892724,Herbst; Matthew,0,11,16,16
1746554951062,MMW 12R,A02,892725,Herbst; Matthew,0,10,16,16
1746554952086,MMW 13R,A01,892727,Staff,0,4,16,16
1746554952086,MMW 13R,A02,892728,Staff,0,4,16,16
1746554952086,MMW 13R,A03,958032,Staff,0,4,16,16
1746554952086,MMW 13R,A04,958033,Staff,0,4,16,16
1746554952086,MMW 13R,A05,958034,Staff,0,4,16,16
1746554953113,SIO 295LS,A00,894015,Staff,5,0,25,20
1746554954140,SIO 295S,A00,894020,Staff,5,0,25,20
1746554955169,SIOC 290S,B01,958918,Merrifield; Mark A,14,0,30,16
1746554956197,SIOC 291S,B01,958922,Gabriel; Corey John,14,0,30,16
1746554957223,SOCI 117,A01,895339,Staff,3,0,5,2
1746554958250,WES 237B,A00,894149,Staff,11,0,20,9
1746554960310,AESE 279B,A00,891859,Staff,13,0,35,22
1746554961338,AIP 197,001,891854,Vespa; Emanuel Ignacio,9999,0,9999,0
1746554962366,ANTH 289S,A00,891856,Gagneux; Pascal,12,0,12,0
1746554963391,BENG 196,001,957946,Engler; Adam J.,9996,0,9999,3
1746554964416,BISP 197,001,959851,Wilhelm; James E.,9998,0,9999,1
1746554965441,CAT 124RS,A01,956906,Staff,6,0,25,19
1746554966470,CAT 125RS,A01,922013,Staff,6,0,25,19
1746554967499,CLRE 250,A00,891860,Morris; Sheldon,9995,0,9999,4
1746554969553,CLRE 251R,A00,907817,Mehta; Ravindra L.,9994,0,9999,5
1746554970576,CLRE 252,A00,891864,Cuomo; Raphael Eduardo,9993,0,9999,6
1746554971623,CLRE 253,A00,891867,Vaida; Florin,9994,0,9999,5
1746554971623,CLRE 253,B00,907819,Staff,9999,0,9999,0
1746554972649,CLRE 259,A00,891868,Patel; Hemal,9998,0,9999,1
1746554973674,CLRE 260,A00,891872,Cuomo; Raphael Eduardo,9999,0,9999,0
1746554974701,CLRE 297,001,891888,Cuomo; Raphael Eduardo,9999,0,9999,0
1746554975726,CSE 191,A00,958773,Minnes Kemp; Mor Mia,9995,0,9999,4
1746554976753,CSE 197,001,959846,Minnes Kemp; Mor Mia,9990,0,9999,9
1746554977779,CSS 201S,A01,892054,Mignozzetti; Umberto,26,0,30,4
1746554978810,CSS 202S,A01,892056,Mignozzetti; Umberto,26,0,30,4
1746554979834,DSC 197,001,956898,Eldridge; Justin Matthew,9997,0,9999,2
1746554980860,DSC 297,001,958000,Mazumdar; Arya,9998,0,9999,1
1746554980860,DSC 297,002,959862,Wang; Yusu,9998,0,9999,1
1746554981888,EAP 100,A00,905686,Staff,9778,0,9999,221
1746554982917,ECE 45,A01,892618,Staff,0,0,65,65
1746554984970,ECE 111,A01,892719,Staff,4,0,65,61
1746554985994,ECE 197,001,957920,Mercier; Patrick Philip,9991,0,9999,8
1746554987021,ECON 178,A01,907814,Zhu; Ying,26,0,35,9
1746554988048,EDS 115,A00,895312,Staff,35,0,45,10
1746554989073,EDS 117,A01,895337,Staff,23,0,30,7
1746554990099,EDS 125,A00,895341,Jones; Gabrielle Anastasia,36,0,45,9
1746554991127,EDS 128A,A01,895459,Fargason; Sharon Gayle,44,0,45,1
1746554992155,EDS 128B,A01,895543,Pappas; Elizabeth,44,0,45,1
1746554993181,EDS 139,A00,897203,Pappas; Elizabeth,44,0,45,1
1746554993181,EDS 139,B00,897209,Fargason; Sharon Gayle,41,0,45,4
1746554994205,EDS 201,A00,895545,Staff,22,0,45,23
1746554995230,EDS 203,A01,895581,Halter; Christopher P.,22,0,45,23
1746554996258,EDS 204R,A01,895625,Heinzman; Erica M.,39,0,45,6
1746554996258,EDS 204R,B01,895693,Halter; Christopher P.,10,0,45,35
1746554997283,EDS 206R,A00,895694,Fargason; Sharon Gayle,1,0,30,29
1746554997283,EDS 206R,B00,895695,Choi; Bailey Miyeon,16,0,30,14
1746554998309,EDS 250,A00,895697,Hemans; Patricia Ann Benitez,22,0,45,23
1746554999355,EDS 281,A00,895701,Meyerott; Theresa Ann,1,0,15,14
1746555000382,EDS 284,A00,895736,Meyerott; Theresa Ann,1,0,15,14
1746555001411,EDS 286,A00,897210,Fine; Sarah,0,0,15,15
1746555002437,EDS 289C,A01,895770,Daly; Alan J.,15,0,15,0
1746555003464,EDS 290,A00,897211,Hofstetter; Carolyn,0,0,15,15
1746555004489,LIGM 5A,A00,896162,Fischer-Grunski; Eva K,13,0,20,7
1746555005517,LIGM 5B,A00,896260,Fischer-Grunski; Eva K,17,0,20,3
1746555006546,LIGM 5C,A00,896308,Fischer-Grunski; Eva K,18,0,20,2
1746555007576,LIIT 5AS,A00,896313,Carnelos; Chiara,18,0,20,2
1746555008604,LIIT 5BS,A00,896416,Carnelos; Chiara,20,0,20,0
1746555009629,LIIT 5CS,A00,896564,Carnelos; Chiara,20,0,20,0
1746555010653,LISP 5A,A00,896588,Munoz Sanchez; Alicia,3,0,20,17
1746555011682,LISP 5B,A00,896653,Munoz Sanchez; Alicia,7,0,20,13
1746555012709,LISP 5C,A00,896655,Munoz Sanchez; Alicia,0,1,20,20
1746555013734,MAE 197,001,957918,Kleissl; Jan,9996,0,9999,3
1746555013734,MAE 197,002,959806,Boechler; Nicholas Sebastia,9998,0,9999,1
1746555013734,MAE 197,003,959852,Mullin; Jennifer S,9998,0,9999,1
1746555014761,MATH 2,A01,957937,Staff,33,0,35,2
1746555015789,MATH 197,001,957876,Kedlaya; Kiran S.,9993,0,9999,6
1746555016814,MCWP 40,A00,892729,Duru; Nur,10,0,20,10
1746555016814,MCWP 40,B00,893304,Montejo; Carolina,14,0,20,6
1746555017845,MCWP 40R,A00,893757,Redela; Pamela Morgan,0,5,20,20
1746555018869,MCWP 50,A00,893758,Morshed; Michael James,0,0,20,20
1746555018869,MCWP 50,B00,893761,Bartulis; Jason Michael,17,0,20,3
1746555019898,MCWP 50R,A00,893766,Compas; Sean Matthew,0,1,20,20
1746555019898,MCWP 50R,B00,893769,Carter; Jennifer A,0,1,20,20
1746555019898,MCWP 50R,C00,893771,Krone; Jarret,0,3,20,20
1746555019898,MCWP 50R,D00,893772,Miller; Elizabeth Deen,0,0,20,20
1746555019898,MCWP 50R,E00,893775,Carter; Andrea L,0,1,20,20
1746555020923,MMW 11R,A01,892721,Herbst; Matthew,11,0,27,16
1746555020923,MMW 11R,A02,892722,Herbst; Matthew,0,0,0,3
1746555021948,MMW 12R,A01,892724,Herbst; Matthew,0,11,16,16
1746555021948,MMW 12R,A02,892725,Herbst; Matthew,0,10,16,16
1746555022972,MMW 13R,A01,892727,Staff,0,4,16,16
1746555022972,MMW 13R,A02,892728,Staff,0,4,16,16
1746555022972,MMW 13R,A03,958032,Staff,0,4,16,16
1746555022972,MMW 13R,A04,958033,Staff,0,4,16,16
1746555022972,MMW 13R,A05,958034,Staff,0,4,16,16
1746555023998,SIO 295LS,A00,894015,Staff,5,0,25,20
1746555025023,SIO 295S,A00,894020,Staff,5,0,25,20
1746555026049,SIOC 290S,B01,958918,Merrifield; Mark A,14,0,30,16
1746555027078,SIOC 291S,B01,958922,Gabriel; Corey John,14,0,30,16
1746555028105,SOCI 117,A01,895339,Staff,3,0,5,2
1746555029132,WES 237B,A00,894149,Staff,11,0,20,9
1746555031192,AESE 279B,A00,891859,Staff,13,0,35,22
1746555032215,AIP 197,001,891854,Vespa; Emanuel Ignacio,9999,0,9999,0
1746555033240,ANTH 289S,A00,891856,Gagneux; Pascal,12,0,12,0
1746555034264,BENG 196,001,957946,Engler; Adam J.,9996,0,9999,3
1746555035290,BISP 197,001,959851,Wilhelm; James E.,9998,0,9999,1
1746555036317,CAT 124RS,A01,956906,Staff,6,0,25,19
1746555037343,CAT 125RS,A01,922013,Staff,6,0,25,19
1746555038369,CLRE 250,A00,891860,Morris; Sheldon,9995,0,9999,4
1746555040422,CLRE 251R,A00,907817,Mehta; Ravindra L.,9994,0,9999,5
1746555041447,CLRE 252,A00,891864,Cuomo; Raphael Eduardo,9993,0,9999,6
1746555042472,CLRE 253,A00,891867,Vaida; Florin,9994,0,9999,5
1746555042472,CLRE 253,B00,907819,Staff,9999,0,9999,0
1746555043496,CLRE 259,A00,891868,Patel; Hemal,9998,0,9999,1
1746555044522,CLRE 260,A00,891872,Cuomo; Raphael Eduardo,9999,0,9999,0
1746555045549,CLRE 297,001,891888,Cuomo; Raphael Eduardo,9999,0,9999,0
1746555046573,CSE 191,A00,958773,Minnes Kemp; Mor Mia,9995,0,9999,4
1746555047601,CSE 197,001,959846,Minnes Kemp; Mor Mia,9990,0,9999,9
1746555048628,CSS 201S,A01,892054,Mignozzetti; Umberto,26,0,30,4
1746555049653,CSS 202S,A01,892056,Mignozzetti; Umberto,26,0,30,4
1746555050679,DSC 197,001,956898,Eldridge; Justin Matthew,9997,0,9999,2
1746555051705,DSC 297,001,958000,Mazumdar; Arya,9998,0,9999,1
1746555051705,DSC 297,002,959862,Wang; Yusu,9998,0,9999,1
1746555052732,EAP 100,A00,905686,Staff,9778,0,9999,221
1746555053758,ECE 45,A01,892618,Staff,0,0,65,65
1746555055809,ECE 111,A01,892719,Staff,4,0,65,61
1746555056834,ECE 197,001,957920,Mercier; Patrick Philip,9991,0,9999,8
1746555057859,ECON 178,A01,907814,Zhu; Ying,26,0,35,9
1746555058883,EDS 115,A00,895312,Staff,35,0,45,10
1746555059909,EDS 117,A01,895337,Staff,23,0,30,7
1746555060935,EDS 125,A00,895341,Jones; Gabrielle Anastasia,36,0,45,9
1746555061961,EDS 128A,A01,895459,Fargason; Sharon Gayle,44,0,45,1
1746555062991,EDS 128B,A01,895543,Pappas; Elizabeth,44,0,45,1
1746555064016,EDS 139,A00,897203,Pappas; Elizabeth,44,0,45,1
1746555064016,EDS 139,B00,897209,Fargason; Sharon Gayle,41,0,45,4
1746555065040,EDS 201,A00,895545,Staff,22,0,45,23
1746555066066,EDS 203,A01,895581,Halter; Christopher P.,22,0,45,23
1746555067094,EDS 204R,A01,895625,Heinzman; Erica M.,39,0,45,6
1746555067094,EDS 204R,B01,895693,Halter; Christopher P.,10,0,45,35
1746555068123,EDS 206R,A00,895694,Fargason; Sharon Gayle,1,0,30,29
1746555068123,EDS 206R,B00,895695,Choi; Bailey Miyeon,16,0,30,14
1746555069149,EDS 250,A00,895697,Hemans; Patricia Ann Benitez,22,0,45,23
1746555070175,EDS 281,A00,895701,Meyerott; Theresa Ann,1,0,15,14
1746555071202,EDS 284,A00,895736,Meyerott; Theresa Ann,1,0,15,14
1746555072231,EDS 286,A00,897210,Fine; Sarah,0,0,15,15
1746555073256,EDS 289C,A01,895770,Daly; Alan J.,15,0,15,0
1746555074285,EDS 290,A00,897211,Hofstetter; Carolyn,0,0,15,15
1746555075310,LIGM 5A,A00,896162,Fischer-Grunski; Eva K,13,0,20,7
1746555076339,LIGM 5B,A00,896260,Fischer-Grunski; Eva K,17,0,20,3
1746555077365,LIGM 5C,A00,896308,Fischer-Grunski; Eva K,18,0,20,2
1746555078390,LIIT 5AS,A00,896313,Carnelos; Chiara,18,0,20,2
1746555079416,LIIT 5BS,A00,896416,Carnelos; Chiara,20,0,20,0
1746555080442,LIIT 5CS,A00,896564,Carnelos; Chiara,20,0,20,0
1746555081467,LISP 5A,A00,896588,Munoz Sanchez; Alicia,3,0,20,17
1746555082493,LISP 5B,A00,896653,Munoz Sanchez; Alicia,7,0,20,13
1746555083517,LISP 5C,A00,896655,Munoz Sanchez; Alicia,0,1,20,20
1746555084541,MAE 197,001,957918,Kleissl; Jan,9996,0,9999,3
1746555084541,MAE 197,002,959806,Boechler; Nicholas Sebastia,9998,0,9999,1
1746555084541,MAE 197,003,959852,Mullin; Jennifer S,9998,0,9999,1
1746555085566,MATH 2,A01,957937,Staff,33,0,35,2
1746555086593,MATH 197,001,957876,Kedlaya; Kiran S.,9993,0,9999,6
1746555087620,MCWP 40,A00,892729,Duru; Nur,10,0,20,10
1746555087620,MCWP 40,B00,893304,Montejo; Carolina,14,0,20,6
1746555088648,MCWP 40R,A00,893757,Redela; Pamela Morgan,0,5,20,20
1746555089673,MCWP 50,A00,893758,Morshed; Michael James,0,0,20,20
1746555089673,MCWP 50,B00,893761,Bartulis; Jason Michael,17,0,20,3
1746555090700,MCWP 50R,A00,893766,Compas; Sean Matthew,0,1,20,20
1746555090700,MCWP 50R,B00,893769,Carter; Jennifer A,0,1,20,20
1746555090700,MCWP 50R,C00,893771,Krone; Jarret,0,3,20,20
1746555090700,MCWP 50R,D00,893772,Miller; Elizabeth Deen,0,0,20,20
1746555090700,MCWP 50R,E00,893775,Carter; Andrea L,0,1,20,20
1746555091726,MMW 11R,A01,892721,Herbst; Matthew,11,0,27,16
1746555091726,MMW 11R,A02,892722,Herbst; Matthew,0,0,0,3
1746555092751,MMW 12R,A01,892724,Herbst; Matthew,0,11,16,16
1746555092751,MMW 12R,A02,892725,Herbst; Matthew,0,10,16,16
1746555093775,MMW 13R,A01,892727,Staff,0,4,16,16
1746555093775,MMW 13R,A02,892728,Staff,0,4,16,16
1746555093775,MMW 13R,A03,958032,Staff,0,4,16,16
1746555093775,MMW 13R,A04,958033,Staff,0,4,16,16
1746555093775,MMW 13R,A05,958034,Staff,0,4,16,16
1746555094803,SIO 295LS,A00,894015,Staff,5,0,25,20
1746555095831,SIO 295S,A00,894020,Staff,5,0,25,20
1746555096859,SIOC 290S,B01,958918,Merrifield; Mark A,14,0,30,16
1746555097886,SIOC 291S,B01,958922,Gabriel; Corey John,14,0,30,16
1746555098916,SOCI 117,A01,895339,Staff,3,0,5,2
1746555099940,WES 237B,A00,894149,Staff,11,0,20,9
1746555102021,AESE 279B,A00,891859,Staff,13,0,35,22
1746555103049,AIP 197,001,891854,Vespa; Emanuel Ignacio,9999,0,9999,0
1746555104073,ANTH 289S,A00,891856,Gagneux; Pascal,12,0,12,0
1746555105100,BENG 196,001,957946,Engler; Adam J.,9996,0,9999,3
1746555106124,BISP 197,001,959851,Wilhelm; James E.,9998,0,9999,1
1746555107150,CAT 124RS,A01,956906,Staff,6,0,25,19
1746555108175,CAT 125RS,A01,922013,Staff,6,0,25,19
1746555109199,CLRE 250,A00,891860,Morris; Sheldon,9995,0,9999,4
1746555111248,CLRE 251R,A00,907817,Mehta; Ravindra L.,9994,0,9999,5
1746555112274,CLRE 252,A00,891864,Cuomo; Raphael Eduardo,9993,0,9999,6
1746555113298,CLRE 253,A00,891867,Vaida; Florin,9994,0,9999,5
1746555113298,CLRE 253,B00,907819,Staff,9999,0,9999,0
1746555114324,CLRE 259,A00,891868,Patel; Hemal,9998,0,9999,1
1746555115351,CLRE 260,A00,891872,Cuomo; Raphael Eduardo,9999,0,9999,0
1746555116375,CLRE 297,001,891888,Cuomo; Raphael Eduardo,9999,0,9999,0
1746555117398,CSE 191,A00,958773,Minnes Kemp; Mor Mia,9995,0,9999,4
1746555118422,CSE 197,001,959846,Minnes Kemp; Mor Mia,9990,0,9999,9
1746555119453,CSS 201S,A01,892054,Mignozzetti; Umberto,26,0,30,4
1746555120485,CSS 202S,A01,892056,Mignozzetti; Umberto,26,0,30,4
1746555121509,DSC 197,001,956898,Eldridge; Justin Matthew,9997,0,9999,2
1746555122533,DSC 297,001,958000,Mazumdar; Arya,9998,0,9999,1
1746555122533,DSC 297,002,959862,Wang; Yusu,9998,0,9999,1
1746555123560,EAP 100,A00,905686,Staff,9778,0,9999,221
1746555124584,ECE 45,A01,892618,Staff,0,0,65,65
1746555126641,ECE 111,A01,892719,Staff,4,0,65,61
1746555127670,ECE 197,001,957920,Mercier; Patrick Philip,9991,0,9999,8
1746555128700,ECON 178,A01,907814,Zhu; Ying,26,0,35,9
1746555129724,EDS 115,A00,895312,Staff,35,0,45,10
1746555130750,EDS 117,A01,895337,Staff,23,0,30,7
1746555131776,EDS 125,A00,895341,Jones; Gabrielle Anastasia,36,0,45,9
1746555132802,EDS 128A,A01,895459,Fargason; Sharon Gayle,44,0,45,1
1746555133830,EDS 128B,A01,895543,Pappas; Elizabeth,44,0,45,1
1746555134858,EDS 139,A00,897203,Pappas; Elizabeth,44,0,45,1
1746555134858,EDS 139,B00,897209,Fargason; Sharon Gayle,41,0,45,4
1746555135884,EDS 201,A00,895545,Staff,22,0,45,23
1746555136913,EDS 203,A01,895581,Halter; Christopher P.,22,0,45,23
1746555137938,EDS 204R,A01,895625,Heinzman; Erica M.,39,0,45,6
1746555137938,EDS 204R,B01,895693,Halter; Christopher P.,10,0,45,35
1746555138963,EDS 206R,A00,895694,Fargason; Sharon Gayle,1,0,30,29
1746555138963,EDS 206R,B00,895695,Choi; Bailey Miyeon,16,0,30,14
1746555140037,EDS 250,A00,895697,Hemans; Patricia Ann Benitez,22,0,45,23
1746555141065,EDS 281,A00,895701,Meyerott; Theresa Ann,1,0,15,14
1746555142090,EDS 284,A00,895736,Meyerott; Theresa Ann,1,0,15,14
1746555143113,EDS 286,A00,897210,Fine; Sarah,0,0,15,15
1746555144143,EDS 289C,A01,895770,Daly; Alan J.,15,0,15,0
1746555145167,EDS 290,A00,897211,Hofstetter; Carolyn,0,0,15,15
1746555146192,LIGM 5A,A00,896162,Fischer-Grunski; Eva K,13,0,20,7
1746555147217,LIGM 5B,A00,896260,Fischer-Grunski; Eva K,17,0,20,3
1746555148241,LIGM 5C,A00,896308,Fischer-Grunski; Eva K,18,0,20,2
1746555149270,LIIT 5AS,A00,896313,Carnelos; Chiara,18,0,20,2
1746555150295,LIIT 5BS,A00,896416,Carnelos; Chiara,20,0,20,0
1746555151322,LIIT 5CS,A00,896564,Carnelos; Chiara,20,0,20,0
1746555152350,LISP 5A,A00,896588,Munoz Sanchez; Alicia,3,0,20,17
1746555153374,LISP 5B,A00,896653,Munoz Sanchez; Alicia,7,0,20,13
1746555154402,LISP 5C,A00,896655,Munoz Sanchez; Alicia,0,1,20,20
1746555155429,MAE 197,001,957918,Kleissl; Jan,9996,0,9999,3
1746555155429,MAE 197,002,959806,Boechler; Nicholas Sebastia,9998,0,9999,1
1746555155429,MAE 197,003,959852,Mullin; Jennifer S,9998,0,9999,1
1746555156455,MATH 2,A01,957937,Staff,33,0,35,2
1746555157481,MATH 197,001,957876,Kedlaya; Kiran S.,9993,0,9999,6
1746555158509,MCWP 40,A00,892729,Duru; Nur,10,0,20,10
1746555158509,MCWP 40,B00,893304,Montejo; Carolina,14,0,20,6
1746555159533,MCWP 40R,A00,893757,Redela; Pamela Morgan,0,5,20,20
1746555160558,MCWP 50,A00,893758,Morshed; Michael James,0,0,20,20
1746555160558,MCWP 50,B00,893761,Bartulis; Jason Michael,17,0,20,3
1746555161582,MCWP 50R,A00,893766,Compas; Sean Matthew,0,1,20,20
1746555161582,MCWP 50R,B00,893769,Carter; Jennifer A,0,1,20,20
1746555161582,MCWP 50R,C00,893771,Krone; Jarret,0,3,20,20
1746555161582,MCWP 50R,D00,893772,Miller; Elizabeth Deen,0,0,20,20
1746555161582,MCWP 50R,E00,893775,Carter; Andrea L,0,1,20,20
1746555162609,MMW 11R,A01,892721,Herbst; Matthew,11,0,27,16
1746555162609,MMW 11R,A02,892722,Herbst; Matthew,0,0,0,3
1746555163635,MMW 12R,A01,892724,Herbst; Matthew,0,11,16,16
1746555163635,MMW 12R,A02,892725,Herbst; Matthew,0,10,16,16
1746555164659,MMW 13R,A01,892727,Staff,0,4,16,16
1746555164659,MMW 13R,A02,892728,Staff,0,4,16,16
1746555164659,MMW 13R,A03,958032,Staff,0,4,16,16
1746555164659,MMW 13R,A04,958033,Staff,0,4,16,16
1746555164659,MMW 13R,A05,958034,Staff,0,4,16,16
1746555165685,SIO 295LS,A00,894015,Staff,5,0,25,20
1746555166714,SIO 295S,A00,894020,Staff,5,0,25,20
1746555167743,SIOC 290S,B01,958918,Merrifield; Mark A,14,0,30,16
1746555168773,SIOC 291S,B01,958922,Gabriel; Corey John,14,0,30,16
1746555169805,SOCI 117,A01,895339,Staff,3,0,5,2
1746555170827,WES 237B,A00,894149,Staff,11,0,20,9
1746555172884,AESE 279B,A00,891859,Staff,13,0,35,22
1746555173907,AIP 197,001,891854,Vespa; Emanuel Ignacio,9999,0,9999,0
1746555174934,ANTH 289S,A00,891856,Gagneux; Pascal,12,0,12,0
1746555175959,BENG 196,001,957946,Engler; Adam J.,9996,0,9999,3
1746555176984,BISP 197,001,959851,Wilhelm; James E.,9998,0,9999,1
1746555178012,CAT 124RS,A01,956906,Staff,6,0,25,19
1746555179037,CAT 125RS,A01,922013,Staff,6,0,25,19
1746555180061,CLRE 250,A00,891860,Morris; Sheldon,9995,0,9999,4
1746555182111,CLRE 251R,A00,907817,Mehta; Ravindra L.,9994,0,9999,5
1746555183135,CLRE 252,A00,891864,Cuomo; Raphael Eduardo,9993,0,9999,6
1746555184161,CLRE 253,A00,891867,Vaida; Florin,9994,0,9999,5
1746555184161,CLRE 253,B00,907819,Staff,9999,0,9999,0
1746555185186,CLRE 259,A00,891868,Patel; Hemal,9998,0,9999,1
1746555186210,CLRE 260,A00,891872,Cuomo; Raphael Eduardo,9999,0,9999,0
1746555187235,CLRE 297,001,891888,Cuomo; Raphael Eduardo,9999,0,9999,0
1746555188266,CSE 191,A00,958773,Minnes Kemp; Mor Mia,9995,0,9999,4
1746555189293,CSE 197,001,959846,Minnes Kemp; Mor Mia,9990,0,9999,9
1746555190318,CSS 201S,A01,892054,Mignozzetti; Umberto,26,0,30,4
1746555191348,CSS 202S,A01,892056,Mignozzetti; Umberto,26,0,30,4
1746555192372,DSC 197,001,956898,Eldridge; Justin Matthew,9997,0,9999,2
1746555193398,DSC 297,001,958000,Mazumdar; Arya,9998,0,9999,1
1746555193398,DSC 297,002,959862,Wang; Yusu,9998,0,9999,1
1746555194422,EAP 100,A00,905686,Staff,9778,0,9999,221
1746555195449,ECE 45,A01,892618,Staff,0,0,65,65
1746555197502,ECE 111,A01,892719,Staff,4,0,65,61
1746555198527,ECE 197,001,957920,Mercier; Patrick Philip,9991,0,9999,8
1746555199557,ECON 178,A01,907814,Zhu; Ying,26,0,35,9
1746555200583,EDS 115,A00,895312,Staff,35,0,45,10
1746555201608,EDS 117,A01,895337,Staff,23,0,30,7
1746555202638,EDS 125,A00,895341,Jones; Gabrielle Anastasia,36,0,45,9
1746555203661,EDS 128A,A01,895459,Fargason; Sharon Gayle,44,0,45,1
1746555204688,EDS 128B,A01,895543,Pappas; Elizabeth,44,0,45,1
1746555205713,EDS 139,A00,897203,Pappas; Elizabeth,44,0,45,1
1746555205713,EDS 139,B00,897209,Fargason; Sharon Gayle,41,0,45,4
1746555206737,EDS 201,A00,895545,Staff,22,0,45,23
1746555207766,EDS 203,A01,895581,Halter; Christopher P.,22,0,45,23
1746555208790,EDS 204R,A01,895625,Heinzman; Erica M.,39,0,45,6
1746555208790,EDS 204R,B01,895693,Halter; Christopher P.,10,0,45,35
1746555209818,EDS 206R,A00,895694,Fargason; Sharon Gayle,1,0,30,29
1746555209818,EDS 206R,B00,895695,Choi; Bailey Miyeon,16,0,30,14
1746555210849,EDS 250,A00,895697,Hemans; Patricia Ann Benitez,22,0,45,23
1746555211873,EDS 281,A00,895701,Meyerott; Theresa Ann,1,0,15,14
1746555212896,EDS 284,A00,895736,Meyerott; Theresa Ann,1,0,15,14
1746555213922,EDS 286,A00,897210,Fine; Sarah,0,0,15,15
1746555214949,EDS 289C,A01,895770,Daly; Alan J.,15,0,15,0
1746555215973,EDS 290,A00,897211,Hofstetter; Carolyn,0,0,15,15
1746555216997,LIGM 5A,A00,896162,Fischer-Grunski; Eva K,13,0,20,7
1746555218024,LIGM 5B,A00,896260,Fischer-Grunski; Eva K,17,0,20,3
1746555219049,LIGM 5C,A00,896308,Fischer-Grunski; Eva K,18,0,20,2
1746555220077,LIIT 5AS,A00,896313,Carnelos; Chiara,18,0,20,2
1746555221105,LIIT 5BS,A00,896416,Carnelos; Chiara,20,0,20,0
1746555222130,LIIT 5CS,A00,896564,Carnelos; Chiara,20,0,20,0
1746555223154,LISP 5A,A00,896588,Munoz Sanchez; Alicia,3,0,20,17
1746555224182,LISP 5B,A00,896653,Munoz Sanchez; Alicia,7,0,20,13
1746555225206,LISP 5C,A00,896655,Munoz Sanchez; Alicia,0,1,20,20
1746555226234,MAE 197,001,957918,Kleissl; Jan,9996,0,9999,3
1746555226234,MAE 197,002,959806,Boechler; Nicholas Sebastia,9998,0,9999,1
1746555226234,MAE 197,003,959852,Mullin; Jennifer S,9998,0,9999,1
1746555227259,MATH 2,A01,957937,Staff,33,0,35,2
1746555228285,MATH 197,001,957876,Kedlaya; Kiran S.,9993,0,9999,6
1746555229311,MCWP 40,A00,892729,Duru; Nur,10,0,20,10
1746555229311,MCWP 40,B00,893304,Montejo; Carolina,14,0,20,6
1746555230338,MCWP 40R,A00,893757,Redela; Pamela Morgan,0,5,20,20
1746555231363,MCWP 50,A00,893758,Morshed; Michael James,0,0,20,20
1746555231363,MCWP 50,B00,893761,Bartulis; Jason Michael,17,0,20,3
1746555232400,MCWP 50R,A00,893766,Compas; Sean Matthew,0,1,20,20
1746555232400,MCWP 50R,B00,893769,Carter; Jennifer A,0,1,20,20
1746555232400,MCWP 50R,C00,893771,Krone; Jarret,0,3,20,20
1746555232400,MCWP 50R,D00,893772,Miller; Elizabeth Deen,0,0,20,20
1746555232400,MCWP 50R,E00,893775,Carter; Andrea L,0,1,20,20
1746555233429,MMW 11R,A01,892721,Herbst; Matthew,11,0,27,16
1746555233429,MMW 11R,A02,892722,Herbst; Matthew,0,0,0,3
1746555234456,MMW 12R,A01,892724,Herbst; Matthew,0,11,16,16
1746555234456,MMW 12R,A02,892725,Herbst; Matthew,0,10,16,16
1746555235481,MMW 13R,A01,892727,Staff,0,4,16,16
1746555235481,MMW 13R,A02,892728,Staff,0,4,16,16
1746555235481,MMW 13R,A03,958032,Staff,0,4,16,16
1746555235481,MMW 13R,A04,958033,Staff,0,4,16,16
1746555235481,MMW 13R,A05,958034,Staff,0,4,16,16
1746555236507,SIO 295LS,A00,894015,Staff,5,0,25,20
1746555237533,SIO 295S,A00,894020,Staff,5,0,25,20
1746555238559,SIOC 290S,B01,958918,Merrifield; Mark A,14,0,30,16
1746555239590,SIOC 291S,B01,958922,Gabriel; Corey John,14,0,30,16
1746555240616,SOCI 117,A01,895339,Staff,3,0,5,2
1746555241646,WES 237B,A00,894149,Staff,11,0,20,9
1746555243702,AESE 279B,A00,891859,Staff,13,0,35,22
1746555244730,AIP 197,001,891854,Vespa; Emanuel Ignacio,9999,0,9999,0
1746555245756,ANTH 289S,A00,891856,Gagneux; Pascal,12,0,12,0
1746555246783,BENG 196,001,957946,Engler; Adam J.,9996,0,9999,3
1746555247807,BISP 197,001,959851,Wilhelm; James E.,9998,0,9999,1
1746555248832,CAT 124RS,A01,956906,Staff,6,0,25,19
1746555249859,CAT 125RS,A01,922013,Staff,6,0,25,19
1746555251087,CLRE 250,A00,891860,Morris; Sheldon,9995,0,9999,4
1746555253139,CLRE 251R,A00,907817,Mehta; Ravindra L.,9994,0,9999,5
1746555254166,CLRE 252,A00,891864,Cuomo; Raphael Eduardo,9993,0,9999,6
1746555255191,CLRE 253,A00,891867,Vaida; Florin,9994,0,9999,5
1746555255191,CLRE 253,B00,907819,Staff,9999,0,9999,0
1746555256216,CLRE 259,A00,891868,Patel; Hemal,9998,0,9999,1
1746555257242,CLRE 260,A00,891872,Cuomo; Raphael Eduardo,9999,0,9999,0
1746555258272,CLRE 297,001,891888,Cuomo; Raphael Eduardo,9999,0,9999,0
1746555259299,CSE 191,A00,958773,Minnes Kemp; Mor Mia,9995,0,9999,4
1746555260327,CSE 197,001,959846,Minnes Kemp; Mor Mia,9990,0,9999,9
1746555261354,CSS 201S,A01,892054,Mignozzetti; Umberto,26,0,30,4
1746555262379,CSS 202S,A01,892056,Mignozzetti; Umberto,26,0,30,4
1746555263408,DSC 197,001,956898,Eldridge; Justin Matthew,9997,0,9999,2
1746555264432,DSC 297,001,958000,Mazumdar; Arya,9998,0,9999,1
1746555264432,DSC 297,002,959862,Wang; Yusu,9998,0,9999,1
1746555265458,EAP 100,A00,905686,Staff,9778,0,9999,221
1746555266484,ECE 45,A01,892618,Staff,0,0,65,65
1746555268536,ECE 111,A01,892719,Staff,4,0,65,61
1746555269585,ECE 197,001,957920,Mercier; Patrick Philip,9991,0,9999,8
1746555270614,ECON 178,A01,907814,Zhu; Ying,26,0,35,9
1746555271639,EDS 115,A00,895312,Staff,35,0,45,10
1746555272665,EDS 117,A01,895337,Staff,23,0,30,7
1746555273690,EDS 125,A00,895341,Jones; Gabrielle Anastasia,36,0,45,9
1746555274717,EDS 128A,A01,895459,Fargason; Sharon Gayle,44,0,45,1
1746555275745,EDS 128B,A01,895543,Pappas; Elizabeth,44,0,45,1
1746555276771,EDS 139,A00,897203,Pappas; Elizabeth,44,0,45,1
1746555276771,EDS 139,B00,897209,Fargason; Sharon Gayle,41,0,45,4
1746555277795,EDS 201,A00,895545,Staff,22,0,45,23
1746555278822,EDS 203,A01,895581,Halter; Christopher P.,22,0,45,23
1746555279845,EDS 204R,A01,895625,Heinzman; Erica M.,39,0,45,6
1746555279845,EDS 204R,B01,895693,Halter; Christopher P.,10,0,45,35
1746555280872,EDS 206R,A00,895694,Fargason; Sharon Gayle,1,0,30,29
1746555280872,EDS 206R,B00,895695,Choi; Bailey Miyeon,16,0,30,14
1746555281899,EDS 250,A00,895697,Hemans; Patricia Ann Benitez,22,0,45,23
1746555282924,EDS 281,A00,895701,Meyerott; Theresa Ann,1,0,15,14
1746555283948,EDS 284,A00,895736,Meyerott; Theresa Ann,1,0,15,14
1746555284972,EDS 286,A00,897210,Fine; Sarah,0,0,15,15
1746555286599,EDS 289C,A01,895770,Daly; Alan J.,15,0,15,0
1746555287627,EDS 290,A00,897211,Hofstetter; Carolyn,0,0,15,15
1746555288651,LIGM 5A,A00,896162,Fischer-Grunski; Eva K,13,0,20,7
1746555289674,LIGM 5B,A00,896260,Fischer-Grunski; Eva K,17,0,20,3
1746555290703,LIGM 5C,A00,896308,Fischer-Grunski; Eva K,18,0,20,2
1746555291729,LIIT 5AS,A00,896313,Carnelos; Chiara,18,0,20,2
1746555292756,LIIT 5BS,A00,896416,Carnelos; Chiara,20,0,20,0
1746555293784,LIIT 5CS,A00,896564,Carnelos; Chiara,20,0,20,0
1746555294810,LISP 5A,A00,896588,Munoz Sanchez; Alicia,3,0,20,17
1746555295834,LISP 5B,A00,896653,Munoz Sanchez; Alicia,7,0,20,13
1746555296861,LISP 5C,A00,896655,Munoz Sanchez; Alicia,0,1,20,20
1746555297906,MAE 197,001,957918,Kleissl; Jan,9996,0,9999,3
1746555297906,MAE 197,002,959806,Boechler; Nicholas Sebastia,9998,0,9999,1
1746555297906,MAE 197,003,959852,Mullin; Jennifer S,9998,0,9999,1
1746555298930,MATH 2,A01,957937,Staff,33,0,35,2
1746555299956,MATH 197,001,957876,Kedlaya; Kiran S.,9993,0,9999,6
1746555300981,MCWP 40,A00,892729,Duru; Nur,10,0,20,10
1746555300981,MCWP 40,B00,893304,Montejo; Carolina,14,0,20,6
1746555302008,MCWP 40R,A00,893757,Redela; Pamela Morgan,0,5,20,20
1746555303033,MCWP 50,A00,893758,Morshed; Michael James,0,0,20,20
1746555303033,MCWP 50,B00,893761,Bartulis; Jason Michael,17,0,20,3
1746555304063,MCWP 50R,A00,893766,Compas; Sean Matthew,0,1,20,20
1746555304063,MCWP 50R,B00,893769,Carter; Jennifer A,0,1,20,20
1746555304063,MCWP 50R,C00,893771,Krone; Jarret,0,3,20,20
1746555304063,MCWP 50R,D00,893772,Miller; Elizabeth Deen,0,0,20,20
1746555304063,MCWP 50R,E00,893775,Carter; Andrea L,0,1,20,20
1746555305086,MMW 11R,A01,892721,Herbst; Matthew,11,0,27,16
1746555305086,MMW 11R,A02,892722,Herbst; Matthew,0,0,0,3
1746555306110,MMW 12R,A01,892724,Herbst; Matthew,0,11,16,16
1746555306110,MMW 12R,A02,892725,Herbst; Matthew,0,10,16,16
1746555307137,MMW 13R,A01,892727,Staff,0,4,16,16
1746555307137,MMW 13R,A02,892728,Staff,0,4,16,16
1746555307137,MMW 13R,A03,958032,Staff,0,4,16,16
1746555307137,MMW 13R,A04,958033,Staff,0,4,16,16
1746555307137,MMW 13R,A05,958034,Staff,0,4,16,16
1746555308162,SIO 295LS,A00,894015,Staff,5,0,25,20
1746555309186,SIO 295S,A00,894020,Staff,5,0,25,20
1746555310215,SIOC 290S,B01,958918,Merrifield; Mark A,14,0,30,16
1746555311241,SIOC 291S,B01,958922,Gabriel; Corey John,14,0,30,16
1746555312265,SOCI 117,A01,895339,Staff,3,0,5,2
1746555313290,WES 237B,A00,894149,Staff,11,0,20,9
1746555315348,AESE 279B,A00,891859,Staff,13,0,35,22
1746555316373,AIP 197,001,891854,Vespa; Emanuel Ignacio,9999,0,9999,0
1746555317396,ANTH 289S,A00,891856,Gagneux; Pascal,12,0,12,0
1746555318423,BENG 196,001,957946,Engler; Adam J.,9996,0,9999,3
1746555319447,BISP 197,001,959851,Wilhelm; James E.,9998,0,9999,1
1746555320474,CAT 124RS,A01,956906,Staff,6,0,25,19
1746555321501,CAT 125RS,A01,922013,Staff,6,0,25,19
1746555322526,CLRE 250,A00,891860,Morris; Sheldon,9995,0,9999,4
1746555324583,CLRE 251R,A00,907817,Mehta; Ravindra L.,9994,0,9999,5
1746555325607,CLRE 252,A00,891864,Cuomo; Raphael Eduardo,9993,0,9999,6
1746555326635,CLRE 253,A00,891867,Vaida; Florin,9994,0,9999,5
1746555326635,CLRE 253,B00,907819,Staff,9999,0,9999,0
1746555327659,CLRE 259,A00,891868,Patel; Hemal,9998,0,9999,1
1746555328685,CLRE 260,A00,891872,Cuomo; Raphael Eduardo,9999,0,9999,0
1746555329711,CLRE 297,001,891888,Cuomo; Raphael Eduardo,9999,0,9999,0
1746555330733,CSE 191,A00,958773,Minnes Kemp; Mor Mia,9995,0,9999,4
1746555331758,CSE 197,001,959846,Minnes Kemp; Mor Mia,9990,0,9999,9
1746555332786,CSS 201S,A01,892054,Mignozzetti; Umberto,26,0,30,4
1746555333817,CSS 202S,A01,892056,Mignozzetti; Umberto,26,0,30,4
1746555334841,DSC 197,001,956898,Eldridge; Justin Matthew,9997,0,9999,2
1746555335869,DSC 297,001,958000,Mazumdar; Arya,9998,0,9999,1
1746555335869,DSC 297,002,959862,Wang; Yusu,9998,0,9999,1
1746555336894,EAP 100,A00,905686,Staff,9778,0,9999,221
1746555337917,ECE 45,A01,892618,Staff,0,0,65,65
1746555339970,ECE 111,A01,892719,Staff,4,0,65,61
1746555340998,ECE 197,001,957920,Mercier; Patrick Philip,9991,0,9999,8
1746555342027,ECON 178,A01,907814,Zhu; Ying,26,0,35,9
1746555343056,EDS 115,A00,895312,Staff,35,0,45,10
1746555344082,EDS 117,A01,895337,Staff,23,0,30,7
1746555345109,EDS 125,A00,895341,Jones; Gabrielle Anastasia,36,0,45,9
1746555346135,EDS 128A,A01,895459,Fargason; Sharon Gayle,44,0,45,1
1746555347160,EDS 128B,A01,895543,Pappas; Elizabeth,44,0,45,1
1746555348188,EDS 139,A00,897203,Pappas; Elizabeth,44,0,45,1
1746555348188,EDS 139,B00,897209,Fargason; Sharon Gayle,41,0,45,4
1746555349215,EDS 201,A00,895545,Staff,22,0,45,23
1746555350241,EDS 203,A01,895581,Halter; Christopher P.,22,0,45,23
1746555351269,EDS 204R,A01,895625,Heinzman; Erica M.,39,0,45,6
1746555351269,EDS 204R,B01,895693,Halter; Christopher P.,10,0,45,35
1746555352295,EDS 206R,A00,895694,Fargason; Sharon Gayle,1,0,30,29
1746555352295,EDS 206R,B00,895695,Choi; Bailey Miyeon,16,0,30,14
1746555353320,EDS 250,A00,895697,Hemans; Patricia Ann Benitez,22,0,45,23
1746555354349,EDS 281,A00,895701,Meyerott; Theresa Ann,1,0,15,14
1746555355372,EDS 284,A00,895736,Meyerott; Theresa Ann,1,0,15,14
1746555356399,EDS 286,A00,897210,Fine; Sarah,0,0,15,15
1746555357427,EDS 289C,A01,895770,Daly; Alan J.,15,0,15,0
1746555358450,EDS 290,A00,897211,Hofstetter; Carolyn,0,0,15,15
1746555359476,LIGM 5A,A00,896162,Fischer-Grunski; Eva K,13,0,20,7
1746555360503,LIGM 5B,A00,896260,Fischer-Grunski; Eva K,17,0,20,3
1746555361527,LIGM 5C,A00,896308,Fischer-Grunski; Eva K,18,0,20,2
1746555362557,LIIT 5AS,A00,896313,Carnelos; Chiara,18,0,20,2
1746555363586,LIIT 5BS,A00,896416,Carnelos; Chiara,20,0,20,0
1746555364614,LIIT 5CS,A00,896564,Carnelos; Chiara,20,0,20,0
1746555365638,LISP 5A,A00,896588,Munoz Sanchez; Alicia,3,0,20,17
1746555366662,LISP 5B,A00,896653,Munoz Sanchez; Alicia,7,0,20,13
1746555367689,LISP 5C,A00,896655,Munoz Sanchez; Alicia,0,1,20,20
1746555368713,MAE 197,001,957918,Kleissl; Jan,9996,0,9999,3
1746555368713,MAE 197,002,959806,Boechler; Nicholas Sebastia,9998,0,9999,1
1746555368713,MAE 197,003,959852,Mullin; Jennifer S,9998,0,9999,1
1746555369737,MATH 2,A01,957937,Staff,33,0,35,2
1746555370762,MATH 197,001,957876,Kedlaya; Kiran S.,9993,0,9999,6
1746555371793,MCWP 40,A00,892729,Duru; Nur,10,0,20,10
1746555371793,MCWP 40,B00,893304,Montejo; Carolina,14,0,20,6
1746555372828,MCWP 40R,A00,893757,Redela; Pamela Morgan,0,5,20,20
1746555373854,MCWP 50,A00,893758,Morshed; Michael James,0,0,20,20
1746555373854,MCWP 50,B00,893761,Bartulis; Jason Michael,17,0,20,3
1746555374881,MCWP 50R,A00,893766,Compas; Sean Matthew,0,1,20,20
1746555374881,MCWP 50R,B00,893769,Carter; Jennifer A,0,1,20,20
1746555374881,MCWP 50R,C00,893771,Krone; Jarret,0,3,20,20
1746555374881,MCWP 50R,D00,893772,Miller; Elizabeth Deen,0,0,20,20
1746555374881,MCWP 50R,E00,893775,Carter; Andrea L,0,1,20,20
1746555375909,MMW 11R,A01,892721,Herbst; Matthew,11,0,27,16
1746555375909,MMW 11R,A02,892722,Herbst; Matthew,0,0,0,3
1746555376937,MMW 12R,A01,892724,Herbst; Matthew,0,11,16,16
1746555376937,MMW 12R,A02,892725,Herbst; Matthew,0,10,16,16
1746555377961,MMW 13R,A01,892727,Staff,0,4,16,16
1746555377961,MMW 13R,A02,892728,Staff,0,4,16,16
1746555377961,MMW 13R,A03,958032,Staff,0,4,16,16
1746555377961,MMW 13R,A04,958033,Staff,0,4,16,16
1746555377961,MMW 13R,A05,958034,Staff,0,4,16,16
1746555378988,SIO 295LS,A00,894015,Staff,5,0,25,20
1746555380020,SIO 295S,A00,894020,Staff,5,0,25,20
1746555381047,SIOC 290S,B01,958918,Merrifield; Mark A,14,0,30,16
1746555382072,SIOC 291S,B01,958922,Gabriel; Corey John,14,0,30,16
1746555383101,SOCI 117,A01,895339,Staff,3,0,5,2
1746555384127,WES 237B,A00,894149,Staff,11,0,20,9
1746555386199,AESE 279B,A00,891859,Staff,13,0,35,22
1746555387223,AIP 197,001,891854,Vespa; Emanuel Ignacio,9999,0,9999,0
1746555388249,ANTH 289S,A00,891856,Gagneux; Pascal,12,0,12,0
1746555389273,BENG 196,001,957946,Engler; Adam J.,9996,0,9999,3
1746555390301,BISP 197,001,959851,Wilhelm; James E.,9998,0,9999,1
1746555391324,CAT 124RS,A01,956906,Staff,6,0,25,19
1746555392349,CAT 125RS,A01,922013,Staff,6,0,25,19
1746555393374,CLRE 250,A00,891860,Morris; Sheldon,9995,0,9999,4
1746555395425,CLRE 251R,A00,907817,Mehta; Ravindra L.,9994,0,9999,5
1746555396451,CLRE 252,A00,891864,Cuomo; Raphael Eduardo,9993,0,9999,6
1746555397477,CLRE 253,A00,891867,Vaida; Florin,9994,0,9999,5
1746555397477,CLRE 253,B00,907819,Staff,9999,0,9999,0
1746555398504,CLRE 259,A00,891868,Patel; Hemal,9998,0,9999,1
1746555399532,CLRE 260,A00,891872,Cuomo; Raphael Eduardo,9999,0,9999,0
1746555400558,CLRE 297,001,891888,Cuomo; Raphael Eduardo,9999,0,9999,0
1746555401585,CSE 191,A00,958773,Minnes Kemp; Mor Mia,9995,0,9999,4
1746555402610,CSE 197,001,959846,Minnes Kemp; Mor Mia,9990,0,9999,9
1746555403636,CSS 201S,A01,892054,Mignozzetti; Umberto,26,0,30,4
1746555404662,CSS 202S,A01,892056,Mignozzetti; Umberto,26,0,30,4
1746555405689,DSC 197,001,956898,Eldridge; Justin Matthew,9997,0,9999,2
1746555406714,DSC 297,001,958000,Mazumdar; Arya,9998,0,9999,1
1746555406714,DSC 297,002,959862,Wang; Yusu,9998,0,9999,1
1746555407739,EAP 100,A00,905686,Staff,9778,0,9999,221
1746555408767,ECE 45,A01,892618,Staff,0,0,65,65
1746555410820,ECE 111,A01,892719,Staff,4,0,65,61
1746555411846,ECE 197,001,957920,Mercier; Patrick Philip,9991,0,9999,8
1746555412874,ECON 178,A01,907814,Zhu; Ying,26,0,35,9
1746555413900,EDS 115,A00,895312,Staff,35,0,45,10
1746555414928,EDS 117,A01,895337,Staff,23,0,30,7
1746555415954,EDS 125,A00,895341,Jones; Gabrielle Anastasia,36,0,45,9
1746555416980,EDS 128A,A01,895459,Fargason; Sharon Gayle,44,0,45,1
1746555418004,EDS 128B,A01,895543,Pappas; Elizabeth,44,0,45,1
1746555419033,EDS 139,A00,897203,Pappas; Elizabeth,44,0,45,1
1746555419033,EDS 139,B00,897209,Fargason; Sharon Gayle,41,0,45,4
1746555420060,EDS 201,A00,895545,Staff,22,0,45,23
1746555421085,EDS 203,A01,895581,Halter; Christopher P.,22,0,45,23
1746555422112,EDS 204R,A01,895625,Heinzman; Erica M.,39,0,45,6
1746555422112,EDS 204R,B01,895693,Halter; Christopher P.,10,0,45,35
1746555423139,EDS 206R,A00,895694,Fargason; Sharon Gayle,1,0,30,29
1746555423139,EDS 206R,B00,895695,Choi; Bailey Miyeon,16,0,30,14
1746555424164,EDS 250,A00,895697,Hemans; Patricia Ann Benitez,22,0,45,23
1746555425191,EDS 281,A00,895701,Meyerott; Theresa Ann,1,0,15,14
1746555426216,EDS 284,A00,895736,Meyerott; Theresa Ann,1,0,15,14
1746555427241,EDS 286,A00,897210,Fine; Sarah,0,0,15,15
1746555428269,EDS 289C,A01,895770,Daly; Alan J.,15,0,15,0
1746555429297,EDS 290,A00,897211,Hofstetter; Carolyn,0,0,15,15
1746555430322,LIGM 5A,A00,896162,Fischer-Grunski; Eva K,13,0,20,7
1746555431350,LIGM 5B,A00,896260,Fischer-Grunski; Eva K,17,0,20,3
1746555432377,LIGM 5C,A00,896308,Fischer-Grunski; Eva K,18,0,20,2
1746555433404,LIIT 5AS,A00,896313,Carnelos; Chiara,18,0,20,2
1746555434433,LIIT 5BS,A00,896416,Carnelos; Chiara,20,0,20,0
1746555435459,LIIT 5CS,A00,896564,Carnelos; Chiara,20,0,20,0
1746555436489,LISP 5A,A00,896588,Munoz Sanchez; Alicia,3,0,20,17
1746555437515,LISP 5B,A00,896653,Munoz Sanchez; Alicia,7,0,20,13
1746555438540,LISP 5C,A00,896655,Munoz Sanchez; Alicia,0,1,20,20
1746555439564,MAE 197,001,957918,Kleissl; Jan,9996,0,9999,3
1746555439564,MAE 197,002,959806,Boechler; Nicholas Sebastia,9998,0,9999,1
1746555439564,MAE 197,003,959852,Mullin; Jennifer S,9998,0,9999,1
1746555440589,MATH 2,A01,957937,Staff,33,0,35,2
1746555441618,MATH 197,001,957876,Kedlaya; Kiran S.,9993,0,9999,6
1746555442646,MCWP 40,A00,892729,Duru; Nur,10,0,20,10
1746555442646,MCWP 40,B00,893304,Montejo; Carolina,14,0,20,6
1746555443676,MCWP 40R,A00,893757,Redela; Pamela Morgan,0,5,20,20
1746555444701,MCWP 50,A00,893758,Morshed; Michael James,0,0,20,20
1746555444701,MCWP 50,B00,893761,Bartulis; Jason Michael,17,0,20,3
1746555445726,MCWP 50R,A00,893766,Compas; Sean Matthew,0,1,20,20
1746555445726,MCWP 50R,B00,893769,Carter; Jennifer A,0,1,20,20
1746555445726,MCWP 50R,C00,893771,Krone; Jarret,0,3,20,20
1746555445726,MCWP 50R,D00,893772,Miller; Elizabeth Deen,0,0,20,20
1746555445726,MCWP 50R,E00,893775,Carter; Andrea L,0,1,20,20
1746555446754,MMW 11R,A01,892721,Herbst; Matthew,11,0,27,16
1746555446754,MMW 11R,A02,892722,Herbst; Matthew,0,0,0,3
1746555447779,MMW 12R,A01,892724,Herbst; Matthew,0,11,16,16
1746555447779,MMW 12R,A02,892725,Herbst; Matthew,0,10,16,16
1746555448804,MMW 13R,A01,892727,Staff,0,4,16,16
1746555448804,MMW 13R,A02,892728,Staff,0,4,16,16
1746555448804,MMW 13R,A03,958032,Staff,0,4,16,16
1746555448804,MMW 13R,A04,958033,Staff,0,4,16,16
1746555448804,MMW 13R,A05,958034,Staff,0,4,16,16
1746555449831,SIO 295LS,A00,894015,Staff,5,0,25,20
1746555450857,SIO 295S,A00,894020,Staff,5,0,25,20
1746555451884,SIOC 290S,B01,958918,Merrifield; Mark A,14,0,30,16
1746555452911,SIOC 291S,B01,958922,Gabriel; Corey John,14,0,30,16
1746555453937,SOCI 117,A01,895339,Staff,3,0,5,2
1746555454962,WES 237B,A00,894149,Staff,11,0,20,9
1746555457021,AESE 279B,A00,891859,Staff,13,0,35,22
1746555458047,AIP 197,001,891854,Vespa; Emanuel Ignacio,9999,0,9999,0
1746555459071,ANTH 289S,A00,891856,Gagneux; Pascal,12,0,12,0
1746555460100,BENG 196,001,957946,Engler; Adam J.,9996,0,9999,3
1746555461131,BISP 197,001,959851,Wilhelm; James E.,9998,0,9999,1
1746555462156,CAT 124RS,A01,956906,Staff,6,0,25,19
1746555463180,CAT 125RS,A01,922013,Staff,6,0,25,19
1746555464204,CLRE 250,A00,891860,Morris; Sheldon,9995,0,9999,4
1746555466256,CLRE 251R,A00,907817,Mehta; Ravindra L.,9994,0,9999,5
1746555467280,CLRE 252,A00,891864,Cuomo; Raphael Eduardo,9993,0,9999,6
1746555468307,CLRE 253,A00,891867,Vaida; Florin,9994,0,9999,5
1746555468307,CLRE 253,B00,907819,Staff,9999,0,9999,0
1746555469333,CLRE 259,A00,891868,Patel; Hemal,9998,0,9999,1
1746555470358,CLRE 260,A00,891872,Cuomo; Raphael Eduardo,9999,0,9999,0
1746555471382,CLRE 297,001,891888,Cuomo; Raphael Eduardo,9999,0,9999,0
1746555472409,CSE 191,A00,958773,Minnes Kemp; Mor Mia,9995,0,9999,4
1746555473436,CSE 197,001,959846,Minnes Kemp; Mor Mia,9990,0,9999,9
1746555474462,CSS 201S,A01,892054,Mignozzetti; Umberto,26,0,30,4
1746555475487,CSS 202S,A01,892056,Mignozzetti; Umberto,26,0,30,4
1746555476510,DSC 197,001,956898,Eldridge; Justin Matthew,9997,0,9999,2
1746555477537,DSC 297,001,958000,Mazumdar; Arya,9998,0,9999,1
1746555477537,DSC 297,002,959862,Wang; Yusu,9998,0,9999,1
1746555478565,EAP 100,A00,905686,Staff,9778,0,9999,221
1746555479593,ECE 45,A01,892618,Staff,0,0,65,65
1746555481647,ECE 111,A01,892719,Staff,4,0,65,61
1746555482673,ECE 197,001,957920,Mercier; Patrick Philip,9991,0,9999,8
1746555483698,ECON 178,A01,907814,Zhu; Ying,26,0,35,9
1746555484727,EDS 115,A00,895312,Staff,35,0,45,10
1746555485751,EDS 117,A01,895337,Staff,23,0,30,7
1746555486775,EDS 125,A00,895341,Jones; Gabrielle Anastasia,36,0,45,9
1746555487800,EDS 128A,A01,895459,Fargason; Sharon Gayle,44,0,45,1
1746555488824,EDS 128B,A01,895543,Pappas; Elizabeth,44,0,45,1
1746555489853,EDS 139,A00,897203,Pappas; Elizabeth,44,0,45,1
1746555489853,EDS 139,B00,897209,Fargason; Sharon Gayle,41,0,45,4
1746555490877,EDS 201,A00,895545,Staff,22,0,45,23
1746555491903,EDS 203,A01,895581,Halter; Christopher P.,22,0,45,23
1746555492931,EDS 204R,A01,895625,Heinzman; Erica M.,39,0,45,6
1746555492931,EDS 204R,B01,895693,Halter; Christopher P.,10,0,45,35
1746555493960,EDS 206R,A00,895694,Fargason; Sharon Gayle,1,0,30,29
1746555493960,EDS 206R,B00,895695,Choi; Bailey Miyeon,16,0,30,14
1746555494990,EDS 250,A00,895697,Hemans; Patricia Ann Benitez,22,0,45,23
1746555496019,EDS 281,A00,895701,Meyerott; Theresa Ann,1,0,15,14
1746555497045,EDS 284,A00,895736,Meyerott; Theresa Ann,1,0,15,14
1746555498072,EDS 286,A00,897210,Fine; Sarah,0,0,15,15
1746555499098,EDS 289C,A01,895770,Daly; Alan J.,15,0,15,0
1746555500127,EDS 290,A00,897211,Hofstetter; Carolyn,0,0,15,15
1746555501156,LIGM 5A,A00,896162,Fischer-Grunski; Eva K,13,0,20,7
1746555502182,LIGM 5B,A00,896260,Fischer-Grunski; Eva K,17,0,20,3
1746555503207,LIGM 5C,A00,896308,Fischer-Grunski; Eva K,18,0,20,2
1746555504236,LIIT 5AS,A00,896313,Carnelos; Chiara,18,0,20,2
1746555505263,LIIT 5BS,A00,896416,Carnelos; Chiara,20,0,20,0
1746555506291,LIIT 5CS,A00,896564,Carnelos; Chiara,20,0,20,0
1746555507316,LISP 5A,A00,896588,Munoz Sanchez; Alicia,3,0,20,17
1746555508341,LISP 5B,A00,896653,Munoz Sanchez; Alicia,7,0,20,13
1746555509366,LISP 5C,A00,896655,Munoz Sanchez; Alicia,0,1,20,20
1746555510392,MAE 197,001,957918,Kleissl; Jan,9996,0,9999,3
1746555510392,MAE 197,002,959806,Boechler; Nicholas Sebastia,9998,0,9999,1
1746555510392,MAE 197,003,959852,Mullin; Jennifer S,9998,0,9999,1
1746555511417,MATH 2,A01,957937,Staff,33,0,35,2
1746555512443,MATH 197,001,957876,Kedlaya; Kiran S.,9993,0,9999,6
1746555513467,MCWP 40,A00,892729,Duru; Nur,10,0,20,10
1746555513467,MCWP 40,B00,893304,Montejo; Carolina,14,0,20,6
1746555514494,MCWP 40R,A00,893757,Redela; Pamela Morgan,0,5,20,20
1746555515521,MCWP 50,A00,893758,Morshed; Michael James,0,0,20,20
1746555515521,MCWP 50,B00,893761,Bartulis; Jason Michael,17,0,20,3
1746555516562,MCWP 50R,A00,893766,Compas; Sean Matthew,0,1,20,20
1746555516562,MCWP 50R,B00,893769,Carter; Jennifer A,0,1,20,20
1746555516562,MCWP 50R,C00,893771,Krone; Jarret,0,3,20,20
1746555516562,MCWP 50R,D00,893772,Miller; Elizabeth Deen,0,0,20,20
1746555516562,MCWP 50R,E00,893775,Carter; Andrea L,0,1,20,20
1746555517591,MMW 11R,A01,892721,Herbst; Matthew,11,0,27,16
1746555517591,MMW 11R,A02,892722,Herbst; Matthew,0,0,0,3
1746555518617,MMW 12R,A01,892724,Herbst; Matthew,0,11,16,16
1746555518617,MMW 12R,A02,892725,Herbst; Matthew,0,10,16,16
1746555519642,MMW 13R,A01,892727,Staff,0,4,16,16
1746555519642,MMW 13R,A02,892728,Staff,0,4,16,16
1746555519642,MMW 13R,A03,958032,Staff,0,4,16,16
1746555519642,MMW 13R,A04,958033,Staff,0,4,16,16
1746555519642,MMW 13R,A05,958034,Staff,0,4,16,16
1746555520667,SIO 295LS,A00,894015,Staff,5,0,25,20
1746555521694,SIO 295S,A00,894020,Staff,5,0,25,20
1746555522723,SIOC 290S,B01,958918,Merrifield; Mark A,14,0,30,16
1746555523750,SIOC 291S,B01,958922,Gabriel; Corey John,14,0,30,16
1746555524777,SOCI 117,A01,895339,Staff,3,0,5,2
1746555525803,WES 237B,A00,894149,Staff,11,0,20,9
1746555527858,AESE 279B,A00,891859,Staff,13,0,35,22
1746555528885,AIP 197,001,891854,Vespa; Emanuel Ignacio,9999,0,9999,0
1746555529912,ANTH 289S,A00,891856,Gagneux; Pascal,12,0,12,0
1746555530939,BENG 196,001,957946,Engler; Adam J.,9996,0,9999,3
1746555531965,BISP 197,001,959851,Wilhelm; James E.,9998,0,9999,1
1746555532990,CAT 124RS,A01,956906,Staff,6,0,25,19
1746555534015,CAT 125RS,A01,922013,Staff,6,0,25,19
1746555535040,CLRE 250,A00,891860,Morris; Sheldon,9995,0,9999,4
1746555537093,CLRE 251R,A00,907817,Mehta; Ravindra L.,9994,0,9999,5
1746555538118,CLRE 252,A00,891864,Cuomo; Raphael Eduardo,9993,0,9999,6
1746555539146,CLRE 253,A00,891867,Vaida; Florin,9994,0,9999,5
1746555539146,CLRE 253,B00,907819,Staff,9999,0,9999,0
1746555540172,CLRE 259,A00,891868,Patel; Hemal,9998,0,9999,1
1746555541195,CLRE 260,A00,891872,Cuomo; Raphael Eduardo,9999,0,9999,0
1746555542221,CLRE 297,001,891888,Cuomo; Raphael Eduardo,9999,0,9999,0
1746555543250,CSE 191,A00,958773,Minnes Kemp; Mor Mia,9995,0,9999,4
1746555544276,CSE 197,001,959846,Minnes Kemp; Mor Mia,9990,0,9999,9
1746555545846,CSS 201S,A01,892054,Mignozzetti; Umberto,26,0,30,4
1746555546877,CSS 202S,A01,892056,Mignozzetti; Umberto,26,0,30,4
1746555547900,DSC 197,001,956898,Eldridge; Justin Matthew,9997,0,9999,2
1746555548927,DSC 297,001,958000,Mazumdar; Arya,9998,0,9999,1
1746555548927,DSC 297,002,959862,Wang; Yusu,9998,0,9999,1
1746555549951,EAP 100,A00,905686,Staff,9778,0,9999,221
1746555550975,ECE 45,A01,892618,Staff,0,0,65,65
1746555553025,ECE 111,A01,892719,Staff,4,0,65,61
1746555554050,ECE 197,001,957920,Mercier; Patrick Philip,9991,0,9999,8
1746555555074,ECON 178,A01,907814,Zhu; Ying,26,0,35,9
1746555556099,EDS 115,A00,895312,Staff,35,0,45,10
1746555557127,EDS 117,A01,895337,Staff,23,0,30,7
1746555558151,EDS 125,A00,895341,Jones; Gabrielle Anastasia,36,0,45,9
1746555559175,EDS 128A,A01,895459,Fargason; Sharon Gayle,44,0,45,1
1746555560199,EDS 128B,A01,895543,Pappas; Elizabeth,44,0,45,1
1746555561226,EDS 139,A00,897203,Pappas; Elizabeth,44,0,45,1
1746555561226,EDS 139,B00,897209,Fargason; Sharon Gayle,41,0,45,4
1746555562253,EDS 201,A00,895545,Staff,22,0,45,23
1746555563280,EDS 203,A01,895581,Halter; Christopher P.,22,0,45,23
1746555564304,EDS 204R,A01,895625,Heinzman; Erica M.,39,0,45,6
1746555564304,EDS 204R,B01,895693,Halter; Christopher P.,10,0,45,35
1746555565335,EDS 206R,A00,895694,Fargason; Sharon Gayle,1,0,30,29
1746555565335,EDS 206R,B00,895695,Choi; Bailey Miyeon,16,0,30,14
1746555566360,EDS 250,A00,895697,Hemans; Patricia Ann Benitez,22,0,45,23
1746555567387,EDS 281,A00,895701,Meyerott; Theresa Ann,1,0,15,14
1746555568411,EDS 284,A00,895736,Meyerott; Theresa Ann,1,0,15,14
1746555569437,EDS 286,A00,897210,Fine; Sarah,0,0,15,15
1746555570463,EDS 289C,A01,895770,Daly; Alan J.,15,0,15,0
1746555571492,EDS 290,A00,897211,Hofstetter; Carolyn,0,0,15,15
1746555572522,LIGM 5A,A00,896162,Fischer-Grunski; Eva K,13,0,20,7
1746555573548,LIGM 5B,A00,896260,Fischer-Grunski; Eva K,17,0,20,3
1746555574574,LIGM 5C,A00,896308,Fischer-Grunski; Eva K,18,0,20,2
1746555575609,LIIT 5AS,A00,896313,Carnelos; Chiara,18,0,20,2
1746555576637,LIIT 5BS,A00,896416,Carnelos; Chiara,20,0,20,0
1746555577665,LIIT 5CS,A00,896564,Carnelos; Chiara,20,0,20,0
1746555578689,LISP 5A,A00,896588,Munoz Sanchez; Alicia,3,0,20,17
1746555579713,LISP 5B,A00,896653,Munoz Sanchez; Alicia,7,0,20,13
1746555580741,LISP 5C,A00,896655,Munoz Sanchez; Alicia,0,1,20,20
1746555581769,MAE 197,001,957918,Kleissl; Jan,9996,0,9999,3
1746555581769,MAE 197,002,959806,Boechler; Nicholas Sebastia,9998,0,9999,1
1746555581769,MAE 197,003,959852,Mullin; Jennifer S,9998,0,9999,1
1746555582794,MATH 2,A01,957937,Staff,33,0,35,2
1746555583820,MATH 197,001,957876,Kedlaya; Kiran S.,9993,0,9999,6
1746555584848,MCWP 40,A00,892729,Duru; Nur,10,0,20,10
1746555584848,MCWP 40,B00,893304,Montejo; Carolina,14,0,20,6
1746555585872,MCWP 40R,A00,893757,Redela; Pamela Morgan,0,5,20,20
1746555586897,MCWP 50,A00,893758,Morshed; Michael James,0,0,20,20
1746555586897,MCWP 50,B00,893761,Bartulis; Jason Michael,17,0,20,3
1746555587923,MCWP 50R,A00,893766,Compas; Sean Matthew,0,1,20,20
1746555587923,MCWP 50R,B00,893769,Carter; Jennifer A,0,1,20,20
1746555587923,MCWP 50R,C00,893771,Krone; Jarret,0,3,20,20
1746555587923,MCWP 50R,D00,893772,Miller; Elizabeth Deen,0,0,20,20
1746555587923,MCWP 50R,E00,893775,Carter; Andrea L,0,1,20,20
1746555588951,MMW 11R,A01,892721,Herbst; Matthew,11,0,27,16
1746555588951,MMW 11R,A02,892722,Herbst; Matthew,0,0,0,3
1746555589977,MMW 12R,A01,892724,Herbst; Matthew,0,11,16,16
1746555589977,MMW 12R,A02,892725,Herbst; Matthew,0,10,16,16
1746555591005,MMW 13R,A01,892727,Staff,0,4,16,16
1746555591005,MMW 13R,A02,892728,Staff,0,4,16,16
1746555591005,MMW 13R,A03,958032,Staff,0,4,16,16
1746555591005,MMW 13R,A04,958033,Staff,0,4,16,16
1746555591005,MMW 13R,A05,958034,Staff,0,4,16,16
1746555592033,SIO 295LS,A00,894015,Staff,5,0,25,20
1746555593057,SIO 295S,A00,894020,Staff,5,0,25,20
1746555594087,SIOC 290S,B01,958918,Merrifield; Mark A,14,0,30,16
1746555595117,SIOC 291S,B01,958922,Gabriel; Corey John,14,0,30,16
1746555596140,SOCI 117,A01,895339,Staff,3,0,5,2
1746555597166,WES 237B,A00,894149,Staff,11,0,20,9
1746555599228,AESE 279B,A00,891859,Staff,13,0,35,22
1746555600253,AIP 197,001,891854,Vespa; Emanuel Ignacio,9999,0,9999,0
1746555601279,ANTH 289S,A00,891856,Gagneux; Pascal,12,0,12,0
1746555602305,BENG 196,001,957946,Engler; Adam J.,9996,0,9999,3
1746555603333,BISP 197,001,959851,Wilhelm; James E.,9998,0,9999,1
1746555604382,CAT 124RS,A01,956906,Staff,6,0,25,19
1746555605411,CAT 125RS,A01,922013,Staff,6,0,25,19
1746555606436,CLRE 250,A00,891860,Morris; Sheldon,9995,0,9999,4
1746555608490,CLRE 251R,A00,907817,Mehta; Ravindra L.,9994,0,9999,5
1746555609517,CLRE 252,A00,891864,Cuomo; Raphael Eduardo,9993,0,9999,6
1746555610542,CLRE 253,A00,891867,Vaida; Florin,9994,0,9999,5
1746555610542,CLRE 253,B00,907819,Staff,9999,0,9999,0
1746555611573,CLRE 259,A00,891868,Patel; Hemal,9998,0,9999,1
1746555612599,CLRE 260,A00,891872,Cuomo; Raphael Eduardo,9999,0,9999,0
1746555613623,CLRE 297,001,891888,Cuomo; Raphael Eduardo,9999,0,9999,0
1746555614652,CSE 191,A00,958773,Minnes Kemp; Mor Mia,9995,0,9999,4
1746555615677,CSE 197,001,959846,Minnes Kemp; Mor Mia,9990,0,9999,9
1746555616702,CSS 201S,A01,892054,Mignozzetti; Umberto,26,0,30,4
1746555617732,CSS 202S,A01,892056,Mignozzetti; Umberto,26,0,30,4
1746555618758,DSC 197,001,956898,Eldridge; Justin Matthew,9997,0,9999,2
1746555619785,DSC 297,001,958000,Mazumdar; Arya,9998,0,9999,1
1746555619785,DSC 297,002,959862,Wang; Yusu,9998,0,9999,1
1746555620812,EAP 100,A00,905686,Staff,9778,0,9999,221
1746555621838,ECE 45,A01,892618,Staff,0,0,65,65
1746555623890,ECE 111,A01,892719,Staff,4,0,65,61
1746555624918,ECE 197,001,957920,Mercier; Patrick Philip,9991,0,9999,8
1746555625947,ECON 178,A01,907814,Zhu; Ying,26,0,35,9
1746555626974,EDS 115,A00,895312,Staff,35,0,45,10
1746555628001,EDS 117,A01,895337,Staff,23,0,30,7
1746555629026,EDS 125,A00,895341,Jones; Gabrielle Anastasia,36,0,45,9
1746555630055,EDS 128A,A01,895459,Fargason; Sharon Gayle,44,0,45,1
1746555631084,EDS 128B,A01,895543,Pappas; Elizabeth,44,0,45,1
1746555632112,EDS 139,A00,897203,Pappas; Elizabeth,44,0,45,1
1746555632112,EDS 139,B00,897209,Fargason; Sharon Gayle,41,0,45,4
1746555633139,EDS 201,A00,895545,Staff,22,0,45,23
1746555634164,EDS 203,A01,895581,Halter; Christopher P.,22,0,45,23
1746555635190,EDS 204R,A01,895625,Heinzman; Erica M.,39,0,45,6
1746555635190,EDS 204R,B01,895693,Halter; Christopher P.,10,0,45,35
1746555636215,EDS 206R,A00,895694,Fargason; Sharon Gayle,1,0,30,29
1746555636215,EDS 206R,B00,895695,Choi; Bailey Miyeon,16,0,30,14
1746555637240,EDS 250,A00,895697,Hemans; Patricia Ann Benitez,22,0,45,23
1746555638264,EDS 281,A00,895701,Meyerott; Theresa Ann,1,0,15,14
1746555639289,EDS 284,A00,895736,Meyerott; Theresa Ann,1,0,15,14
1746555640314,EDS 286,A00,897210,Fine; Sarah,0,0,15,15
1746555641340,EDS 289C,A01,895770,Daly; Alan J.,15,0,15,0
1746555642366,EDS 290,A00,897211,Hofstetter; Carolyn,0,0,15,15
1746555643391,LIGM 5A,A00,896162,Fischer-Grunski; Eva K,13,0,20,7
1746555644420,LIGM 5B,A00,896260,Fischer-Grunski; Eva K,17,0,20,3
1746555645445,LIGM 5C,A00,896308,Fischer-Grunski; Eva K,18,0,20,2
1746555646473,LIIT 5AS,A00,896313,Carnelos; Chiara,18,0,20,2
1746555647501,LIIT 5BS,A00,896416,Carnelos; Chiara,20,0,20,0
1746555648525,LIIT 5CS,A00,896564,Carnelos; Chiara,20,0,20,0
1746555649553,LISP 5A,A00,896588,Munoz Sanchez; Alicia,3,0,20,17
1746555650579,LISP 5B,A00,896653,Munoz Sanchez; Alicia,7,0,20,13
1746555651609,LISP 5C,A00,896655,Munoz Sanchez; Alicia,0,1,20,20
1746555652634,MAE 197,001,957918,Kleissl; Jan,9996,0,9999,3
1746555652634,MAE 197,002,959806,Boechler; Nicholas Sebastia,9998,0,9999,1
1746555652634,MAE 197,003,959852,Mullin; Jennifer S,9998,0,9999,1
1746555653659,MATH 2,A01,957937,Staff,33,0,35,2
1746555654686,MATH 197,001,957876,Kedlaya; Kiran S.,9993,0,9999,6
1746555655716,MCWP 40,A00,892729,Duru; Nur,10,0,20,10
1746555655716,MCWP 40,B00,893304,Montejo; Carolina,14,0,20,6
1746555656745,MCWP 40R,A00,893757,Redela; Pamela Morgan,0,5,20,20
1746555657773,MCWP 50,A00,893758,Morshed; Michael James,0,0,20,20
1746555657773,MCWP 50,B00,893761,Bartulis; Jason Michael,17,0,20,3
1746555658798,MCWP 50R,A00,893766,Compas; Sean Matthew,0,1,20,20
1746555658798,MCWP 50R,B00,893769,Carter; Jennifer A,0,1,20,20
1746555658798,MCWP 50R,C00,893771,Krone; Jarret,0,3,20,20
1746555658798,MCWP 50R,D00,893772,Miller; Elizabeth Deen,0,0,20,20
1746555658798,MCWP 50R,E00,893775,Carter; Andrea L,0,1,20,20
1746555659823,MMW 11R,A01,892721,Herbst; Matthew,11,0,27,16
1746555659823,MMW 11R,A02,892722,Herbst; Matthew,0,0,0,3
1746555660849,MMW 12R,A01,892724,Herbst; Matthew,0,11,16,16
1746555660849,MMW 12R,A02,892725,Herbst; Matthew,0,10,16,16
1746555661877,MMW 13R,A01,892727,Staff,0,4,16,16
1746555661877,MMW 13R,A02,892728,Staff,0,4,16,16
1746555661877,MMW 13R,A03,958032,Staff,0,4,16,16
1746555661877,MMW 13R,A04,958033,Staff,0,4,16,16
1746555661877,MMW 13R,A05,958034,Staff,0,4,16,16
1746555662901,SIO 295LS,A00,894015,Staff,5,0,25,20
1746555663927,SIO 295S,A00,894020,Staff,5,0,25,20
1746555664953,SIOC 290S,B01,958918,Merrifield; Mark A,14,0,30,16
1746555665983,SIOC 291S,B01,958922,Gabriel; Corey John,14,0,30,16
1746555667010,SOCI 117,A01,895339,Staff,3,0,5,2
1746555668036,WES 237B,A00,894149,Staff,11,0,20,9
1746555670103,AESE 279B,A00,891859,Staff,13,0,35,22
1746555671135,AIP 197,001,891854,Vespa; Emanuel Ignacio,9999,0,9999,0
1746555672159,ANTH 289S,A00,891856,Gagneux; Pascal,12,0,12,0
1746555673186,BENG 196,001,957946,Engler; Adam J.,9996,0,9999,3
1746555674212,BISP 197,001,959851,Wilhelm; James E.,9998,0,9999,1
1746555675241,CAT 124RS,A01,956906,Staff,6,0,25,19
1746555676267,CAT 125RS,A01,922013,Staff,6,0,25,19
1746555677295,CLRE 250,A00,891860,Morris; Sheldon,9995,0,9999,4
1746555679346,CLRE 251R,A00,907817,Mehta; Ravindra L.,9994,0,9999,5
1746555680372,CLRE 252,A00,891864,Cuomo; Raphael Eduardo,9993,0,9999,6
1746555681398,CLRE 253,A00,891867,Vaida; Florin,9994,0,9999,5
1746555681398,CLRE 253,B00,907819,Staff,9999,0,9999,0
1746555682423,CLRE 259,A00,891868,Patel; Hemal,9998,0,9999,1
1746555683451,CLRE 260,A00,891872,Cuomo; Raphael Eduardo,9999,0,9999,0
1746555684480,CLRE 297,001,891888,Cuomo; Raphael Eduardo,9999,0,9999,0
1746555685505,CSE 191,A00,958773,Minnes Kemp; Mor Mia,9995,0,9999,4
1746555686530,CSE 197,001,959846,Minnes Kemp; Mor Mia,9990,0,9999,9
1746555687560,CSS 201S,A01,892054,Mignozzetti; Umberto,26,0,30,4
1746555688586,CSS 202S,A01,892056,Mignozzetti; Umberto,26,0,30,4
1746555689614,DSC 197,001,956898,Eldridge; Justin Matthew,9997,0,9999,2
1746555690638,DSC 297,001,958000,Mazumdar; Arya,9998,0,9999,1
1746555690638,DSC 297,002,959862,Wang; Yusu,9998,0,9999,1
1746555691663,EAP 100,A00,905686,Staff,9778,0,9999,221
1746555692693,ECE 45,A01,892618,Staff,0,0,65,65
1746555694746,ECE 111,A01,892719,Staff,4,0,65,61
1746555695775,ECE 197,001,957920,Mercier; Patrick Philip,9991,0,9999,8
1746555696802,ECON 178,A01,907814,Zhu; Ying,26,0,35,9
1746555697831,EDS 115,A00,895312,Staff,35,0,45,10
1746555698855,EDS 117,A01,895337,Staff,23,0,30,7
1746555699882,EDS 125,A00,895341,Jones; Gabrielle Anastasia,36,0,45,9
1746555700910,EDS 128A,A01,895459,Fargason; Sharon Gayle,44,0,45,1
1746555701935,EDS 128B,A01,895543,Pappas; Elizabeth,44,0,45,1
1746555702960,EDS 139,A00,897203,Pappas; Elizabeth,44,0,45,1
1746555702960,EDS 139,B00,897209,Fargason; Sharon Gayle,41,0,45,4
1746555703990,EDS 201,A00,895545,Staff,22,0,45,23
1746555705013,EDS 203,A01,895581,Halter; Christopher P.,22,0,45,23
1746555706039,EDS 204R,A01,895625,Heinzman; Erica M.,39,0,45,6
1746555706039,EDS 204R,B01,895693,Halter; Christopher P.,10,0,45,35
1746555707064,EDS 206R,A00,895694,Fargason; Sharon Gayle,1,0,30,29
1746555707064,EDS 206R,B00,895695,Choi; Bailey Miyeon,16,0,30,14
1746555708091,EDS 250,A00,895697,Hemans; Patricia Ann Benitez,22,0,45,23
1746555709116,EDS 281,A00,895701,Meyerott; Theresa Ann,1,0,15,14
1746555710143,EDS 284,A00,895736,Meyerott; Theresa Ann,1,0,15,14
1746555711170,EDS 286,A00,897210,Fine; Sarah,0,0,15,15
1746555712193,EDS 289C,A01,895770,Daly; Alan J.,15,0,15,0
1746555713222,EDS 290,A00,897211,Hofstetter; Carolyn,0,0,15,15
1746555714248,LIGM 5A,A00,896162,Fischer-Grunski; Eva K,13,0,20,7
1746555715275,LIGM 5B,A00,896260,Fischer-Grunski; Eva K,17,0,20,3
1746555716301,LIGM 5C,A00,896308,Fischer-Grunski; Eva K,18,0,20,2
1746555717329,LIIT 5AS,A00,896313,Carnelos; Chiara,18,0,20,2
1746555718355,LIIT 5BS,A00,896416,Carnelos; Chiara,20,0,20,0
1746555719381,LIIT 5CS,A00,896564,Carnelos; Chiara,20,0,20,0
1746555720406,LISP 5A,A00,896588,Munoz Sanchez; Alicia,3,0,20,17
1746555721434,LISP 5B,A00,896653,Munoz Sanchez; Alicia,7,0,20,13
1746555722463,LISP 5C,A00,896655,Munoz Sanchez; Alicia,0,1,20,20
1746555723491,MAE 197,001,957918,Kleissl; Jan,9996,0,9999,3
1746555723491,MAE 197,002,959806,Boechler; Nicholas Sebastia,9998,0,9999,1
1746555723491,MAE 197,003,959852,Mullin; Jennifer S,9998,0,9999,1
1746555724517,MATH 2,A01,957937,Staff,33,0,35,2
1746555725542,MATH 197,001,957876,Kedlaya; Kiran S.,9993,0,9999,6
1746555726569,MCWP 40,A00,892729,Duru; Nur,10,0,20,10
1746555726569,MCWP 40,B00,893304,Montejo; Carolina,14,0,20,6
1746555727600,MCWP 40R,A00,893757,Redela; Pamela Morgan,0,5,20,20
1746555728627,MCWP 50,A00,893758,Morshed; Michael James,0,0,20,20
1746555728627,MCWP 50,B00,893761,Bartulis; Jason Michael,17,0,20,3
1746555729657,MCWP 50R,A00,893766,Compas; Sean Matthew,0,1,20,20
1746555729657,MCWP 50R,B00,893769,Carter; Jennifer A,0,1,20,20
1746555729657,MCWP 50R,C00,893771,Krone; Jarret,0,3,20,20
1746555729657,MCWP 50R,D00,893772,Miller; Elizabeth Deen,0,0,20,20
1746555729657,MCWP 50R,E00,893775,Carter; Andrea L,0,1,20,20
1746555730685,MMW 11R,A01,892721,Herbst; Matthew,11,0,27,16
1746555730685,MMW 11R,A02,892722,Herbst; Matthew,0,0,0,3
1746555731712,MMW 12R,A01,892724,Herbst; Matthew,0,11,16,16
1746555731712,MMW 12R,A02,892725,Herbst; Matthew,0,10,16,16
1746555732737,MMW 13R,A01,892727,Staff,0,4,16,16
1746555732737,MMW 13R,A02,892728,Staff,0,4,16,16
1746555732737,MMW 13R,A03,958032,Staff,0,4,16,16
1746555732737,MMW 13R,A04,958033,Staff,0,4,16,16
1746555732737,MMW 13R,A05,958034,Staff,0,4,16,16
1746555733765,SIO 295LS,A00,894015,Staff,5,0,25,20
1746555734791,SIO 295S,A00,894020,Staff,5,0,25,20
1746555735817,SIOC 290S,B01,958918,Merrifield; Mark A,14,0,30,16
1746555736843,SIOC 291S,B01,958922,Gabriel; Corey John,14,0,30,16
1746555737874,SOCI 117,A01,895339,Staff,3,0,5,2
1746555738899,WES 237B,A00,894149,Staff,11,0,20,9
1746555740967,AESE 279B,A00,891859,Staff,13,0,35,22
1746555741994,AIP 197,001,891854,Vespa; Emanuel Ignacio,9999,0,9999,0
1746555743022,ANTH 289S,A00,891856,Gagneux; Pascal,12,0,12,0
1746555744047,BENG 196,001,957946,Engler; Adam J.,9996,0,9999,3
1746555745073,BISP 197,001,959851,Wilhelm; James E.,9998,0,9999,1
1746555746099,CAT 124RS,A01,956906,Staff,6,0,25,19
1746555747123,CAT 125RS,A01,922013,Staff,6,0,25,19
1746555748149,CLRE 250,A00,891860,Morris; Sheldon,9995,0,9999,4
1746555750205,CLRE 251R,A00,907817,Mehta; Ravindra L.,9994,0,9999,5
1746555751231,CLRE 252,A00,891864,Cuomo; Raphael Eduardo,9993,0,9999,6
1746555752256,CLRE 253,A00,891867,Vaida; Florin,9994,0,9999,5
1746555752256,CLRE 253,B00,907819,Staff,9999,0,9999,0
1746555753281,CLRE 259,A00,891868,Patel; Hemal,9998,0,9999,1
1746555754308,CLRE 260,A00,891872,Cuomo; Raphael Eduardo,9999,0,9999,0
1746555755333,CLRE 297,001,891888,Cuomo; Raphael Eduardo,9999,0,9999,0
1746555756359,CSE 191,A00,958773,Minnes Kemp; Mor Mia,9995,0,9999,4
1746555757386,CSE 197,001,959846,Minnes Kemp; Mor Mia,9990,0,9999,9
1746555758416,CSS 201S,A01,892054,Mignozzetti; Umberto,26,0,30,4
1746555759445,CSS 202S,A01,892056,Mignozzetti; Umberto,26,0,30,4
1746555760469,DSC 197,001,956898,Eldridge; Justin Matthew,9997,0,9999,2
1746555761497,DSC 297,001,958000,Mazumdar; Arya,9998,0,9999,1
1746555761497,DSC 297,002,959862,Wang; Yusu,9998,0,9999,1
1746555762522,EAP 100,A00,905686,Staff,9778,0,9999,221
1746555763550,ECE 45,A01,892618,Staff,0,0,65,65
1746555765599,ECE 111,A01,892719,Staff,4,0,65,61
1746555766624,ECE 197,001,957920,Mercier; Patrick Philip,9991,0,9999,8
1746555767652,ECON 178,A01,907814,Zhu; Ying,26,0,35,9
1746555768677,EDS 115,A00,895312,Staff,35,0,45,10
1746555769704,EDS 117,A01,895337,Staff,23,0,30,7
1746555770729,EDS 125,A00,895341,Jones; Gabrielle Anastasia,36,0,45,9
1746555771754,EDS 128A,A01,895459,Fargason; Sharon Gayle,44,0,45,1
1746555772779,EDS 128B,A01,895543,Pappas; Elizabeth,44,0,45,1
1746555773803,EDS 139,A00,897203,Pappas; Elizabeth,44,0,45,1
1746555773803,EDS 139,B00,897209,Fargason; Sharon Gayle,41,0,45,4
1746555774828,EDS 201,A00,895545,Staff,22,0,45,23
1746555775856,EDS 203,A01,895581,Halter; Christopher P.,22,0,45,23
1746555776880,EDS 204R,A01,895625,Heinzman; Erica M.,39,0,45,6
1746555776880,EDS 204R,B01,895693,Halter; Christopher P.,10,0,45,35
1746555777908,EDS 206R,A00,895694,Fargason; Sharon Gayle,1,0,30,29
1746555777908,EDS 206R,B00,895695,Choi; Bailey Miyeon,16,0,30,14
1746555778936,EDS 250,A00,895697,Hemans; Patricia Ann Benitez,22,0,45,23
1746555779960,EDS 281,A00,895701,Meyerott; Theresa Ann,1,0,15,14
1746555780984,EDS 284,A00,895736,Meyerott; Theresa Ann,1,0,15,14
1746555782010,EDS 286,A00,897210,Fine; Sarah,0,0,15,15
1746555783039,EDS 289C,A01,895770,Daly; Alan J.,15,0,15,0
1746555784065,EDS 290,A00,897211,Hofstetter; Carolyn,0,0,15,15
1746555785093,LIGM 5A,A00,896162,Fischer-Grunski; Eva K,13,0,20,7
1746555786119,LIGM 5B,A00,896260,Fischer-Grunski; Eva K,17,0,20,3
1746555787148,LIGM 5C,A00,896308,Fischer-Grunski; Eva K,18,0,20,2
1746555788173,LIIT 5AS,A00,896313,Carnelos; Chiara,18,0,20,2
1746555789199,LIIT 5BS,A00,896416,Carnelos; Chiara,20,0,20,0
1746555790223,LIIT 5CS,A00,896564,Carnelos; Chiara,20,0,20,0
1746555791256,LISP 5A,A00,896588,Munoz Sanchez; Alicia,3,0,20,17
1746555792285,LISP 5B,A00,896653,Munoz Sanchez; Alicia,7,0,20,13
1746555793308,LISP 5C,A00,896655,Munoz Sanchez; Alicia,0,1,20,20
1746555794334,MAE 197,001,957918,Kleissl; Jan,9996,0,9999,3
1746555794334,MAE 197,002,959806,Boechler; Nicholas Sebastia,9998,0,9999,1
1746555794334,MAE 197,003,959852,Mullin; Jennifer S,9998,0,9999,1
1746555795359,MATH 2,A01,957937,Staff,33,0,35,2
1746555796386,MATH 197,001,957876,Kedlaya; Kiran S.,9993,0,9999,6
1746555797413,MCWP 40,A00,892729,Duru; Nur,10,0,20,10
1746555797413,MCWP 40,B00,893304,Montejo; Carolina,14,0,20,6
1746555798439,MCWP 40R,A00,893757,Redela; Pamela Morgan,0,5,20,20
1746555799465,MCWP 50,A00,893758,Morshed; Michael James,0,0,20,20
1746555799465,MCWP 50,B00,893761,Bartulis; Jason Michael,17,0,20,3
1746555800494,MCWP 50R,A00,893766,Compas; Sean Matthew,0,1,20,20
1746555800494,MCWP 50R,B00,893769,Carter; Jennifer A,0,1,20,20
1746555800494,MCWP 50R,C00,893771,Krone; Jarret,0,3,20,20
1746555800494,MCWP 50R,D00,893772,Miller; Elizabeth Deen,0,0,20,20
1746555800494,MCWP 50R,E00,893775,Carter; Andrea L,0,1,20,20
1746555801520,MMW 11R,A01,892721,Herbst; Matthew,11,0,27,16
1746555801520,MMW 11R,A02,892722,Herbst; Matthew,0,0,0,3
1746555802546,MMW 12R,A01,892724,Herbst; Matthew,0,11,16,16
1746555802546,MMW 12R,A02,892725,Herbst; Matthew,0,10,16,16
1746555803571,MMW 13R,A01,892727,Staff,0,4,16,16
1746555803571,MMW 13R,A02,892728,Staff,0,4,16,16
1746555803571,MMW 13R,A03,958032,Staff,0,4,16,16
1746555803571,MMW 13R,A04,958033,Staff,0,4,16,16
1746555803571,MMW 13R,A05,958034,Staff,0,4,16,16
1746555804599,SIO 295LS,A00,894015,Staff,5,0,25,20
1746555805625,SIO 295S,A00,894020,Staff,5,0,25,20
1746555806654,SIOC 290S,B01,958918,Merrifield; Mark A,14,0,30,16
1746555807680,SIOC 291S,B01,958922,Gabriel; Corey John,14,0,30,16
1746555808704,SOCI 117,A01,895339,Staff,3,0,5,2
1746555809729,WES 237B,A00,894149,Staff,11,0,20,9
1746555811793,AESE 279B,A00,891859,Staff,13,0,35,22
1746555812821,AIP 197,001,891854,Vespa; Emanuel Ignacio,9999,0,9999,0
1746555813847,ANTH 289S,A00,891856,Gagneux; Pascal,12,0,12,0
1746555814874,BENG 196,001,957946,Engler; Adam J.,9996,0,9999,3
1746555815899,BISP 197,001,959851,Wilhelm; James E.,9998,0,9999,1
1746555816922,CAT 124RS,A01,956906,Staff,6,0,25,19
1746555817949,CAT 125RS,A01,922013,Staff,6,0,25,19
1746555818976,CLRE 250,A00,891860,Morris; Sheldon,9995,0,9999,4
1746555821038,CLRE 251R,A00,907817,Mehta; Ravindra L.,9994,0,9999,5
1746555822064,CLRE 252,A00,891864,Cuomo; Raphael Eduardo,9993,0,9999,6
1746555823089,CLRE 253,A00,891867,Vaida; Florin,9994,0,9999,5
1746555823089,CLRE 253,B00,907819,Staff,9999,0,9999,0
1746555824117,CLRE 259,A00,891868,Patel; Hemal,9998,0,9999,1
1746555825142,CLRE 260,A00,891872,Cuomo; Raphael Eduardo,9999,0,9999,0
1746555826169,CLRE 297,001,891888,Cuomo; Raphael Eduardo,9999,0,9999,0
1746555827193,CSE 191,A00,958773,Minnes Kemp; Mor Mia,9995,0,9999,4
1746555828219,CSE 197,001,959846,Minnes Kemp; Mor Mia,9990,0,9999,9
1746555829244,CSS 201S,A01,892054,Mignozzetti; Umberto,26,0,30,4
1746555830273,CSS 202S,A01,892056,Mignozzetti; Umberto,26,0,30,4
1746555831301,DSC 197,001,956898,Eldridge; Justin Matthew,9997,0,9999,2
1746555832326,DSC 297,001,958000,Mazumdar; Arya,9998,0,9999,1
1746555832326,DSC 297,002,959862,Wang; Yusu,9998,0,9999,1
1746555833352,EAP 100,A00,905686,Staff,9778,0,9999,221
1746555834381,ECE 45,A01,892618,Staff,0,0,65,65
1746555836435,ECE 111,A01,892719,Staff,4,0,65,61
1746555837460,ECE 197,001,957920,Mercier; Patrick Philip,9991,0,9999,8
1746555838488,ECON 178,A01,907814,Zhu; Ying,26,0,35,9
1746555839516,EDS 115,A00,895312,Staff,35,0,45,10
1746555840543,EDS 117,A01,895337,Staff,23,0,30,7
1746555841570,EDS 125,A00,895341,Jones; Gabrielle Anastasia,36,0,45,9
1746555842598,EDS 128A,A01,895459,Fargason; Sharon Gayle,44,0,45,1
1746555843621,EDS 128B,A01,895543,Pappas; Elizabeth,44,0,45,1
1746555844647,EDS 139,A00,897203,Pappas; Elizabeth,44,0,45,1
1746555844647,EDS 139,B00,897209,Fargason; Sharon Gayle,41,0,45,4
1746555845674,EDS 201,A00,895545,Staff,22,0,45,23
1746555846701,EDS 203,A01,895581,Halter; Christopher P.,22,0,45,23
1746555847724,EDS 204R,A01,895625,Heinzman; Erica M.,39,0,45,6
1746555847724,EDS 204R,B01,895693,Halter; Christopher P.,10,0,45,35
1746555848749,EDS 206R,A00,895694,Fargason; Sharon Gayle,1,0,30,29
1746555848749,EDS 206R,B00,895695,Choi; Bailey Miyeon,16,0,30,14
1746555849774,EDS 250,A00,895697,Hemans; Patricia Ann Benitez,22,0,45,23
1746555850802,EDS 281,A00,895701,Meyerott; Theresa Ann,1,0,15,14
1746555851825,EDS 284,A00,895736,Meyerott; Theresa Ann,1,0,15,14
1746555852850,EDS 286,A00,897210,Fine; Sarah,0,0,15,15
1746555853877,EDS 289C,A01,895770,Daly; Alan J.,15,0,15,0
1746555854904,EDS 290,A00,897211,Hofstetter; Carolyn,0,0,15,15
1746555855929,LIGM 5A,A00,896162,Fischer-Grunski; Eva K,13,0,20,7
1746555856954,LIGM 5B,A00,896260,Fischer-Grunski; Eva K,17,0,20,3
1746555857978,LIGM 5C,A00,896308,Fischer-Grunski; Eva K,18,0,20,2
1746555859009,LIIT 5AS,A00,896313,Carnelos; Chiara,18,0,20,2
1746555860033,LIIT 5BS,A00,896416,Carnelos; Chiara,20,0,20,0
1746555861063,LIIT 5CS,A00,896564,Carnelos; Chiara,20,0,20,0
1746555862091,LISP 5A,A00,896588,Munoz Sanchez; Alicia,3,0,20,17
1746555863118,LISP 5B,A00,896653,Munoz Sanchez; Alicia,7,0,20,13
1746555864142,LISP 5C,A00,896655,Munoz Sanchez; Alicia,0,1,20,20
1746555865171,MAE 197,001,957918,Kleissl; Jan,9996,0,9999,3
1746555865171,MAE 197,002,959806,Boechler; Nicholas Sebastia,9998,0,9999,1
1746555865171,MAE 197,003,959852,Mullin; Jennifer S,9998,0,9999,1
1746555866200,MATH 2,A01,957937,Staff,33,0,35,2
1746555867226,MATH 197,001,957876,Kedlaya; Kiran S.,9993,0,9999,6
1746555868253,MCWP 40,A00,892729,Duru; Nur,10,0,20,10
1746555868253,MCWP 40,B00,893304,Montejo; Carolina,14,0,20,6
1746555869282,MCWP 40R,A00,893757,Redela; Pamela Morgan,0,5,20,20
1746555870310,MCWP 50,A00,893758,Morshed; Michael James,0,0,20,20
1746555870310,MCWP 50,B00,893761,Bartulis; Jason Michael,17,0,20,3
1746555871343,MCWP 50R,A00,893766,Compas; Sean Matthew,0,1,20,20
1746555871343,MCWP 50R,B00,893769,Carter; Jennifer A,0,1,20,20
1746555871343,MCWP 50R,C00,893771,Krone; Jarret,0,3,20,20
1746555871343,MCWP 50R,D00,893772,Miller; Elizabeth Deen,0,0,20,20
1746555871343,MCWP 50R,E00,893775,Carter; Andrea L,0,1,20,20
1746555872370,MMW 11R,A01,892721,Herbst; Matthew,11,0,27,16
1746555872370,MMW 11R,A02,892722,Herbst; Matthew,0,0,0,3
1746555873395,MMW 12R,A01,892724,Herbst; Matthew,0,11,16,16
1746555873395,MMW 12R,A02,892725,Herbst; Matthew,0,10,16,16
1746555874421,MMW 13R,A01,892727,Staff,0,4,16,16
1746555874421,MMW 13R,A02,892728,Staff,0,4,16,16
1746555874421,MMW 13R,A03,958032,Staff,0,4,16,16
1746555874421,MMW 13R,A04,958033,Staff,0,4,16,16
1746555874421,MMW 13R,A05,958034,Staff,0,4,16,16
1746555875446,SIO 295LS,A00,894015,Staff,5,0,25,20
1746555876473,SIO 295S,A00,894020,Staff,5,0,25,20
1746555877498,SIOC 290S,B01,958918,Merrifield; Mark A,14,0,30,16
1746555878530,SIOC 291S,B01,958922,Gabriel; Corey John,14,0,30,16
1746555879556,SOCI 117,A01,895339,Staff,3,0,5,2
1746555880581,WES 237B,A00,894149,Staff,11,0,20,9
1746555882646,AESE 279B,A00,891859,Staff,13,0,35,22
1746555883672,AIP 197,001,891854,Vespa; Emanuel Ignacio,9999,0,9999,0
1746555884698,ANTH 289S,A00,891856,Gagneux; Pascal,12,0,12,0
1746555885722,BENG 196,001,957946,Engler; Adam J.,9996,0,9999,3
1746555886748,BISP 197,001,959851,Wilhelm; James E.,9998,0,9999,1
1746555887774,CAT 124RS,A01,956906,Staff,6,0,25,19
1746555888797,CAT 125RS,A01,922013,Staff,6,0,25,19
1746555889825,CLRE 250,A00,891860,Morris; Sheldon,9995,0,9999,4
1746555891876,CLRE 251R,A00,907817,Mehta; Ravindra L.,9994,0,9999,5
1746555892903,CLRE 252,A00,891864,Cuomo; Raphael Eduardo,9993,0,9999,6
1746555893928,CLRE 253,A00,891867,Vaida; Florin,9994,0,9999,5
1746555893928,CLRE 253,B00,907819,Staff,9999,0,9999,0
1746555894956,CLRE 259,A00,891868,Patel; Hemal,9998,0,9999,1
1746555895982,CLRE 260,A00,891872,Cuomo; Raphael Eduardo,9999,0,9999,0
1746555897009,CLRE 297,001,891888,Cuomo; Raphael Eduardo,9999,0,9999,0
1746555898038,CSE 191,A00,958773,Minnes Kemp; Mor Mia,9995,0,9999,4
1746555899064,CSE 197,001,959846,Minnes Kemp; Mor Mia,9990,0,9999,9
1746555900092,CSS 201S,A01,892054,Mignozzetti; Umberto,26,0,30,4
1746555901117,CSS 202S,A01,892056,Mignozzetti; Umberto,26,0,30,4
1746555902142,DSC 197,001,956898,Eldridge; Justin Matthew,9997,0,9999,2
1746555903211,DSC 297,001,958000,Mazumdar; Arya,9998,0,9999,1
1746555903211,DSC 297,002,959862,Wang; Yusu,9998,0,9999,1
1746555904237,EAP 100,A00,905686,Staff,9778,0,9999,221
1746555905264,ECE 45,A01,892618,Staff,0,0,65,65
1746555907318,ECE 111,A01,892719,Staff,4,0,65,61
1746555908344,ECE 197,001,957920,Mercier; Patrick Philip,9991,0,9999,8
1746555909371,ECON 178,A01,907814,Zhu; Ying,26,0,35,9
1746555910398,EDS 115,A00,895312,Staff,35,0,45,10
1746555911423,EDS 117,A01,895337,Staff,23,0,30,7
1746555912451,EDS 125,A00,895341,Jones; Gabrielle Anastasia,36,0,45,9
1746555913478,EDS 128A,A01,895459,Fargason; Sharon Gayle,44,0,45,1
1746555914505,EDS 128B,A01,895543,Pappas; Elizabeth,44,0,45,1
1746555915531,EDS 139,A00,897203,Pappas; Elizabeth,44,0,45,1
1746555915531,EDS 139,B00,897209,Fargason; Sharon Gayle,41,0,45,4
1746555916555,EDS 201,A00,895545,Staff,22,0,45,23
1746555917581,EDS 203,A01,895581,Halter; Christopher P.,22,0,45,23
1746555918606,EDS 204R,A01,895625,Heinzman; Erica M.,39,0,45,6
1746555918606,EDS 204R,B01,895693,Halter; Christopher P.,10,0,45,35
1746555919632,EDS 206R,A00,895694,Fargason; Sharon Gayle,1,0,30,29
1746555919632,EDS 206R,B00,895695,Choi; Bailey Miyeon,16,0,30,14
1746555920655,EDS 250,A00,895697,Hemans; Patricia Ann Benitez,22,0,45,23
1746555921680,EDS 281,A00,895701,Meyerott; Theresa Ann,1,0,15,14
1746555922705,EDS 284,A00,895736,Meyerott; Theresa Ann,1,0,15,14
1746555923732,EDS 286,A00,897210,Fine; Sarah,0,0,15,15
1746555924758,EDS 289C,A01,895770,Daly; Alan J.,15,0,15,0
1746555925783,EDS 290,A00,897211,Hofstetter; Carolyn,0,0,15,15
1746555926811,LIGM 5A,A00,896162,Fischer-Grunski; Eva K,13,0,20,7
1746555927836,LIGM 5B,A00,896260,Fischer-Grunski; Eva K,17,0,20,3
1746555928862,LIGM 5C,A00,896308,Fischer-Grunski; Eva K,18,0,20,2
1746555929889,LIIT 5AS,A00,896313,Carnelos; Chiara,18,0,20,2
1746555930913,LIIT 5BS,A00,896416,Carnelos; Chiara,20,0,20,0
1746555931947,LIIT 5CS,A00,896564,Carnelos; Chiara,20,0,20,0
1746555932972,LISP 5A,A00,896588,Munoz Sanchez; Alicia,3,0,20,17
1746555933997,LISP 5B,A00,896653,Munoz Sanchez; Alicia,7,0,20,13
1746555935024,LISP 5C,A00,896655,Munoz Sanchez; Alicia,0,1,20,20
1746555936048,MAE 197,001,957918,Kleissl; Jan,9996,0,9999,3
1746555936048,MAE 197,002,959806,Boechler; Nicholas Sebastia,9998,0,9999,1
1746555936048,MAE 197,003,959852,Mullin; Jennifer S,9998,0,9999,1
1746555937074,MATH 2,A01,957937,Staff,33,0,35,2
1746555938099,MATH 197,001,957876,Kedlaya; Kiran S.,9993,0,9999,6
1746555939127,MCWP 40,A00,892729,Duru; Nur,10,0,20,10
1746555939127,MCWP 40,B00,893304,Montejo; Carolina,14,0,20,6
1746555940153,MCWP 40R,A00,893757,Redela; Pamela Morgan,0,5,20,20
1746555941180,MCWP 50,A00,893758,Morshed; Michael James,0,0,20,20
1746555941180,MCWP 50,B00,893761,Bartulis; Jason Michael,17,0,20,3
1746555942208,MCWP 50R,A00,893766,Compas; Sean Matthew,0,1,20,20
1746555942208,MCWP 50R,B00,893769,Carter; Jennifer A,0,1,20,20
1746555942208,MCWP 50R,C00,893771,Krone; Jarret,0,3,20,20
1746555942208,MCWP 50R,D00,893772,Miller; Elizabeth Deen,0,0,20,20
1746555942208,MCWP 50R,E00,893775,Carter; Andrea L,0,1,20,20
1746555943236,MMW 11R,A01,892721,Herbst; Matthew,11,0,27,16
1746555943236,MMW 11R,A02,892722,Herbst; Matthew,0,0,0,3
1746555944262,MMW 12R,A01,892724,Herbst; Matthew,0,11,16,16
1746555944262,MMW 12R,A02,892725,Herbst; Matthew,0,10,16,16
1746555945288,MMW 13R,A01,892727,Staff,0,4,16,16
1746555945288,MMW 13R,A02,892728,Staff,0,4,16,16
1746555945288,MMW 13R,A03,958032,Staff,0,4,16,16
1746555945288,MMW 13R,A04,958033,Staff,0,4,16,16
1746555945288,MMW 13R,A05,958034,Staff,0,4,16,16
1746555946314,SIO 295LS,A00,894015,Staff,5,0,25,20
1746555947338,SIO 295S,A00,894020,Staff,5,0,25,20
1746555948363,SIOC 290S,B01,958918,Merrifield; Mark A,14,0,30,16
1746555949389,SIOC 291S,B01,958922,Gabriel; Corey John,14,0,30,16
1746555950415,SOCI 117,A01,895339,Staff,3,0,5,2
1746555951443,WES 237B,A00,894149,Staff,11,0,20,9
1746555953500,AESE 279B,A00,891859,Staff,13,0,35,22
1746555954528,AIP 197,001,891854,Vespa; Emanuel Ignacio,9999,0,9999,0
1746555955554,ANTH 289S,A00,891856,Gagneux; Pascal,12,0,12,0
1746555956578,BENG 196,001,957946,Engler; Adam J.,9996,0,9999,3
1746555957602,BISP 197,001,959851,Wilhelm; James E.,9998,0,9999,1
1746555958628,CAT 124RS,A01,956906,Staff,6,0,25,19
1746555959651,CAT 125RS,A01,922013,Staff,6,0,25,19
1746555960680,CLRE 250,A00,891860,Morris; Sheldon,9995,0,9999,4
1746555962733,CLRE 251R,A00,907817,Mehta; Ravindra L.,9994,0,9999,5
1746555963758,CLRE 252,A00,891864,Cuomo; Raphael Eduardo,9993,0,9999,6
1746555964786,CLRE 253,A00,891867,Vaida; Florin,9994,0,9999,5
1746555964786,CLRE 253,B00,907819,Staff,9999,0,9999,0
1746555965812,CLRE 259,A00,891868,Patel; Hemal,9998,0,9999,1
1746555966837,CLRE 260,A00,891872,Cuomo; Raphael Eduardo,9999,0,9999,0
1746555967861,CLRE 297,001,891888,Cuomo; Raphael Eduardo,9999,0,9999,0
1746555968885,CSE 191,A00,958773,Minnes Kemp; Mor Mia,9995,0,9999,4
1746555969915,CSE 197,001,959846,Minnes Kemp; Mor Mia,9990,0,9999,9
1746555970944,CSS 201S,A01,892054,Mignozzetti; Umberto,26,0,30,4
1746555971969,CSS 202S,A01,892056,Mignozzetti; Umberto,26,0,30,4
1746555972998,DSC 197,001,956898,Eldridge; Justin Matthew,9997,0,9999,2
1746555974024,DSC 297,001,958000,Mazumdar; Arya,9998,0,9999,1
1746555974024,DSC 297,002,959862,Wang; Yusu,9998,0,9999,1
1746555975049,EAP 100,A00,905686,Staff,9778,0,9999,221
1746555976078,ECE 45,A01,892618,Staff,0,0,65,65
1746555979145,ECE 111,A01,892719,Staff,4,0,65,61
1746555980171,ECE 197,001,957920,Mercier; Patrick Philip,9991,0,9999,8
1746555981197,ECON 178,A01,907814,Zhu; Ying,26,0,35,9
1746555982221,EDS 115,A00,895312,Staff,35,0,45,10
1746555983246,EDS 117,A01,895337,Staff,23,0,30,7
1746555984271,EDS 125,A00,895341,Jones; Gabrielle Anastasia,36,0,45,9
1746555985301,EDS 128A,A01,895459,Fargason; Sharon Gayle,44,0,45,1
1746555986325,EDS 128B,A01,895543,Pappas; Elizabeth,44,0,45,1
1746555987351,EDS 139,A00,897203,Pappas; Elizabeth,44,0,45,1
1746555987351,EDS 139,B00,897209,Fargason; Sharon Gayle,41,0,45,4
1746555988379,EDS 201,A00,895545,Staff,22,0,45,23
1746555989403,EDS 203,A01,895581,Halter; Christopher P.,22,0,45,23
1746555990428,EDS 204R,A01,895625,Heinzman; Erica M.,39,0,45,6
1746555990428,EDS 204R,B01,895693,Halter; Christopher P.,10,0,45,35
1746555991452,EDS 206R,A00,895694,Fargason; Sharon Gayle,1,0,30,29
1746555991452,EDS 206R,B00,895695,Choi; Bailey Miyeon,16,0,30,14
1746555992477,EDS 250,A00,895697,Hemans; Patricia Ann Benitez,22,0,45,23
1746555993503,EDS 281,A00,895701,Meyerott; Theresa Ann,1,0,15,14
1746555994531,EDS 284,A00,895736,Meyerott; Theresa Ann,1,0,15,14
1746555995556,EDS 286,A00,897210,Fine; Sarah,0,0,15,15
1746555996585,EDS 289C,A01,895770,Daly; Alan J.,15,0,15,0
1746555997612,EDS 290,A00,897211,Hofstetter; Carolyn,0,0,15,15
1746555998638,LIGM 5A,A00,896162,Fischer-Grunski; Eva K,13,0,20,7
1746555999664,LIGM 5B,A00,896260,Fischer-Grunski; Eva K,17,0,20,3
1746556000690,LIGM 5C,A00,896308,Fischer-Grunski; Eva K,18,0,20,2
1746556001718,LIIT 5AS,A00,896313,Carnelos; Chiara,18,0,20,2
1746556002742,LIIT 5BS,A00,896416,Carnelos; Chiara,20,0,20,0
1746556003767,LIIT 5CS,A00,896564,Carnelos; Chiara,20,0,20,0
1746556004796,LISP 5A,A00,896588,Munoz Sanchez; Alicia,3,0,20,17
1746556005824,LISP 5B,A00,896653,Munoz Sanchez; Alicia,7,0,20,13
1746556006851,LISP 5C,A00,896655,Munoz Sanchez; Alicia,0,1,20,20
1746556007878,MAE 197,001,957918,Kleissl; Jan,9996,0,9999,3
1746556007878,MAE 197,002,959806,Boechler; Nicholas Sebastia,9998,0,9999,1
1746556007878,MAE 197,003,959852,Mullin; Jennifer S,9998,0,9999,1
1746556008903,MATH 2,A01,957937,Staff,33,0,35,2
1746556009929,MATH 197,001,957876,Kedlaya; Kiran S.,9993,0,9999,6
1746556010953,MCWP 40,A00,892729,Duru; Nur,10,0,20,10
1746556010953,MCWP 40,B00,893304,Montejo; Carolina,14,0,20,6
1746556011982,MCWP 40R,A00,893757,Redela; Pamela Morgan,0,5,20,20
1746556013010,MCWP 50,A00,893758,Morshed; Michael James,0,0,20,20
1746556013010,MCWP 50,B00,893761,Bartulis; Jason Michael,17,0,20,3
1746556014038,MCWP 50R,A00,893766,Compas; Sean Matthew,0,1,20,20
1746556014038,MCWP 50R,B00,893769,Carter; Jennifer A,0,1,20,20
1746556014038,MCWP 50R,C00,893771,Krone; Jarret,0,3,20,20
1746556014038,MCWP 50R,D00,893772,Miller; Elizabeth Deen,0,0,20,20
1746556014038,MCWP 50R,E00,893775,Carter; Andrea L,0,1,20,20
1746556015065,MMW 11R,A01,892721,Herbst; Matthew,11,0,27,16
1746556015065,MMW 11R,A02,892722,Herbst; Matthew,0,0,0,3
1746556016092,MMW 12R,A01,892724,Herbst; Matthew,0,11,16,16
1746556016092,MMW 12R,A02,892725,Herbst; Matthew,0,10,16,16
1746556017117,MMW 13R,A01,892727,Staff,0,4,16,16
1746556017117,MMW 13R,A02,892728,Staff,0,4,16,16
1746556017117,MMW 13R,A03,958032,Staff,0,4,16,16
1746556017117,MMW 13R,A04,958033,Staff,0,4,16,16
1746556017117,MMW 13R,A05,958034,Staff,0,4,16,16
1746556018144,SIO 295LS,A00,894015,Staff,5,0,25,20
1746556019169,SIO 295S,A00,894020,Staff,5,0,25,20
1746556020194,SIOC 290S,B01,958918,Merrifield; Mark A,14,0,30,16
1746556021219,SIOC 291S,B01,958922,Gabriel; Corey John,14,0,30,16
1746556022244,SOCI 117,A01,895339,Staff,3,0,5,2
1746556023270,WES 237B,A00,894149,Staff,11,0,20,9
1746556025333,AESE 279B,A00,891859,Staff,13,0,35,22
1746556026358,AIP 197,001,891854,Vespa; Emanuel Ignacio,9999,0,9999,0
1746556027388,ANTH 289S,A00,891856,Gagneux; Pascal,12,0,12,0
1746556028413,BENG 196,001,957946,Engler; Adam J.,9996,0,9999,3
1746556029436,BISP 197,001,959851,Wilhelm; James E.,9998,0,9999,1
1746556030462,CAT 124RS,A01,956906,Staff,6,0,25,19
1746556031490,CAT 125RS,A01,922013,Staff,6,0,25,19
1746556032515,CLRE 250,A00,891860,Morris; Sheldon,9995,0,9999,4
1746556034570,CLRE 251R,A00,907817,Mehta; Ravindra L.,9994,0,9999,5
1746556035594,CLRE 252,A00,891864,Cuomo; Raphael Eduardo,9993,0,9999,6
1746556036622,CLRE 253,A00,891867,Vaida; Florin,9994,0,9999,5
1746556036622,CLRE 253,B00,907819,Staff,9999,0,9999,0
1746556037652,CLRE 259,A00,891868,Patel; Hemal,9998,0,9999,1
1746556038679,CLRE 260,A00,891872,Cuomo; Raphael Eduardo,9999,0,9999,0
1746556039703,CLRE 297,001,891888,Cuomo; Raphael Eduardo,9999,0,9999,0
1746556040732,CSE 191,A00,958773,Minnes Kemp; Mor Mia,9995,0,9999,4
1746556041758,CSE 197,001,959846,Minnes Kemp; Mor Mia,9990,0,9999,9
1746556042786,CSS 201S,A01,892054,Mignozzetti; Umberto,26,0,30,4
1746556043815,CSS 202S,A01,892056,Mignozzetti; Umberto,26,0,30,4
1746556044842,DSC 197,001,956898,Eldridge; Justin Matthew,9997,0,9999,2
1746556045867,DSC 297,001,958000,Mazumdar; Arya,9998,0,9999,1
1746556045867,DSC 297,002,959862,Wang; Yusu,9998,0,9999,1
1746556046892,EAP 100,A00,905686,Staff,9778,0,9999,221
1746556047918,ECE 45,A01,892618,Staff,0,0,65,65
1746556049970,ECE 111,A01,892719,Staff,4,0,65,61
1746556050994,ECE 197,001,957920,Mercier; Patrick Philip,9991,0,9999,8
1746556052021,ECON 178,A01,907814,Zhu; Ying,26,0,35,9
1746556053047,EDS 115,A00,895312,Staff,35,0,45,10
1746556054073,EDS 117,A01,895337,Staff,23,0,30,7
1746556055101,EDS 125,A00,895341,Jones; Gabrielle Anastasia,36,0,45,9
1746556056129,EDS 128A,A01,895459,Fargason; Sharon Gayle,44,0,45,1
1746556057155,EDS 128B,A01,895543,Pappas; Elizabeth,44,0,45,1
1746556058180,EDS 139,A00,897203,Pappas; Elizabeth,44,0,45,1
1746556058180,EDS 139,B00,897209,Fargason; Sharon Gayle,41,0,45,4
1746556059204,EDS 201,A00,895545,Staff,22,0,45,23
1746556060229,EDS 203,A01,895581,Halter; Christopher P.,22,0,45,23
1746556061254,EDS 204R,A01,895625,Heinzman; Erica M.,39,0,45,6
1746556061254,EDS 204R,B01,895693,Halter; Christopher P.,10,0,45,35
1746556062281,EDS 206R,A00,895694,Fargason; Sharon Gayle,1,0,30,29
1746556062281,EDS 206R,B00,895695,Choi; Bailey Miyeon,16,0,30,14
1746556063308,EDS 250,A00,895697,Hemans; Patricia Ann Benitez,22,0,45,23
1746556064332,EDS 281,A00,895701,Meyerott; Theresa Ann,1,0,15,14
1746556065358,EDS 284,A00,895736,Meyerott; Theresa Ann,1,0,15,14
1746556066380,EDS 286,A00,897210,Fine; Sarah,0,0,15,15
1746556067405,EDS 289C,A01,895770,Daly; Alan J.,15,0,15,0
1746556068431,EDS 290,A00,897211,Hofstetter; Carolyn,0,0,15,15
1746556069455,LIGM 5A,A00,896162,Fischer-Grunski; Eva K,13,0,20,7
1746556070481,LIGM 5B,A00,896260,Fischer-Grunski; Eva K,17,0,20,3
1746556071505,LIGM 5C,A00,896308,Fischer-Grunski; Eva K,18,0,20,2
1746556072532,LIIT 5AS,A00,896313,Carnelos; Chiara,18,0,20,2
1746556073559,LIIT 5BS,A00,896416,Carnelos; Chiara,20,0,20,0
1746556074583,LIIT 5CS,A00,896564,Carnelos; Chiara,20,0,20,0
1746556075609,LISP 5A,A00,896588,Munoz Sanchez; Alicia,3,0,20,17
1746556076636,LISP 5B,A00,896653,Munoz Sanchez; Alicia,7,0,20,13
1746556077663,LISP 5C,A00,896655,Munoz Sanchez; Alicia,0,1,20,20
1746556078688,MAE 197,001,957918,Kleissl; Jan,9996,0,9999,3
1746556078688,MAE 197,002,959806,Boechler; Nicholas Sebastia,9998,0,9999,1
1746556078688,MAE 197,003,959852,Mullin; Jennifer S,9998,0,9999,1
1746556079712,MATH 2,A01,957937,Staff,33,0,35,2
1746556080740,MATH 197,001,957876,Kedlaya; Kiran S.,9993,0,9999,6
1746556081766,MCWP 40,A00,892729,Duru; Nur,10,0,20,10
1746556081766,MCWP 40,B00,893304,Montejo; Carolina,14,0,20,6
1746556082791,MCWP 40R,A00,893757,Redela; Pamela Morgan,0,5,20,20
1746556083816,MCWP 50,A00,893758,Morshed; Michael James,0,0,20,20
1746556083816,MCWP 50,B00,893761,Bartulis; Jason Michael,17,0,20,3
1746556084845,MCWP 50R,A00,893766,Compas; Sean Matthew,0,1,20,20
1746556084845,MCWP 50R,B00,893769,Carter; Jennifer A,0,1,20,20
1746556084845,MCWP 50R,C00,893771,Krone; Jarret,0,3,20,20
1746556084845,MCWP 50R,D00,893772,Miller; Elizabeth Deen,0,0,20,20
1746556084845,MCWP 50R,E00,893775,Carter; Andrea L,0,1,20,20
1746556085868,MMW 11R,A01,892721,Herbst; Matthew,11,0,27,16
1746556085868,MMW 11R,A02,892722,Herbst; Matthew,0,0,0,3
1746556086894,MMW 12R,A01,892724,Herbst; Matthew,0,11,16,16
1746556086894,MMW 12R,A02,892725,Herbst; Matthew,0,10,16,16
1746556087922,MMW 13R,A01,892727,Staff,0,4,16,16
1746556087922,MMW 13R,A02,892728,Staff,0,4,16,16
1746556087922,MMW 13R,A03,958032,Staff,0,4,16,16
1746556087922,MMW 13R,A04,958033,Staff,0,4,16,16
1746556087922,MMW 13R,A05,958034,Staff,0,4,16,16
1746556088946,SIO 295LS,A00,894015,Staff,5,0,25,20
1746556090032,SIO 295S,A00,894020,Staff,5,0,25,20
1746556091057,SIOC 290S,B01,958918,Merrifield; Mark A,14,0,30,16
1746556092086,SIOC 291S,B01,958922,Gabriel; Corey John,14,0,30,16
1746556093110,SOCI 117,A01,895339,Staff,3,0,5,2
1746556094134,WES 237B,A00,894149,Staff,11,0,20,9
1746556096198,AESE 279B,A00,891859,Staff,13,0,35,22
1746556097223,AIP 197,001,891854,Vespa; Emanuel Ignacio,9999,0,9999,0
1746556098250,ANTH 289S,A00,891856,Gagneux; Pascal,12,0,12,0
1746556099274,BENG 196,001,957946,Engler; Adam J.,9996,0,9999,3
1746556100301,BISP 197,001,959851,Wilhelm; James E.,9998,0,9999,1
1746556101327,CAT 124RS,A01,956906,Staff,6,0,25,19
1746556102352,CAT 125RS,A01,922013,Staff,6,0,25,19
1746556103376,CLRE 250,A00,891860,Morris; Sheldon,9995,0,9999,4
1746556105426,CLRE 251R,A00,907817,Mehta; Ravindra L.,9994,0,9999,5
1746556106453,CLRE 252,A00,891864,Cuomo; Raphael Eduardo,9993,0,9999,6
1746556107479,CLRE 253,A00,891867,Vaida; Florin,9994,0,9999,5
1746556107479,CLRE 253,B00,907819,Staff,9999,0,9999,0
1746556108503,CLRE 259,A00,891868,Patel; Hemal,9998,0,9999,1
1746556109528,CLRE 260,A00,891872,Cuomo; Raphael Eduardo,9999,0,9999,0
1746556110556,CLRE 297,001,891888,Cuomo; Raphael Eduardo,9999,0,9999,0
1746556111582,CSE 191,A00,958773,Minnes Kemp; Mor Mia,9995,0,9999,4
1746556112611,CSE 197,001,959846,Minnes Kemp; Mor Mia,9990,0,9999,9
1746556113639,CSS 201S,A01,892054,Mignozzetti; Umberto,26,0,30,4
1746556114665,CSS 202S,A01,892056,Mignozzetti; Umberto,26,0,30,4
1746556115689,DSC 197,001,956898,Eldridge; Justin Matthew,9997,0,9999,2
1746556116718,DSC 297,001,958000,Mazumdar; Arya,9998,0,9999,1
1746556116718,DSC 297,002,959862,Wang; Yusu,9998,0,9999,1
1746556117744,EAP 100,A00,905686,Staff,9778,0,9999,221
1746556118769,ECE 45,A01,892618,Staff,0,0,65,65
1746556120822,ECE 111,A01,892719,Staff,4,0,65,61
1746556121849,ECE 197,001,957920,Mercier; Patrick Philip,9991,0,9999,8
1746556122876,ECON 178,A01,907814,Zhu; Ying,26,0,35,9
1746556123901,EDS 115,A00,895312,Staff,35,0,45,10
1746556124928,EDS 117,A01,895337,Staff,23,0,30,7
1746556125953,EDS 125,A00,895341,Jones; Gabrielle Anastasia,36,0,45,9
1746556126979,EDS 128A,A01,895459,Fargason; Sharon Gayle,44,0,45,1
1746556128004,EDS 128B,A01,895543,Pappas; Elizabeth,44,0,45,1
1746556129028,EDS 139,A00,897203,Pappas; Elizabeth,44,0,45,1
1746556129028,EDS 139,B00,897209,Fargason; Sharon Gayle,41,0,45,4
1746556130053,EDS 201,A00,895545,Staff,22,0,45,23
1746556131081,EDS 203,A01,895581,Halter; Christopher P.,22,0,45,23
1746556132105,EDS 204R,A01,895625,Heinzman; Erica M.,39,0,45,6
1746556132105,EDS 204R,B01,895693,Halter; Christopher P.,10,0,45,35
1746556133130,EDS 206R,A00,895694,Fargason; Sharon Gayle,1,0,30,29
1746556133130,EDS 206R,B00,895695,Choi; Bailey Miyeon,16,0,30,14
1746556134157,EDS 250,A00,895697,Hemans; Patricia Ann Benitez,22,0,45,23
1746556135183,EDS 281,A00,895701,Meyerott; Theresa Ann,1,0,15,14
1746556136210,EDS 284,A00,895736,Meyerott; Theresa Ann,1,0,15,14
1746556137234,EDS 286,A00,897210,Fine; Sarah,0,0,15,15
1746556138259,EDS 289C,A01,895770,Daly; Alan J.,15,0,15,0
1746556139289,EDS 290,A00,897211,Hofstetter; Carolyn,0,0,15,15
1746556140317,LIGM 5A,A00,896162,Fischer-Grunski; Eva K,13,0,20,7
1746556141343,LIGM 5B,A00,896260,Fischer-Grunski; Eva K,17,0,20,3
1746556142369,LIGM 5C,A00,896308,Fischer-Grunski; Eva K,18,0,20,2
1746556143397,LIIT 5AS,A00,896313,Carnelos; Chiara,18,0,20,2
1746556144425,LIIT 5BS,A00,896416,Carnelos; Chiara,20,0,20,0
1746556145450,LIIT 5CS,A00,896564,Carnelos; Chiara,20,0,20,0
1746556146474,LISP 5A,A00,896588,Munoz Sanchez; Alicia,3,0,20,17
1746556147499,LISP 5B,A00,896653,Munoz Sanchez; Alicia,7,0,20,13
1746556148523,LISP 5C,A00,896655,Munoz Sanchez; Alicia,0,1,20,20
1746556149548,MAE 197,001,957918,Kleissl; Jan,9996,0,9999,3
1746556149548,MAE 197,002,959806,Boechler; Nicholas Sebastia,9998,0,9999,1
1746556149548,MAE 197,003,959852,Mullin; Jennifer S,9998,0,9999,1
1746556150572,MATH 2,A01,957937,Staff,33,0,35,2
1746556151596,MATH 197,001,957876,Kedlaya; Kiran S.,9993,0,9999,6
1746556152625,MCWP 40,A00,892729,Duru; Nur,10,0,20,10
1746556152625,MCWP 40,B00,893304,Montejo; Carolina,14,0,20,6
1746556153652,MCWP 40R,A00,893757,Redela; Pamela Morgan,0,5,20,20
1746556154680,MCWP 50,A00,893758,Morshed; Michael James,0,0,20,20
1746556154680,MCWP 50,B00,893761,Bartulis; Jason Michael,17,0,20,3
1746556155707,MCWP 50R,A00,893766,Compas; Sean Matthew,0,1,20,20
1746556155707,MCWP 50R,B00,893769,Carter; Jennifer A,0,1,20,20
1746556155707,MCWP 50R,C00,893771,Krone; Jarret,0,3,20,20
1746556155707,MCWP 50R,D00,893772,Miller; Elizabeth Deen,0,0,20,20
1746556155707,MCWP 50R,E00,893775,Carter; Andrea L,0,1,20,20
1746556156735,MMW 11R,A01,892721,Herbst; Matthew,11,0,27,16
1746556156735,MMW 11R,A02,892722,Herbst; Matthew,0,0,0,3
1746556157762,MMW 12R,A01,892724,Herbst; Matthew,0,11,16,16
1746556157762,MMW 12R,A02,892725,Herbst; Matthew,0,10,16,16
1746556158787,MMW 13R,A01,892727,Staff,0,4,16,16
1746556158787,MMW 13R,A02,892728,Staff,0,4,16,16
1746556158787,MMW 13R,A03,958032,Staff,0,4,16,16
1746556158787,MMW 13R,A04,958033,Staff,0,4,16,16
1746556158787,MMW 13R,A05,958034,Staff,0,4,16,16
1746556159813,SIO 295LS,A00,894015,Staff,5,0,25,20
1746556160837,SIO 295S,A00,894020,Staff,5,0,25,20
1746556161866,SIOC 290S,B01,958918,Merrifield; Mark A,14,0,30,16
1746556162895,SIOC 291S,B01,958922,Gabriel; Corey John,14,0,30,16
1746556163921,SOCI 117,A01,895339,Staff,3,0,5,2
1746556164947,WES 237B,A00,894149,Staff,11,0,20,9
1746556167006,AESE 279B,A00,891859,Staff,13,0,35,22
1746556168035,AIP 197,001,891854,Vespa; Emanuel Ignacio,9999,0,9999,0
1746556169059,ANTH 289S,A00,891856,Gagneux; Pascal,12,0,12,0
1746556170088,BENG 196,001,957946,Engler; Adam J.,9996,0,9999,3
1746556171115,BISP 197,001,959851,Wilhelm; James E.,9998,0,9999,1
1746556172139,CAT 124RS,A01,956906,Staff,6,0,25,19
1746556173165,CAT 125RS,A01,922013,Staff,6,0,25,19
1746556174188,CLRE 250,A00,891860,Morris; Sheldon,9995,0,9999,4
1746556176242,CLRE 251R,A00,907817,Mehta; Ravindra L.,9994,0,9999,5
1746556177266,CLRE 252,A00,891864,Cuomo; Raphael Eduardo,9993,0,9999,6
1746556178293,CLRE 253,A00,891867,Vaida; Florin,9994,0,9999,5
1746556178293,CLRE 253,B00,907819,Staff,9999,0,9999,0
1746556179321,CLRE 259,A00,891868,Patel; Hemal,9998,0,9999,1
1746556180347,CLRE 260,A00,891872,Cuomo; Raphael Eduardo,9999,0,9999,0
1746556181373,CLRE 297,001,891888,Cuomo; Raphael Eduardo,9999,0,9999,0
1746556182408,CSE 191,A00,958773,Minnes Kemp; Mor Mia,9995,0,9999,4
1746556183431,CSE 197,001,959846,Minnes Kemp; Mor Mia,9990,0,9999,9
1746556184457,CSS 201S,A01,892054,Mignozzetti; Umberto,26,0,30,4
1746556185485,CSS 202S,A01,892056,Mignozzetti; Umberto,26,0,30,4
1746556186512,DSC 197,001,956898,Eldridge; Justin Matthew,9997,0,9999,2
1746556187538,DSC 297,001,958000,Mazumdar; Arya,9998,0,9999,1
1746556187538,DSC 297,002,959862,Wang; Yusu,9998,0,9999,1
1746556188564,EAP 100,A00,905686,Staff,9778,0,9999,221
1746556189594,ECE 45,A01,892618,Staff,0,0,65,65
1746556191644,ECE 111,A01,892719,Staff,4,0,65,61
1746556192668,ECE 197,001,957920,Mercier; Patrick Philip,9991,0,9999,8
1746556193696,ECON 178,A01,907814,Zhu; Ying,26,0,35,9
1746556194719,EDS 115,A00,895312,Staff,35,0,45,10
1746556195747,EDS 117,A01,895337,Staff,23,0,30,7
1746556196771,EDS 125,A00,895341,Jones; Gabrielle Anastasia,36,0,45,9
1746556197795,EDS 128A,A01,895459,Fargason; Sharon Gayle,44,0,45,1
1746556198820,EDS 128B,A01,895543,Pappas; Elizabeth,44,0,45,1
1746556199846,EDS 139,A00,897203,Pappas; Elizabeth,44,0,45,1
1746556199846,EDS 139,B00,897209,Fargason; Sharon Gayle,41,0,45,4
1746556200871,EDS 201,A00,895545,Staff,22,0,45,23
1746556201899,EDS 203,A01,895581,Halter; Christopher P.,22,0,45,23
1746556202925,EDS 204R,A01,895625,Heinzman; Erica M.,39,0,45,6
1746556202925,EDS 204R,B01,895693,Halter; Christopher P.,10,0,45,35
1746556203951,EDS 206R,A00,895694,Fargason; Sharon Gayle,1,0,30,29
1746556203951,EDS 206R,B00,895695,Choi; Bailey Miyeon,16,0,30,14
1746556204977,EDS 250,A00,895697,Hemans; Patricia Ann Benitez,22,0,45,23
1746556206003,EDS 281,A00,895701,Meyerott; Theresa Ann,1,0,15,14
1746556207031,EDS 284,A00,895736,Meyerott; Theresa Ann,1,0,15,14
1746556208057,EDS 286,A00,897210,Fine; Sarah,0,0,15,15
1746556209085,EDS 289C,A01,895770,Daly; Alan J.,15,0,15,0
1746556210110,EDS 290,A00,897211,Hofstetter; Carolyn,0,0,15,15
1746556211136,LIGM 5A,A00,896162,Fischer-Grunski; Eva K,13,0,20,7
1746556212161,LIGM 5B,A00,896260,Fischer-Grunski; Eva K,17,0,20,3
1746556213188,LIGM 5C,A00,896308,Fischer-Grunski; Eva K,18,0,20,2
1746556214213,LIIT 5AS,A00,896313,Carnelos; Chiara,18,0,20,2
1746556215242,LIIT 5BS,A00,896416,Carnelos; Chiara,20,0,20,0
1746556216270,LIIT 5CS,A00,896564,Carnelos; Chiara,20,0,20,0
1746556217297,LISP 5A,A00,896588,Munoz Sanchez; Alicia,3,0,20,17
1746556218321,LISP 5B,A00,896653,Munoz Sanchez; Alicia,7,0,20,13
1746556219347,LISP 5C,A00,896655,Munoz Sanchez; Alicia,0,1,20,20
1746556220372,MAE 197,001,957918,Kleissl; Jan,9996,0,9999,3
1746556220372,MAE 197,002,959806,Boechler; Nicholas Sebastia,9998,0,9999,1
1746556220372,MAE 197,003,959852,Mullin; Jennifer S,9998,0,9999,1
1746556221399,MATH 2,A01,957937,Staff,33,0,35,2
1746556222426,MATH 197,001,957876,Kedlaya; Kiran S.,9993,0,9999,6
1746556223450,MCWP 40,A00,892729,Duru; Nur,10,0,20,10
1746556223450,MCWP 40,B00,893304,Montejo; Carolina,14,0,20,6
1746556224477,MCWP 40R,A00,893757,Redela; Pamela Morgan,0,5,20,20
1746556225502,MCWP 50,A00,893758,Morshed; Michael James,0,0,20,20
1746556225502,MCWP 50,B00,893761,Bartulis; Jason Michael,17,0,20,3
1746556226528,MCWP 50R,A00,893766,Compas; Sean Matthew,0,1,20,20
1746556226528,MCWP 50R,B00,893769,Carter; Jennifer A,0,1,20,20
1746556226528,MCWP 50R,C00,893771,Krone; Jarret,0,3,20,20
1746556226528,MCWP 50R,D00,893772,Miller; Elizabeth Deen,0,0,20,20
1746556226528,MCWP 50R,E00,893775,Carter; Andrea L,0,1,20,20
1746556227555,MMW 11R,A01,892721,Herbst; Matthew,11,0,27,16
1746556227555,MMW 11R,A02,892722,Herbst; Matthew,0,0,0,3
1746556228579,MMW 12R,A01,892724,Herbst; Matthew,0,11,16,16
1746556228579,MMW 12R,A02,892725,Herbst; Matthew,0,10,16,16
1746556229604,MMW 13R,A01,892727,Staff,0,4,16,16
1746556229604,MMW 13R,A02,892728,Staff,0,4,16,16
1746556229604,MMW 13R,A03,958032,Staff,0,4,16,16
1746556229604,MMW 13R,A04,958033,Staff,0,4,16,16
1746556229604,MMW 13R,A05,958034,Staff,0,4,16,16
1746556230629,SIO 295LS,A00,894015,Staff,5,0,25,20
1746556231658,SIO 295S,A00,894020,Staff,5,0,25,20
1746556232690,SIOC 290S,B01,958918,Merrifield; Mark A,14,0,30,16
1746556233715,SIOC 291S,B01,958922,Gabriel; Corey John,14,0,30,16
1746556234739,SOCI 117,A01,895339,Staff,3,0,5,2
1746556235764,WES 237B,A00,894149,Staff,11,0,20,9
1746556237828,AESE 279B,A00,891859,Staff,13,0,35,22
1746556238855,AIP 197,001,891854,Vespa; Emanuel Ignacio,9999,0,9999,0
1746556239884,ANTH 289S,A00,891856,Gagneux; Pascal,12,0,12,0
1746556240910,BENG 196,001,957946,Engler; Adam J.,9996,0,9999,3
1746556241937,BISP 197,001,959851,Wilhelm; James E.,9998,0,9999,1
1746556242964,CAT 124RS,A01,956906,Staff,6,0,25,19
1746556243991,CAT 125RS,A01,922013,Staff,6,0,25,19
1746556245016,CLRE 250,A00,891860,Morris; Sheldon,9995,0,9999,4
1746556247072,CLRE 251R,A00,907817,Mehta; Ravindra L.,9994,0,9999,5
1746556248100,CLRE 252,A00,891864,Cuomo; Raphael Eduardo,9993,0,9999,6
1746556249127,CLRE 253,A00,891867,Vaida; Florin,9994,0,9999,5
1746556249127,CLRE 253,B00,907819,Staff,9999,0,9999,0
1746556250154,CLRE 259,A00,891868,Patel; Hemal,9998,0,9999,1
1746556251180,CLRE 260,A00,891872,Cuomo; Raphael Eduardo,9999,0,9999,0
1746556252207,CLRE 297,001,891888,Cuomo; Raphael Eduardo,9999,0,9999,0
1746556253233,CSE 191,A00,958773,Minnes Kemp; Mor Mia,9995,0,9999,4
1746556254260,CSE 197,001,959846,Minnes Kemp; Mor Mia,9990,0,9999,9
1746556255285,CSS 201S,A01,892054,Mignozzetti; Umberto,26,0,30,4
1746556256310,CSS 202S,A01,892056,Mignozzetti; Umberto,26,0,30,4
1746556257336,DSC 197,001,956898,Eldridge; Justin Matthew,9997,0,9999,2
1746556258360,DSC 297,001,958000,Mazumdar; Arya,9998,0,9999,1
1746556258360,DSC 297,002,959862,Wang; Yusu,9998,0,9999,1
1746556259385,EAP 100,A00,905686,Staff,9778,0,9999,221
1746556260412,ECE 45,A01,892618,Staff,0,0,65,65
1746556262462,ECE 111,A01,892719,Staff,4,0,65,61
1746556263488,ECE 197,001,957920,Mercier; Patrick Philip,9991,0,9999,8
1746556264518,ECON 178,A01,907814,Zhu; Ying,26,0,35,9
1746556265543,EDS 115,A00,895312,Staff,35,0,45,10
1746556266570,EDS 117,A01,895337,Staff,23,0,30,7
1746556267597,EDS 125,A00,895341,Jones; Gabrielle Anastasia,36,0,45,9
1746556268626,EDS 128A,A01,895459,Fargason; Sharon Gayle,44,0,45,1
1746556269653,EDS 128B,A01,895543,Pappas; Elizabeth,44,0,45,1
1746556270678,EDS 139,A00,897203,Pappas; Elizabeth,44,0,45,1
1746556270678,EDS 139,B00,897209,Fargason; Sharon Gayle,41,0,45,4
1746556271703,EDS 201,A00,895545,Staff,22,0,45,23
1746556272726,EDS 203,A01,895581,Halter; Christopher P.,22,0,45,23
1746556273754,EDS 204R,A01,895625,Heinzman; Erica M.,39,0,45,6
1746556273754,EDS 204R,B01,895693,Halter; Christopher P.,10,0,45,35
1746556274779,EDS 206R,A00,895694,Fargason; Sharon Gayle,1,0,30,29
1746556274779,EDS 206R,B00,895695,Choi; Bailey Miyeon,16,0,30,14
1746556275808,EDS 250,A00,895697,Hemans; Patricia Ann Benitez,22,0,45,23
1746556276832,EDS 281,A00,895701,Meyerott; Theresa Ann,1,0,15,14
1746556277856,EDS 284,A00,895736,Meyerott; Theresa Ann,1,0,15,14
1746556278886,EDS 286,A00,897210,Fine; Sarah,0,0,15,15
1746556279910,EDS 289C,A01,895770,Daly; Alan J.,14,0,15,1
1746556280934,EDS 290,A00,897211,Hofstetter; Carolyn,0,0,15,15
1746556282173,LIGM 5A,A00,896162,Fischer-Grunski; Eva K,13,0,20,7
1746556283202,LIGM 5B,A00,896260,Fischer-Grunski; Eva K,17,0,20,3
1746556284227,LIGM 5C,A00,896308,Fischer-Grunski; Eva K,18,0,20,2
1746556285252,LIIT 5AS,A00,896313,Carnelos; Chiara,18,0,20,2
1746556286278,LIIT 5BS,A00,896416,Carnelos; Chiara,20,0,20,0
1746556287306,LIIT 5CS,A00,896564,Carnelos; Chiara,20,0,20,0
1746556288330,LISP 5A,A00,896588,Munoz Sanchez; Alicia,3,0,20,17
1746556289355,LISP 5B,A00,896653,Munoz Sanchez; Alicia,7,0,20,13
1746556290415,LISP 5C,A00,896655,Munoz Sanchez; Alicia,0,1,20,20
1746556291440,MAE 197,001,957918,Kleissl; Jan,9996,0,9999,3
1746556291440,MAE 197,002,959806,Boechler; Nicholas Sebastia,9998,0,9999,1
1746556291440,MAE 197,003,959852,Mullin; Jennifer S,9998,0,9999,1
1746556292467,MATH 2,A01,957937,Staff,33,0,35,2
1746556293492,MATH 197,001,957876,Kedlaya; Kiran S.,9993,0,9999,6
1746556294518,MCWP 40,A00,892729,Duru; Nur,10,0,20,10
1746556294518,MCWP 40,B00,893304,Montejo; Carolina,14,0,20,6
1746556295541,MCWP 40R,A00,893757,Redela; Pamela Morgan,0,5,20,20
1746556296570,MCWP 50,A00,893758,Morshed; Michael James,0,0,20,20
1746556296570,MCWP 50,B00,893761,Bartulis; Jason Michael,17,0,20,3
1746556297595,MCWP 50R,A00,893766,Compas; Sean Matthew,0,1,20,20
1746556297595,MCWP 50R,B00,893769,Carter; Jennifer A,0,1,20,20
1746556297595,MCWP 50R,C00,893771,Krone; Jarret,0,3,20,20
1746556297595,MCWP 50R,D00,893772,Miller; Elizabeth Deen,0,0,20,20
1746556297595,MCWP 50R,E00,893775,Carter; Andrea L,0,1,20,20
1746556298621,MMW 11R,A01,892721,Herbst; Matthew,11,0,27,16
1746556298621,MMW 11R,A02,892722,Herbst; Matthew,0,0,0,3
1746556299646,MMW 12R,A01,892724,Herbst; Matthew,0,11,16,16
1746556299646,MMW 12R,A02,892725,Herbst; Matthew,0,10,16,16
1746556300674,MMW 13R,A01,892727,Staff,0,4,16,16
1746556300674,MMW 13R,A02,892728,Staff,0,4,16,16
1746556300674,MMW 13R,A03,958032,Staff,0,4,16,16
1746556300674,MMW 13R,A04,958033,Staff,0,4,16,16
1746556300674,MMW 13R,A05,958034,Staff,0,4,16,16
1746556301698,SIO 295LS,A00,894015,Staff,5,0,25,20
1746556302724,SIO 295S,A00,894020,Staff,5,0,25,20
1746556303749,SIOC 290S,B01,958918,Merrifield; Mark A,14,0,30,16
1746556304776,SIOC 291S,B01,958922,Gabriel; Corey John,14,0,30,16
1746556305802,SOCI 117,A01,895339,Staff,3,0,5,2
1746556306825,WES 237B,A00,894149,Staff,11,0,20,9
1746556308889,AESE 279B,A00,891859,Staff,13,0,35,22
1746556309915,AIP 197,001,891854,Vespa; Emanuel Ignacio,9999,0,9999,0
1746556310942,ANTH 289S,A00,891856,Gagneux; Pascal,12,0,12,0
1746556311966,BENG 196,001,957946,Engler; Adam J.,9996,0,9999,3
1746556312995,BISP 197,001,959851,Wilhelm; James E.,9998,0,9999,1
1746556314019,CAT 124RS,A01,956906,Staff,6,0,25,19
1746556315045,CAT 125RS,A01,922013,Staff,6,0,25,19
1746556316069,CLRE 250,A00,891860,Morris; Sheldon,9995,0,9999,4
1746556318122,CLRE 251R,A00,907817,Mehta; Ravindra L.,9994,0,9999,5
1746556319146,CLRE 252,A00,891864,Cuomo; Raphael Eduardo,9993,0,9999,6
1746556320171,CLRE 253,A00,891867,Vaida; Florin,9994,0,9999,5
1746556320171,CLRE 253,B00,907819,Staff,9999,0,9999,0
1746556321198,CLRE 259,A00,891868,Patel; Hemal,9998,0,9999,1
1746556322222,CLRE 260,A00,891872,Cuomo; Raphael Eduardo,9999,0,9999,0
1746556323247,CLRE 297,001,891888,Cuomo; Raphael Eduardo,9999,0,9999,0
1746556324275,CSE 191,A00,958773,Minnes Kemp; Mor Mia,9995,0,9999,4
1746556325300,CSE 197,001,959846,Minnes Kemp; Mor Mia,9990,0,9999,9
1746556326325,CSS 201S,A01,892054,Mignozzetti; Umberto,26,0,30,4
1746556327349,CSS 202S,A01,892056,Mignozzetti; Umberto,26,0,30,4
1746556328378,DSC 197,001,956898,Eldridge; Justin Matthew,9997,0,9999,2
1746556329403,DSC 297,001,958000,Mazumdar; Arya,9998,0,9999,1
1746556329403,DSC 297,002,959862,Wang; Yusu,9998,0,9999,1
1746556330430,EAP 100,A00,905686,Staff,9778,0,9999,221
1746556331455,ECE 45,A01,892618,Staff,0,0,65,65
1746556333505,ECE 111,A01,892719,Staff,4,0,65,61
1746556334532,ECE 197,001,957920,Mercier; Patrick Philip,9991,0,9999,8
1746556335563,ECON 178,A01,907814,Zhu; Ying,26,0,35,9
1746556336589,EDS 115,A00,895312,Staff,35,0,45,10
1746556337616,EDS 117,A01,895337,Staff,23,0,30,7
1746556338642,EDS 125,A00,895341,Jones; Gabrielle Anastasia,36,0,45,9
1746556339667,EDS 128A,A01,895459,Fargason; Sharon Gayle,44,0,45,1
1746556340693,EDS 128B,A01,895543,Pappas; Elizabeth,44,0,45,1
1746556341721,EDS 139,A00,897203,Pappas; Elizabeth,44,0,45,1
1746556341721,EDS 139,B00,897209,Fargason; Sharon Gayle,41,0,45,4
1746556342746,EDS 201,A00,895545,Staff,22,0,45,23
1746556343771,EDS 203,A01,895581,Halter; Christopher P.,22,0,45,23
1746556344797,EDS 204R,A01,895625,Heinzman; Erica M.,39,0,45,6
1746556344797,EDS 204R,B01,895693,Halter; Christopher P.,10,0,45,35
1746556345821,EDS 206R,A00,895694,Fargason; Sharon Gayle,1,0,30,29
1746556345821,EDS 206R,B00,895695,Choi; Bailey Miyeon,16,0,30,14
1746556346848,EDS 250,A00,895697,Hemans; Patricia Ann Benitez,22,0,45,23
1746556347873,EDS 281,A00,895701,Meyerott; Theresa Ann,1,0,15,14
1746556348898,EDS 284,A00,895736,Meyerott; Theresa Ann,1,0,15,14
1746556349922,EDS 286,A00,897210,Fine; Sarah,0,0,15,15
1746556350947,EDS 289C,A01,895770,Daly; Alan J.,12,0,15,3
1746556351973,EDS 290,A00,897211,Hofstetter; Carolyn,0,0,15,15
1746556352999,LIGM 5A,A00,896162,Fischer-Grunski; Eva K,13,0,20,7
1746556354025,LIGM 5B,A00,896260,Fischer-Grunski; Eva K,17,0,20,3
1746556355048,LIGM 5C,A00,896308,Fischer-Grunski; Eva K,18,0,20,2
1746556356077,LIIT 5AS,A00,896313,Carnelos; Chiara,18,0,20,2
1746556357102,LIIT 5BS,A00,896416,Carnelos; Chiara,20,0,20,0
1746556358131,LIIT 5CS,A00,896564,Carnelos; Chiara,20,0,20,0
1746556359158,LISP 5A,A00,896588,Munoz Sanchez; Alicia,3,0,20,17
1746556360182,LISP 5B,A00,896653,Munoz Sanchez; Alicia,7,0,20,13
1746556361206,LISP 5C,A00,896655,Munoz Sanchez; Alicia,0,1,20,20
1746556362231,MAE 197,001,957918,Kleissl; Jan,9996,0,9999,3
1746556362231,MAE 197,002,959806,Boechler; Nicholas Sebastia,9998,0,9999,1
1746556362231,MAE 197,003,959852,Mullin; Jennifer S,9998,0,9999,1
1746556363255,MATH 2,A01,957937,Staff,33,0,35,2
1746556364282,MATH 197,001,957876,Kedlaya; Kiran S.,9993,0,9999,6
1746556365309,MCWP 40,A00,892729,Duru; Nur,10,0,20,10
1746556365309,MCWP 40,B00,893304,Montejo; Carolina,14,0,20,6
1746556366332,MCWP 40R,A00,893757,Redela; Pamela Morgan,0,5,20,20
1746556367356,MCWP 50,A00,893758,Morshed; Michael James,0,0,20,20
1746556367356,MCWP 50,B00,893761,Bartulis; Jason Michael,17,0,20,3
1746556368380,MCWP 50R,A00,893766,Compas; Sean Matthew,0,1,20,20
1746556368380,MCWP 50R,B00,893769,Carter; Jennifer A,0,1,20,20
1746556368380,MCWP 50R,C00,893771,Krone; Jarret,0,3,20,20
1746556368380,MCWP 50R,D00,893772,Miller; Elizabeth Deen,0,0,20,20
1746556368380,MCWP 50R,E00,893775,Carter; Andrea L,0,1,20,20
1746556369403,MMW 11R,A01,892721,Herbst; Matthew,11,0,27,16
1746556369403,MMW 11R,A02,892722,Herbst; Matthew,0,0,0,3
1746556370432,MMW 12R,A01,892724,Herbst; Matthew,0,11,16,16
1746556370432,MMW 12R,A02,892725,Herbst; Matthew,0,10,16,16
1746556371458,MMW 13R,A01,892727,Staff,0,4,16,16
1746556371458,MMW 13R,A02,892728,Staff,0,4,16,16
1746556371458,MMW 13R,A03,958032,Staff,0,4,16,16
1746556371458,MMW 13R,A04,958033,Staff,0,4,16,16
1746556371458,MMW 13R,A05,958034,Staff,0,4,16,16
1746556372483,SIO 295LS,A00,894015,Staff,5,0,25,20
1746556373508,SIO 295S,A00,894020,Staff,5,0,25,20
1746556374532,SIOC 290S,B01,958918,Merrifield; Mark A,14,0,30,16
1746556375557,SIOC 291S,B01,958922,Gabriel; Corey John,14,0,30,16
1746556376582,SOCI 117,A01,895339,Staff,3,0,5,2
1746556377607,WES 237B,A00,894149,Staff,11,0,20,9
1746556379665,AESE 279B,A00,891859,Staff,13,0,35,22
1746556380689,AIP 197,001,891854,Vespa; Emanuel Ignacio,9999,0,9999,0
1746556381717,ANTH 289S,A00,891856,Gagneux; Pascal,12,0,12,0
1746556382745,BENG 196,001,957946,Engler; Adam J.,9996,0,9999,3
1746556383772,BISP 197,001,959851,Wilhelm; James E.,9998,0,9999,1
1746556384796,CAT 124RS,A01,956906,Staff,6,0,25,19
1746556385819,CAT 125RS,A01,922013,Staff,6,0,25,19
1746556386844,CLRE 250,A00,891860,Morris; Sheldon,9995,0,9999,4
1746556388895,CLRE 251R,A00,907817,Mehta; Ravindra L.,9994,0,9999,5
1746556389922,CLRE 252,A00,891864,Cuomo; Raphael Eduardo,9993,0,9999,6
1746556390949,CLRE 253,A00,891867,Vaida; Florin,9994,0,9999,5
1746556390949,CLRE 253,B00,907819,Staff,9999,0,9999,0
1746556391974,CLRE 259,A00,891868,Patel; Hemal,9998,0,9999,1
1746556392998,CLRE 260,A00,891872,Cuomo; Raphael Eduardo,9999,0,9999,0
1746556394023,CLRE 297,001,891888,Cuomo; Raphael Eduardo,9999,0,9999,0
1746556395054,CSE 191,A00,958773,Minnes Kemp; Mor Mia,9995,0,9999,4
1746556396080,CSE 197,001,959846,Minnes Kemp; Mor Mia,9990,0,9999,9
1746556397110,CSS 201S,A01,892054,Mignozzetti; Umberto,26,0,30,4
1746556398136,CSS 202S,A01,892056,Mignozzetti; Umberto,26,0,30,4
1746556399163,DSC 197,001,956898,Eldridge; Justin Matthew,9997,0,9999,2
1746556400192,DSC 297,001,958000,Mazumdar; Arya,9998,0,9999,1
1746556400192,DSC 297,002,959862,Wang; Yusu,9998,0,9999,1
1746556401219,EAP 100,A00,905686,Staff,9778,0,9999,221
1746556402249,ECE 45,A01,892618,Staff,0,0,65,65
1746556404312,ECE 111,A01,892719,Staff,4,0,65,61
1746556405340,ECE 197,001,957920,Mercier; Patrick Philip,9991,0,9999,8
1746556406365,ECON 178,A01,907814,Zhu; Ying,26,0,35,9
1746556407392,EDS 115,A00,895312,Staff,35,0,45,10
1746556408415,EDS 117,A01,895337,Staff,23,0,30,7
1746556409443,EDS 125,A00,895341,Jones; Gabrielle Anastasia,36,0,45,9
1746556410501,EDS 128A,A01,895459,Fargason; Sharon Gayle,44,0,45,1
1746556411528,EDS 128B,A01,895543,Pappas; Elizabeth,44,0,45,1
1746556412552,EDS 139,A00,897203,Pappas; Elizabeth,44,0,45,1
1746556412552,EDS 139,B00,897209,Fargason; Sharon Gayle,41,0,45,4
1746556413578,EDS 201,A00,895545,Staff,22,0,45,23
1746556414607,EDS 203,A01,895581,Halter; Christopher P.,22,0,45,23
1746556415634,EDS 204R,A01,895625,Heinzman; Erica M.,39,0,45,6
1746556415634,EDS 204R,B01,895693,Halter; Christopher P.,10,0,45,35
1746556416659,EDS 206R,A00,895694,Fargason; Sharon Gayle,1,0,30,29
1746556416659,EDS 206R,B00,895695,Choi; Bailey Miyeon,16,0,30,14
1746556417693,EDS 250,A00,895697,Hemans; Patricia Ann Benitez,22,0,45,23
1746556418716,EDS 281,A00,895701,Meyerott; Theresa Ann,1,0,15,14
1746556419741,EDS 284,A00,895736,Meyerott; Theresa Ann,1,0,15,14
1746556420765,EDS 286,A00,897210,Fine; Sarah,0,0,15,15
1746556421790,EDS 289C,A01,895770,Daly; Alan J.,10,0,15,5
1746556422814,EDS 290,A00,897211,Hofstetter; Carolyn,0,0,15,15
1746556423843,LIGM 5A,A00,896162,Fischer-Grunski; Eva K,13,0,20,7
1746556424870,LIGM 5B,A00,896260,Fischer-Grunski; Eva K,17,0,20,3
1746556425895,LIGM 5C,A00,896308,Fischer-Grunski; Eva K,18,0,20,2
1746556426921,LIIT 5AS,A00,896313,Carnelos; Chiara,18,0,20,2
1746556427945,LIIT 5BS,A00,896416,Carnelos; Chiara,20,0,20,0
1746556428974,LIIT 5CS,A00,896564,Carnelos; Chiara,20,0,20,0
1746556430019,LISP 5A,A00,896588,Munoz Sanchez; Alicia,3,0,20,17
1746556431046,LISP 5B,A00,896653,Munoz Sanchez; Alicia,7,0,20,13
1746556432075,LISP 5C,A00,896655,Munoz Sanchez; Alicia,0,1,20,20
1746556433099,MAE 197,001,957918,Kleissl; Jan,9996,0,9999,3
1746556433099,MAE 197,002,959806,Boechler; Nicholas Sebastia,9998,0,9999,1
1746556433099,MAE 197,003,959852,Mullin; Jennifer S,9998,0,9999,1
1746556434124,MATH 2,A01,957937,Staff,33,0,35,2
1746556435149,MATH 197,001,957876,Kedlaya; Kiran S.,9993,0,9999,6
1746556436173,MCWP 40,A00,892729,Duru; Nur,10,0,20,10
1746556436173,MCWP 40,B00,893304,Montejo; Carolina,14,0,20,6
1746556437201,MCWP 40R,A00,893757,Redela; Pamela Morgan,0,5,20,20
1746556438228,MCWP 50,A00,893758,Morshed; Michael James,0,0,20,20
1746556438228,MCWP 50,B00,893761,Bartulis; Jason Michael,17,0,20,3
1746556439256,MCWP 50R,A00,893766,Compas; Sean Matthew,0,1,20,20
1746556439256,MCWP 50R,B00,893769,Carter; Jennifer A,0,1,20,20
1746556439256,MCWP 50R,C00,893771,Krone; Jarret,0,3,20,20
1746556439256,MCWP 50R,D00,893772,Miller; Elizabeth Deen,0,0,20,20
1746556439256,MCWP 50R,E00,893775,Carter; Andrea L,0,1,20,20
1746556440281,MMW 11R,A01,892721,Herbst; Matthew,11,0,27,16
1746556440281,MMW 11R,A02,892722,Herbst; Matthew,0,0,0,3
1746556441306,MMW 12R,A01,892724,Herbst; Matthew,0,11,16,16
1746556441306,MMW 12R,A02,892725,Herbst; Matthew,0,10,16,16
1746556442331,MMW 13R,A01,892727,Staff,0,4,16,16
1746556442331,MMW 13R,A02,892728,Staff,0,4,16,16
1746556442331,MMW 13R,A03,958032,Staff,0,4,16,16
1746556442331,MMW 13R,A04,958033,Staff,0,4,16,16
1746556442331,MMW 13R,A05,958034,Staff,0,4,16,16
1746556443356,SIO 295LS,A00,894015,Staff,5,0,25,20
1746556444380,SIO 295S,A00,894020,Staff,5,0,25,20
1746556445411,SIOC 290S,B01,958918,Merrifield; Mark A,14,0,30,16
1746556446439,SIOC 291S,B01,958922,Gabriel; Corey John,14,0,30,16
1746556447463,SOCI 117,A01,895339,Staff,3,0,5,2
1746556448491,WES 237B,A00,894149,Staff,11,0,20,9
1746556450558,AESE 279B,A00,891859,Staff,13,0,35,22
1746556451583,AIP 197,001,891854,Vespa; Emanuel Ignacio,9999,0,9999,0
1746556452611,ANTH 289S,A00,891856,Gagneux; Pascal,12,0,12,0
1746556453641,BENG 196,001,957946,Engler; Adam J.,9996,0,9999,3
1746556454670,BISP 197,001,959851,Wilhelm; James E.,9998,0,9999,1
1746556455695,CAT 124RS,A01,956906,Staff,6,0,25,19
1746556456721,CAT 125RS,A01,922013,Staff,6,0,25,19
1746556457747,CLRE 250,A00,891860,Morris; Sheldon,9995,0,9999,4
1746556459803,CLRE 251R,A00,907817,Mehta; Ravindra L.,9994,0,9999,5
1746556460827,CLRE 252,A00,891864,Cuomo; Raphael Eduardo,9993,0,9999,6
1746556461855,CLRE 253,A00,891867,Vaida; Florin,9994,0,9999,5
1746556461855,CLRE 253,B00,907819,Staff,9999,0,9999,0
1746556462883,CLRE 259,A00,891868,Patel; Hemal,9998,0,9999,1
1746556463911,CLRE 260,A00,891872,Cuomo; Raphael Eduardo,9999,0,9999,0
1746556464939,CLRE 297,001,891888,Cuomo; Raphael Eduardo,9999,0,9999,0
1746556465964,CSE 191,A00,958773,Minnes Kemp; Mor Mia,9995,0,9999,4
1746556466993,CSE 197,001,959846,Minnes Kemp; Mor Mia,9990,0,9999,9
1746556468021,CSS 201S,A01,892054,Mignozzetti; Umberto,26,0,30,4
1746556469047,CSS 202S,A01,892056,Mignozzetti; Umberto,26,0,30,4
1746556470077,DSC 197,001,956898,Eldridge; Justin Matthew,9997,0,9999,2
1746556471103,DSC 297,001,958000,Mazumdar; Arya,9998,0,9999,1
1746556471103,DSC 297,002,959862,Wang; Yusu,9998,0,9999,1
1746556472128,EAP 100,A00,905686,Staff,9778,0,9999,221
1746556473154,ECE 45,A01,892618,Staff,0,0,65,65
1746556475209,ECE 111,A01,892719,Staff,4,0,65,61
1746556476234,ECE 197,001,957920,Mercier; Patrick Philip,9991,0,9999,8
1746556477257,ECON 178,A01,907814,Zhu; Ying,26,0,35,9
1746556478284,EDS 115,A00,895312,Staff,35,0,45,10
1746556479309,EDS 117,A01,895337,Staff,23,0,30,7
1746556480334,EDS 125,A00,895341,Jones; Gabrielle Anastasia,36,0,45,9
1746556481358,EDS 128A,A01,895459,Fargason; Sharon Gayle,44,0,45,1
1746556482385,EDS 128B,A01,895543,Pappas; Elizabeth,44,0,45,1
1746556483413,EDS 139,A00,897203,Pappas; Elizabeth,44,0,45,1
1746556483413,EDS 139,B00,897209,Fargason; Sharon Gayle,41,0,45,4
1746556484439,EDS 201,A00,895545,Staff,22,0,45,23
1746556485464,EDS 203,A01,895581,Halter; Christopher P.,22,0,45,23
1746556486495,EDS 204R,A01,895625,Heinzman; Erica M.,39,0,45,6
1746556486495,EDS 204R,B01,895693,Halter; Christopher P.,10,0,45,35
1746556487520,EDS 206R,A00,895694,Fargason; Sharon Gayle,1,0,30,29
1746556487520,EDS 206R,B00,895695,Choi; Bailey Miyeon,16,0,30,14
1746556488545,EDS 250,A00,895697,Hemans; Patricia Ann Benitez,22,0,45,23
1746556489771,EDS 281,A00,895701,Meyerott; Theresa Ann,1,0,15,14
1746556490797,EDS 284,A00,895736,Meyerott; Theresa Ann,1,0,15,14
1746556491825,EDS 286,A00,897210,Fine; Sarah,0,0,15,15
1746556492851,EDS 289C,A01,895770,Daly; Alan J.,7,0,15,8
1746556493878,EDS 290,A00,897211,Hofstetter; Carolyn,0,0,15,15
1746556494903,LIGM 5A,A00,896162,Fischer-Grunski; Eva K,13,0,20,7
1746556495927,LIGM 5B,A00,896260,Fischer-Grunski; Eva K,17,0,20,3
1746556496953,LIGM 5C,A00,896308,Fischer-Grunski; Eva K,18,0,20,2
1746556497978,LIIT 5AS,A00,896313,Carnelos; Chiara,18,0,20,2
1746556499006,LIIT 5BS,A00,896416,Carnelos; Chiara,20,0,20,0
1746556500031,LIIT 5CS,A00,896564,Carnelos; Chiara,20,0,20,0
1746556501060,LISP 5A,A00,896588,Munoz Sanchez; Alicia,3,0,20,17
1746556502092,LISP 5B,A00,896653,Munoz Sanchez; Alicia,7,0,20,13
1746556503118,LISP 5C,A00,896655,Munoz Sanchez; Alicia,0,1,20,20
1746556504145,MAE 197,001,957918,Kleissl; Jan,9996,0,9999,3
1746556504145,MAE 197,002,959806,Boechler; Nicholas Sebastia,9998,0,9999,1
1746556504145,MAE 197,003,959852,Mullin; Jennifer S,9998,0,9999,1
1746556505172,MATH 2,A01,957937,Staff,33,0,35,2
1746556506200,MATH 197,001,957876,Kedlaya; Kiran S.,9993,0,9999,6
1746556507230,MCWP 40,A00,892729,Duru; Nur,10,0,20,10
1746556507230,MCWP 40,B00,893304,Montejo; Carolina,14,0,20,6
1746556508258,MCWP 40R,A00,893757,Redela; Pamela Morgan,0,5,20,20
1746556509283,MCWP 50,A00,893758,Morshed; Michael James,0,0,20,20
1746556509283,MCWP 50,B00,893761,Bartulis; Jason Michael,17,0,20,3
1746556510308,MCWP 50R,A00,893766,Compas; Sean Matthew,0,1,20,20
1746556510308,MCWP 50R,B00,893769,Carter; Jennifer A,0,1,20,20
1746556510308,MCWP 50R,C00,893771,Krone; Jarret,0,3,20,20
1746556510308,MCWP 50R,D00,893772,Miller; Elizabeth Deen,0,0,20,20
1746556510308,MCWP 50R,E00,893775,Carter; Andrea L,0,1,20,20
1746556511332,MMW 11R,A01,892721,Herbst; Matthew,11,0,27,16
1746556511332,MMW 11R,A02,892722,Herbst; Matthew,0,0,0,3
1746556512357,MMW 12R,A01,892724,Herbst; Matthew,0,11,16,16
1746556512357,MMW 12R,A02,892725,Herbst; Matthew,0,10,16,16
1746556513382,MMW 13R,A01,892727,Staff,0,4,16,16
1746556513382,MMW 13R,A02,892728,Staff,0,4,16,16
1746556513382,MMW 13R,A03,958032,Staff,0,4,16,16
1746556513382,MMW 13R,A04,958033,Staff,0,4,16,16
1746556513382,MMW 13R,A05,958034,Staff,0,4,16,16
1746556514408,SIO 295LS,A00,894015,Staff,5,0,25,20
1746556515436,SIO 295S,A00,894020,Staff,5,0,25,20
1746556516462,SIOC 290S,B01,958918,Merrifield; Mark A,14,0,30,16
1746556517493,SIOC 291S,B01,958922,Gabriel; Corey John,14,0,30,16
1746556518521,SOCI 117,A01,895339,Staff,3,0,5,2
1746556519546,WES 237B,A00,894149,Staff,11,0,20,9
1746556521610,AESE 279B,A00,891859,Staff,13,0,35,22
1746556522636,AIP 197,001,891854,Vespa; Emanuel Ignacio,9999,0,9999,0
1746556523663,ANTH 289S,A00,891856,Gagneux; Pascal,12,0,12,0
1746556524692,BENG 196,001,957946,Engler; Adam J.,9996,0,9999,3
1746556525720,BISP 197,001,959851,Wilhelm; James E.,9998,0,9999,1
1746556526747,CAT 124RS,A01,956906,Staff,6,0,25,19
1746556527773,CAT 125RS,A01,922013,Staff,6,0,25,19
1746556528798,CLRE 250,A00,891860,Morris; Sheldon,9995,0,9999,4
1746556530851,CLRE 251R,A00,907817,Mehta; Ravindra L.,9994,0,9999,5
1746556531877,CLRE 252,A00,891864,Cuomo; Raphael Eduardo,9993,0,9999,6
1746556532902,CLRE 253,A00,891867,Vaida; Florin,9994,0,9999,5
1746556532902,CLRE 253,B00,907819,Staff,9999,0,9999,0
1746556533925,CLRE 259,A00,891868,Patel; Hemal,9998,0,9999,1
1746556534950,CLRE 260,A00,891872,Cuomo; Raphael Eduardo,9999,0,9999,0
1746556535978,CLRE 297,001,891888,Cuomo; Raphael Eduardo,9999,0,9999,0
1746556537006,CSE 191,A00,958773,Minnes Kemp; Mor Mia,9995,0,9999,4
1746556538033,CSE 197,001,959846,Minnes Kemp; Mor Mia,9990,0,9999,9
1746556539058,CSS 201S,A01,892054,Mignozzetti; Umberto,26,0,30,4
1746556540084,CSS 202S,A01,892056,Mignozzetti; Umberto,26,0,30,4
1746556541111,DSC 197,001,956898,Eldridge; Justin Matthew,9997,0,9999,2
1746556542135,DSC 297,001,958000,Mazumdar; Arya,9998,0,9999,1
1746556542135,DSC 297,002,959862,Wang; Yusu,9998,0,9999,1
1746556543163,EAP 100,A00,905686,Staff,9778,0,9999,221
1746556544197,ECE 45,A01,892618,Staff,0,0,65,65
1746556546248,ECE 111,A01,892719,Staff,4,0,65,61
1746556547276,ECE 197,001,957920,Mercier; Patrick Philip,9991,0,9999,8
1746556548301,ECON 178,A01,907814,Zhu; Ying,26,0,35,9
1746556549328,EDS 115,A00,895312,Staff,35,0,45,10
1746556550353,EDS 117,A01,895337,Staff,23,0,30,7
1746556551381,EDS 125,A00,895341,Jones; Gabrielle Anastasia,36,0,45,9
1746556552409,EDS 128A,A01,895459,Fargason; Sharon Gayle,44,0,45,1
1746556553433,EDS 128B,A01,895543,Pappas; Elizabeth,44,0,45,1
1746556554457,EDS 139,A00,897203,Pappas; Elizabeth,44,0,45,1
1746556554457,EDS 139,B00,897209,Fargason; Sharon Gayle,41,0,45,4
1746556555482,EDS 201,A00,895545,Staff,22,0,45,23
1746556556506,EDS 203,A01,895581,Halter; Christopher P.,22,0,45,23
1746556557532,EDS 204R,A01,895625,Heinzman; Erica M.,39,0,45,6
1746556557532,EDS 204R,B01,895693,Halter; Christopher P.,10,0,45,35
1746556558556,EDS 206R,A00,895694,Fargason; Sharon Gayle,1,0,30,29
1746556558556,EDS 206R,B00,895695,Choi; Bailey Miyeon,16,0,30,14
1746556559585,EDS 250,A00,895697,Hemans; Patricia Ann Benitez,22,0,45,23
1746556560608,EDS 281,A00,895701,Meyerott; Theresa Ann,1,0,15,14
1746556561634,EDS 284,A00,895736,Meyerott; Theresa Ann,1,0,15,14
1746556562661,EDS 286,A00,897210,Fine; Sarah,0,0,15,15
1746556563688,EDS 289C,A01,895770,Daly; Alan J.,5,0,15,10
1746556564712,EDS 290,A00,897211,Hofstetter; Carolyn,0,0,15,15
1746556565799,LIGM 5A,A00,896162,Fischer-Grunski; Eva K,13,0,20,7
1746556566828,LIGM 5B,A00,896260,Fischer-Grunski; Eva K,17,0,20,3
1746556567852,LIGM 5C,A00,896308,Fischer-Grunski; Eva K,18,0,20,2
1746556568878,LIIT 5AS,A00,896313,Carnelos; Chiara,18,0,20,2
1746556569906,LIIT 5BS,A00,896416,Carnelos; Chiara,20,0,20,0
1746556570931,LIIT 5CS,A00,896564,Carnelos; Chiara,20,0,20,0
1746556571963,LISP 5A,A00,896588,Munoz Sanchez; Alicia,3,0,20,17
1746556572992,LISP 5B,A00,896653,Munoz Sanchez; Alicia,7,0,20,13
1746556574016,LISP 5C,A00,896655,Munoz Sanchez; Alicia,0,1,20,20
1746556575043,MAE 197,001,957918,Kleissl; Jan,9996,0,9999,3
1746556575043,MAE 197,002,959806,Boechler; Nicholas Sebastia,9998,0,9999,1
1746556575043,MAE 197,003,959852,Mullin; Jennifer S,9998,0,9999,1
1746556576069,MATH 2,A01,957937,Staff,33,0,35,2
1746556577096,MATH 197,001,957876,Kedlaya; Kiran S.,9993,0,9999,6
1746556578124,MCWP 40,A00,892729,Duru; Nur,10,0,20,10
1746556578124,MCWP 40,B00,893304,Montejo; Carolina,14,0,20,6
1746556579149,MCWP 40R,A00,893757,Redela; Pamela Morgan,0,5,20,20
1746556580175,MCWP 50,A00,893758,Morshed; Michael James,0,0,20,20
1746556580175,MCWP 50,B00,893761,Bartulis; Jason Michael,17,0,20,3
1746556581199,MCWP 50R,A00,893766,Compas; Sean Matthew,0,1,20,20
1746556581199,MCWP 50R,B00,893769,Carter; Jennifer A,0,1,20,20
1746556581199,MCWP 50R,C00,893771,Krone; Jarret,0,3,20,20
1746556581199,MCWP 50R,D00,893772,Miller; Elizabeth Deen,0,0,20,20
1746556581199,MCWP 50R,E00,893775,Carter; Andrea L,0,1,20,20
1746556582229,MMW 11R,A01,892721,Herbst; Matthew,11,0,27,16
1746556582229,MMW 11R,A02,892722,Herbst; Matthew,0,0,0,3
1746556583254,MMW 12R,A01,892724,Herbst; Matthew,0,11,16,16
1746556583254,MMW 12R,A02,892725,Herbst; Matthew,0,10,16,16
1746556584282,MMW 13R,A01,892727,Staff,0,4,16,16
1746556584282,MMW 13R,A02,892728,Staff,0,4,16,16
1746556584282,MMW 13R,A03,958032,Staff,0,4,16,16
1746556584282,MMW 13R,A04,958033,Staff,0,4,16,16
1746556584282,MMW 13R,A05,958034,Staff,0,4,16,16
1746556585310,SIO 295LS,A00,894015,Staff,5,0,25,20
1746556586338,SIO 295S,A00,894020,Staff,5,0,25,20
1746556587365,SIOC 290S,B01,958918,Merrifield; Mark A,14,0,30,16
1746556588388,SIOC 291S,B01,958922,Gabriel; Corey John,14,0,30,16
1746556589415,SOCI 117,A01,895339,Staff,3,0,5,2
1746556590442,WES 237B,A00,894149,Staff,11,0,20,9
1746556592493,AESE 279B,A00,891859,Staff,13,0,35,22
1746556593521,AIP 197,001,891854,Vespa; Emanuel Ignacio,9999,0,9999,0
1746556594547,ANTH 289S,A00,891856,Gagneux; Pascal,12,0,12,0
1746556595571,BENG 196,001,957946,Engler; Adam J.,9996,0,9999,3
1746556596596,BISP 197,001,959851,Wilhelm; James E.,9998,0,9999,1
1746556597621,CAT 124RS,A01,956906,Staff,6,0,25,19
1746556598647,CAT 125RS,A01,922013,Staff,6,0,25,19
1746556599675,CLRE 250,A00,891860,Morris; Sheldon,9995,0,9999,4
1746556601724,CLRE 251R,A00,907817,Mehta; Ravindra L.,9994,0,9999,5
1746556602751,CLRE 252,A00,891864,Cuomo; Raphael Eduardo,9993,0,9999,6
1746556603780,CLRE 253,A00,891867,Vaida; Florin,9994,0,9999,5
1746556603780,CLRE 253,B00,907819,Staff,9999,0,9999,0
1746556604835,CLRE 259,A00,891868,Patel; Hemal,9998,0,9999,1
1746556605863,CLRE 260,A00,891872,Cuomo; Raphael Eduardo,9999,0,9999,0
1746556606891,CLRE 297,001,891888,Cuomo; Raphael Eduardo,9999,0,9999,0
1746556607915,CSE 191,A00,958773,Minnes Kemp; Mor Mia,9995,0,9999,4
1746556608940,CSE 197,001,959846,Minnes Kemp; Mor Mia,9990,0,9999,9
1746556609980,CSS 201S,A01,892054,Mignozzetti; Umberto,26,0,30,4
1746556611008,CSS 202S,A01,892056,Mignozzetti; Umberto,26,0,30,4
1746556612039,DSC 197,001,956898,Eldridge; Justin Matthew,9997,0,9999,2
1746556613066,DSC 297,001,958000,Mazumdar; Arya,9998,0,9999,1
1746556613066,DSC 297,002,959862,Wang; Yusu,9998,0,9999,1
1746556614089,EAP 100,A00,905686,Staff,9778,0,9999,221
1746556615117,ECE 45,A01,892618,Staff,0,0,65,65
1746556617169,ECE 111,A01,892719,Staff,4,0,65,61
1746556618194,ECE 197,001,957920,Mercier; Patrick Philip,9991,0,9999,8
1746556619218,ECON 178,A01,907814,Zhu; Ying,26,0,35,9
1746556620247,EDS 115,A00,895312,Staff,35,0,45,10
1746556621274,EDS 117,A01,895337,Staff,23,0,30,7
1746556622300,EDS 125,A00,895341,Jones; Gabrielle Anastasia,36,0,45,9
1746556623325,EDS 128A,A01,895459,Fargason; Sharon Gayle,44,0,45,1
1746556624352,EDS 128B,A01,895543,Pappas; Elizabeth,44,0,45,1
1746556625377,EDS 139,A00,897203,Pappas; Elizabeth,44,0,45,1
1746556625377,EDS 139,B00,897209,Fargason; Sharon Gayle,41,0,45,4
1746556626404,EDS 201,A00,895545,Staff,22,0,45,23
1746556627429,EDS 203,A01,895581,Halter; Christopher P.,22,0,45,23
1746556628454,EDS 204R,A01,895625,Heinzman; Erica M.,39,0,45,6
1746556628454,EDS 204R,B01,895693,Halter; Christopher P.,10,0,45,35
1746556629479,EDS 206R,A00,895694,Fargason; Sharon Gayle,1,0,30,29
1746556629479,EDS 206R,B00,895695,Choi; Bailey Miyeon,16,0,30,14
1746556630505,EDS 250,A00,895697,Hemans; Patricia Ann Benitez,22,0,45,23
1746556631531,EDS 281,A00,895701,Meyerott; Theresa Ann,1,0,15,14
1746556632559,EDS 284,A00,895736,Meyerott; Theresa Ann,1,0,15,14
1746556633586,EDS 286,A00,897210,Fine; Sarah,0,0,15,15
1746556634613,EDS 289C,A01,895770,Daly; Alan J.,3,0,15,12
1746556635636,EDS 290,A00,897211,Hofstetter; Carolyn,0,0,15,15
1746556636667,LIGM 5A,A00,896162,Fischer-Grunski; Eva K,13,0,20,7
1746556637693,LIGM 5B,A00,896260,Fischer-Grunski; Eva K,17,0,20,3
1746556638719,LIGM 5C,A00,896308,Fischer-Grunski; Eva K,18,0,20,2
1746556639746,LIIT 5AS,A00,896313,Carnelos; Chiara,18,0,20,2
1746556640770,LIIT 5BS,A00,896416,Carnelos; Chiara,20,0,20,0
1746556641797,LIIT 5CS,A00,896564,Carnelos; Chiara,20,0,20,0
1746556642821,LISP 5A,A00,896588,Munoz Sanchez; Alicia,3,0,20,17
1746556644050,LISP 5B,A00,896653,Munoz Sanchez; Alicia,7,0,20,13
1746556645075,LISP 5C,A00,896655,Munoz Sanchez; Alicia,0,1,20,20
1746556646101,MAE 197,001,957918,Kleissl; Jan,9996,0,9999,3
1746556646101,MAE 197,002,959806,Boechler; Nicholas Sebastia,9998,0,9999,1
1746556646101,MAE 197,003,959852,Mullin; Jennifer S,9998,0,9999,1
1746556647125,MATH 2,A01,957937,Staff,33,0,35,2
1746556648151,MATH 197,001,957876,Kedlaya; Kiran S.,9993,0,9999,6
1746556649175,MCWP 40,A00,892729,Duru; Nur,10,0,20,10
1746556649175,MCWP 40,B00,893304,Montejo; Carolina,14,0,20,6
1746556650200,MCWP 40R,A00,893757,Redela; Pamela Morgan,0,5,20,20
1746556651228,MCWP 50,A00,893758,Morshed; Michael James,0,0,20,20
1746556651228,MCWP 50,B00,893761,Bartulis; Jason Michael,17,0,20,3
1746556652253,MCWP 50R,A00,893766,Compas; Sean Matthew,0,1,20,20
1746556652253,MCWP 50R,B00,893769,Carter; Jennifer A,0,1,20,20
1746556652253,MCWP 50R,C00,893771,Krone; Jarret,0,3,20,20
1746556652253,MCWP 50R,D00,893772,Miller; Elizabeth Deen,0,0,20,20
1746556652253,MCWP 50R,E00,893775,Carter; Andrea L,0,1,20,20
1746556653277,MMW 11R,A01,892721,Herbst; Matthew,11,0,27,16
1746556653277,MMW 11R,A02,892722,Herbst; Matthew,0,0,0,3
1746556654304,MMW 12R,A01,892724,Herbst; Matthew,0,11,16,16
1746556654304,MMW 12R,A02,892725,Herbst; Matthew,0,10,16,16
1746556655329,MMW 13R,A01,892727,Staff,0,4,16,16
1746556655329,MMW 13R,A02,892728,Staff,0,4,16,16
1746556655329,MMW 13R,A03,958032,Staff,0,4,16,16
1746556655329,MMW 13R,A04,958033,Staff,0,4,16,16
1746556655329,MMW 13R,A05,958034,Staff,0,4,16,16
1746556656355,SIO 295LS,A00,894015,Staff,5,0,25,20
1746556657379,SIO 295S,A00,894020,Staff,5,0,25,20
1746556658404,SIOC 290S,B01,958918,Merrifield; Mark A,14,0,30,16
1746556659432,SIOC 291S,B01,958922,Gabriel; Corey John,14,0,30,16
1746556660457,SOCI 117,A01,895339,Staff,3,0,5,2
1746556661482,WES 237B,A00,894149,Staff,11,0,20,9
1746556663546,AESE 279B,A00,891859,Staff,13,0,35,22
1746556664573,AIP 197,001,891854,Vespa; Emanuel Ignacio,9999,0,9999,0
1746556665601,ANTH 289S,A00,891856,Gagneux; Pascal,12,0,12,0
1746556666628,BENG 196,001,957946,Engler; Adam J.,9996,0,9999,3
1746556667653,BISP 197,001,959851,Wilhelm; James E.,9998,0,9999,1
1746556668679,CAT 124RS,A01,956906,Staff,6,0,25,19
1746556669763,CAT 125RS,A01,922013,Staff,6,0,25,19
1746556670787,CLRE 250,A00,891860,Morris; Sheldon,9995,0,9999,4
1746556672839,CLRE 251R,A00,907817,Mehta; Ravindra L.,9994,0,9999,5
1746556673865,CLRE 252,A00,891864,Cuomo; Raphael Eduardo,9993,0,9999,6
1746556674892,CLRE 253,A00,891867,Vaida; Florin,9994,0,9999,5
1746556674892,CLRE 253,B00,907819,Staff,9999,0,9999,0
1746556675919,CLRE 259,A00,891868,Patel; Hemal,9998,0,9999,1
1746556676946,CLRE 260,A00,891872,Cuomo; Raphael Eduardo,9999,0,9999,0
1746556677971,CLRE 297,001,891888,Cuomo; Raphael Eduardo,9999,0,9999,0
1746556678997,CSE 191,A00,958773,Minnes Kemp; Mor Mia,9995,0,9999,4
1746556680023,CSE 197,001,959846,Minnes Kemp; Mor Mia,9990,0,9999,9
1746556681052,CSS 201S,A01,892054,Mignozzetti; Umberto,26,0,30,4
1746556682079,CSS 202S,A01,892056,Mignozzetti; Umberto,26,0,30,4
1746556683105,DSC 197,001,956898,Eldridge; Justin Matthew,9997,0,9999,2
1746556684133,DSC 297,001,958000,Mazumdar; Arya,9998,0,9999,1
1746556684133,DSC 297,002,959862,Wang; Yusu,9998,0,9999,1
1746556685158,EAP 100,A00,905686,Staff,9778,0,9999,221
1746556686184,ECE 45,A01,892618,Staff,0,0,65,65
1746556688236,ECE 111,A01,892719,Staff,4,0,65,61
1746556689261,ECE 197,001,957920,Mercier; Patrick Philip,9991,0,9999,8
1746556690291,ECON 178,A01,907814,Zhu; Ying,26,0,35,9
1746556691316,EDS 115,A00,895312,Staff,35,0,45,10
1746556692342,EDS 117,A01,895337,Staff,23,0,30,7
1746556693368,EDS 125,A00,895341,Jones; Gabrielle Anastasia,36,0,45,9
1746556694394,EDS 128A,A01,895459,Fargason; Sharon Gayle,44,0,45,1
1746556695418,EDS 128B,A01,895543,Pappas; Elizabeth,44,0,45,1
1746556696444,EDS 139,A00,897203,Pappas; Elizabeth,44,0,45,1
1746556696444,EDS 139,B00,897209,Fargason; Sharon Gayle,41,0,45,4
1746556697473,EDS 201,A00,895545,Staff,22,0,45,23
1746556698498,EDS 203,A01,895581,Halter; Christopher P.,22,0,45,23
1746556699523,EDS 204R,A01,895625,Heinzman; Erica M.,39,0,45,6
1746556699523,EDS 204R,B01,895693,Halter; Christopher P.,10,0,45,35
1746556700548,EDS 206R,A00,895694,Fargason; Sharon Gayle,1,0,30,29
1746556700548,EDS 206R,B00,895695,Choi; Bailey Miyeon,16,0,30,14
1746556701577,EDS 250,A00,895697,Hemans; Patricia Ann Benitez,22,0,45,23
1746556702601,EDS 281,A00,895701,Meyerott; Theresa Ann,1,0,15,14
1746556703626,EDS 284,A00,895736,Meyerott; Theresa Ann,1,0,15,14
1746556704650,EDS 286,A00,897210,Fine; Sarah,0,0,15,15
1746556705674,EDS 289C,A01,895770,Daly; Alan J.,1,0,15,14
1746556706700,EDS 290,A00,897211,Hofstetter; Carolyn,0,0,15,15
1746556707730,LIGM 5A,A00,896162,Fischer-Grunski; Eva K,13,0,20,7
1746556708758,LIGM 5B,A00,896260,Fischer-Grunski; Eva K,17,0,20,3
1746556709783,LIGM 5C,A00,896308,Fischer-Grunski; Eva K,18,0,20,2
1746556710807,LIIT 5AS,A00,896313,Carnelos; Chiara,18,0,20,2
1746556711832,LIIT 5BS,A00,896416,Carnelos; Chiara,20,0,20,0
1746556712860,LIIT 5CS,A00,896564,Carnelos; Chiara,20,0,20,0
1746556713884,LISP 5A,A00,896588,Munoz Sanchez; Alicia,3,0,20,17
1746556714910,LISP 5B,A00,896653,Munoz Sanchez; Alicia,7,0,20,13
1746556715935,LISP 5C,A00,896655,Munoz Sanchez; Alicia,0,1,20,20
1746556716961,MAE 197,001,957918,Kleissl; Jan,9996,0,9999,3
1746556716961,MAE 197,002,959806,Boechler; Nicholas Sebastia,9998,0,9999,1
1746556716961,MAE 197,003,959852,Mullin; Jennifer S,9998,0,9999,1
1746556717988,MATH 2,A01,957937,Staff,33,0,35,2
1746556719014,MATH 197,001,957876,Kedlaya; Kiran S.,9993,0,9999,6
1746556720045,MCWP 40,A00,892729,Duru; Nur,10,0,20,10
1746556720045,MCWP 40,B00,893304,Montejo; Carolina,14,0,20,6
1746556721072,MCWP 40R,A00,893757,Redela; Pamela Morgan,0,5,20,20
1746556722098,MCWP 50,A00,893758,Morshed; Michael James,0,0,20,20
1746556722098,MCWP 50,B00,893761,Bartulis; Jason Michael,17,0,20,3
1746556723124,MCWP 50R,A00,893766,Compas; Sean Matthew,0,1,20,20
1746556723124,MCWP 50R,B00,893769,Carter; Jennifer A,0,1,20,20
1746556723124,MCWP 50R,C00,893771,Krone; Jarret,0,3,20,20
1746556723124,MCWP 50R,D00,893772,Miller; Elizabeth Deen,0,0,20,20
1746556723124,MCWP 50R,E00,893775,Carter; Andrea L,0,1,20,20
1746556724150,MMW 11R,A01,892721,Herbst; Matthew,11,0,27,16
1746556724150,MMW 11R,A02,892722,Herbst; Matthew,0,0,0,3
1746556725180,MMW 12R,A01,892724,Herbst; Matthew,0,11,16,16
1746556725180,MMW 12R,A02,892725,Herbst; Matthew,0,10,16,16
1746556726207,MMW 13R,A01,892727,Staff,0,4,16,16
1746556726207,MMW 13R,A02,892728,Staff,0,4,16,16
1746556726207,MMW 13R,A03,958032,Staff,0,4,16,16
1746556726207,MMW 13R,A04,958033,Staff,0,4,16,16
1746556726207,MMW 13R,A05,958034,Staff,0,4,16,16
1746556727235,SIO 295LS,A00,894015,Staff,5,0,25,20
1746556728259,SIO 295S,A00,894020,Staff,5,0,25,20
1746556729290,SIOC 290S,B01,958918,Merrifield; Mark A,14,0,30,16
1746556730316,SIOC 291S,B01,958922,Gabriel; Corey John,14,0,30,16
1746556731340,SOCI 117,A01,895339,Staff,3,0,5,2
1746556732366,WES 237B,A00,894149,Staff,11,0,20,9
1746556734418,AESE 279B,A00,891859,Staff,13,0,35,22
1746556735444,AIP 197,001,891854,Vespa; Emanuel Ignacio,9999,0,9999,0
1746556736472,ANTH 289S,A00,891856,Gagneux; Pascal,12,0,12,0
1746556737499,BENG 196,001,957946,Engler; Adam J.,9996,0,9999,3
1746556738526,BISP 197,001,959851,Wilhelm; James E.,9998,0,9999,1
1746556739552,CAT 124RS,A01,956906,Staff,6,0,25,19
1746556740581,CAT 125RS,A01,922013,Staff,6,0,25,19
1746556741606,CLRE 250,A00,891860,Morris; Sheldon,9995,0,9999,4
1746556743660,CLRE 251R,A00,907817,Mehta; Ravindra L.,9994,0,9999,5
1746556744684,CLRE 252,A00,891864,Cuomo; Raphael Eduardo,9993,0,9999,6
1746556745709,CLRE 253,A00,891867,Vaida; Florin,9994,0,9999,5
1746556745709,CLRE 253,B00,907819,Staff,9999,0,9999,0
1746556746733,CLRE 259,A00,891868,Patel; Hemal,9998,0,9999,1
1746556747761,CLRE 260,A00,891872,Cuomo; Raphael Eduardo,9999,0,9999,0
1746556748787,CLRE 297,001,891888,Cuomo; Raphael Eduardo,9999,0,9999,0
1746556749815,CSE 191,A00,958773,Minnes Kemp; Mor Mia,9995,0,9999,4
1746556750842,CSE 197,001,959846,Minnes Kemp; Mor Mia,9990,0,9999,9
1746556751870,CSS 201S,A01,892054,Mignozzetti; Umberto,26,0,30,4
1746556752895,CSS 202S,A01,892056,Mignozzetti; Umberto,26,0,30,4
1746556753921,DSC 197,001,956898,Eldridge; Justin Matthew,9997,0,9999,2
1746556754947,DSC 297,001,958000,Mazumdar; Arya,9998,0,9999,1
1746556754947,DSC 297,002,959862,Wang; Yusu,9998,0,9999,1
1746556755973,EAP 100,A00,905686,Staff,9778,0,9999,221
1746556757003,ECE 45,A01,892618,Staff,0,0,65,65
1746556759059,ECE 111,A01,892719,Staff,4,0,65,61
1746556760087,ECE 197,001,957920,Mercier; Patrick Philip,9991,0,9999,8
1746556761111,ECON 178,A01,907814,Zhu; Ying,26,0,35,9
1746556762136,EDS 115,A00,895312,Staff,35,0,45,10
1746556763164,EDS 117,A01,895337,Staff,23,0,30,7
1746556764191,EDS 125,A00,895341,Jones; Gabrielle Anastasia,36,0,45,9
1746556765218,EDS 128A,A01,895459,Fargason; Sharon Gayle,44,0,45,1
1746556766247,EDS 128B,A01,895543,Pappas; Elizabeth,44,0,45,1
1746556767272,EDS 139,A00,897203,Pappas; Elizabeth,44,0,45,1
1746556767272,EDS 139,B00,897209,Fargason; Sharon Gayle,41,0,45,4
1746556768298,EDS 201,A00,895545,Staff,22,0,45,23
1746556769325,EDS 203,A01,895581,Halter; Christopher P.,22,0,45,23
1746556770351,EDS 204R,A01,895625,Heinzman; Erica M.,39,0,45,6
1746556770351,EDS 204R,B01,895693,Halter; Christopher P.,10,0,45,35
1746556771377,EDS 206R,A00,895694,Fargason; Sharon Gayle,1,0,30,29
1746556771377,EDS 206R,B00,895695,Choi; Bailey Miyeon,16,0,30,14
1746556772402,EDS 250,A00,895697,Hemans; Patricia Ann Benitez,22,0,45,23
1746556773468,EDS 281,A00,895701,Meyerott; Theresa Ann,1,0,15,14
1746556774494,EDS 284,A00,895736,Meyerott; Theresa Ann,1,0,15,14
1746556775519,EDS 286,A00,897210,Fine; Sarah,0,0,15,15
1746556776546,EDS 289C,A01,895770,Daly; Alan J.,1,0,15,14
1746556777571,EDS 290,A00,897211,Hofstetter; Carolyn,0,0,15,15
1746556778596,LIGM 5A,A00,896162,Fischer-Grunski; Eva K,13,0,20,7
1746556779621,LIGM 5B,A00,896260,Fischer-Grunski; Eva K,17,0,20,3
1746556780646,LIGM 5C,A00,896308,Fischer-Grunski; Eva K,18,0,20,2
1746556781671,LIIT 5AS,A00,896313,Carnelos; Chiara,18,0,20,2
1746556782698,LIIT 5BS,A00,896416,Carnelos; Chiara,20,0,20,0
1746556783724,LIIT 5CS,A00,896564,Carnelos; Chiara,20,0,20,0
1746556784753,LISP 5A,A00,896588,Munoz Sanchez; Alicia,3,0,20,17
1746556785781,LISP 5B,A00,896653,Munoz Sanchez; Alicia,7,0,20,13
1746556786810,LISP 5C,A00,896655,Munoz Sanchez; Alicia,0,1,20,20
1746556787837,MAE 197,001,957918,Kleissl; Jan,9996,0,9999,3
1746556787837,MAE 197,002,959806,Boechler; Nicholas Sebastia,9998,0,9999,1
1746556787837,MAE 197,003,959852,Mullin; Jennifer S,9998,0,9999,1
1746556788861,MATH 2,A01,957937,Staff,33,0,35,2
1746556789886,MATH 197,001,957876,Kedlaya; Kiran S.,9993,0,9999,6
1746556790911,MCWP 40,A00,892729,Duru; Nur,10,0,20,10
1746556790911,MCWP 40,B00,893304,Montejo; Carolina,14,0,20,6
1746556791936,MCWP 40R,A00,893757,Redela; Pamela Morgan,0,5,20,20
1746556792965,MCWP 50,A00,893758,Morshed; Michael James,0,0,20,20
1746556792965,MCWP 50,B00,893761,Bartulis; Jason Michael,17,0,20,3
1746556793989,MCWP 50R,A00,893766,Compas; Sean Matthew,0,1,20,20
1746556793989,MCWP 50R,B00,893769,Carter; Jennifer A,0,1,20,20
1746556793989,MCWP 50R,C00,893771,Krone; Jarret,0,3,20,20
1746556793989,MCWP 50R,D00,893772,Miller; Elizabeth Deen,0,0,20,20
1746556793989,MCWP 50R,E00,893775,Carter; Andrea L,0,1,20,20
1746556795019,MMW 11R,A01,892721,Herbst; Matthew,11,0,27,16
1746556795019,MMW 11R,A02,892722,Herbst; Matthew,0,0,0,3
1746556796044,MMW 12R,A01,892724,Herbst; Matthew,0,11,16,16
1746556796044,MMW 12R,A02,892725,Herbst; Matthew,0,10,16,16
1746556797073,MMW 13R,A01,892727,Staff,0,4,16,16
1746556797073,MMW 13R,A02,892728,Staff,0,4,16,16
1746556797073,MMW 13R,A03,958032,Staff,0,4,16,16
1746556797073,MMW 13R,A04,958033,Staff,0,4,16,16
1746556797073,MMW 13R,A05,958034,Staff,0,4,16,16
1746556798097,SIO 295LS,A00,894015,Staff,5,0,25,20
1746556799122,SIO 295S,A00,894020,Staff,5,0,25,20
1746556800147,SIOC 290S,B01,958918,Merrifield; Mark A,14,0,30,16
1746556801171,SIOC 291S,B01,958922,Gabriel; Corey John,14,0,30,16
1746556802195,SOCI 117,A01,895339,Staff,3,0,5,2
1746556803220,WES 237B,A00,894149,Staff,11,0,20,9
1746556805277,AESE 279B,A00,891859,Staff,13,0,35,22
1746556806302,AIP 197,001,891854,Vespa; Emanuel Ignacio,9999,0,9999,0
1746556807325,ANTH 289S,A00,891856,Gagneux; Pascal,12,0,12,0
1746556808350,BENG 196,001,957946,Engler; Adam J.,9996,0,9999,3
1746556809376,BISP 197,001,959851,Wilhelm; James E.,9998,0,9999,1
1746556810402,CAT 124RS,A01,956906,Staff,6,0,25,19
1746556811427,CAT 125RS,A01,922013,Staff,6,0,25,19
1746556812452,CLRE 250,A00,891860,Morris; Sheldon,9995,0,9999,4
1746556814505,CLRE 251R,A00,907817,Mehta; Ravindra L.,9994,0,9999,5
1746556815531,CLRE 252,A00,891864,Cuomo; Raphael Eduardo,9993,0,9999,6
1746556816559,CLRE 253,A00,891867,Vaida; Florin,9994,0,9999,5
1746556816559,CLRE 253,B00,907819,Staff,9999,0,9999,0
1746556817588,CLRE 259,A00,891868,Patel; Hemal,9998,0,9999,1
1746556818611,CLRE 260,A00,891872,Cuomo; Raphael Eduardo,9999,0,9999,0
1746556819639,CLRE 297,001,891888,Cuomo; Raphael Eduardo,9999,0,9999,0
1746556820668,CSE 191,A00,958773,Minnes Kemp; Mor Mia,9995,0,9999,4
1746556821694,CSE 197,001,959846,Minnes Kemp; Mor Mia,9990,0,9999,9
1746556822719,CSS 201S,A01,892054,Mignozzetti; Umberto,26,0,30,4
1746556823748,CSS 202S,A01,892056,Mignozzetti; Umberto,26,0,30,4
1746556824773,DSC 197,001,956898,Eldridge; Justin Matthew,9997,0,9999,2
1746556825799,DSC 297,001,958000,Mazumdar; Arya,9998,0,9999,1
1746556825799,DSC 297,002,959862,Wang; Yusu,9998,0,9999,1
1746556826824,EAP 100,A00,905686,Staff,9778,0,9999,221
1746556827851,ECE 45,A01,892618,Staff,0,0,65,65
1746556829914,ECE 111,A01,892719,Staff,4,0,65,61
1746556830940,ECE 197,001,957920,Mercier; Patrick Philip,9991,0,9999,8
1746556831965,ECON 178,A01,907814,Zhu; Ying,26,0,35,9
1746556832990,EDS 115,A00,895312,Staff,35,0,45,10
1746556834018,EDS 117,A01,895337,Staff,23,0,30,7
1746556835042,EDS 125,A00,895341,Jones; Gabrielle Anastasia,36,0,45,9
1746556836069,EDS 128A,A01,895459,Fargason; Sharon Gayle,44,0,45,1
1746556837097,EDS 128B,A01,895543,Pappas; Elizabeth,44,0,45,1
1746556838123,EDS 139,A00,897203,Pappas; Elizabeth,44,0,45,1
1746556838123,EDS 139,B00,897209,Fargason; Sharon Gayle,41,0,45,4
1746556839148,EDS 201,A00,895545,Staff,22,0,45,23
1746556840171,EDS 203,A01,895581,Halter; Christopher P.,22,0,45,23
1746556841195,EDS 204R,A01,895625,Heinzman; Erica M.,39,0,45,6
1746556841195,EDS 204R,B01,895693,Halter; Christopher P.,10,0,45,35
1746556842225,EDS 206R,A00,895694,Fargason; Sharon Gayle,1,0,30,29
1746556842225,EDS 206R,B00,895695,Choi; Bailey Miyeon,16,0,30,14
1746556843249,EDS 250,A00,895697,Hemans; Patricia Ann Benitez,22,0,45,23
1746556844274,EDS 281,A00,895701,Meyerott; Theresa Ann,1,0,15,14
1746556845299,EDS 284,A00,895736,Meyerott; Theresa Ann,1,0,15,14
1746556846327,EDS 286,A00,897210,Fine; Sarah,0,0,15,15
1746556847351,EDS 289C,A01,895770,Daly; Alan J.,1,0,15,14
1746556848377,EDS 290,A00,897211,Hofstetter; Carolyn,0,0,15,15
1746556849403,LIGM 5A,A00,896162,Fischer-Grunski; Eva K,13,0,20,7
1746556850691,LIGM 5B,A00,896260,Fischer-Grunski; Eva K,17,0,20,3
1746556851716,LIGM 5C,A00,896308,Fischer-Grunski; Eva K,18,0,20,2
1746556852740,LIIT 5AS,A00,896313,Carnelos; Chiara,18,0,20,2
1746556853765,LIIT 5BS,A00,896416,Carnelos; Chiara,20,0,20,0
1746556854792,LIIT 5CS,A00,896564,Carnelos; Chiara,20,0,20,0
1746556855818,LISP 5A,A00,896588,Munoz Sanchez; Alicia,3,0,20,17
1746556856843,LISP 5B,A00,896653,Munoz Sanchez; Alicia,7,0,20,13
1746556857867,LISP 5C,A00,896655,Munoz Sanchez; Alicia,0,1,20,20
1746556858893,MAE 197,001,957918,Kleissl; Jan,9996,0,9999,3
1746556858893,MAE 197,002,959806,Boechler; Nicholas Sebastia,9998,0,9999,1
1746556858893,MAE 197,003,959852,Mullin; Jennifer S,9998,0,9999,1
1746556859917,MATH 2,A01,957937,Staff,33,0,35,2
1746556860951,MATH 197,001,957876,Kedlaya; Kiran S.,9993,0,9999,6
1746556861975,MCWP 40,A00,892729,Duru; Nur,10,0,20,10
1746556861975,MCWP 40,B00,893304,Montejo; Carolina,14,0,20,6
1746556863000,MCWP 40R,A00,893757,Redela; Pamela Morgan,0,5,20,20
1746556864026,MCWP 50,A00,893758,Morshed; Michael James,0,0,20,20
1746556864026,MCWP 50,B00,893761,Bartulis; Jason Michael,17,0,20,3
1746556865056,MCWP 50R,A00,893766,Compas; Sean Matthew,0,1,20,20
1746556865056,MCWP 50R,B00,893769,Carter; Jennifer A,0,1,20,20
1746556865056,MCWP 50R,C00,893771,Krone; Jarret,0,3,20,20
1746556865056,MCWP 50R,D00,893772,Miller; Elizabeth Deen,0,0,20,20
1746556865056,MCWP 50R,E00,893775,Carter; Andrea L,0,1,20,20
1746556866080,MMW 11R,A01,892721,Herbst; Matthew,11,0,27,16
1746556866080,MMW 11R,A02,892722,Herbst; Matthew,0,0,0,3
1746556867109,MMW 12R,A01,892724,Herbst; Matthew,0,11,16,16
1746556867109,MMW 12R,A02,892725,Herbst; Matthew,0,10,16,16
1746556868133,MMW 13R,A01,892727,Staff,0,4,16,16
1746556868133,MMW 13R,A02,892728,Staff,0,4,16,16
1746556868133,MMW 13R,A03,958032,Staff,0,4,16,16
1746556868133,MMW 13R,A04,958033,Staff,0,4,16,16
1746556868133,MMW 13R,A05,958034,Staff,0,4,16,16
1746556869158,SIO 295LS,A00,894015,Staff,5,0,25,20
1746556870183,SIO 295S,A00,894020,Staff,5,0,25,20
1746556871211,SIOC 290S,B01,958918,Merrifield; Mark A,14,0,30,16
1746556872236,SIOC 291S,B01,958922,Gabriel; Corey John,14,0,30,16
1746556873263,SOCI 117,A01,895339,Staff,3,0,5,2
1746556874287,WES 237B,A00,894149,Staff,11,0,20,9
1746556876357,AESE 279B,A00,891859,Staff,13,0,35,22
1746556877382,AIP 197,001,891854,Vespa; Emanuel Ignacio,9999,0,9999,0
1746556878407,ANTH 289S,A00,891856,Gagneux; Pascal,12,0,12,0
1746556879433,BENG 196,001,957946,Engler; Adam J.,9996,0,9999,3
1746556880457,BISP 197,001,959851,Wilhelm; James E.,9998,0,9999,1
1746556881485,CAT 124RS,A01,956906,Staff,6,0,25,19
1746556882511,CAT 125RS,A01,922013,Staff,6,0,25,19
1746556883538,CLRE 250,A00,891860,Morris; Sheldon,9995,0,9999,4
1746556885590,CLRE 251R,A00,907817,Mehta; Ravindra L.,9994,0,9999,5
1746556886618,CLRE 252,A00,891864,Cuomo; Raphael Eduardo,9993,0,9999,6
1746556887644,CLRE 253,A00,891867,Vaida; Florin,9994,0,9999,5
1746556887644,CLRE 253,B00,907819,Staff,9999,0,9999,0
1746556888668,CLRE 259,A00,891868,Patel; Hemal,9998,0,9999,1
1746556889697,CLRE 260,A00,891872,Cuomo; Raphael Eduardo,9999,0,9999,0
1746556890723,CLRE 297,001,891888,Cuomo; Raphael Eduardo,9999,0,9999,0
1746556891750,CSE 191,A00,958773,Minnes Kemp; Mor Mia,9995,0,9999,4
1746556892776,CSE 197,001,959846,Minnes Kemp; Mor Mia,9990,0,9999,9
1746556893800,CSS 201S,A01,892054,Mignozzetti; Umberto,26,0,30,4
1746556894826,CSS 202S,A01,892056,Mignozzetti; Umberto,26,0,30,4
1746556895857,DSC 197,001,956898,Eldridge; Justin Matthew,9997,0,9999,2
1746556896882,DSC 297,001,958000,Mazumdar; Arya,9998,0,9999,1
1746556896882,DSC 297,002,959862,Wang; Yusu,9998,0,9999,1
1746556897908,EAP 100,A00,905686,Staff,9778,0,9999,221
1746556898932,ECE 45,A01,892618,Staff,0,0,65,65
1746556900989,ECE 111,A01,892719,Staff,4,0,65,61
1746556902013,ECE 197,001,957920,Mercier; Patrick Philip,9991,0,9999,8
1746556903038,ECON 178,A01,907814,Zhu; Ying,26,0,35,9
1746556904064,EDS 115,A00,895312,Staff,35,0,45,10
1746556905089,EDS 117,A01,895337,Staff,23,0,30,7
1746556906118,EDS 125,A00,895341,Jones; Gabrielle Anastasia,36,0,45,9
1746556907144,EDS 128A,A01,895459,Fargason; Sharon Gayle,44,0,45,1
1746556908170,EDS 128B,A01,895543,Pappas; Elizabeth,44,0,45,1
1746556909197,EDS 139,A00,897203,Pappas; Elizabeth,44,0,45,1
1746556909197,EDS 139,B00,897209,Fargason; Sharon Gayle,41,0,45,4
1746556910223,EDS 201,A00,895545,Staff,22,0,45,23
1746556911251,EDS 203,A01,895581,Halter; Christopher P.,22,0,45,23
1746556912279,EDS 204R,A01,895625,Heinzman; Erica M.,39,0,45,6
1746556912279,EDS 204R,B01,895693,Halter; Christopher P.,10,0,45,35
1746556913304,EDS 206R,A00,895694,Fargason; Sharon Gayle,1,0,30,29
1746556913304,EDS 206R,B00,895695,Choi; Bailey Miyeon,16,0,30,14
1746556914331,EDS 250,A00,895697,Hemans; Patricia Ann Benitez,22,0,45,23
1746556915355,EDS 281,A00,895701,Meyerott; Theresa Ann,1,0,15,14
1746556916381,EDS 284,A00,895736,Meyerott; Theresa Ann,1,0,15,14
1746556917405,EDS 286,A00,897210,Fine; Sarah,0,0,15,15
1746556918432,EDS 289C,A01,895770,Daly; Alan J.,1,0,15,14
1746556919456,EDS 290,A00,897211,Hofstetter; Carolyn,0,0,15,15
1746556920483,LIGM 5A,A00,896162,Fischer-Grunski; Eva K,13,0,20,7
1746556921511,LIGM 5B,A00,896260,Fischer-Grunski; Eva K,17,0,20,3
1746556922536,LIGM 5C,A00,896308,Fischer-Grunski; Eva K,18,0,20,2
1746556923565,LIIT 5AS,A00,896313,Carnelos; Chiara,18,0,20,2
1746556924592,LIIT 5BS,A00,896416,Carnelos; Chiara,20,0,20,0
1746556925619,LIIT 5CS,A00,896564,Carnelos; Chiara,20,0,20,0
1746556926648,LISP 5A,A00,896588,Munoz Sanchez; Alicia,3,0,20,17
1746556927675,LISP 5B,A00,896653,Munoz Sanchez; Alicia,7,0,20,13
1746556928699,LISP 5C,A00,896655,Munoz Sanchez; Alicia,0,1,20,20
1746556929726,MAE 197,001,957918,Kleissl; Jan,9996,0,9999,3
1746556929726,MAE 197,002,959806,Boechler; Nicholas Sebastia,9998,0,9999,1
1746556929726,MAE 197,003,959852,Mullin; Jennifer S,9998,0,9999,1
1746556930751,MATH 2,A01,957937,Staff,33,0,35,2
1746556931778,MATH 197,001,957876,Kedlaya; Kiran S.,9993,0,9999,6
1746556932803,MCWP 40,A00,892729,Duru; Nur,10,0,20,10
1746556932803,MCWP 40,B00,893304,Montejo; Carolina,14,0,20,6
1746556933829,MCWP 40R,A00,893757,Redela; Pamela Morgan,0,5,20,20
1746556934855,MCWP 50,A00,893758,Morshed; Michael James,0,0,20,20
1746556934855,MCWP 50,B00,893761,Bartulis; Jason Michael,17,0,20,3
1746556935883,MCWP 50R,A00,893766,Compas; Sean Matthew,0,1,20,20
1746556935883,MCWP 50R,B00,893769,Carter; Jennifer A,0,1,20,20
1746556935883,MCWP 50R,C00,893771,Krone; Jarret,0,3,20,20
1746556935883,MCWP 50R,D00,893772,Miller; Elizabeth Deen,0,0,20,20
1746556935883,MCWP 50R,E00,893775,Carter; Andrea L,0,1,20,20
1746556936908,MMW 11R,A01,892721,Herbst; Matthew,11,0,27,16
1746556936908,MMW 11R,A02,892722,Herbst; Matthew,0,0,0,3
1746556937936,MMW 12R,A01,892724,Herbst; Matthew,0,11,16,16
1746556937936,MMW 12R,A02,892725,Herbst; Matthew,0,10,16,16
1746556938963,MMW 13R,A01,892727,Staff,0,4,16,16
1746556938963,MMW 13R,A02,892728,Staff,0,4,16,16
1746556938963,MMW 13R,A03,958032,Staff,0,4,16,16
1746556938963,MMW 13R,A04,958033,Staff,0,4,16,16
1746556938963,MMW 13R,A05,958034,Staff,0,4,16,16
1746556939990,SIO 295LS,A00,894015,Staff,5,0,25,20
1746556941020,SIO 295S,A00,894020,Staff,5,0,25,20
1746556942044,SIOC 290S,B01,958918,Merrifield; Mark A,14,0,30,16
1746556943071,SIOC 291S,B01,958922,Gabriel; Corey John,14,0,30,16
1746556944093,SOCI 117,A01,895339,Staff,3,0,5,2
1746556945119,WES 237B,A00,894149,Staff,11,0,20,9
1746556947182,AESE 279B,A00,891859,Staff,13,0,35,22
1746556948206,AIP 197,001,891854,Vespa; Emanuel Ignacio,9999,0,9999,0
1746556949234,ANTH 289S,A00,891856,Gagneux; Pascal,12,0,12,0
1746556950262,BENG 196,001,957946,Engler; Adam J.,9996,0,9999,3
1746556951286,BISP 197,001,959851,Wilhelm; James E.,9998,0,9999,1
1746556952313,CAT 124RS,A01,956906,Staff,6,0,25,19
1746556953339,CAT 125RS,A01,922013,Staff,6,0,25,19
1746556954363,CLRE 250,A00,891860,Morris; Sheldon,9995,0,9999,4
1746556956411,CLRE 251R,A00,907817,Mehta; Ravindra L.,9994,0,9999,5
1746556957437,CLRE 252,A00,891864,Cuomo; Raphael Eduardo,9993,0,9999,6
1746556958462,CLRE 253,A00,891867,Vaida; Florin,9994,0,9999,5
1746556958462,CLRE 253,B00,907819,Staff,9999,0,9999,0
1746556959485,CLRE 259,A00,891868,Patel; Hemal,9998,0,9999,1
1746556960510,CLRE 260,A00,891872,Cuomo; Raphael Eduardo,9999,0,9999,0
1746556961536,CLRE 297,001,891888,Cuomo; Raphael Eduardo,9999,0,9999,0
1746556962562,CSE 191,A00,958773,Minnes Kemp; Mor Mia,9995,0,9999,4
1746556963586,CSE 197,001,959846,Minnes Kemp; Mor Mia,9990,0,9999,9
1746556964611,CSS 201S,A01,892054,Mignozzetti; Umberto,26,0,30,4
1746556965638,CSS 202S,A01,892056,Mignozzetti; Umberto,26,0,30,4
1746556966662,DSC 197,001,956898,Eldridge; Justin Matthew,9997,0,9999,2
1746556967687,DSC 297,001,958000,Mazumdar; Arya,9998,0,9999,1
1746556967687,DSC 297,002,959862,Wang; Yusu,9998,0,9999,1
1746556968714,EAP 100,A00,905686,Staff,9778,0,9999,221
1746556969739,ECE 45,A01,892618,Staff,0,0,65,65
1746556971792,ECE 111,A01,892719,Staff,4,0,65,61
1746556972820,ECE 197,001,957920,Mercier; Patrick Philip,9991,0,9999,8
1746556973844,ECON 178,A01,907814,Zhu; Ying,26,0,35,9
1746556974869,EDS 115,A00,895312,Staff,35,0,45,10
1746556975897,EDS 117,A01,895337,Staff,23,0,30,7
1746556976922,EDS 125,A00,895341,Jones; Gabrielle Anastasia,36,0,45,9
1746556977945,EDS 128A,A01,895459,Fargason; Sharon Gayle,44,0,45,1
1746556978971,EDS 128B,A01,895543,Pappas; Elizabeth,44,0,45,1
1746556979996,EDS 139,A00,897203,Pappas; Elizabeth,44,0,45,1
1746556979996,EDS 139,B00,897209,Fargason; Sharon Gayle,41,0,45,4
1746556981021,EDS 201,A00,895545,Staff,22,0,45,23
1746556982049,EDS 203,A01,895581,Halter; Christopher P.,22,0,45,23
1746556983078,EDS 204R,A01,895625,Heinzman; Erica M.,39,0,45,6
1746556983078,EDS 204R,B01,895693,Halter; Christopher P.,10,0,45,35
1746556984106,EDS 206R,A00,895694,Fargason; Sharon Gayle,1,0,30,29
1746556984106,EDS 206R,B00,895695,Choi; Bailey Miyeon,16,0,30,14
1746556985132,EDS 250,A00,895697,Hemans; Patricia Ann Benitez,22,0,45,23
1746556986159,EDS 281,A00,895701,Meyerott; Theresa Ann,1,0,15,14
1746556987187,EDS 284,A00,895736,Meyerott; Theresa Ann,1,0,15,14
1746556988211,EDS 286,A00,897210,Fine; Sarah,0,0,15,15
1746556989235,EDS 289C,A01,895770,Daly; Alan J.,1,0,15,14
1746556990260,EDS 290,A00,897211,Hofstetter; Carolyn,0,0,15,15
1746556991285,LIGM 5A,A00,896162,Fischer-Grunski; Eva K,13,0,20,7
1746556992314,LIGM 5B,A00,896260,Fischer-Grunski; Eva K,17,0,20,3
1746556993339,LIGM 5C,A00,896308,Fischer-Grunski; Eva K,18,0,20,2
1746556994366,LIIT 5AS,A00,896313,Carnelos; Chiara,18,0,20,2
1746556995393,LIIT 5BS,A00,896416,Carnelos; Chiara,20,0,20,0
1746556996420,LIIT 5CS,A00,896564,Carnelos; Chiara,20,0,20,0
1746556997447,LISP 5A,A00,896588,Munoz Sanchez; Alicia,3,0,20,17
1746556998476,LISP 5B,A00,896653,Munoz Sanchez; Alicia,7,0,20,13
1746556999501,LISP 5C,A00,896655,Munoz Sanchez; Alicia,0,1,20,20
1746557000531,MAE 197,001,957918,Kleissl; Jan,9996,0,9999,3
1746557000531,MAE 197,002,959806,Boechler; Nicholas Sebastia,9998,0,9999,1
1746557000531,MAE 197,003,959852,Mullin; Jennifer S,9998,0,9999,1
1746557001557,MATH 2,A01,957937,Staff,33,0,35,2
1746557002582,MATH 197,001,957876,Kedlaya; Kiran S.,9993,0,9999,6
1746557003607,MCWP 40,A00,892729,Duru; Nur,10,0,20,10
1746557003607,MCWP 40,B00,893304,Montejo; Carolina,14,0,20,6
1746557004635,MCWP 40R,A00,893757,Redela; Pamela Morgan,0,5,20,20
1746557005660,MCWP 50,A00,893758,Morshed; Michael James,0,0,20,20
1746557005660,MCWP 50,B00,893761,Bartulis; Jason Michael,17,0,20,3
1746557006688,MCWP 50R,A00,893766,Compas; Sean Matthew,0,1,20,20
1746557006688,MCWP 50R,B00,893769,Carter; Jennifer A,0,1,20,20
1746557006688,MCWP 50R,C00,893771,Krone; Jarret,0,3,20,20
1746557006688,MCWP 50R,D00,893772,Miller; Elizabeth Deen,0,0,20,20
1746557006688,MCWP 50R,E00,893775,Carter; Andrea L,0,1,20,20
1746557007713,MMW 11R,A01,892721,Herbst; Matthew,11,0,27,16
1746557007713,MMW 11R,A02,892722,Herbst; Matthew,0,0,0,3
1746557008741,MMW 12R,A01,892724,Herbst; Matthew,0,11,16,16
1746557008741,MMW 12R,A02,892725,Herbst; Matthew,0,10,16,16
1746557009766,MMW 13R,A01,892727,Staff,0,4,16,16
1746557009766,MMW 13R,A02,892728,Staff,0,4,16,16
1746557009766,MMW 13R,A03,958032,Staff,0,4,16,16
1746557009766,MMW 13R,A04,958033,Staff,0,4,16,16
1746557009766,MMW 13R,A05,958034,Staff,0,4,16,16
1746557010791,SIO 295LS,A00,894015,Staff,5,0,25,20
1746557011818,SIO 295S,A00,894020,Staff,5,0,25,20
1746557012847,SIOC 290S,B01,958918,Merrifield; Mark A,14,0,30,16
1746557013878,SIOC 291S,B01,958922,Gabriel; Corey John,14,0,30,16
1746557014903,SOCI 117,A01,895339,Staff,3,0,5,2
1746557015930,WES 237B,A00,894149,Staff,11,0,20,9
1746557017988,AESE 279B,A00,891859,Staff,13,0,35,22
1746557019108,AIP 197,001,891854,Vespa; Emanuel Ignacio,9999,0,9999,0
1746557020133,ANTH 289S,A00,891856,Gagneux; Pascal,12,0,12,0
1746557021159,BENG 196,001,957946,Engler; Adam J.,9996,0,9999,3
1746557022191,BISP 197,001,959851,Wilhelm; James E.,9998,0,9999,1
1746557023218,CAT 124RS,A01,956906,Staff,6,0,25,19
1746557024244,CAT 125RS,A01,922013,Staff,6,0,25,19
1746557025272,CLRE 250,A00,891860,Morris; Sheldon,9995,0,9999,4
1746557027321,CLRE 251R,A00,907817,Mehta; Ravindra L.,9994,0,9999,5
1746557028348,CLRE 252,A00,891864,Cuomo; Raphael Eduardo,9993,0,9999,6
1746557029372,CLRE 253,A00,891867,Vaida; Florin,9994,0,9999,5
1746557029372,CLRE 253,B00,907819,Staff,9999,0,9999,0
1746557030397,CLRE 259,A00,891868,Patel; Hemal,9998,0,9999,1
1746557031425,CLRE 260,A00,891872,Cuomo; Raphael Eduardo,9999,0,9999,0
1746557032451,CLRE 297,001,891888,Cuomo; Raphael Eduardo,9999,0,9999,0
1746557033476,CSE 191,A00,958773,Minnes Kemp; Mor Mia,9995,0,9999,4
1746557034504,CSE 197,001,959846,Minnes Kemp; Mor Mia,9990,0,9999,9
1746557035530,CSS 201S,A01,892054,Mignozzetti; Umberto,26,0,30,4
1746557036556,CSS 202S,A01,892056,Mignozzetti; Umberto,26,0,30,4
1746557037580,DSC 197,001,956898,Eldridge; Justin Matthew,9997,0,9999,2
1746557038606,DSC 297,001,958000,Mazumdar; Arya,9998,0,9999,1
1746557038606,DSC 297,002,959862,Wang; Yusu,9998,0,9999,1
1746557039631,EAP 100,A00,905686,Staff,9778,0,9999,221
1746557040656,ECE 45,A01,892618,Staff,0,0,65,65
1746557042709,ECE 111,A01,892719,Staff,4,0,65,61
1746557043734,ECE 197,001,957920,Mercier; Patrick Philip,9991,0,9999,8
1746557044763,ECON 178,A01,907814,Zhu; Ying,26,0,35,9
1746557045791,EDS 115,A00,895312,Staff,35,0,45,10
1746557046814,EDS 117,A01,895337,Staff,23,0,30,7
1746557047840,EDS 125,A00,895341,Jones; Gabrielle Anastasia,36,0,45,9
1746557048864,EDS 128A,A01,895459,Fargason; Sharon Gayle,44,0,45,1
1746557049891,EDS 128B,A01,895543,Pappas; Elizabeth,44,0,45,1
1746557050916,EDS 139,A00,897203,Pappas; Elizabeth,44,0,45,1
1746557050916,EDS 139,B00,897209,Fargason; Sharon Gayle,41,0,45,4
1746557051941,EDS 201,A00,895545,Staff,22,0,45,23
1746557052969,EDS 203,A01,895581,Halter; Christopher P.,22,0,45,23
1746557053993,EDS 204R,A01,895625,Heinzman; Erica M.,39,0,45,6
1746557053993,EDS 204R,B01,895693,Halter; Christopher P.,10,0,45,35
1746557055017,EDS 206R,A00,895694,Fargason; Sharon Gayle,1,0,30,29
1746557055017,EDS 206R,B00,895695,Choi; Bailey Miyeon,16,0,30,14
1746557056046,EDS 250,A00,895697,Hemans; Patricia Ann Benitez,22,0,45,23
1746557057073,EDS 281,A00,895701,Meyerott; Theresa Ann,1,0,15,14
1746557058098,EDS 284,A00,895736,Meyerott; Theresa Ann,1,0,15,14
1746557059124,EDS 286,A00,897210,Fine; Sarah,0,0,15,15
1746557060156,EDS 289C,A01,895770,Daly; Alan J.,1,0,15,14
1746557061181,EDS 290,A00,897211,Hofstetter; Carolyn,0,0,15,15
1746557062206,LIGM 5A,A00,896162,Fischer-Grunski; Eva K,13,0,20,7
1746557063230,LIGM 5B,A00,896260,Fischer-Grunski; Eva K,17,0,20,3
1746557064255,LIGM 5C,A00,896308,Fischer-Grunski; Eva K,18,0,20,2
1746557065279,LIIT 5AS,A00,896313,Carnelos; Chiara,18,0,20,2
1746557066305,LIIT 5BS,A00,896416,Carnelos; Chiara,20,0,20,0
1746557067333,LIIT 5CS,A00,896564,Carnelos; Chiara,20,0,20,0
1746557068360,LISP 5A,A00,896588,Munoz Sanchez; Alicia,3,0,20,17
1746557069387,LISP 5B,A00,896653,Munoz Sanchez; Alicia,7,0,20,13
1746557070412,LISP 5C,A00,896655,Munoz Sanchez; Alicia,0,1,20,20
1746557071436,MAE 197,001,957918,Kleissl; Jan,9996,0,9999,3
1746557071436,MAE 197,002,959806,Boechler; Nicholas Sebastia,9998,0,9999,1
1746557071436,MAE 197,003,959852,Mullin; Jennifer S,9998,0,9999,1
1746557072459,MATH 2,A01,957937,Staff,33,0,35,2
1746557073486,MATH 197,001,957876,Kedlaya; Kiran S.,9993,0,9999,6
1746557074512,MCWP 40,A00,892729,Duru; Nur,10,0,20,10
1746557074512,MCWP 40,B00,893304,Montejo; Carolina,14,0,20,6
1746557075542,MCWP 40R,A00,893757,Redela; Pamela Morgan,0,5,20,20
1746557076567,MCWP 50,A00,893758,Morshed; Michael James,0,0,20,20
1746557076567,MCWP 50,B00,893761,Bartulis; Jason Michael,17,0,20,3
1746557077592,MCWP 50R,A00,893766,Compas; Sean Matthew,0,1,20,20
1746557077592,MCWP 50R,B00,893769,Carter; Jennifer A,0,1,20,20
1746557077592,MCWP 50R,C00,893771,Krone; Jarret,0,3,20,20
1746557077592,MCWP 50R,D00,893772,Miller; Elizabeth Deen,0,0,20,20
1746557077592,MCWP 50R,E00,893775,Carter; Andrea L,0,1,20,20
1746557078619,MMW 11R,A01,892721,Herbst; Matthew,11,0,27,16
1746557078619,MMW 11R,A02,892722,Herbst; Matthew,0,0,0,3
1746557079649,MMW 12R,A01,892724,Herbst; Matthew,0,11,16,16
1746557079649,MMW 12R,A02,892725,Herbst; Matthew,0,10,16,16
1746557080672,MMW 13R,A01,892727,Staff,0,4,16,16
1746557080672,MMW 13R,A02,892728,Staff,0,4,16,16
1746557080672,MMW 13R,A03,958032,Staff,0,4,16,16
1746557080672,MMW 13R,A04,958033,Staff,0,4,16,16
1746557080672,MMW 13R,A05,958034,Staff,0,4,16,16
1746557081698,SIO 295LS,A00,894015,Staff,5,0,25,20
1746557082724,SIO 295S,A00,894020,Staff,5,0,25,20
1746557083956,SIOC 290S,B01,958918,Merrifield; Mark A,14,0,30,16
1746557084985,SIOC 291S,B01,958922,Gabriel; Corey John,14,0,30,16
1746557086008,SOCI 117,A01,895339,Staff,3,0,5,2
1746557087034,WES 237B,A00,894149,Staff,11,0,20,9
1746557089088,AESE 279B,A00,891859,Staff,13,0,35,22
1746557090115,AIP 197,001,891854,Vespa; Emanuel Ignacio,9999,0,9999,0
1746557091140,ANTH 289S,A00,891856,Gagneux; Pascal,12,0,12,0
1746557092163,BENG 196,001,957946,Engler; Adam J.,9996,0,9999,3
1746557093191,BISP 197,001,959851,Wilhelm; James E.,9998,0,9999,1
1746557094219,CAT 124RS,A01,956906,Staff,6,0,25,19
1746557095247,CAT 125RS,A01,922013,Staff,6,0,25,19
1746557096275,CLRE 250,A00,891860,Morris; Sheldon,9995,0,9999,4
1746557098349,CLRE 251R,A00,907817,Mehta; Ravindra L.,9994,0,9999,5
1746557099377,CLRE 252,A00,891864,Cuomo; Raphael Eduardo,9993,0,9999,6
1746557100403,CLRE 253,A00,891867,Vaida; Florin,9994,0,9999,5
1746557100403,CLRE 253,B00,907819,Staff,9999,0,9999,0
1746557101430,CLRE 259,A00,891868,Patel; Hemal,9998,0,9999,1
1746557102466,CLRE 260,A00,891872,Cuomo; Raphael Eduardo,9999,0,9999,0
1746557103493,CLRE 297,001,891888,Cuomo; Raphael Eduardo,9999,0,9999,0
1746557104520,CSE 191,A00,958773,Minnes Kemp; Mor Mia,9995,0,9999,4
1746557105547,CSE 197,001,959846,Minnes Kemp; Mor Mia,9990,0,9999,9
1746557106579,CSS 201S,A01,892054,Mignozzetti; Umberto,26,0,30,4
1746557107609,CSS 202S,A01,892056,Mignozzetti; Umberto,26,0,30,4
1746557108639,DSC 197,001,956898,Eldridge; Justin Matthew,9997,0,9999,2
1746557109669,DSC 297,001,958000,Mazumdar; Arya,9998,0,9999,1
1746557109669,DSC 297,002,959862,Wang; Yusu,9998,0,9999,1
1746557110697,EAP 100,A00,905686,Staff,9778,0,9999,221
1746557111726,ECE 45,A01,892618,Staff,0,0,65,65
1746557113780,ECE 111,A01,892719,Staff,4,0,65,61
1746557114806,ECE 197,001,957920,Mercier; Patrick Philip,9991,0,9999,8
1746557115833,ECON 178,A01,907814,Zhu; Ying,26,0,35,9
1746557116859,EDS 115,A00,895312,Staff,35,0,45,10
1746557117884,EDS 117,A01,895337,Staff,23,0,30,7
1746557118913,EDS 125,A00,895341,Jones; Gabrielle Anastasia,36,0,45,9
1746557119937,EDS 128A,A01,895459,Fargason; Sharon Gayle,44,0,45,1
1746557120963,EDS 128B,A01,895543,Pappas; Elizabeth,44,0,45,1
1746557121989,EDS 139,A00,897203,Pappas; Elizabeth,44,0,45,1
1746557121989,EDS 139,B00,897209,Fargason; Sharon Gayle,41,0,45,4
1746557123015,EDS 201,A00,895545,Staff,22,0,45,23
1746557124044,EDS 203,A01,895581,Halter; Christopher P.,22,0,45,23
1746557125068,EDS 204R,A01,895625,Heinzman; Erica M.,39,0,45,6
1746557125068,EDS 204R,B01,895693,Halter; Christopher P.,10,0,45,35
1746557126099,EDS 206R,A00,895694,Fargason; Sharon Gayle,1,0,30,29
1746557126099,EDS 206R,B00,895695,Choi; Bailey Miyeon,16,0,30,14
1746557127124,EDS 250,A00,895697,Hemans; Patricia Ann Benitez,22,0,45,23
1746557128151,EDS 281,A00,895701,Meyerott; Theresa Ann,1,0,15,14
1746557129176,EDS 284,A00,895736,Meyerott; Theresa Ann,1,0,15,14
1746557130204,EDS 286,A00,897210,Fine; Sarah,0,0,15,15
1746557131229,EDS 289C,A01,895770,Daly; Alan J.,1,0,15,14
1746557132254,EDS 290,A00,897211,Hofstetter; Carolyn,0,0,15,15
1746557133279,LIGM 5A,A00,896162,Fischer-Grunski; Eva K,13,0,20,7
1746557134303,LIGM 5B,A00,896260,Fischer-Grunski; Eva K,17,0,20,3
1746557135331,LIGM 5C,A00,896308,Fischer-Grunski; Eva K,18,0,20,2
1746557136359,LIIT 5AS,A00,896313,Carnelos; Chiara,18,0,20,2
1746557137383,LIIT 5BS,A00,896416,Carnelos; Chiara,20,0,20,0
1746557138411,LIIT 5CS,A00,896564,Carnelos; Chiara,20,0,20,0
1746557139439,LISP 5A,A00,896588,Munoz Sanchez; Alicia,3,0,20,17
1746557140464,LISP 5B,A00,896653,Munoz Sanchez; Alicia,7,0,20,13
1746557141489,LISP 5C,A00,896655,Munoz Sanchez; Alicia,0,1,20,20
1746557142513,MAE 197,001,957918,Kleissl; Jan,9996,0,9999,3
1746557142513,MAE 197,002,959806,Boechler; Nicholas Sebastia,9998,0,9999,1
1746557142513,MAE 197,003,959852,Mullin; Jennifer S,9998,0,9999,1
1746557143538,MATH 2,A01,957937,Staff,33,0,35,2
1746557144563,MATH 197,001,957876,Kedlaya; Kiran S.,9993,0,9999,6
1746557145591,MCWP 40,A00,892729,Duru; Nur,10,0,20,10
1746557145591,MCWP 40,B00,893304,Montejo; Carolina,14,0,20,6
1746557146616,MCWP 40R,A00,893757,Redela; Pamela Morgan,0,5,20,20
1746557147650,MCWP 50,A00,893758,Morshed; Michael James,0,0,20,20
1746557147650,MCWP 50,B00,893761,Bartulis; Jason Michael,17,0,20,3
1746557148677,MCWP 50R,A00,893766,Compas; Sean Matthew,0,1,20,20
1746557148677,MCWP 50R,B00,893769,Carter; Jennifer A,0,1,20,20
1746557148677,MCWP 50R,C00,893771,Krone; Jarret,0,3,20,20
1746557148677,MCWP 50R,D00,893772,Miller; Elizabeth Deen,0,0,20,20
1746557148677,MCWP 50R,E00,893775,Carter; Andrea L,0,1,20,20
1746557149703,MMW 11R,A01,892721,Herbst; Matthew,11,0,27,16
1746557149703,MMW 11R,A02,892722,Herbst; Matthew,0,0,0,3
1746557150751,MMW 12R,A01,892724,Herbst; Matthew,0,11,16,16
1746557150751,MMW 12R,A02,892725,Herbst; Matthew,0,10,16,16
1746557151778,MMW 13R,A01,892727,Staff,0,4,16,16
1746557151778,MMW 13R,A02,892728,Staff,0,4,16,16
1746557151778,MMW 13R,A03,958032,Staff,0,4,16,16
1746557151778,MMW 13R,A04,958033,Staff,0,4,16,16
1746557151778,MMW 13R,A05,958034,Staff,0,4,16,16
1746557152804,SIO 295LS,A00,894015,Staff,5,0,25,20
1746557153829,SIO 295S,A00,894020,Staff,5,0,25,20
1746557154856,SIOC 290S,B01,958918,Merrifield; Mark A,14,0,30,16
1746557155882,SIOC 291S,B01,958922,Gabriel; Corey John,14,0,30,16
1746557156907,SOCI 117,A01,895339,Staff,3,0,5,2
1746557157933,WES 237B,A00,894149,Staff,11,0,20,9
1746557160004,AESE 279B,A00,891859,Staff,13,0,35,22
1746557161031,AIP 197,001,891854,Vespa; Emanuel Ignacio,9999,0,9999,0
1746557162057,ANTH 289S,A00,891856,Gagneux; Pascal,12,0,12,0
1746557163082,BENG 196,001,957946,Engler; Adam J.,9996,0,9999,3
1746557164107,BISP 197,001,959851,Wilhelm; James E.,9998,0,9999,1
1746557165133,CAT 124RS,A01,956906,Staff,6,0,25,19
1746557166161,CAT 125RS,A01,922013,Staff,6,0,25,19
1746557167189,CLRE 250,A00,891860,Morris; Sheldon,9995,0,9999,4
1746557169243,CLRE 251R,A00,907817,Mehta; Ravindra L.,9994,0,9999,5
1746557170277,CLRE 252,A00,891864,Cuomo; Raphael Eduardo,9993,0,9999,6
1746557171304,CLRE 253,A00,891867,Vaida; Florin,9994,0,9999,5
1746557171304,CLRE 253,B00,907819,Staff,9999,0,9999,0
1746557172330,CLRE 259,A00,891868,Patel; Hemal,9998,0,9999,1
1746557173356,CLRE 260,A00,891872,Cuomo; Raphael Eduardo,9999,0,9999,0
1746557174384,CLRE 297,001,891888,Cuomo; Raphael Eduardo,9999,0,9999,0
1746557175414,CSE 191,A00,958773,Minnes Kemp; Mor Mia,9995,0,9999,4
1746557176438,CSE 197,001,959846,Minnes Kemp; Mor Mia,9990,0,9999,9
1746557177463,CSS 201S,A01,892054,Mignozzetti; Umberto,26,0,30,4
1746557178493,CSS 202S,A01,892056,Mignozzetti; Umberto,26,0,30,4
1746557179520,DSC 197,001,956898,Eldridge; Justin Matthew,9997,0,9999,2
1746557180548,DSC 297,001,958000,Mazumdar; Arya,9998,0,9999,1
1746557180548,DSC 297,002,959862,Wang; Yusu,9998,0,9999,1
1746557181575,EAP 100,A00,905686,Staff,9778,0,9999,221
1746557182602,ECE 45,A01,892618,Staff,0,0,65,65
1746557184666,ECE 111,A01,892719,Staff,4,0,65,61
1746557185693,ECE 197,001,957920,Mercier; Patrick Philip,9991,0,9999,8
1746557186718,ECON 178,A01,907814,Zhu; Ying,26,0,35,9
1746557187743,EDS 115,A00,895312,Staff,35,0,45,10
1746557188766,EDS 117,A01,895337,Staff,23,0,30,7
1746557189793,EDS 125,A00,895341,Jones; Gabrielle Anastasia,36,0,45,9
1746557190822,EDS 128A,A01,895459,Fargason; Sharon Gayle,44,0,45,1
1746557191848,EDS 128B,A01,895543,Pappas; Elizabeth,44,0,45,1
1746557192887,EDS 139,A00,897203,Pappas; Elizabeth,44,0,45,1
1746557192887,EDS 139,B00,897209,Fargason; Sharon Gayle,41,0,45,4
1746557193912,EDS 201,A00,895545,Staff,22,0,45,23
1746557194936,EDS 203,A01,895581,Halter; Christopher P.,22,0,45,23
1746557195960,EDS 204R,A01,895625,Heinzman; Erica M.,39,0,45,6
1746557195960,EDS 204R,B01,895693,Halter; Christopher P.,10,0,45,35
1746557196984,EDS 206R,A00,895694,Fargason; Sharon Gayle,1,0,30,29
1746557196984,EDS 206R,B00,895695,Choi; Bailey Miyeon,16,0,30,14
1746557198062,EDS 250,A00,895697,Hemans; Patricia Ann Benitez,22,0,45,23
1746557199089,EDS 281,A00,895701,Meyerott; Theresa Ann,1,0,15,14
1746557200116,EDS 284,A00,895736,Meyerott; Theresa Ann,1,0,15,14
1746557201141,EDS 286,A00,897210,Fine; Sarah,0,0,15,15
1746557202167,EDS 289C,A01,895770,Daly; Alan J.,1,0,15,14
1746557203192,EDS 290,A00,897211,Hofstetter; Carolyn,0,0,15,15
1746557204217,LIGM 5A,A00,896162,Fischer-Grunski; Eva K,13,0,20,7
1746557205246,LIGM 5B,A00,896260,Fischer-Grunski; Eva K,17,0,20,3
1746557206274,LIGM 5C,A00,896308,Fischer-Grunski; Eva K,18,0,20,2
1746557207303,LIIT 5AS,A00,896313,Carnelos; Chiara,18,0,20,2
1746557208331,LIIT 5BS,A00,896416,Carnelos; Chiara,20,0,20,0
1746557209359,LIIT 5CS,A00,896564,Carnelos; Chiara,20,0,20,0
1746557210383,LISP 5A,A00,896588,Munoz Sanchez; Alicia,3,0,20,17
1746557211411,LISP 5B,A00,896653,Munoz Sanchez; Alicia,7,0,20,13
1746557212437,LISP 5C,A00,896655,Munoz Sanchez; Alicia,0,1,20,20
1746557213466,MAE 197,001,957918,Kleissl; Jan,9996,0,9999,3
1746557213466,MAE 197,002,959806,Boechler; Nicholas Sebastia,9998,0,9999,1
1746557213466,MAE 197,003,959852,Mullin; Jennifer S,9998,0,9999,1
1746557214492,MATH 2,A01,957937,Staff,33,0,35,2
1746557215519,MATH 197,001,957876,Kedlaya; Kiran S.,9993,0,9999,6
1746557216544,MCWP 40,A00,892729,Duru; Nur,10,0,20,10
1746557216544,MCWP 40,B00,893304,Montejo; Carolina,14,0,20,6
1746557217568,MCWP 40R,A00,893757,Redela; Pamela Morgan,0,5,20,20
1746557218597,MCWP 50,A00,893758,Morshed; Michael James,0,0,20,20
1746557218597,MCWP 50,B00,893761,Bartulis; Jason Michael,17,0,20,3
1746557219623,MCWP 50R,A00,893766,Compas; Sean Matthew,0,1,20,20
1746557219623,MCWP 50R,B00,893769,Carter; Jennifer A,0,1,20,20
1746557219623,MCWP 50R,C00,893771,Krone; Jarret,0,3,20,20
1746557219623,MCWP 50R,D00,893772,Miller; Elizabeth Deen,0,0,20,20
1746557219623,MCWP 50R,E00,893775,Carter; Andrea L,0,1,20,20
1746557220648,MMW 11R,A01,892721,Herbst; Matthew,11,0,27,16
1746557220648,MMW 11R,A02,892722,Herbst; Matthew,0,0,0,3
1746557221674,MMW 12R,A01,892724,Herbst; Matthew,0,11,16,16
1746557221674,MMW 12R,A02,892725,Herbst; Matthew,0,10,16,16
1746557222702,MMW 13R,A01,892727,Staff,0,4,16,16
1746557222702,MMW 13R,A02,892728,Staff,0,4,16,16
1746557222702,MMW 13R,A03,958032,Staff,0,4,16,16
1746557222702,MMW 13R,A04,958033,Staff,0,4,16,16
1746557222702,MMW 13R,A05,958034,Staff,0,4,16,16
1746557223728,SIO 295LS,A00,894015,Staff,5,0,25,20
1746557224758,SIO 295S,A00,894020,Staff,5,0,25,20
1746557225782,SIOC 290S,B01,958918,Merrifield; Mark A,14,0,30,16
1746557226811,SIOC 291S,B01,958922,Gabriel; Corey John,14,0,30,16
1746557227840,SOCI 117,A01,895339,Staff,3,0,5,2
1746557228864,WES 237B,A00,894149,Staff,11,0,20,9
1746557230929,AESE 279B,A00,891859,Staff,13,0,35,22
1746557231959,AIP 197,001,891854,Vespa; Emanuel Ignacio,9999,0,9999,0
1746557232987,ANTH 289S,A00,891856,Gagneux; Pascal,12,0,12,0
1746557234012,BENG 196,001,957946,Engler; Adam J.,9996,0,9999,3
1746557235038,BISP 197,001,959851,Wilhelm; James E.,9998,0,9999,1
1746557236063,CAT 124RS,A01,956906,Staff,6,0,25,19
1746557237088,CAT 125RS,A01,922013,Staff,6,0,25,19
1746557238113,CLRE 250,A00,891860,Morris; Sheldon,9995,0,9999,4
1746557240163,CLRE 251R,A00,907817,Mehta; Ravindra L.,9994,0,9999,5
1746557241192,CLRE 252,A00,891864,Cuomo; Raphael Eduardo,9993,0,9999,6
1746557242216,CLRE 253,A00,891867,Vaida; Florin,9994,0,9999,5
1746557242216,CLRE 253,B00,907819,Staff,9999,0,9999,0
1746557243244,CLRE 259,A00,891868,Patel; Hemal,9998,0,9999,1
1746557244272,CLRE 260,A00,891872,Cuomo; Raphael Eduardo,9999,0,9999,0
1746557245297,CLRE 297,001,891888,Cuomo; Raphael Eduardo,9999,0,9999,0
1746557246324,CSE 191,A00,958773,Minnes Kemp; Mor Mia,9995,0,9999,4
1746557247351,CSE 197,001,959846,Minnes Kemp; Mor Mia,9990,0,9999,9
1746557248379,CSS 201S,A01,892054,Mignozzetti; Umberto,26,0,30,4
1746557249407,CSS 202S,A01,892056,Mignozzetti; Umberto,26,0,30,4
1746557250434,DSC 197,001,956898,Eldridge; Justin Matthew,9997,0,9999,2
1746557251460,DSC 297,001,958000,Mazumdar; Arya,9998,0,9999,1
1746557251460,DSC 297,002,959862,Wang; Yusu,9998,0,9999,1
1746557252485,EAP 100,A00,905686,Staff,9778,0,9999,221
1746557253510,ECE 45,A01,892618,Staff,0,0,65,65
1746557255560,ECE 111,A01,892719,Staff,4,0,65,61
1746557256589,ECE 197,001,957920,Mercier; Patrick Philip,9991,0,9999,8
1746557257615,ECON 178,A01,907814,Zhu; Ying,26,0,35,9
1746557258640,EDS 115,A00,895312,Staff,35,0,45,10
1746557259669,EDS 117,A01,895337,Staff,23,0,30,7
1746557260696,EDS 125,A00,895341,Jones; Gabrielle Anastasia,36,0,45,9
1746557261725,EDS 128A,A01,895459,Fargason; Sharon Gayle,44,0,45,1
1746557262753,EDS 128B,A01,895543,Pappas; Elizabeth,44,0,45,1
1746557263779,EDS 139,A00,897203,Pappas; Elizabeth,44,0,45,1
1746557263779,EDS 139,B00,897209,Fargason; Sharon Gayle,41,0,45,4
1746557264804,EDS 201,A00,895545,Staff,22,0,45,23
1746557265831,EDS 203,A01,895581,Halter; Christopher P.,22,0,45,23
1746557266859,EDS 204R,A01,895625,Heinzman; Erica M.,39,0,45,6
1746557266859,EDS 204R,B01,895693,Halter; Christopher P.,10,0,45,35
1746557267885,EDS 206R,A00,895694,Fargason; Sharon Gayle,1,0,30,29
1746557267885,EDS 206R,B00,895695,Choi; Bailey Miyeon,16,0,30,14
1746557268915,EDS 250,A00,895697,Hemans; Patricia Ann Benitez,22,0,45,23
1746557269942,EDS 281,A00,895701,Meyerott; Theresa Ann,1,0,15,14
1746557270970,EDS 284,A00,895736,Meyerott; Theresa Ann,1,0,15,14
1746557271996,EDS 286,A00,897210,Fine; Sarah,0,0,15,15
1746557273020,EDS 289C,A01,895770,Daly; Alan J.,1,0,15,14
1746557274047,EDS 290,A00,897211,Hofstetter; Carolyn,0,0,15,15
1746557275076,LIGM 5A,A00,896162,Fischer-Grunski; Eva K,13,0,20,7
1746557276102,LIGM 5B,A00,896260,Fischer-Grunski; Eva K,17,0,20,3
1746557277127,LIGM 5C,A00,896308,Fischer-Grunski; Eva K,18,0,20,2
1746557278154,LIIT 5AS,A00,896313,Carnelos; Chiara,18,0,20,2
1746557279179,LIIT 5BS,A00,896416,Carnelos; Chiara,20,0,20,0
1746557280203,LIIT 5CS,A00,896564,Carnelos; Chiara,20,0,20,0
1746557281231,LISP 5A,A00,896588,Munoz Sanchez; Alicia,3,0,20,17
1746557282257,LISP 5B,A00,896653,Munoz Sanchez; Alicia,7,0,20,13
1746557283281,LISP 5C,A00,896655,Munoz Sanchez; Alicia,0,1,20,20
1746557284308,MAE 197,001,957918,Kleissl; Jan,9996,0,9999,3
1746557284308,MAE 197,002,959806,Boechler; Nicholas Sebastia,9998,0,9999,1
1746557284308,MAE 197,003,959852,Mullin; Jennifer S,9998,0,9999,1
1746557285336,MATH 2,A01,957937,Staff,33,0,35,2
1746557286359,MATH 197,001,957876,Kedlaya; Kiran S.,9993,0,9999,6
1746557287384,MCWP 40,A00,892729,Duru; Nur,10,0,20,10
1746557287384,MCWP 40,B00,893304,Montejo; Carolina,14,0,20,6
1746557288411,MCWP 40R,A00,893757,Redela; Pamela Morgan,0,5,20,20
1746557289436,MCWP 50,A00,893758,Morshed; Michael James,0,0,20,20
1746557289436,MCWP 50,B00,893761,Bartulis; Jason Michael,17,0,20,3
1746557290462,MCWP 50R,A00,893766,Compas; Sean Matthew,0,1,20,20
1746557290462,MCWP 50R,B00,893769,Carter; Jennifer A,0,1,20,20
1746557290462,MCWP 50R,C00,893771,Krone; Jarret,0,3,20,20
1746557290462,MCWP 50R,D00,893772,Miller; Elizabeth Deen,0,0,20,20
1746557290462,MCWP 50R,E00,893775,Carter; Andrea L,0,1,20,20
1746557291489,MMW 11R,A01,892721,Herbst; Matthew,11,0,27,16
1746557291489,MMW 11R,A02,892722,Herbst; Matthew,0,0,0,3
1746557292513,MMW 12R,A01,892724,Herbst; Matthew,0,11,16,16
1746557292513,MMW 12R,A02,892725,Herbst; Matthew,0,10,16,16
1746557293540,MMW 13R,A01,892727,Staff,0,4,16,16
1746557293540,MMW 13R,A02,892728,Staff,0,4,16,16
1746557293540,MMW 13R,A03,958032,Staff,0,4,16,16
1746557293540,MMW 13R,A04,958033,Staff,0,4,16,16
1746557293540,MMW 13R,A05,958034,Staff,0,4,16,16
1746557294569,SIO 295LS,A00,894015,Staff,5,0,25,20
1746557295598,SIO 295S,A00,894020,Staff,5,0,25,20
1746557296624,SIOC 290S,B01,958918,Merrifield; Mark A,14,0,30,16
1746557297655,SIOC 291S,B01,958922,Gabriel; Corey John,14,0,30,16
1746557298680,SOCI 117,A01,895339,Staff,3,0,5,2
1746557299705,WES 237B,A00,894149,Staff,11,0,20,9
1746557301781,AESE 279B,A00,891859,Staff,13,0,35,22
1746557302807,AIP 197,001,891854,Vespa; Emanuel Ignacio,9999,0,9999,0
1746557303833,ANTH 289S,A00,891856,Gagneux; Pascal,12,0,12,0
1746557304858,BENG 196,001,957946,Engler; Adam J.,9996,0,9999,3
1746557305882,BISP 197,001,959851,Wilhelm; James E.,9998,0,9999,1
1746557306907,CAT 124RS,A01,956906,Staff,6,0,25,19
1746557307933,CAT 125RS,A01,922013,Staff,6,0,25,19
1746557308958,CLRE 250,A00,891860,Morris; Sheldon,9995,0,9999,4
1746557311010,CLRE 251R,A00,907817,Mehta; Ravindra L.,9994,0,9999,5
1746557312035,CLRE 252,A00,891864,Cuomo; Raphael Eduardo,9993,0,9999,6
1746557313061,CLRE 253,A00,891867,Vaida; Florin,9994,0,9999,5
1746557313061,CLRE 253,B00,907819,Staff,9999,0,9999,0
1746557314089,CLRE 259,A00,891868,Patel; Hemal,9998,0,9999,1
1746557315116,CLRE 260,A00,891872,Cuomo; Raphael Eduardo,9999,0,9999,0
1746557316142,CLRE 297,001,891888,Cuomo; Raphael Eduardo,9999,0,9999,0
1746557317168,CSE 191,A00,958773,Minnes Kemp; Mor Mia,9995,0,9999,4
1746557318194,CSE 197,001,959846,Minnes Kemp; Mor Mia,9990,0,9999,9
1746557319219,CSS 201S,A01,892054,Mignozzetti; Umberto,26,0,30,4
1746557320799,CSS 202S,A01,892056,Mignozzetti; Umberto,26,0,30,4
1746557321829,DSC 197,001,956898,Eldridge; Justin Matthew,9997,0,9999,2
1746557322856,DSC 297,001,958000,Mazumdar; Arya,9998,0,9999,1
1746557322856,DSC 297,002,959862,Wang; Yusu,9998,0,9999,1
1746557323880,EAP 100,A00,905686,Staff,9778,0,9999,221
1746557324907,ECE 45,A01,892618,Staff,0,0,65,65
1746557326960,ECE 111,A01,892719,Staff,4,0,65,61
1746557327987,ECE 197,001,957920,Mercier; Patrick Philip,9991,0,9999,8
1746557329012,ECON 178,A01,907814,Zhu; Ying,26,0,35,9
1746557330040,EDS 115,A00,895312,Staff,35,0,45,10
1746557331065,EDS 117,A01,895337,Staff,23,0,30,7
1746557332089,EDS 125,A00,895341,Jones; Gabrielle Anastasia,36,0,45,9
1746557333117,EDS 128A,A01,895459,Fargason; Sharon Gayle,44,0,45,1
1746557334142,EDS 128B,A01,895543,Pappas; Elizabeth,44,0,45,1
1746557335171,EDS 139,A00,897203,Pappas; Elizabeth,44,0,45,1
1746557335171,EDS 139,B00,897209,Fargason; Sharon Gayle,41,0,45,4
1746557336198,EDS 201,A00,895545,Staff,22,0,45,23
1746557337262,EDS 203,A01,895581,Halter; Christopher P.,22,0,45,23
1746557338286,EDS 204R,A01,895625,Heinzman; Erica M.,39,0,45,6
1746557338286,EDS 204R,B01,895693,Halter; Christopher P.,10,0,45,35
1746557339312,EDS 206R,A00,895694,Fargason; Sharon Gayle,1,0,30,29
1746557339312,EDS 206R,B00,895695,Choi; Bailey Miyeon,16,0,30,14
1746557340339,EDS 250,A00,895697,Hemans; Patricia Ann Benitez,22,0,45,23
1746557341364,EDS 281,A00,895701,Meyerott; Theresa Ann,1,0,15,14
1746557342387,EDS 284,A00,895736,Meyerott; Theresa Ann,1,0,15,14
1746557343414,EDS 286,A00,897210,Fine; Sarah,0,0,15,15
1746557344441,EDS 289C,A01,895770,Daly; Alan J.,1,0,15,14
1746557345469,EDS 290,A00,897211,Hofstetter; Carolyn,0,0,15,15
1746557346494,LIGM 5A,A00,896162,Fischer-Grunski; Eva K,12,0,20,8
1746557347522,LIGM 5B,A00,896260,Fischer-Grunski; Eva K,17,0,20,3
1746557348548,LIGM 5C,A00,896308,Fischer-Grunski; Eva K,18,0,20,2
1746557349572,LIIT 5AS,A00,896313,Carnelos; Chiara,18,0,20,2
1746557350597,LIIT 5BS,A00,896416,Carnelos; Chiara,20,0,20,0
1746557351623,LIIT 5CS,A00,896564,Carnelos; Chiara,20,0,20,0
1746557352652,LISP 5A,A00,896588,Munoz Sanchez; Alicia,3,0,20,17
1746557353677,LISP 5B,A00,896653,Munoz Sanchez; Alicia,7,0,20,13
1746557354701,LISP 5C,A00,896655,Munoz Sanchez; Alicia,0,1,20,20
1746557355728,MAE 197,001,957918,Kleissl; Jan,9996,0,9999,3
1746557355728,MAE 197,002,959806,Boechler; Nicholas Sebastia,9998,0,9999,1
1746557355728,MAE 197,003,959852,Mullin; Jennifer S,9998,0,9999,1
1746557356753,MATH 2,A01,957937,Staff,33,0,35,2
1746557357779,MATH 197,001,957876,Kedlaya; Kiran S.,9993,0,9999,6
1746557358805,MCWP 40,A00,892729,Duru; Nur,10,0,20,10
1746557358805,MCWP 40,B00,893304,Montejo; Carolina,14,0,20,6
1746557359831,MCWP 40R,A00,893757,Redela; Pamela Morgan,0,5,20,20
1746557360854,MCWP 50,A00,893758,Morshed; Michael James,0,0,20,20
1746557360854,MCWP 50,B00,893761,Bartulis; Jason Michael,17,0,20,3
1746557361878,MCWP 50R,A00,893766,Compas; Sean Matthew,0,1,20,20
1746557361878,MCWP 50R,B00,893769,Carter; Jennifer A,0,1,20,20
1746557361878,MCWP 50R,C00,893771,Krone; Jarret,0,3,20,20
1746557361878,MCWP 50R,D00,893772,Miller; Elizabeth Deen,0,0,20,20
1746557361878,MCWP 50R,E00,893775,Carter; Andrea L,0,1,20,20
1746557362906,MMW 11R,A01,892721,Herbst; Matthew,11,0,27,16
1746557362906,MMW 11R,A02,892722,Herbst; Matthew,0,0,0,3
1746557363932,MMW 12R,A01,892724,Herbst; Matthew,0,11,16,16
1746557363932,MMW 12R,A02,892725,Herbst; Matthew,0,10,16,16
1746557364956,MMW 13R,A01,892727,Staff,0,4,16,16
1746557364956,MMW 13R,A02,892728,Staff,0,4,16,16
1746557364956,MMW 13R,A03,958032,Staff,0,4,16,16
1746557364956,MMW 13R,A04,958033,Staff,0,4,16,16
1746557364956,MMW 13R,A05,958034,Staff,0,4,16,16
1746557365980,SIO 295LS,A00,894015,Staff,5,0,25,20
1746557367005,SIO 295S,A00,894020,Staff,5,0,25,20
1746557368035,SIOC 290S,B01,958918,Merrifield; Mark A,14,0,30,16
1746557369064,SIOC 291S,B01,958922,Gabriel; Corey John,14,0,30,16
1746557370090,SOCI 117,A01,895339,Staff,3,0,5,2
1746557371114,WES 237B,A00,894149,Staff,11,0,20,9
1746557373219,AESE 279B,A00,891859,Staff,13,0,35,22
1746557374243,AIP 197,001,891854,Vespa; Emanuel Ignacio,9999,0,9999,0
1746557375268,ANTH 289S,A00,891856,Gagneux; Pascal,12,0,12,0
1746557376295,BENG 196,001,957946,Engler; Adam J.,9996,0,9999,3
1746557377322,BISP 197,001,959851,Wilhelm; James E.,9998,0,9999,1
1746557378347,CAT 124RS,A01,956906,Staff,6,0,25,19
1746557379373,CAT 125RS,A01,922013,Staff,6,0,25,19
1746557380396,CLRE 250,A00,891860,Morris; Sheldon,9995,0,9999,4
1746557382448,CLRE 251R,A00,907817,Mehta; Ravindra L.,9994,0,9999,5
1746557383474,CLRE 252,A00,891864,Cuomo; Raphael Eduardo,9993,0,9999,6
1746557384499,CLRE 253,A00,891867,Vaida; Florin,9994,0,9999,5
1746557384499,CLRE 253,B00,907819,Staff,9999,0,9999,0
1746557385524,CLRE 259,A00,891868,Patel; Hemal,9998,0,9999,1
1746557386551,CLRE 260,A00,891872,Cuomo; Raphael Eduardo,9999,0,9999,0
1746557387576,CLRE 297,001,891888,Cuomo; Raphael Eduardo,9999,0,9999,0
1746557388602,CSE 191,A00,958773,Minnes Kemp; Mor Mia,9995,0,9999,4
1746557389625,CSE 197,001,959846,Minnes Kemp; Mor Mia,9990,0,9999,9
1746557390651,CSS 201S,A01,892054,Mignozzetti; Umberto,26,0,30,4
1746557391677,CSS 202S,A01,892056,Mignozzetti; Umberto,26,0,30,4
1746557392705,DSC 197,001,956898,Eldridge; Justin Matthew,9997,0,9999,2
1746557393732,DSC 297,001,958000,Mazumdar; Arya,9998,0,9999,1
1746557393732,DSC 297,002,959862,Wang; Yusu,9998,0,9999,1
1746557394757,EAP 100,A00,905686,Staff,9778,0,9999,221
1746557395785,ECE 45,A01,892618,Staff,0,0,65,65
1746557397842,ECE 111,A01,892719,Staff,4,0,65,61
1746557398866,ECE 197,001,957920,Mercier; Patrick Philip,9991,0,9999,8
1746557399891,ECON 178,A01,907814,Zhu; Ying,26,0,35,9
1746557400918,EDS 115,A00,895312,Staff,35,0,45,10
1746557401946,EDS 117,A01,895337,Staff,23,0,30,7
1746557402971,EDS 125,A00,895341,Jones; Gabrielle Anastasia,36,0,45,9
1746557403995,EDS 128A,A01,895459,Fargason; Sharon Gayle,44,0,45,1
1746557405024,EDS 128B,A01,895543,Pappas; Elizabeth,44,0,45,1
1746557406051,EDS 139,A00,897203,Pappas; Elizabeth,44,0,45,1
1746557406051,EDS 139,B00,897209,Fargason; Sharon Gayle,41,0,45,4
1746557407076,EDS 201,A00,895545,Staff,22,0,45,23
1746557408101,EDS 203,A01,895581,Halter; Christopher P.,22,0,45,23
1746557409125,EDS 204R,A01,895625,Heinzman; Erica M.,39,0,45,6
1746557409125,EDS 204R,B01,895693,Halter; Christopher P.,10,0,45,35
1746557410152,EDS 206R,A00,895694,Fargason; Sharon Gayle,1,0,30,29
1746557410152,EDS 206R,B00,895695,Choi; Bailey Miyeon,16,0,30,14
1746557411177,EDS 250,A00,895697,Hemans; Patricia Ann Benitez,22,0,45,23
1746557412204,EDS 281,A00,895701,Meyerott; Theresa Ann,1,0,15,14
1746557413229,EDS 284,A00,895736,Meyerott; Theresa Ann,1,0,15,14
1746557414256,EDS 286,A00,897210,Fine; Sarah,0,0,15,15
1746557415282,EDS 289C,A01,895770,Daly; Alan J.,1,0,15,14
1746557416311,EDS 290,A00,897211,Hofstetter; Carolyn,0,0,15,15
1746557417336,LIGM 5A,A00,896162,Fischer-Grunski; Eva K,12,0,20,8
1746557418361,LIGM 5B,A00,896260,Fischer-Grunski; Eva K,17,0,20,3
1746557419386,LIGM 5C,A00,896308,Fischer-Grunski; Eva K,18,0,20,2
1746557420411,LIIT 5AS,A00,896313,Carnelos; Chiara,18,0,20,2
1746557421439,LIIT 5BS,A00,896416,Carnelos; Chiara,20,0,20,0
1746557422470,LIIT 5CS,A00,896564,Carnelos; Chiara,20,0,20,0
1746557423494,LISP 5A,A00,896588,Munoz Sanchez; Alicia,3,0,20,17
1746557424518,LISP 5B,A00,896653,Munoz Sanchez; Alicia,7,0,20,13
1746557425751,LISP 5C,A00,896655,Munoz Sanchez; Alicia,0,1,20,20
1746557426775,MAE 197,001,957918,Kleissl; Jan,9996,0,9999,3
1746557426775,MAE 197,002,959806,Boechler; Nicholas Sebastia,9998,0,9999,1
1746557426775,MAE 197,003,959852,Mullin; Jennifer S,9998,0,9999,1
1746557427802,MATH 2,A01,957937,Staff,33,0,35,2
1746557428828,MATH 197,001,957876,Kedlaya; Kiran S.,9993,0,9999,6
1746557429852,MCWP 40,A00,892729,Duru; Nur,10,0,20,10
1746557429852,MCWP 40,B00,893304,Montejo; Carolina,14,0,20,6
1746557430878,MCWP 40R,A00,893757,Redela; Pamela Morgan,0,5,20,20
1746557431903,MCWP 50,A00,893758,Morshed; Michael James,0,0,20,20
1746557431903,MCWP 50,B00,893761,Bartulis; Jason Michael,17,0,20,3
1746557432929,MCWP 50R,A00,893766,Compas; Sean Matthew,0,1,20,20
1746557432929,MCWP 50R,B00,893769,Carter; Jennifer A,0,1,20,20
1746557432929,MCWP 50R,C00,893771,Krone; Jarret,0,3,20,20
1746557432929,MCWP 50R,D00,893772,Miller; Elizabeth Deen,0,0,20,20
1746557432929,MCWP 50R,E00,893775,Carter; Andrea L,0,1,20,20
1746557433958,MMW 11R,A01,892721,Herbst; Matthew,11,0,27,16
1746557433958,MMW 11R,A02,892722,Herbst; Matthew,0,0,0,3
1746557434982,MMW 12R,A01,892724,Herbst; Matthew,0,11,16,16
1746557434982,MMW 12R,A02,892725,Herbst; Matthew,0,10,16,16
1746557436010,MMW 13R,A01,892727,Staff,0,4,16,16
1746557436010,MMW 13R,A02,892728,Staff,0,4,16,16
1746557436010,MMW 13R,A03,958032,Staff,0,4,16,16
1746557436010,MMW 13R,A04,958033,Staff,0,4,16,16
1746557436010,MMW 13R,A05,958034,Staff,0,4,16,16
1746557437038,SIO 295LS,A00,894015,Staff,5,0,25,20
1746557438063,SIO 295S,A00,894020,Staff,5,0,25,20
1746557439088,SIOC 290S,B01,958918,Merrifield; Mark A,14,0,30,16
1746557440116,SIOC 291S,B01,958922,Gabriel; Corey John,14,0,30,16
1746557441182,SOCI 117,A01,895339,Staff,3,0,5,2
1746557442208,WES 237B,A00,894149,Staff,11,0,20,9
1746557444268,AESE 279B,A00,891859,Staff,13,0,35,22
1746557445293,AIP 197,001,891854,Vespa; Emanuel Ignacio,9999,0,9999,0
1746557446317,ANTH 289S,A00,891856,Gagneux; Pascal,12,0,12,0
1746557447341,BENG 196,001,957946,Engler; Adam J.,9996,0,9999,3
1746557448371,BISP 197,001,959851,Wilhelm; James E.,9998,0,9999,1
1746557449394,CAT 124RS,A01,956906,Staff,6,0,25,19
1746557450419,CAT 125RS,A01,922013,Staff,6,0,25,19
1746557451445,CLRE 250,A00,891860,Morris; Sheldon,9995,0,9999,4
1746557453498,CLRE 251R,A00,907817,Mehta; Ravindra L.,9994,0,9999,5
1746557454522,CLRE 252,A00,891864,Cuomo; Raphael Eduardo,9993,0,9999,6
1746557455548,CLRE 253,A00,891867,Vaida; Florin,9994,0,9999,5
1746557455548,CLRE 253,B00,907819,Staff,9999,0,9999,0
1746557456573,CLRE 259,A00,891868,Patel; Hemal,9998,0,9999,1
1746557457598,CLRE 260,A00,891872,Cuomo; Raphael Eduardo,9999,0,9999,0
1746557458623,CLRE 297,001,891888,Cuomo; Raphael Eduardo,9999,0,9999,0
1746557459647,CSE 191,A00,958773,Minnes Kemp; Mor Mia,9995,0,9999,4
1746557460672,CSE 197,001,959846,Minnes Kemp; Mor Mia,9990,0,9999,9
1746557461697,CSS 201S,A01,892054,Mignozzetti; Umberto,26,0,30,4
1746557462722,CSS 202S,A01,892056,Mignozzetti; Umberto,26,0,30,4
1746557463749,DSC 197,001,956898,Eldridge; Justin Matthew,9997,0,9999,2
1746557464776,DSC 297,001,958000,Mazumdar; Arya,9998,0,9999,1
1746557464776,DSC 297,002,959862,Wang; Yusu,9998,0,9999,1
1746557465802,EAP 100,A00,905686,Staff,9778,0,9999,221
1746557466828,ECE 45,A01,892618,Staff,0,0,65,65
1746557468882,ECE 111,A01,892719,Staff,4,0,65,61
1746557469905,ECE 197,001,957920,Mercier; Patrick Philip,9991,0,9999,8
1746557470933,ECON 178,A01,907814,Zhu; Ying,26,0,35,9
1746557471961,EDS 115,A00,895312,Staff,35,0,45,10
1746557472986,EDS 117,A01,895337,Staff,23,0,30,7
1746557474011,EDS 125,A00,895341,Jones; Gabrielle Anastasia,36,0,45,9
1746557475036,EDS 128A,A01,895459,Fargason; Sharon Gayle,44,0,45,1
1746557476064,EDS 128B,A01,895543,Pappas; Elizabeth,44,0,45,1
1746557477090,EDS 139,A00,897203,Pappas; Elizabeth,44,0,45,1
1746557477090,EDS 139,B00,897209,Fargason; Sharon Gayle,41,0,45,4
1746557478117,EDS 201,A00,895545,Staff,22,0,45,23
1746557479142,EDS 203,A01,895581,Halter; Christopher P.,22,0,45,23
1746557480168,EDS 204R,A01,895625,Heinzman; Erica M.,39,0,45,6
1746557480168,EDS 204R,B01,895693,Halter; Christopher P.,10,0,45,35
1746557481194,EDS 206R,A00,895694,Fargason; Sharon Gayle,1,0,30,29
1746557481194,EDS 206R,B00,895695,Choi; Bailey Miyeon,16,0,30,14
1746557482225,EDS 250,A00,895697,Hemans; Patricia Ann Benitez,22,0,45,23
1746557483251,EDS 281,A00,895701,Meyerott; Theresa Ann,1,0,15,14
1746557484277,EDS 284,A00,895736,Meyerott; Theresa Ann,1,0,15,14
1746557485305,EDS 286,A00,897210,Fine; Sarah,0,0,15,15
1746557486331,EDS 289C,A01,895770,Daly; Alan J.,1,0,15,14
1746557487364,EDS 290,A00,897211,Hofstetter; Carolyn,0,0,15,15
1746557488391,LIGM 5A,A00,896162,Fischer-Grunski; Eva K,12,0,20,8
1746557489416,LIGM 5B,A00,896260,Fischer-Grunski; Eva K,17,0,20,3
1746557490440,LIGM 5C,A00,896308,Fischer-Grunski; Eva K,18,0,20,2
1746557491464,LIIT 5AS,A00,896313,Carnelos; Chiara,18,0,20,2
1746557492487,LIIT 5BS,A00,896416,Carnelos; Chiara,20,0,20,0
1746557493515,LIIT 5CS,A00,896564,Carnelos; Chiara,20,0,20,0
1746557494539,LISP 5A,A00,896588,Munoz Sanchez; Alicia,3,0,20,17
1746557495569,LISP 5B,A00,896653,Munoz Sanchez; Alicia,7,0,20,13
1746557496595,LISP 5C,A00,896655,Munoz Sanchez; Alicia,0,1,20,20
1746557497624,MAE 197,001,957918,Kleissl; Jan,9996,0,9999,3
1746557497624,MAE 197,002,959806,Boechler; Nicholas Sebastia,9998,0,9999,1
1746557497624,MAE 197,003,959852,Mullin; Jennifer S,9998,0,9999,1
1746557498648,MATH 2,A01,957937,Staff,33,0,35,2
1746557499675,MATH 197,001,957876,Kedlaya; Kiran S.,9993,0,9999,6
1746557500701,MCWP 40,A00,892729,Duru; Nur,10,0,20,10
1746557500701,MCWP 40,B00,893304,Montejo; Carolina,14,0,20,6
1746557501730,MCWP 40R,A00,893757,Redela; Pamela Morgan,0,5,20,20
1746557502757,MCWP 50,A00,893758,Morshed; Michael James,0,0,20,20
1746557502757,MCWP 50,B00,893761,Bartulis; Jason Michael,17,0,20,3
1746557503782,MCWP 50R,A00,893766,Compas; Sean Matthew,0,1,20,20
1746557503782,MCWP 50R,B00,893769,Carter; Jennifer A,0,1,20,20
1746557503782,MCWP 50R,C00,893771,Krone; Jarret,0,3,20,20
1746557503782,MCWP 50R,D00,893772,Miller; Elizabeth Deen,0,0,20,20
1746557503782,MCWP 50R,E00,893775,Carter; Andrea L,0,1,20,20
1746557504808,MMW 11R,A01,892721,Herbst; Matthew,11,0,27,16
1746557504808,MMW 11R,A02,892722,Herbst; Matthew,0,0,0,3
1746557505833,MMW 12R,A01,892724,Herbst; Matthew,0,11,16,16
1746557505833,MMW 12R,A02,892725,Herbst; Matthew,0,10,16,16
1746557506858,MMW 13R,A01,892727,Staff,0,4,16,16
1746557506858,MMW 13R,A02,892728,Staff,0,4,16,16
1746557506858,MMW 13R,A03,958032,Staff,0,4,16,16
1746557506858,MMW 13R,A04,958033,Staff,0,4,16,16
1746557506858,MMW 13R,A05,958034,Staff,0,4,16,16
1746557507883,SIO 295LS,A00,894015,Staff,5,0,25,20
1746557508906,SIO 295S,A00,894020,Staff,5,0,25,20
1746557509931,SIOC 290S,B01,958918,Merrifield; Mark A,14,0,30,16
1746557510956,SIOC 291S,B01,958922,Gabriel; Corey John,14,0,30,16
1746557511980,SOCI 117,A01,895339,Staff,3,0,5,2
1746557513005,WES 237B,A00,894149,Staff,11,0,20,9
1746557515072,AESE 279B,A00,891859,Staff,13,0,35,22
1746557516097,AIP 197,001,891854,Vespa; Emanuel Ignacio,9999,0,9999,0
1746557517123,ANTH 289S,A00,891856,Gagneux; Pascal,12,0,12,0
1746557518146,BENG 196,001,957946,Engler; Adam J.,9996,0,9999,3
1746557519168,BISP 197,001,959851,Wilhelm; James E.,9998,0,9999,1
1746557520213,CAT 124RS,A01,956906,Staff,6,0,25,19
1746557521236,CAT 125RS,A01,922013,Staff,6,0,25,19
1746557522261,CLRE 250,A00,891860,Morris; Sheldon,9995,0,9999,4
1746557524313,CLRE 251R,A00,907817,Mehta; Ravindra L.,9994,0,9999,5
1746557525338,CLRE 252,A00,891864,Cuomo; Raphael Eduardo,9993,0,9999,6
1746557526362,CLRE 253,A00,891867,Vaida; Florin,9994,0,9999,5
1746557526362,CLRE 253,B00,907819,Staff,9999,0,9999,0
1746557527396,CLRE 259,A00,891868,Patel; Hemal,9998,0,9999,1
1746557528422,CLRE 260,A00,891872,Cuomo; Raphael Eduardo,9999,0,9999,0
1746557529449,CLRE 297,001,891888,Cuomo; Raphael Eduardo,9999,0,9999,0
1746557530478,CSE 191,A00,958773,Minnes Kemp; Mor Mia,9995,0,9999,4
1746557531503,CSE 197,001,959846,Minnes Kemp; Mor Mia,9990,0,9999,9
1746557532531,CSS 201S,A01,892054,Mignozzetti; Umberto,26,0,30,4
1746557533554,CSS 202S,A01,892056,Mignozzetti; Umberto,26,0,30,4
1746557534583,DSC 197,001,956898,Eldridge; Justin Matthew,9997,0,9999,2
1746557535608,DSC 297,001,958000,Mazumdar; Arya,9998,0,9999,1
1746557535608,DSC 297,002,959862,Wang; Yusu,9998,0,9999,1
1746557536633,EAP 100,A00,905686,Staff,9778,0,9999,221
1746557537662,ECE 45,A01,892618,Staff,0,0,65,65
1746557539712,ECE 111,A01,892719,Staff,4,0,65,61
1746557540738,ECE 197,001,957920,Mercier; Patrick Philip,9991,0,9999,8
1746557541762,ECON 178,A01,907814,Zhu; Ying,26,0,35,9
1746557542788,EDS 115,A00,895312,Staff,35,0,45,10
1746557543817,EDS 117,A01,895337,Staff,23,0,30,7
1746557544841,EDS 125,A00,895341,Jones; Gabrielle Anastasia,36,0,45,9
1746557545864,EDS 128A,A01,895459,Fargason; Sharon Gayle,44,0,45,1
1746557546892,EDS 128B,A01,895543,Pappas; Elizabeth,44,0,45,1
1746557547917,EDS 139,A00,897203,Pappas; Elizabeth,44,0,45,1
1746557547917,EDS 139,B00,897209,Fargason; Sharon Gayle,41,0,45,4
1746557548945,EDS 201,A00,895545,Staff,22,0,45,23
1746557549969,EDS 203,A01,895581,Halter; Christopher P.,22,0,45,23
1746557550993,EDS 204R,A01,895625,Heinzman; Erica M.,39,0,45,6
1746557550993,EDS 204R,B01,895693,Halter; Christopher P.,10,0,45,35
1746557552018,EDS 206R,A00,895694,Fargason; Sharon Gayle,1,0,30,29
1746557552018,EDS 206R,B00,895695,Choi; Bailey Miyeon,16,0,30,14
1746557553043,EDS 250,A00,895697,Hemans; Patricia Ann Benitez,22,0,45,23
1746557554068,EDS 281,A00,895701,Meyerott; Theresa Ann,1,0,15,14
1746557555094,EDS 284,A00,895736,Meyerott; Theresa Ann,1,0,15,14
1746557556118,EDS 286,A00,897210,Fine; Sarah,0,0,15,15
1746557557144,EDS 289C,A01,895770,Daly; Alan J.,1,0,15,14
1746557558170,EDS 290,A00,897211,Hofstetter; Carolyn,0,0,15,15
1746557559197,LIGM 5A,A00,896162,Fischer-Grunski; Eva K,12,0,20,8
1746557560222,LIGM 5B,A00,896260,Fischer-Grunski; Eva K,17,0,20,3
1746557561246,LIGM 5C,A00,896308,Fischer-Grunski; Eva K,18,0,20,2
1746557562271,LIIT 5AS,A00,896313,Carnelos; Chiara,18,0,20,2
1746557563295,LIIT 5BS,A00,896416,Carnelos; Chiara,20,0,20,0
1746557564323,LIIT 5CS,A00,896564,Carnelos; Chiara,20,0,20,0
1746557565350,LISP 5A,A00,896588,Munoz Sanchez; Alicia,3,0,20,17
1746557566374,LISP 5B,A00,896653,Munoz Sanchez; Alicia,7,0,20,13
1746557567397,LISP 5C,A00,896655,Munoz Sanchez; Alicia,0,1,20,20
1746557568421,MAE 197,001,957918,Kleissl; Jan,9996,0,9999,3
1746557568421,MAE 197,002,959806,Boechler; Nicholas Sebastia,9998,0,9999,1
1746557568421,MAE 197,003,959852,Mullin; Jennifer S,9998,0,9999,1
1746557569446,MATH 2,A01,957937,Staff,33,0,35,2
1746557570471,MATH 197,001,957876,Kedlaya; Kiran S.,9993,0,9999,6
1746557571495,MCWP 40,A00,892729,Duru; Nur,10,0,20,10
1746557571495,MCWP 40,B00,893304,Montejo; Carolina,14,0,20,6
1746557572520,MCWP 40R,A00,893757,Redela; Pamela Morgan,0,5,20,20
1746557573545,MCWP 50,A00,893758,Morshed; Michael James,0,0,20,20
1746557573545,MCWP 50,B00,893761,Bartulis; Jason Michael,17,0,20,3
1746557574574,MCWP 50R,A00,893766,Compas; Sean Matthew,0,1,20,20
1746557574574,MCWP 50R,B00,893769,Carter; Jennifer A,0,1,20,20
1746557574574,MCWP 50R,C00,893771,Krone; Jarret,0,3,20,20
1746557574574,MCWP 50R,D00,893772,Miller; Elizabeth Deen,0,0,20,20
1746557574574,MCWP 50R,E00,893775,Carter; Andrea L,0,1,20,20
1746557575599,MMW 11R,A01,892721,Herbst; Matthew,11,0,27,16
1746557575599,MMW 11R,A02,892722,Herbst; Matthew,0,0,0,3
1746557576627,MMW 12R,A01,892724,Herbst; Matthew,0,11,16,16
1746557576627,MMW 12R,A02,892725,Herbst; Matthew,0,10,16,16
1746557577659,MMW 13R,A01,892727,Staff,0,4,16,16
1746557577659,MMW 13R,A02,892728,Staff,0,4,16,16
1746557577659,MMW 13R,A03,958032,Staff,0,4,16,16
1746557577659,MMW 13R,A04,958033,Staff,0,4,16,16
1746557577659,MMW 13R,A05,958034,Staff,0,4,16,16
1746557578683,SIO 295LS,A00,894015,Staff,5,0,25,20
1746557579709,SIO 295S,A00,894020,Staff,5,0,25,20
1746557580734,SIOC 290S,B01,958918,Merrifield; Mark A,14,0,30,16
1746557581765,SIOC 291S,B01,958922,Gabriel; Corey John,14,0,30,16
1746557582790,SOCI 117,A01,895339,Staff,3,0,5,2
1746557583815,WES 237B,A00,894149,Staff,11,0,20,9
1746557585881,AESE 279B,A00,891859,Staff,13,0,35,22
1746557586905,AIP 197,001,891854,Vespa; Emanuel Ignacio,9999,0,9999,0
1746557587928,ANTH 289S,A00,891856,Gagneux; Pascal,12,0,12,0
1746557588956,BENG 196,001,957946,Engler; Adam J.,9996,0,9999,3
1746557589980,BISP 197,001,959851,Wilhelm; James E.,9998,0,9999,1
1746557591006,CAT 124RS,A01,956906,Staff,6,0,25,19
1746557592034,CAT 125RS,A01,922013,Staff,6,0,25,19
1746557593062,CLRE 250,A00,891860,Morris; Sheldon,9995,0,9999,4
1746557595114,CLRE 251R,A00,907817,Mehta; Ravindra L.,9994,0,9999,5
1746557596142,CLRE 252,A00,891864,Cuomo; Raphael Eduardo,9993,0,9999,6
1746557597170,CLRE 253,A00,891867,Vaida; Florin,9994,0,9999,5
1746557597170,CLRE 253,B00,907819,Staff,9999,0,9999,0
1746557598196,CLRE 259,A00,891868,Patel; Hemal,9998,0,9999,1
1746557599221,CLRE 260,A00,891872,Cuomo; Raphael Eduardo,9999,0,9999,0
1746557600248,CLRE 297,001,891888,Cuomo; Raphael Eduardo,9999,0,9999,0
1746557601274,CSE 191,A00,958773,Minnes Kemp; Mor Mia,9995,0,9999,4
1746557602299,CSE 197,001,959846,Minnes Kemp; Mor Mia,9990,0,9999,9
1746557603327,CSS 201S,A01,892054,Mignozzetti; Umberto,26,0,30,4
1746557604353,CSS 202S,A01,892056,Mignozzetti; Umberto,26,0,30,4
1746557605379,DSC 197,001,956898,Eldridge; Justin Matthew,9997,0,9999,2
1746557606405,DSC 297,001,958000,Mazumdar; Arya,9998,0,9999,1
1746557606405,DSC 297,002,959862,Wang; Yusu,9998,0,9999,1
1746557607430,EAP 100,A00,905686,Staff,9778,0,9999,221
1746557608455,ECE 45,A01,892618,Staff,0,0,65,65
1746557610505,ECE 111,A01,892719,Staff,4,0,65,61
1746557611531,ECE 197,001,957920,Mercier; Patrick Philip,9991,0,9999,8
1746557612556,ECON 178,A01,907814,Zhu; Ying,26,0,35,9
1746557613580,EDS 115,A00,895312,Staff,35,0,45,10
1746557614606,EDS 117,A01,895337,Staff,23,0,30,7
1746557615634,EDS 125,A00,895341,Jones; Gabrielle Anastasia,36,0,45,9
1746557616662,EDS 128A,A01,895459,Fargason; Sharon Gayle,44,0,45,1
1746557617692,EDS 128B,A01,895543,Pappas; Elizabeth,44,0,45,1
1746557618719,EDS 139,A00,897203,Pappas; Elizabeth,44,0,45,1
1746557618719,EDS 139,B00,897209,Fargason; Sharon Gayle,41,0,45,4
1746557619746,EDS 201,A00,895545,Staff,22,0,45,23
1746557620774,EDS 203,A01,895581,Halter; Christopher P.,22,0,45,23
1746557621799,EDS 204R,A01,895625,Heinzman; Erica M.,39,0,45,6
1746557621799,EDS 204R,B01,895693,Halter; Christopher P.,10,0,45,35
1746557622823,EDS 206R,A00,895694,Fargason; Sharon Gayle,1,0,30,29
1746557622823,EDS 206R,B00,895695,Choi; Bailey Miyeon,16,0,30,14
1746557623849,EDS 250,A00,895697,Hemans; Patricia Ann Benitez,22,0,45,23
1746557624874,EDS 281,A00,895701,Meyerott; Theresa Ann,1,0,15,14
1746557625899,EDS 284,A00,895736,Meyerott; Theresa Ann,1,0,15,14
1746557626922,EDS 286,A00,897210,Fine; Sarah,0,0,15,15
1746557627949,EDS 289C,A01,895770,Daly; Alan J.,1,0,15,14
1746557628975,EDS 290,A00,897211,Hofstetter; Carolyn,0,0,15,15
1746557630001,LIGM 5A,A00,896162,Fischer-Grunski; Eva K,12,0,20,8
1746557631026,LIGM 5B,A00,896260,Fischer-Grunski; Eva K,17,0,20,3
1746557632054,LIGM 5C,A00,896308,Fischer-Grunski; Eva K,18,0,20,2
1746557633081,LIIT 5AS,A00,896313,Carnelos; Chiara,18,0,20,2
1746557634107,LIIT 5BS,A00,896416,Carnelos; Chiara,20,0,20,0
1746557635138,LIIT 5CS,A00,896564,Carnelos; Chiara,20,0,20,0
1746557636165,LISP 5A,A00,896588,Munoz Sanchez; Alicia,3,0,20,17
1746557637190,LISP 5B,A00,896653,Munoz Sanchez; Alicia,7,0,20,13
1746557638215,LISP 5C,A00,896655,Munoz Sanchez; Alicia,0,1,20,20
1746557639242,MAE 197,001,957918,Kleissl; Jan,9996,0,9999,3
1746557639242,MAE 197,002,959806,Boechler; Nicholas Sebastia,9998,0,9999,1
1746557639242,MAE 197,003,959852,Mullin; Jennifer S,9998,0,9999,1
1746557640291,MATH 2,A01,957937,Staff,33,0,35,2
1746557641319,MATH 197,001,957876,Kedlaya; Kiran S.,9993,0,9999,6
1746557642343,MCWP 40,A00,892729,Duru; Nur,10,0,20,10
1746557642343,MCWP 40,B00,893304,Montejo; Carolina,14,0,20,6
1746557643369,MCWP 40R,A00,893757,Redela; Pamela Morgan,0,5,20,20
1746557644391,MCWP 50,A00,893758,Morshed; Michael James,0,0,20,20
1746557644391,MCWP 50,B00,893761,Bartulis; Jason Michael,17,0,20,3
1746557645417,MCWP 50R,A00,893766,Compas; Sean Matthew,0,1,20,20
1746557645417,MCWP 50R,B00,893769,Carter; Jennifer A,0,1,20,20
1746557645417,MCWP 50R,C00,893771,Krone; Jarret,0,3,20,20
1746557645417,MCWP 50R,D00,893772,Miller; Elizabeth Deen,0,0,20,20
1746557645417,MCWP 50R,E00,893775,Carter; Andrea L,0,1,20,20
1746557646442,MMW 11R,A01,892721,Herbst; Matthew,11,0,27,16
1746557646442,MMW 11R,A02,892722,Herbst; Matthew,0,0,0,3
1746557647469,MMW 12R,A01,892724,Herbst; Matthew,0,11,16,16
1746557647469,MMW 12R,A02,892725,Herbst; Matthew,0,10,16,16
1746557648494,MMW 13R,A01,892727,Staff,0,4,16,16
1746557648494,MMW 13R,A02,892728,Staff,0,4,16,16
1746557648494,MMW 13R,A03,958032,Staff,0,4,16,16
1746557648494,MMW 13R,A04,958033,Staff,0,4,16,16
1746557648494,MMW 13R,A05,958034,Staff,0,4,16,16
1746557649520,SIO 295LS,A00,894015,Staff,5,0,25,20
1746557650544,SIO 295S,A00,894020,Staff,5,0,25,20
1746557651573,SIOC 290S,B01,958918,Merrifield; Mark A,14,0,30,16
1746557652603,SIOC 291S,B01,958922,Gabriel; Corey John,14,0,30,16
1746557653627,SOCI 117,A01,895339,Staff,3,0,5,2
1746557654653,WES 237B,A00,894149,Staff,11,0,20,9
1746557656713,AESE 279B,A00,891859,Staff,13,0,35,22
1746557657739,AIP 197,001,891854,Vespa; Emanuel Ignacio,9999,0,9999,0
1746557658764,ANTH 289S,A00,891856,Gagneux; Pascal,12,0,12,0
1746557659790,BENG 196,001,957946,Engler; Adam J.,9996,0,9999,3
1746557660814,BISP 197,001,959851,Wilhelm; James E.,9998,0,9999,1
1746557661840,CAT 124RS,A01,956906,Staff,6,0,25,19
1746557662864,CAT 125RS,A01,922013,Staff,6,0,25,19
1746557663892,CLRE 250,A00,891860,Morris; Sheldon,9995,0,9999,4
1746557665946,CLRE 251R,A00,907817,Mehta; Ravindra L.,9994,0,9999,5
1746557666976,CLRE 252,A00,891864,Cuomo; Raphael Eduardo,9993,0,9999,6
1746557667999,CLRE 253,A00,891867,Vaida; Florin,9994,0,9999,5
1746557667999,CLRE 253,B00,907819,Staff,9999,0,9999,0
1746557669024,CLRE 259,A00,891868,Patel; Hemal,9998,0,9999,1
1746557670051,CLRE 260,A00,891872,Cuomo; Raphael Eduardo,9999,0,9999,0
1746557671076,CLRE 297,001,891888,Cuomo; Raphael Eduardo,9999,0,9999,0
1746557672103,CSE 191,A00,958773,Minnes Kemp; Mor Mia,9995,0,9999,4
1746557673131,CSE 197,001,959846,Minnes Kemp; Mor Mia,9990,0,9999,9
1746557674157,CSS 201S,A01,892054,Mignozzetti; Umberto,26,0,30,4
1746557675187,CSS 202S,A01,892056,Mignozzetti; Umberto,26,0,30,4
1746557676213,DSC 197,001,956898,Eldridge; Justin Matthew,9997,0,9999,2
1746557677264,DSC 297,001,958000,Mazumdar; Arya,9998,0,9999,1
1746557677264,DSC 297,002,959862,Wang; Yusu,9998,0,9999,1
1746557678291,EAP 100,A00,905686,Staff,9778,0,9999,221
1746557679319,ECE 45,A01,892618,Staff,0,0,65,65
1746557681368,ECE 111,A01,892719,Staff,4,0,65,61
1746557682391,ECE 197,001,957920,Mercier; Patrick Philip,9991,0,9999,8
1746557683419,ECON 178,A01,907814,Zhu; Ying,26,0,35,9
1746557684443,EDS 115,A00,895312,Staff,35,0,45,10
1746557685469,EDS 117,A01,895337,Staff,23,0,30,7
1746557686493,EDS 125,A00,895341,Jones; Gabrielle Anastasia,36,0,45,9
1746557687518,EDS 128A,A01,895459,Fargason; Sharon Gayle,44,0,45,1
1746557688545,EDS 128B,A01,895543,Pappas; Elizabeth,44,0,45,1
1746557689571,EDS 139,A00,897203,Pappas; Elizabeth,44,0,45,1
1746557689571,EDS 139,B00,897209,Fargason; Sharon Gayle,41,0,45,4
1746557690598,EDS 201,A00,895545,Staff,22,0,45,23
1746557691624,EDS 203,A01,895581,Halter; Christopher P.,22,0,45,23
1746557692649,EDS 204R,A01,895625,Heinzman; Erica M.,39,0,45,6
1746557692649,EDS 204R,B01,895693,Halter; Christopher P.,10,0,45,35
1746557693673,EDS 206R,A00,895694,Fargason; Sharon Gayle,1,0,30,29
1746557693673,EDS 206R,B00,895695,Choi; Bailey Miyeon,16,0,30,14
1746557694698,EDS 250,A00,895697,Hemans; Patricia Ann Benitez,22,0,45,23
1746557695725,EDS 281,A00,895701,Meyerott; Theresa Ann,1,0,15,14
1746557696752,EDS 284,A00,895736,Meyerott; Theresa Ann,1,0,15,14
1746557697776,EDS 286,A00,897210,Fine; Sarah,0,0,15,15
1746557698800,EDS 289C,A01,895770,Daly; Alan J.,1,0,15,14
1746557700335,EDS 290,A00,897211,Hofstetter; Carolyn,0,0,15,15
1746557701359,LIGM 5A,A00,896162,Fischer-Grunski; Eva K,12,0,20,8
1746557702383,LIGM 5B,A00,896260,Fischer-Grunski; Eva K,17,0,20,3
1746557703409,LIGM 5C,A00,896308,Fischer-Grunski; Eva K,18,0,20,2
1746557704434,LIIT 5AS,A00,896313,Carnelos; Chiara,18,0,20,2
1746557705459,LIIT 5BS,A00,896416,Carnelos; Chiara,20,0,20,0
1746557706486,LIIT 5CS,A00,896564,Carnelos; Chiara,20,0,20,0
1746557707514,LISP 5A,A00,896588,Munoz Sanchez; Alicia,3,0,20,17
1746557708538,LISP 5B,A00,896653,Munoz Sanchez; Alicia,7,0,20,13
1746557709562,LISP 5C,A00,896655,Munoz Sanchez; Alicia,0,1,20,20
1746557710588,MAE 197,001,957918,Kleissl; Jan,9996,0,9999,3
1746557710588,MAE 197,002,959806,Boechler; Nicholas Sebastia,9998,0,9999,1
1746557710588,MAE 197,003,959852,Mullin; Jennifer S,9998,0,9999,1
1746557711615,MATH 2,A01,957937,Staff,33,0,35,2
1746557712640,MATH 197,001,957876,Kedlaya; Kiran S.,9993,0,9999,6
1746557713665,MCWP 40,A00,892729,Duru; Nur,10,0,20,10
1746557713665,MCWP 40,B00,893304,Montejo; Carolina,14,0,20,6
1746557714688,MCWP 40R,A00,893757,Redela; Pamela Morgan,0,5,20,20
1746557715751,MCWP 50,A00,893758,Morshed; Michael James,0,0,20,20
1746557715751,MCWP 50,B00,893761,Bartulis; Jason Michael,17,0,20,3
1746557716777,MCWP 50R,A00,893766,Compas; Sean Matthew,0,1,20,20
1746557716777,MCWP 50R,B00,893769,Carter; Jennifer A,0,1,20,20
1746557716777,MCWP 50R,C00,893771,Krone; Jarret,0,3,20,20
1746557716777,MCWP 50R,D00,893772,Miller; Elizabeth Deen,0,0,20,20
1746557716777,MCWP 50R,E00,893775,Carter; Andrea L,0,1,20,20
1746557717803,MMW 11R,A01,892721,Herbst; Matthew,11,0,27,16
1746557717803,MMW 11R,A02,892722,Herbst; Matthew,0,0,0,3
1746557718831,MMW 12R,A01,892724,Herbst; Matthew,0,11,16,16
1746557718831,MMW 12R,A02,892725,Herbst; Matthew,0,10,16,16
1746557719857,MMW 13R,A01,892727,Staff,0,4,16,16
1746557719857,MMW 13R,A02,892728,Staff,0,4,16,16
1746557719857,MMW 13R,A03,958032,Staff,0,4,16,16
1746557719857,MMW 13R,A04,958033,Staff,0,4,16,16
1746557719857,MMW 13R,A05,958034,Staff,0,4,16,16
1746557720883,SIO 295LS,A00,894015,Staff,5,0,25,20
1746557721910,SIO 295S,A00,894020,Staff,5,0,25,20
1746557722936,SIOC 290S,B01,958918,Merrifield; Mark A,14,0,30,16
1746557723962,SIOC 291S,B01,958922,Gabriel; Corey John,14,0,30,16
1746557724987,SOCI 117,A01,895339,Staff,3,0,5,2
1746557726013,WES 237B,A00,894149,Staff,11,0,20,9
1746557728081,AESE 279B,A00,891859,Staff,13,0,35,22
1746557729108,AIP 197,001,891854,Vespa; Emanuel Ignacio,9999,0,9999,0
1746557730137,ANTH 289S,A00,891856,Gagneux; Pascal,12,0,12,0
1746557731166,BENG 196,001,957946,Engler; Adam J.,9996,0,9999,3
1746557732193,BISP 197,001,959851,Wilhelm; James E.,9998,0,9999,1
1746557733216,CAT 124RS,A01,956906,Staff,6,0,25,19
1746557734244,CAT 125RS,A01,922013,Staff,6,0,25,19
1746557735268,CLRE 250,A00,891860,Morris; Sheldon,9995,0,9999,4
1746557737320,CLRE 251R,A00,907817,Mehta; Ravindra L.,9994,0,9999,5
1746557738349,CLRE 252,A00,891864,Cuomo; Raphael Eduardo,9993,0,9999,6
1746557739377,CLRE 253,A00,891867,Vaida; Florin,9994,0,9999,5
1746557739377,CLRE 253,B00,907819,Staff,9999,0,9999,0
1746557740402,CLRE 259,A00,891868,Patel; Hemal,9998,0,9999,1
1746557741429,CLRE 260,A00,891872,Cuomo; Raphael Eduardo,9999,0,9999,0
1746557742454,CLRE 297,001,891888,Cuomo; Raphael Eduardo,9999,0,9999,0
1746557743480,CSE 191,A00,958773,Minnes Kemp; Mor Mia,9995,0,9999,4
1746557744505,CSE 197,001,959846,Minnes Kemp; Mor Mia,9990,0,9999,9
1746557745534,CSS 201S,A01,892054,Mignozzetti; Umberto,26,0,30,4
1746557746559,CSS 202S,A01,892056,Mignozzetti; Umberto,26,0,30,4
1746557747584,DSC 197,001,956898,Eldridge; Justin Matthew,9997,0,9999,2
1746557748612,DSC 297,001,958000,Mazumdar; Arya,9998,0,9999,1
1746557748612,DSC 297,002,959862,Wang; Yusu,9998,0,9999,1
1746557749638,EAP 100,A00,905686,Staff,9778,0,9999,221
1746557750663,ECE 45,A01,892618,Staff,0,0,65,65
1746557752715,ECE 111,A01,892719,Staff,4,0,65,61
1746557753743,ECE 197,001,957920,Mercier; Patrick Philip,9991,0,9999,8
1746557754771,ECON 178,A01,907814,Zhu; Ying,26,0,35,9
1746557755807,EDS 115,A00,895312,Staff,35,0,45,10
1746557756833,EDS 117,A01,895337,Staff,23,0,30,7
1746557757860,EDS 125,A00,895341,Jones; Gabrielle Anastasia,36,0,45,9
1746557758887,EDS 128A,A01,895459,Fargason; Sharon Gayle,44,0,45,1
1746557759914,EDS 128B,A01,895543,Pappas; Elizabeth,44,0,45,1
1746557760941,EDS 139,A00,897203,Pappas; Elizabeth,44,0,45,1
1746557760941,EDS 139,B00,897209,Fargason; Sharon Gayle,41,0,45,4
1746557761967,EDS 201,A00,895545,Staff,22,0,45,23
1746557762994,EDS 203,A01,895581,Halter; Christopher P.,22,0,45,23
1746557764017,EDS 204R,A01,895625,Heinzman; Erica M.,39,0,45,6
1746557764017,EDS 204R,B01,895693,Halter; Christopher P.,10,0,45,35
1746557765046,EDS 206R,A00,895694,Fargason; Sharon Gayle,1,0,30,29
1746557765046,EDS 206R,B00,895695,Choi; Bailey Miyeon,16,0,30,14
1746557766074,EDS 250,A00,895697,Hemans; Patricia Ann Benitez,22,0,45,23
1746557767098,EDS 281,A00,895701,Meyerott; Theresa Ann,1,0,15,14
1746557768125,EDS 284,A00,895736,Meyerott; Theresa Ann,1,0,15,14
1746557769150,EDS 286,A00,897210,Fine; Sarah,0,0,15,15
1746557770178,EDS 289C,A01,895770,Daly; Alan J.,1,0,15,14
1746557771205,EDS 290,A00,897211,Hofstetter; Carolyn,0,0,15,15
1746557772229,LIGM 5A,A00,896162,Fischer-Grunski; Eva K,12,0,20,8
1746557773256,LIGM 5B,A00,896260,Fischer-Grunski; Eva K,17,0,20,3
1746557774285,LIGM 5C,A00,896308,Fischer-Grunski; Eva K,18,0,20,2
1746557775312,LIIT 5AS,A00,896313,Carnelos; Chiara,18,0,20,2
1746557776337,LIIT 5BS,A00,896416,Carnelos; Chiara,20,0,20,0
1746557777365,LIIT 5CS,A00,896564,Carnelos; Chiara,20,0,20,0
1746557778393,LISP 5A,A00,896588,Munoz Sanchez; Alicia,3,0,20,17
1746557779418,LISP 5B,A00,896653,Munoz Sanchez; Alicia,7,0,20,13
1746557780445,LISP 5C,A00,896655,Munoz Sanchez; Alicia,0,1,20,20
1746557781471,MAE 197,001,957918,Kleissl; Jan,9996,0,9999,3
1746557781471,MAE 197,002,959806,Boechler; Nicholas Sebastia,9998,0,9999,1
1746557781471,MAE 197,003,959852,Mullin; Jennifer S,9998,0,9999,1
1746557782495,MATH 2,A01,957937,Staff,33,0,35,2
1746557783522,MATH 197,001,957876,Kedlaya; Kiran S.,9993,0,9999,6
1746557784550,MCWP 40,A00,892729,Duru; Nur,10,0,20,10
1746557784550,MCWP 40,B00,893304,Montejo; Carolina,14,0,20,6
1746557785578,MCWP 40R,A00,893757,Redela; Pamela Morgan,0,5,20,20
1746557786603,MCWP 50,A00,893758,Morshed; Michael James,0,0,20,20
1746557786603,MCWP 50,B00,893761,Bartulis; Jason Michael,17,0,20,3
1746557787628,MCWP 50R,A00,893766,Compas; Sean Matthew,0,1,20,20
1746557787628,MCWP 50R,B00,893769,Carter; Jennifer A,0,1,20,20
1746557787628,MCWP 50R,C00,893771,Krone; Jarret,0,3,20,20
1746557787628,MCWP 50R,D00,893772,Miller; Elizabeth Deen,0,0,20,20
1746557787628,MCWP 50R,E00,893775,Carter; Andrea L,0,1,20,20
1746557788656,MMW 11R,A01,892721,Herbst; Matthew,11,0,27,16
1746557788656,MMW 11R,A02,892722,Herbst; Matthew,0,0,0,3
1746557789684,MMW 12R,A01,892724,Herbst; Matthew,0,11,16,16
1746557789684,MMW 12R,A02,892725,Herbst; Matthew,0,10,16,16
1746557790710,MMW 13R,A01,892727,Staff,0,4,16,16
1746557790710,MMW 13R,A02,892728,Staff,0,4,16,16
1746557790710,MMW 13R,A03,958032,Staff,0,4,16,16
1746557790710,MMW 13R,A04,958033,Staff,0,4,16,16
1746557790710,MMW 13R,A05,958034,Staff,0,4,16,16
1746557791738,SIO 295LS,A00,894015,Staff,5,0,25,20
1746557792762,SIO 295S,A00,894020,Staff,5,0,25,20
1746557793787,SIOC 290S,B01,958918,Merrifield; Mark A,14,0,30,16
1746557794811,SIOC 291S,B01,958922,Gabriel; Corey John,14,0,30,16
1746557795836,SOCI 117,A01,895339,Staff,3,0,5,2
1746557796862,WES 237B,A00,894149,Staff,11,0,20,9
1746557798918,AESE 279B,A00,891859,Staff,13,0,35,22
1746557799942,AIP 197,001,891854,Vespa; Emanuel Ignacio,9999,0,9999,0
1746557800967,ANTH 289S,A00,891856,Gagneux; Pascal,12,0,12,0
1746557801991,BENG 196,001,957946,Engler; Adam J.,9996,0,9999,3
1746557803015,BISP 197,001,959851,Wilhelm; James E.,9998,0,9999,1
1746557804042,CAT 124RS,A01,956906,Staff,6,0,25,19
1746557805069,CAT 125RS,A01,922013,Staff,6,0,25,19
1746557806094,CLRE 250,A00,891860,Morris; Sheldon,9995,0,9999,4
1746557808143,CLRE 251R,A00,907817,Mehta; Ravindra L.,9994,0,9999,5
1746557809172,CLRE 252,A00,891864,Cuomo; Raphael Eduardo,9993,0,9999,6
1746557810201,CLRE 253,A00,891867,Vaida; Florin,9994,0,9999,5
1746557810201,CLRE 253,B00,907819,Staff,9999,0,9999,0
1746557811226,CLRE 259,A00,891868,Patel; Hemal,9998,0,9999,1
1746557812253,CLRE 260,A00,891872,Cuomo; Raphael Eduardo,9999,0,9999,0
1746557813277,CLRE 297,001,891888,Cuomo; Raphael Eduardo,9999,0,9999,0
1746557814302,CSE 191,A00,958773,Minnes Kemp; Mor Mia,9995,0,9999,4
1746557815326,CSE 197,001,959846,Minnes Kemp; Mor Mia,9990,0,9999,9
1746557816351,CSS 201S,A01,892054,Mignozzetti; Umberto,26,0,30,4
1746557817380,CSS 202S,A01,892056,Mignozzetti; Umberto,26,0,30,4
1746557818408,DSC 197,001,956898,Eldridge; Justin Matthew,9997,0,9999,2
1746557819433,DSC 297,001,958000,Mazumdar; Arya,9998,0,9999,1
1746557819433,DSC 297,002,959862,Wang; Yusu,9998,0,9999,1
1746557820460,EAP 100,A00,905686,Staff,9778,0,9999,221
1746557821486,ECE 45,A01,892618,Staff,0,0,65,65
1746557823542,ECE 111,A01,892719,Staff,4,0,65,61
1746557824568,ECE 197,001,957920,Mercier; Patrick Philip,9991,0,9999,8
1746557825593,ECON 178,A01,907814,Zhu; Ying,26,0,35,9
1746557826618,EDS 115,A00,895312,Staff,35,0,45,10
1746557827641,EDS 117,A01,895337,Staff,23,0,30,7
1746557828665,EDS 125,A00,895341,Jones; Gabrielle Anastasia,36,0,45,9
1746557829689,EDS 128A,A01,895459,Fargason; Sharon Gayle,44,0,45,1
1746557830714,EDS 128B,A01,895543,Pappas; Elizabeth,44,0,45,1
1746557831739,EDS 139,A00,897203,Pappas; Elizabeth,44,0,45,1
1746557831739,EDS 139,B00,897209,Fargason; Sharon Gayle,41,0,45,4
1746557832764,EDS 201,A00,895545,Staff,22,0,45,23
1746557833792,EDS 203,A01,895581,Halter; Christopher P.,22,0,45,23
1746557834819,EDS 204R,A01,895625,Heinzman; Erica M.,39,0,45,6
1746557834819,EDS 204R,B01,895693,Halter; Christopher P.,10,0,45,35
1746557835845,EDS 206R,A00,895694,Fargason; Sharon Gayle,1,0,30,29
1746557835845,EDS 206R,B00,895695,Choi; Bailey Miyeon,16,0,30,14
1746557836875,EDS 250,A00,895697,Hemans; Patricia Ann Benitez,22,0,45,23
1746557837899,EDS 281,A00,895701,Meyerott; Theresa Ann,1,0,15,14
1746557838926,EDS 284,A00,895736,Meyerott; Theresa Ann,1,0,15,14
1746557839952,EDS 286,A00,897210,Fine; Sarah,0,0,15,15
1746557840979,EDS 289C,A01,895770,Daly; Alan J.,1,0,15,14
1746557842004,EDS 290,A00,897211,Hofstetter; Carolyn,0,0,15,15
1746557843028,LIGM 5A,A00,896162,Fischer-Grunski; Eva K,12,0,20,8
1746557844053,LIGM 5B,A00,896260,Fischer-Grunski; Eva K,17,0,20,3
1746557845077,LIGM 5C,A00,896308,Fischer-Grunski; Eva K,18,0,20,2
1746557846104,LIIT 5AS,A00,896313,Carnelos; Chiara,18,0,20,2
1746557847129,LIIT 5BS,A00,896416,Carnelos; Chiara,20,0,20,0
1746557848155,LIIT 5CS,A00,896564,Carnelos; Chiara,20,0,20,0
1746557849179,LISP 5A,A00,896588,Munoz Sanchez; Alicia,3,0,20,17
1746557850207,LISP 5B,A00,896653,Munoz Sanchez; Alicia,7,0,20,13
1746557851234,LISP 5C,A00,896655,Munoz Sanchez; Alicia,0,1,20,20
1746557852259,MAE 197,001,957918,Kleissl; Jan,9996,0,9999,3
1746557852259,MAE 197,002,959806,Boechler; Nicholas Sebastia,9998,0,9999,1
1746557852259,MAE 197,003,959852,Mullin; Jennifer S,9998,0,9999,1
1746557853284,MATH 2,A01,957937,Staff,33,0,35,2
1746557854310,MATH 197,001,957876,Kedlaya; Kiran S.,9993,0,9999,6
1746557855337,MCWP 40,A00,892729,Duru; Nur,10,0,20,10
1746557855337,MCWP 40,B00,893304,Montejo; Carolina,14,0,20,6
1746557856364,MCWP 40R,A00,893757,Redela; Pamela Morgan,0,5,20,20
1746557857390,MCWP 50,A00,893758,Morshed; Michael James,0,0,20,20
1746557857390,MCWP 50,B00,893761,Bartulis; Jason Michael,17,0,20,3
1746557858417,MCWP 50R,A00,893766,Compas; Sean Matthew,0,1,20,20
1746557858417,MCWP 50R,B00,893769,Carter; Jennifer A,0,1,20,20
1746557858417,MCWP 50R,C00,893771,Krone; Jarret,0,3,20,20
1746557858417,MCWP 50R,D00,893772,Miller; Elizabeth Deen,0,0,20,20
1746557858417,MCWP 50R,E00,893775,Carter; Andrea L,0,1,20,20
1746557859442,MMW 11R,A01,892721,Herbst; Matthew,11,0,27,16
1746557859442,MMW 11R,A02,892722,Herbst; Matthew,0,0,0,3
1746557860468,MMW 12R,A01,892724,Herbst; Matthew,0,11,16,16
1746557860468,MMW 12R,A02,892725,Herbst; Matthew,0,10,16,16
1746557861493,MMW 13R,A01,892727,Staff,0,4,16,16
1746557861493,MMW 13R,A02,892728,Staff,0,4,16,16
1746557861493,MMW 13R,A03,958032,Staff,0,4,16,16
1746557861493,MMW 13R,A04,958033,Staff,0,4,16,16
1746557861493,MMW 13R,A05,958034,Staff,0,4,16,16
1746557862519,SIO 295LS,A00,894015,Staff,5,0,25,20
1746557863546,SIO 295S,A00,894020,Staff,5,0,25,20
1746557864576,SIOC 290S,B01,958918,Merrifield; Mark A,14,0,30,16
1746557865603,SIOC 291S,B01,958922,Gabriel; Corey John,14,0,30,16
1746557866630,SOCI 117,A01,895339,Staff,3,0,5,2
1746557867654,WES 237B,A00,894149,Staff,11,0,20,9
1746557869709,AESE 279B,A00,891859,Staff,13,0,35,22
1746557870735,AIP 197,001,891854,Vespa; Emanuel Ignacio,9999,0,9999,0
1746557871759,ANTH 289S,A00,891856,Gagneux; Pascal,12,0,12,0
1746557872787,BENG 196,001,957946,Engler; Adam J.,9996,0,9999,3
1746557873812,BISP 197,001,959851,Wilhelm; James E.,9998,0,9999,1
1746557874838,CAT 124RS,A01,956906,Staff,6,0,25,19
1746557875863,CAT 125RS,A01,922013,Staff,6,0,25,19
1746557876887,CLRE 250,A00,891860,Morris; Sheldon,9995,0,9999,4
1746557878945,CLRE 251R,A00,907817,Mehta; Ravindra L.,9994,0,9999,5
1746557879971,CLRE 252,A00,891864,Cuomo; Raphael Eduardo,9993,0,9999,6
1746557880998,CLRE 253,A00,891867,Vaida; Florin,9994,0,9999,5
1746557880998,CLRE 253,B00,907819,Staff,9999,0,9999,0
1746557882023,CLRE 259,A00,891868,Patel; Hemal,9998,0,9999,1
1746557883047,CLRE 260,A00,891872,Cuomo; Raphael Eduardo,9999,0,9999,0
1746557884071,CLRE 297,001,891888,Cuomo; Raphael Eduardo,9999,0,9999,0
1746557885095,CSE 191,A00,958773,Minnes Kemp; Mor Mia,9995,0,9999,4
1746557886120,CSE 197,001,959846,Minnes Kemp; Mor Mia,9990,0,9999,9
1746557887146,CSS 201S,A01,892054,Mignozzetti; Umberto,26,0,30,4
1746557888176,CSS 202S,A01,892056,Mignozzetti; Umberto,26,0,30,4
1746557889201,DSC 197,001,956898,Eldridge; Justin Matthew,9997,0,9999,2
1746557890227,DSC 297,001,958000,Mazumdar; Arya,9998,0,9999,1
1746557890227,DSC 297,002,959862,Wang; Yusu,9998,0,9999,1
1746557891253,EAP 100,A00,905686,Staff,9778,0,9999,221
1746557892278,ECE 45,A01,892618,Staff,0,0,65,65
1746557894333,ECE 111,A01,892719,Staff,4,0,65,61
1746557895439,ECE 197,001,957920,Mercier; Patrick Philip,9991,0,9999,8
1746557896472,ECON 178,A01,907814,Zhu; Ying,26,0,35,9
1746557897499,EDS 115,A00,895312,Staff,35,0,45,10
1746557898525,EDS 117,A01,895337,Staff,23,0,30,7
1746557899550,EDS 125,A00,895341,Jones; Gabrielle Anastasia,36,0,45,9
1746557900573,EDS 128A,A01,895459,Fargason; Sharon Gayle,44,0,45,1
1746557901599,EDS 128B,A01,895543,Pappas; Elizabeth,44,0,45,1
1746557902663,EDS 139,A00,897203,Pappas; Elizabeth,44,0,45,1
1746557902663,EDS 139,B00,897209,Fargason; Sharon Gayle,41,0,45,4
1746557903690,EDS 201,A00,895545,Staff,22,0,45,23
1746557904715,EDS 203,A01,895581,Halter; Christopher P.,22,0,45,23
1746557905740,EDS 204R,A01,895625,Heinzman; Erica M.,39,0,45,6
1746557905740,EDS 204R,B01,895693,Halter; Christopher P.,10,0,45,35
1746557906763,EDS 206R,A00,895694,Fargason; Sharon Gayle,1,0,30,29
1746557906763,EDS 206R,B00,895695,Choi; Bailey Miyeon,16,0,30,14
1746557907789,EDS 250,A00,895697,Hemans; Patricia Ann Benitez,22,0,45,23
1746557908814,EDS 281,A00,895701,Meyerott; Theresa Ann,1,0,15,14
1746557909838,EDS 284,A00,895736,Meyerott; Theresa Ann,1,0,15,14
1746557910862,EDS 286,A00,897210,Fine; Sarah,0,0,15,15
1746557911887,EDS 289C,A01,895770,Daly; Alan J.,1,0,15,14
1746557912913,EDS 290,A00,897211,Hofstetter; Carolyn,0,0,15,15
1746557913938,LIGM 5A,A00,896162,Fischer-Grunski; Eva K,12,0,20,8
1746557914967,LIGM 5B,A00,896260,Fischer-Grunski; Eva K,17,0,20,3
1746557915992,LIGM 5C,A00,896308,Fischer-Grunski; Eva K,18,0,20,2
1746557917017,LIIT 5AS,A00,896313,Carnelos; Chiara,18,0,20,2
1746557918042,LIIT 5BS,A00,896416,Carnelos; Chiara,20,0,20,0
1746557919070,LIIT 5CS,A00,896564,Carnelos; Chiara,20,0,20,0
1746557920099,LISP 5A,A00,896588,Munoz Sanchez; Alicia,3,0,20,17
1746557921125,LISP 5B,A00,896653,Munoz Sanchez; Alicia,7,0,20,13
1746557922153,LISP 5C,A00,896655,Munoz Sanchez; Alicia,0,1,20,20
1746557923178,MAE 197,001,957918,Kleissl; Jan,9996,0,9999,3
1746557923178,MAE 197,002,959806,Boechler; Nicholas Sebastia,9998,0,9999,1
1746557923178,MAE 197,003,959852,Mullin; Jennifer S,9998,0,9999,1
1746557924205,MATH 2,A01,957937,Staff,33,0,35,2
1746557925231,MATH 197,001,957876,Kedlaya; Kiran S.,9993,0,9999,6
1746557926256,MCWP 40,A00,892729,Duru; Nur,10,0,20,10
1746557926256,MCWP 40,B00,893304,Montejo; Carolina,14,0,20,6
1746557927281,MCWP 40R,A00,893757,Redela; Pamela Morgan,0,5,20,20
1746557928306,MCWP 50,A00,893758,Morshed; Michael James,0,0,20,20
1746557928306,MCWP 50,B00,893761,Bartulis; Jason Michael,17,0,20,3
1746557929333,MCWP 50R,A00,893766,Compas; Sean Matthew,0,1,20,20
1746557929333,MCWP 50R,B00,893769,Carter; Jennifer A,0,1,20,20
1746557929333,MCWP 50R,C00,893771,Krone; Jarret,0,3,20,20
1746557929333,MCWP 50R,D00,893772,Miller; Elizabeth Deen,0,0,20,20
1746557929333,MCWP 50R,E00,893775,Carter; Andrea L,0,1,20,20
1746557930362,MMW 11R,A01,892721,Herbst; Matthew,11,0,27,16
1746557930362,MMW 11R,A02,892722,Herbst; Matthew,0,0,0,3
1746557931387,MMW 12R,A01,892724,Herbst; Matthew,0,11,16,16
1746557931387,MMW 12R,A02,892725,Herbst; Matthew,0,10,16,16
1746557932413,MMW 13R,A01,892727,Staff,0,4,16,16
1746557932413,MMW 13R,A02,892728,Staff,0,4,16,16
1746557932413,MMW 13R,A03,958032,Staff,0,4,16,16
1746557932413,MMW 13R,A04,958033,Staff,0,4,16,16
1746557932413,MMW 13R,A05,958034,Staff,0,4,16,16
1746557933441,SIO 295LS,A00,894015,Staff,5,0,25,20
1746557934467,SIO 295S,A00,894020,Staff,5,0,25,20
1746557935492,SIOC 290S,B01,958918,Merrifield; Mark A,14,0,30,16
1746557936518,SIOC 291S,B01,958922,Gabriel; Corey John,14,0,30,16
1746557937543,SOCI 117,A01,895339,Staff,3,0,5,2
1746557938586,WES 237B,A00,894149,Staff,11,0,20,9
1746557940655,AESE 279B,A00,891859,Staff,13,0,35,22
1746557941692,AIP 197,001,891854,Vespa; Emanuel Ignacio,9999,0,9999,0
1746557942718,ANTH 289S,A00,891856,Gagneux; Pascal,12,0,12,0
1746557943743,BENG 196,001,957946,Engler; Adam J.,9996,0,9999,3
1746557944768,BISP 197,001,959851,Wilhelm; James E.,9998,0,9999,1
1746557945791,CAT 124RS,A01,956906,Staff,6,0,25,19
1746557946816,CAT 125RS,A01,922013,Staff,6,0,25,19
1746557947842,CLRE 250,A00,891860,Morris; Sheldon,9995,0,9999,4
1746557949893,CLRE 251R,A00,907817,Mehta; Ravindra L.,9994,0,9999,5
1746557950919,CLRE 252,A00,891864,Cuomo; Raphael Eduardo,9993,0,9999,6
1746557951945,CLRE 253,A00,891867,Vaida; Florin,9994,0,9999,5
1746557951945,CLRE 253,B00,907819,Staff,9999,0,9999,0
1746557952973,CLRE 259,A00,891868,Patel; Hemal,9998,0,9999,1
1746557953997,CLRE 260,A00,891872,Cuomo; Raphael Eduardo,9999,0,9999,0
1746557955061,CLRE 297,001,891888,Cuomo; Raphael Eduardo,9999,0,9999,0
1746557956085,CSE 191,A00,958773,Minnes Kemp; Mor Mia,9995,0,9999,4
1746557957110,CSE 197,001,959846,Minnes Kemp; Mor Mia,9990,0,9999,9
1746557958138,CSS 201S,A01,892054,Mignozzetti; Umberto,26,0,30,4
1746557959168,CSS 202S,A01,892056,Mignozzetti; Umberto,26,0,30,4
1746557960199,DSC 197,001,956898,Eldridge; Justin Matthew,9997,0,9999,2
1746557961225,DSC 297,001,958000,Mazumdar; Arya,9998,0,9999,1
1746557961225,DSC 297,002,959862,Wang; Yusu,9998,0,9999,1
1746557962249,EAP 100,A00,905686,Staff,9778,0,9999,221
1746557963276,ECE 45,A01,892618,Staff,0,0,65,65
1746557965329,ECE 111,A01,892719,Staff,4,0,65,61
1746557966356,ECE 197,001,957920,Mercier; Patrick Philip,9991,0,9999,8
1746557967384,ECON 178,A01,907814,Zhu; Ying,26,0,35,9
1746557968411,EDS 115,A00,895312,Staff,35,0,45,10
1746557969435,EDS 117,A01,895337,Staff,23,0,30,7
1746557970461,EDS 125,A00,895341,Jones; Gabrielle Anastasia,36,0,45,9
1746557971488,EDS 128A,A01,895459,Fargason; Sharon Gayle,44,0,45,1
1746557972512,EDS 128B,A01,895543,Pappas; Elizabeth,44,0,45,1
1746557973539,EDS 139,A00,897203,Pappas; Elizabeth,44,0,45,1
1746557973539,EDS 139,B00,897209,Fargason; Sharon Gayle,41,0,45,4
1746557974565,EDS 201,A00,895545,Staff,22,0,45,23
1746557975589,EDS 203,A01,895581,Halter; Christopher P.,22,0,45,23
1746557976616,EDS 204R,A01,895625,Heinzman; Erica M.,39,0,45,6
1746557976616,EDS 204R,B01,895693,Halter; Christopher P.,10,0,45,35
1746557977640,EDS 206R,A00,895694,Fargason; Sharon Gayle,1,0,30,29
1746557977640,EDS 206R,B00,895695,Choi; Bailey Miyeon,16,0,30,14
1746557978664,EDS 250,A00,895697,Hemans; Patricia Ann Benitez,22,0,45,23
1746557979690,EDS 281,A00,895701,Meyerott; Theresa Ann,1,0,15,14
1746557980718,EDS 284,A00,895736,Meyerott; Theresa Ann,1,0,15,14
1746557981743,EDS 286,A00,897210,Fine; Sarah,0,0,15,15
1746557982768,EDS 289C,A01,895770,Daly; Alan J.,1,0,15,14
1746557983793,EDS 290,A00,897211,Hofstetter; Carolyn,0,0,15,15
1746557984821,LIGM 5A,A00,896162,Fischer-Grunski; Eva K,12,0,20,8
1746557985847,LIGM 5B,A00,896260,Fischer-Grunski; Eva K,17,0,20,3
1746557986872,LIGM 5C,A00,896308,Fischer-Grunski; Eva K,18,0,20,2
1746557987897,LIIT 5AS,A00,896313,Carnelos; Chiara,18,0,20,2
1746557988923,LIIT 5BS,A00,896416,Carnelos; Chiara,20,0,20,0
1746557989948,LIIT 5CS,A00,896564,Carnelos; Chiara,20,0,20,0
1746557990977,LISP 5A,A00,896588,Munoz Sanchez; Alicia,3,0,20,17
1746557992003,LISP 5B,A00,896653,Munoz Sanchez; Alicia,7,0,20,13
1746557993028,LISP 5C,A00,896655,Munoz Sanchez; Alicia,0,1,20,20
1746557994055,MAE 197,001,957918,Kleissl; Jan,9996,0,9999,3
1746557994055,MAE 197,002,959806,Boechler; Nicholas Sebastia,9998,0,9999,1
1746557994055,MAE 197,003,959852,Mullin; Jennifer S,9998,0,9999,1
1746557995078,MATH 2,A01,957937,Staff,33,0,35,2
1746557996107,MATH 197,001,957876,Kedlaya; Kiran S.,9993,0,9999,6
1746557997133,MCWP 40,A00,892729,Duru; Nur,10,0,20,10
1746557997133,MCWP 40,B00,893304,Montejo; Carolina,14,0,20,6
1746557998162,MCWP 40R,A00,893757,Redela; Pamela Morgan,0,5,20,20
1746557999187,MCWP 50,A00,893758,Morshed; Michael James,0,0,20,20
1746557999187,MCWP 50,B00,893761,Bartulis; Jason Michael,17,0,20,3
1746558000212,MCWP 50R,A00,893766,Compas; Sean Matthew,0,1,20,20
1746558000212,MCWP 50R,B00,893769,Carter; Jennifer A,0,1,20,20
1746558000212,MCWP 50R,C00,893771,Krone; Jarret,0,3,20,20
1746558000212,MCWP 50R,D00,893772,Miller; Elizabeth Deen,0,0,20,20
1746558000212,MCWP 50R,E00,893775,Carter; Andrea L,0,1,20,20
1746558001237,MMW 11R,A01,892721,Herbst; Matthew,11,0,27,16
1746558001237,MMW 11R,A02,892722,Herbst; Matthew,0,0,0,3
1746558002267,MMW 12R,A01,892724,Herbst; Matthew,0,11,16,16
1746558002267,MMW 12R,A02,892725,Herbst; Matthew,0,10,16,16
1746558003305,MMW 13R,A01,892727,Staff,0,4,16,16
1746558003305,MMW 13R,A02,892728,Staff,0,4,16,16
1746558003305,MMW 13R,A03,958032,Staff,0,4,16,16
1746558003305,MMW 13R,A04,958033,Staff,0,4,16,16
1746558003305,MMW 13R,A05,958034,Staff,0,4,16,16
1746558004328,SIO 295LS,A00,894015,Staff,5,0,25,20
1746558005357,SIO 295S,A00,894020,Staff,5,0,25,20
1746558006382,SIOC 290S,B01,958918,Merrifield; Mark A,14,0,30,16
1746558007406,SIOC 291S,B01,958922,Gabriel; Corey John,14,0,30,16
1746558008434,SOCI 117,A01,895339,Staff,3,0,5,2
1746558009499,WES 237B,A00,894149,Staff,11,0,20,9
1746558011561,AESE 279B,A00,891859,Staff,13,0,35,22
1746558012588,AIP 197,001,891854,Vespa; Emanuel Ignacio,9999,0,9999,0
1746558013617,ANTH 289S,A00,891856,Gagneux; Pascal,12,0,12,0
1746558014643,BENG 196,001,957946,Engler; Adam J.,9996,0,9999,3
1746558015671,BISP 197,001,959851,Wilhelm; James E.,9998,0,9999,1
1746558016697,CAT 124RS,A01,956906,Staff,6,0,25,19
1746558017721,CAT 125RS,A01,922013,Staff,6,0,25,19
1746558018748,CLRE 250,A00,891860,Morris; Sheldon,9995,0,9999,4
1746558020805,CLRE 251R,A00,907817,Mehta; Ravindra L.,9994,0,9999,5
1746558021831,CLRE 252,A00,891864,Cuomo; Raphael Eduardo,9993,0,9999,6
1746558022859,CLRE 253,A00,891867,Vaida; Florin,9994,0,9999,5
1746558022859,CLRE 253,B00,907819,Staff,9999,0,9999,0
1746558023888,CLRE 259,A00,891868,Patel; Hemal,9998,0,9999,1
1746558024913,CLRE 260,A00,891872,Cuomo; Raphael Eduardo,9999,0,9999,0
1746558025940,CLRE 297,001,891888,Cuomo; Raphael Eduardo,9999,0,9999,0
1746558026966,CSE 191,A00,958773,Minnes Kemp; Mor Mia,9995,0,9999,4
1746558027993,CSE 197,001,959846,Minnes Kemp; Mor Mia,9990,0,9999,9
1746558029021,CSS 201S,A01,892054,Mignozzetti; Umberto,26,0,30,4
1746558030045,CSS 202S,A01,892056,Mignozzetti; Umberto,26,0,30,4
1746558031070,DSC 197,001,956898,Eldridge; Justin Matthew,9997,0,9999,2
1746558032098,DSC 297,001,958000,Mazumdar; Arya,9998,0,9999,1
1746558032098,DSC 297,002,959862,Wang; Yusu,9998,0,9999,1
1746558033126,EAP 100,A00,905686,Staff,9778,0,9999,221
1746558034152,ECE 45,A01,892618,Staff,0,0,65,65
1746558036205,ECE 111,A01,892719,Staff,4,0,65,61
1746558037233,ECE 197,001,957920,Mercier; Patrick Philip,9991,0,9999,8
1746558038260,ECON 178,A01,907814,Zhu; Ying,26,0,35,9
1746558039288,EDS 115,A00,895312,Staff,35,0,45,10
1746558040313,EDS 117,A01,895337,Staff,23,0,30,7
1746558041340,EDS 125,A00,895341,Jones; Gabrielle Anastasia,36,0,45,9
1746558042367,EDS 128A,A01,895459,Fargason; Sharon Gayle,44,0,45,1
1746558043395,EDS 128B,A01,895543,Pappas; Elizabeth,44,0,45,1
1746558044422,EDS 139,A00,897203,Pappas; Elizabeth,44,0,45,1
1746558044422,EDS 139,B00,897209,Fargason; Sharon Gayle,41,0,45,4
1746558045447,EDS 201,A00,895545,Staff,22,0,45,23
1746558046472,EDS 203,A01,895581,Halter; Christopher P.,22,0,45,23
1746558047498,EDS 204R,A01,895625,Heinzman; Erica M.,39,0,45,6
1746558047498,EDS 204R,B01,895693,Halter; Christopher P.,10,0,45,35
1746558048528,EDS 206R,A00,895694,Fargason; Sharon Gayle,1,0,30,29
1746558048528,EDS 206R,B00,895695,Choi; Bailey Miyeon,16,0,30,14
1746558049554,EDS 250,A00,895697,Hemans; Patricia Ann Benitez,22,0,45,23
1746558050583,EDS 281,A00,895701,Meyerott; Theresa Ann,1,0,15,14
1746558051606,EDS 284,A00,895736,Meyerott; Theresa Ann,1,0,15,14
1746558052634,EDS 286,A00,897210,Fine; Sarah,0,0,15,15
1746558053661,EDS 289C,A01,895770,Daly; Alan J.,1,0,15,14
1746558054685,EDS 290,A00,897211,Hofstetter; Carolyn,0,0,15,15
1746558055711,LIGM 5A,A00,896162,Fischer-Grunski; Eva K,12,0,20,8
1746558056736,LIGM 5B,A00,896260,Fischer-Grunski; Eva K,17,0,20,3
1746558057765,LIGM 5C,A00,896308,Fischer-Grunski; Eva K,18,0,20,2
1746558058793,LIIT 5AS,A00,896313,Carnelos; Chiara,18,0,20,2
1746558059821,LIIT 5BS,A00,896416,Carnelos; Chiara,20,0,20,0
1746558060847,LIIT 5CS,A00,896564,Carnelos; Chiara,20,0,20,0
1746558061872,LISP 5A,A00,896588,Munoz Sanchez; Alicia,3,0,20,17
1746558062902,LISP 5B,A00,896653,Munoz Sanchez; Alicia,7,0,20,13
1746558063931,LISP 5C,A00,896655,Munoz Sanchez; Alicia,0,1,20,20
1746558064956,MAE 197,001,957918,Kleissl; Jan,9996,0,9999,3
1746558064956,MAE 197,002,959806,Boechler; Nicholas Sebastia,9998,0,9999,1
1746558064956,MAE 197,003,959852,Mullin; Jennifer S,9998,0,9999,1
1746558065984,MATH 2,A01,957937,Staff,33,0,35,2
1746558067011,MATH 197,001,957876,Kedlaya; Kiran S.,9993,0,9999,6
1746558068040,MCWP 40,A00,892729,Duru; Nur,10,0,20,10
1746558068040,MCWP 40,B00,893304,Montejo; Carolina,14,0,20,6
1746558069067,MCWP 40R,A00,893757,Redela; Pamela Morgan,0,5,20,20
1746558070093,MCWP 50,A00,893758,Morshed; Michael James,0,0,20,20
1746558070093,MCWP 50,B00,893761,Bartulis; Jason Michael,17,0,20,3
1746558071118,MCWP 50R,A00,893766,Compas; Sean Matthew,0,1,20,20
1746558071118,MCWP 50R,B00,893769,Carter; Jennifer A,0,1,20,20
1746558071118,MCWP 50R,C00,893771,Krone; Jarret,0,3,20,20
1746558071118,MCWP 50R,D00,893772,Miller; Elizabeth Deen,0,0,20,20
1746558071118,MCWP 50R,E00,893775,Carter; Andrea L,0,1,20,20
1746558072143,MMW 11R,A01,892721,Herbst; Matthew,11,0,27,16
1746558072143,MMW 11R,A02,892722,Herbst; Matthew,0,0,0,3
1746558073170,MMW 12R,A01,892724,Herbst; Matthew,0,11,16,16
1746558073170,MMW 12R,A02,892725,Herbst; Matthew,0,10,16,16
1746558074194,MMW 13R,A01,892727,Staff,0,4,16,16
1746558074194,MMW 13R,A02,892728,Staff,0,4,16,16
1746558074194,MMW 13R,A03,958032,Staff,0,4,16,16
1746558074194,MMW 13R,A04,958033,Staff,0,4,16,16
1746558074194,MMW 13R,A05,958034,Staff,0,4,16,16
1746558075221,SIO 295LS,A00,894015,Staff,5,0,25,20
1746558076248,SIO 295S,A00,894020,Staff,5,0,25,20
1746558077273,SIOC 290S,B01,958918,Merrifield; Mark A,14,0,30,16
1746558078300,SIOC 291S,B01,958922,Gabriel; Corey John,14,0,30,16
1746558079324,SOCI 117,A01,895339,Staff,3,0,5,2
1746558080348,WES 237B,A00,894149,Staff,11,0,20,9
1746558082408,AESE 279B,A00,891859,Staff,13,0,35,22
1746558083434,AIP 197,001,891854,Vespa; Emanuel Ignacio,9999,0,9999,0
1746558084487,ANTH 289S,A00,891856,Gagneux; Pascal,12,0,12,0
1746558085512,BENG 196,001,957946,Engler; Adam J.,9996,0,9999,3
1746558086536,BISP 197,001,959851,Wilhelm; James E.,9998,0,9999,1
1746558087561,CAT 124RS,A01,956906,Staff,6,0,25,19
1746558088586,CAT 125RS,A01,922013,Staff,6,0,25,19
1746558089611,CLRE 250,A00,891860,Morris; Sheldon,9995,0,9999,4
1746558091669,CLRE 251R,A00,907817,Mehta; Ravindra L.,9994,0,9999,5
1746558092696,CLRE 252,A00,891864,Cuomo; Raphael Eduardo,9993,0,9999,6
1746558093723,CLRE 253,A00,891867,Vaida; Florin,9994,0,9999,5
1746558093723,CLRE 253,B00,907819,Staff,9999,0,9999,0
1746558094748,CLRE 259,A00,891868,Patel; Hemal,9998,0,9999,1
1746558095772,CLRE 260,A00,891872,Cuomo; Raphael Eduardo,9999,0,9999,0
1746558096800,CLRE 297,001,891888,Cuomo; Raphael Eduardo,9999,0,9999,0
1746558097828,CSE 191,A00,958773,Minnes Kemp; Mor Mia,9995,0,9999,4
1746558098853,CSE 197,001,959846,Minnes Kemp; Mor Mia,9990,0,9999,9
1746558099878,CSS 201S,A01,892054,Mignozzetti; Umberto,26,0,30,4
1746558100905,CSS 202S,A01,892056,Mignozzetti; Umberto,26,0,30,4
1746558101931,DSC 197,001,956898,Eldridge; Justin Matthew,9997,0,9999,2
1746558102955,DSC 297,001,958000,Mazumdar; Arya,9998,0,9999,1
1746558102955,DSC 297,002,959862,Wang; Yusu,9998,0,9999,1
1746558103981,EAP 100,A00,905686,Staff,9778,0,9999,221
1746558105007,ECE 45,A01,892618,Staff,0,0,65,65
1746558107056,ECE 111,A01,892719,Staff,4,0,65,61
1746558108085,ECE 197,001,957920,Mercier; Patrick Philip,9991,0,9999,8
1746558109112,ECON 178,A01,907814,Zhu; Ying,26,0,35,9
1746558110140,EDS 115,A00,895312,Staff,35,0,45,10
1746558111170,EDS 117,A01,895337,Staff,23,0,30,7
1746558112195,EDS 125,A00,895341,Jones; Gabrielle Anastasia,36,0,45,9
1746558113221,EDS 128A,A01,895459,Fargason; Sharon Gayle,44,0,45,1
1746558114247,EDS 128B,A01,895543,Pappas; Elizabeth,44,0,45,1
1746558115274,EDS 139,A00,897203,Pappas; Elizabeth,44,0,45,1
1746558115274,EDS 139,B00,897209,Fargason; Sharon Gayle,41,0,45,4
1746558116301,EDS 201,A00,895545,Staff,22,0,45,23
1746558117329,EDS 203,A01,895581,Halter; Christopher P.,22,0,45,23
1746558118564,EDS 204R,A01,895625,Heinzman; Erica M.,39,0,45,6
1746558118564,EDS 204R,B01,895693,Halter; Christopher P.,10,0,45,35
1746558119589,EDS 206R,A00,895694,Fargason; Sharon Gayle,1,0,30,29
1746558119589,EDS 206R,B00,895695,Choi; Bailey Miyeon,16,0,30,14
1746558120613,EDS 250,A00,895697,Hemans; Patricia Ann Benitez,22,0,45,23
1746558121637,EDS 281,A00,895701,Meyerott; Theresa Ann,1,0,15,14
1746558122662,EDS 284,A00,895736,Meyerott; Theresa Ann,1,0,15,14
1746558123693,EDS 286,A00,897210,Fine; Sarah,0,0,15,15
1746558124734,EDS 289C,A01,895770,Daly; Alan J.,1,0,15,14
1746558125759,EDS 290,A00,897211,Hofstetter; Carolyn,0,0,15,15
1746558126786,LIGM 5A,A00,896162,Fischer-Grunski; Eva K,12,0,20,8
1746558127816,LIGM 5B,A00,896260,Fischer-Grunski; Eva K,17,0,20,3
1746558128847,LIGM 5C,A00,896308,Fischer-Grunski; Eva K,18,0,20,2
1746558129873,LIIT 5AS,A00,896313,Carnelos; Chiara,18,0,20,2
1746558130899,LIIT 5BS,A00,896416,Carnelos; Chiara,20,0,20,0
1746558131927,LIIT 5CS,A00,896564,Carnelos; Chiara,20,0,20,0
1746558132952,LISP 5A,A00,896588,Munoz Sanchez; Alicia,3,0,20,17
1746558133980,LISP 5B,A00,896653,Munoz Sanchez; Alicia,7,0,20,13
1746558135034,LISP 5C,A00,896655,Munoz Sanchez; Alicia,0,1,20,20
1746558136059,MAE 197,001,957918,Kleissl; Jan,9996,0,9999,3
1746558136059,MAE 197,002,959806,Boechler; Nicholas Sebastia,9998,0,9999,1
1746558136059,MAE 197,003,959852,Mullin; Jennifer S,9998,0,9999,1
1746558137086,MATH 2,A01,957937,Staff,33,0,35,2
1746558138111,MATH 197,001,957876,Kedlaya; Kiran S.,9993,0,9999,6
1746558139136,MCWP 40,A00,892729,Duru; Nur,10,0,20,10
1746558139136,MCWP 40,B00,893304,Montejo; Carolina,14,0,20,6
1746558140162,MCWP 40R,A00,893757,Redela; Pamela Morgan,0,5,20,20
1746558141387,MCWP 50,A00,893758,Morshed; Michael James,0,0,20,20
1746558141387,MCWP 50,B00,893761,Bartulis; Jason Michael,17,0,20,3
1746558142424,MCWP 50R,A00,893766,Compas; Sean Matthew,0,1,20,20
1746558142424,MCWP 50R,B00,893769,Carter; Jennifer A,0,1,20,20
1746558142424,MCWP 50R,C00,893771,Krone; Jarret,0,3,20,20
1746558142424,MCWP 50R,D00,893772,Miller; Elizabeth Deen,0,0,20,20
1746558142424,MCWP 50R,E00,893775,Carter; Andrea L,0,1,20,20
1746558143453,MMW 11R,A01,892721,Herbst; Matthew,11,0,27,16
1746558143453,MMW 11R,A02,892722,Herbst; Matthew,0,0,0,3
1746558144481,MMW 12R,A01,892724,Herbst; Matthew,0,11,16,16
1746558144481,MMW 12R,A02,892725,Herbst; Matthew,0,10,16,16
1746558145507,MMW 13R,A01,892727,Staff,0,4,16,16
1746558145507,MMW 13R,A02,892728,Staff,0,4,16,16
1746558145507,MMW 13R,A03,958032,Staff,0,4,16,16
1746558145507,MMW 13R,A04,958033,Staff,0,4,16,16
1746558145507,MMW 13R,A05,958034,Staff,0,4,16,16
1746558146533,SIO 295LS,A00,894015,Staff,5,0,25,20
1746558147557,SIO 295S,A00,894020,Staff,5,0,25,20
1746558148584,SIOC 290S,B01,958918,Merrifield; Mark A,14,0,30,16
1746558149613,SIOC 291S,B01,958922,Gabriel; Corey John,14,0,30,16
1746558150637,SOCI 117,A01,895339,Staff,3,0,5,2
1746558151661,WES 237B,A00,894149,Staff,11,0,20,9
1746558153718,AESE 279B,A00,891859,Staff,13,0,35,22
1746558154745,AIP 197,001,891854,Vespa; Emanuel Ignacio,9999,0,9999,0
1746558155771,ANTH 289S,A00,891856,Gagneux; Pascal,12,0,12,0
1746558156797,BENG 196,001,957946,Engler; Adam J.,9996,0,9999,3
1746558157824,BISP 197,001,959851,Wilhelm; James E.,9998,0,9999,1
1746558158849,CAT 124RS,A01,956906,Staff,6,0,25,19
1746558159876,CAT 125RS,A01,922013,Staff,6,0,25,19
1746558160902,CLRE 250,A00,891860,Morris; Sheldon,9995,0,9999,4
1746558162954,CLRE 251R,A00,907817,Mehta; Ravindra L.,9994,0,9999,5
1746558163981,CLRE 252,A00,891864,Cuomo; Raphael Eduardo,9993,0,9999,6
1746558165007,CLRE 253,A00,891867,Vaida; Florin,9994,0,9999,5
1746558165007,CLRE 253,B00,907819,Staff,9999,0,9999,0
1746558166031,CLRE 259,A00,891868,Patel; Hemal,9998,0,9999,1
1746558167056,CLRE 260,A00,891872,Cuomo; Raphael Eduardo,9999,0,9999,0
1746558168085,CLRE 297,001,891888,Cuomo; Raphael Eduardo,9999,0,9999,0
1746558169110,CSE 191,A00,958773,Minnes Kemp; Mor Mia,9995,0,9999,4
1746558170134,CSE 197,001,959846,Minnes Kemp; Mor Mia,9990,0,9999,9
1746558171165,CSS 201S,A01,892054,Mignozzetti; Umberto,26,0,30,4
1746558172190,CSS 202S,A01,892056,Mignozzetti; Umberto,26,0,30,4
1746558173245,DSC 197,001,956898,Eldridge; Justin Matthew,9997,0,9999,2
1746558174270,DSC 297,001,958000,Mazumdar; Arya,9998,0,9999,1
1746558174270,DSC 297,002,959862,Wang; Yusu,9998,0,9999,1
1746558175297,EAP 100,A00,905686,Staff,9778,0,9999,221
1746558176321,ECE 45,A01,892618,Staff,0,0,65,65
1746558178373,ECE 111,A01,892719,Staff,4,0,65,61
1746558179400,ECE 197,001,957920,Mercier; Patrick Philip,9991,0,9999,8
1746558180429,ECON 178,A01,907814,Zhu; Ying,26,0,35,9
1746558181453,EDS 115,A00,895312,Staff,35,0,45,10
1746558182476,EDS 117,A01,895337,Staff,23,0,30,7
1746558184522,EDS 125,A00,895341,Jones; Gabrielle Anastasia,36,0,45,9
1746558185549,EDS 128A,A01,895459,Fargason; Sharon Gayle,44,0,45,1
1746558186576,EDS 128B,A01,895543,Pappas; Elizabeth,44,0,45,1
1746558187603,EDS 139,A00,897203,Pappas; Elizabeth,44,0,45,1
1746558187603,EDS 139,B00,897209,Fargason; Sharon Gayle,41,0,45,4
1746558188627,EDS 201,A00,895545,Staff,22,0,45,23
1746558189654,EDS 203,A01,895581,Halter; Christopher P.,22,0,45,23
1746558190679,EDS 204R,A01,895625,Heinzman; Erica M.,39,0,45,6
1746558190679,EDS 204R,B01,895693,Halter; Christopher P.,10,0,45,35
1746558191705,EDS 206R,A00,895694,Fargason; Sharon Gayle,1,0,30,29
1746558191705,EDS 206R,B00,895695,Choi; Bailey Miyeon,16,0,30,14
1746558192733,EDS 250,A00,895697,Hemans; Patricia Ann Benitez,22,0,45,23
1746558193756,EDS 281,A00,895701,Meyerott; Theresa Ann,1,0,15,14
1746558194781,EDS 284,A00,895736,Meyerott; Theresa Ann,1,0,15,14
1746558195805,EDS 286,A00,897210,Fine; Sarah,0,0,15,15
1746558196829,EDS 289C,A01,895770,Daly; Alan J.,1,0,15,14
1746558197855,EDS 290,A00,897211,Hofstetter; Carolyn,0,0,15,15
1746558198881,LIGM 5A,A00,896162,Fischer-Grunski; Eva K,12,0,20,8
1746558199909,LIGM 5B,A00,896260,Fischer-Grunski; Eva K,17,0,20,3
1746558200934,LIGM 5C,A00,896308,Fischer-Grunski; Eva K,18,0,20,2
1746558201959,LIIT 5AS,A00,896313,Carnelos; Chiara,18,0,20,2
1746558203499,LIIT 5BS,A00,896416,Carnelos; Chiara,20,0,20,0
1746558204526,LIIT 5CS,A00,896564,Carnelos; Chiara,20,0,20,0
1746558205551,LISP 5A,A00,896588,Munoz Sanchez; Alicia,3,0,20,17
1746558206580,LISP 5B,A00,896653,Munoz Sanchez; Alicia,7,0,20,13
1746558207605,LISP 5C,A00,896655,Munoz Sanchez; Alicia,0,1,20,20
1746558208630,MAE 197,001,957918,Kleissl; Jan,9996,0,9999,3
1746558208630,MAE 197,002,959806,Boechler; Nicholas Sebastia,9998,0,9999,1
1746558208630,MAE 197,003,959852,Mullin; Jennifer S,9998,0,9999,1
1746558209655,MATH 2,A01,957937,Staff,33,0,35,2
1746558210678,MATH 197,001,957876,Kedlaya; Kiran S.,9993,0,9999,6
1746558211703,MCWP 40,A00,892729,Duru; Nur,10,0,20,10
1746558211703,MCWP 40,B00,893304,Montejo; Carolina,14,0,20,6
1746558212731,MCWP 40R,A00,893757,Redela; Pamela Morgan,0,5,20,20
1746558213759,MCWP 50,A00,893758,Morshed; Michael James,0,0,20,20
1746558213759,MCWP 50,B00,893761,Bartulis; Jason Michael,17,0,20,3
1746558214784,MCWP 50R,A00,893766,Compas; Sean Matthew,0,1,20,20
1746558214784,MCWP 50R,B00,893769,Carter; Jennifer A,0,1,20,20
1746558214784,MCWP 50R,C00,893771,Krone; Jarret,0,3,20,20
1746558214784,MCWP 50R,D00,893772,Miller; Elizabeth Deen,0,0,20,20
1746558214784,MCWP 50R,E00,893775,Carter; Andrea L,0,1,20,20
1746558215813,MMW 11R,A01,892721,Herbst; Matthew,11,0,27,16
1746558215813,MMW 11R,A02,892722,Herbst; Matthew,0,0,0,3
1746558216840,MMW 12R,A01,892724,Herbst; Matthew,0,11,16,16
1746558216840,MMW 12R,A02,892725,Herbst; Matthew,0,10,16,16
1746558217869,MMW 13R,A01,892727,Staff,0,4,16,16
1746558217869,MMW 13R,A02,892728,Staff,0,4,16,16
1746558217869,MMW 13R,A03,958032,Staff,0,4,16,16
1746558217869,MMW 13R,A04,958033,Staff,0,4,16,16
1746558217869,MMW 13R,A05,958034,Staff,0,4,16,16
1746558218896,SIO 295LS,A00,894015,Staff,5,0,25,20
1746558219924,SIO 295S,A00,894020,Staff,5,0,25,20
1746558220954,SIOC 290S,B01,958918,Merrifield; Mark A,14,0,30,16
1746558221980,SIOC 291S,B01,958922,Gabriel; Corey John,14,0,30,16
1746558223007,SOCI 117,A01,895339,Staff,3,0,5,2
1746558224030,WES 237B,A00,894149,Staff,11,0,20,9
1746558226086,AESE 279B,A00,891859,Staff,13,0,35,22
1746558227112,AIP 197,001,891854,Vespa; Emanuel Ignacio,9999,0,9999,0
1746558228138,ANTH 289S,A00,891856,Gagneux; Pascal,12,0,12,0
1746558229162,BENG 196,001,957946,Engler; Adam J.,9996,0,9999,3
1746558230187,BISP 197,001,959851,Wilhelm; James E.,9998,0,9999,1
1746558231213,CAT 124RS,A01,956906,Staff,6,0,25,19
1746558232237,CAT 125RS,A01,922013,Staff,6,0,25,19
1746558233262,CLRE 250,A00,891860,Morris; Sheldon,9995,0,9999,4
1746558235311,CLRE 251R,A00,907817,Mehta; Ravindra L.,9994,0,9999,5
1746558236336,CLRE 252,A00,891864,Cuomo; Raphael Eduardo,9993,0,9999,6
1746558237415,CLRE 253,A00,891867,Vaida; Florin,9994,0,9999,5
1746558237415,CLRE 253,B00,907819,Staff,9999,0,9999,0
1746558238442,CLRE 259,A00,891868,Patel; Hemal,9998,0,9999,1
1746558239467,CLRE 260,A00,891872,Cuomo; Raphael Eduardo,9999,0,9999,0
1746558240492,CLRE 297,001,891888,Cuomo; Raphael Eduardo,9999,0,9999,0
1746558241521,CSE 191,A00,958773,Minnes Kemp; Mor Mia,9995,0,9999,4
1746558242546,CSE 197,001,959846,Minnes Kemp; Mor Mia,9990,0,9999,9
1746558243571,CSS 201S,A01,892054,Mignozzetti; Umberto,26,0,30,4
1746558244600,CSS 202S,A01,892056,Mignozzetti; Umberto,26,0,30,4
1746558245624,DSC 197,001,956898,Eldridge; Justin Matthew,9997,0,9999,2
1746558246652,DSC 297,001,958000,Mazumdar; Arya,9998,0,9999,1
1746558246652,DSC 297,002,959862,Wang; Yusu,9998,0,9999,1
1746558247678,EAP 100,A00,905686,Staff,9778,0,9999,221
1746558248908,ECE 45,A01,892618,Staff,0,0,65,65
1746558250957,ECE 111,A01,892719,Staff,4,0,65,61
1746558251983,ECE 197,001,957920,Mercier; Patrick Philip,9991,0,9999,8
1746558253009,ECON 178,A01,907814,Zhu; Ying,26,0,35,9
1746558254036,EDS 115,A00,895312,Staff,35,0,45,10
1746558255060,EDS 117,A01,895337,Staff,23,0,30,7
1746558256087,EDS 125,A00,895341,Jones; Gabrielle Anastasia,36,0,45,9
1746558257113,EDS 128A,A01,895459,Fargason; Sharon Gayle,44,0,45,1
1746558258137,EDS 128B,A01,895543,Pappas; Elizabeth,44,0,45,1
1746558259167,EDS 139,A00,897203,Pappas; Elizabeth,44,0,45,1
1746558259167,EDS 139,B00,897209,Fargason; Sharon Gayle,41,0,45,4
1746558260192,EDS 201,A00,895545,Staff,22,0,45,23
1746558261220,EDS 203,A01,895581,Halter; Christopher P.,22,0,45,23
1746558262245,EDS 204R,A01,895625,Heinzman; Erica M.,39,0,45,6
1746558262245,EDS 204R,B01,895693,Halter; Christopher P.,10,0,45,35
1746558263271,EDS 206R,A00,895694,Fargason; Sharon Gayle,1,0,30,29
1746558263271,EDS 206R,B00,895695,Choi; Bailey Miyeon,16,0,30,14
1746558264296,EDS 250,A00,895697,Hemans; Patricia Ann Benitez,22,0,45,23
1746558265322,EDS 281,A00,895701,Meyerott; Theresa Ann,1,0,15,14
1746558266346,EDS 284,A00,895736,Meyerott; Theresa Ann,1,0,15,14
1746558267374,EDS 286,A00,897210,Fine; Sarah,0,0,15,15
1746558268398,EDS 289C,A01,895770,Daly; Alan J.,1,0,15,14
1746558269423,EDS 290,A00,897211,Hofstetter; Carolyn,0,0,15,15
1746558270450,LIGM 5A,A00,896162,Fischer-Grunski; Eva K,12,0,20,8
1746558271477,LIGM 5B,A00,896260,Fischer-Grunski; Eva K,17,0,20,3
1746558272505,LIGM 5C,A00,896308,Fischer-Grunski; Eva K,18,0,20,2
1746558273534,LIIT 5AS,A00,896313,Carnelos; Chiara,18,0,20,2
1746558274559,LIIT 5BS,A00,896416,Carnelos; Chiara,20,0,20,0
1746558275583,LIIT 5CS,A00,896564,Carnelos; Chiara,20,0,20,0
1746558276611,LISP 5A,A00,896588,Munoz Sanchez; Alicia,3,0,20,17
1746558277639,LISP 5B,A00,896653,Munoz Sanchez; Alicia,7,0,20,13
1746558278666,LISP 5C,A00,896655,Munoz Sanchez; Alicia,0,1,20,20
1746558279695,MAE 197,001,957918,Kleissl; Jan,9996,0,9999,3
1746558279695,MAE 197,002,959806,Boechler; Nicholas Sebastia,9998,0,9999,1
1746558279695,MAE 197,003,959852,Mullin; Jennifer S,9998,0,9999,1
1746558280720,MATH 2,A01,957937,Staff,33,0,35,2
1746558281748,MATH 197,001,957876,Kedlaya; Kiran S.,9993,0,9999,6
1746558282776,MCWP 40,A00,892729,Duru; Nur,10,0,20,10
1746558282776,MCWP 40,B00,893304,Montejo; Carolina,14,0,20,6
1746558283802,MCWP 40R,A00,893757,Redela; Pamela Morgan,0,5,20,20
1746558284826,MCWP 50,A00,893758,Morshed; Michael James,0,0,20,20
1746558284826,MCWP 50,B00,893761,Bartulis; Jason Michael,17,0,20,3
1746558285855,MCWP 50R,A00,893766,Compas; Sean Matthew,0,1,20,20
1746558285855,MCWP 50R,B00,893769,Carter; Jennifer A,0,1,20,20
1746558285855,MCWP 50R,C00,893771,Krone; Jarret,0,3,20,20
1746558285855,MCWP 50R,D00,893772,Miller; Elizabeth Deen,0,0,20,20
1746558285855,MCWP 50R,E00,893775,Carter; Andrea L,0,1,20,20
1746558286883,MMW 11R,A01,892721,Herbst; Matthew,11,0,27,16
1746558286883,MMW 11R,A02,892722,Herbst; Matthew,0,0,0,3
1746558287909,MMW 12R,A01,892724,Herbst; Matthew,0,11,16,16
1746558287909,MMW 12R,A02,892725,Herbst; Matthew,0,10,16,16
1746558288939,MMW 13R,A01,892727,Staff,0,4,16,16
1746558288939,MMW 13R,A02,892728,Staff,0,4,16,16
1746558288939,MMW 13R,A03,958032,Staff,0,4,16,16
1746558288939,MMW 13R,A04,958033,Staff,0,4,16,16
1746558288939,MMW 13R,A05,958034,Staff,0,4,16,16
1746558289964,SIO 295LS,A00,894015,Staff,5,0,25,20
1746558290992,SIO 295S,A00,894020,Staff,5,0,25,20
1746558292023,SIOC 290S,B01,958918,Merrifield; Mark A,14,0,30,16
1746558293051,SIOC 291S,B01,958922,Gabriel; Corey John,14,0,30,16
1746558294076,SOCI 117,A01,895339,Staff,3,0,5,2
1746558295103,WES 237B,A00,894149,Staff,11,0,20,9
1746558297170,AESE 279B,A00,891859,Staff,13,0,35,22
1746558298193,AIP 197,001,891854,Vespa; Emanuel Ignacio,9999,0,9999,0
1746558299221,ANTH 289S,A00,891856,Gagneux; Pascal,12,0,12,0
1746558300248,BENG 196,001,957946,Engler; Adam J.,9996,0,9999,3
1746558301273,BISP 197,001,959851,Wilhelm; James E.,9998,0,9999,1
1746558302299,CAT 124RS,A01,956906,Staff,6,0,25,19
1746558303324,CAT 125RS,A01,922013,Staff,6,0,25,19
1746558304353,CLRE 250,A00,891860,Morris; Sheldon,9995,0,9999,4
1746558306407,CLRE 251R,A00,907817,Mehta; Ravindra L.,9994,0,9999,5
1746558307512,CLRE 252,A00,891864,Cuomo; Raphael Eduardo,9993,0,9999,6
1746558308538,CLRE 253,A00,891867,Vaida; Florin,9994,0,9999,5
1746558308538,CLRE 253,B00,907819,Staff,9999,0,9999,0
1746558309567,CLRE 259,A00,891868,Patel; Hemal,9998,0,9999,1
1746558310593,CLRE 260,A00,891872,Cuomo; Raphael Eduardo,9999,0,9999,0
1746558311619,CLRE 297,001,891888,Cuomo; Raphael Eduardo,9999,0,9999,0
1746558312644,CSE 191,A00,958773,Minnes Kemp; Mor Mia,9995,0,9999,4
1746558313672,CSE 197,001,959846,Minnes Kemp; Mor Mia,9990,0,9999,9
1746558314701,CSS 201S,A01,892054,Mignozzetti; Umberto,26,0,30,4
1746558315728,CSS 202S,A01,892056,Mignozzetti; Umberto,26,0,30,4
1746558316753,DSC 197,001,956898,Eldridge; Justin Matthew,9997,0,9999,2
1746558317779,DSC 297,001,958000,Mazumdar; Arya,9998,0,9999,1
1746558317779,DSC 297,002,959862,Wang; Yusu,9998,0,9999,1
1746558318805,EAP 100,A00,905686,Staff,9778,0,9999,221
1746558319836,ECE 45,A01,892618,Staff,0,0,65,65
1746558321890,ECE 111,A01,892719,Staff,4,0,65,61
1746558322915,ECE 197,001,957920,Mercier; Patrick Philip,9991,0,9999,8
1746558323941,ECON 178,A01,907814,Zhu; Ying,26,0,35,9
1746558324966,EDS 115,A00,895312,Staff,35,0,45,10
1746558325992,EDS 117,A01,895337,Staff,23,0,30,7
1746558327020,EDS 125,A00,895341,Jones; Gabrielle Anastasia,36,0,45,9
1746558328046,EDS 128A,A01,895459,Fargason; Sharon Gayle,44,0,45,1
1746558329074,EDS 128B,A01,895543,Pappas; Elizabeth,44,0,45,1
1746558330103,EDS 139,A00,897203,Pappas; Elizabeth,44,0,45,1
1746558330103,EDS 139,B00,897209,Fargason; Sharon Gayle,41,0,45,4
1746558331130,EDS 201,A00,895545,Staff,22,0,45,23
1746558332160,EDS 203,A01,895581,Halter; Christopher P.,22,0,45,23
1746558333187,EDS 204R,A01,895625,Heinzman; Erica M.,39,0,45,6
1746558333187,EDS 204R,B01,895693,Halter; Christopher P.,10,0,45,35
1746558334228,EDS 206R,A00,895694,Fargason; Sharon Gayle,1,0,30,29
1746558334228,EDS 206R,B00,895695,Choi; Bailey Miyeon,16,0,30,14
1746558335256,EDS 250,A00,895697,Hemans; Patricia Ann Benitez,22,0,45,23
1746558336282,EDS 281,A00,895701,Meyerott; Theresa Ann,1,0,15,14
1746558337307,EDS 284,A00,895736,Meyerott; Theresa Ann,1,0,15,14
1746558338332,EDS 286,A00,897210,Fine; Sarah,0,0,15,15
1746558339359,EDS 289C,A01,895770,Daly; Alan J.,1,0,15,14
1746558340386,EDS 290,A00,897211,Hofstetter; Carolyn,0,0,15,15
1746558341410,LIGM 5A,A00,896162,Fischer-Grunski; Eva K,12,0,20,8
1746558342434,LIGM 5B,A00,896260,Fischer-Grunski; Eva K,17,0,20,3
1746558343462,LIGM 5C,A00,896308,Fischer-Grunski; Eva K,18,0,20,2
1746558344487,LIIT 5AS,A00,896313,Carnelos; Chiara,18,0,20,2
1746558345517,LIIT 5BS,A00,896416,Carnelos; Chiara,20,0,20,0
1746558346548,LIIT 5CS,A00,896564,Carnelos; Chiara,20,0,20,0
1746558347576,LISP 5A,A00,896588,Munoz Sanchez; Alicia,3,0,20,17
1746558348604,LISP 5B,A00,896653,Munoz Sanchez; Alicia,7,0,20,13
1746558349629,LISP 5C,A00,896655,Munoz Sanchez; Alicia,0,1,20,20
1746558350657,MAE 197,001,957918,Kleissl; Jan,9996,0,9999,3
1746558350657,MAE 197,002,959806,Boechler; Nicholas Sebastia,9998,0,9999,1
1746558350657,MAE 197,003,959852,Mullin; Jennifer S,9998,0,9999,1
1746558351681,MATH 2,A01,957937,Staff,33,0,35,2
1746558352706,MATH 197,001,957876,Kedlaya; Kiran S.,9993,0,9999,6
1746558353730,MCWP 40,A00,892729,Duru; Nur,10,0,20,10
1746558353730,MCWP 40,B00,893304,Montejo; Carolina,14,0,20,6
1746558354755,MCWP 40R,A00,893757,Redela; Pamela Morgan,0,5,20,20
1746558355782,MCWP 50,A00,893758,Morshed; Michael James,0,0,20,20
1746558355782,MCWP 50,B00,893761,Bartulis; Jason Michael,17,0,20,3
1746558356811,MCWP 50R,A00,893766,Compas; Sean Matthew,0,1,20,20
1746558356811,MCWP 50R,B00,893769,Carter; Jennifer A,0,1,20,20
1746558356811,MCWP 50R,C00,893771,Krone; Jarret,0,3,20,20
1746558356811,MCWP 50R,D00,893772,Miller; Elizabeth Deen,0,0,20,20
1746558356811,MCWP 50R,E00,893775,Carter; Andrea L,0,1,20,20
1746558357839,MMW 11R,A01,892721,Herbst; Matthew,11,0,27,16
1746558357839,MMW 11R,A02,892722,Herbst; Matthew,0,0,0,3
1746558358865,MMW 12R,A01,892724,Herbst; Matthew,0,11,16,16
1746558358865,MMW 12R,A02,892725,Herbst; Matthew,0,10,16,16
1746558359889,MMW 13R,A01,892727,Staff,0,4,16,16
1746558359889,MMW 13R,A02,892728,Staff,0,4,16,16
1746558359889,MMW 13R,A03,958032,Staff,0,4,16,16
1746558359889,MMW 13R,A04,958033,Staff,0,4,16,16
1746558359889,MMW 13R,A05,958034,Staff,0,4,16,16
1746558360914,SIO 295LS,A00,894015,Staff,5,0,25,20
1746558361941,SIO 295S,A00,894020,Staff,5,0,25,20
1746558362969,SIOC 290S,B01,958918,Merrifield; Mark A,14,0,30,16
1746558363995,SIOC 291S,B01,958922,Gabriel; Corey John,14,0,30,16
1746558365021,SOCI 117,A01,895339,Staff,3,0,5,2
1746558366048,WES 237B,A00,894149,Staff,11,0,20,9
1746558368105,AESE 279B,A00,891859,Staff,13,0,35,22
1746558369132,AIP 197,001,891854,Vespa; Emanuel Ignacio,9999,0,9999,0
1746558370165,ANTH 289S,A00,891856,Gagneux; Pascal,12,0,12,0
1746558371192,BENG 196,001,957946,Engler; Adam J.,9996,0,9999,3
1746558372221,BISP 197,001,959851,Wilhelm; James E.,9998,0,9999,1
1746558373245,CAT 124RS,A01,956906,Staff,6,0,25,19
1746558374271,CAT 125RS,A01,922013,Staff,6,0,25,19
1746558375299,CLRE 250,A00,891860,Morris; Sheldon,9995,0,9999,4
1746558377349,CLRE 251R,A00,907817,Mehta; Ravindra L.,9994,0,9999,5
1746558378377,CLRE 252,A00,891864,Cuomo; Raphael Eduardo,9993,0,9999,6
1746558379403,CLRE 253,A00,891867,Vaida; Florin,9994,0,9999,5
1746558379403,CLRE 253,B00,907819,Staff,9999,0,9999,0
1746558380431,CLRE 259,A00,891868,Patel; Hemal,9998,0,9999,1
1746558381459,CLRE 260,A00,891872,Cuomo; Raphael Eduardo,9999,0,9999,0
1746558382485,CLRE 297,001,891888,Cuomo; Raphael Eduardo,9999,0,9999,0
1746558383519,CSE 191,A00,958773,Minnes Kemp; Mor Mia,9995,0,9999,4
1746558384546,CSE 197,001,959846,Minnes Kemp; Mor Mia,9990,0,9999,9
1746558385830,CSS 201S,A01,892054,Mignozzetti; Umberto,26,0,30,4
1746558386858,CSS 202S,A01,892056,Mignozzetti; Umberto,26,0,30,4
1746558387883,DSC 197,001,956898,Eldridge; Justin Matthew,9997,0,9999,2
1746558388907,DSC 297,001,958000,Mazumdar; Arya,9998,0,9999,1
1746558388907,DSC 297,002,959862,Wang; Yusu,9998,0,9999,1
1746558389931,EAP 100,A00,905686,Staff,9778,0,9999,221
1746558390956,ECE 45,A01,892618,Staff,0,0,65,65
1746558393009,ECE 111,A01,892719,Staff,4,0,65,61
1746558394036,ECE 197,001,957920,Mercier; Patrick Philip,9991,0,9999,8
1746558395061,ECON 178,A01,907814,Zhu; Ying,26,0,35,9
1746558396085,EDS 115,A00,895312,Staff,35,0,45,10
1746558397110,EDS 117,A01,895337,Staff,23,0,30,7
1746558398135,EDS 125,A00,895341,Jones; Gabrielle Anastasia,36,0,45,9
1746558399164,EDS 128A,A01,895459,Fargason; Sharon Gayle,44,0,45,1
1746558400189,EDS 128B,A01,895543,Pappas; Elizabeth,44,0,45,1
1746558401213,EDS 139,A00,897203,Pappas; Elizabeth,44,0,45,1
1746558401213,EDS 139,B00,897209,Fargason; Sharon Gayle,41,0,45,4
1746558402238,EDS 201,A00,895545,Staff,22,0,45,23
1746558403266,EDS 203,A01,895581,Halter; Christopher P.,22,0,45,23
1746558404292,EDS 204R,A01,895625,Heinzman; Erica M.,39,0,45,6
1746558404292,EDS 204R,B01,895693,Halter; Christopher P.,10,0,45,35
1746558405319,EDS 206R,A00,895694,Fargason; Sharon Gayle,1,0,30,29
1746558405319,EDS 206R,B00,895695,Choi; Bailey Miyeon,16,0,30,14
1746558406345,EDS 250,A00,895697,Hemans; Patricia Ann Benitez,22,0,45,23
1746558407370,EDS 281,A00,895701,Meyerott; Theresa Ann,1,0,15,14
1746558408397,EDS 284,A00,895736,Meyerott; Theresa Ann,1,0,15,14
1746558409421,EDS 286,A00,897210,Fine; Sarah,0,0,15,15
1746558410447,EDS 289C,A01,895770,Daly; Alan J.,1,0,15,14
1746558411473,EDS 290,A00,897211,Hofstetter; Carolyn,0,0,15,15
1746558412499,LIGM 5A,A00,896162,Fischer-Grunski; Eva K,12,0,20,8
1746558413526,LIGM 5B,A00,896260,Fischer-Grunski; Eva K,17,0,20,3
1746558414551,LIGM 5C,A00,896308,Fischer-Grunski; Eva K,18,0,20,2
1746558415575,LIIT 5AS,A00,896313,Carnelos; Chiara,18,0,20,2
1746558416601,LIIT 5BS,A00,896416,Carnelos; Chiara,20,0,20,0
1746558417626,LIIT 5CS,A00,896564,Carnelos; Chiara,20,0,20,0
1746558418651,LISP 5A,A00,896588,Munoz Sanchez; Alicia,3,0,20,17
1746558419676,LISP 5B,A00,896653,Munoz Sanchez; Alicia,7,0,20,13
1746558420701,LISP 5C,A00,896655,Munoz Sanchez; Alicia,0,1,20,20
1746558421725,MAE 197,001,957918,Kleissl; Jan,9996,0,9999,3
1746558421725,MAE 197,002,959806,Boechler; Nicholas Sebastia,9998,0,9999,1
1746558421725,MAE 197,003,959852,Mullin; Jennifer S,9998,0,9999,1
1746558422752,MATH 2,A01,957937,Staff,33,0,35,2
1746558423777,MATH 197,001,957876,Kedlaya; Kiran S.,9993,0,9999,6
1746558424804,MCWP 40,A00,892729,Duru; Nur,10,0,20,10
1746558424804,MCWP 40,B00,893304,Montejo; Carolina,14,0,20,6
1746558425831,MCWP 40R,A00,893757,Redela; Pamela Morgan,0,5,20,20
1746558426858,MCWP 50,A00,893758,Morshed; Michael James,0,0,20,20
1746558426858,MCWP 50,B00,893761,Bartulis; Jason Michael,17,0,20,3
1746558427884,MCWP 50R,A00,893766,Compas; Sean Matthew,0,1,20,20
1746558427884,MCWP 50R,B00,893769,Carter; Jennifer A,0,1,20,20
1746558427884,MCWP 50R,C00,893771,Krone; Jarret,0,3,20,20
1746558427884,MCWP 50R,D00,893772,Miller; Elizabeth Deen,0,0,20,20
1746558427884,MCWP 50R,E00,893775,Carter; Andrea L,0,1,20,20
1746558428908,MMW 11R,A01,892721,Herbst; Matthew,11,0,27,16
1746558428908,MMW 11R,A02,892722,Herbst; Matthew,0,0,0,3
1746558429936,MMW 12R,A01,892724,Herbst; Matthew,0,11,16,16
1746558429936,MMW 12R,A02,892725,Herbst; Matthew,0,10,16,16
1746558430963,MMW 13R,A01,892727,Staff,0,4,16,16
1746558430963,MMW 13R,A02,892728,Staff,0,4,16,16
1746558430963,MMW 13R,A03,958032,Staff,0,4,16,16
1746558430963,MMW 13R,A04,958033,Staff,0,4,16,16
1746558430963,MMW 13R,A05,958034,Staff,0,4,16,16
1746558431989,SIO 295LS,A00,894015,Staff,5,0,25,20
1746558433018,SIO 295S,A00,894020,Staff,5,0,25,20
1746558434044,SIOC 290S,B01,958918,Merrifield; Mark A,14,0,30,16
1746558435074,SIOC 291S,B01,958922,Gabriel; Corey John,14,0,30,16
1746558436102,SOCI 117,A01,895339,Staff,3,0,5,2
1746558437126,WES 237B,A00,894149,Staff,11,0,20,9
1746558439186,AESE 279B,A00,891859,Staff,13,0,35,22
1746558440215,AIP 197,001,891854,Vespa; Emanuel Ignacio,9999,0,9999,0
1746558441246,ANTH 289S,A00,891856,Gagneux; Pascal,12,0,12,0
1746558442703,BENG 196,001,957946,Engler; Adam J.,9996,0,9999,3
1746558443729,BISP 197,001,959851,Wilhelm; James E.,9998,0,9999,1
1746558444763,CAT 124RS,A01,956906,Staff,6,0,25,19
1746558445808,CAT 125RS,A01,922013,Staff,6,0,25,19
1746558446834,CLRE 250,A00,891860,Morris; Sheldon,9995,0,9999,4
1746558448886,CLRE 251R,A00,907817,Mehta; Ravindra L.,9994,0,9999,5
1746558449911,CLRE 252,A00,891864,Cuomo; Raphael Eduardo,9993,0,9999,6
1746558450936,CLRE 253,A00,891867,Vaida; Florin,9994,0,9999,5
1746558450936,CLRE 253,B00,907819,Staff,9999,0,9999,0
1746558451960,CLRE 259,A00,891868,Patel; Hemal,9998,0,9999,1
1746558452984,CLRE 260,A00,891872,Cuomo; Raphael Eduardo,9999,0,9999,0
1746558454011,CLRE 297,001,891888,Cuomo; Raphael Eduardo,9999,0,9999,0
1746558455037,CSE 191,A00,958773,Minnes Kemp; Mor Mia,9995,0,9999,4
1746558456064,CSE 197,001,959846,Minnes Kemp; Mor Mia,9990,0,9999,9
1746558457093,CSS 201S,A01,892054,Mignozzetti; Umberto,26,0,30,4
1746558458122,CSS 202S,A01,892056,Mignozzetti; Umberto,26,0,30,4
1746558459146,DSC 197,001,956898,Eldridge; Justin Matthew,9997,0,9999,2
1746558460171,DSC 297,001,958000,Mazumdar; Arya,9998,0,9999,1
1746558460171,DSC 297,002,959862,Wang; Yusu,9998,0,9999,1
1746558461197,EAP 100,A00,905686,Staff,9778,0,9999,221
1746558462424,ECE 45,A01,892618,Staff,0,0,65,65
1746558464475,ECE 111,A01,892719,Staff,4,0,65,61
1746558465501,ECE 197,001,957920,Mercier; Patrick Philip,9991,0,9999,8
1746558466529,ECON 178,A01,907814,Zhu; Ying,26,0,35,9
1746558467553,EDS 115,A00,895312,Staff,35,0,45,10
1746558468580,EDS 117,A01,895337,Staff,23,0,30,7
1746558469605,EDS 125,A00,895341,Jones; Gabrielle Anastasia,36,0,45,9
1746558470629,EDS 128A,A01,895459,Fargason; Sharon Gayle,44,0,45,1
1746558471653,EDS 128B,A01,895543,Pappas; Elizabeth,44,0,45,1
1746558472678,EDS 139,A00,897203,Pappas; Elizabeth,44,0,45,1
1746558472678,EDS 139,B00,897209,Fargason; Sharon Gayle,41,0,45,4
1746558473704,EDS 201,A00,895545,Staff,22,0,45,23
1746558474732,EDS 203,A01,895581,Halter; Christopher P.,22,0,45,23
1746558475758,EDS 204R,A01,895625,Heinzman; Erica M.,39,0,45,6
1746558475758,EDS 204R,B01,895693,Halter; Christopher P.,10,0,45,35
1746558476782,EDS 206R,A00,895694,Fargason; Sharon Gayle,1,0,30,29
1746558476782,EDS 206R,B00,895695,Choi; Bailey Miyeon,16,0,30,14
1746558477811,EDS 250,A00,895697,Hemans; Patricia Ann Benitez,22,0,45,23
1746558478837,EDS 281,A00,895701,Meyerott; Theresa Ann,1,0,15,14
1746558479862,EDS 284,A00,895736,Meyerott; Theresa Ann,1,0,15,14
1746558480886,EDS 286,A00,897210,Fine; Sarah,0,0,15,15
1746558481914,EDS 289C,A01,895770,Daly; Alan J.,1,0,15,14
1746558482994,EDS 290,A00,897211,Hofstetter; Carolyn,0,0,15,15
1746558484022,LIGM 5A,A00,896162,Fischer-Grunski; Eva K,12,0,20,8
1746558485047,LIGM 5B,A00,896260,Fischer-Grunski; Eva K,17,0,20,3
1746558486074,LIGM 5C,A00,896308,Fischer-Grunski; Eva K,18,0,20,2
1746558487102,LIIT 5AS,A00,896313,Carnelos; Chiara,18,0,20,2
1746558488128,LIIT 5BS,A00,896416,Carnelos; Chiara,20,0,20,0
1746558489156,LIIT 5CS,A00,896564,Carnelos; Chiara,20,0,20,0
1746558490190,LISP 5A,A00,896588,Munoz Sanchez; Alicia,3,0,20,17
1746558491214,LISP 5B,A00,896653,Munoz Sanchez; Alicia,7,0,20,13
1746558492240,LISP 5C,A00,896655,Munoz Sanchez; Alicia,0,1,20,20
1746558493266,MAE 197,001,957918,Kleissl; Jan,9996,0,9999,3
1746558493266,MAE 197,002,959806,Boechler; Nicholas Sebastia,9998,0,9999,1
1746558493266,MAE 197,003,959852,Mullin; Jennifer S,9998,0,9999,1
1746558494292,MATH 2,A01,957937,Staff,33,0,35,2
1746558495318,MATH 197,001,957876,Kedlaya; Kiran S.,9993,0,9999,6
1746558496342,MCWP 40,A00,892729,Duru; Nur,10,0,20,10
1746558496342,MCWP 40,B00,893304,Montejo; Carolina,14,0,20,6
1746558497368,MCWP 40R,A00,893757,Redela; Pamela Morgan,0,5,20,20
1746558498393,MCWP 50,A00,893758,Morshed; Michael James,0,0,20,20
1746558498393,MCWP 50,B00,893761,Bartulis; Jason Michael,17,0,20,3
1746558499420,MCWP 50R,A00,893766,Compas; Sean Matthew,0,1,20,20
1746558499420,MCWP 50R,B00,893769,Carter; Jennifer A,0,1,20,20
1746558499420,MCWP 50R,C00,893771,Krone; Jarret,0,3,20,20
1746558499420,MCWP 50R,D00,893772,Miller; Elizabeth Deen,0,0,20,20
1746558499420,MCWP 50R,E00,893775,Carter; Andrea L,0,1,20,20
1746558500444,MMW 11R,A01,892721,Herbst; Matthew,11,0,27,16
1746558500444,MMW 11R,A02,892722,Herbst; Matthew,0,0,0,3
1746558501470,MMW 12R,A01,892724,Herbst; Matthew,0,11,16,16
1746558501470,MMW 12R,A02,892725,Herbst; Matthew,0,10,16,16
1746558502495,MMW 13R,A01,892727,Staff,0,4,16,16
1746558502495,MMW 13R,A02,892728,Staff,0,4,16,16
1746558502495,MMW 13R,A03,958032,Staff,0,4,16,16
1746558502495,MMW 13R,A04,958033,Staff,0,4,16,16
1746558502495,MMW 13R,A05,958034,Staff,0,4,16,16
1746558503520,SIO 295LS,A00,894015,Staff,5,0,25,20
1746558504548,SIO 295S,A00,894020,Staff,5,0,25,20
1746558505576,SIOC 290S,B01,958918,Merrifield; Mark A,14,0,30,16
1746558506602,SIOC 291S,B01,958922,Gabriel; Corey John,14,0,30,16
1746558507639,SOCI 117,A01,895339,Staff,3,0,5,2
1746558508663,WES 237B,A00,894149,Staff,11,0,20,9
1746558510723,AESE 279B,A00,891859,Staff,13,0,35,22
1746558511748,AIP 197,001,891854,Vespa; Emanuel Ignacio,9999,0,9999,0
1746558512777,ANTH 289S,A00,891856,Gagneux; Pascal,12,0,12,0
1746558513805,BENG 196,001,957946,Engler; Adam J.,9996,0,9999,3
1746558514832,BISP 197,001,959851,Wilhelm; James E.,9998,0,9999,1
1746558515856,CAT 124RS,A01,956906,Staff,6,0,25,19
1746558516881,CAT 125RS,A01,922013,Staff,6,0,25,19
1746558517911,CLRE 250,A00,891860,Morris; Sheldon,9995,0,9999,4
1746558519960,CLRE 251R,A00,907817,Mehta; Ravindra L.,9994,0,9999,5
1746558520988,CLRE 252,A00,891864,Cuomo; Raphael Eduardo,9993,0,9999,6
1746558522016,CLRE 253,A00,891867,Vaida; Florin,9994,0,9999,5
1746558522016,CLRE 253,B00,907819,Staff,9999,0,9999,0
1746558523041,CLRE 259,A00,891868,Patel; Hemal,9998,0,9999,1
1746558524069,CLRE 260,A00,891872,Cuomo; Raphael Eduardo,9999,0,9999,0
1746558525094,CLRE 297,001,891888,Cuomo; Raphael Eduardo,9999,0,9999,0
1746558526120,CSE 191,A00,958773,Minnes Kemp; Mor Mia,9995,0,9999,4
1746558527144,CSE 197,001,959846,Minnes Kemp; Mor Mia,9990,0,9999,9
1746558528169,CSS 201S,A01,892054,Mignozzetti; Umberto,26,0,30,4
1746558529193,CSS 202S,A01,892056,Mignozzetti; Umberto,26,0,30,4
1746558530220,DSC 197,001,956898,Eldridge; Justin Matthew,9997,0,9999,2
1746558531245,DSC 297,001,958000,Mazumdar; Arya,9998,0,9999,1
1746558531245,DSC 297,002,959862,Wang; Yusu,9998,0,9999,1
1746558532270,EAP 100,A00,905686,Staff,9778,0,9999,221
1746558533297,ECE 45,A01,892618,Staff,0,0,65,65
1746558535347,ECE 111,A01,892719,Staff,4,0,65,61
1746558536372,ECE 197,001,957920,Mercier; Patrick Philip,9991,0,9999,8
1746558537397,ECON 178,A01,907814,Zhu; Ying,26,0,35,9
1746558538423,EDS 115,A00,895312,Staff,35,0,45,10
1746558539449,EDS 117,A01,895337,Staff,23,0,30,7
1746558540475,EDS 125,A00,895341,Jones; Gabrielle Anastasia,36,0,45,9
1746558541498,EDS 128A,A01,895459,Fargason; Sharon Gayle,44,0,45,1
1746558542526,EDS 128B,A01,895543,Pappas; Elizabeth,44,0,45,1
1746558543552,EDS 139,A00,897203,Pappas; Elizabeth,44,0,45,1
1746558543552,EDS 139,B00,897209,Fargason; Sharon Gayle,41,0,45,4
1746558544579,EDS 201,A00,895545,Staff,22,0,45,23
1746558545604,EDS 203,A01,895581,Halter; Christopher P.,22,0,45,23
1746558546633,EDS 204R,A01,895625,Heinzman; Erica M.,39,0,45,6
1746558546633,EDS 204R,B01,895693,Halter; Christopher P.,10,0,45,35
1746558547658,EDS 206R,A00,895694,Fargason; Sharon Gayle,1,0,30,29
1746558547658,EDS 206R,B00,895695,Choi; Bailey Miyeon,16,0,30,14
1746558548685,EDS 250,A00,895697,Hemans; Patricia Ann Benitez,22,0,45,23
1746558549711,EDS 281,A00,895701,Meyerott; Theresa Ann,1,0,15,14
1746558550734,EDS 284,A00,895736,Meyerott; Theresa Ann,1,0,15,14
1746558551759,EDS 286,A00,897210,Fine; Sarah,0,0,15,15
1746558552785,EDS 289C,A01,895770,Daly; Alan J.,1,0,15,14
1746558553810,EDS 290,A00,897211,Hofstetter; Carolyn,0,0,15,15
1746558554838,LIGM 5A,A00,896162,Fischer-Grunski; Eva K,12,0,20,8
1746558555868,LIGM 5B,A00,896260,Fischer-Grunski; Eva K,17,0,20,3
1746558556893,LIGM 5C,A00,896308,Fischer-Grunski; Eva K,18,0,20,2
1746558557917,LIIT 5AS,A00,896313,Carnelos; Chiara,18,0,20,2
1746558558942,LIIT 5BS,A00,896416,Carnelos; Chiara,20,0,20,0
1746558559978,LIIT 5CS,A00,896564,Carnelos; Chiara,20,0,20,0
1746558561003,LISP 5A,A00,896588,Munoz Sanchez; Alicia,3,0,20,17
1746558562032,LISP 5B,A00,896653,Munoz Sanchez; Alicia,7,0,20,13
1746558563058,LISP 5C,A00,896655,Munoz Sanchez; Alicia,0,1,20,20
1746558564086,MAE 197,001,957918,Kleissl; Jan,9996,0,9999,3
1746558564086,MAE 197,002,959806,Boechler; Nicholas Sebastia,9998,0,9999,1
1746558564086,MAE 197,003,959852,Mullin; Jennifer S,9998,0,9999,1
1746558565112,MATH 2,A01,957937,Staff,33,0,35,2
1746558566139,MATH 197,001,957876,Kedlaya; Kiran S.,9993,0,9999,6
1746558567166,MCWP 40,A00,892729,Duru; Nur,10,0,20,10
1746558567166,MCWP 40,B00,893304,Montejo; Carolina,14,0,20,6
1746558568190,MCWP 40R,A00,893757,Redela; Pamela Morgan,0,5,20,20
1746558569215,MCWP 50,A00,893758,Morshed; Michael James,0,0,20,20
1746558569215,MCWP 50,B00,893761,Bartulis; Jason Michael,17,0,20,3
1746558570245,MCWP 50R,A00,893766,Compas; Sean Matthew,0,1,20,20
1746558570245,MCWP 50R,B00,893769,Carter; Jennifer A,0,1,20,20
1746558570245,MCWP 50R,C00,893771,Krone; Jarret,0,3,20,20
1746558570245,MCWP 50R,D00,893772,Miller; Elizabeth Deen,0,0,20,20
1746558570245,MCWP 50R,E00,893775,Carter; Andrea L,0,1,20,20
1746558571269,MMW 11R,A01,892721,Herbst; Matthew,11,0,27,16
1746558571269,MMW 11R,A02,892722,Herbst; Matthew,0,0,0,3
1746558572294,MMW 12R,A01,892724,Herbst; Matthew,0,11,16,16
1746558572294,MMW 12R,A02,892725,Herbst; Matthew,0,10,16,16
1746558573318,MMW 13R,A01,892727,Staff,0,4,16,16
1746558573318,MMW 13R,A02,892728,Staff,0,4,16,16
1746558573318,MMW 13R,A03,958032,Staff,0,4,16,16
1746558573318,MMW 13R,A04,958033,Staff,0,4,16,16
1746558573318,MMW 13R,A05,958034,Staff,0,4,16,16
1746558574396,SIO 295LS,A00,894015,Staff,5,0,25,20
1746558575425,SIO 295S,A00,894020,Staff,5,0,25,20
1746558576455,SIOC 290S,B01,958918,Merrifield; Mark A,14,0,30,16
1746558577484,SIOC 291S,B01,958922,Gabriel; Corey John,14,0,30,16
1746558578510,SOCI 117,A01,895339,Staff,3,0,5,2
1746558579538,WES 237B,A00,894149,Staff,11,0,20,9
1746558581602,AESE 279B,A00,891859,Staff,13,0,35,22
1746558582627,AIP 197,001,891854,Vespa; Emanuel Ignacio,9999,0,9999,0
1746558583652,ANTH 289S,A00,891856,Gagneux; Pascal,12,0,12,0
1746558584677,BENG 196,001,957946,Engler; Adam J.,9996,0,9999,3
1746558585707,BISP 197,001,959851,Wilhelm; James E.,9998,0,9999,1
1746558586732,CAT 124RS,A01,956906,Staff,6,0,25,19
1746558587757,CAT 125RS,A01,922013,Staff,6,0,25,19
1746558588784,CLRE 250,A00,891860,Morris; Sheldon,9995,0,9999,4
1746558590836,CLRE 251R,A00,907817,Mehta; Ravindra L.,9994,0,9999,5
1746558591862,CLRE 252,A00,891864,Cuomo; Raphael Eduardo,9993,0,9999,6
1746558592894,CLRE 253,A00,891867,Vaida; Florin,9994,0,9999,5
1746558592894,CLRE 253,B00,907819,Staff,9999,0,9999,0
1746558593920,CLRE 259,A00,891868,Patel; Hemal,9998,0,9999,1
1746558594944,CLRE 260,A00,891872,Cuomo; Raphael Eduardo,9999,0,9999,0
1746558595968,CLRE 297,001,891888,Cuomo; Raphael Eduardo,9999,0,9999,0
1746558596993,CSE 191,A00,958773,Minnes Kemp; Mor Mia,9995,0,9999,4
1746558598018,CSE 197,001,959846,Minnes Kemp; Mor Mia,9990,0,9999,9
1746558599048,CSS 201S,A01,892054,Mignozzetti; Umberto,26,0,30,4
1746558600074,CSS 202S,A01,892056,Mignozzetti; Umberto,26,0,30,4
1746558601099,DSC 197,001,956898,Eldridge; Justin Matthew,9997,0,9999,2
1746558602123,DSC 297,001,958000,Mazumdar; Arya,9998,0,9999,1
1746558602123,DSC 297,002,959862,Wang; Yusu,9998,0,9999,1
1746558603150,EAP 100,A00,905686,Staff,9778,0,9999,221
1746558604180,ECE 45,A01,892618,Staff,0,0,65,65
1746558606232,ECE 111,A01,892719,Staff,4,0,65,61
1746558607257,ECE 197,001,957920,Mercier; Patrick Philip,9991,0,9999,8
1746558608282,ECON 178,A01,907814,Zhu; Ying,26,0,35,9
1746558609312,EDS 115,A00,895312,Staff,35,0,45,10
1746558629893,EDS 117,A01,895337,Staff,23,0,30,7
1746558630916,EDS 125,A00,895341,Jones; Gabrielle Anastasia,36,0,45,9
1746558631941,EDS 128A,A01,895459,Fargason; Sharon Gayle,44,0,45,1
1746558632966,EDS 128B,A01,895543,Pappas; Elizabeth,44,0,45,1
1746558633993,EDS 139,A00,897203,Pappas; Elizabeth,44,0,45,1
1746558633993,EDS 139,B00,897209,Fargason; Sharon Gayle,41,0,45,4
1746558635019,EDS 201,A00,895545,Staff,22,0,45,23
1746558636046,EDS 203,A01,895581,Halter; Christopher P.,22,0,45,23
1746558637071,EDS 204R,A01,895625,Heinzman; Erica M.,39,0,45,6
1746558637071,EDS 204R,B01,895693,Halter; Christopher P.,10,0,45,35
1746558638098,EDS 206R,A00,895694,Fargason; Sharon Gayle,1,0,30,29
1746558638098,EDS 206R,B00,895695,Choi; Bailey Miyeon,16,0,30,14
1746558639165,EDS 250,A00,895697,Hemans; Patricia Ann Benitez,22,0,45,23
1746558640193,EDS 281,A00,895701,Meyerott; Theresa Ann,1,0,15,14
1746558641218,EDS 284,A00,895736,Meyerott; Theresa Ann,1,0,15,14
1746558642243,EDS 286,A00,897210,Fine; Sarah,0,0,15,15
1746558643272,EDS 289C,A01,895770,Daly; Alan J.,1,0,15,14
1746558644298,EDS 290,A00,897211,Hofstetter; Carolyn,0,0,15,15
1746558645325,LIGM 5A,A00,896162,Fischer-Grunski; Eva K,12,0,20,8
1746558646355,LIGM 5B,A00,896260,Fischer-Grunski; Eva K,17,0,20,3
1746558647379,LIGM 5C,A00,896308,Fischer-Grunski; Eva K,18,0,20,2
1746558648402,LIIT 5AS,A00,896313,Carnelos; Chiara,18,0,20,2
1746558649431,LIIT 5BS,A00,896416,Carnelos; Chiara,20,0,20,0
1746558650459,LIIT 5CS,A00,896564,Carnelos; Chiara,20,0,20,0
1746558651488,LISP 5A,A00,896588,Munoz Sanchez; Alicia,3,0,20,17
1746558652513,LISP 5B,A00,896653,Munoz Sanchez; Alicia,7,0,20,13
1746558653541,LISP 5C,A00,896655,Munoz Sanchez; Alicia,0,1,20,20
1746558654569,MAE 197,001,957918,Kleissl; Jan,9996,0,9999,3
1746558654569,MAE 197,002,959806,Boechler; Nicholas Sebastia,9998,0,9999,1
1746558654569,MAE 197,003,959852,Mullin; Jennifer S,9998,0,9999,1
1746558655596,MATH 2,A01,957937,Staff,33,0,35,2
1746558656623,MATH 197,001,957876,Kedlaya; Kiran S.,9993,0,9999,6
1746558657650,MCWP 40,A00,892729,Duru; Nur,10,0,20,10
1746558657650,MCWP 40,B00,893304,Montejo; Carolina,14,0,20,6
1746558658680,MCWP 40R,A00,893757,Redela; Pamela Morgan,0,5,20,20
1746558659707,MCWP 50,A00,893758,Morshed; Michael James,0,0,20,20
1746558659707,MCWP 50,B00,893761,Bartulis; Jason Michael,17,0,20,3
1746558660734,MCWP 50R,A00,893766,Compas; Sean Matthew,0,1,20,20
1746558660734,MCWP 50R,B00,893769,Carter; Jennifer A,0,1,20,20
1746558660734,MCWP 50R,C00,893771,Krone; Jarret,0,3,20,20
1746558660734,MCWP 50R,D00,893772,Miller; Elizabeth Deen,0,0,20,20
1746558660734,MCWP 50R,E00,893775,Carter; Andrea L,0,1,20,20
1746558661761,MMW 11R,A01,892721,Herbst; Matthew,11,0,27,16
1746558661761,MMW 11R,A02,892722,Herbst; Matthew,0,0,0,3
1746558662790,MMW 12R,A01,892724,Herbst; Matthew,0,11,16,16
1746558662790,MMW 12R,A02,892725,Herbst; Matthew,0,10,16,16
1746558663816,MMW 13R,A01,892727,Staff,0,4,16,16
1746558663816,MMW 13R,A02,892728,Staff,0,4,16,16
1746558663816,MMW 13R,A03,958032,Staff,0,4,16,16
1746558663816,MMW 13R,A04,958033,Staff,0,4,16,16
1746558663816,MMW 13R,A05,958034,Staff,0,4,16,16
1746558664841,SIO 295LS,A00,894015,Staff,5,0,25,20
1746558665867,SIO 295S,A00,894020,Staff,5,0,25,20
1746558666893,SIOC 290S,B01,958918,Merrifield; Mark A,14,0,30,16
1746558667922,SIOC 291S,B01,958922,Gabriel; Corey John,14,0,30,16
1746558668951,SOCI 117,A01,895339,Staff,3,0,5,2
1746558669977,WES 237B,A00,894149,Staff,11,0,20,9
1746558672038,AESE 279B,A00,891859,Staff,13,0,35,22
1746558673062,AIP 197,001,891854,Vespa; Emanuel Ignacio,9999,0,9999,0
1746558674087,ANTH 289S,A00,891856,Gagneux; Pascal,12,0,12,0
1746558675117,BENG 196,001,957946,Engler; Adam J.,9996,0,9999,3
1746558676140,BISP 197,001,959851,Wilhelm; James E.,9998,0,9999,1
1746558677165,CAT 124RS,A01,956906,Staff,6,0,25,19
1746558678190,CAT 125RS,A01,922013,Staff,6,0,25,19
1746558679217,CLRE 250,A00,891860,Morris; Sheldon,9995,0,9999,4
1746558681270,CLRE 251R,A00,907817,Mehta; Ravindra L.,9994,0,9999,5
1746558682305,CLRE 252,A00,891864,Cuomo; Raphael Eduardo,9993,0,9999,6
1746558683329,CLRE 253,A00,891867,Vaida; Florin,9994,0,9999,5
1746558683329,CLRE 253,B00,907819,Staff,9999,0,9999,0
1746558684355,CLRE 259,A00,891868,Patel; Hemal,9998,0,9999,1
1746558685379,CLRE 260,A00,891872,Cuomo; Raphael Eduardo,9999,0,9999,0
1746558686405,CLRE 297,001,891888,Cuomo; Raphael Eduardo,9999,0,9999,0
1746558687432,CSE 191,A00,958773,Minnes Kemp; Mor Mia,9995,0,9999,4
1746558688456,CSE 197,001,959846,Minnes Kemp; Mor Mia,9990,0,9999,9
1746558689482,CSS 201S,A01,892054,Mignozzetti; Umberto,26,0,30,4
1746558690510,CSS 202S,A01,892056,Mignozzetti; Umberto,26,0,30,4
1746558691536,DSC 197,001,956898,Eldridge; Justin Matthew,9997,0,9999,2
1746558692561,DSC 297,001,958000,Mazumdar; Arya,9998,0,9999,1
1746558692561,DSC 297,002,959862,Wang; Yusu,9998,0,9999,1
1746558693585,EAP 100,A00,905686,Staff,9778,0,9999,221
1746558694614,ECE 45,A01,892618,Staff,0,0,65,65
1746558696666,ECE 111,A01,892719,Staff,4,0,65,61
1746558697692,ECE 197,001,957920,Mercier; Patrick Philip,9991,0,9999,8
1746558698717,ECON 178,A01,907814,Zhu; Ying,26,0,35,9
1746558699744,EDS 115,A00,895312,Staff,35,0,45,10
1746558700769,EDS 117,A01,895337,Staff,23,0,30,7
1746558701796,EDS 125,A00,895341,Jones; Gabrielle Anastasia,36,0,45,9
1746558702820,EDS 128A,A01,895459,Fargason; Sharon Gayle,44,0,45,1
1746558703845,EDS 128B,A01,895543,Pappas; Elizabeth,44,0,45,1
1746558704905,EDS 139,A00,897203,Pappas; Elizabeth,44,0,45,1
1746558704905,EDS 139,B00,897209,Fargason; Sharon Gayle,41,0,45,4
1746558705934,EDS 201,A00,895545,Staff,22,0,45,23
1746558706959,EDS 203,A01,895581,Halter; Christopher P.,22,0,45,23
1746558707985,EDS 204R,A01,895625,Heinzman; Erica M.,39,0,45,6
1746558707985,EDS 204R,B01,895693,Halter; Christopher P.,10,0,45,35
1746558709010,EDS 206R,A00,895694,Fargason; Sharon Gayle,1,0,30,29
1746558709010,EDS 206R,B00,895695,Choi; Bailey Miyeon,16,0,30,14
1746558710039,EDS 250,A00,895697,Hemans; Patricia Ann Benitez,22,0,45,23
1746558711064,EDS 281,A00,895701,Meyerott; Theresa Ann,1,0,15,14
1746558712090,EDS 284,A00,895736,Meyerott; Theresa Ann,1,0,15,14
1746558713115,EDS 286,A00,897210,Fine; Sarah,0,0,15,15
1746558714139,EDS 289C,A01,895770,Daly; Alan J.,1,0,15,14
1746558715165,EDS 290,A00,897211,Hofstetter; Carolyn,0,0,15,15
1746558716193,LIGM 5A,A00,896162,Fischer-Grunski; Eva K,12,0,20,8
1746558717222,LIGM 5B,A00,896260,Fischer-Grunski; Eva K,17,0,20,3
1746558718249,LIGM 5C,A00,896308,Fischer-Grunski; Eva K,18,0,20,2
1746558719276,LIIT 5AS,A00,896313,Carnelos; Chiara,18,0,20,2
1746558720305,LIIT 5BS,A00,896416,Carnelos; Chiara,20,0,20,0
1746558721330,LIIT 5CS,A00,896564,Carnelos; Chiara,20,0,20,0
1746558722359,LISP 5A,A00,896588,Munoz Sanchez; Alicia,3,0,20,17
1746558723386,LISP 5B,A00,896653,Munoz Sanchez; Alicia,7,0,20,13
1746558724411,LISP 5C,A00,896655,Munoz Sanchez; Alicia,0,1,20,20
1746558725442,MAE 197,001,957918,Kleissl; Jan,9996,0,9999,3
1746558725442,MAE 197,002,959806,Boechler; Nicholas Sebastia,9998,0,9999,1
1746558725442,MAE 197,003,959852,Mullin; Jennifer S,9998,0,9999,1
1746558726488,MATH 2,A01,957937,Staff,33,0,35,2
1746558727512,MATH 197,001,957876,Kedlaya; Kiran S.,9993,0,9999,6
1746558728537,MCWP 40,A00,892729,Duru; Nur,10,0,20,10
1746558728537,MCWP 40,B00,893304,Montejo; Carolina,14,0,20,6
1746558729564,MCWP 40R,A00,893757,Redela; Pamela Morgan,0,5,20,20
1746558730592,MCWP 50,A00,893758,Morshed; Michael James,0,0,20,20
1746558730592,MCWP 50,B00,893761,Bartulis; Jason Michael,17,0,20,3
1746558731625,MCWP 50R,A00,893766,Compas; Sean Matthew,0,1,20,20
1746558731625,MCWP 50R,B00,893769,Carter; Jennifer A,0,1,20,20
1746558731625,MCWP 50R,C00,893771,Krone; Jarret,0,3,20,20
1746558731625,MCWP 50R,D00,893772,Miller; Elizabeth Deen,0,0,20,20
1746558731625,MCWP 50R,E00,893775,Carter; Andrea L,0,1,20,20
1746558732651,MMW 11R,A01,892721,Herbst; Matthew,11,0,27,16
1746558732651,MMW 11R,A02,892722,Herbst; Matthew,0,0,0,3
1746558733677,MMW 12R,A01,892724,Herbst; Matthew,0,11,16,16
1746558733677,MMW 12R,A02,892725,Herbst; Matthew,0,10,16,16
1746558734705,MMW 13R,A01,892727,Staff,0,4,16,16
1746558734705,MMW 13R,A02,892728,Staff,0,4,16,16
1746558734705,MMW 13R,A03,958032,Staff,0,4,16,16
1746558734705,MMW 13R,A04,958033,Staff,0,4,16,16
1746558734705,MMW 13R,A05,958034,Staff,0,4,16,16
1746558735729,SIO 295LS,A00,894015,Staff,5,0,25,20
1746558736754,SIO 295S,A00,894020,Staff,5,0,25,20
1746558737786,SIOC 290S,B01,958918,Merrifield; Mark A,14,0,30,16
1746558738812,SIOC 291S,B01,958922,Gabriel; Corey John,14,0,30,16
1746558739839,SOCI 117,A01,895339,Staff,3,0,5,2
1746558740865,WES 237B,A00,894149,Staff,11,0,20,9
1746558742935,AESE 279B,A00,891859,Staff,13,0,35,22
1746558743960,AIP 197,001,891854,Vespa; Emanuel Ignacio,9999,0,9999,0
1746558744984,ANTH 289S,A00,891856,Gagneux; Pascal,12,0,12,0
1746558746011,BENG 196,001,957946,Engler; Adam J.,9996,0,9999,3
1746558747035,BISP 197,001,959851,Wilhelm; James E.,9998,0,9999,1
1746558748065,CAT 124RS,A01,956906,Staff,6,0,25,19
1746558749089,CAT 125RS,A01,922013,Staff,6,0,25,19
1746558750116,CLRE 250,A00,891860,Morris; Sheldon,9995,0,9999,4
1746558752186,CLRE 251R,A00,907817,Mehta; Ravindra L.,9994,0,9999,5
1746558753212,CLRE 252,A00,891864,Cuomo; Raphael Eduardo,9993,0,9999,6
1746558754238,CLRE 253,A00,891867,Vaida; Florin,9994,0,9999,5
1746558754238,CLRE 253,B00,907819,Staff,9999,0,9999,0
1746558755263,CLRE 259,A00,891868,Patel; Hemal,9998,0,9999,1
1746558756288,CLRE 260,A00,891872,Cuomo; Raphael Eduardo,9999,0,9999,0
1746558757315,CLRE 297,001,891888,Cuomo; Raphael Eduardo,9999,0,9999,0
1746558758340,CSE 191,A00,958773,Minnes Kemp; Mor Mia,9995,0,9999,4
1746558759364,CSE 197,001,959846,Minnes Kemp; Mor Mia,9990,0,9999,9
1746558760388,CSS 201S,A01,892054,Mignozzetti; Umberto,26,0,30,4
1746558761413,CSS 202S,A01,892056,Mignozzetti; Umberto,26,0,30,4
1746558762437,DSC 197,001,956898,Eldridge; Justin Matthew,9997,0,9999,2
1746558763461,DSC 297,001,958000,Mazumdar; Arya,9998,0,9999,1
1746558763461,DSC 297,002,959862,Wang; Yusu,9998,0,9999,1
1746558764485,EAP 100,A00,905686,Staff,9778,0,9999,221
1746558765515,ECE 45,A01,892618,Staff,0,0,65,65
1746558767571,ECE 111,A01,892719,Staff,4,0,65,61
1746558768595,ECE 197,001,957920,Mercier; Patrick Philip,9991,0,9999,8
1746558769624,ECON 178,A01,907814,Zhu; Ying,26,0,35,9
1746558770651,EDS 115,A00,895312,Staff,35,0,45,10
1746558771680,EDS 117,A01,895337,Staff,23,0,30,7
1746558772708,EDS 125,A00,895341,Jones; Gabrielle Anastasia,36,0,45,9
1746558773733,EDS 128A,A01,895459,Fargason; Sharon Gayle,44,0,45,1
1746558774759,EDS 128B,A01,895543,Pappas; Elizabeth,44,0,45,1
1746558775787,EDS 139,A00,897203,Pappas; Elizabeth,44,0,45,1
1746558775787,EDS 139,B00,897209,Fargason; Sharon Gayle,41,0,45,4
1746558776813,EDS 201,A00,895545,Staff,22,0,45,23
1746558777842,EDS 203,A01,895581,Halter; Christopher P.,22,0,45,23
1746558778871,EDS 204R,A01,895625,Heinzman; Erica M.,39,0,45,6
1746558778871,EDS 204R,B01,895693,Halter; Christopher P.,10,0,45,35
1746558779896,EDS 206R,A00,895694,Fargason; Sharon Gayle,1,0,30,29
1746558779896,EDS 206R,B00,895695,Choi; Bailey Miyeon,16,0,30,14
1746558780922,EDS 250,A00,895697,Hemans; Patricia Ann Benitez,22,0,45,23
1746558781947,EDS 281,A00,895701,Meyerott; Theresa Ann,1,0,15,14
1746558782972,EDS 284,A00,895736,Meyerott; Theresa Ann,1,0,15,14
1746558783996,EDS 286,A00,897210,Fine; Sarah,0,0,15,15
1746558785025,EDS 289C,A01,895770,Daly; Alan J.,1,0,15,14
1746558786051,EDS 290,A00,897211,Hofstetter; Carolyn,0,0,15,15
1746558787080,LIGM 5A,A00,896162,Fischer-Grunski; Eva K,12,0,20,8
1746558788106,LIGM 5B,A00,896260,Fischer-Grunski; Eva K,17,0,20,3
1746558789136,LIGM 5C,A00,896308,Fischer-Grunski; Eva K,18,0,20,2
1746558790161,LIIT 5AS,A00,896313,Carnelos; Chiara,18,0,20,2
1746558791188,LIIT 5BS,A00,896416,Carnelos; Chiara,20,0,20,0
1746558792212,LIIT 5CS,A00,896564,Carnelos; Chiara,20,0,20,0
1746558793239,LISP 5A,A00,896588,Munoz Sanchez; Alicia,3,0,20,17
1746558794265,LISP 5B,A00,896653,Munoz Sanchez; Alicia,7,0,20,13
1746558795291,LISP 5C,A00,896655,Munoz Sanchez; Alicia,0,1,20,20
1746558796315,MAE 197,001,957918,Kleissl; Jan,9996,0,9999,3
1746558796315,MAE 197,002,959806,Boechler; Nicholas Sebastia,9998,0,9999,1
1746558796315,MAE 197,003,959852,Mullin; Jennifer S,9998,0,9999,1
1746558797344,MATH 2,A01,957937,Staff,33,0,35,2
1746558798369,MATH 197,001,957876,Kedlaya; Kiran S.,9993,0,9999,6
1746558799395,MCWP 40,A00,892729,Duru; Nur,10,0,20,10
1746558799395,MCWP 40,B00,893304,Montejo; Carolina,14,0,20,6
1746558800424,MCWP 40R,A00,893757,Redela; Pamela Morgan,0,5,20,20
1746558801449,MCWP 50,A00,893758,Morshed; Michael James,0,0,20,20
1746558801449,MCWP 50,B00,893761,Bartulis; Jason Michael,17,0,20,3
1746558802481,MCWP 50R,A00,893766,Compas; Sean Matthew,0,1,20,20
1746558802481,MCWP 50R,B00,893769,Carter; Jennifer A,0,1,20,20
1746558802481,MCWP 50R,C00,893771,Krone; Jarret,0,3,20,20
1746558802481,MCWP 50R,D00,893772,Miller; Elizabeth Deen,0,0,20,20
1746558802481,MCWP 50R,E00,893775,Carter; Andrea L,0,1,20,20
1746558803507,MMW 11R,A01,892721,Herbst; Matthew,11,0,27,16
1746558803507,MMW 11R,A02,892722,Herbst; Matthew,0,0,0,3
1746558804530,MMW 12R,A01,892724,Herbst; Matthew,0,11,16,16
1746558804530,MMW 12R,A02,892725,Herbst; Matthew,0,10,16,16
1746558805556,MMW 13R,A01,892727,Staff,0,4,16,16
1746558805556,MMW 13R,A02,892728,Staff,0,4,16,16
1746558805556,MMW 13R,A03,958032,Staff,0,4,16,16
1746558805556,MMW 13R,A04,958033,Staff,0,4,16,16
1746558805556,MMW 13R,A05,958034,Staff,0,4,16,16
1746558806581,SIO 295LS,A00,894015,Staff,5,0,25,20
1746558807607,SIO 295S,A00,894020,Staff,5,0,25,20
1746558808636,SIOC 290S,B01,958918,Merrifield; Mark A,14,0,30,16
1746558809660,SIOC 291S,B01,958922,Gabriel; Corey John,14,0,30,16
1746558810688,SOCI 117,A01,895339,Staff,3,0,5,2
1746558811715,WES 237B,A00,894149,Staff,11,0,20,9
1746558813772,AESE 279B,A00,891859,Staff,13,0,35,22
1746558814798,AIP 197,001,891854,Vespa; Emanuel Ignacio,9999,0,9999,0
1746558815824,ANTH 289S,A00,891856,Gagneux; Pascal,12,0,12,0
1746558816853,BENG 196,001,957946,Engler; Adam J.,9996,0,9999,3
1746558817876,BISP 197,001,959851,Wilhelm; James E.,9998,0,9999,1
1746558818900,CAT 124RS,A01,956906,Staff,6,0,25,19
1746558819925,CAT 125RS,A01,922013,Staff,6,0,25,19
1746558820950,CLRE 250,A00,891860,Morris; Sheldon,9995,0,9999,4
1746558823002,CLRE 251R,A00,907817,Mehta; Ravindra L.,9994,0,9999,5
1746558824028,CLRE 252,A00,891864,Cuomo; Raphael Eduardo,9993,0,9999,6
1746558825056,CLRE 253,A00,891867,Vaida; Florin,9994,0,9999,5
1746558825056,CLRE 253,B00,907819,Staff,9999,0,9999,0
1746558826082,CLRE 259,A00,891868,Patel; Hemal,9998,0,9999,1
1746558827108,CLRE 260,A00,891872,Cuomo; Raphael Eduardo,9999,0,9999,0
1746558828133,CLRE 297,001,891888,Cuomo; Raphael Eduardo,9999,0,9999,0
1746558829157,CSE 191,A00,958773,Minnes Kemp; Mor Mia,9995,0,9999,4
1746558830185,CSE 197,001,959846,Minnes Kemp; Mor Mia,9990,0,9999,9
1746558831214,CSS 201S,A01,892054,Mignozzetti; Umberto,26,0,30,4
1746558832242,CSS 202S,A01,892056,Mignozzetti; Umberto,26,0,30,4
1746558833267,DSC 197,001,956898,Eldridge; Justin Matthew,9997,0,9999,2
1746558834294,DSC 297,001,958000,Mazumdar; Arya,9998,0,9999,1
1746558834294,DSC 297,002,959862,Wang; Yusu,9998,0,9999,1
1746558835317,EAP 100,A00,905686,Staff,9778,0,9999,221
1746558836346,ECE 45,A01,892618,Staff,0,0,65,65
1746558838397,ECE 111,A01,892719,Staff,4,0,65,61
1746558839424,ECE 197,001,957920,Mercier; Patrick Philip,9991,0,9999,8
1746558840453,ECON 178,A01,907814,Zhu; Ying,26,0,35,9
1746558841480,EDS 115,A00,895312,Staff,35,0,45,10
1746558842506,EDS 117,A01,895337,Staff,23,0,30,7
1746558843534,EDS 125,A00,895341,Jones; Gabrielle Anastasia,36,0,45,9
1746558844562,EDS 128A,A01,895459,Fargason; Sharon Gayle,44,0,45,1
1746558845588,EDS 128B,A01,895543,Pappas; Elizabeth,44,0,45,1
1746558846612,EDS 139,A00,897203,Pappas; Elizabeth,44,0,45,1
1746558846612,EDS 139,B00,897209,Fargason; Sharon Gayle,41,0,45,4
1746558847640,EDS 201,A00,895545,Staff,22,0,45,23
1746558848666,EDS 203,A01,895581,Halter; Christopher P.,22,0,45,23
1746558849690,EDS 204R,A01,895625,Heinzman; Erica M.,39,0,45,6
1746558849690,EDS 204R,B01,895693,Halter; Christopher P.,10,0,45,35
1746558850718,EDS 206R,A00,895694,Fargason; Sharon Gayle,1,0,30,29
1746558850718,EDS 206R,B00,895695,Choi; Bailey Miyeon,16,0,30,14
1746558851746,EDS 250,A00,895697,Hemans; Patricia Ann Benitez,22,0,45,23
1746558852772,EDS 281,A00,895701,Meyerott; Theresa Ann,1,0,15,14
1746558853798,EDS 284,A00,895736,Meyerott; Theresa Ann,1,0,15,14
1746558854823,EDS 286,A00,897210,Fine; Sarah,0,0,15,15
1746558855853,EDS 289C,A01,895770,Daly; Alan J.,1,0,15,14
1746558856878,EDS 290,A00,897211,Hofstetter; Carolyn,0,0,15,15
1746558857907,LIGM 5A,A00,896162,Fischer-Grunski; Eva K,12,0,20,8
1746558858934,LIGM 5B,A00,896260,Fischer-Grunski; Eva K,17,0,20,3
1746558859959,LIGM 5C,A00,896308,Fischer-Grunski; Eva K,18,0,20,2
1746558860988,LIIT 5AS,A00,896313,Carnelos; Chiara,18,0,20,2
1746558862017,LIIT 5BS,A00,896416,Carnelos; Chiara,20,0,20,0
1746558863041,LIIT 5CS,A00,896564,Carnelos; Chiara,20,0,20,0
1746558864068,LISP 5A,A00,896588,Munoz Sanchez; Alicia,3,0,20,17
1746558865095,LISP 5B,A00,896653,Munoz Sanchez; Alicia,7,0,20,13
1746558866123,LISP 5C,A00,896655,Munoz Sanchez; Alicia,0,1,20,20
1746558867150,MAE 197,001,957918,Kleissl; Jan,9996,0,9999,3
1746558867150,MAE 197,002,959806,Boechler; Nicholas Sebastia,9998,0,9999,1
1746558867150,MAE 197,003,959852,Mullin; Jennifer S,9998,0,9999,1
1746558868175,MATH 2,A01,957937,Staff,33,0,35,2
1746558869199,MATH 197,001,957876,Kedlaya; Kiran S.,9993,0,9999,6
1746558870223,MCWP 40,A00,892729,Duru; Nur,10,0,20,10
1746558870223,MCWP 40,B00,893304,Montejo; Carolina,14,0,20,6
1746558871249,MCWP 40R,A00,893757,Redela; Pamela Morgan,0,5,20,20
1746558872276,MCWP 50,A00,893758,Morshed; Michael James,0,0,20,20
1746558872276,MCWP 50,B00,893761,Bartulis; Jason Michael,17,0,20,3
1746558873304,MCWP 50R,A00,893766,Compas; Sean Matthew,0,1,20,20
1746558873304,MCWP 50R,B00,893769,Carter; Jennifer A,0,1,20,20
1746558873304,MCWP 50R,C00,893771,Krone; Jarret,0,3,20,20
1746558873304,MCWP 50R,D00,893772,Miller; Elizabeth Deen,0,0,20,20
1746558873304,MCWP 50R,E00,893775,Carter; Andrea L,0,1,20,20
1746558874332,MMW 11R,A01,892721,Herbst; Matthew,11,0,27,16
1746558874332,MMW 11R,A02,892722,Herbst; Matthew,0,0,0,3
1746558875357,MMW 12R,A01,892724,Herbst; Matthew,0,11,16,16
1746558875357,MMW 12R,A02,892725,Herbst; Matthew,0,10,16,16
1746558876382,MMW 13R,A01,892727,Staff,0,4,16,16
1746558876382,MMW 13R,A02,892728,Staff,0,4,16,16
1746558876382,MMW 13R,A03,958032,Staff,0,4,16,16
1746558876382,MMW 13R,A04,958033,Staff,0,4,16,16
1746558876382,MMW 13R,A05,958034,Staff,0,4,16,16
1746558877414,SIO 295LS,A00,894015,Staff,5,0,25,20
1746558878440,SIO 295S,A00,894020,Staff,5,0,25,20
1746558879536,SIOC 290S,B01,958918,Merrifield; Mark A,14,0,30,16
1746558880562,SIOC 291S,B01,958922,Gabriel; Corey John,14,0,30,16
1746558881587,SOCI 117,A01,895339,Staff,3,0,5,2
1746558882614,WES 237B,A00,894149,Staff,11,0,20,9
1746558884670,AESE 279B,A00,891859,Staff,13,0,35,22
1746558885698,AIP 197,001,891854,Vespa; Emanuel Ignacio,9999,0,9999,0
1746558886723,ANTH 289S,A00,891856,Gagneux; Pascal,12,0,12,0
1746558887750,BENG 196,001,957946,Engler; Adam J.,9996,0,9999,3
1746558888778,BISP 197,001,959851,Wilhelm; James E.,9998,0,9999,1
1746558889806,CAT 124RS,A01,956906,Staff,6,0,25,19
1746558890836,CAT 125RS,A01,922013,Staff,6,0,25,19
1746558891865,CLRE 250,A00,891860,Morris; Sheldon,9995,0,9999,4
1746558893915,CLRE 251R,A00,907817,Mehta; Ravindra L.,9994,0,9999,5
1746558894944,CLRE 252,A00,891864,Cuomo; Raphael Eduardo,9993,0,9999,6
1746558895971,CLRE 253,A00,891867,Vaida; Florin,9994,0,9999,5
1746558895971,CLRE 253,B00,907819,Staff,9999,0,9999,0
1746558896995,CLRE 259,A00,891868,Patel; Hemal,9998,0,9999,1
1746558898021,CLRE 260,A00,891872,Cuomo; Raphael Eduardo,9999,0,9999,0
1746558899048,CLRE 297,001,891888,Cuomo; Raphael Eduardo,9999,0,9999,0
1746558900077,CSE 191,A00,958773,Minnes Kemp; Mor Mia,9995,0,9999,4
1746558901103,CSE 197,001,959846,Minnes Kemp; Mor Mia,9990,0,9999,9
1746558902133,CSS 201S,A01,892054,Mignozzetti; Umberto,26,0,30,4
1746558903160,CSS 202S,A01,892056,Mignozzetti; Umberto,26,0,30,4
1746558904186,DSC 197,001,956898,Eldridge; Justin Matthew,9997,0,9999,2
1746558905211,DSC 297,001,958000,Mazumdar; Arya,9998,0,9999,1
1746558905211,DSC 297,002,959862,Wang; Yusu,9998,0,9999,1
1746558906237,EAP 100,A00,905686,Staff,9778,0,9999,221
1746558907265,ECE 45,A01,892618,Staff,0,0,65,65
1746558909341,ECE 111,A01,892719,Staff,4,0,65,61
1746558910369,ECE 197,001,957920,Mercier; Patrick Philip,9991,0,9999,8
1746558911394,ECON 178,A01,907814,Zhu; Ying,26,0,35,9
1746558912417,EDS 115,A00,895312,Staff,35,0,45,10
1746558913440,EDS 117,A01,895337,Staff,23,0,30,7
1746558914466,EDS 125,A00,895341,Jones; Gabrielle Anastasia,36,0,45,9
1746558915496,EDS 128A,A01,895459,Fargason; Sharon Gayle,44,0,45,1
1746558916519,EDS 128B,A01,895543,Pappas; Elizabeth,44,0,45,1
1746558917547,EDS 139,A00,897203,Pappas; Elizabeth,44,0,45,1
1746558917547,EDS 139,B00,897209,Fargason; Sharon Gayle,41,0,45,4
1746558918573,EDS 201,A00,895545,Staff,22,0,45,23
1746558919597,EDS 203,A01,895581,Halter; Christopher P.,22,0,45,23
1746558920626,EDS 204R,A01,895625,Heinzman; Erica M.,39,0,45,6
1746558920626,EDS 204R,B01,895693,Halter; Christopher P.,10,0,45,35
1746558921651,EDS 206R,A00,895694,Fargason; Sharon Gayle,1,0,30,29
1746558921651,EDS 206R,B00,895695,Choi; Bailey Miyeon,16,0,30,14
1746558922677,EDS 250,A00,895697,Hemans; Patricia Ann Benitez,22,0,45,23
1746558923706,EDS 281,A00,895701,Meyerott; Theresa Ann,1,0,15,14
1746558924731,EDS 284,A00,895736,Meyerott; Theresa Ann,1,0,15,14
1746558925756,EDS 286,A00,897210,Fine; Sarah,0,0,15,15
1746558926988,EDS 289C,A01,895770,Daly; Alan J.,1,0,15,14
1746558928014,EDS 290,A00,897211,Hofstetter; Carolyn,0,0,15,15
1746558929042,LIGM 5A,A00,896162,Fischer-Grunski; Eva K,12,0,20,8
1746558930068,LIGM 5B,A00,896260,Fischer-Grunski; Eva K,17,0,20,3
1746558931128,LIGM 5C,A00,896308,Fischer-Grunski; Eva K,18,0,20,2
1746558932151,LIIT 5AS,A00,896313,Carnelos; Chiara,18,0,20,2
1746558933178,LIIT 5BS,A00,896416,Carnelos; Chiara,20,0,20,0
1746558934203,LIIT 5CS,A00,896564,Carnelos; Chiara,20,0,20,0
1746558935228,LISP 5A,A00,896588,Munoz Sanchez; Alicia,3,0,20,17
1746558936257,LISP 5B,A00,896653,Munoz Sanchez; Alicia,7,0,20,13
1746558937281,LISP 5C,A00,896655,Munoz Sanchez; Alicia,0,1,20,20
1746558938308,MAE 197,001,957918,Kleissl; Jan,9996,0,9999,3
1746558938308,MAE 197,002,959806,Boechler; Nicholas Sebastia,9998,0,9999,1
1746558938308,MAE 197,003,959852,Mullin; Jennifer S,9998,0,9999,1
1746558939332,MATH 2,A01,957937,Staff,33,0,35,2
1746558940357,MATH 197,001,957876,Kedlaya; Kiran S.,9993,0,9999,6
1746558941387,MCWP 40,A00,892729,Duru; Nur,10,0,20,10
1746558941387,MCWP 40,B00,893304,Montejo; Carolina,14,0,20,6
1746558942414,MCWP 40R,A00,893757,Redela; Pamela Morgan,0,5,20,20
1746558943443,MCWP 50,A00,893758,Morshed; Michael James,0,0,20,20
1746558943443,MCWP 50,B00,893761,Bartulis; Jason Michael,17,0,20,3
1746558944470,MCWP 50R,A00,893766,Compas; Sean Matthew,0,1,20,20
1746558944470,MCWP 50R,B00,893769,Carter; Jennifer A,0,1,20,20
1746558944470,MCWP 50R,C00,893771,Krone; Jarret,0,3,20,20
1746558944470,MCWP 50R,D00,893772,Miller; Elizabeth Deen,0,0,20,20
1746558944470,MCWP 50R,E00,893775,Carter; Andrea L,0,1,20,20
1746558945499,MMW 11R,A01,892721,Herbst; Matthew,11,0,27,16
1746558945499,MMW 11R,A02,892722,Herbst; Matthew,0,0,0,3
1746558946524,MMW 12R,A01,892724,Herbst; Matthew,0,11,16,16
1746558946524,MMW 12R,A02,892725,Herbst; Matthew,0,10,16,16
1746558947551,MMW 13R,A01,892727,Staff,0,4,16,16
1746558947551,MMW 13R,A02,892728,Staff,0,4,16,16
1746558947551,MMW 13R,A03,958032,Staff,0,4,16,16
1746558947551,MMW 13R,A04,958033,Staff,0,4,16,16
1746558947551,MMW 13R,A05,958034,Staff,0,4,16,16
1746558948580,SIO 295LS,A00,894015,Staff,5,0,25,20
1746558949607,SIO 295S,A00,894020,Staff,5,0,25,20
1746558950634,SIOC 290S,B01,958918,Merrifield; Mark A,14,0,30,16
1746558951662,SIOC 291S,B01,958922,Gabriel; Corey John,14,0,30,16
1746558952688,SOCI 117,A01,895339,Staff,3,0,5,2
1746558953711,WES 237B,A00,894149,Staff,11,0,20,9
1746558955777,AESE 279B,A00,891859,Staff,13,0,35,22
1746558956801,AIP 197,001,891854,Vespa; Emanuel Ignacio,9999,0,9999,0
1746558957827,ANTH 289S,A00,891856,Gagneux; Pascal,12,0,12,0
1746558958853,BENG 196,001,957946,Engler; Adam J.,9996,0,9999,3
1746558959878,BISP 197,001,959851,Wilhelm; James E.,9998,0,9999,1
1746558960905,CAT 124RS,A01,956906,Staff,6,0,25,19
1746558961944,CAT 125RS,A01,922013,Staff,6,0,25,19
1746558962969,CLRE 250,A00,891860,Morris; Sheldon,9995,0,9999,4
1746558965021,CLRE 251R,A00,907817,Mehta; Ravindra L.,9994,0,9999,5
1746558966048,CLRE 252,A00,891864,Cuomo; Raphael Eduardo,9993,0,9999,6
1746558967076,CLRE 253,A00,891867,Vaida; Florin,9994,0,9999,5
1746558967076,CLRE 253,B00,907819,Staff,9999,0,9999,0
1746558968102,CLRE 259,A00,891868,Patel; Hemal,9998,0,9999,1
1746558969126,CLRE 260,A00,891872,Cuomo; Raphael Eduardo,9999,0,9999,0
1746558970150,CLRE 297,001,891888,Cuomo; Raphael Eduardo,9999,0,9999,0
1746558971176,CSE 191,A00,958773,Minnes Kemp; Mor Mia,9995,0,9999,4
1746558972204,CSE 197,001,959846,Minnes Kemp; Mor Mia,9990,0,9999,9
1746558973230,CSS 201S,A01,892054,Mignozzetti; Umberto,26,0,30,4
1746558974256,CSS 202S,A01,892056,Mignozzetti; Umberto,26,0,30,4
1746558975280,DSC 197,001,956898,Eldridge; Justin Matthew,9997,0,9999,2
1746558976307,DSC 297,001,958000,Mazumdar; Arya,9998,0,9999,1
1746558976307,DSC 297,002,959862,Wang; Yusu,9998,0,9999,1
1746558977332,EAP 100,A00,905686,Staff,9778,0,9999,221
1746558978357,ECE 45,A01,892618,Staff,0,0,65,65
1746558980409,ECE 111,A01,892719,Staff,4,0,65,61
1746558981435,ECE 197,001,957920,Mercier; Patrick Philip,9991,0,9999,8
1746558982464,ECON 178,A01,907814,Zhu; Ying,26,0,35,9
1746558983491,EDS 115,A00,895312,Staff,35,0,45,10
1746558984522,EDS 117,A01,895337,Staff,23,0,30,7
1746558985546,EDS 125,A00,895341,Jones; Gabrielle Anastasia,36,0,45,9
1746558986571,EDS 128A,A01,895459,Fargason; Sharon Gayle,44,0,45,1
1746558987596,EDS 128B,A01,895543,Pappas; Elizabeth,44,0,45,1
1746558988624,EDS 139,A00,897203,Pappas; Elizabeth,44,0,45,1
1746558988624,EDS 139,B00,897209,Fargason; Sharon Gayle,41,0,45,4
1746558989650,EDS 201,A00,895545,Staff,22,0,45,23
1746558990675,EDS 203,A01,895581,Halter; Christopher P.,22,0,45,23
1746558991703,EDS 204R,A01,895625,Heinzman; Erica M.,39,0,45,6
1746558991703,EDS 204R,B01,895693,Halter; Christopher P.,10,0,45,35
1746558992731,EDS 206R,A00,895694,Fargason; Sharon Gayle,1,0,30,29
1746558992731,EDS 206R,B00,895695,Choi; Bailey Miyeon,16,0,30,14
1746558993754,EDS 250,A00,895697,Hemans; Patricia Ann Benitez,22,0,45,23
1746558994783,EDS 281,A00,895701,Meyerott; Theresa Ann,1,0,15,14
1746558995811,EDS 284,A00,895736,Meyerott; Theresa Ann,1,0,15,14
1746558996834,EDS 286,A00,897210,Fine; Sarah,0,0,15,15
1746558997859,EDS 289C,A01,895770,Daly; Alan J.,1,0,15,14
1746558998887,EDS 290,A00,897211,Hofstetter; Carolyn,0,0,15,15
1746558999912,LIGM 5A,A00,896162,Fischer-Grunski; Eva K,12,0,20,8
1746559000938,LIGM 5B,A00,896260,Fischer-Grunski; Eva K,17,0,20,3
1746559001963,LIGM 5C,A00,896308,Fischer-Grunski; Eva K,18,0,20,2
1746559002990,LIIT 5AS,A00,896313,Carnelos; Chiara,18,0,20,2
1746559004013,LIIT 5BS,A00,896416,Carnelos; Chiara,20,0,20,0
1746559005038,LIIT 5CS,A00,896564,Carnelos; Chiara,20,0,20,0
1746559006066,LISP 5A,A00,896588,Munoz Sanchez; Alicia,3,0,20,17
1746559007093,LISP 5B,A00,896653,Munoz Sanchez; Alicia,7,0,20,13
1746559008118,LISP 5C,A00,896655,Munoz Sanchez; Alicia,0,1,20,20
1746559009146,MAE 197,001,957918,Kleissl; Jan,9996,0,9999,3
1746559009146,MAE 197,002,959806,Boechler; Nicholas Sebastia,9998,0,9999,1
1746559009146,MAE 197,003,959852,Mullin; Jennifer S,9998,0,9999,1
1746559010170,MATH 2,A01,957937,Staff,33,0,35,2
1746559011195,MATH 197,001,957876,Kedlaya; Kiran S.,9993,0,9999,6
1746559012220,MCWP 40,A00,892729,Duru; Nur,10,0,20,10
1746559012220,MCWP 40,B00,893304,Montejo; Carolina,14,0,20,6
1746559013245,MCWP 40R,A00,893757,Redela; Pamela Morgan,0,5,20,20
1746559014270,MCWP 50,A00,893758,Morshed; Michael James,0,0,20,20
1746559014270,MCWP 50,B00,893761,Bartulis; Jason Michael,17,0,20,3
1746559015298,MCWP 50R,A00,893766,Compas; Sean Matthew,0,1,20,20
1746559015298,MCWP 50R,B00,893769,Carter; Jennifer A,0,1,20,20
1746559015298,MCWP 50R,C00,893771,Krone; Jarret,0,3,20,20
1746559015298,MCWP 50R,D00,893772,Miller; Elizabeth Deen,0,0,20,20
1746559015298,MCWP 50R,E00,893775,Carter; Andrea L,0,1,20,20
1746559016324,MMW 11R,A01,892721,Herbst; Matthew,11,0,27,16
1746559016324,MMW 11R,A02,892722,Herbst; Matthew,0,0,0,3
1746559017349,MMW 12R,A01,892724,Herbst; Matthew,0,11,16,16
1746559017349,MMW 12R,A02,892725,Herbst; Matthew,0,10,16,16
1746559018373,MMW 13R,A01,892727,Staff,0,4,16,16
1746559018373,MMW 13R,A02,892728,Staff,0,4,16,16
1746559018373,MMW 13R,A03,958032,Staff,0,4,16,16
1746559018373,MMW 13R,A04,958033,Staff,0,4,16,16
1746559018373,MMW 13R,A05,958034,Staff,0,4,16,16
1746559019442,SIO 295LS,A00,894015,Staff,5,0,25,20
1746559020467,SIO 295S,A00,894020,Staff,5,0,25,20
1746559021492,SIOC 290S,B01,958918,Merrifield; Mark A,14,0,30,16
1746559022522,SIOC 291S,B01,958922,Gabriel; Corey John,14,0,30,16
1746559023548,SOCI 117,A01,895339,Staff,3,0,5,2
1746559024574,WES 237B,A00,894149,Staff,11,0,20,9
1746559026640,AESE 279B,A00,891859,Staff,13,0,35,22
1746559027666,AIP 197,001,891854,Vespa; Emanuel Ignacio,9999,0,9999,0
1746559028694,ANTH 289S,A00,891856,Gagneux; Pascal,12,0,12,0
1746559029721,BENG 196,001,957946,Engler; Adam J.,9996,0,9999,3
1746559030746,BISP 197,001,959851,Wilhelm; James E.,9998,0,9999,1
1746559031771,CAT 124RS,A01,956906,Staff,6,0,25,19
1746559032797,CAT 125RS,A01,922013,Staff,6,0,25,19
1746559033823,CLRE 250,A00,891860,Morris; Sheldon,9995,0,9999,4
1746559035878,CLRE 251R,A00,907817,Mehta; Ravindra L.,9994,0,9999,5
1746559036903,CLRE 252,A00,891864,Cuomo; Raphael Eduardo,9993,0,9999,6
1746559037928,CLRE 253,A00,891867,Vaida; Florin,9994,0,9999,5
1746559037928,CLRE 253,B00,907819,Staff,9999,0,9999,0
1746559038954,CLRE 259,A00,891868,Patel; Hemal,9998,0,9999,1
1746559039980,CLRE 260,A00,891872,Cuomo; Raphael Eduardo,9999,0,9999,0
1746559041007,CLRE 297,001,891888,Cuomo; Raphael Eduardo,9999,0,9999,0
1746559042035,CSE 191,A00,958773,Minnes Kemp; Mor Mia,9995,0,9999,4
1746559043061,CSE 197,001,959846,Minnes Kemp; Mor Mia,9990,0,9999,9
1746559044086,CSS 201S,A01,892054,Mignozzetti; Umberto,26,0,30,4
1746559045115,CSS 202S,A01,892056,Mignozzetti; Umberto,26,0,30,4
1746559046140,DSC 197,001,956898,Eldridge; Justin Matthew,9997,0,9999,2
1746559047166,DSC 297,001,958000,Mazumdar; Arya,9998,0,9999,1
1746559047166,DSC 297,002,959862,Wang; Yusu,9998,0,9999,1
1746559048191,EAP 100,A00,905686,Staff,9778,0,9999,221
1746559049218,ECE 45,A01,892618,Staff,0,0,65,65
1746559051271,ECE 111,A01,892719,Staff,4,0,65,61
1746559052295,ECE 197,001,957920,Mercier; Patrick Philip,9991,0,9999,8
1746559053320,ECON 178,A01,907814,Zhu; Ying,26,0,35,9
1746559054344,EDS 115,A00,895312,Staff,35,0,45,10
1746559055371,EDS 117,A01,895337,Staff,23,0,30,7
1746559056398,EDS 125,A00,895341,Jones; Gabrielle Anastasia,36,0,45,9
1746559057425,EDS 128A,A01,895459,Fargason; Sharon Gayle,44,0,45,1
1746559058450,EDS 128B,A01,895543,Pappas; Elizabeth,44,0,45,1
1746559059477,EDS 139,A00,897203,Pappas; Elizabeth,44,0,45,1
1746559059477,EDS 139,B00,897209,Fargason; Sharon Gayle,41,0,45,4
1746559060503,EDS 201,A00,895545,Staff,22,0,45,23
1746559061529,EDS 203,A01,895581,Halter; Christopher P.,22,0,45,23
1746559062554,EDS 204R,A01,895625,Heinzman; Erica M.,39,0,45,6
1746559062554,EDS 204R,B01,895693,Halter; Christopher P.,10,0,45,35
1746559063582,EDS 206R,A00,895694,Fargason; Sharon Gayle,1,0,30,29
1746559063582,EDS 206R,B00,895695,Choi; Bailey Miyeon,16,0,30,14
1746559064605,EDS 250,A00,895697,Hemans; Patricia Ann Benitez,22,0,45,23
1746559065633,EDS 281,A00,895701,Meyerott; Theresa Ann,1,0,15,14
1746559066659,EDS 284,A00,895736,Meyerott; Theresa Ann,1,0,15,14
1746559067686,EDS 286,A00,897210,Fine; Sarah,0,0,15,15
1746559068711,EDS 289C,A01,895770,Daly; Alan J.,1,0,15,14
1746559069736,EDS 290,A00,897211,Hofstetter; Carolyn,0,0,15,15
1746559070764,LIGM 5A,A00,896162,Fischer-Grunski; Eva K,12,0,20,8
1746559071789,LIGM 5B,A00,896260,Fischer-Grunski; Eva K,17,0,20,3
1746559072814,LIGM 5C,A00,896308,Fischer-Grunski; Eva K,18,0,20,2
1746559073842,LIIT 5AS,A00,896313,Carnelos; Chiara,18,0,20,2
1746559074869,LIIT 5BS,A00,896416,Carnelos; Chiara,20,0,20,0
1746559075894,LIIT 5CS,A00,896564,Carnelos; Chiara,20,0,20,0
1746559076919,LISP 5A,A00,896588,Munoz Sanchez; Alicia,3,0,20,17
1746559077946,LISP 5B,A00,896653,Munoz Sanchez; Alicia,7,0,20,13
1746559078974,LISP 5C,A00,896655,Munoz Sanchez; Alicia,0,1,20,20
1746559079998,MAE 197,001,957918,Kleissl; Jan,9996,0,9999,3
1746559079998,MAE 197,002,959806,Boechler; Nicholas Sebastia,9998,0,9999,1
1746559079998,MAE 197,003,959852,Mullin; Jennifer S,9998,0,9999,1
1746559081024,MATH 2,A01,957937,Staff,33,0,35,2
1746559082049,MATH 197,001,957876,Kedlaya; Kiran S.,9993,0,9999,6
1746559083074,MCWP 40,A00,892729,Duru; Nur,10,0,20,10
1746559083074,MCWP 40,B00,893304,Montejo; Carolina,14,0,20,6
1746559084101,MCWP 40R,A00,893757,Redela; Pamela Morgan,0,5,20,20
1746559085124,MCWP 50,A00,893758,Morshed; Michael James,0,0,20,20
1746559085124,MCWP 50,B00,893761,Bartulis; Jason Michael,17,0,20,3
1746559086153,MCWP 50R,A00,893766,Compas; Sean Matthew,0,1,20,20
1746559086153,MCWP 50R,B00,893769,Carter; Jennifer A,0,1,20,20
1746559086153,MCWP 50R,C00,893771,Krone; Jarret,0,3,20,20
1746559086153,MCWP 50R,D00,893772,Miller; Elizabeth Deen,0,0,20,20
1746559086153,MCWP 50R,E00,893775,Carter; Andrea L,0,1,20,20
1746559087179,MMW 11R,A01,892721,Herbst; Matthew,11,0,27,16
1746559087179,MMW 11R,A02,892722,Herbst; Matthew,0,0,0,3
1746559088204,MMW 12R,A01,892724,Herbst; Matthew,0,11,16,16
1746559088204,MMW 12R,A02,892725,Herbst; Matthew,0,10,16,16
1746559089229,MMW 13R,A01,892727,Staff,0,4,16,16
1746559089229,MMW 13R,A02,892728,Staff,0,4,16,16
1746559089229,MMW 13R,A03,958032,Staff,0,4,16,16
1746559089229,MMW 13R,A04,958033,Staff,0,4,16,16
1746559089229,MMW 13R,A05,958034,Staff,0,4,16,16
1746559090255,SIO 295LS,A00,894015,Staff,5,0,25,20
1746559091281,SIO 295S,A00,894020,Staff,5,0,25,20
1746559092306,SIOC 290S,B01,958918,Merrifield; Mark A,14,0,30,16
1746559093335,SIOC 291S,B01,958922,Gabriel; Corey John,14,0,30,16
1746559094360,SOCI 117,A01,895339,Staff,3,0,5,2
1746559095384,WES 237B,A00,894149,Staff,11,0,20,9
1746559097440,AESE 279B,A00,891859,Staff,13,0,35,22
1746559098465,AIP 197,001,891854,Vespa; Emanuel Ignacio,9999,0,9999,0
1746559099492,ANTH 289S,A00,891856,Gagneux; Pascal,12,0,12,0
1746559100515,BENG 196,001,957946,Engler; Adam J.,9996,0,9999,3
1746559101538,BISP 197,001,959851,Wilhelm; James E.,9998,0,9999,1
1746559102563,CAT 124RS,A01,956906,Staff,6,0,25,19
1746559103588,CAT 125RS,A01,922013,Staff,6,0,25,19
1746559104620,CLRE 250,A00,891860,Morris; Sheldon,9995,0,9999,4
1746559106670,CLRE 251R,A00,907817,Mehta; Ravindra L.,9994,0,9999,5
1746559107696,CLRE 252,A00,891864,Cuomo; Raphael Eduardo,9993,0,9999,6
1746559108721,CLRE 253,A00,891867,Vaida; Florin,9994,0,9999,5
1746559108721,CLRE 253,B00,907819,Staff,9999,0,9999,0
1746559109748,CLRE 259,A00,891868,Patel; Hemal,9998,0,9999,1
1746559110776,CLRE 260,A00,891872,Cuomo; Raphael Eduardo,9999,0,9999,0
1746559111803,CLRE 297,001,891888,Cuomo; Raphael Eduardo,9999,0,9999,0
1746559112829,CSE 191,A00,958773,Minnes Kemp; Mor Mia,9995,0,9999,4
1746559113857,CSE 197,001,959846,Minnes Kemp; Mor Mia,9990,0,9999,9
1746559114883,CSS 201S,A01,892054,Mignozzetti; Umberto,26,0,30,4
1746559115910,CSS 202S,A01,892056,Mignozzetti; Umberto,26,0,30,4
1746559116958,DSC 197,001,956898,Eldridge; Justin Matthew,9997,0,9999,2
1746559117981,DSC 297,001,958000,Mazumdar; Arya,9998,0,9999,1
1746559117981,DSC 297,002,959862,Wang; Yusu,9998,0,9999,1
1746559119008,EAP 100,A00,905686,Staff,9778,0,9999,221
1746559120033,ECE 45,A01,892618,Staff,0,0,65,65
1746559122089,ECE 111,A01,892719,Staff,4,0,65,61
1746559123112,ECE 197,001,957920,Mercier; Patrick Philip,9991,0,9999,8
1746559124138,ECON 178,A01,907814,Zhu; Ying,26,0,35,9
1746559125162,EDS 115,A00,895312,Staff,35,0,45,10
1746559126187,EDS 117,A01,895337,Staff,23,0,30,7
1746559127215,EDS 125,A00,895341,Jones; Gabrielle Anastasia,36,0,45,9
1746559128242,EDS 128A,A01,895459,Fargason; Sharon Gayle,44,0,45,1
1746559129267,EDS 128B,A01,895543,Pappas; Elizabeth,44,0,45,1
1746559130299,EDS 139,A00,897203,Pappas; Elizabeth,44,0,45,1
1746559130299,EDS 139,B00,897209,Fargason; Sharon Gayle,41,0,45,4
1746559131328,EDS 201,A00,895545,Staff,22,0,45,23
1746559132352,EDS 203,A01,895581,Halter; Christopher P.,22,0,45,23
1746559133380,EDS 204R,A01,895625,Heinzman; Erica M.,39,0,45,6
1746559133380,EDS 204R,B01,895693,Halter; Christopher P.,10,0,45,35
1746559134409,EDS 206R,A00,895694,Fargason; Sharon Gayle,1,0,30,29
1746559134409,EDS 206R,B00,895695,Choi; Bailey Miyeon,16,0,30,14
1746559135437,EDS 250,A00,895697,Hemans; Patricia Ann Benitez,22,0,45,23
1746559136465,EDS 281,A00,895701,Meyerott; Theresa Ann,1,0,15,14
1746559137488,EDS 284,A00,895736,Meyerott; Theresa Ann,1,0,15,14
1746559138513,EDS 286,A00,897210,Fine; Sarah,0,0,15,15
1746559139545,EDS 289C,A01,895770,Daly; Alan J.,1,0,15,14
1746559140575,EDS 290,A00,897211,Hofstetter; Carolyn,0,0,15,15
1746559141605,LIGM 5A,A00,896162,Fischer-Grunski; Eva K,12,0,20,8
1746559142630,LIGM 5B,A00,896260,Fischer-Grunski; Eva K,17,0,20,3
1746559143657,LIGM 5C,A00,896308,Fischer-Grunski; Eva K,18,0,20,2
1746559144725,LIIT 5AS,A00,896313,Carnelos; Chiara,18,0,20,2
1746559145752,LIIT 5BS,A00,896416,Carnelos; Chiara,20,0,20,0
1746559146778,LIIT 5CS,A00,896564,Carnelos; Chiara,20,0,20,0
1746559147804,LISP 5A,A00,896588,Munoz Sanchez; Alicia,3,0,20,17
1746559148830,LISP 5B,A00,896653,Munoz Sanchez; Alicia,7,0,20,13
1746559149855,LISP 5C,A00,896655,Munoz Sanchez; Alicia,0,1,20,20
1746559150882,MAE 197,001,957918,Kleissl; Jan,9996,0,9999,3
1746559150882,MAE 197,002,959806,Boechler; Nicholas Sebastia,9998,0,9999,1
1746559150882,MAE 197,003,959852,Mullin; Jennifer S,9998,0,9999,1
1746559151907,MATH 2,A01,957937,Staff,33,0,35,2
1746559152935,MATH 197,001,957876,Kedlaya; Kiran S.,9993,0,9999,6
1746559153962,MCWP 40,A00,892729,Duru; Nur,10,0,20,10
1746559153962,MCWP 40,B00,893304,Montejo; Carolina,14,0,20,6
1746559154986,MCWP 40R,A00,893757,Redela; Pamela Morgan,0,5,20,20
1746559156012,MCWP 50,A00,893758,Morshed; Michael James,0,0,20,20
1746559156012,MCWP 50,B00,893761,Bartulis; Jason Michael,17,0,20,3
1746559157037,MCWP 50R,A00,893766,Compas; Sean Matthew,0,1,20,20
1746559157037,MCWP 50R,B00,893769,Carter; Jennifer A,0,1,20,20
1746559157037,MCWP 50R,C00,893771,Krone; Jarret,0,3,20,20
1746559157037,MCWP 50R,D00,893772,Miller; Elizabeth Deen,0,0,20,20
1746559157037,MCWP 50R,E00,893775,Carter; Andrea L,0,1,20,20
1746559158065,MMW 11R,A01,892721,Herbst; Matthew,11,0,27,16
1746559158065,MMW 11R,A02,892722,Herbst; Matthew,0,0,0,3
1746559159091,MMW 12R,A01,892724,Herbst; Matthew,0,11,16,16
1746559159091,MMW 12R,A02,892725,Herbst; Matthew,0,10,16,16
1746559160120,MMW 13R,A01,892727,Staff,0,4,16,16
1746559160120,MMW 13R,A02,892728,Staff,0,4,16,16
1746559160120,MMW 13R,A03,958032,Staff,0,4,16,16
1746559160120,MMW 13R,A04,958033,Staff,0,4,16,16
1746559160120,MMW 13R,A05,958034,Staff,0,4,16,16
1746559161149,SIO 295LS,A00,894015,Staff,5,0,25,20
1746559162177,SIO 295S,A00,894020,Staff,5,0,25,20
1746559163203,SIOC 290S,B01,958918,Merrifield; Mark A,14,0,30,16
1746559164236,SIOC 291S,B01,958922,Gabriel; Corey John,14,0,30,16
1746559165262,SOCI 117,A01,895339,Staff,3,0,5,2
1746559166289,WES 237B,A00,894149,Staff,11,0,20,9
1746559168355,AESE 279B,A00,891859,Staff,13,0,35,22
1746559169382,AIP 197,001,891854,Vespa; Emanuel Ignacio,9999,0,9999,0
1746559170408,ANTH 289S,A00,891856,Gagneux; Pascal,12,0,12,0
1746559171440,BENG 196,001,957946,Engler; Adam J.,9996,0,9999,3
1746559172501,BISP 197,001,959851,Wilhelm; James E.,9998,0,9999,1
1746559173525,CAT 124RS,A01,956906,Staff,6,0,25,19
1746559174549,CAT 125RS,A01,922013,Staff,6,0,25,19
1746559175574,CLRE 250,A00,891860,Morris; Sheldon,9995,0,9999,4
1746559177630,CLRE 251R,A00,907817,Mehta; Ravindra L.,9994,0,9999,5
1746559178654,CLRE 252,A00,891864,Cuomo; Raphael Eduardo,9993,0,9999,6
1746559179685,CLRE 253,A00,891867,Vaida; Florin,9994,0,9999,5
1746559179685,CLRE 253,B00,907819,Staff,9999,0,9999,0
1746559180721,CLRE 259,A00,891868,Patel; Hemal,9998,0,9999,1
1746559181747,CLRE 260,A00,891872,Cuomo; Raphael Eduardo,9999,0,9999,0
1746559182771,CLRE 297,001,891888,Cuomo; Raphael Eduardo,9999,0,9999,0
1746559183794,CSE 191,A00,958773,Minnes Kemp; Mor Mia,9995,0,9999,4
1746559184821,CSE 197,001,959846,Minnes Kemp; Mor Mia,9990,0,9999,9
1746559185849,CSS 201S,A01,892054,Mignozzetti; Umberto,26,0,30,4
1746559186874,CSS 202S,A01,892056,Mignozzetti; Umberto,26,0,30,4
1746559187903,DSC 197,001,956898,Eldridge; Justin Matthew,9997,0,9999,2
1746559188926,DSC 297,001,958000,Mazumdar; Arya,9998,0,9999,1
1746559188926,DSC 297,002,959862,Wang; Yusu,9998,0,9999,1
1746559189950,EAP 100,A00,905686,Staff,9778,0,9999,221
1746559190981,ECE 45,A01,892618,Staff,0,0,65,65
1746559193054,ECE 111,A01,892719,Staff,4,0,65,61
1746559194084,ECE 197,001,957920,Mercier; Patrick Philip,9991,0,9999,8
1746559195110,ECON 178,A01,907814,Zhu; Ying,26,0,35,9
1746559196144,EDS 115,A00,895312,Staff,35,0,45,10
1746559197170,EDS 117,A01,895337,Staff,23,0,30,7
1746559198193,EDS 125,A00,895341,Jones; Gabrielle Anastasia,36,0,45,9
1746559199217,EDS 128A,A01,895459,Fargason; Sharon Gayle,44,0,45,1
1746559200245,EDS 128B,A01,895543,Pappas; Elizabeth,44,0,45,1
1746559201272,EDS 139,A00,897203,Pappas; Elizabeth,44,0,45,1
1746559201272,EDS 139,B00,897209,Fargason; Sharon Gayle,41,0,45,4
1746559202296,EDS 201,A00,895545,Staff,22,0,45,23
1746559203327,EDS 203,A01,895581,Halter; Christopher P.,22,0,45,23
1746559204351,EDS 204R,A01,895625,Heinzman; Erica M.,39,0,45,6
1746559204351,EDS 204R,B01,895693,Halter; Christopher P.,10,0,45,35
1746559205375,EDS 206R,A00,895694,Fargason; Sharon Gayle,1,0,30,29
1746559205375,EDS 206R,B00,895695,Choi; Bailey Miyeon,16,0,30,14
1746559206402,EDS 250,A00,895697,Hemans; Patricia Ann Benitez,22,0,45,23
1746559207429,EDS 281,A00,895701,Meyerott; Theresa Ann,1,0,15,14
1746559208455,EDS 284,A00,895736,Meyerott; Theresa Ann,1,0,15,14
1746559209483,EDS 286,A00,897210,Fine; Sarah,0,0,15,15
1746559210510,EDS 289C,A01,895770,Daly; Alan J.,1,0,15,14
1746559211539,EDS 290,A00,897211,Hofstetter; Carolyn,0,0,15,15
1746559212564,LIGM 5A,A00,896162,Fischer-Grunski; Eva K,12,0,20,8
1746559213592,LIGM 5B,A00,896260,Fischer-Grunski; Eva K,17,0,20,3
1746559214620,LIGM 5C,A00,896308,Fischer-Grunski; Eva K,18,0,20,2
1746559215648,LIIT 5AS,A00,896313,Carnelos; Chiara,18,0,20,2
1746559216678,LIIT 5BS,A00,896416,Carnelos; Chiara,20,0,20,0
1746559217703,LIIT 5CS,A00,896564,Carnelos; Chiara,20,0,20,0
1746559218731,LISP 5A,A00,896588,Munoz Sanchez; Alicia,3,0,20,17
1746559219764,LISP 5B,A00,896653,Munoz Sanchez; Alicia,7,0,20,13
1746559220791,LISP 5C,A00,896655,Munoz Sanchez; Alicia,0,1,20,20
1746559221818,MAE 197,001,957918,Kleissl; Jan,9996,0,9999,3
1746559221818,MAE 197,002,959806,Boechler; Nicholas Sebastia,9998,0,9999,1
1746559221818,MAE 197,003,959852,Mullin; Jennifer S,9998,0,9999,1
1746559222847,MATH 2,A01,957937,Staff,33,0,35,2
1746559223873,MATH 197,001,957876,Kedlaya; Kiran S.,9993,0,9999,6
1746559224898,MCWP 40,A00,892729,Duru; Nur,10,0,20,10
1746559224898,MCWP 40,B00,893304,Montejo; Carolina,14,0,20,6
1746559225923,MCWP 40R,A00,893757,Redela; Pamela Morgan,0,5,20,20
1746559226953,MCWP 50,A00,893758,Morshed; Michael James,0,0,20,20
1746559226953,MCWP 50,B00,893761,Bartulis; Jason Michael,17,0,20,3
1746559227981,MCWP 50R,A00,893766,Compas; Sean Matthew,0,1,20,20
1746559227981,MCWP 50R,B00,893769,Carter; Jennifer A,0,1,20,20
1746559227981,MCWP 50R,C00,893771,Krone; Jarret,0,3,20,20
1746559227981,MCWP 50R,D00,893772,Miller; Elizabeth Deen,0,0,20,20
1746559227981,MCWP 50R,E00,893775,Carter; Andrea L,0,1,20,20
1746559229004,MMW 11R,A01,892721,Herbst; Matthew,11,0,27,16
1746559229004,MMW 11R,A02,892722,Herbst; Matthew,0,0,0,3
1746559230028,MMW 12R,A01,892724,Herbst; Matthew,0,11,16,16
1746559230028,MMW 12R,A02,892725,Herbst; Matthew,0,10,16,16
1746559231059,MMW 13R,A01,892727,Staff,0,4,16,16
1746559231059,MMW 13R,A02,892728,Staff,0,4,16,16
1746559231059,MMW 13R,A03,958032,Staff,0,4,16,16
1746559231059,MMW 13R,A04,958033,Staff,0,4,16,16
1746559231059,MMW 13R,A05,958034,Staff,0,4,16,16
1746559232088,SIO 295LS,A00,894015,Staff,5,0,25,20
1746559233111,SIO 295S,A00,894020,Staff,5,0,25,20
1746559234137,SIOC 290S,B01,958918,Merrifield; Mark A,14,0,30,16
1746559235167,SIOC 291S,B01,958922,Gabriel; Corey John,14,0,30,16
1746559236191,SOCI 117,A01,895339,Staff,3,0,5,2
1746559237215,WES 237B,A00,894149,Staff,11,0,20,9
1746559239271,AESE 279B,A00,891859,Staff,13,0,35,22
1746559240298,AIP 197,001,891854,Vespa; Emanuel Ignacio,9999,0,9999,0
1746559241325,ANTH 289S,A00,891856,Gagneux; Pascal,12,0,12,0
1746559242352,BENG 196,001,957946,Engler; Adam J.,9996,0,9999,3
1746559243375,BISP 197,001,959851,Wilhelm; James E.,9998,0,9999,1
1746559244399,CAT 124RS,A01,956906,Staff,6,0,25,19
1746559245423,CAT 125RS,A01,922013,Staff,6,0,25,19
1746559246450,CLRE 250,A00,891860,Morris; Sheldon,9995,0,9999,4
1746559248505,CLRE 251R,A00,907817,Mehta; Ravindra L.,9994,0,9999,5
1746559249529,CLRE 252,A00,891864,Cuomo; Raphael Eduardo,9993,0,9999,6
1746559250555,CLRE 253,A00,891867,Vaida; Florin,9994,0,9999,5
1746559250555,CLRE 253,B00,907819,Staff,9999,0,9999,0
1746559251586,CLRE 259,A00,891868,Patel; Hemal,9998,0,9999,1
1746559252613,CLRE 260,A00,891872,Cuomo; Raphael Eduardo,9999,0,9999,0
1746559253639,CLRE 297,001,891888,Cuomo; Raphael Eduardo,9999,0,9999,0
1746559254666,CSE 191,A00,958773,Minnes Kemp; Mor Mia,9995,0,9999,4
1746559255742,CSE 197,001,959846,Minnes Kemp; Mor Mia,9990,0,9999,9
1746559256769,CSS 201S,A01,892054,Mignozzetti; Umberto,26,0,30,4
1746559257805,CSS 202S,A01,892056,Mignozzetti; Umberto,26,0,30,4
1746559258833,DSC 197,001,956898,Eldridge; Justin Matthew,9997,0,9999,2
1746559259867,DSC 297,001,958000,Mazumdar; Arya,9998,0,9999,1
1746559259867,DSC 297,002,959862,Wang; Yusu,9998,0,9999,1
1746559260892,EAP 100,A00,905686,Staff,9778,0,9999,221
1746559261920,ECE 45,A01,892618,Staff,0,0,65,65
1746559263975,ECE 111,A01,892719,Staff,4,0,65,61
1746559265002,ECE 197,001,957920,Mercier; Patrick Philip,9991,0,9999,8
1746559266026,ECON 178,A01,907814,Zhu; Ying,26,0,35,9
1746559267051,EDS 115,A00,895312,Staff,35,0,45,10
1746559268076,EDS 117,A01,895337,Staff,23,0,30,7
1746559269100,EDS 125,A00,895341,Jones; Gabrielle Anastasia,36,0,45,9
1746559270128,EDS 128A,A01,895459,Fargason; Sharon Gayle,44,0,45,1
1746559271157,EDS 128B,A01,895543,Pappas; Elizabeth,44,0,45,1
1746559272182,EDS 139,A00,897203,Pappas; Elizabeth,44,0,45,1
1746559272182,EDS 139,B00,897209,Fargason; Sharon Gayle,41,0,45,4
1746559273208,EDS 201,A00,895545,Staff,22,0,45,23
1746559274241,EDS 203,A01,895581,Halter; Christopher P.,22,0,45,23
1746559275267,EDS 204R,A01,895625,Heinzman; Erica M.,39,0,45,6
1746559275267,EDS 204R,B01,895693,Halter; Christopher P.,10,0,45,35
1746559276294,EDS 206R,A00,895694,Fargason; Sharon Gayle,1,0,30,29
1746559276294,EDS 206R,B00,895695,Choi; Bailey Miyeon,16,0,30,14
1746559277341,EDS 250,A00,895697,Hemans; Patricia Ann Benitez,22,0,45,23
1746559278366,EDS 281,A00,895701,Meyerott; Theresa Ann,1,0,15,14
1746559279393,EDS 284,A00,895736,Meyerott; Theresa Ann,1,0,15,14
1746559280421,EDS 286,A00,897210,Fine; Sarah,0,0,15,15
1746559281445,EDS 289C,A01,895770,Daly; Alan J.,1,0,15,14
1746559282473,EDS 290,A00,897211,Hofstetter; Carolyn,0,0,15,15
1746559283506,LIGM 5A,A00,896162,Fischer-Grunski; Eva K,12,0,20,8
1746559284530,LIGM 5B,A00,896260,Fischer-Grunski; Eva K,17,0,20,3
1746559285559,LIGM 5C,A00,896308,Fischer-Grunski; Eva K,18,0,20,2
1746559286586,LIIT 5AS,A00,896313,Carnelos; Chiara,18,0,20,2
1746559287613,LIIT 5BS,A00,896416,Carnelos; Chiara,20,0,20,0
1746559289225,LIIT 5CS,A00,896564,Carnelos; Chiara,20,0,20,0
1746559290248,LISP 5A,A00,896588,Munoz Sanchez; Alicia,3,0,20,17
1746559291276,LISP 5B,A00,896653,Munoz Sanchez; Alicia,7,0,20,13
1746559292302,LISP 5C,A00,896655,Munoz Sanchez; Alicia,0,1,20,20
1746559293327,MAE 197,001,957918,Kleissl; Jan,9996,0,9999,3
1746559293327,MAE 197,002,959806,Boechler; Nicholas Sebastia,9998,0,9999,1
1746559293327,MAE 197,003,959852,Mullin; Jennifer S,9998,0,9999,1
1746559294357,MATH 2,A01,957937,Staff,33,0,35,2
1746559295383,MATH 197,001,957876,Kedlaya; Kiran S.,9993,0,9999,6
1746559296411,MCWP 40,A00,892729,Duru; Nur,10,0,20,10
1746559296411,MCWP 40,B00,893304,Montejo; Carolina,14,0,20,6
1746559297447,MCWP 40R,A00,893757,Redela; Pamela Morgan,0,5,20,20
1746559298474,MCWP 50,A00,893758,Morshed; Michael James,0,0,20,20
1746559298474,MCWP 50,B00,893761,Bartulis; Jason Michael,17,0,20,3
1746559299503,MCWP 50R,A00,893766,Compas; Sean Matthew,0,1,20,20
1746559299503,MCWP 50R,B00,893769,Carter; Jennifer A,0,1,20,20
1746559299503,MCWP 50R,C00,893771,Krone; Jarret,0,3,20,20
1746559299503,MCWP 50R,D00,893772,Miller; Elizabeth Deen,0,0,20,20
1746559299503,MCWP 50R,E00,893775,Carter; Andrea L,0,1,20,20
1746559300532,MMW 11R,A01,892721,Herbst; Matthew,11,0,27,16
1746559300532,MMW 11R,A02,892722,Herbst; Matthew,0,0,0,3
1746559301557,MMW 12R,A01,892724,Herbst; Matthew,0,11,16,16
1746559301557,MMW 12R,A02,892725,Herbst; Matthew,0,10,16,16
1746559302585,MMW 13R,A01,892727,Staff,0,4,16,16
1746559302585,MMW 13R,A02,892728,Staff,0,4,16,16
1746559302585,MMW 13R,A03,958032,Staff,0,4,16,16
1746559302585,MMW 13R,A04,958033,Staff,0,4,16,16
1746559302585,MMW 13R,A05,958034,Staff,0,4,16,16
1746559303613,SIO 295LS,A00,894015,Staff,5,0,25,20
1746559304640,SIO 295S,A00,894020,Staff,5,0,25,20
1746559305669,SIOC 290S,B01,958918,Merrifield; Mark A,14,0,30,16
1746559306696,SIOC 291S,B01,958922,Gabriel; Corey John,14,0,30,16
1746559307724,SOCI 117,A01,895339,Staff,3,0,5,2
1746559308748,WES 237B,A00,894149,Staff,11,0,20,9
1746559310808,AESE 279B,A00,891859,Staff,13,0,35,22
1746559311832,AIP 197,001,891854,Vespa; Emanuel Ignacio,9999,0,9999,0
1746559312856,ANTH 289S,A00,891856,Gagneux; Pascal,12,0,12,0
1746559313880,BENG 196,001,957946,Engler; Adam J.,9996,0,9999,3
1746559314907,BISP 197,001,959851,Wilhelm; James E.,9998,0,9999,1
1746559315932,CAT 124RS,A01,956906,Staff,6,0,25,19
1746559316958,CAT 125RS,A01,922013,Staff,6,0,25,19
1746559317985,CLRE 250,A00,891860,Morris; Sheldon,9995,0,9999,4
1746559320037,CLRE 251R,A00,907817,Mehta; Ravindra L.,9994,0,9999,5
1746559321065,CLRE 252,A00,891864,Cuomo; Raphael Eduardo,9993,0,9999,6
1746559322090,CLRE 253,A00,891867,Vaida; Florin,9994,0,9999,5
1746559322090,CLRE 253,B00,907819,Staff,9999,0,9999,0
1746559323115,CLRE 259,A00,891868,Patel; Hemal,9998,0,9999,1
1746559324140,CLRE 260,A00,891872,Cuomo; Raphael Eduardo,9999,0,9999,0
1746559325165,CLRE 297,001,891888,Cuomo; Raphael Eduardo,9999,0,9999,0
1746559326190,CSE 191,A00,958773,Minnes Kemp; Mor Mia,9995,0,9999,4
1746559327217,CSE 197,001,959846,Minnes Kemp; Mor Mia,9990,0,9999,9
1746559328243,CSS 201S,A01,892054,Mignozzetti; Umberto,26,0,30,4
1746559329269,CSS 202S,A01,892056,Mignozzetti; Umberto,26,0,30,4
1746559330294,DSC 197,001,956898,Eldridge; Justin Matthew,9997,0,9999,2
1746559331321,DSC 297,001,958000,Mazumdar; Arya,9998,0,9999,1
1746559331321,DSC 297,002,959862,Wang; Yusu,9998,0,9999,1
1746559332347,EAP 100,A00,905686,Staff,9778,0,9999,221
1746559333377,ECE 45,A01,892618,Staff,0,0,65,65
1746559335433,ECE 111,A01,892719,Staff,4,0,65,61
1746559336460,ECE 197,001,957920,Mercier; Patrick Philip,9991,0,9999,8
1746559337489,ECON 178,A01,907814,Zhu; Ying,26,0,35,9
1746559338516,EDS 115,A00,895312,Staff,35,0,45,10
1746559339543,EDS 117,A01,895337,Staff,23,0,30,7
1746559340571,EDS 125,A00,895341,Jones; Gabrielle Anastasia,36,0,45,9
1746559341595,EDS 128A,A01,895459,Fargason; Sharon Gayle,44,0,45,1
1746559342621,EDS 128B,A01,895543,Pappas; Elizabeth,44,0,45,1
1746559343645,EDS 139,A00,897203,Pappas; Elizabeth,44,0,45,1
1746559343645,EDS 139,B00,897209,Fargason; Sharon Gayle,41,0,45,4
1746559344670,EDS 201,A00,895545,Staff,22,0,45,23
1746559345694,EDS 203,A01,895581,Halter; Christopher P.,22,0,45,23
1746559346718,EDS 204R,A01,895625,Heinzman; Erica M.,39,0,45,6
1746559346718,EDS 204R,B01,895693,Halter; Christopher P.,10,0,45,35
1746559347743,EDS 206R,A00,895694,Fargason; Sharon Gayle,1,0,30,29
1746559347743,EDS 206R,B00,895695,Choi; Bailey Miyeon,16,0,30,14
1746559348771,EDS 250,A00,895697,Hemans; Patricia Ann Benitez,22,0,45,23
1746559349799,EDS 281,A00,895701,Meyerott; Theresa Ann,1,0,15,14
1746559350828,EDS 284,A00,895736,Meyerott; Theresa Ann,1,0,15,14
1746559351856,EDS 286,A00,897210,Fine; Sarah,0,0,15,15
1746559352882,EDS 289C,A01,895770,Daly; Alan J.,1,0,15,14
1746559353906,EDS 290,A00,897211,Hofstetter; Carolyn,0,0,15,15
1746559354930,LIGM 5A,A00,896162,Fischer-Grunski; Eva K,12,0,20,8
1746559355956,LIGM 5B,A00,896260,Fischer-Grunski; Eva K,17,0,20,3
1746559356981,LIGM 5C,A00,896308,Fischer-Grunski; Eva K,18,0,20,2
1746559358009,LIIT 5AS,A00,896313,Carnelos; Chiara,18,0,20,2
1746559359034,LIIT 5BS,A00,896416,Carnelos; Chiara,20,0,20,0
1746559360061,LIIT 5CS,A00,896564,Carnelos; Chiara,20,0,20,0
1746559361089,LISP 5A,A00,896588,Munoz Sanchez; Alicia,3,0,20,17
1746559362114,LISP 5B,A00,896653,Munoz Sanchez; Alicia,7,0,20,13
1746559363144,LISP 5C,A00,896655,Munoz Sanchez; Alicia,0,1,20,20
1746559364170,MAE 197,001,957918,Kleissl; Jan,9996,0,9999,3
1746559364170,MAE 197,002,959806,Boechler; Nicholas Sebastia,9998,0,9999,1
1746559364170,MAE 197,003,959852,Mullin; Jennifer S,9998,0,9999,1
1746559365193,MATH 2,A01,957937,Staff,33,0,35,2
1746559366217,MATH 197,001,957876,Kedlaya; Kiran S.,9993,0,9999,6
1746559367242,MCWP 40,A00,892729,Duru; Nur,10,0,20,10
1746559367242,MCWP 40,B00,893304,Montejo; Carolina,14,0,20,6
1746559368269,MCWP 40R,A00,893757,Redela; Pamela Morgan,0,5,20,20
1746559369296,MCWP 50,A00,893758,Morshed; Michael James,0,0,20,20
1746559369296,MCWP 50,B00,893761,Bartulis; Jason Michael,17,0,20,3
1746559370326,MCWP 50R,A00,893766,Compas; Sean Matthew,0,1,20,20
1746559370326,MCWP 50R,B00,893769,Carter; Jennifer A,0,1,20,20
1746559370326,MCWP 50R,C00,893771,Krone; Jarret,0,3,20,20
1746559370326,MCWP 50R,D00,893772,Miller; Elizabeth Deen,0,0,20,20
1746559370326,MCWP 50R,E00,893775,Carter; Andrea L,0,1,20,20
1746559371357,MMW 11R,A01,892721,Herbst; Matthew,11,0,27,16
1746559371357,MMW 11R,A02,892722,Herbst; Matthew,0,0,0,3
1746559372385,MMW 12R,A01,892724,Herbst; Matthew,0,11,16,16
1746559372385,MMW 12R,A02,892725,Herbst; Matthew,0,10,16,16
1746559373409,MMW 13R,A01,892727,Staff,0,4,16,16
1746559373409,MMW 13R,A02,892728,Staff,0,4,16,16
1746559373409,MMW 13R,A03,958032,Staff,0,4,16,16
1746559373409,MMW 13R,A04,958033,Staff,0,4,16,16
1746559373409,MMW 13R,A05,958034,Staff,0,4,16,16
1746559374437,SIO 295LS,A00,894015,Staff,5,0,25,20
1746559375461,SIO 295S,A00,894020,Staff,5,0,25,20
1746559376487,SIOC 290S,B01,958918,Merrifield; Mark A,14,0,30,16
1746559377512,SIOC 291S,B01,958922,Gabriel; Corey John,14,0,30,16
1746559378535,SOCI 117,A01,895339,Staff,3,0,5,2
1746559379560,WES 237B,A00,894149,Staff,11,0,20,9
1746559381614,AESE 279B,A00,891859,Staff,13,0,35,22
1746559382641,AIP 197,001,891854,Vespa; Emanuel Ignacio,9999,0,9999,0
1746559383669,ANTH 289S,A00,891856,Gagneux; Pascal,12,0,12,0
1746559384693,BENG 196,001,957946,Engler; Adam J.,9996,0,9999,3
1746559385717,BISP 197,001,959851,Wilhelm; James E.,9998,0,9999,1
1746559386742,CAT 124RS,A01,956906,Staff,6,0,25,19
1746559387805,CAT 125RS,A01,922013,Staff,6,0,25,19
1746559388829,CLRE 250,A00,891860,Morris; Sheldon,9995,0,9999,4
1746559390881,CLRE 251R,A00,907817,Mehta; Ravindra L.,9994,0,9999,5
1746559391909,CLRE 252,A00,891864,Cuomo; Raphael Eduardo,9993,0,9999,6
1746559392945,CLRE 253,A00,891867,Vaida; Florin,9994,0,9999,5
1746559392945,CLRE 253,B00,907819,Staff,9999,0,9999,0
1746559393969,CLRE 259,A00,891868,Patel; Hemal,9998,0,9999,1
1746559394996,CLRE 260,A00,891872,Cuomo; Raphael Eduardo,9999,0,9999,0
1746559396022,CLRE 297,001,891888,Cuomo; Raphael Eduardo,9999,0,9999,0
1746559397048,CSE 191,A00,958773,Minnes Kemp; Mor Mia,9995,0,9999,4
1746559398074,CSE 197,001,959846,Minnes Kemp; Mor Mia,9990,0,9999,9
1746559399104,CSS 201S,A01,892054,Mignozzetti; Umberto,26,0,30,4
1746559400133,CSS 202S,A01,892056,Mignozzetti; Umberto,26,0,30,4
1746559401161,DSC 197,001,956898,Eldridge; Justin Matthew,9997,0,9999,2
1746559402187,DSC 297,001,958000,Mazumdar; Arya,9998,0,9999,1
1746559402187,DSC 297,002,959862,Wang; Yusu,9998,0,9999,1
1746559403211,EAP 100,A00,905686,Staff,9778,0,9999,221
1746559404241,ECE 45,A01,892618,Staff,0,0,65,65
1746559406293,ECE 111,A01,892719,Staff,4,0,65,61
1746559407317,ECE 197,001,957920,Mercier; Patrick Philip,9991,0,9999,8
1746559408343,ECON 178,A01,907814,Zhu; Ying,26,0,35,9
1746559409369,EDS 115,A00,895312,Staff,35,0,45,10
1746559410393,EDS 117,A01,895337,Staff,23,0,30,7
1746559411420,EDS 125,A00,895341,Jones; Gabrielle Anastasia,36,0,45,9
1746559412449,EDS 128A,A01,895459,Fargason; Sharon Gayle,44,0,45,1
1746559413473,EDS 128B,A01,895543,Pappas; Elizabeth,44,0,45,1
1746559414500,EDS 139,A00,897203,Pappas; Elizabeth,44,0,45,1
1746559414500,EDS 139,B00,897209,Fargason; Sharon Gayle,41,0,45,4
1746559415525,EDS 201,A00,895545,Staff,22,0,45,23
1746559416553,EDS 203,A01,895581,Halter; Christopher P.,22,0,45,23
1746559417578,EDS 204R,A01,895625,Heinzman; Erica M.,39,0,45,6
1746559417578,EDS 204R,B01,895693,Halter; Christopher P.,10,0,45,35
1746559418604,EDS 206R,A00,895694,Fargason; Sharon Gayle,1,0,30,29
1746559418604,EDS 206R,B00,895695,Choi; Bailey Miyeon,16,0,30,14
1746559419630,EDS 250,A00,895697,Hemans; Patricia Ann Benitez,22,0,45,23
1746559420659,EDS 281,A00,895701,Meyerott; Theresa Ann,1,0,15,14
1746559421684,EDS 284,A00,895736,Meyerott; Theresa Ann,1,0,15,14
1746559422709,EDS 286,A00,897210,Fine; Sarah,0,0,15,15
1746559423736,EDS 289C,A01,895770,Daly; Alan J.,1,0,15,14
1746559424763,EDS 290,A00,897211,Hofstetter; Carolyn,0,0,15,15
1746559425791,LIGM 5A,A00,896162,Fischer-Grunski; Eva K,12,0,20,8
1746559426821,LIGM 5B,A00,896260,Fischer-Grunski; Eva K,17,0,20,3
1746559427847,LIGM 5C,A00,896308,Fischer-Grunski; Eva K,18,0,20,2
1746559428875,LIIT 5AS,A00,896313,Carnelos; Chiara,18,0,20,2
1746559429904,LIIT 5BS,A00,896416,Carnelos; Chiara,20,0,20,0
1746559430929,LIIT 5CS,A00,896564,Carnelos; Chiara,20,0,20,0
1746559431954,LISP 5A,A00,896588,Munoz Sanchez; Alicia,3,0,20,17
1746559432979,LISP 5B,A00,896653,Munoz Sanchez; Alicia,7,0,20,13
1746559434007,LISP 5C,A00,896655,Munoz Sanchez; Alicia,0,1,20,20
1746559435033,MAE 197,001,957918,Kleissl; Jan,9996,0,9999,3
1746559435033,MAE 197,002,959806,Boechler; Nicholas Sebastia,9998,0,9999,1
1746559435033,MAE 197,003,959852,Mullin; Jennifer S,9998,0,9999,1
1746559436061,MATH 2,A01,957937,Staff,33,0,35,2
1746559437089,MATH 197,001,957876,Kedlaya; Kiran S.,9993,0,9999,6
1746559438112,MCWP 40,A00,892729,Duru; Nur,10,0,20,10
1746559438112,MCWP 40,B00,893304,Montejo; Carolina,14,0,20,6
1746559439140,MCWP 40R,A00,893757,Redela; Pamela Morgan,0,5,20,20
1746559440165,MCWP 50,A00,893758,Morshed; Michael James,0,0,20,20
1746559440165,MCWP 50,B00,893761,Bartulis; Jason Michael,17,0,20,3
1746559441194,MCWP 50R,A00,893766,Compas; Sean Matthew,0,1,20,20
1746559441194,MCWP 50R,B00,893769,Carter; Jennifer A,0,1,20,20
1746559441194,MCWP 50R,C00,893771,Krone; Jarret,0,3,20,20
1746559441194,MCWP 50R,D00,893772,Miller; Elizabeth Deen,0,0,20,20
1746559441194,MCWP 50R,E00,893775,Carter; Andrea L,0,1,20,20
1746559442222,MMW 11R,A01,892721,Herbst; Matthew,11,0,27,16
1746559442222,MMW 11R,A02,892722,Herbst; Matthew,0,0,0,3
1746559443248,MMW 12R,A01,892724,Herbst; Matthew,0,11,16,16
1746559443248,MMW 12R,A02,892725,Herbst; Matthew,0,10,16,16
1746559444274,MMW 13R,A01,892727,Staff,0,4,16,16
1746559444274,MMW 13R,A02,892728,Staff,0,4,16,16
1746559444274,MMW 13R,A03,958032,Staff,0,4,16,16
1746559444274,MMW 13R,A04,958033,Staff,0,4,16,16
1746559444274,MMW 13R,A05,958034,Staff,0,4,16,16
1746559445298,SIO 295LS,A00,894015,Staff,5,0,25,20
1746559446326,SIO 295S,A00,894020,Staff,5,0,25,20
1746559447355,SIOC 290S,B01,958918,Merrifield; Mark A,14,0,30,16
1746559448379,SIOC 291S,B01,958922,Gabriel; Corey John,14,0,30,16
1746559449403,SOCI 117,A01,895339,Staff,3,0,5,2
1746559450428,WES 237B,A00,894149,Staff,11,0,20,9
1746559452506,AESE 279B,A00,891859,Staff,13,0,35,22
1746559453533,AIP 197,001,891854,Vespa; Emanuel Ignacio,9999,0,9999,0
1746559454558,ANTH 289S,A00,891856,Gagneux; Pascal,12,0,12,0
1746559455584,BENG 196,001,957946,Engler; Adam J.,9996,0,9999,3
1746559456611,BISP 197,001,959851,Wilhelm; James E.,9998,0,9999,1
1746559457637,CAT 124RS,A01,956906,Staff,6,0,25,19
1746559458665,CAT 125RS,A01,922013,Staff,6,0,25,19
1746559459693,CLRE 250,A00,891860,Morris; Sheldon,9995,0,9999,4
1746559461749,CLRE 251R,A00,907817,Mehta; Ravindra L.,9994,0,9999,5
1746559462775,CLRE 252,A00,891864,Cuomo; Raphael Eduardo,9993,0,9999,6
1746559463803,CLRE 253,A00,891867,Vaida; Florin,9994,0,9999,5
1746559463803,CLRE 253,B00,907819,Staff,9999,0,9999,0
1746559464829,CLRE 259,A00,891868,Patel; Hemal,9998,0,9999,1
1746559465855,CLRE 260,A00,891872,Cuomo; Raphael Eduardo,9999,0,9999,0
1746559466881,CLRE 297,001,891888,Cuomo; Raphael Eduardo,9999,0,9999,0
1746559467907,CSE 191,A00,958773,Minnes Kemp; Mor Mia,9995,0,9999,4
1746559468932,CSE 197,001,959846,Minnes Kemp; Mor Mia,9990,0,9999,9
1746559469957,CSS 201S,A01,892054,Mignozzetti; Umberto,26,0,30,4
1746559470986,CSS 202S,A01,892056,Mignozzetti; Umberto,26,0,30,4
1746559472011,DSC 197,001,956898,Eldridge; Justin Matthew,9997,0,9999,2
1746559473039,DSC 297,001,958000,Mazumdar; Arya,9998,0,9999,1
1746559473039,DSC 297,002,959862,Wang; Yusu,9998,0,9999,1
1746559474065,EAP 100,A00,905686,Staff,9778,0,9999,221
1746559475092,ECE 45,A01,892618,Staff,0,0,65,65
1746559477143,ECE 111,A01,892719,Staff,4,0,65,61
1746559478168,ECE 197,001,957920,Mercier; Patrick Philip,9991,0,9999,8
1746559479197,ECON 178,A01,907814,Zhu; Ying,26,0,35,9
1746559480223,EDS 115,A00,895312,Staff,35,0,45,10
1746559481250,EDS 117,A01,895337,Staff,23,0,30,7
1746559482278,EDS 125,A00,895341,Jones; Gabrielle Anastasia,36,0,45,9
1746559483310,EDS 128A,A01,895459,Fargason; Sharon Gayle,44,0,45,1
1746559484338,EDS 128B,A01,895543,Pappas; Elizabeth,44,0,45,1
1746559485364,EDS 139,A00,897203,Pappas; Elizabeth,44,0,45,1
1746559485364,EDS 139,B00,897209,Fargason; Sharon Gayle,41,0,45,4
1746559486389,EDS 201,A00,895545,Staff,22,0,45,23
1746559487416,EDS 203,A01,895581,Halter; Christopher P.,22,0,45,23
1746559488445,EDS 204R,A01,895625,Heinzman; Erica M.,39,0,45,6
1746559488445,EDS 204R,B01,895693,Halter; Christopher P.,10,0,45,35
1746559489470,EDS 206R,A00,895694,Fargason; Sharon Gayle,1,0,30,29
1746559489470,EDS 206R,B00,895695,Choi; Bailey Miyeon,16,0,30,14
1746559490494,EDS 250,A00,895697,Hemans; Patricia Ann Benitez,22,0,45,23
1746559491560,EDS 281,A00,895701,Meyerott; Theresa Ann,1,0,15,14
1746559492583,EDS 284,A00,895736,Meyerott; Theresa Ann,1,0,15,14
1746559493611,EDS 286,A00,897210,Fine; Sarah,0,0,15,15
1746559494635,EDS 289C,A01,895770,Daly; Alan J.,1,0,15,14
1746559495663,EDS 290,A00,897211,Hofstetter; Carolyn,0,0,15,15
1746559496691,LIGM 5A,A00,896162,Fischer-Grunski; Eva K,12,0,20,8
1746559497716,LIGM 5B,A00,896260,Fischer-Grunski; Eva K,17,0,20,3
1746559498745,LIGM 5C,A00,896308,Fischer-Grunski; Eva K,18,0,20,2
1746559499774,LIIT 5AS,A00,896313,Carnelos; Chiara,18,0,20,2
1746559500799,LIIT 5BS,A00,896416,Carnelos; Chiara,20,0,20,0
1746559501828,LIIT 5CS,A00,896564,Carnelos; Chiara,20,0,20,0
1746559502856,LISP 5A,A00,896588,Munoz Sanchez; Alicia,3,0,20,17
1746559503880,LISP 5B,A00,896653,Munoz Sanchez; Alicia,7,0,20,13
1746559504906,LISP 5C,A00,896655,Munoz Sanchez; Alicia,0,1,20,20
1746559505931,MAE 197,001,957918,Kleissl; Jan,9996,0,9999,3
1746559505931,MAE 197,002,959806,Boechler; Nicholas Sebastia,9998,0,9999,1
1746559505931,MAE 197,003,959852,Mullin; Jennifer S,9998,0,9999,1
1746559506956,MATH 2,A01,957937,Staff,33,0,35,2
1746559507980,MATH 197,001,957876,Kedlaya; Kiran S.,9993,0,9999,6
1746559509007,MCWP 40,A00,892729,Duru; Nur,10,0,20,10
1746559509007,MCWP 40,B00,893304,Montejo; Carolina,14,0,20,6
1746559510036,MCWP 40R,A00,893757,Redela; Pamela Morgan,0,5,20,20
1746559511061,MCWP 50,A00,893758,Morshed; Michael James,0,0,20,20
1746559511061,MCWP 50,B00,893761,Bartulis; Jason Michael,17,0,20,3
1746559512087,MCWP 50R,A00,893766,Compas; Sean Matthew,0,1,20,20
1746559512087,MCWP 50R,B00,893769,Carter; Jennifer A,0,1,20,20
1746559512087,MCWP 50R,C00,893771,Krone; Jarret,0,3,20,20
1746559512087,MCWP 50R,D00,893772,Miller; Elizabeth Deen,0,0,20,20
1746559512087,MCWP 50R,E00,893775,Carter; Andrea L,0,1,20,20
1746559513114,MMW 11R,A01,892721,Herbst; Matthew,11,0,27,16
1746559513114,MMW 11R,A02,892722,Herbst; Matthew,0,0,0,3
1746559514140,MMW 12R,A01,892724,Herbst; Matthew,0,11,16,16
1746559514140,MMW 12R,A02,892725,Herbst; Matthew,0,10,16,16
1746559515165,MMW 13R,A01,892727,Staff,0,4,16,16
1746559515165,MMW 13R,A02,892728,Staff,0,4,16,16
1746559515165,MMW 13R,A03,958032,Staff,0,4,16,16
1746559515165,MMW 13R,A04,958033,Staff,0,4,16,16
1746559515165,MMW 13R,A05,958034,Staff,0,4,16,16
1746559516194,SIO 295LS,A00,894015,Staff,5,0,25,20
1746559517218,SIO 295S,A00,894020,Staff,5,0,25,20
1746559518253,SIOC 290S,B01,958918,Merrifield; Mark A,14,0,30,16
1746559519283,SIOC 291S,B01,958922,Gabriel; Corey John,14,0,30,16
1746559520311,SOCI 117,A01,895339,Staff,3,0,5,2
1746559521335,WES 237B,A00,894149,Staff,11,0,20,9
1746559523405,AESE 279B,A00,891859,Staff,13,0,35,22
1746559524431,AIP 197,001,891854,Vespa; Emanuel Ignacio,9999,0,9999,0
1746559525455,ANTH 289S,A00,891856,Gagneux; Pascal,12,0,12,0
1746559526480,BENG 196,001,957946,Engler; Adam J.,9996,0,9999,3
1746559527507,BISP 197,001,959851,Wilhelm; James E.,9998,0,9999,1
1746559528533,CAT 124RS,A01,956906,Staff,6,0,25,19
1746559529558,CAT 125RS,A01,922013,Staff,6,0,25,19
1746559530585,CLRE 250,A00,891860,Morris; Sheldon,9995,0,9999,4
1746559532636,CLRE 251R,A00,907817,Mehta; Ravindra L.,9994,0,9999,5
1746559533662,CLRE 252,A00,891864,Cuomo; Raphael Eduardo,9993,0,9999,6
1746559534688,CLRE 253,A00,891867,Vaida; Florin,9994,0,9999,5
1746559534688,CLRE 253,B00,907819,Staff,9999,0,9999,0
1746559535713,CLRE 259,A00,891868,Patel; Hemal,9998,0,9999,1
1746559536737,CLRE 260,A00,891872,Cuomo; Raphael Eduardo,9999,0,9999,0
1746559537760,CLRE 297,001,891888,Cuomo; Raphael Eduardo,9999,0,9999,0
1746559538785,CSE 191,A00,958773,Minnes Kemp; Mor Mia,9995,0,9999,4
1746559539813,CSE 197,001,959846,Minnes Kemp; Mor Mia,9990,0,9999,9
1746559540838,CSS 201S,A01,892054,Mignozzetti; Umberto,26,0,30,4
1746559541865,CSS 202S,A01,892056,Mignozzetti; Umberto,26,0,30,4
1746559542891,DSC 197,001,956898,Eldridge; Justin Matthew,9997,0,9999,2
1746559543918,DSC 297,001,958000,Mazumdar; Arya,9998,0,9999,1
1746559543918,DSC 297,002,959862,Wang; Yusu,9998,0,9999,1
1746559544945,EAP 100,A00,905686,Staff,9778,0,9999,221
1746559545975,ECE 45,A01,892618,Staff,0,0,65,65
1746559548028,ECE 111,A01,892719,Staff,4,0,65,61
1746559549057,ECE 197,001,957920,Mercier; Patrick Philip,9991,0,9999,8
1746559550083,ECON 178,A01,907814,Zhu; Ying,26,0,35,9
1746559551112,EDS 115,A00,895312,Staff,35,0,45,10
1746559552140,EDS 117,A01,895337,Staff,23,0,30,7
1746559553169,EDS 125,A00,895341,Jones; Gabrielle Anastasia,36,0,45,9
1746559554194,EDS 128A,A01,895459,Fargason; Sharon Gayle,44,0,45,1
1746559555223,EDS 128B,A01,895543,Pappas; Elizabeth,44,0,45,1
1746559556251,EDS 139,A00,897203,Pappas; Elizabeth,44,0,45,1
1746559556251,EDS 139,B00,897209,Fargason; Sharon Gayle,41,0,45,4
1746559557281,EDS 201,A00,895545,Staff,22,0,45,23
1746559558324,EDS 203,A01,895581,Halter; Christopher P.,22,0,45,23
1746559559351,EDS 204R,A01,895625,Heinzman; Erica M.,39,0,45,6
1746559559351,EDS 204R,B01,895693,Halter; Christopher P.,10,0,45,35
1746559560379,EDS 206R,A00,895694,Fargason; Sharon Gayle,1,0,30,29
1746559560379,EDS 206R,B00,895695,Choi; Bailey Miyeon,16,0,30,14
1746559561404,EDS 250,A00,895697,Hemans; Patricia Ann Benitez,22,0,45,23
1746559562433,EDS 281,A00,895701,Meyerott; Theresa Ann,1,0,15,14
1746559563458,EDS 284,A00,895736,Meyerott; Theresa Ann,1,0,15,14
1746559564484,EDS 286,A00,897210,Fine; Sarah,0,0,15,15
1746559565512,EDS 289C,A01,895770,Daly; Alan J.,1,0,15,14
1746559566537,EDS 290,A00,897211,Hofstetter; Carolyn,0,0,15,15
1746559567565,LIGM 5A,A00,896162,Fischer-Grunski; Eva K,12,0,20,8
1746559568595,LIGM 5B,A00,896260,Fischer-Grunski; Eva K,17,0,20,3
1746559569624,LIGM 5C,A00,896308,Fischer-Grunski; Eva K,18,0,20,2
1746559570657,LIIT 5AS,A00,896313,Carnelos; Chiara,18,0,20,2
1746559571682,LIIT 5BS,A00,896416,Carnelos; Chiara,20,0,20,0
1746559572709,LIIT 5CS,A00,896564,Carnelos; Chiara,20,0,20,0
1746559573738,LISP 5A,A00,896588,Munoz Sanchez; Alicia,3,0,20,17
1746559574764,LISP 5B,A00,896653,Munoz Sanchez; Alicia,7,0,20,13
1746559575788,LISP 5C,A00,896655,Munoz Sanchez; Alicia,0,1,20,20
1746559576816,MAE 197,001,957918,Kleissl; Jan,9996,0,9999,3
1746559576816,MAE 197,002,959806,Boechler; Nicholas Sebastia,9998,0,9999,1
1746559576816,MAE 197,003,959852,Mullin; Jennifer S,9998,0,9999,1
1746559577846,MATH 2,A01,957937,Staff,33,0,35,2
1746559578872,MATH 197,001,957876,Kedlaya; Kiran S.,9993,0,9999,6
1746559579903,MCWP 40,A00,892729,Duru; Nur,10,0,20,10
1746559579903,MCWP 40,B00,893304,Montejo; Carolina,14,0,20,6
1746559580930,MCWP 40R,A00,893757,Redela; Pamela Morgan,0,5,20,20
1746559581957,MCWP 50,A00,893758,Morshed; Michael James,0,0,20,20
1746559581957,MCWP 50,B00,893761,Bartulis; Jason Michael,17,0,20,3
1746559582986,MCWP 50R,A00,893766,Compas; Sean Matthew,0,1,20,20
1746559582986,MCWP 50R,B00,893769,Carter; Jennifer A,0,1,20,20
1746559582986,MCWP 50R,C00,893771,Krone; Jarret,0,3,20,20
1746559582986,MCWP 50R,D00,893772,Miller; Elizabeth Deen,0,0,20,20
1746559582986,MCWP 50R,E00,893775,Carter; Andrea L,0,1,20,20
1746559584014,MMW 11R,A01,892721,Herbst; Matthew,11,0,27,16
1746559584014,MMW 11R,A02,892722,Herbst; Matthew,0,0,0,3
1746559585041,MMW 12R,A01,892724,Herbst; Matthew,0,11,16,16
1746559585041,MMW 12R,A02,892725,Herbst; Matthew,0,10,16,16
1746559586067,MMW 13R,A01,892727,Staff,0,4,16,16
1746559586067,MMW 13R,A02,892728,Staff,0,4,16,16
1746559586067,MMW 13R,A03,958032,Staff,0,4,16,16
1746559586067,MMW 13R,A04,958033,Staff,0,4,16,16
1746559586067,MMW 13R,A05,958034,Staff,0,4,16,16
1746559587093,SIO 295LS,A00,894015,Staff,5,0,25,20
1746559588119,SIO 295S,A00,894020,Staff,5,0,25,20
1746559589144,SIOC 290S,B01,958918,Merrifield; Mark A,14,0,30,16
1746559590169,SIOC 291S,B01,958922,Gabriel; Corey John,14,0,30,16
1746559591195,SOCI 117,A01,895339,Staff,3,0,5,2
1746559592220,WES 237B,A00,894149,Staff,11,0,20,9
1746559594281,AESE 279B,A00,891859,Staff,13,0,35,22
1746559595362,AIP 197,001,891854,Vespa; Emanuel Ignacio,9999,0,9999,0
1746559596388,ANTH 289S,A00,891856,Gagneux; Pascal,12,0,12,0
1746559597412,BENG 196,001,957946,Engler; Adam J.,9996,0,9999,3
1746559598438,BISP 197,001,959851,Wilhelm; James E.,9998,0,9999,1
1746559599465,CAT 124RS,A01,956906,Staff,6,0,25,19
1746559600490,CAT 125RS,A01,922013,Staff,6,0,25,19
1746559601514,CLRE 250,A00,891860,Morris; Sheldon,9995,0,9999,4
1746559603563,CLRE 251R,A00,907817,Mehta; Ravindra L.,9994,0,9999,5
1746559604588,CLRE 252,A00,891864,Cuomo; Raphael Eduardo,9993,0,9999,6
1746559605637,CLRE 253,A00,891867,Vaida; Florin,9994,0,9999,5
1746559605637,CLRE 253,B00,907819,Staff,9999,0,9999,0
1746559606662,CLRE 259,A00,891868,Patel; Hemal,9998,0,9999,1
1746559607687,CLRE 260,A00,891872,Cuomo; Raphael Eduardo,9999,0,9999,0
1746559608713,CLRE 297,001,891888,Cuomo; Raphael Eduardo,9999,0,9999,0
1746559609739,CSE 191,A00,958773,Minnes Kemp; Mor Mia,9995,0,9999,4
1746559610764,CSE 197,001,959846,Minnes Kemp; Mor Mia,9990,0,9999,9
1746559611792,CSS 201S,A01,892054,Mignozzetti; Umberto,26,0,30,4
1746559612817,CSS 202S,A01,892056,Mignozzetti; Umberto,26,0,30,4
1746559613841,DSC 197,001,956898,Eldridge; Justin Matthew,9997,0,9999,2
1746559614867,DSC 297,001,958000,Mazumdar; Arya,9998,0,9999,1
1746559614867,DSC 297,002,959862,Wang; Yusu,9998,0,9999,1
1746559615895,EAP 100,A00,905686,Staff,9778,0,9999,221
1746559616922,ECE 45,A01,892618,Staff,0,0,65,65
1746559618977,ECE 111,A01,892719,Staff,4,0,65,61
1746559620005,ECE 197,001,957920,Mercier; Patrick Philip,9991,0,9999,8
1746559621035,ECON 178,A01,907814,Zhu; Ying,26,0,35,9
1746559622059,EDS 115,A00,895312,Staff,35,0,45,10
1746559623084,EDS 117,A01,895337,Staff,23,0,30,7
1746559624109,EDS 125,A00,895341,Jones; Gabrielle Anastasia,36,0,45,9
1746559625133,EDS 128A,A01,895459,Fargason; Sharon Gayle,44,0,45,1
1746559626157,EDS 128B,A01,895543,Pappas; Elizabeth,44,0,45,1
1746559627182,EDS 139,A00,897203,Pappas; Elizabeth,44,0,45,1
1746559627182,EDS 139,B00,897209,Fargason; Sharon Gayle,41,0,45,4
1746559628206,EDS 201,A00,895545,Staff,22,0,45,23
1746559629240,EDS 203,A01,895581,Halter; Christopher P.,22,0,45,23
1746559630264,EDS 204R,A01,895625,Heinzman; Erica M.,39,0,45,6
1746559630264,EDS 204R,B01,895693,Halter; Christopher P.,10,0,45,35
1746559631289,EDS 206R,A00,895694,Fargason; Sharon Gayle,1,0,30,29
1746559631289,EDS 206R,B00,895695,Choi; Bailey Miyeon,16,0,30,14
1746559632313,EDS 250,A00,895697,Hemans; Patricia Ann Benitez,22,0,45,23
1746559633337,EDS 281,A00,895701,Meyerott; Theresa Ann,1,0,15,14
1746559634361,EDS 284,A00,895736,Meyerott; Theresa Ann,1,0,15,14
1746559635387,EDS 286,A00,897210,Fine; Sarah,0,0,15,15
1746559636415,EDS 289C,A01,895770,Daly; Alan J.,1,0,15,14
1746559637439,EDS 290,A00,897211,Hofstetter; Carolyn,0,0,15,15
1746559638463,LIGM 5A,A00,896162,Fischer-Grunski; Eva K,12,0,20,8
1746559639490,LIGM 5B,A00,896260,Fischer-Grunski; Eva K,17,0,20,3
1746559640515,LIGM 5C,A00,896308,Fischer-Grunski; Eva K,18,0,20,2
1746559641540,LIIT 5AS,A00,896313,Carnelos; Chiara,18,0,20,2
1746559642565,LIIT 5BS,A00,896416,Carnelos; Chiara,20,0,20,0
1746559643590,LIIT 5CS,A00,896564,Carnelos; Chiara,20,0,20,0
1746559644617,LISP 5A,A00,896588,Munoz Sanchez; Alicia,3,0,20,17
1746559645646,LISP 5B,A00,896653,Munoz Sanchez; Alicia,7,0,20,13
1746559646671,LISP 5C,A00,896655,Munoz Sanchez; Alicia,0,1,20,20
1746559647700,MAE 197,001,957918,Kleissl; Jan,9996,0,9999,3
1746559647700,MAE 197,002,959806,Boechler; Nicholas Sebastia,9998,0,9999,1
1746559647700,MAE 197,003,959852,Mullin; Jennifer S,9998,0,9999,1
1746559648725,MATH 2,A01,957937,Staff,33,0,35,2
1746559649750,MATH 197,001,957876,Kedlaya; Kiran S.,9993,0,9999,6
1746559650775,MCWP 40,A00,892729,Duru; Nur,10,0,20,10
1746559650775,MCWP 40,B00,893304,Montejo; Carolina,14,0,20,6
1746559651803,MCWP 40R,A00,893757,Redela; Pamela Morgan,0,5,20,20
1746559652830,MCWP 50,A00,893758,Morshed; Michael James,0,0,20,20
1746559652830,MCWP 50,B00,893761,Bartulis; Jason Michael,17,0,20,3
1746559653859,MCWP 50R,A00,893766,Compas; Sean Matthew,0,1,20,20
1746559653859,MCWP 50R,B00,893769,Carter; Jennifer A,0,1,20,20
1746559653859,MCWP 50R,C00,893771,Krone; Jarret,0,3,20,20
1746559653859,MCWP 50R,D00,893772,Miller; Elizabeth Deen,0,0,20,20
1746559653859,MCWP 50R,E00,893775,Carter; Andrea L,0,1,20,20
1746559654884,MMW 11R,A01,892721,Herbst; Matthew,11,0,27,16
1746559654884,MMW 11R,A02,892722,Herbst; Matthew,0,0,0,3
1746559655910,MMW 12R,A01,892724,Herbst; Matthew,0,11,16,16
1746559655910,MMW 12R,A02,892725,Herbst; Matthew,0,10,16,16
1746559656938,MMW 13R,A01,892727,Staff,0,4,16,16
1746559656938,MMW 13R,A02,892728,Staff,0,4,16,16
1746559656938,MMW 13R,A03,958032,Staff,0,4,16,16
1746559656938,MMW 13R,A04,958033,Staff,0,4,16,16
1746559656938,MMW 13R,A05,958034,Staff,0,4,16,16
1746559657964,SIO 295LS,A00,894015,Staff,5,0,25,20
1746559658989,SIO 295S,A00,894020,Staff,5,0,25,20
1746559660016,SIOC 290S,B01,958918,Merrifield; Mark A,14,0,30,16
1746559661045,SIOC 291S,B01,958922,Gabriel; Corey John,14,0,30,16
1746559662073,SOCI 117,A01,895339,Staff,3,0,5,2
1746559663113,WES 237B,A00,894149,Staff,11,0,20,9
1746559665176,AESE 279B,A00,891859,Staff,13,0,35,22
1746559666203,AIP 197,001,891854,Vespa; Emanuel Ignacio,9999,0,9999,0
1746559667230,ANTH 289S,A00,891856,Gagneux; Pascal,12,0,12,0
1746559668255,BENG 196,001,957946,Engler; Adam J.,9996,0,9999,3
1746559669279,BISP 197,001,959851,Wilhelm; James E.,9998,0,9999,1
1746559670305,CAT 124RS,A01,956906,Staff,6,0,25,19
1746559671332,CAT 125RS,A01,922013,Staff,6,0,25,19
1746559672359,CLRE 250,A00,891860,Morris; Sheldon,9995,0,9999,4
1746559674409,CLRE 251R,A00,907817,Mehta; Ravindra L.,9994,0,9999,5
1746559675432,CLRE 252,A00,891864,Cuomo; Raphael Eduardo,9993,0,9999,6
1746559676457,CLRE 253,A00,891867,Vaida; Florin,9994,0,9999,5
1746559676457,CLRE 253,B00,907819,Staff,9999,0,9999,0
1746559677484,CLRE 259,A00,891868,Patel; Hemal,9998,0,9999,1
1746559678509,CLRE 260,A00,891872,Cuomo; Raphael Eduardo,9999,0,9999,0
1746559679535,CLRE 297,001,891888,Cuomo; Raphael Eduardo,9999,0,9999,0
1746559680561,CSE 191,A00,958773,Minnes Kemp; Mor Mia,9995,0,9999,4
1746559681588,CSE 197,001,959846,Minnes Kemp; Mor Mia,9990,0,9999,9
1746559682613,CSS 201S,A01,892054,Mignozzetti; Umberto,26,0,30,4
1746559683638,CSS 202S,A01,892056,Mignozzetti; Umberto,26,0,30,4
1746559684662,DSC 197,001,956898,Eldridge; Justin Matthew,9997,0,9999,2
1746559685687,DSC 297,001,958000,Mazumdar; Arya,9998,0,9999,1
1746559685687,DSC 297,002,959862,Wang; Yusu,9998,0,9999,1
1746559686714,EAP 100,A00,905686,Staff,9778,0,9999,221
1746559687741,ECE 45,A01,892618,Staff,0,0,65,65
1746559689790,ECE 111,A01,892719,Staff,4,0,65,61
1746559690814,ECE 197,001,957920,Mercier; Patrick Philip,9991,0,9999,8
1746559691849,ECON 178,A01,907814,Zhu; Ying,26,0,35,9
1746559692873,EDS 115,A00,895312,Staff,35,0,45,10
1746559693899,EDS 117,A01,895337,Staff,23,0,30,7
1746559694925,EDS 125,A00,895341,Jones; Gabrielle Anastasia,36,0,45,9
1746559695951,EDS 128A,A01,895459,Fargason; Sharon Gayle,44,0,45,1
1746559696979,EDS 128B,A01,895543,Pappas; Elizabeth,44,0,45,1
1746559698003,EDS 139,A00,897203,Pappas; Elizabeth,44,0,45,1
1746559698003,EDS 139,B00,897209,Fargason; Sharon Gayle,41,0,45,4
1746559699068,EDS 201,A00,895545,Staff,22,0,45,23
1746559700093,EDS 203,A01,895581,Halter; Christopher P.,22,0,45,23
1746559701118,EDS 204R,A01,895625,Heinzman; Erica M.,39,0,45,6
1746559701118,EDS 204R,B01,895693,Halter; Christopher P.,10,0,45,35
1746559702147,EDS 206R,A00,895694,Fargason; Sharon Gayle,1,0,30,29
1746559702147,EDS 206R,B00,895695,Choi; Bailey Miyeon,16,0,30,14
1746559703172,EDS 250,A00,895697,Hemans; Patricia Ann Benitez,22,0,45,23
1746559704200,EDS 281,A00,895701,Meyerott; Theresa Ann,1,0,15,14
1746559705226,EDS 284,A00,895736,Meyerott; Theresa Ann,1,0,15,14
1746559706255,EDS 286,A00,897210,Fine; Sarah,0,0,15,15
1746559707281,EDS 289C,A01,895770,Daly; Alan J.,1,0,15,14
1746559708305,EDS 290,A00,897211,Hofstetter; Carolyn,0,0,15,15
1746559709333,LIGM 5A,A00,896162,Fischer-Grunski; Eva K,12,0,20,8
1746559710357,LIGM 5B,A00,896260,Fischer-Grunski; Eva K,17,0,20,3
1746559711387,LIGM 5C,A00,896308,Fischer-Grunski; Eva K,18,0,20,2
1746559712415,LIIT 5AS,A00,896313,Carnelos; Chiara,18,0,20,2
1746559713443,LIIT 5BS,A00,896416,Carnelos; Chiara,20,0,20,0
1746559714469,LIIT 5CS,A00,896564,Carnelos; Chiara,20,0,20,0
1746559715493,LISP 5A,A00,896588,Munoz Sanchez; Alicia,3,0,20,17
1746559716517,LISP 5B,A00,896653,Munoz Sanchez; Alicia,7,0,20,13
1746559717543,LISP 5C,A00,896655,Munoz Sanchez; Alicia,0,1,20,20
1746559718573,MAE 197,001,957918,Kleissl; Jan,9996,0,9999,3
1746559718573,MAE 197,002,959806,Boechler; Nicholas Sebastia,9998,0,9999,1
1746559718573,MAE 197,003,959852,Mullin; Jennifer S,9998,0,9999,1
1746559719597,MATH 2,A01,957937,Staff,33,0,35,2
1746559720623,MATH 197,001,957876,Kedlaya; Kiran S.,9993,0,9999,6
1746559721647,MCWP 40,A00,892729,Duru; Nur,10,0,20,10
1746559721647,MCWP 40,B00,893304,Montejo; Carolina,14,0,20,6
1746559722674,MCWP 40R,A00,893757,Redela; Pamela Morgan,0,5,20,20
1746559723702,MCWP 50,A00,893758,Morshed; Michael James,0,0,20,20
1746559723702,MCWP 50,B00,893761,Bartulis; Jason Michael,17,0,20,3
1746559724729,MCWP 50R,A00,893766,Compas; Sean Matthew,0,1,20,20
1746559724729,MCWP 50R,B00,893769,Carter; Jennifer A,0,1,20,20
1746559724729,MCWP 50R,C00,893771,Krone; Jarret,0,3,20,20
1746559724729,MCWP 50R,D00,893772,Miller; Elizabeth Deen,0,0,20,20
1746559724729,MCWP 50R,E00,893775,Carter; Andrea L,0,1,20,20
1746559725754,MMW 11R,A01,892721,Herbst; Matthew,11,0,27,16
1746559725754,MMW 11R,A02,892722,Herbst; Matthew,0,0,0,3
1746559726780,MMW 12R,A01,892724,Herbst; Matthew,0,11,16,16
1746559726780,MMW 12R,A02,892725,Herbst; Matthew,0,10,16,16
1746559727806,MMW 13R,A01,892727,Staff,0,4,16,16
1746559727806,MMW 13R,A02,892728,Staff,0,4,16,16
1746559727806,MMW 13R,A03,958032,Staff,0,4,16,16
1746559727806,MMW 13R,A04,958033,Staff,0,4,16,16
1746559727806,MMW 13R,A05,958034,Staff,0,4,16,16
1746559728837,SIO 295LS,A00,894015,Staff,5,0,25,20
1746559729863,SIO 295S,A00,894020,Staff,5,0,25,20
1746559730893,SIOC 290S,B01,958918,Merrifield; Mark A,14,0,30,16
1746559731922,SIOC 291S,B01,958922,Gabriel; Corey John,14,0,30,16
1746559732947,SOCI 117,A01,895339,Staff,3,0,5,2
1746559733971,WES 237B,A00,894149,Staff,11,0,20,9
1746559736032,AESE 279B,A00,891859,Staff,13,0,35,22
1746559737057,AIP 197,001,891854,Vespa; Emanuel Ignacio,9999,0,9999,0
1746559738084,ANTH 289S,A00,891856,Gagneux; Pascal,12,0,12,0
1746559739113,BENG 196,001,957946,Engler; Adam J.,9996,0,9999,3
1746559740143,BISP 197,001,959851,Wilhelm; James E.,9998,0,9999,1
1746559741168,CAT 124RS,A01,956906,Staff,6,0,25,19
1746559742195,CAT 125RS,A01,922013,Staff,6,0,25,19
1746559743224,CLRE 250,A00,891860,Morris; Sheldon,9995,0,9999,4
1746559745279,CLRE 251R,A00,907817,Mehta; Ravindra L.,9994,0,9999,5
1746559746304,CLRE 252,A00,891864,Cuomo; Raphael Eduardo,9993,0,9999,6
1746559747332,CLRE 253,A00,891867,Vaida; Florin,9994,0,9999,5
1746559747332,CLRE 253,B00,907819,Staff,9999,0,9999,0
1746559748360,CLRE 259,A00,891868,Patel; Hemal,9998,0,9999,1
1746559749383,CLRE 260,A00,891872,Cuomo; Raphael Eduardo,9999,0,9999,0
1746559750411,CLRE 297,001,891888,Cuomo; Raphael Eduardo,9999,0,9999,0
1746559751436,CSE 191,A00,958773,Minnes Kemp; Mor Mia,9995,0,9999,4
1746559752461,CSE 197,001,959846,Minnes Kemp; Mor Mia,9990,0,9999,9
1746559753485,CSS 201S,A01,892054,Mignozzetti; Umberto,26,0,30,4
1746559754513,CSS 202S,A01,892056,Mignozzetti; Umberto,26,0,30,4
1746559755540,DSC 197,001,956898,Eldridge; Justin Matthew,9997,0,9999,2
1746559756564,DSC 297,001,958000,Mazumdar; Arya,9998,0,9999,1
1746559756564,DSC 297,002,959862,Wang; Yusu,9998,0,9999,1
1746559757589,EAP 100,A00,905686,Staff,9778,0,9999,221
1746559758615,ECE 45,A01,892618,Staff,0,0,65,65
1746559760664,ECE 111,A01,892719,Staff,4,0,65,61
1746559761689,ECE 197,001,957920,Mercier; Patrick Philip,9991,0,9999,8
1746559762717,ECON 178,A01,907814,Zhu; Ying,26,0,35,9
1746559763743,EDS 115,A00,895312,Staff,35,0,45,10
1746559764769,EDS 117,A01,895337,Staff,23,0,30,7
1746559765795,EDS 125,A00,895341,Jones; Gabrielle Anastasia,36,0,45,9
1746559766820,EDS 128A,A01,895459,Fargason; Sharon Gayle,44,0,45,1
1746559767845,EDS 128B,A01,895543,Pappas; Elizabeth,44,0,45,1
1746559768870,EDS 139,A00,897203,Pappas; Elizabeth,44,0,45,1
1746559768870,EDS 139,B00,897209,Fargason; Sharon Gayle,41,0,45,4
1746559769894,EDS 201,A00,895545,Staff,22,0,45,23
1746559770923,EDS 203,A01,895581,Halter; Christopher P.,22,0,45,23
1746559771951,EDS 204R,A01,895625,Heinzman; Erica M.,39,0,45,6
1746559771951,EDS 204R,B01,895693,Halter; Christopher P.,10,0,45,35
1746559772977,EDS 206R,A00,895694,Fargason; Sharon Gayle,1,0,30,29
1746559772977,EDS 206R,B00,895695,Choi; Bailey Miyeon,16,0,30,14
1746559774005,EDS 250,A00,895697,Hemans; Patricia Ann Benitez,22,0,45,23
1746559775032,EDS 281,A00,895701,Meyerott; Theresa Ann,1,0,15,14
1746559776057,EDS 284,A00,895736,Meyerott; Theresa Ann,1,0,15,14
1746559777080,EDS 286,A00,897210,Fine; Sarah,0,0,15,15
1746559778105,EDS 289C,A01,895770,Daly; Alan J.,1,0,15,14
1746559779130,EDS 290,A00,897211,Hofstetter; Carolyn,0,0,15,15
1746559780155,LIGM 5A,A00,896162,Fischer-Grunski; Eva K,12,0,20,8
1746559781179,LIGM 5B,A00,896260,Fischer-Grunski; Eva K,17,0,20,3
1746559782206,LIGM 5C,A00,896308,Fischer-Grunski; Eva K,18,0,20,2
1746559783233,LIIT 5AS,A00,896313,Carnelos; Chiara,18,0,20,2
1746559784259,LIIT 5BS,A00,896416,Carnelos; Chiara,20,0,20,0
1746559785284,LIIT 5CS,A00,896564,Carnelos; Chiara,20,0,20,0
1746559786311,LISP 5A,A00,896588,Munoz Sanchez; Alicia,3,0,20,17
1746559787336,LISP 5B,A00,896653,Munoz Sanchez; Alicia,7,0,20,13
1746559788364,LISP 5C,A00,896655,Munoz Sanchez; Alicia,0,1,20,20
1746559789387,MAE 197,001,957918,Kleissl; Jan,9996,0,9999,3
1746559789387,MAE 197,002,959806,Boechler; Nicholas Sebastia,9998,0,9999,1
1746559789387,MAE 197,003,959852,Mullin; Jennifer S,9998,0,9999,1
1746559790414,MATH 2,A01,957937,Staff,33,0,35,2
1746559791438,MATH 197,001,957876,Kedlaya; Kiran S.,9993,0,9999,6
1746559792462,MCWP 40,A00,892729,Duru; Nur,10,0,20,10
1746559792462,MCWP 40,B00,893304,Montejo; Carolina,14,0,20,6
1746559793491,MCWP 40R,A00,893757,Redela; Pamela Morgan,0,5,20,20
1746559794517,MCWP 50,A00,893758,Morshed; Michael James,0,0,20,20
1746559794517,MCWP 50,B00,893761,Bartulis; Jason Michael,17,0,20,3
1746559795545,MCWP 50R,A00,893766,Compas; Sean Matthew,0,1,20,20
1746559795545,MCWP 50R,B00,893769,Carter; Jennifer A,0,1,20,20
1746559795545,MCWP 50R,C00,893771,Krone; Jarret,0,3,20,20
1746559795545,MCWP 50R,D00,893772,Miller; Elizabeth Deen,0,0,20,20
1746559795545,MCWP 50R,E00,893775,Carter; Andrea L,0,1,20,20
1746559796571,MMW 11R,A01,892721,Herbst; Matthew,11,0,27,16
1746559796571,MMW 11R,A02,892722,Herbst; Matthew,0,0,0,3
1746559797599,MMW 12R,A01,892724,Herbst; Matthew,0,11,16,16
1746559797599,MMW 12R,A02,892725,Herbst; Matthew,0,10,16,16
1746559798627,MMW 13R,A01,892727,Staff,0,4,16,16
1746559798627,MMW 13R,A02,892728,Staff,0,4,16,16
1746559798627,MMW 13R,A03,958032,Staff,0,4,16,16
1746559798627,MMW 13R,A04,958033,Staff,0,4,16,16
1746559798627,MMW 13R,A05,958034,Staff,0,4,16,16
1746559799655,SIO 295LS,A00,894015,Staff,5,0,25,20
1746559800682,SIO 295S,A00,894020,Staff,5,0,25,20
1746559801709,SIOC 290S,B01,958918,Merrifield; Mark A,14,0,30,16
1746559802737,SIOC 291S,B01,958922,Gabriel; Corey John,14,0,30,16
1746559803763,SOCI 117,A01,895339,Staff,3,0,5,2
1746559804788,WES 237B,A00,894149,Staff,11,0,20,9
1746559806864,AESE 279B,A00,891859,Staff,13,0,35,22
1746559807891,AIP 197,001,891854,Vespa; Emanuel Ignacio,9999,0,9999,0
1746559808918,ANTH 289S,A00,891856,Gagneux; Pascal,12,0,12,0
1746559809946,BENG 196,001,957946,Engler; Adam J.,9996,0,9999,3
1746559810972,BISP 197,001,959851,Wilhelm; James E.,9998,0,9999,1
1746559811997,CAT 124RS,A01,956906,Staff,6,0,25,19
1746559813021,CAT 125RS,A01,922013,Staff,6,0,25,19
1746559814045,CLRE 250,A00,891860,Morris; Sheldon,9995,0,9999,4
1746559816127,CLRE 251R,A00,907817,Mehta; Ravindra L.,9994,0,9999,5
1746559817152,CLRE 252,A00,891864,Cuomo; Raphael Eduardo,9993,0,9999,6
1746559818180,CLRE 253,A00,891867,Vaida; Florin,9994,0,9999,5
1746559818180,CLRE 253,B00,907819,Staff,9999,0,9999,0
1746559819207,CLRE 259,A00,891868,Patel; Hemal,9998,0,9999,1
1746559820232,CLRE 260,A00,891872,Cuomo; Raphael Eduardo,9999,0,9999,0
1746559821258,CLRE 297,001,891888,Cuomo; Raphael Eduardo,9999,0,9999,0
1746559822283,CSE 191,A00,958773,Minnes Kemp; Mor Mia,9995,0,9999,4
1746559823311,CSE 197,001,959846,Minnes Kemp; Mor Mia,9990,0,9999,9
1746559824549,CSS 201S,A01,892054,Mignozzetti; Umberto,26,0,30,4
1746559825575,CSS 202S,A01,892056,Mignozzetti; Umberto,26,0,30,4
1746559826600,DSC 197,001,956898,Eldridge; Justin Matthew,9997,0,9999,2
1746559827627,DSC 297,001,958000,Mazumdar; Arya,9998,0,9999,1
1746559827627,DSC 297,002,959862,Wang; Yusu,9998,0,9999,1
1746559828654,EAP 100,A00,905686,Staff,9778,0,9999,221
1746559829678,ECE 45,A01,892618,Staff,0,0,65,65
1746559831733,ECE 111,A01,892719,Staff,4,0,65,61
1746559832762,ECE 197,001,957920,Mercier; Patrick Philip,9991,0,9999,8
1746559833788,ECON 178,A01,907814,Zhu; Ying,26,0,35,9
1746559834815,EDS 115,A00,895312,Staff,35,0,45,10
1746559835840,EDS 117,A01,895337,Staff,23,0,30,7
1746559836867,EDS 125,A00,895341,Jones; Gabrielle Anastasia,36,0,45,9
1746559837893,EDS 128A,A01,895459,Fargason; Sharon Gayle,44,0,45,1
1746559838919,EDS 128B,A01,895543,Pappas; Elizabeth,44,0,45,1
1746559839946,EDS 139,A00,897203,Pappas; Elizabeth,44,0,45,1
1746559839946,EDS 139,B00,897209,Fargason; Sharon Gayle,41,0,45,4
1746559840973,EDS 201,A00,895545,Staff,22,0,45,23
1746559842001,EDS 203,A01,895581,Halter; Christopher P.,22,0,45,23
1746559843024,EDS 204R,A01,895625,Heinzman; Erica M.,39,0,45,6
1746559843024,EDS 204R,B01,895693,Halter; Christopher P.,10,0,45,35
1746559844054,EDS 206R,A00,895694,Fargason; Sharon Gayle,1,0,30,29
1746559844054,EDS 206R,B00,895695,Choi; Bailey Miyeon,16,0,30,14
1746559845084,EDS 250,A00,895697,Hemans; Patricia Ann Benitez,22,0,45,23
1746559847699,EDS 281,A00,895701,Meyerott; Theresa Ann,1,0,15,14
1746559848726,EDS 284,A00,895736,Meyerott; Theresa Ann,1,0,15,14
1746559849755,EDS 286,A00,897210,Fine; Sarah,0,0,15,15
1746559850782,EDS 289C,A01,895770,Daly; Alan J.,1,0,15,14
1746559851809,EDS 290,A00,897211,Hofstetter; Carolyn,0,0,15,15
1746559852834,LIGM 5A,A00,896162,Fischer-Grunski; Eva K,12,0,20,8
1746559853862,LIGM 5B,A00,896260,Fischer-Grunski; Eva K,17,0,20,3
1746559854887,LIGM 5C,A00,896308,Fischer-Grunski; Eva K,18,0,20,2
1746559855918,LIIT 5AS,A00,896313,Carnelos; Chiara,18,0,20,2
1746559856941,LIIT 5BS,A00,896416,Carnelos; Chiara,20,0,20,0
1746559857966,LIIT 5CS,A00,896564,Carnelos; Chiara,20,0,20,0
1746559858992,LISP 5A,A00,896588,Munoz Sanchez; Alicia,3,0,20,17
1746559860042,LISP 5B,A00,896653,Munoz Sanchez; Alicia,7,0,20,13
1746559861072,LISP 5C,A00,896655,Munoz Sanchez; Alicia,0,1,20,20
1746559862102,MAE 197,001,957918,Kleissl; Jan,9996,0,9999,3
1746559862102,MAE 197,002,959806,Boechler; Nicholas Sebastia,9998,0,9999,1
1746559862102,MAE 197,003,959852,Mullin; Jennifer S,9998,0,9999,1
1746559863130,MATH 2,A01,957937,Staff,33,0,35,2
1746559864157,MATH 197,001,957876,Kedlaya; Kiran S.,9993,0,9999,6
1746559865183,MCWP 40,A00,892729,Duru; Nur,10,0,20,10
1746559865183,MCWP 40,B00,893304,Montejo; Carolina,14,0,20,6
1746559866211,MCWP 40R,A00,893757,Redela; Pamela Morgan,0,5,20,20
1746559867240,MCWP 50,A00,893758,Morshed; Michael James,0,0,20,20
1746559867240,MCWP 50,B00,893761,Bartulis; Jason Michael,17,0,20,3
1746559868270,MCWP 50R,A00,893766,Compas; Sean Matthew,0,1,20,20
1746559868270,MCWP 50R,B00,893769,Carter; Jennifer A,0,1,20,20
1746559868270,MCWP 50R,C00,893771,Krone; Jarret,0,3,20,20
1746559868270,MCWP 50R,D00,893772,Miller; Elizabeth Deen,0,0,20,20
1746559868270,MCWP 50R,E00,893775,Carter; Andrea L,0,1,20,20
1746559869297,MMW 11R,A01,892721,Herbst; Matthew,11,0,27,16
1746559869297,MMW 11R,A02,892722,Herbst; Matthew,0,0,0,3
1746559870321,MMW 12R,A01,892724,Herbst; Matthew,0,11,16,16
1746559870321,MMW 12R,A02,892725,Herbst; Matthew,0,10,16,16
1746559871347,MMW 13R,A01,892727,Staff,0,4,16,16
1746559871347,MMW 13R,A02,892728,Staff,0,4,16,16
1746559871347,MMW 13R,A03,958032,Staff,0,4,16,16
1746559871347,MMW 13R,A04,958033,Staff,0,4,16,16
1746559871347,MMW 13R,A05,958034,Staff,0,4,16,16
1746559872373,SIO 295LS,A00,894015,Staff,5,0,25,20
1746559873398,SIO 295S,A00,894020,Staff,5,0,25,20
1746559874423,SIOC 290S,B01,958918,Merrifield; Mark A,14,0,30,16
1746559875447,SIOC 291S,B01,958922,Gabriel; Corey John,14,0,30,16
1746559876472,SOCI 117,A01,895339,Staff,3,0,5,2
1746559877498,WES 237B,A00,894149,Staff,11,0,20,9
1746559879563,AESE 279B,A00,891859,Staff,13,0,35,22
1746559880586,AIP 197,001,891854,Vespa; Emanuel Ignacio,9999,0,9999,0
1746559881611,ANTH 289S,A00,891856,Gagneux; Pascal,12,0,12,0
1746559882640,BENG 196,001,957946,Engler; Adam J.,9996,0,9999,3
1746559883664,BISP 197,001,959851,Wilhelm; James E.,9998,0,9999,1
1746559884688,CAT 124RS,A01,956906,Staff,6,0,25,19
1746559885711,CAT 125RS,A01,922013,Staff,6,0,25,19
1746559886740,CLRE 250,A00,891860,Morris; Sheldon,9995,0,9999,4
1746559888789,CLRE 251R,A00,907817,Mehta; Ravindra L.,9994,0,9999,5
1746559889815,CLRE 252,A00,891864,Cuomo; Raphael Eduardo,9993,0,9999,6
1746559890840,CLRE 253,A00,891867,Vaida; Florin,9994,0,9999,5
1746559890840,CLRE 253,B00,907819,Staff,9999,0,9999,0
1746559891868,CLRE 259,A00,891868,Patel; Hemal,9998,0,9999,1
1746559892894,CLRE 260,A00,891872,Cuomo; Raphael Eduardo,9999,0,9999,0
1746559893918,CLRE 297,001,891888,Cuomo; Raphael Eduardo,9999,0,9999,0
1746559894943,CSE 191,A00,958773,Minnes Kemp; Mor Mia,9995,0,9999,4
1746559895971,CSE 197,001,959846,Minnes Kemp; Mor Mia,9990,0,9999,9
1746559897001,CSS 201S,A01,892054,Mignozzetti; Umberto,26,0,30,4
1746559898025,CSS 202S,A01,892056,Mignozzetti; Umberto,26,0,30,4
1746559899052,DSC 197,001,956898,Eldridge; Justin Matthew,9997,0,9999,2
1746559900080,DSC 297,001,958000,Mazumdar; Arya,9998,0,9999,1
1746559900080,DSC 297,002,959862,Wang; Yusu,9998,0,9999,1
1746559901107,EAP 100,A00,905686,Staff,9778,0,9999,221
1746559902133,ECE 45,A01,892618,Staff,0,0,65,65
1746559904182,ECE 111,A01,892719,Staff,4,0,65,61
1746559905207,ECE 197,001,957920,Mercier; Patrick Philip,9991,0,9999,8
1746559906234,ECON 178,A01,907814,Zhu; Ying,26,0,35,9
1746559907262,EDS 115,A00,895312,Staff,35,0,45,10
1746559908290,EDS 117,A01,895337,Staff,23,0,30,7
1746559909316,EDS 125,A00,895341,Jones; Gabrielle Anastasia,36,0,45,9
1746559910342,EDS 128A,A01,895459,Fargason; Sharon Gayle,44,0,45,1
1746559911369,EDS 128B,A01,895543,Pappas; Elizabeth,44,0,45,1
1746559912397,EDS 139,A00,897203,Pappas; Elizabeth,44,0,45,1
1746559912397,EDS 139,B00,897209,Fargason; Sharon Gayle,41,0,45,4
1746559913424,EDS 201,A00,895545,Staff,22,0,45,23
1746559914451,EDS 203,A01,895581,Halter; Christopher P.,22,0,45,23
1746559915479,EDS 204R,A01,895625,Heinzman; Erica M.,39,0,45,6
1746559915479,EDS 204R,B01,895693,Halter; Christopher P.,10,0,45,35
1746559916510,EDS 206R,A00,895694,Fargason; Sharon Gayle,1,0,30,29
1746559916510,EDS 206R,B00,895695,Choi; Bailey Miyeon,16,0,30,14
1746559917534,EDS 250,A00,895697,Hemans; Patricia Ann Benitez,22,0,45,23
1746559918560,EDS 281,A00,895701,Meyerott; Theresa Ann,1,0,15,14
1746559919586,EDS 284,A00,895736,Meyerott; Theresa Ann,1,0,15,14
1746559920615,EDS 286,A00,897210,Fine; Sarah,0,0,15,15
1746559921640,EDS 289C,A01,895770,Daly; Alan J.,1,0,15,14
1746559922668,EDS 290,A00,897211,Hofstetter; Carolyn,0,0,15,15
1746559923692,LIGM 5A,A00,896162,Fischer-Grunski; Eva K,12,0,20,8
1746559924718,LIGM 5B,A00,896260,Fischer-Grunski; Eva K,17,0,20,3
1746559925744,LIGM 5C,A00,896308,Fischer-Grunski; Eva K,18,0,20,2
1746559926769,LIIT 5AS,A00,896313,Carnelos; Chiara,18,0,20,2
1746559927797,LIIT 5BS,A00,896416,Carnelos; Chiara,20,0,20,0
1746559928822,LIIT 5CS,A00,896564,Carnelos; Chiara,20,0,20,0
1746559929848,LISP 5A,A00,896588,Munoz Sanchez; Alicia,3,0,20,17
1746559930874,LISP 5B,A00,896653,Munoz Sanchez; Alicia,7,0,20,13
1746559931902,LISP 5C,A00,896655,Munoz Sanchez; Alicia,0,1,20,20
1746559932929,MAE 197,001,957918,Kleissl; Jan,9996,0,9999,3
1746559932929,MAE 197,002,959806,Boechler; Nicholas Sebastia,9998,0,9999,1
1746559932929,MAE 197,003,959852,Mullin; Jennifer S,9998,0,9999,1
1746559933956,MATH 2,A01,957937,Staff,33,0,35,2
1746559934986,MATH 197,001,957876,Kedlaya; Kiran S.,9993,0,9999,6
1746559936012,MCWP 40,A00,892729,Duru; Nur,10,0,20,10
1746559936012,MCWP 40,B00,893304,Montejo; Carolina,14,0,20,6
1746559937037,MCWP 40R,A00,893757,Redela; Pamela Morgan,0,5,20,20
1746559938064,MCWP 50,A00,893758,Morshed; Michael James,0,0,20,20
1746559938064,MCWP 50,B00,893761,Bartulis; Jason Michael,17,0,20,3
1746559939089,MCWP 50R,A00,893766,Compas; Sean Matthew,0,1,20,20
1746559939089,MCWP 50R,B00,893769,Carter; Jennifer A,0,1,20,20
1746559939089,MCWP 50R,C00,893771,Krone; Jarret,0,3,20,20
1746559939089,MCWP 50R,D00,893772,Miller; Elizabeth Deen,0,0,20,20
1746559939089,MCWP 50R,E00,893775,Carter; Andrea L,0,1,20,20
1746559940139,MMW 11R,A01,892721,Herbst; Matthew,11,0,27,16
1746559940139,MMW 11R,A02,892722,Herbst; Matthew,0,0,0,3
1746559941163,MMW 12R,A01,892724,Herbst; Matthew,0,11,16,16
1746559941163,MMW 12R,A02,892725,Herbst; Matthew,0,10,16,16
1746559942188,MMW 13R,A01,892727,Staff,0,4,16,16
1746559942188,MMW 13R,A02,892728,Staff,0,4,16,16
1746559942188,MMW 13R,A03,958032,Staff,0,4,16,16
1746559942188,MMW 13R,A04,958033,Staff,0,4,16,16
1746559942188,MMW 13R,A05,958034,Staff,0,4,16,16
1746559943213,SIO 295LS,A00,894015,Staff,5,0,25,20
1746559944239,SIO 295S,A00,894020,Staff,5,0,25,20
1746559945264,SIOC 290S,B01,958918,Merrifield; Mark A,14,0,30,16
1746559946290,SIOC 291S,B01,958922,Gabriel; Corey John,14,0,30,16
1746559947316,SOCI 117,A01,895339,Staff,3,0,5,2
1746559948342,WES 237B,A00,894149,Staff,11,0,20,9
1746559950408,AESE 279B,A00,891859,Staff,13,0,35,22
1746559951431,AIP 197,001,891854,Vespa; Emanuel Ignacio,9999,0,9999,0
1746559952458,ANTH 289S,A00,891856,Gagneux; Pascal,12,0,12,0
1746559953482,BENG 196,001,957946,Engler; Adam J.,9996,0,9999,3
1746559954507,BISP 197,001,959851,Wilhelm; James E.,9998,0,9999,1
1746559955533,CAT 124RS,A01,956906,Staff,6,0,25,19
1746559956559,CAT 125RS,A01,922013,Staff,6,0,25,19
1746559957585,CLRE 250,A00,891860,Morris; Sheldon,9995,0,9999,4
1746559959636,CLRE 251R,A00,907817,Mehta; Ravindra L.,9994,0,9999,5
1746559960661,CLRE 252,A00,891864,Cuomo; Raphael Eduardo,9993,0,9999,6
1746559961688,CLRE 253,A00,891867,Vaida; Florin,9994,0,9999,5
1746559961688,CLRE 253,B00,907819,Staff,9999,0,9999,0
1746559962715,CLRE 259,A00,891868,Patel; Hemal,9998,0,9999,1
1746559963738,CLRE 260,A00,891872,Cuomo; Raphael Eduardo,9999,0,9999,0
1746559964763,CLRE 297,001,891888,Cuomo; Raphael Eduardo,9999,0,9999,0
1746559965790,CSE 191,A00,958773,Minnes Kemp; Mor Mia,9995,0,9999,4
1746559966819,CSE 197,001,959846,Minnes Kemp; Mor Mia,9990,0,9999,9
1746559967844,CSS 201S,A01,892054,Mignozzetti; Umberto,26,0,30,4
1746559968874,CSS 202S,A01,892056,Mignozzetti; Umberto,26,0,30,4
1746559969898,DSC 197,001,956898,Eldridge; Justin Matthew,9997,0,9999,2
1746559970923,DSC 297,001,958000,Mazumdar; Arya,9998,0,9999,1
1746559970923,DSC 297,002,959862,Wang; Yusu,9998,0,9999,1
1746559971950,EAP 100,A00,905686,Staff,9778,0,9999,221
1746559972981,ECE 45,A01,892618,Staff,0,0,65,65
1746559975037,ECE 111,A01,892719,Staff,4,0,65,61
1746559976063,ECE 197,001,957920,Mercier; Patrick Philip,9991,0,9999,8
1746559977092,ECON 178,A01,907814,Zhu; Ying,26,0,35,9
1746559978118,EDS 115,A00,895312,Staff,35,0,45,10
1746559979145,EDS 117,A01,895337,Staff,23,0,30,7
1746559980171,EDS 125,A00,895341,Jones; Gabrielle Anastasia,36,0,45,9
1746559981197,EDS 128A,A01,895459,Fargason; Sharon Gayle,44,0,45,1
1746559982224,EDS 128B,A01,895543,Pappas; Elizabeth,44,0,45,1
1746559983253,EDS 139,A00,897203,Pappas; Elizabeth,44,0,45,1
1746559983253,EDS 139,B00,897209,Fargason; Sharon Gayle,41,0,45,4
1746559984277,EDS 201,A00,895545,Staff,22,0,45,23
1746559985304,EDS 203,A01,895581,Halter; Christopher P.,22,0,45,23
1746559986333,EDS 204R,A01,895625,Heinzman; Erica M.,39,0,45,6
1746559986333,EDS 204R,B01,895693,Halter; Christopher P.,10,0,45,35
1746559987356,EDS 206R,A00,895694,Fargason; Sharon Gayle,1,0,30,29
1746559987356,EDS 206R,B00,895695,Choi; Bailey Miyeon,16,0,30,14
1746559988384,EDS 250,A00,895697,Hemans; Patricia Ann Benitez,22,0,45,23
1746559989408,EDS 281,A00,895701,Meyerott; Theresa Ann,1,0,15,14
1746559990431,EDS 284,A00,895736,Meyerott; Theresa Ann,1,0,15,14
1746559991461,EDS 286,A00,897210,Fine; Sarah,0,0,15,15
1746559992489,EDS 289C,A01,895770,Daly; Alan J.,1,0,15,14
1746559993513,EDS 290,A00,897211,Hofstetter; Carolyn,0,0,15,15
1746559994540,LIGM 5A,A00,896162,Fischer-Grunski; Eva K,12,0,20,8
1746559995567,LIGM 5B,A00,896260,Fischer-Grunski; Eva K,17,0,20,3
1746559996593,LIGM 5C,A00,896308,Fischer-Grunski; Eva K,18,0,20,2
1746559997619,LIIT 5AS,A00,896313,Carnelos; Chiara,18,0,20,2
1746559998649,LIIT 5BS,A00,896416,Carnelos; Chiara,20,0,20,0
1746559999677,LIIT 5CS,A00,896564,Carnelos; Chiara,20,0,20,0
1746560000706,LISP 5A,A00,896588,Munoz Sanchez; Alicia,3,0,20,17
1746560001735,LISP 5B,A00,896653,Munoz Sanchez; Alicia,7,0,20,13
1746560002764,LISP 5C,A00,896655,Munoz Sanchez; Alicia,0,1,20,20
1746560003790,MAE 197,001,957918,Kleissl; Jan,9996,0,9999,3
1746560003790,MAE 197,002,959806,Boechler; Nicholas Sebastia,9998,0,9999,1
1746560003790,MAE 197,003,959852,Mullin; Jennifer S,9998,0,9999,1
1746560004820,MATH 2,A01,957937,Staff,33,0,35,2
1746560005846,MATH 197,001,957876,Kedlaya; Kiran S.,9993,0,9999,6
1746560006875,MCWP 40,A00,892729,Duru; Nur,10,0,20,10
1746560006875,MCWP 40,B00,893304,Montejo; Carolina,14,0,20,6
1746560007901,MCWP 40R,A00,893757,Redela; Pamela Morgan,0,5,20,20
1746560008931,MCWP 50,A00,893758,Morshed; Michael James,0,0,20,20
1746560008931,MCWP 50,B00,893761,Bartulis; Jason Michael,17,0,20,3
1746560009962,MCWP 50R,A00,893766,Compas; Sean Matthew,0,1,20,20
1746560009962,MCWP 50R,B00,893769,Carter; Jennifer A,0,1,20,20
1746560009962,MCWP 50R,C00,893771,Krone; Jarret,0,3,20,20
1746560009962,MCWP 50R,D00,893772,Miller; Elizabeth Deen,0,0,20,20
1746560009962,MCWP 50R,E00,893775,Carter; Andrea L,0,1,20,20
1746560010987,MMW 11R,A01,892721,Herbst; Matthew,11,0,27,16
1746560010987,MMW 11R,A02,892722,Herbst; Matthew,0,0,0,3
1746560012013,MMW 12R,A01,892724,Herbst; Matthew,0,11,16,16
1746560012013,MMW 12R,A02,892725,Herbst; Matthew,0,10,16,16
1746560013041,MMW 13R,A01,892727,Staff,0,4,16,16
1746560013041,MMW 13R,A02,892728,Staff,0,4,16,16
1746560013041,MMW 13R,A03,958032,Staff,0,4,16,16
1746560013041,MMW 13R,A04,958033,Staff,0,4,16,16
1746560013041,MMW 13R,A05,958034,Staff,0,4,16,16
1746560014071,SIO 295LS,A00,894015,Staff,5,0,25,20
1746560015099,SIO 295S,A00,894020,Staff,5,0,25,20
1746560016124,SIOC 290S,B01,958918,Merrifield; Mark A,14,0,30,16
1746560017149,SIOC 291S,B01,958922,Gabriel; Corey John,14,0,30,16
1746560018177,SOCI 117,A01,895339,Staff,3,0,5,2
1746560019200,WES 237B,A00,894149,Staff,11,0,20,9
1746560021272,AESE 279B,A00,891859,Staff,13,0,35,22
1746560022297,AIP 197,001,891854,Vespa; Emanuel Ignacio,9999,0,9999,0
1746560023324,ANTH 289S,A00,891856,Gagneux; Pascal,12,0,12,0
1746560024347,BENG 196,001,957946,Engler; Adam J.,9996,0,9999,3
1746560025372,BISP 197,001,959851,Wilhelm; James E.,9998,0,9999,1
1746560026398,CAT 124RS,A01,956906,Staff,6,0,25,19
1746560027425,CAT 125RS,A01,922013,Staff,6,0,25,19
1746560028449,CLRE 250,A00,891860,Morris; Sheldon,9995,0,9999,4
1746560030498,CLRE 251R,A00,907817,Mehta; Ravindra L.,9994,0,9999,5
1746560031523,CLRE 252,A00,891864,Cuomo; Raphael Eduardo,9993,0,9999,6
1746560032548,CLRE 253,A00,891867,Vaida; Florin,9994,0,9999,5
1746560032548,CLRE 253,B00,907819,Staff,9999,0,9999,0
1746560033576,CLRE 259,A00,891868,Patel; Hemal,9998,0,9999,1
1746560034603,CLRE 260,A00,891872,Cuomo; Raphael Eduardo,9999,0,9999,0
1746560035627,CLRE 297,001,891888,Cuomo; Raphael Eduardo,9999,0,9999,0
1746560036655,CSE 191,A00,958773,Minnes Kemp; Mor Mia,9995,0,9999,4
1746560037685,CSE 197,001,959846,Minnes Kemp; Mor Mia,9990,0,9999,9
1746560038709,CSS 201S,A01,892054,Mignozzetti; Umberto,26,0,30,4
1746560039738,CSS 202S,A01,892056,Mignozzetti; Umberto,26,0,30,4
1746560040763,DSC 197,001,956898,Eldridge; Justin Matthew,9997,0,9999,2
1746560041787,DSC 297,001,958000,Mazumdar; Arya,9998,0,9999,1
1746560041787,DSC 297,002,959862,Wang; Yusu,9998,0,9999,1
1746560042814,EAP 100,A00,905686,Staff,9778,0,9999,221
1746560043839,ECE 45,A01,892618,Staff,0,0,65,65
1746560045898,ECE 111,A01,892719,Staff,4,0,65,61
1746560046923,ECE 197,001,957920,Mercier; Patrick Philip,9991,0,9999,8
1746560047950,ECON 178,A01,907814,Zhu; Ying,26,0,35,9
1746560048976,EDS 115,A00,895312,Staff,35,0,45,10
1746560050001,EDS 117,A01,895337,Staff,23,0,30,7
1746560051029,EDS 125,A00,895341,Jones; Gabrielle Anastasia,36,0,45,9
1746560052056,EDS 128A,A01,895459,Fargason; Sharon Gayle,44,0,45,1
1746560053080,EDS 128B,A01,895543,Pappas; Elizabeth,44,0,45,1
1746560054108,EDS 139,A00,897203,Pappas; Elizabeth,44,0,45,1
1746560054108,EDS 139,B00,897209,Fargason; Sharon Gayle,41,0,45,4
1746560055133,EDS 201,A00,895545,Staff,22,0,45,23
1746560056162,EDS 203,A01,895581,Halter; Christopher P.,22,0,45,23
1746560057187,EDS 204R,A01,895625,Heinzman; Erica M.,39,0,45,6
1746560057187,EDS 204R,B01,895693,Halter; Christopher P.,10,0,45,35
1746560058215,EDS 206R,A00,895694,Fargason; Sharon Gayle,1,0,30,29
1746560058215,EDS 206R,B00,895695,Choi; Bailey Miyeon,16,0,30,14
1746560059244,EDS 250,A00,895697,Hemans; Patricia Ann Benitez,22,0,45,23
1746560060271,EDS 281,A00,895701,Meyerott; Theresa Ann,1,0,15,14
1746560061296,EDS 284,A00,895736,Meyerott; Theresa Ann,1,0,15,14
1746560062322,EDS 286,A00,897210,Fine; Sarah,0,0,15,15
1746560063348,EDS 289C,A01,895770,Daly; Alan J.,1,0,15,14
1746560064372,EDS 290,A00,897211,Hofstetter; Carolyn,0,0,15,15
1746560065396,LIGM 5A,A00,896162,Fischer-Grunski; Eva K,12,0,20,8
1746560066425,LIGM 5B,A00,896260,Fischer-Grunski; Eva K,17,0,20,3
1746560067449,LIGM 5C,A00,896308,Fischer-Grunski; Eva K,18,0,20,2
1746560068478,LIIT 5AS,A00,896313,Carnelos; Chiara,18,0,20,2
1746560069507,LIIT 5BS,A00,896416,Carnelos; Chiara,20,0,20,0
1746560070533,LIIT 5CS,A00,896564,Carnelos; Chiara,20,0,20,0
1746560071556,LISP 5A,A00,896588,Munoz Sanchez; Alicia,3,0,20,17
1746560072580,LISP 5B,A00,896653,Munoz Sanchez; Alicia,7,0,20,13
1746560073607,LISP 5C,A00,896655,Munoz Sanchez; Alicia,0,1,20,20
1746560074654,MAE 197,001,957918,Kleissl; Jan,9996,0,9999,3
1746560074654,MAE 197,002,959806,Boechler; Nicholas Sebastia,9998,0,9999,1
1746560074654,MAE 197,003,959852,Mullin; Jennifer S,9998,0,9999,1
1746560075678,MATH 2,A01,957937,Staff,33,0,35,2
1746560076703,MATH 197,001,957876,Kedlaya; Kiran S.,9993,0,9999,6
1746560077735,MCWP 40,A00,892729,Duru; Nur,10,0,20,10
1746560077735,MCWP 40,B00,893304,Montejo; Carolina,14,0,20,6
1746560078763,MCWP 40R,A00,893757,Redela; Pamela Morgan,0,5,20,20
1746560079789,MCWP 50,A00,893758,Morshed; Michael James,0,0,20,20
1746560079789,MCWP 50,B00,893761,Bartulis; Jason Michael,17,0,20,3
1746560080815,MCWP 50R,A00,893766,Compas; Sean Matthew,0,1,20,20
1746560080815,MCWP 50R,B00,893769,Carter; Jennifer A,0,1,20,20
1746560080815,MCWP 50R,C00,893771,Krone; Jarret,0,3,20,20
1746560080815,MCWP 50R,D00,893772,Miller; Elizabeth Deen,0,0,20,20
1746560080815,MCWP 50R,E00,893775,Carter; Andrea L,0,1,20,20
1746560081840,MMW 11R,A01,892721,Herbst; Matthew,11,0,27,16
1746560081840,MMW 11R,A02,892722,Herbst; Matthew,0,0,0,3
1746560082869,MMW 12R,A01,892724,Herbst; Matthew,0,11,16,16
1746560082869,MMW 12R,A02,892725,Herbst; Matthew,0,10,16,16
1746560083893,MMW 13R,A01,892727,Staff,0,4,16,16
1746560083893,MMW 13R,A02,892728,Staff,0,4,16,16
1746560083893,MMW 13R,A03,958032,Staff,0,4,16,16
1746560083893,MMW 13R,A04,958033,Staff,0,4,16,16
1746560083893,MMW 13R,A05,958034,Staff,0,4,16,16
1746560084919,SIO 295LS,A00,894015,Staff,5,0,25,20
1746560085943,SIO 295S,A00,894020,Staff,5,0,25,20
1746560086968,SIOC 290S,B01,958918,Merrifield; Mark A,14,0,30,16
1746560087996,SIOC 291S,B01,958922,Gabriel; Corey John,14,0,30,16
1746560089020,SOCI 117,A01,895339,Staff,3,0,5,2
1746560090045,WES 237B,A00,894149,Staff,11,0,20,9
1746560092110,AESE 279B,A00,891859,Staff,13,0,35,22
1746560093134,AIP 197,001,891854,Vespa; Emanuel Ignacio,9999,0,9999,0
1746560094160,ANTH 289S,A00,891856,Gagneux; Pascal,12,0,12,0
1746560095189,BENG 196,001,957946,Engler; Adam J.,9996,0,9999,3
1746560096214,BISP 197,001,959851,Wilhelm; James E.,9998,0,9999,1
1746560097238,CAT 124RS,A01,956906,Staff,6,0,25,19
1746560098261,CAT 125RS,A01,922013,Staff,6,0,25,19
1746560099289,CLRE 250,A00,891860,Morris; Sheldon,9995,0,9999,4
1746560101341,CLRE 251R,A00,907817,Mehta; Ravindra L.,9994,0,9999,5
1746560102371,CLRE 252,A00,891864,Cuomo; Raphael Eduardo,9993,0,9999,6
1746560103396,CLRE 253,A00,891867,Vaida; Florin,9994,0,9999,5
1746560103396,CLRE 253,B00,907819,Staff,9999,0,9999,0
1746560104423,CLRE 259,A00,891868,Patel; Hemal,9998,0,9999,1
1746560105451,CLRE 260,A00,891872,Cuomo; Raphael Eduardo,9999,0,9999,0
1746560106481,CLRE 297,001,891888,Cuomo; Raphael Eduardo,9999,0,9999,0
1746560107507,CSE 191,A00,958773,Minnes Kemp; Mor Mia,9995,0,9999,4
1746560108534,CSE 197,001,959846,Minnes Kemp; Mor Mia,9990,0,9999,9
1746560109560,CSS 201S,A01,892054,Mignozzetti; Umberto,26,0,30,4
1746560110590,CSS 202S,A01,892056,Mignozzetti; Umberto,26,0,30,4
1746560111614,DSC 197,001,956898,Eldridge; Justin Matthew,9997,0,9999,2
1746560112641,DSC 297,001,958000,Mazumdar; Arya,9998,0,9999,1
1746560112641,DSC 297,002,959862,Wang; Yusu,9998,0,9999,1
1746560113665,EAP 100,A00,905686,Staff,9778,0,9999,221
1746560114693,ECE 45,A01,892618,Staff,0,0,65,65
1746560116750,ECE 111,A01,892719,Staff,4,0,65,61
1746560117779,ECE 197,001,957920,Mercier; Patrick Philip,9991,0,9999,8
1746560118806,ECON 178,A01,907814,Zhu; Ying,26,0,35,9
1746560119831,EDS 115,A00,895312,Staff,35,0,45,10
1746560120858,EDS 117,A01,895337,Staff,23,0,30,7
1746560121886,EDS 125,A00,895341,Jones; Gabrielle Anastasia,36,0,45,9
1746560122916,EDS 128A,A01,895459,Fargason; Sharon Gayle,44,0,45,1
1746560123941,EDS 128B,A01,895543,Pappas; Elizabeth,44,0,45,1
1746560124967,EDS 139,A00,897203,Pappas; Elizabeth,44,0,45,1
1746560124967,EDS 139,B00,897209,Fargason; Sharon Gayle,41,0,45,4
1746560125992,EDS 201,A00,895545,Staff,22,0,45,23
1746560127020,EDS 203,A01,895581,Halter; Christopher P.,22,0,45,23
1746560128048,EDS 204R,A01,895625,Heinzman; Erica M.,39,0,45,6
1746560128048,EDS 204R,B01,895693,Halter; Christopher P.,10,0,45,35
1746560129072,EDS 206R,A00,895694,Fargason; Sharon Gayle,1,0,30,29
1746560129072,EDS 206R,B00,895695,Choi; Bailey Miyeon,16,0,30,14
1746560130101,EDS 250,A00,895697,Hemans; Patricia Ann Benitez,22,0,45,23
1746560131131,EDS 281,A00,895701,Meyerott; Theresa Ann,1,0,15,14
1746560132156,EDS 284,A00,895736,Meyerott; Theresa Ann,1,0,15,14
1746560133181,EDS 286,A00,897210,Fine; Sarah,0,0,15,15
1746560134207,EDS 289C,A01,895770,Daly; Alan J.,1,0,15,14
1746560135232,EDS 290,A00,897211,Hofstetter; Carolyn,0,0,15,15
1746560136260,LIGM 5A,A00,896162,Fischer-Grunski; Eva K,12,0,20,8
1746560137290,LIGM 5B,A00,896260,Fischer-Grunski; Eva K,17,0,20,3
1746560138314,LIGM 5C,A00,896308,Fischer-Grunski; Eva K,18,0,20,2
1746560139343,LIIT 5AS,A00,896313,Carnelos; Chiara,18,0,20,2
1746560140368,LIIT 5BS,A00,896416,Carnelos; Chiara,20,0,20,0
1746560141395,LIIT 5CS,A00,896564,Carnelos; Chiara,20,0,20,0
1746560142425,LISP 5A,A00,896588,Munoz Sanchez; Alicia,3,0,20,17
1746560143477,LISP 5B,A00,896653,Munoz Sanchez; Alicia,7,0,20,13
1746560144502,LISP 5C,A00,896655,Munoz Sanchez; Alicia,0,1,20,20
1746560145529,MAE 197,001,957918,Kleissl; Jan,9996,0,9999,3
1746560145529,MAE 197,002,959806,Boechler; Nicholas Sebastia,9998,0,9999,1
1746560145529,MAE 197,003,959852,Mullin; Jennifer S,9998,0,9999,1
1746560146553,MATH 2,A01,957937,Staff,33,0,35,2
1746560147581,MATH 197,001,957876,Kedlaya; Kiran S.,9993,0,9999,6
1746560148606,MCWP 40,A00,892729,Duru; Nur,10,0,20,10
1746560148606,MCWP 40,B00,893304,Montejo; Carolina,14,0,20,6
1746560149629,MCWP 40R,A00,893757,Redela; Pamela Morgan,0,5,20,20
1746560150654,MCWP 50,A00,893758,Morshed; Michael James,0,0,20,20
1746560150654,MCWP 50,B00,893761,Bartulis; Jason Michael,17,0,20,3
1746560151679,MCWP 50R,A00,893766,Compas; Sean Matthew,0,1,20,20
1746560151679,MCWP 50R,B00,893769,Carter; Jennifer A,0,1,20,20
1746560151679,MCWP 50R,C00,893771,Krone; Jarret,0,3,20,20
1746560151679,MCWP 50R,D00,893772,Miller; Elizabeth Deen,0,0,20,20
1746560151679,MCWP 50R,E00,893775,Carter; Andrea L,0,1,20,20
1746560152706,MMW 11R,A01,892721,Herbst; Matthew,11,0,27,16
1746560152706,MMW 11R,A02,892722,Herbst; Matthew,0,0,0,3
1746560153733,MMW 12R,A01,892724,Herbst; Matthew,0,11,16,16
1746560153733,MMW 12R,A02,892725,Herbst; Matthew,0,10,16,16
1746560154757,MMW 13R,A01,892727,Staff,0,4,16,16
1746560154757,MMW 13R,A02,892728,Staff,0,4,16,16
1746560154757,MMW 13R,A03,958032,Staff,0,4,16,16
1746560154757,MMW 13R,A04,958033,Staff,0,4,16,16
1746560154757,MMW 13R,A05,958034,Staff,0,4,16,16
1746560155785,SIO 295LS,A00,894015,Staff,5,0,25,20
1746560156809,SIO 295S,A00,894020,Staff,5,0,25,20
1746560157836,SIOC 290S,B01,958918,Merrifield; Mark A,14,0,30,16
1746560158871,SIOC 291S,B01,958922,Gabriel; Corey John,14,0,30,16
1746560159897,SOCI 117,A01,895339,Staff,3,0,5,2
1746560160922,WES 237B,A00,894149,Staff,11,0,20,9
1746560162975,AESE 279B,A00,891859,Staff,13,0,35,22
1746560164000,AIP 197,001,891854,Vespa; Emanuel Ignacio,9999,0,9999,0
1746560165025,ANTH 289S,A00,891856,Gagneux; Pascal,12,0,12,0
1746560166052,BENG 196,001,957946,Engler; Adam J.,9996,0,9999,3
1746560167078,BISP 197,001,959851,Wilhelm; James E.,9998,0,9999,1
1746560168102,CAT 124RS,A01,956906,Staff,6,0,25,19
1746560169138,CAT 125RS,A01,922013,Staff,6,0,25,19
1746560170163,CLRE 250,A00,891860,Morris; Sheldon,9995,0,9999,4
1746560172213,CLRE 251R,A00,907817,Mehta; Ravindra L.,9994,0,9999,5
1746560173237,CLRE 252,A00,891864,Cuomo; Raphael Eduardo,9993,0,9999,6
1746560174265,CLRE 253,A00,891867,Vaida; Florin,9994,0,9999,5
1746560174265,CLRE 253,B00,907819,Staff,9999,0,9999,0
1746560175288,CLRE 259,A00,891868,Patel; Hemal,9998,0,9999,1
1746560176311,CLRE 260,A00,891872,Cuomo; Raphael Eduardo,9999,0,9999,0
1746560177338,CLRE 297,001,891888,Cuomo; Raphael Eduardo,9999,0,9999,0
1746560178363,CSE 191,A00,958773,Minnes Kemp; Mor Mia,9995,0,9999,4
1746560179413,CSE 197,001,959846,Minnes Kemp; Mor Mia,9990,0,9999,9
1746560180441,CSS 201S,A01,892054,Mignozzetti; Umberto,26,0,30,4
1746560181468,CSS 202S,A01,892056,Mignozzetti; Umberto,26,0,30,4
1746560182493,DSC 197,001,956898,Eldridge; Justin Matthew,9997,0,9999,2
1746560183531,DSC 297,001,958000,Mazumdar; Arya,9998,0,9999,1
1746560183531,DSC 297,002,959862,Wang; Yusu,9998,0,9999,1
1746560184555,EAP 100,A00,905686,Staff,9778,0,9999,221
1746560185583,ECE 45,A01,892618,Staff,0,0,65,65
1746560187636,ECE 111,A01,892719,Staff,4,0,65,61
1746560188660,ECE 197,001,957920,Mercier; Patrick Philip,9991,0,9999,8
1746560189688,ECON 178,A01,907814,Zhu; Ying,26,0,35,9
1746560190713,EDS 115,A00,895312,Staff,35,0,45,10
1746560191740,EDS 117,A01,895337,Staff,23,0,30,7
1746560192765,EDS 125,A00,895341,Jones; Gabrielle Anastasia,36,0,45,9
1746560193791,EDS 128A,A01,895459,Fargason; Sharon Gayle,44,0,45,1
1746560194817,EDS 128B,A01,895543,Pappas; Elizabeth,44,0,45,1
1746560195843,EDS 139,A00,897203,Pappas; Elizabeth,44,0,45,1
1746560195843,EDS 139,B00,897209,Fargason; Sharon Gayle,41,0,45,4
1746560196870,EDS 201,A00,895545,Staff,22,0,45,23
1746560197894,EDS 203,A01,895581,Halter; Christopher P.,22,0,45,23
1746560198920,EDS 204R,A01,895625,Heinzman; Erica M.,39,0,45,6
1746560198920,EDS 204R,B01,895693,Halter; Christopher P.,10,0,45,35
1746560199947,EDS 206R,A00,895694,Fargason; Sharon Gayle,1,0,30,29
1746560199947,EDS 206R,B00,895695,Choi; Bailey Miyeon,16,0,30,14
1746560200974,EDS 250,A00,895697,Hemans; Patricia Ann Benitez,22,0,45,23
1746560201999,EDS 281,A00,895701,Meyerott; Theresa Ann,1,0,15,14
1746560203026,EDS 284,A00,895736,Meyerott; Theresa Ann,1,0,15,14
1746560204051,EDS 286,A00,897210,Fine; Sarah,0,0,15,15
1746560205079,EDS 289C,A01,895770,Daly; Alan J.,1,0,15,14
1746560206102,EDS 290,A00,897211,Hofstetter; Carolyn,0,0,15,15
1746560207128,LIGM 5A,A00,896162,Fischer-Grunski; Eva K,12,0,20,8
1746560208153,LIGM 5B,A00,896260,Fischer-Grunski; Eva K,17,0,20,3
1746560209183,LIGM 5C,A00,896308,Fischer-Grunski; Eva K,18,0,20,2
1746560210207,LIIT 5AS,A00,896313,Carnelos; Chiara,18,0,20,2
1746560211235,LIIT 5BS,A00,896416,Carnelos; Chiara,20,0,20,0
1746560212260,LIIT 5CS,A00,896564,Carnelos; Chiara,20,0,20,0
1746560213284,LISP 5A,A00,896588,Munoz Sanchez; Alicia,3,0,20,17
1746560214309,LISP 5B,A00,896653,Munoz Sanchez; Alicia,7,0,20,13
1746560215336,LISP 5C,A00,896655,Munoz Sanchez; Alicia,0,1,20,20
1746560216364,MAE 197,001,957918,Kleissl; Jan,9996,0,9999,3
1746560216364,MAE 197,002,959806,Boechler; Nicholas Sebastia,9998,0,9999,1
1746560216364,MAE 197,003,959852,Mullin; Jennifer S,9998,0,9999,1
1746560217392,MATH 2,A01,957937,Staff,33,0,35,2
1746560218415,MATH 197,001,957876,Kedlaya; Kiran S.,9993,0,9999,6
1746560219442,MCWP 40,A00,892729,Duru; Nur,10,0,20,10
1746560219442,MCWP 40,B00,893304,Montejo; Carolina,14,0,20,6
1746560220466,MCWP 40R,A00,893757,Redela; Pamela Morgan,0,5,20,20
1746560221492,MCWP 50,A00,893758,Morshed; Michael James,0,0,20,20
1746560221492,MCWP 50,B00,893761,Bartulis; Jason Michael,17,0,20,3
1746560222521,MCWP 50R,A00,893766,Compas; Sean Matthew,0,1,20,20
1746560222521,MCWP 50R,B00,893769,Carter; Jennifer A,0,1,20,20
1746560222521,MCWP 50R,C00,893771,Krone; Jarret,0,3,20,20
1746560222521,MCWP 50R,D00,893772,Miller; Elizabeth Deen,0,0,20,20
1746560222521,MCWP 50R,E00,893775,Carter; Andrea L,0,1,20,20
1746560223551,MMW 11R,A01,892721,Herbst; Matthew,11,0,27,16
1746560223551,MMW 11R,A02,892722,Herbst; Matthew,0,0,0,3
1746560224576,MMW 12R,A01,892724,Herbst; Matthew,0,11,16,16
1746560224576,MMW 12R,A02,892725,Herbst; Matthew,0,10,16,16
1746560225604,MMW 13R,A01,892727,Staff,0,4,16,16
1746560225604,MMW 13R,A02,892728,Staff,0,4,16,16
1746560225604,MMW 13R,A03,958032,Staff,0,4,16,16
1746560225604,MMW 13R,A04,958033,Staff,0,4,16,16
1746560225604,MMW 13R,A05,958034,Staff,0,4,16,16
1746560226628,SIO 295LS,A00,894015,Staff,5,0,25,20
1746560227655,SIO 295S,A00,894020,Staff,5,0,25,20
1746560228679,SIOC 290S,B01,958918,Merrifield; Mark A,14,0,30,16
1746560229705,SIOC 291S,B01,958922,Gabriel; Corey John,14,0,30,16
1746560230730,SOCI 117,A01,895339,Staff,3,0,5,2
1746560231755,WES 237B,A00,894149,Staff,11,0,20,9
1746560233818,AESE 279B,A00,891859,Staff,13,0,35,22
1746560234840,AIP 197,001,891854,Vespa; Emanuel Ignacio,9999,0,9999,0
1746560235868,ANTH 289S,A00,891856,Gagneux; Pascal,12,0,12,0
1746560236893,BENG 196,001,957946,Engler; Adam J.,9996,0,9999,3
1746560237920,BISP 197,001,959851,Wilhelm; James E.,9998,0,9999,1
1746560238947,CAT 124RS,A01,956906,Staff,6,0,25,19
1746560239971,CAT 125RS,A01,922013,Staff,6,0,25,19
1746560240993,CLRE 250,A00,891860,Morris; Sheldon,9995,0,9999,4
1746560243044,CLRE 251R,A00,907817,Mehta; Ravindra L.,9994,0,9999,5
1746560244069,CLRE 252,A00,891864,Cuomo; Raphael Eduardo,9993,0,9999,6
1746560245092,CLRE 253,A00,891867,Vaida; Florin,9994,0,9999,5
1746560245092,CLRE 253,B00,907819,Staff,9999,0,9999,0
1746560246119,CLRE 259,A00,891868,Patel; Hemal,9998,0,9999,1
1746560247144,CLRE 260,A00,891872,Cuomo; Raphael Eduardo,9999,0,9999,0
1746560248171,CLRE 297,001,891888,Cuomo; Raphael Eduardo,9999,0,9999,0
1746560249199,CSE 191,A00,958773,Minnes Kemp; Mor Mia,9995,0,9999,4
1746560250227,CSE 197,001,959846,Minnes Kemp; Mor Mia,9990,0,9999,9
1746560251256,CSS 201S,A01,892054,Mignozzetti; Umberto,26,0,30,4
1746560252281,CSS 202S,A01,892056,Mignozzetti; Umberto,26,0,30,4
1746560253307,DSC 197,001,956898,Eldridge; Justin Matthew,9997,0,9999,2
1746560254334,DSC 297,001,958000,Mazumdar; Arya,9998,0,9999,1
1746560254334,DSC 297,002,959862,Wang; Yusu,9998,0,9999,1
1746560255358,EAP 100,A00,905686,Staff,9778,0,9999,221
1746560256388,ECE 45,A01,892618,Staff,0,0,65,65
1746560258443,ECE 111,A01,892719,Staff,4,0,65,61
1746560259474,ECE 197,001,957920,Mercier; Patrick Philip,9991,0,9999,8
1746560260503,ECON 178,A01,907814,Zhu; Ying,26,0,35,9
1746560261528,EDS 115,A00,895312,Staff,35,0,45,10
1746560262556,EDS 117,A01,895337,Staff,23,0,30,7
1746560263596,EDS 125,A00,895341,Jones; Gabrielle Anastasia,36,0,45,9
1746560264625,EDS 128A,A01,895459,Fargason; Sharon Gayle,44,0,45,1
1746560265649,EDS 128B,A01,895543,Pappas; Elizabeth,44,0,45,1
1746560266678,EDS 139,A00,897203,Pappas; Elizabeth,44,0,45,1
1746560266678,EDS 139,B00,897209,Fargason; Sharon Gayle,41,0,45,4
1746560267705,EDS 201,A00,895545,Staff,22,0,45,23
1746560268732,EDS 203,A01,895581,Halter; Christopher P.,22,0,45,23
1746560269760,EDS 204R,A01,895625,Heinzman; Erica M.,39,0,45,6
1746560269760,EDS 204R,B01,895693,Halter; Christopher P.,10,0,45,35
1746560270784,EDS 206R,A00,895694,Fargason; Sharon Gayle,1,0,30,29
1746560270784,EDS 206R,B00,895695,Choi; Bailey Miyeon,16,0,30,14
1746560271810,EDS 250,A00,895697,Hemans; Patricia Ann Benitez,22,0,45,23
1746560272835,EDS 281,A00,895701,Meyerott; Theresa Ann,1,0,15,14
1746560273860,EDS 284,A00,895736,Meyerott; Theresa Ann,1,0,15,14
1746560274884,EDS 286,A00,897210,Fine; Sarah,0,0,15,15
1746560275911,EDS 289C,A01,895770,Daly; Alan J.,1,0,15,14
1746560276939,EDS 290,A00,897211,Hofstetter; Carolyn,0,0,15,15
1746560277963,LIGM 5A,A00,896162,Fischer-Grunski; Eva K,12,0,20,8
1746560278988,LIGM 5B,A00,896260,Fischer-Grunski; Eva K,17,0,20,3
1746560280017,LIGM 5C,A00,896308,Fischer-Grunski; Eva K,18,0,20,2
1746560281042,LIIT 5AS,A00,896313,Carnelos; Chiara,18,0,20,2
1746560282069,LIIT 5BS,A00,896416,Carnelos; Chiara,20,0,20,0
1746560283097,LIIT 5CS,A00,896564,Carnelos; Chiara,20,0,20,0
1746560284125,LISP 5A,A00,896588,Munoz Sanchez; Alicia,3,0,20,17
1746560285152,LISP 5B,A00,896653,Munoz Sanchez; Alicia,7,0,20,13
1746560286179,LISP 5C,A00,896655,Munoz Sanchez; Alicia,0,1,20,20
1746560287203,MAE 197,001,957918,Kleissl; Jan,9996,0,9999,3
1746560287203,MAE 197,002,959806,Boechler; Nicholas Sebastia,9998,0,9999,1
1746560287203,MAE 197,003,959852,Mullin; Jennifer S,9998,0,9999,1
1746560288230,MATH 2,A01,957937,Staff,33,0,35,2
1746560289256,MATH 197,001,957876,Kedlaya; Kiran S.,9993,0,9999,6
1746560290283,MCWP 40,A00,892729,Duru; Nur,10,0,20,10
1746560290283,MCWP 40,B00,893304,Montejo; Carolina,14,0,20,6
1746560291308,MCWP 40R,A00,893757,Redela; Pamela Morgan,0,5,20,20
1746560292334,MCWP 50,A00,893758,Morshed; Michael James,0,0,20,20
1746560292334,MCWP 50,B00,893761,Bartulis; Jason Michael,17,0,20,3
1746560293362,MCWP 50R,A00,893766,Compas; Sean Matthew,0,1,20,20
1746560293362,MCWP 50R,B00,893769,Carter; Jennifer A,0,1,20,20
1746560293362,MCWP 50R,C00,893771,Krone; Jarret,0,3,20,20
1746560293362,MCWP 50R,D00,893772,Miller; Elizabeth Deen,0,0,20,20
1746560293362,MCWP 50R,E00,893775,Carter; Andrea L,0,1,20,20
1746560294387,MMW 11R,A01,892721,Herbst; Matthew,11,0,27,16
1746560294387,MMW 11R,A02,892722,Herbst; Matthew,0,0,0,3
1746560295415,MMW 12R,A01,892724,Herbst; Matthew,0,11,16,16
1746560295415,MMW 12R,A02,892725,Herbst; Matthew,0,10,16,16
1746560296440,MMW 13R,A01,892727,Staff,0,4,16,16
1746560296440,MMW 13R,A02,892728,Staff,0,4,16,16
1746560296440,MMW 13R,A03,958032,Staff,0,4,16,16
1746560296440,MMW 13R,A04,958033,Staff,0,4,16,16
1746560296440,MMW 13R,A05,958034,Staff,0,4,16,16
1746560297466,SIO 295LS,A00,894015,Staff,5,0,25,20
1746560298492,SIO 295S,A00,894020,Staff,5,0,25,20
1746560299518,SIOC 290S,B01,958918,Merrifield; Mark A,14,0,30,16
1746560300549,SIOC 291S,B01,958922,Gabriel; Corey John,14,0,30,16
1746560301574,SOCI 117,A01,895339,Staff,3,0,5,2
1746560302598,WES 237B,A00,894149,Staff,11,0,20,9
1746560304677,AESE 279B,A00,891859,Staff,13,0,35,22
1746560305700,AIP 197,001,891854,Vespa; Emanuel Ignacio,9999,0,9999,0
1746560306725,ANTH 289S,A00,891856,Gagneux; Pascal,12,0,12,0
1746560307751,BENG 196,001,957946,Engler; Adam J.,9996,0,9999,3
1746560308778,BISP 197,001,959851,Wilhelm; James E.,9998,0,9999,1
1746560309804,CAT 124RS,A01,956906,Staff,6,0,25,19
1746560310832,CAT 125RS,A01,922013,Staff,6,0,25,19
1746560311875,CLRE 250,A00,891860,Morris; Sheldon,9995,0,9999,4
1746560313927,CLRE 251R,A00,907817,Mehta; Ravindra L.,9994,0,9999,5
1746560314952,CLRE 252,A00,891864,Cuomo; Raphael Eduardo,9993,0,9999,6
1746560315977,CLRE 253,A00,891867,Vaida; Florin,9994,0,9999,5
1746560315977,CLRE 253,B00,907819,Staff,9999,0,9999,0
1746560317002,CLRE 259,A00,891868,Patel; Hemal,9998,0,9999,1
1746560318028,CLRE 260,A00,891872,Cuomo; Raphael Eduardo,9999,0,9999,0
1746560319056,CLRE 297,001,891888,Cuomo; Raphael Eduardo,9999,0,9999,0
1746560320080,CSE 191,A00,958773,Minnes Kemp; Mor Mia,9995,0,9999,4
1746560321103,CSE 197,001,959846,Minnes Kemp; Mor Mia,9990,0,9999,9
1746560322128,CSS 201S,A01,892054,Mignozzetti; Umberto,26,0,30,4
1746560323154,CSS 202S,A01,892056,Mignozzetti; Umberto,26,0,30,4
1746560324177,DSC 197,001,956898,Eldridge; Justin Matthew,9997,0,9999,2
1746560325204,DSC 297,001,958000,Mazumdar; Arya,9998,0,9999,1
1746560325204,DSC 297,002,959862,Wang; Yusu,9998,0,9999,1
1746560326231,EAP 100,A00,905686,Staff,9778,0,9999,221
1746560327260,ECE 45,A01,892618,Staff,0,0,65,65
1746560329310,ECE 111,A01,892719,Staff,4,0,65,61
1746560330337,ECE 197,001,957920,Mercier; Patrick Philip,9991,0,9999,8
1746560331363,ECON 178,A01,907814,Zhu; Ying,26,0,35,9
1746560332399,EDS 115,A00,895312,Staff,35,0,45,10
1746560333423,EDS 117,A01,895337,Staff,23,0,30,7
1746560334451,EDS 125,A00,895341,Jones; Gabrielle Anastasia,36,0,45,9
1746560335476,EDS 128A,A01,895459,Fargason; Sharon Gayle,44,0,45,1
1746560336505,EDS 128B,A01,895543,Pappas; Elizabeth,44,0,45,1
1746560337532,EDS 139,A00,897203,Pappas; Elizabeth,44,0,45,1
1746560337532,EDS 139,B00,897209,Fargason; Sharon Gayle,41,0,45,4
1746560338555,EDS 201,A00,895545,Staff,22,0,45,23
1746560339582,EDS 203,A01,895581,Halter; Christopher P.,22,0,45,23
1746560340612,EDS 204R,A01,895625,Heinzman; Erica M.,39,0,45,6
1746560340612,EDS 204R,B01,895693,Halter; Christopher P.,10,0,45,35
1746560341638,EDS 206R,A00,895694,Fargason; Sharon Gayle,1,0,30,29
1746560341638,EDS 206R,B00,895695,Choi; Bailey Miyeon,16,0,30,14
1746560342670,EDS 250,A00,895697,Hemans; Patricia Ann Benitez,22,0,45,23
1746560343694,EDS 281,A00,895701,Meyerott; Theresa Ann,1,0,15,14
1746560344721,EDS 284,A00,895736,Meyerott; Theresa Ann,1,0,15,14
1746560345748,EDS 286,A00,897210,Fine; Sarah,0,0,15,15
1746560346774,EDS 289C,A01,895770,Daly; Alan J.,1,0,15,14
1746560347801,EDS 290,A00,897211,Hofstetter; Carolyn,0,0,15,15
1746560348833,LIGM 5A,A00,896162,Fischer-Grunski; Eva K,12,0,20,8
1746560349858,LIGM 5B,A00,896260,Fischer-Grunski; Eva K,17,0,20,3
1746560350884,LIGM 5C,A00,896308,Fischer-Grunski; Eva K,18,0,20,2
1746560351909,LIIT 5AS,A00,896313,Carnelos; Chiara,18,0,20,2
1746560352935,LIIT 5BS,A00,896416,Carnelos; Chiara,20,0,20,0
1746560353963,LIIT 5CS,A00,896564,Carnelos; Chiara,20,0,20,0
1746560354988,LISP 5A,A00,896588,Munoz Sanchez; Alicia,3,0,20,17
1746560356017,LISP 5B,A00,896653,Munoz Sanchez; Alicia,7,0,20,13
1746560357043,LISP 5C,A00,896655,Munoz Sanchez; Alicia,0,1,20,20
1746560358069,MAE 197,001,957918,Kleissl; Jan,9996,0,9999,3
1746560358069,MAE 197,002,959806,Boechler; Nicholas Sebastia,9998,0,9999,1
1746560358069,MAE 197,003,959852,Mullin; Jennifer S,9998,0,9999,1
1746560359095,MATH 2,A01,957937,Staff,33,0,35,2
1746560360121,MATH 197,001,957876,Kedlaya; Kiran S.,9993,0,9999,6
1746560361147,MCWP 40,A00,892729,Duru; Nur,10,0,20,10
1746560361147,MCWP 40,B00,893304,Montejo; Carolina,14,0,20,6
1746560362171,MCWP 40R,A00,893757,Redela; Pamela Morgan,0,5,20,20
1746560363197,MCWP 50,A00,893758,Morshed; Michael James,0,0,20,20
1746560363197,MCWP 50,B00,893761,Bartulis; Jason Michael,17,0,20,3
1746560364224,MCWP 50R,A00,893766,Compas; Sean Matthew,0,1,20,20
1746560364224,MCWP 50R,B00,893769,Carter; Jennifer A,0,1,20,20
1746560364224,MCWP 50R,C00,893771,Krone; Jarret,0,3,20,20
1746560364224,MCWP 50R,D00,893772,Miller; Elizabeth Deen,0,0,20,20
1746560364224,MCWP 50R,E00,893775,Carter; Andrea L,0,1,20,20
1746560365249,MMW 11R,A01,892721,Herbst; Matthew,11,0,27,16
1746560365249,MMW 11R,A02,892722,Herbst; Matthew,0,0,0,3
1746560366275,MMW 12R,A01,892724,Herbst; Matthew,0,11,16,16
1746560366275,MMW 12R,A02,892725,Herbst; Matthew,0,10,16,16
1746560367300,MMW 13R,A01,892727,Staff,0,4,16,16
1746560367300,MMW 13R,A02,892728,Staff,0,4,16,16
1746560367300,MMW 13R,A03,958032,Staff,0,4,16,16
1746560367300,MMW 13R,A04,958033,Staff,0,4,16,16
1746560367300,MMW 13R,A05,958034,Staff,0,4,16,16
1746560368327,SIO 295LS,A00,894015,Staff,5,0,25,20
1746560369352,SIO 295S,A00,894020,Staff,5,0,25,20
1746560370380,SIOC 290S,B01,958918,Merrifield; Mark A,14,0,30,16
1746560371405,SIOC 291S,B01,958922,Gabriel; Corey John,14,0,30,16
1746560372432,SOCI 117,A01,895339,Staff,3,0,5,2
1746560373457,WES 237B,A00,894149,Staff,11,0,20,9
1746560375525,AESE 279B,A00,891859,Staff,13,0,35,22
1746560376554,AIP 197,001,891854,Vespa; Emanuel Ignacio,9999,0,9999,0
1746560377581,ANTH 289S,A00,891856,Gagneux; Pascal,12,0,12,0
1746560378605,BENG 196,001,957946,Engler; Adam J.,9996,0,9999,3
1746560379633,BISP 197,001,959851,Wilhelm; James E.,9998,0,9999,1
1746560380657,CAT 124RS,A01,956906,Staff,6,0,25,19
1746560381685,CAT 125RS,A01,922013,Staff,6,0,25,19
1746560382710,CLRE 250,A00,891860,Morris; Sheldon,9995,0,9999,4
1746560384763,CLRE 251R,A00,907817,Mehta; Ravindra L.,9994,0,9999,5
1746560385791,CLRE 252,A00,891864,Cuomo; Raphael Eduardo,9993,0,9999,6
1746560386819,CLRE 253,A00,891867,Vaida; Florin,9994,0,9999,5
1746560386819,CLRE 253,B00,907819,Staff,9999,0,9999,0
1746560387843,CLRE 259,A00,891868,Patel; Hemal,9998,0,9999,1
1746560388868,CLRE 260,A00,891872,Cuomo; Raphael Eduardo,9999,0,9999,0
1746560389896,CLRE 297,001,891888,Cuomo; Raphael Eduardo,9999,0,9999,0
1746560390922,CSE 191,A00,958773,Minnes Kemp; Mor Mia,9995,0,9999,4
1746560391946,CSE 197,001,959846,Minnes Kemp; Mor Mia,9990,0,9999,9
1746560392972,CSS 201S,A01,892054,Mignozzetti; Umberto,26,0,30,4
1746560394000,CSS 202S,A01,892056,Mignozzetti; Umberto,26,0,30,4
1746560395032,DSC 197,001,956898,Eldridge; Justin Matthew,9997,0,9999,2
1746560396059,DSC 297,001,958000,Mazumdar; Arya,9998,0,9999,1
1746560396059,DSC 297,002,959862,Wang; Yusu,9998,0,9999,1
1746560397084,EAP 100,A00,905686,Staff,9778,0,9999,221
1746560398112,ECE 45,A01,892618,Staff,0,0,65,65
1746560400165,ECE 111,A01,892719,Staff,4,0,65,61
1746560401190,ECE 197,001,957920,Mercier; Patrick Philip,9991,0,9999,8
1746560402221,ECON 178,A01,907814,Zhu; Ying,26,0,35,9
1746560403245,EDS 115,A00,895312,Staff,35,0,45,10
1746560404274,EDS 117,A01,895337,Staff,23,0,30,7
1746560405301,EDS 125,A00,895341,Jones; Gabrielle Anastasia,36,0,45,9
1746560406330,EDS 128A,A01,895459,Fargason; Sharon Gayle,44,0,45,1
1746560407358,EDS 128B,A01,895543,Pappas; Elizabeth,44,0,45,1
1746560408382,EDS 139,A00,897203,Pappas; Elizabeth,44,0,45,1
1746560408382,EDS 139,B00,897209,Fargason; Sharon Gayle,41,0,45,4
1746560409409,EDS 201,A00,895545,Staff,22,0,45,23
1746560410435,EDS 203,A01,895581,Halter; Christopher P.,22,0,45,23
1746560411460,EDS 204R,A01,895625,Heinzman; Erica M.,39,0,45,6
1746560411460,EDS 204R,B01,895693,Halter; Christopher P.,10,0,45,35
1746560412485,EDS 206R,A00,895694,Fargason; Sharon Gayle,1,0,30,29
1746560412485,EDS 206R,B00,895695,Choi; Bailey Miyeon,16,0,30,14
1746560413511,EDS 250,A00,895697,Hemans; Patricia Ann Benitez,22,0,45,23
1746560414537,EDS 281,A00,895701,Meyerott; Theresa Ann,1,0,15,14
1746560415564,EDS 284,A00,895736,Meyerott; Theresa Ann,1,0,15,14
1746560416592,EDS 286,A00,897210,Fine; Sarah,0,0,15,15
1746560417617,EDS 289C,A01,895770,Daly; Alan J.,1,0,15,14
1746560418641,EDS 290,A00,897211,Hofstetter; Carolyn,0,0,15,15
1746560419671,LIGM 5A,A00,896162,Fischer-Grunski; Eva K,12,0,20,8
1746560420697,LIGM 5B,A00,896260,Fischer-Grunski; Eva K,17,0,20,3
1746560421723,LIGM 5C,A00,896308,Fischer-Grunski; Eva K,18,0,20,2
1746560422747,LIIT 5AS,A00,896313,Carnelos; Chiara,18,0,20,2
1746560423774,LIIT 5BS,A00,896416,Carnelos; Chiara,20,0,20,0
1746560424801,LIIT 5CS,A00,896564,Carnelos; Chiara,20,0,20,0
1746560425829,LISP 5A,A00,896588,Munoz Sanchez; Alicia,3,0,20,17
1746560426857,LISP 5B,A00,896653,Munoz Sanchez; Alicia,7,0,20,13
1746560427885,LISP 5C,A00,896655,Munoz Sanchez; Alicia,0,1,20,20
1746560428914,MAE 197,001,957918,Kleissl; Jan,9996,0,9999,3
1746560428914,MAE 197,002,959806,Boechler; Nicholas Sebastia,9998,0,9999,1
1746560428914,MAE 197,003,959852,Mullin; Jennifer S,9998,0,9999,1
1746560429942,MATH 2,A01,957937,Staff,33,0,35,2
1746560430968,MATH 197,001,957876,Kedlaya; Kiran S.,9993,0,9999,6
1746560431995,MCWP 40,A00,892729,Duru; Nur,10,0,20,10
1746560431995,MCWP 40,B00,893304,Montejo; Carolina,14,0,20,6
1746560433020,MCWP 40R,A00,893757,Redela; Pamela Morgan,0,5,20,20
1746560434047,MCWP 50,A00,893758,Morshed; Michael James,0,0,20,20
1746560434047,MCWP 50,B00,893761,Bartulis; Jason Michael,17,0,20,3
1746560435075,MCWP 50R,A00,893766,Compas; Sean Matthew,0,1,20,20
1746560435075,MCWP 50R,B00,893769,Carter; Jennifer A,0,1,20,20
1746560435075,MCWP 50R,C00,893771,Krone; Jarret,0,3,20,20
1746560435075,MCWP 50R,D00,893772,Miller; Elizabeth Deen,0,0,20,20
1746560435075,MCWP 50R,E00,893775,Carter; Andrea L,0,1,20,20
1746560436101,MMW 11R,A01,892721,Herbst; Matthew,11,0,27,16
1746560436101,MMW 11R,A02,892722,Herbst; Matthew,0,0,0,3
1746560437127,MMW 12R,A01,892724,Herbst; Matthew,0,11,16,16
1746560437127,MMW 12R,A02,892725,Herbst; Matthew,0,10,16,16
1746560438153,MMW 13R,A01,892727,Staff,0,4,16,16
1746560438153,MMW 13R,A02,892728,Staff,0,4,16,16
1746560438153,MMW 13R,A03,958032,Staff,0,4,16,16
1746560438153,MMW 13R,A04,958033,Staff,0,4,16,16
1746560438153,MMW 13R,A05,958034,Staff,0,4,16,16
1746560439180,SIO 295LS,A00,894015,Staff,5,0,25,20
1746560440206,SIO 295S,A00,894020,Staff,5,0,25,20
1746560441246,SIOC 290S,B01,958918,Merrifield; Mark A,14,0,30,16
1746560442273,SIOC 291S,B01,958922,Gabriel; Corey John,14,0,30,16
1746560443303,SOCI 117,A01,895339,Staff,3,0,5,2
1746560444330,WES 237B,A00,894149,Staff,11,0,20,9
1746560446390,AESE 279B,A00,891859,Staff,13,0,35,22
1746560447414,AIP 197,001,891854,Vespa; Emanuel Ignacio,9999,0,9999,0
1746560448442,ANTH 289S,A00,891856,Gagneux; Pascal,12,0,12,0
1746560449467,BENG 196,001,957946,Engler; Adam J.,9996,0,9999,3
1746560450496,BISP 197,001,959851,Wilhelm; James E.,9998,0,9999,1
1746560451547,CAT 124RS,A01,956906,Staff,6,0,25,19
1746560452573,CAT 125RS,A01,922013,Staff,6,0,25,19
1746560453598,CLRE 250,A00,891860,Morris; Sheldon,9995,0,9999,4
1746560455645,CLRE 251R,A00,907817,Mehta; Ravindra L.,9994,0,9999,5
1746560456669,CLRE 252,A00,891864,Cuomo; Raphael Eduardo,9993,0,9999,6
1746560457693,CLRE 253,A00,891867,Vaida; Florin,9994,0,9999,5
1746560457693,CLRE 253,B00,907819,Staff,9999,0,9999,0
1746560458719,CLRE 259,A00,891868,Patel; Hemal,9998,0,9999,1
1746560459744,CLRE 260,A00,891872,Cuomo; Raphael Eduardo,9999,0,9999,0
1746560460766,CLRE 297,001,891888,Cuomo; Raphael Eduardo,9999,0,9999,0
1746560461790,CSE 191,A00,958773,Minnes Kemp; Mor Mia,9995,0,9999,4
1746560462819,CSE 197,001,959846,Minnes Kemp; Mor Mia,9990,0,9999,9
1746560463844,CSS 201S,A01,892054,Mignozzetti; Umberto,26,0,30,4
1746560464869,CSS 202S,A01,892056,Mignozzetti; Umberto,26,0,30,4
1746560465897,DSC 197,001,956898,Eldridge; Justin Matthew,9997,0,9999,2
1746560466926,DSC 297,001,958000,Mazumdar; Arya,9998,0,9999,1
1746560466926,DSC 297,002,959862,Wang; Yusu,9998,0,9999,1
1746560467951,EAP 100,A00,905686,Staff,9778,0,9999,221
1746560468979,ECE 45,A01,892618,Staff,0,0,65,65
1746560471032,ECE 111,A01,892719,Staff,4,0,65,61
1746560472056,ECE 197,001,957920,Mercier; Patrick Philip,9991,0,9999,8
1746560473085,ECON 178,A01,907814,Zhu; Ying,26,0,35,9
1746560474111,EDS 115,A00,895312,Staff,35,0,45,10
1746560475139,EDS 117,A01,895337,Staff,23,0,30,7
1746560476162,EDS 125,A00,895341,Jones; Gabrielle Anastasia,36,0,45,9
1746560477191,EDS 128A,A01,895459,Fargason; Sharon Gayle,44,0,45,1
1746560478215,EDS 128B,A01,895543,Pappas; Elizabeth,44,0,45,1
1746560479243,EDS 139,A00,897203,Pappas; Elizabeth,44,0,45,1
1746560479243,EDS 139,B00,897209,Fargason; Sharon Gayle,41,0,45,4
1746560480269,EDS 201,A00,895545,Staff,22,0,45,23
1746560481297,EDS 203,A01,895581,Halter; Christopher P.,22,0,45,23
1746560482323,EDS 204R,A01,895625,Heinzman; Erica M.,39,0,45,6
1746560482323,EDS 204R,B01,895693,Halter; Christopher P.,10,0,45,35
1746560483349,EDS 206R,A00,895694,Fargason; Sharon Gayle,1,0,30,29
1746560483349,EDS 206R,B00,895695,Choi; Bailey Miyeon,16,0,30,14
1746560484374,EDS 250,A00,895697,Hemans; Patricia Ann Benitez,22,0,45,23
1746560485402,EDS 281,A00,895701,Meyerott; Theresa Ann,1,0,15,14
1746560486429,EDS 284,A00,895736,Meyerott; Theresa Ann,1,0,15,14
1746560487452,EDS 286,A00,897210,Fine; Sarah,0,0,15,15
1746560488481,EDS 289C,A01,895770,Daly; Alan J.,1,0,15,14
1746560489507,EDS 290,A00,897211,Hofstetter; Carolyn,0,0,15,15
1746560490530,LIGM 5A,A00,896162,Fischer-Grunski; Eva K,12,0,20,8
1746560491559,LIGM 5B,A00,896260,Fischer-Grunski; Eva K,17,0,20,3
1746560492587,LIGM 5C,A00,896308,Fischer-Grunski; Eva K,18,0,20,2
1746560493611,LIIT 5AS,A00,896313,Carnelos; Chiara,18,0,20,2
1746560494635,LIIT 5BS,A00,896416,Carnelos; Chiara,20,0,20,0
1746560495663,LIIT 5CS,A00,896564,Carnelos; Chiara,20,0,20,0
1746560496687,LISP 5A,A00,896588,Munoz Sanchez; Alicia,3,0,20,17
1746560497711,LISP 5B,A00,896653,Munoz Sanchez; Alicia,7,0,20,13
1746560498736,LISP 5C,A00,896655,Munoz Sanchez; Alicia,0,1,20,20
1746560499762,MAE 197,001,957918,Kleissl; Jan,9996,0,9999,3
1746560499762,MAE 197,002,959806,Boechler; Nicholas Sebastia,9998,0,9999,1
1746560499762,MAE 197,003,959852,Mullin; Jennifer S,9998,0,9999,1
1746560500788,MATH 2,A01,957937,Staff,33,0,35,2
1746560501816,MATH 197,001,957876,Kedlaya; Kiran S.,9993,0,9999,6
1746560502841,MCWP 40,A00,892729,Duru; Nur,10,0,20,10
1746560502841,MCWP 40,B00,893304,Montejo; Carolina,14,0,20,6
1746560503870,MCWP 40R,A00,893757,Redela; Pamela Morgan,0,5,20,20
1746560504896,MCWP 50,A00,893758,Morshed; Michael James,0,0,20,20
1746560504896,MCWP 50,B00,893761,Bartulis; Jason Michael,17,0,20,3
1746560505925,MCWP 50R,A00,893766,Compas; Sean Matthew,0,1,20,20
1746560505925,MCWP 50R,B00,893769,Carter; Jennifer A,0,1,20,20
1746560505925,MCWP 50R,C00,893771,Krone; Jarret,0,3,20,20
1746560505925,MCWP 50R,D00,893772,Miller; Elizabeth Deen,0,0,20,20
1746560505925,MCWP 50R,E00,893775,Carter; Andrea L,0,1,20,20
1746560506954,MMW 11R,A01,892721,Herbst; Matthew,11,0,27,16
1746560506954,MMW 11R,A02,892722,Herbst; Matthew,0,0,0,3
1746560507981,MMW 12R,A01,892724,Herbst; Matthew,0,11,16,16
1746560507981,MMW 12R,A02,892725,Herbst; Matthew,0,10,16,16
1746560509006,MMW 13R,A01,892727,Staff,0,4,16,16
1746560509006,MMW 13R,A02,892728,Staff,0,4,16,16
1746560509006,MMW 13R,A03,958032,Staff,0,4,16,16
1746560509006,MMW 13R,A04,958033,Staff,0,4,16,16
1746560509006,MMW 13R,A05,958034,Staff,0,4,16,16
1746560510033,SIO 295LS,A00,894015,Staff,5,0,25,20
1746560511057,SIO 295S,A00,894020,Staff,5,0,25,20
1746560512083,SIOC 290S,B01,958918,Merrifield; Mark A,14,0,30,16
1746560513113,SIOC 291S,B01,958922,Gabriel; Corey John,14,0,30,16
1746560514137,SOCI 117,A01,895339,Staff,3,0,5,2
1746560515167,WES 237B,A00,894149,Staff,11,0,20,9
1746560517227,AESE 279B,A00,891859,Staff,13,0,35,22
1746560518251,AIP 197,001,891854,Vespa; Emanuel Ignacio,9999,0,9999,0
1746560519275,ANTH 289S,A00,891856,Gagneux; Pascal,12,0,12,0
1746560520300,BENG 196,001,957946,Engler; Adam J.,9996,0,9999,3
1746560521324,BISP 197,001,959851,Wilhelm; James E.,9998,0,9999,1
1746560522353,CAT 124RS,A01,956906,Staff,6,0,25,19
1746560523379,CAT 125RS,A01,922013,Staff,6,0,25,19
1746560524402,CLRE 250,A00,891860,Morris; Sheldon,9995,0,9999,4
1746560526460,CLRE 251R,A00,907817,Mehta; Ravindra L.,9994,0,9999,5
1746560527484,CLRE 252,A00,891864,Cuomo; Raphael Eduardo,9993,0,9999,6
1746560528514,CLRE 253,A00,891867,Vaida; Florin,9994,0,9999,5
1746560528514,CLRE 253,B00,907819,Staff,9999,0,9999,0
1746560529540,CLRE 259,A00,891868,Patel; Hemal,9998,0,9999,1
1746560530567,CLRE 260,A00,891872,Cuomo; Raphael Eduardo,9999,0,9999,0
1746560531594,CLRE 297,001,891888,Cuomo; Raphael Eduardo,9999,0,9999,0
1746560532621,CSE 191,A00,958773,Minnes Kemp; Mor Mia,9995,0,9999,4
1746560533645,CSE 197,001,959846,Minnes Kemp; Mor Mia,9990,0,9999,9
1746560534670,CSS 201S,A01,892054,Mignozzetti; Umberto,26,0,30,4
1746560535699,CSS 202S,A01,892056,Mignozzetti; Umberto,26,0,30,4
1746560536729,DSC 197,001,956898,Eldridge; Justin Matthew,9997,0,9999,2
1746560537755,DSC 297,001,958000,Mazumdar; Arya,9998,0,9999,1
1746560537755,DSC 297,002,959862,Wang; Yusu,9998,0,9999,1
1746560538782,EAP 100,A00,905686,Staff,9778,0,9999,221
1746560539807,ECE 45,A01,892618,Staff,0,0,65,65
1746560541862,ECE 111,A01,892719,Staff,4,0,65,61
1746560542887,ECE 197,001,957920,Mercier; Patrick Philip,9991,0,9999,8
1746560543915,ECON 178,A01,907814,Zhu; Ying,26,0,35,9
1746560544940,EDS 115,A00,895312,Staff,35,0,45,10
1746560545972,EDS 117,A01,895337,Staff,23,0,30,7
1746560546995,EDS 125,A00,895341,Jones; Gabrielle Anastasia,36,0,45,9
1746560548019,EDS 128A,A01,895459,Fargason; Sharon Gayle,44,0,45,1
1746560549049,EDS 128B,A01,895543,Pappas; Elizabeth,44,0,45,1
1746560550072,EDS 139,A00,897203,Pappas; Elizabeth,44,0,45,1
1746560550072,EDS 139,B00,897209,Fargason; Sharon Gayle,41,0,45,4
1746560551100,EDS 201,A00,895545,Staff,22,0,45,23
1746560552124,EDS 203,A01,895581,Halter; Christopher P.,22,0,45,23
1746560553152,EDS 204R,A01,895625,Heinzman; Erica M.,39,0,45,6
1746560553152,EDS 204R,B01,895693,Halter; Christopher P.,10,0,45,35
1746560554178,EDS 206R,A00,895694,Fargason; Sharon Gayle,1,0,30,29
1746560554178,EDS 206R,B00,895695,Choi; Bailey Miyeon,16,0,30,14
1746560555204,EDS 250,A00,895697,Hemans; Patricia Ann Benitez,22,0,45,23
1746560556230,EDS 281,A00,895701,Meyerott; Theresa Ann,1,0,15,14
1746560557254,EDS 284,A00,895736,Meyerott; Theresa Ann,1,0,15,14
1746560558282,EDS 286,A00,897210,Fine; Sarah,0,0,15,15
1746560559307,EDS 289C,A01,895770,Daly; Alan J.,1,0,15,14
1746560560334,EDS 290,A00,897211,Hofstetter; Carolyn,0,0,15,15
1746560561361,LIGM 5A,A00,896162,Fischer-Grunski; Eva K,12,0,20,8
1746560562398,LIGM 5B,A00,896260,Fischer-Grunski; Eva K,17,0,20,3
1746560563422,LIGM 5C,A00,896308,Fischer-Grunski; Eva K,18,0,20,2
1746560564447,LIIT 5AS,A00,896313,Carnelos; Chiara,18,0,20,2
1746560565471,LIIT 5BS,A00,896416,Carnelos; Chiara,20,0,20,0
1746560566497,LIIT 5CS,A00,896564,Carnelos; Chiara,20,0,20,0
1746560567525,LISP 5A,A00,896588,Munoz Sanchez; Alicia,3,0,20,17
1746560568550,LISP 5B,A00,896653,Munoz Sanchez; Alicia,7,0,20,13
1746560569575,LISP 5C,A00,896655,Munoz Sanchez; Alicia,0,1,20,20
1746560570602,MAE 197,001,957918,Kleissl; Jan,9996,0,9999,3
1746560570602,MAE 197,002,959806,Boechler; Nicholas Sebastia,9998,0,9999,1
1746560570602,MAE 197,003,959852,Mullin; Jennifer S,9998,0,9999,1
1746560571633,MATH 2,A01,957937,Staff,33,0,35,2
1746560572657,MATH 197,001,957876,Kedlaya; Kiran S.,9993,0,9999,6
1746560573685,MCWP 40,A00,892729,Duru; Nur,10,0,20,10
1746560573685,MCWP 40,B00,893304,Montejo; Carolina,14,0,20,6
1746560574710,MCWP 40R,A00,893757,Redela; Pamela Morgan,0,5,20,20
1746560575736,MCWP 50,A00,893758,Morshed; Michael James,0,0,20,20
1746560575736,MCWP 50,B00,893761,Bartulis; Jason Michael,17,0,20,3
1746560576761,MCWP 50R,A00,893766,Compas; Sean Matthew,0,1,20,20
1746560576761,MCWP 50R,B00,893769,Carter; Jennifer A,0,1,20,20
1746560576761,MCWP 50R,C00,893771,Krone; Jarret,0,3,20,20
1746560576761,MCWP 50R,D00,893772,Miller; Elizabeth Deen,0,0,20,20
1746560576761,MCWP 50R,E00,893775,Carter; Andrea L,0,1,20,20
1746560577787,MMW 11R,A01,892721,Herbst; Matthew,11,0,27,16
1746560577787,MMW 11R,A02,892722,Herbst; Matthew,0,0,0,3
1746560578814,MMW 12R,A01,892724,Herbst; Matthew,0,11,16,16
1746560578814,MMW 12R,A02,892725,Herbst; Matthew,0,10,16,16
1746560579842,MMW 13R,A01,892727,Staff,0,4,16,16
1746560579842,MMW 13R,A02,892728,Staff,0,4,16,16
1746560579842,MMW 13R,A03,958032,Staff,0,4,16,16
1746560579842,MMW 13R,A04,958033,Staff,0,4,16,16
1746560579842,MMW 13R,A05,958034,Staff,0,4,16,16
1746560580868,SIO 295LS,A00,894015,Staff,5,0,25,20
1746560581893,SIO 295S,A00,894020,Staff,5,0,25,20
1746560582924,SIOC 290S,B01,958918,Merrifield; Mark A,14,0,30,16
1746560583955,SIOC 291S,B01,958922,Gabriel; Corey John,14,0,30,16
1746560584986,SOCI 117,A01,895339,Staff,3,0,5,2
1746560586014,WES 237B,A00,894149,Staff,11,0,20,9
1746560588075,AESE 279B,A00,891859,Staff,13,0,35,22
1746560589100,AIP 197,001,891854,Vespa; Emanuel Ignacio,9999,0,9999,0
1746560590126,ANTH 289S,A00,891856,Gagneux; Pascal,12,0,12,0
1746560591151,BENG 196,001,957946,Engler; Adam J.,9996,0,9999,3
1746560592177,BISP 197,001,959851,Wilhelm; James E.,9998,0,9999,1
1746560593203,CAT 124RS,A01,956906,Staff,6,0,25,19
1746560594227,CAT 125RS,A01,922013,Staff,6,0,25,19
1746560595252,CLRE 250,A00,891860,Morris; Sheldon,9995,0,9999,4
1746560597305,CLRE 251R,A00,907817,Mehta; Ravindra L.,9994,0,9999,5
1746560598334,CLRE 252,A00,891864,Cuomo; Raphael Eduardo,9993,0,9999,6
1746560599362,CLRE 253,A00,891867,Vaida; Florin,9994,0,9999,5
1746560599362,CLRE 253,B00,907819,Staff,9999,0,9999,0
1746560600387,CLRE 259,A00,891868,Patel; Hemal,9998,0,9999,1
1746560601413,CLRE 260,A00,891872,Cuomo; Raphael Eduardo,9999,0,9999,0
1746560602438,CLRE 297,001,891888,Cuomo; Raphael Eduardo,9999,0,9999,0
1746560603467,CSE 191,A00,958773,Minnes Kemp; Mor Mia,9995,0,9999,4
1746560604492,CSE 197,001,959846,Minnes Kemp; Mor Mia,9990,0,9999,9
1746560605522,CSS 201S,A01,892054,Mignozzetti; Umberto,26,0,30,4
1746560606551,CSS 202S,A01,892056,Mignozzetti; Umberto,26,0,30,4
1746560607579,DSC 197,001,956898,Eldridge; Justin Matthew,9997,0,9999,2
1746560608607,DSC 297,001,958000,Mazumdar; Arya,9998,0,9999,1
1746560608607,DSC 297,002,959862,Wang; Yusu,9998,0,9999,1
1746560609635,EAP 100,A00,905686,Staff,9778,0,9999,221
1746560610661,ECE 45,A01,892618,Staff,0,0,65,65
1746560612710,ECE 111,A01,892719,Staff,4,0,65,61
1746560613736,ECE 197,001,957920,Mercier; Patrick Philip,9991,0,9999,8
1746560614767,ECON 178,A01,907814,Zhu; Ying,26,0,35,9
1746560615792,EDS 115,A00,895312,Staff,35,0,45,10
1746560616819,EDS 117,A01,895337,Staff,23,0,30,7
1746560617846,EDS 125,A00,895341,Jones; Gabrielle Anastasia,36,0,45,9
1746560618875,EDS 128A,A01,895459,Fargason; Sharon Gayle,44,0,45,1
1746560619900,EDS 128B,A01,895543,Pappas; Elizabeth,44,0,45,1
1746560620930,EDS 139,A00,897203,Pappas; Elizabeth,44,0,45,1
1746560620930,EDS 139,B00,897209,Fargason; Sharon Gayle,41,0,45,4
1746560621955,EDS 201,A00,895545,Staff,22,0,45,23
1746560622981,EDS 203,A01,895581,Halter; Christopher P.,22,0,45,23
1746560624011,EDS 204R,A01,895625,Heinzman; Erica M.,39,0,45,6
1746560624011,EDS 204R,B01,895693,Halter; Christopher P.,10,0,45,35
1746560625040,EDS 206R,A00,895694,Fargason; Sharon Gayle,1,0,30,29
1746560625040,EDS 206R,B00,895695,Choi; Bailey Miyeon,16,0,30,14
1746560626065,EDS 250,A00,895697,Hemans; Patricia Ann Benitez,22,0,45,23
1746560627090,EDS 281,A00,895701,Meyerott; Theresa Ann,1,0,15,14
1746560628113,EDS 284,A00,895736,Meyerott; Theresa Ann,1,0,15,14
1746560629140,EDS 286,A00,897210,Fine; Sarah,0,0,15,15
1746560630168,EDS 289C,A01,895770,Daly; Alan J.,1,0,15,14
1746560631192,EDS 290,A00,897211,Hofstetter; Carolyn,0,0,15,15
1746560632222,LIGM 5A,A00,896162,Fischer-Grunski; Eva K,12,0,20,8
1746560633251,LIGM 5B,A00,896260,Fischer-Grunski; Eva K,17,0,20,3
1746560634274,LIGM 5C,A00,896308,Fischer-Grunski; Eva K,18,0,20,2
1746560635305,LIIT 5AS,A00,896313,Carnelos; Chiara,18,0,20,2
1746560636332,LIIT 5BS,A00,896416,Carnelos; Chiara,20,0,20,0
1746560637359,LIIT 5CS,A00,896564,Carnelos; Chiara,20,0,20,0
1746560638387,LISP 5A,A00,896588,Munoz Sanchez; Alicia,3,0,20,17
1746560639411,LISP 5B,A00,896653,Munoz Sanchez; Alicia,7,0,20,13
1746560640437,LISP 5C,A00,896655,Munoz Sanchez; Alicia,0,1,20,20
1746560641467,MAE 197,001,957918,Kleissl; Jan,9996,0,9999,3
1746560641467,MAE 197,002,959806,Boechler; Nicholas Sebastia,9998,0,9999,1
1746560641467,MAE 197,003,959852,Mullin; Jennifer S,9998,0,9999,1
1746560642491,MATH 2,A01,957937,Staff,33,0,35,2
1746560643515,MATH 197,001,957876,Kedlaya; Kiran S.,9993,0,9999,6
1746560644540,MCWP 40,A00,892729,Duru; Nur,10,0,20,10
1746560644540,MCWP 40,B00,893304,Montejo; Carolina,14,0,20,6
1746560645565,MCWP 40R,A00,893757,Redela; Pamela Morgan,0,5,20,20
1746560646595,MCWP 50,A00,893758,Morshed; Michael James,0,0,20,20
1746560646595,MCWP 50,B00,893761,Bartulis; Jason Michael,17,0,20,3
1746560647621,MCWP 50R,A00,893766,Compas; Sean Matthew,0,1,20,20
1746560647621,MCWP 50R,B00,893769,Carter; Jennifer A,0,1,20,20
1746560647621,MCWP 50R,C00,893771,Krone; Jarret,0,3,20,20
1746560647621,MCWP 50R,D00,893772,Miller; Elizabeth Deen,0,0,20,20
1746560647621,MCWP 50R,E00,893775,Carter; Andrea L,0,1,20,20
1746560648651,MMW 11R,A01,892721,Herbst; Matthew,11,0,27,16
1746560648651,MMW 11R,A02,892722,Herbst; Matthew,0,0,0,3
1746560649680,MMW 12R,A01,892724,Herbst; Matthew,0,11,16,16
1746560649680,MMW 12R,A02,892725,Herbst; Matthew,0,10,16,16
1746560650706,MMW 13R,A01,892727,Staff,0,4,16,16
1746560650706,MMW 13R,A02,892728,Staff,0,4,16,16
1746560650706,MMW 13R,A03,958032,Staff,0,4,16,16
1746560650706,MMW 13R,A04,958033,Staff,0,4,16,16
1746560650706,MMW 13R,A05,958034,Staff,0,4,16,16
1746560651732,SIO 295LS,A00,894015,Staff,5,0,25,20
1746560652760,SIO 295S,A00,894020,Staff,5,0,25,20
1746560653788,SIOC 290S,B01,958918,Merrifield; Mark A,14,0,30,16
1746560654814,SIOC 291S,B01,958922,Gabriel; Corey John,14,0,30,16
1746560655839,SOCI 117,A01,895339,Staff,3,0,5,2
1746560656864,WES 237B,A00,894149,Staff,11,0,20,9
1746560658921,AESE 279B,A00,891859,Staff,13,0,35,22
1746560659948,AIP 197,001,891854,Vespa; Emanuel Ignacio,9999,0,9999,0
1746560660979,ANTH 289S,A00,891856,Gagneux; Pascal,12,0,12,0
1746560662007,BENG 196,001,957946,Engler; Adam J.,9996,0,9999,3
1746560663034,BISP 197,001,959851,Wilhelm; James E.,9998,0,9999,1
1746560664059,CAT 124RS,A01,956906,Staff,6,0,25,19
1746560665085,CAT 125RS,A01,922013,Staff,6,0,25,19
1746560666110,CLRE 250,A00,891860,Morris; Sheldon,9995,0,9999,4
1746560668161,CLRE 251R,A00,907817,Mehta; Ravindra L.,9994,0,9999,5
1746560669189,CLRE 252,A00,891864,Cuomo; Raphael Eduardo,9993,0,9999,6
1746560670215,CLRE 253,A00,891867,Vaida; Florin,9994,0,9999,5
1746560670215,CLRE 253,B00,907819,Staff,9999,0,9999,0
1746560671241,CLRE 259,A00,891868,Patel; Hemal,9998,0,9999,1
1746560672267,CLRE 260,A00,891872,Cuomo; Raphael Eduardo,9999,0,9999,0
1746560673295,CLRE 297,001,891888,Cuomo; Raphael Eduardo,9999,0,9999,0
1746560674320,CSE 191,A00,958773,Minnes Kemp; Mor Mia,9995,0,9999,4
1746560675345,CSE 197,001,959846,Minnes Kemp; Mor Mia,9990,0,9999,9
1746560676371,CSS 201S,A01,892054,Mignozzetti; Umberto,26,0,30,4
1746560677400,CSS 202S,A01,892056,Mignozzetti; Umberto,26,0,30,4
1746560678429,DSC 197,001,956898,Eldridge; Justin Matthew,9997,0,9999,2
1746560679454,DSC 297,001,958000,Mazumdar; Arya,9998,0,9999,1
1746560679454,DSC 297,002,959862,Wang; Yusu,9998,0,9999,1
1746560680482,EAP 100,A00,905686,Staff,9778,0,9999,221
1746560681513,ECE 45,A01,892618,Staff,0,0,65,65
1746560683562,ECE 111,A01,892719,Staff,4,0,65,61
1746560684590,ECE 197,001,957920,Mercier; Patrick Philip,9991,0,9999,8
1746560685617,ECON 178,A01,907814,Zhu; Ying,26,0,35,9
1746560686644,EDS 115,A00,895312,Staff,35,0,45,10
1746560687669,EDS 117,A01,895337,Staff,23,0,30,7
1746560688692,EDS 125,A00,895341,Jones; Gabrielle Anastasia,36,0,45,9
1746560689718,EDS 128A,A01,895459,Fargason; Sharon Gayle,44,0,45,1
1746560690744,EDS 128B,A01,895543,Pappas; Elizabeth,44,0,45,1
1746560691768,EDS 139,A00,897203,Pappas; Elizabeth,44,0,45,1
1746560691768,EDS 139,B00,897209,Fargason; Sharon Gayle,41,0,45,4
1746560692792,EDS 201,A00,895545,Staff,22,0,45,23
1746560693822,EDS 203,A01,895581,Halter; Christopher P.,22,0,45,23
1746560694848,EDS 204R,A01,895625,Heinzman; Erica M.,39,0,45,6
1746560694848,EDS 204R,B01,895693,Halter; Christopher P.,10,0,45,35
1746560695877,EDS 206R,A00,895694,Fargason; Sharon Gayle,1,0,30,29
1746560695877,EDS 206R,B00,895695,Choi; Bailey Miyeon,16,0,30,14
1746560696903,EDS 250,A00,895697,Hemans; Patricia Ann Benitez,22,0,45,23
1746560697930,EDS 281,A00,895701,Meyerott; Theresa Ann,1,0,15,14
1746560698958,EDS 284,A00,895736,Meyerott; Theresa Ann,1,0,15,14
1746560700025,EDS 286,A00,897210,Fine; Sarah,0,0,15,15
1746560701054,EDS 289C,A01,895770,Daly; Alan J.,1,0,15,14
1746560702091,EDS 290,A00,897211,Hofstetter; Carolyn,0,0,15,15
1746560703121,LIGM 5A,A00,896162,Fischer-Grunski; Eva K,12,0,20,8
1746560704149,LIGM 5B,A00,896260,Fischer-Grunski; Eva K,17,0,20,3
1746560705173,LIGM 5C,A00,896308,Fischer-Grunski; Eva K,18,0,20,2
1746560706197,LIIT 5AS,A00,896313,Carnelos; Chiara,18,0,20,2
1746560707224,LIIT 5BS,A00,896416,Carnelos; Chiara,20,0,20,0
1746560708247,LIIT 5CS,A00,896564,Carnelos; Chiara,20,0,20,0
1746560709272,LISP 5A,A00,896588,Munoz Sanchez; Alicia,3,0,20,17
1746560710299,LISP 5B,A00,896653,Munoz Sanchez; Alicia,7,0,20,13
1746560711323,LISP 5C,A00,896655,Munoz Sanchez; Alicia,0,1,20,20
1746560712351,MAE 197,001,957918,Kleissl; Jan,9996,0,9999,3
1746560712351,MAE 197,002,959806,Boechler; Nicholas Sebastia,9998,0,9999,1
1746560712351,MAE 197,003,959852,Mullin; Jennifer S,9998,0,9999,1
1746560713377,MATH 2,A01,957937,Staff,33,0,35,2
1746560714403,MATH 197,001,957876,Kedlaya; Kiran S.,9993,0,9999,6
1746560715428,MCWP 40,A00,892729,Duru; Nur,10,0,20,10
1746560715428,MCWP 40,B00,893304,Montejo; Carolina,14,0,20,6
1746560716454,MCWP 40R,A00,893757,Redela; Pamela Morgan,0,5,20,20
1746560717480,MCWP 50,A00,893758,Morshed; Michael James,0,0,20,20
1746560717480,MCWP 50,B00,893761,Bartulis; Jason Michael,17,0,20,3
1746560718506,MCWP 50R,A00,893766,Compas; Sean Matthew,0,1,20,20
1746560718506,MCWP 50R,B00,893769,Carter; Jennifer A,0,1,20,20
1746560718506,MCWP 50R,C00,893771,Krone; Jarret,0,3,20,20
1746560718506,MCWP 50R,D00,893772,Miller; Elizabeth Deen,0,0,20,20
1746560718506,MCWP 50R,E00,893775,Carter; Andrea L,0,1,20,20
1746560719532,MMW 11R,A01,892721,Herbst; Matthew,11,0,27,16
1746560719532,MMW 11R,A02,892722,Herbst; Matthew,0,0,0,3
1746560720557,MMW 12R,A01,892724,Herbst; Matthew,0,11,16,16
1746560720557,MMW 12R,A02,892725,Herbst; Matthew,0,10,16,16
1746560721582,MMW 13R,A01,892727,Staff,0,4,16,16
1746560721582,MMW 13R,A02,892728,Staff,0,4,16,16
1746560721582,MMW 13R,A03,958032,Staff,0,4,16,16
1746560721582,MMW 13R,A04,958033,Staff,0,4,16,16
1746560721582,MMW 13R,A05,958034,Staff,0,4,16,16
1746560722609,SIO 295LS,A00,894015,Staff,5,0,25,20
1746560723635,SIO 295S,A00,894020,Staff,5,0,25,20
1746560724663,SIOC 290S,B01,958918,Merrifield; Mark A,14,0,30,16
1746560725689,SIOC 291S,B01,958922,Gabriel; Corey John,14,0,30,16
1746560726713,SOCI 117,A01,895339,Staff,3,0,5,2
1746560727738,WES 237B,A00,894149,Staff,11,0,20,9
1746560729793,AESE 279B,A00,891859,Staff,13,0,35,22
1746560730824,AIP 197,001,891854,Vespa; Emanuel Ignacio,9999,0,9999,0
1746560731851,ANTH 289S,A00,891856,Gagneux; Pascal,12,0,12,0
1746560732876,BENG 196,001,957946,Engler; Adam J.,9996,0,9999,3
1746560733900,BISP 197,001,959851,Wilhelm; James E.,9998,0,9999,1
1746560734928,CAT 124RS,A01,956906,Staff,6,0,25,19
1746560735954,CAT 125RS,A01,922013,Staff,6,0,25,19
1746560736986,CLRE 250,A00,891860,Morris; Sheldon,9995,0,9999,4
1746560739034,CLRE 251R,A00,907817,Mehta; Ravindra L.,9994,0,9999,5
1746560740059,CLRE 252,A00,891864,Cuomo; Raphael Eduardo,9993,0,9999,6
1746560741088,CLRE 253,A00,891867,Vaida; Florin,9994,0,9999,5
1746560741088,CLRE 253,B00,907819,Staff,9999,0,9999,0
1746560742111,CLRE 259,A00,891868,Patel; Hemal,9998,0,9999,1
1746560743135,CLRE 260,A00,891872,Cuomo; Raphael Eduardo,9999,0,9999,0
1746560744159,CLRE 297,001,891888,Cuomo; Raphael Eduardo,9999,0,9999,0
1746560745186,CSE 191,A00,958773,Minnes Kemp; Mor Mia,9995,0,9999,4
1746560746210,CSE 197,001,959846,Minnes Kemp; Mor Mia,9990,0,9999,9
1746560747241,CSS 201S,A01,892054,Mignozzetti; Umberto,26,0,30,4
1746560748267,CSS 202S,A01,892056,Mignozzetti; Umberto,26,0,30,4
1746560749293,DSC 197,001,956898,Eldridge; Justin Matthew,9997,0,9999,2
1746560750321,DSC 297,001,958000,Mazumdar; Arya,9998,0,9999,1
1746560750321,DSC 297,002,959862,Wang; Yusu,9998,0,9999,1
1746560751345,EAP 100,A00,905686,Staff,9778,0,9999,221
1746560752371,ECE 45,A01,892618,Staff,0,0,65,65
1746560754426,ECE 111,A01,892719,Staff,4,0,65,61
1746560755450,ECE 197,001,957920,Mercier; Patrick Philip,9991,0,9999,8
1746560756478,ECON 178,A01,907814,Zhu; Ying,26,0,35,9
1746560757504,EDS 115,A00,895312,Staff,35,0,45,10
1746560758529,EDS 117,A01,895337,Staff,23,0,30,7
1746560759559,EDS 125,A00,895341,Jones; Gabrielle Anastasia,36,0,45,9
1746560760584,EDS 128A,A01,895459,Fargason; Sharon Gayle,44,0,45,1
1746560761610,EDS 128B,A01,895543,Pappas; Elizabeth,44,0,45,1
1746560762636,EDS 139,A00,897203,Pappas; Elizabeth,44,0,45,1
1746560762636,EDS 139,B00,897209,Fargason; Sharon Gayle,41,0,45,4
1746560763662,EDS 201,A00,895545,Staff,22,0,45,23
1746560764690,EDS 203,A01,895581,Halter; Christopher P.,22,0,45,23
1746560765719,EDS 204R,A01,895625,Heinzman; Erica M.,39,0,45,6
1746560765719,EDS 204R,B01,895693,Halter; Christopher P.,10,0,45,35
1746560766743,EDS 206R,A00,895694,Fargason; Sharon Gayle,1,0,30,29
1746560766743,EDS 206R,B00,895695,Choi; Bailey Miyeon,16,0,30,14
1746560767770,EDS 250,A00,895697,Hemans; Patricia Ann Benitez,22,0,45,23
1746560768799,EDS 281,A00,895701,Meyerott; Theresa Ann,1,0,15,14
1746560769827,EDS 284,A00,895736,Meyerott; Theresa Ann,1,0,15,14
1746560770853,EDS 286,A00,897210,Fine; Sarah,0,0,15,15
1746560771881,EDS 289C,A01,895770,Daly; Alan J.,1,0,15,14
1746560772907,EDS 290,A00,897211,Hofstetter; Carolyn,0,0,15,15
1746560773932,LIGM 5A,A00,896162,Fischer-Grunski; Eva K,12,0,20,8
1746560774957,LIGM 5B,A00,896260,Fischer-Grunski; Eva K,17,0,20,3
1746560775983,LIGM 5C,A00,896308,Fischer-Grunski; Eva K,18,0,20,2
1746560777010,LIIT 5AS,A00,896313,Carnelos; Chiara,18,0,20,2
1746560778034,LIIT 5BS,A00,896416,Carnelos; Chiara,20,0,20,0
1746560779063,LIIT 5CS,A00,896564,Carnelos; Chiara,20,0,20,0
1746560780089,LISP 5A,A00,896588,Munoz Sanchez; Alicia,3,0,20,17
1746560781113,LISP 5B,A00,896653,Munoz Sanchez; Alicia,7,0,20,13
1746560782141,LISP 5C,A00,896655,Munoz Sanchez; Alicia,0,1,20,20
1746560783166,MAE 197,001,957918,Kleissl; Jan,9996,0,9999,3
1746560783166,MAE 197,002,959806,Boechler; Nicholas Sebastia,9998,0,9999,1
1746560783166,MAE 197,003,959852,Mullin; Jennifer S,9998,0,9999,1
1746560784192,MATH 2,A01,957937,Staff,33,0,35,2
1746560785221,MATH 197,001,957876,Kedlaya; Kiran S.,9993,0,9999,6
1746560786250,MCWP 40,A00,892729,Duru; Nur,10,0,20,10
1746560786250,MCWP 40,B00,893304,Montejo; Carolina,14,0,20,6
1746560787279,MCWP 40R,A00,893757,Redela; Pamela Morgan,0,5,20,20
1746560788304,MCWP 50,A00,893758,Morshed; Michael James,0,0,20,20
1746560788304,MCWP 50,B00,893761,Bartulis; Jason Michael,17,0,20,3
1746560789328,MCWP 50R,A00,893766,Compas; Sean Matthew,0,1,20,20
1746560789328,MCWP 50R,B00,893769,Carter; Jennifer A,0,1,20,20
1746560789328,MCWP 50R,C00,893771,Krone; Jarret,0,3,20,20
1746560789328,MCWP 50R,D00,893772,Miller; Elizabeth Deen,0,0,20,20
1746560789328,MCWP 50R,E00,893775,Carter; Andrea L,0,1,20,20
1746560790356,MMW 11R,A01,892721,Herbst; Matthew,11,0,27,16
1746560790356,MMW 11R,A02,892722,Herbst; Matthew,0,0,0,3
1746560791382,MMW 12R,A01,892724,Herbst; Matthew,0,11,16,16
1746560791382,MMW 12R,A02,892725,Herbst; Matthew,0,10,16,16
1746560792424,MMW 13R,A01,892727,Staff,0,4,16,16
1746560792424,MMW 13R,A02,892728,Staff,0,4,16,16
1746560792424,MMW 13R,A03,958032,Staff,0,4,16,16
1746560792424,MMW 13R,A04,958033,Staff,0,4,16,16
1746560792424,MMW 13R,A05,958034,Staff,0,4,16,16
1746560793451,SIO 295LS,A00,894015,Staff,5,0,25,20
1746560794479,SIO 295S,A00,894020,Staff,5,0,25,20
1746560795505,SIOC 290S,B01,958918,Merrifield; Mark A,14,0,30,16
1746560796535,SIOC 291S,B01,958922,Gabriel; Corey John,14,0,30,16
1746560797563,SOCI 117,A01,895339,Staff,3,0,5,2
1746560798589,WES 237B,A00,894149,Staff,11,0,20,9
1746560800647,AESE 279B,A00,891859,Staff,13,0,35,22
1746560801676,AIP 197,001,891854,Vespa; Emanuel Ignacio,9999,0,9999,0
1746560802705,ANTH 289S,A00,891856,Gagneux; Pascal,12,0,12,0
1746560803733,BENG 196,001,957946,Engler; Adam J.,9996,0,9999,3
1746560804760,BISP 197,001,959851,Wilhelm; James E.,9998,0,9999,1
1746560805787,CAT 124RS,A01,956906,Staff,6,0,25,19
1746560806811,CAT 125RS,A01,922013,Staff,6,0,25,19
1746560807839,CLRE 250,A00,891860,Morris; Sheldon,9995,0,9999,4
1746560809892,CLRE 251R,A00,907817,Mehta; Ravindra L.,9994,0,9999,5
1746560810919,CLRE 252,A00,891864,Cuomo; Raphael Eduardo,9993,0,9999,6
1746560811943,CLRE 253,A00,891867,Vaida; Florin,9994,0,9999,5
1746560811943,CLRE 253,B00,907819,Staff,9999,0,9999,0
1746560812971,CLRE 259,A00,891868,Patel; Hemal,9998,0,9999,1
1746560813994,CLRE 260,A00,891872,Cuomo; Raphael Eduardo,9999,0,9999,0
1746560815019,CLRE 297,001,891888,Cuomo; Raphael Eduardo,9999,0,9999,0
1746560816045,CSE 191,A00,958773,Minnes Kemp; Mor Mia,9995,0,9999,4
1746560817072,CSE 197,001,959846,Minnes Kemp; Mor Mia,9990,0,9999,9
1746560818100,CSS 201S,A01,892054,Mignozzetti; Umberto,26,0,30,4
1746560819133,CSS 202S,A01,892056,Mignozzetti; Umberto,26,0,30,4
1746560820160,DSC 197,001,956898,Eldridge; Justin Matthew,9997,0,9999,2
1746560821187,DSC 297,001,958000,Mazumdar; Arya,9998,0,9999,1
1746560821187,DSC 297,002,959862,Wang; Yusu,9998,0,9999,1
1746560822213,EAP 100,A00,905686,Staff,9778,0,9999,221
1746560823239,ECE 45,A01,892618,Staff,0,0,65,65
1746560825289,ECE 111,A01,892719,Staff,4,0,65,61
1746560826313,ECE 197,001,957920,Mercier; Patrick Philip,9991,0,9999,8
1746560827339,ECON 178,A01,907814,Zhu; Ying,26,0,35,9
1746560828363,EDS 115,A00,895312,Staff,35,0,45,10
1746560829392,EDS 117,A01,895337,Staff,23,0,30,7
1746560830419,EDS 125,A00,895341,Jones; Gabrielle Anastasia,36,0,45,9
1746560831448,EDS 128A,A01,895459,Fargason; Sharon Gayle,44,0,45,1
1746560832473,EDS 128B,A01,895543,Pappas; Elizabeth,44,0,45,1
1746560833499,EDS 139,A00,897203,Pappas; Elizabeth,44,0,45,1
1746560833499,EDS 139,B00,897209,Fargason; Sharon Gayle,41,0,45,4
1746560834526,EDS 201,A00,895545,Staff,22,0,45,23
1746560835551,EDS 203,A01,895581,Halter; Christopher P.,22,0,45,23
1746560836578,EDS 204R,A01,895625,Heinzman; Erica M.,39,0,45,6
1746560836578,EDS 204R,B01,895693,Halter; Christopher P.,10,0,45,35
1746560837604,EDS 206R,A00,895694,Fargason; Sharon Gayle,1,0,30,29
1746560837604,EDS 206R,B00,895695,Choi; Bailey Miyeon,16,0,30,14
1746560838628,EDS 250,A00,895697,Hemans; Patricia Ann Benitez,22,0,45,23
1746560839655,EDS 281,A00,895701,Meyerott; Theresa Ann,1,0,15,14
1746560840682,EDS 284,A00,895736,Meyerott; Theresa Ann,1,0,15,14
1746560841708,EDS 286,A00,897210,Fine; Sarah,0,0,15,15
1746560842735,EDS 289C,A01,895770,Daly; Alan J.,1,0,15,14
1746560843765,EDS 290,A00,897211,Hofstetter; Carolyn,0,0,15,15
1746560844794,LIGM 5A,A00,896162,Fischer-Grunski; Eva K,12,0,20,8
1746560845819,LIGM 5B,A00,896260,Fischer-Grunski; Eva K,17,0,20,3
1746560846843,LIGM 5C,A00,896308,Fischer-Grunski; Eva K,18,0,20,2
1746560847868,LIIT 5AS,A00,896313,Carnelos; Chiara,18,0,20,2
1746560848895,LIIT 5BS,A00,896416,Carnelos; Chiara,20,0,20,0
1746560849921,LIIT 5CS,A00,896564,Carnelos; Chiara,20,0,20,0
1746560850946,LISP 5A,A00,896588,Munoz Sanchez; Alicia,3,0,20,17
1746560851977,LISP 5B,A00,896653,Munoz Sanchez; Alicia,7,0,20,13
1746560853006,LISP 5C,A00,896655,Munoz Sanchez; Alicia,0,1,20,20
1746560854032,MAE 197,001,957918,Kleissl; Jan,9996,0,9999,3
1746560854032,MAE 197,002,959806,Boechler; Nicholas Sebastia,9998,0,9999,1
1746560854032,MAE 197,003,959852,Mullin; Jennifer S,9998,0,9999,1
1746560855058,MATH 2,A01,957937,Staff,33,0,35,2
1746560856086,MATH 197,001,957876,Kedlaya; Kiran S.,9993,0,9999,6
1746560857110,MCWP 40,A00,892729,Duru; Nur,10,0,20,10
1746560857110,MCWP 40,B00,893304,Montejo; Carolina,14,0,20,6
1746560858135,MCWP 40R,A00,893757,Redela; Pamela Morgan,0,5,20,20
1746560859163,MCWP 50,A00,893758,Morshed; Michael James,0,0,20,20
1746560859163,MCWP 50,B00,893761,Bartulis; Jason Michael,17,0,20,3
1746560860187,MCWP 50R,A00,893766,Compas; Sean Matthew,0,1,20,20
1746560860187,MCWP 50R,B00,893769,Carter; Jennifer A,0,1,20,20
1746560860187,MCWP 50R,C00,893771,Krone; Jarret,0,3,20,20
1746560860187,MCWP 50R,D00,893772,Miller; Elizabeth Deen,0,0,20,20
1746560860187,MCWP 50R,E00,893775,Carter; Andrea L,0,1,20,20
1746560861217,MMW 11R,A01,892721,Herbst; Matthew,11,0,27,16
1746560861217,MMW 11R,A02,892722,Herbst; Matthew,0,0,0,3
1746560862245,MMW 12R,A01,892724,Herbst; Matthew,0,11,16,16
1746560862245,MMW 12R,A02,892725,Herbst; Matthew,0,10,16,16
1746560863272,MMW 13R,A01,892727,Staff,0,4,16,16
1746560863272,MMW 13R,A02,892728,Staff,0,4,16,16
1746560863272,MMW 13R,A03,958032,Staff,0,4,16,16
1746560863272,MMW 13R,A04,958033,Staff,0,4,16,16
1746560863272,MMW 13R,A05,958034,Staff,0,4,16,16
1746560864296,SIO 295LS,A00,894015,Staff,5,0,25,20
1746560865326,SIO 295S,A00,894020,Staff,5,0,25,20
1746560866351,SIOC 290S,B01,958918,Merrifield; Mark A,14,0,30,16
1746560867377,SIOC 291S,B01,958922,Gabriel; Corey John,14,0,30,16
1746560868406,SOCI 117,A01,895339,Staff,3,0,5,2
1746560869430,WES 237B,A00,894149,Staff,11,0,20,9
1746560871489,AESE 279B,A00,891859,Staff,13,0,35,22
1746560872515,AIP 197,001,891854,Vespa; Emanuel Ignacio,9999,0,9999,0
1746560873540,ANTH 289S,A00,891856,Gagneux; Pascal,12,0,12,0
1746560874568,BENG 196,001,957946,Engler; Adam J.,9996,0,9999,3
1746560875590,BISP 197,001,959851,Wilhelm; James E.,9998,0,9999,1
1746560876615,CAT 124RS,A01,956906,Staff,6,0,25,19
1746560877642,CAT 125RS,A01,922013,Staff,6,0,25,19
1746560878669,CLRE 250,A00,891860,Morris; Sheldon,9995,0,9999,4
1746560880722,CLRE 251R,A00,907817,Mehta; Ravindra L.,9994,0,9999,5
1746560881747,CLRE 252,A00,891864,Cuomo; Raphael Eduardo,9993,0,9999,6
1746560882774,CLRE 253,A00,891867,Vaida; Florin,9994,0,9999,5
1746560882774,CLRE 253,B00,907819,Staff,9999,0,9999,0
1746560883798,CLRE 259,A00,891868,Patel; Hemal,9998,0,9999,1
1746560884823,CLRE 260,A00,891872,Cuomo; Raphael Eduardo,9999,0,9999,0
1746560885847,CLRE 297,001,891888,Cuomo; Raphael Eduardo,9999,0,9999,0
1746560886875,CSE 191,A00,958773,Minnes Kemp; Mor Mia,9995,0,9999,4
1746560887903,CSE 197,001,959846,Minnes Kemp; Mor Mia,9990,0,9999,9
1746560888930,CSS 201S,A01,892054,Mignozzetti; Umberto,26,0,30,4
1746560889954,CSS 202S,A01,892056,Mignozzetti; Umberto,26,0,30,4
1746560890980,DSC 197,001,956898,Eldridge; Justin Matthew,9997,0,9999,2
1746560892005,DSC 297,001,958000,Mazumdar; Arya,9998,0,9999,1
1746560892005,DSC 297,002,959862,Wang; Yusu,9998,0,9999,1
1746560893032,EAP 100,A00,905686,Staff,9778,0,9999,221
1746560894058,ECE 45,A01,892618,Staff,0,0,65,65
1746560896111,ECE 111,A01,892719,Staff,4,0,65,61
1746560897136,ECE 197,001,957920,Mercier; Patrick Philip,9991,0,9999,8
1746560898166,ECON 178,A01,907814,Zhu; Ying,26,0,35,9
1746560899194,EDS 115,A00,895312,Staff,35,0,45,10
1746560900220,EDS 117,A01,895337,Staff,23,0,30,7
1746560901249,EDS 125,A00,895341,Jones; Gabrielle Anastasia,36,0,45,9
1746560902279,EDS 128A,A01,895459,Fargason; Sharon Gayle,44,0,45,1
1746560903304,EDS 128B,A01,895543,Pappas; Elizabeth,44,0,45,1
1746560904329,EDS 139,A00,897203,Pappas; Elizabeth,44,0,45,1
1746560904329,EDS 139,B00,897209,Fargason; Sharon Gayle,41,0,45,4
1746560905355,EDS 201,A00,895545,Staff,22,0,45,23
1746560906381,EDS 203,A01,895581,Halter; Christopher P.,22,0,45,23
1746560907407,EDS 204R,A01,895625,Heinzman; Erica M.,39,0,45,6
1746560907407,EDS 204R,B01,895693,Halter; Christopher P.,10,0,45,35
1746560908436,EDS 206R,A00,895694,Fargason; Sharon Gayle,1,0,30,29
1746560908436,EDS 206R,B00,895695,Choi; Bailey Miyeon,16,0,30,14
1746560909460,EDS 250,A00,895697,Hemans; Patricia Ann Benitez,22,0,45,23
1746560910489,EDS 281,A00,895701,Meyerott; Theresa Ann,1,0,15,14
1746560911514,EDS 284,A00,895736,Meyerott; Theresa Ann,1,0,15,14
1746560912538,EDS 286,A00,897210,Fine; Sarah,0,0,15,15
1746560913565,EDS 289C,A01,895770,Daly; Alan J.,1,0,15,14
1746560914590,EDS 290,A00,897211,Hofstetter; Carolyn,0,0,15,15
1746560915633,LIGM 5A,A00,896162,Fischer-Grunski; Eva K,12,0,20,8
1746560916660,LIGM 5B,A00,896260,Fischer-Grunski; Eva K,17,0,20,3
1746560917685,LIGM 5C,A00,896308,Fischer-Grunski; Eva K,18,0,20,2
1746560918711,LIIT 5AS,A00,896313,Carnelos; Chiara,18,0,20,2
1746560919744,LIIT 5BS,A00,896416,Carnelos; Chiara,20,0,20,0
1746560920768,LIIT 5CS,A00,896564,Carnelos; Chiara,20,0,20,0
1746560921795,LISP 5A,A00,896588,Munoz Sanchez; Alicia,3,0,20,17
1746560922823,LISP 5B,A00,896653,Munoz Sanchez; Alicia,7,0,20,13
1746560923858,LISP 5C,A00,896655,Munoz Sanchez; Alicia,0,1,20,20
1746560924883,MAE 197,001,957918,Kleissl; Jan,9996,0,9999,3
1746560924883,MAE 197,002,959806,Boechler; Nicholas Sebastia,9998,0,9999,1
1746560924883,MAE 197,003,959852,Mullin; Jennifer S,9998,0,9999,1
1746560925909,MATH 2,A01,957937,Staff,33,0,35,2
1746560926938,MATH 197,001,957876,Kedlaya; Kiran S.,9993,0,9999,6
1746560927966,MCWP 40,A00,892729,Duru; Nur,10,0,20,10
1746560927966,MCWP 40,B00,893304,Montejo; Carolina,14,0,20,6
1746560928991,MCWP 40R,A00,893757,Redela; Pamela Morgan,0,5,20,20
1746560930023,MCWP 50,A00,893758,Morshed; Michael James,0,0,20,20
1746560930023,MCWP 50,B00,893761,Bartulis; Jason Michael,17,0,20,3
1746560931048,MCWP 50R,A00,893766,Compas; Sean Matthew,0,1,20,20
1746560931048,MCWP 50R,B00,893769,Carter; Jennifer A,0,1,20,20
1746560931048,MCWP 50R,C00,893771,Krone; Jarret,0,3,20,20
1746560931048,MCWP 50R,D00,893772,Miller; Elizabeth Deen,0,0,20,20
1746560931048,MCWP 50R,E00,893775,Carter; Andrea L,0,1,20,20
1746560932076,MMW 11R,A01,892721,Herbst; Matthew,11,0,27,16
1746560932076,MMW 11R,A02,892722,Herbst; Matthew,0,0,0,3
1746560933100,MMW 12R,A01,892724,Herbst; Matthew,0,11,16,16
1746560933100,MMW 12R,A02,892725,Herbst; Matthew,0,10,16,16
1746560934124,MMW 13R,A01,892727,Staff,0,4,16,16
1746560934124,MMW 13R,A02,892728,Staff,0,4,16,16
1746560934124,MMW 13R,A03,958032,Staff,0,4,16,16
1746560934124,MMW 13R,A04,958033,Staff,0,4,16,16
1746560934124,MMW 13R,A05,958034,Staff,0,4,16,16
1746560935152,SIO 295LS,A00,894015,Staff,5,0,25,20
1746560936180,SIO 295S,A00,894020,Staff,5,0,25,20
1746560937216,SIOC 290S,B01,958918,Merrifield; Mark A,14,0,30,16
1746560938244,SIOC 291S,B01,958922,Gabriel; Corey John,14,0,30,16
1746560939268,SOCI 117,A01,895339,Staff,3,0,5,2
1746560940292,WES 237B,A00,894149,Staff,11,0,20,9
1746560942353,AESE 279B,A00,891859,Staff,13,0,35,22
1746560943381,AIP 197,001,891854,Vespa; Emanuel Ignacio,9999,0,9999,0
1746560944470,ANTH 289S,A00,891856,Gagneux; Pascal,12,0,12,0
1746560945495,BENG 196,001,957946,Engler; Adam J.,9996,0,9999,3
1746560946521,BISP 197,001,959851,Wilhelm; James E.,9998,0,9999,1
1746560947549,CAT 124RS,A01,956906,Staff,6,0,25,19
1746560948573,CAT 125RS,A01,922013,Staff,6,0,25,19
1746560949601,CLRE 250,A00,891860,Morris; Sheldon,9995,0,9999,4
1746560951650,CLRE 251R,A00,907817,Mehta; Ravindra L.,9994,0,9999,5
1746560952676,CLRE 252,A00,891864,Cuomo; Raphael Eduardo,9993,0,9999,6
1746560953703,CLRE 253,A00,891867,Vaida; Florin,9994,0,9999,5
1746560953703,CLRE 253,B00,907819,Staff,9999,0,9999,0
1746560954732,CLRE 259,A00,891868,Patel; Hemal,9998,0,9999,1
1746560955758,CLRE 260,A00,891872,Cuomo; Raphael Eduardo,9999,0,9999,0
1746560956784,CLRE 297,001,891888,Cuomo; Raphael Eduardo,9999,0,9999,0
1746560957811,CSE 191,A00,958773,Minnes Kemp; Mor Mia,9995,0,9999,4
1746560958838,CSE 197,001,959846,Minnes Kemp; Mor Mia,9990,0,9999,9
1746560959865,CSS 201S,A01,892054,Mignozzetti; Umberto,26,0,30,4
1746560960891,CSS 202S,A01,892056,Mignozzetti; Umberto,26,0,30,4
1746560961921,DSC 197,001,956898,Eldridge; Justin Matthew,9997,0,9999,2
1746560962946,DSC 297,001,958000,Mazumdar; Arya,9998,0,9999,1
1746560962946,DSC 297,002,959862,Wang; Yusu,9998,0,9999,1
1746560963972,EAP 100,A00,905686,Staff,9778,0,9999,221
1746560965001,ECE 45,A01,892618,Staff,0,0,65,65
1746560967058,ECE 111,A01,892719,Staff,4,0,65,61
1746560968082,ECE 197,001,957920,Mercier; Patrick Philip,9991,0,9999,8
1746560969106,ECON 178,A01,907814,Zhu; Ying,26,0,35,9
1746560970132,EDS 115,A00,895312,Staff,35,0,45,10
1746560971167,EDS 117,A01,895337,Staff,23,0,30,7
1746560972216,EDS 125,A00,895341,Jones; Gabrielle Anastasia,36,0,45,9
1746560973242,EDS 128A,A01,895459,Fargason; Sharon Gayle,44,0,45,1
1746560974267,EDS 128B,A01,895543,Pappas; Elizabeth,44,0,45,1
1746560975292,EDS 139,A00,897203,Pappas; Elizabeth,44,0,45,1
1746560975292,EDS 139,B00,897209,Fargason; Sharon Gayle,41,0,45,4
1746560976320,EDS 201,A00,895545,Staff,22,0,45,23
1746560977347,EDS 203,A01,895581,Halter; Christopher P.,22,0,45,23
1746560978371,EDS 204R,A01,895625,Heinzman; Erica M.,39,0,45,6
1746560978371,EDS 204R,B01,895693,Halter; Christopher P.,10,0,45,35
1746560979401,EDS 206R,A00,895694,Fargason; Sharon Gayle,1,0,30,29
1746560979401,EDS 206R,B00,895695,Choi; Bailey Miyeon,16,0,30,14
1746560980429,EDS 250,A00,895697,Hemans; Patricia Ann Benitez,22,0,45,23
1746560981454,EDS 281,A00,895701,Meyerott; Theresa Ann,1,0,15,14
1746560982481,EDS 284,A00,895736,Meyerott; Theresa Ann,1,0,15,14
1746560983508,EDS 286,A00,897210,Fine; Sarah,0,0,15,15
1746560984535,EDS 289C,A01,895770,Daly; Alan J.,1,0,15,14
1746560985560,EDS 290,A00,897211,Hofstetter; Carolyn,0,0,15,15
1746560986587,LIGM 5A,A00,896162,Fischer-Grunski; Eva K,12,0,20,8
1746560987614,LIGM 5B,A00,896260,Fischer-Grunski; Eva K,17,0,20,3
1746560988641,LIGM 5C,A00,896308,Fischer-Grunski; Eva K,18,0,20,2
1746560989666,LIIT 5AS,A00,896313,Carnelos; Chiara,18,0,20,2
1746560990695,LIIT 5BS,A00,896416,Carnelos; Chiara,20,0,20,0
1746560991719,LIIT 5CS,A00,896564,Carnelos; Chiara,20,0,20,0
1746560992746,LISP 5A,A00,896588,Munoz Sanchez; Alicia,3,0,20,17
1746560993776,LISP 5B,A00,896653,Munoz Sanchez; Alicia,7,0,20,13
1746560994800,LISP 5C,A00,896655,Munoz Sanchez; Alicia,0,1,20,20
1746560995825,MAE 197,001,957918,Kleissl; Jan,9996,0,9999,3
1746560995825,MAE 197,002,959806,Boechler; Nicholas Sebastia,9998,0,9999,1
1746560995825,MAE 197,003,959852,Mullin; Jennifer S,9998,0,9999,1
1746560996852,MATH 2,A01,957937,Staff,33,0,35,2
1746560997879,MATH 197,001,957876,Kedlaya; Kiran S.,9993,0,9999,6
1746560998903,MCWP 40,A00,892729,Duru; Nur,10,0,20,10
1746560998903,MCWP 40,B00,893304,Montejo; Carolina,14,0,20,6
1746560999928,MCWP 40R,A00,893757,Redela; Pamela Morgan,0,5,20,20
1746561000954,MCWP 50,A00,893758,Morshed; Michael James,0,0,20,20
1746561000954,MCWP 50,B00,893761,Bartulis; Jason Michael,17,0,20,3
1746561001980,MCWP 50R,A00,893766,Compas; Sean Matthew,0,1,20,20
1746561001980,MCWP 50R,B00,893769,Carter; Jennifer A,0,1,20,20
1746561001980,MCWP 50R,C00,893771,Krone; Jarret,0,3,20,20
1746561001980,MCWP 50R,D00,893772,Miller; Elizabeth Deen,0,0,20,20
1746561001980,MCWP 50R,E00,893775,Carter; Andrea L,0,1,20,20
1746561003007,MMW 11R,A01,892721,Herbst; Matthew,11,0,27,16
1746561003007,MMW 11R,A02,892722,Herbst; Matthew,0,0,0,3
1746561004038,MMW 12R,A01,892724,Herbst; Matthew,0,11,16,16
1746561004038,MMW 12R,A02,892725,Herbst; Matthew,0,10,16,16
1746561005067,MMW 13R,A01,892727,Staff,0,4,16,16
1746561005067,MMW 13R,A02,892728,Staff,0,4,16,16
1746561005067,MMW 13R,A03,958032,Staff,0,4,16,16
1746561005067,MMW 13R,A04,958033,Staff,0,4,16,16
1746561005067,MMW 13R,A05,958034,Staff,0,4,16,16
1746561006092,SIO 295LS,A00,894015,Staff,5,0,25,20
1746561007118,SIO 295S,A00,894020,Staff,5,0,25,20
1746561008143,SIOC 290S,B01,958918,Merrifield; Mark A,14,0,30,16
1746561009170,SIOC 291S,B01,958922,Gabriel; Corey John,14,0,30,16
1746561010198,SOCI 117,A01,895339,Staff,3,0,5,2
1746561011223,WES 237B,A00,894149,Staff,11,0,20,9
1746561013284,AESE 279B,A00,891859,Staff,13,0,35,22
1746561014312,AIP 197,001,891854,Vespa; Emanuel Ignacio,9999,0,9999,0
1746561015336,ANTH 289S,A00,891856,Gagneux; Pascal,12,0,12,0
1746561016363,BENG 196,001,957946,Engler; Adam J.,9996,0,9999,3
1746561017388,BISP 197,001,959851,Wilhelm; James E.,9998,0,9999,1
1746561018412,CAT 124RS,A01,956906,Staff,6,0,25,19
1746561019440,CAT 125RS,A01,922013,Staff,6,0,25,19
1746561020467,CLRE 250,A00,891860,Morris; Sheldon,9995,0,9999,4
1746561022522,CLRE 251R,A00,907817,Mehta; Ravindra L.,9994,0,9999,5
1746561023547,CLRE 252,A00,891864,Cuomo; Raphael Eduardo,9993,0,9999,6
1746561024573,CLRE 253,A00,891867,Vaida; Florin,9994,0,9999,5
1746561024573,CLRE 253,B00,907819,Staff,9999,0,9999,0
1746561025599,CLRE 259,A00,891868,Patel; Hemal,9998,0,9999,1
1746561026624,CLRE 260,A00,891872,Cuomo; Raphael Eduardo,9999,0,9999,0
1746561027650,CLRE 297,001,891888,Cuomo; Raphael Eduardo,9999,0,9999,0
1746561028674,CSE 191,A00,958773,Minnes Kemp; Mor Mia,9995,0,9999,4
1746561029698,CSE 197,001,959846,Minnes Kemp; Mor Mia,9990,0,9999,9
1746561030726,CSS 201S,A01,892054,Mignozzetti; Umberto,26,0,30,4
1746561031753,CSS 202S,A01,892056,Mignozzetti; Umberto,26,0,30,4
1746561032777,DSC 197,001,956898,Eldridge; Justin Matthew,9997,0,9999,2
1746561033802,DSC 297,001,958000,Mazumdar; Arya,9998,0,9999,1
1746561033802,DSC 297,002,959862,Wang; Yusu,9998,0,9999,1
1746561034826,EAP 100,A00,905686,Staff,9778,0,9999,221
1746561035855,ECE 45,A01,892618,Staff,0,0,65,65
1746561037904,ECE 111,A01,892719,Staff,4,0,65,61
1746561038931,ECE 197,001,957920,Mercier; Patrick Philip,9991,0,9999,8
1746561039959,ECON 178,A01,907814,Zhu; Ying,26,0,35,9
1746561040984,EDS 115,A00,895312,Staff,35,0,45,10
1746561042012,EDS 117,A01,895337,Staff,23,0,30,7
1746561043036,EDS 125,A00,895341,Jones; Gabrielle Anastasia,36,0,45,9
1746561044062,EDS 128A,A01,895459,Fargason; Sharon Gayle,44,0,45,1
1746561045088,EDS 128B,A01,895543,Pappas; Elizabeth,44,0,45,1
1746561046112,EDS 139,A00,897203,Pappas; Elizabeth,44,0,45,1
1746561046112,EDS 139,B00,897209,Fargason; Sharon Gayle,41,0,45,4
1746561047136,EDS 201,A00,895545,Staff,22,0,45,23
1746561048164,EDS 203,A01,895581,Halter; Christopher P.,22,0,45,23
1746561049190,EDS 204R,A01,895625,Heinzman; Erica M.,39,0,45,6
1746561049190,EDS 204R,B01,895693,Halter; Christopher P.,10,0,45,35
1746561050244,EDS 206R,A00,895694,Fargason; Sharon Gayle,1,0,30,29
1746561050244,EDS 206R,B00,895695,Choi; Bailey Miyeon,16,0,30,14
1746561051268,EDS 250,A00,895697,Hemans; Patricia Ann Benitez,22,0,45,23
1746561052292,EDS 281,A00,895701,Meyerott; Theresa Ann,1,0,15,14
1746561053317,EDS 284,A00,895736,Meyerott; Theresa Ann,1,0,15,14
1746561054343,EDS 286,A00,897210,Fine; Sarah,0,0,15,15
1746561055370,EDS 289C,A01,895770,Daly; Alan J.,1,0,15,14
1746561056397,EDS 290,A00,897211,Hofstetter; Carolyn,0,0,15,15
1746561057425,LIGM 5A,A00,896162,Fischer-Grunski; Eva K,12,0,20,8
1746561058459,LIGM 5B,A00,896260,Fischer-Grunski; Eva K,17,0,20,3
1746561059485,LIGM 5C,A00,896308,Fischer-Grunski; Eva K,18,0,20,2
1746561060510,LIIT 5AS,A00,896313,Carnelos; Chiara,18,0,20,2
1746561061539,LIIT 5BS,A00,896416,Carnelos; Chiara,20,0,20,0
1746561062565,LIIT 5CS,A00,896564,Carnelos; Chiara,20,0,20,0
1746561063594,LISP 5A,A00,896588,Munoz Sanchez; Alicia,3,0,20,17
1746561064622,LISP 5B,A00,896653,Munoz Sanchez; Alicia,7,0,20,13
1746561065651,LISP 5C,A00,896655,Munoz Sanchez; Alicia,0,1,20,20
1746561066678,MAE 197,001,957918,Kleissl; Jan,9996,0,9999,3
1746561066678,MAE 197,002,959806,Boechler; Nicholas Sebastia,9998,0,9999,1
1746561066678,MAE 197,003,959852,Mullin; Jennifer S,9998,0,9999,1
1746561067705,MATH 2,A01,957937,Staff,33,0,35,2
1746561068731,MATH 197,001,957876,Kedlaya; Kiran S.,9993,0,9999,6
1746561069756,MCWP 40,A00,892729,Duru; Nur,10,0,20,10
1746561069756,MCWP 40,B00,893304,Montejo; Carolina,14,0,20,6
1746561070781,MCWP 40R,A00,893757,Redela; Pamela Morgan,0,5,20,20
1746561071806,MCWP 50,A00,893758,Morshed; Michael James,0,0,20,20
1746561071806,MCWP 50,B00,893761,Bartulis; Jason Michael,17,0,20,3
1746561072835,MCWP 50R,A00,893766,Compas; Sean Matthew,0,1,20,20
1746561072835,MCWP 50R,B00,893769,Carter; Jennifer A,0,1,20,20
1746561072835,MCWP 50R,C00,893771,Krone; Jarret,0,3,20,20
1746561072835,MCWP 50R,D00,893772,Miller; Elizabeth Deen,0,0,20,20
1746561072835,MCWP 50R,E00,893775,Carter; Andrea L,0,1,20,20
1746561073862,MMW 11R,A01,892721,Herbst; Matthew,11,0,27,16
1746561073862,MMW 11R,A02,892722,Herbst; Matthew,0,0,0,3
1746561074891,MMW 12R,A01,892724,Herbst; Matthew,0,11,16,16
1746561074891,MMW 12R,A02,892725,Herbst; Matthew,0,10,16,16
1746561075917,MMW 13R,A01,892727,Staff,0,4,16,16
1746561075917,MMW 13R,A02,892728,Staff,0,4,16,16
1746561075917,MMW 13R,A03,958032,Staff,0,4,16,16
1746561075917,MMW 13R,A04,958033,Staff,0,4,16,16
1746561075917,MMW 13R,A05,958034,Staff,0,4,16,16
1746561076942,SIO 295LS,A00,894015,Staff,5,0,25,20
1746561077971,SIO 295S,A00,894020,Staff,5,0,25,20
1746561078999,SIOC 290S,B01,958918,Merrifield; Mark A,14,0,30,16
1746561080025,SIOC 291S,B01,958922,Gabriel; Corey John,14,0,30,16
1746561081050,SOCI 117,A01,895339,Staff,3,0,5,2
1746561082075,WES 237B,A00,894149,Staff,11,0,20,9
1746561084139,AESE 279B,A00,891859,Staff,13,0,35,22
1746561085176,AIP 197,001,891854,Vespa; Emanuel Ignacio,9999,0,9999,0
1746561086202,ANTH 289S,A00,891856,Gagneux; Pascal,12,0,12,0
1746561087225,BENG 196,001,957946,Engler; Adam J.,9996,0,9999,3
1746561088250,BISP 197,001,959851,Wilhelm; James E.,9998,0,9999,1
1746561089275,CAT 124RS,A01,956906,Staff,6,0,25,19
1746561090298,CAT 125RS,A01,922013,Staff,6,0,25,19
1746561091326,CLRE 250,A00,891860,Morris; Sheldon,9995,0,9999,4
1746561093375,CLRE 251R,A00,907817,Mehta; Ravindra L.,9994,0,9999,5
1746561094401,CLRE 252,A00,891864,Cuomo; Raphael Eduardo,9993,0,9999,6
1746561095426,CLRE 253,A00,891867,Vaida; Florin,9994,0,9999,5
1746561095426,CLRE 253,B00,907819,Staff,9999,0,9999,0
1746561096452,CLRE 259,A00,891868,Patel; Hemal,9998,0,9999,1
1746561097479,CLRE 260,A00,891872,Cuomo; Raphael Eduardo,9999,0,9999,0
1746561098503,CLRE 297,001,891888,Cuomo; Raphael Eduardo,9999,0,9999,0
1746561099530,CSE 191,A00,958773,Minnes Kemp; Mor Mia,9995,0,9999,4
1746561100558,CSE 197,001,959846,Minnes Kemp; Mor Mia,9990,0,9999,9
1746561101584,CSS 201S,A01,892054,Mignozzetti; Umberto,26,0,30,4
1746561102609,CSS 202S,A01,892056,Mignozzetti; Umberto,26,0,30,4
1746561103635,DSC 197,001,956898,Eldridge; Justin Matthew,9997,0,9999,2
1746561104664,DSC 297,001,958000,Mazumdar; Arya,9998,0,9999,1
1746561104664,DSC 297,002,959862,Wang; Yusu,9998,0,9999,1
1746561105690,EAP 100,A00,905686,Staff,9778,0,9999,221
1746561106719,ECE 45,A01,892618,Staff,0,0,65,65
1746561108770,ECE 111,A01,892719,Staff,4,0,65,61
1746561109798,ECE 197,001,957920,Mercier; Patrick Philip,9991,0,9999,8
1746561110823,ECON 178,A01,907814,Zhu; Ying,26,0,35,9
1746561111849,EDS 115,A00,895312,Staff,35,0,45,10
1746561112878,EDS 117,A01,895337,Staff,23,0,30,7
1746561113906,EDS 125,A00,895341,Jones; Gabrielle Anastasia,36,0,45,9
1746561114932,EDS 128A,A01,895459,Fargason; Sharon Gayle,44,0,45,1
1746561115957,EDS 128B,A01,895543,Pappas; Elizabeth,44,0,45,1
1746561116984,EDS 139,A00,897203,Pappas; Elizabeth,44,0,45,1
1746561116984,EDS 139,B00,897209,Fargason; Sharon Gayle,41,0,45,4
1746561118008,EDS 201,A00,895545,Staff,22,0,45,23
1746561119035,EDS 203,A01,895581,Halter; Christopher P.,22,0,45,23
1746561120062,EDS 204R,A01,895625,Heinzman; Erica M.,39,0,45,6
1746561120062,EDS 204R,B01,895693,Halter; Christopher P.,10,0,45,35
1746561121090,EDS 206R,A00,895694,Fargason; Sharon Gayle,1,0,30,29
1746561121090,EDS 206R,B00,895695,Choi; Bailey Miyeon,16,0,30,14
1746561122118,EDS 250,A00,895697,Hemans; Patricia Ann Benitez,22,0,45,23
1746561123142,EDS 281,A00,895701,Meyerott; Theresa Ann,1,0,15,14
1746561124170,EDS 284,A00,895736,Meyerott; Theresa Ann,1,0,15,14
1746561125194,EDS 286,A00,897210,Fine; Sarah,0,0,15,15
1746561126223,EDS 289C,A01,895770,Daly; Alan J.,1,0,15,14
1746561127248,EDS 290,A00,897211,Hofstetter; Carolyn,0,0,15,15
1746561128273,LIGM 5A,A00,896162,Fischer-Grunski; Eva K,12,0,20,8
1746561129299,LIGM 5B,A00,896260,Fischer-Grunski; Eva K,17,0,20,3
1746561130328,LIGM 5C,A00,896308,Fischer-Grunski; Eva K,18,0,20,2
1746561131355,LIIT 5AS,A00,896313,Carnelos; Chiara,18,0,20,2
1746561132383,LIIT 5BS,A00,896416,Carnelos; Chiara,20,0,20,0
1746561133407,LIIT 5CS,A00,896564,Carnelos; Chiara,20,0,20,0
1746561134432,LISP 5A,A00,896588,Munoz Sanchez; Alicia,3,0,20,17
1746561135459,LISP 5B,A00,896653,Munoz Sanchez; Alicia,7,0,20,13
1746561136485,LISP 5C,A00,896655,Munoz Sanchez; Alicia,0,1,20,20
1746561137514,MAE 197,001,957918,Kleissl; Jan,9996,0,9999,3
1746561137514,MAE 197,002,959806,Boechler; Nicholas Sebastia,9998,0,9999,1
1746561137514,MAE 197,003,959852,Mullin; Jennifer S,9998,0,9999,1
1746561138541,MATH 2,A01,957937,Staff,33,0,35,2
1746561139568,MATH 197,001,957876,Kedlaya; Kiran S.,9993,0,9999,6
1746561140595,MCWP 40,A00,892729,Duru; Nur,10,0,20,10
1746561140595,MCWP 40,B00,893304,Montejo; Carolina,14,0,20,6
1746561141619,MCWP 40R,A00,893757,Redela; Pamela Morgan,0,5,20,20
1746561142645,MCWP 50,A00,893758,Morshed; Michael James,0,0,20,20
1746561142645,MCWP 50,B00,893761,Bartulis; Jason Michael,17,0,20,3
1746561143670,MCWP 50R,A00,893766,Compas; Sean Matthew,0,1,20,20
1746561143670,MCWP 50R,B00,893769,Carter; Jennifer A,0,1,20,20
1746561143670,MCWP 50R,C00,893771,Krone; Jarret,0,3,20,20
1746561143670,MCWP 50R,D00,893772,Miller; Elizabeth Deen,0,0,20,20
1746561143670,MCWP 50R,E00,893775,Carter; Andrea L,0,1,20,20
1746561144701,MMW 11R,A01,892721,Herbst; Matthew,11,0,27,16
1746561144701,MMW 11R,A02,892722,Herbst; Matthew,0,0,0,3
1746561145731,MMW 12R,A01,892724,Herbst; Matthew,0,11,16,16
1746561145731,MMW 12R,A02,892725,Herbst; Matthew,0,10,16,16
1746561146759,MMW 13R,A01,892727,Staff,0,4,16,16
1746561146759,MMW 13R,A02,892728,Staff,0,4,16,16
1746561146759,MMW 13R,A03,958032,Staff,0,4,16,16
1746561146759,MMW 13R,A04,958033,Staff,0,4,16,16
1746561146759,MMW 13R,A05,958034,Staff,0,4,16,16
1746561147785,SIO 295LS,A00,894015,Staff,5,0,25,20
1746561148813,SIO 295S,A00,894020,Staff,5,0,25,20
1746561149840,SIOC 290S,B01,958918,Merrifield; Mark A,14,0,30,16
1746561150866,SIOC 291S,B01,958922,Gabriel; Corey John,14,0,30,16
1746561151894,SOCI 117,A01,895339,Staff,3,0,5,2
1746561152922,WES 237B,A00,894149,Staff,11,0,20,9
1746561154982,AESE 279B,A00,891859,Staff,13,0,35,22
1746561156006,AIP 197,001,891854,Vespa; Emanuel Ignacio,9999,0,9999,0
1746561157029,ANTH 289S,A00,891856,Gagneux; Pascal,12,0,12,0
1746561158055,BENG 196,001,957946,Engler; Adam J.,9996,0,9999,3
1746561159079,BISP 197,001,959851,Wilhelm; James E.,9998,0,9999,1
1746561160103,CAT 124RS,A01,956906,Staff,6,0,25,19
1746561161130,CAT 125RS,A01,922013,Staff,6,0,25,19
1746561162154,CLRE 250,A00,891860,Morris; Sheldon,9995,0,9999,4
1746561164210,CLRE 251R,A00,907817,Mehta; Ravindra L.,9994,0,9999,5
1746561165236,CLRE 252,A00,891864,Cuomo; Raphael Eduardo,9993,0,9999,6
1746561166262,CLRE 253,A00,891867,Vaida; Florin,9994,0,9999,5
1746561166262,CLRE 253,B00,907819,Staff,9999,0,9999,0
1746561167288,CLRE 259,A00,891868,Patel; Hemal,9998,0,9999,1
1746561168315,CLRE 260,A00,891872,Cuomo; Raphael Eduardo,9999,0,9999,0
1746561169340,CLRE 297,001,891888,Cuomo; Raphael Eduardo,9999,0,9999,0
1746561170366,CSE 191,A00,958773,Minnes Kemp; Mor Mia,9995,0,9999,4
1746561171392,CSE 197,001,959846,Minnes Kemp; Mor Mia,9990,0,9999,9
1746561172426,CSS 201S,A01,892054,Mignozzetti; Umberto,26,0,30,4
1746561173454,CSS 202S,A01,892056,Mignozzetti; Umberto,26,0,30,4
1746561174482,DSC 197,001,956898,Eldridge; Justin Matthew,9997,0,9999,2
1746561175512,DSC 297,001,958000,Mazumdar; Arya,9998,0,9999,1
1746561175512,DSC 297,002,959862,Wang; Yusu,9998,0,9999,1
1746561176535,EAP 100,A00,905686,Staff,9778,0,9999,221
1746561177563,ECE 45,A01,892618,Staff,0,0,65,65
1746561179615,ECE 111,A01,892719,Staff,4,0,65,61
1746561180641,ECE 197,001,957920,Mercier; Patrick Philip,9991,0,9999,8
1746561181666,ECON 178,A01,907814,Zhu; Ying,26,0,35,9
1746561182693,EDS 115,A00,895312,Staff,35,0,45,10
1746561183722,EDS 117,A01,895337,Staff,23,0,30,7
1746561184747,EDS 125,A00,895341,Jones; Gabrielle Anastasia,36,0,45,9
1746561185773,EDS 128A,A01,895459,Fargason; Sharon Gayle,44,0,45,1
1746561186802,EDS 128B,A01,895543,Pappas; Elizabeth,44,0,45,1
1746561187826,EDS 139,A00,897203,Pappas; Elizabeth,44,0,45,1
1746561187826,EDS 139,B00,897209,Fargason; Sharon Gayle,41,0,45,4
1746561188853,EDS 201,A00,895545,Staff,22,0,45,23
1746561189881,EDS 203,A01,895581,Halter; Christopher P.,22,0,45,23
1746561190910,EDS 204R,A01,895625,Heinzman; Erica M.,39,0,45,6
1746561190910,EDS 204R,B01,895693,Halter; Christopher P.,10,0,45,35
1746561191937,EDS 206R,A00,895694,Fargason; Sharon Gayle,1,0,30,29
1746561191937,EDS 206R,B00,895695,Choi; Bailey Miyeon,16,0,30,14
1746561192962,EDS 250,A00,895697,Hemans; Patricia Ann Benitez,22,0,45,23
1746561193986,EDS 281,A00,895701,Meyerott; Theresa Ann,1,0,15,14
1746561195010,EDS 284,A00,895736,Meyerott; Theresa Ann,1,0,15,14
1746561196036,EDS 286,A00,897210,Fine; Sarah,0,0,15,15
1746561197078,EDS 289C,A01,895770,Daly; Alan J.,1,0,15,14
1746561198105,EDS 290,A00,897211,Hofstetter; Carolyn,0,0,15,15
1746561199130,LIGM 5A,A00,896162,Fischer-Grunski; Eva K,12,0,20,8
1746561200155,LIGM 5B,A00,896260,Fischer-Grunski; Eva K,17,0,20,3
1746561201180,LIGM 5C,A00,896308,Fischer-Grunski; Eva K,18,0,20,2
1746561202207,LIIT 5AS,A00,896313,Carnelos; Chiara,18,0,20,2
1746561203235,LIIT 5BS,A00,896416,Carnelos; Chiara,20,0,20,0
1746561204259,LIIT 5CS,A00,896564,Carnelos; Chiara,20,0,20,0
1746561205284,LISP 5A,A00,896588,Munoz Sanchez; Alicia,3,0,20,17
1746561206308,LISP 5B,A00,896653,Munoz Sanchez; Alicia,7,0,20,13
1746561207333,LISP 5C,A00,896655,Munoz Sanchez; Alicia,0,1,20,20
1746561208359,MAE 197,001,957918,Kleissl; Jan,9996,0,9999,3
1746561208359,MAE 197,002,959806,Boechler; Nicholas Sebastia,9998,0,9999,1
1746561208359,MAE 197,003,959852,Mullin; Jennifer S,9998,0,9999,1
1746561209384,MATH 2,A01,957937,Staff,33,0,35,2
1746561210412,MATH 197,001,957876,Kedlaya; Kiran S.,9993,0,9999,6
1746561211439,MCWP 40,A00,892729,Duru; Nur,10,0,20,10
1746561211439,MCWP 40,B00,893304,Montejo; Carolina,14,0,20,6
1746561212466,MCWP 40R,A00,893757,Redela; Pamela Morgan,0,5,20,20
1746561213491,MCWP 50,A00,893758,Morshed; Michael James,0,0,20,20
1746561213491,MCWP 50,B00,893761,Bartulis; Jason Michael,17,0,20,3
1746561214517,MCWP 50R,A00,893766,Compas; Sean Matthew,0,1,20,20
1746561214517,MCWP 50R,B00,893769,Carter; Jennifer A,0,1,20,20
1746561214517,MCWP 50R,C00,893771,Krone; Jarret,0,3,20,20
1746561214517,MCWP 50R,D00,893772,Miller; Elizabeth Deen,0,0,20,20
1746561214517,MCWP 50R,E00,893775,Carter; Andrea L,0,1,20,20
1746561215547,MMW 11R,A01,892721,Herbst; Matthew,11,0,27,16
1746561215547,MMW 11R,A02,892722,Herbst; Matthew,0,0,0,3
1746561216572,MMW 12R,A01,892724,Herbst; Matthew,0,11,16,16
1746561216572,MMW 12R,A02,892725,Herbst; Matthew,0,10,16,16
1746561217598,MMW 13R,A01,892727,Staff,0,4,16,16
1746561217598,MMW 13R,A02,892728,Staff,0,4,16,16
1746561217598,MMW 13R,A03,958032,Staff,0,4,16,16
1746561217598,MMW 13R,A04,958033,Staff,0,4,16,16
1746561217598,MMW 13R,A05,958034,Staff,0,4,16,16
1746561218623,SIO 295LS,A00,894015,Staff,5,0,25,20
1746561219649,SIO 295S,A00,894020,Staff,5,0,25,20
1746561220674,SIOC 290S,B01,958918,Merrifield; Mark A,14,0,30,16
1746561221702,SIOC 291S,B01,958922,Gabriel; Corey John,14,0,30,16
1746561222728,SOCI 117,A01,895339,Staff,3,0,5,2
1746561223753,WES 237B,A00,894149,Staff,11,0,20,9
1746561225807,AESE 279B,A00,891859,Staff,13,0,35,22
1746561226833,AIP 197,001,891854,Vespa; Emanuel Ignacio,9999,0,9999,0
1746561227858,ANTH 289S,A00,891856,Gagneux; Pascal,12,0,12,0
1746561228884,BENG 196,001,957946,Engler; Adam J.,9996,0,9999,3
1746561229909,BISP 197,001,959851,Wilhelm; James E.,9998,0,9999,1
1746561230933,CAT 124RS,A01,956906,Staff,6,0,25,19
1746561231957,CAT 125RS,A01,922013,Staff,6,0,25,19
1746561232981,CLRE 250,A00,891860,Morris; Sheldon,9995,0,9999,4
1746561235029,CLRE 251R,A00,907817,Mehta; Ravindra L.,9994,0,9999,5
1746561236055,CLRE 252,A00,891864,Cuomo; Raphael Eduardo,9993,0,9999,6
1746561237080,CLRE 253,A00,891867,Vaida; Florin,9994,0,9999,5
1746561237080,CLRE 253,B00,907819,Staff,9999,0,9999,0
1746561238107,CLRE 259,A00,891868,Patel; Hemal,9998,0,9999,1
1746561239131,CLRE 260,A00,891872,Cuomo; Raphael Eduardo,9999,0,9999,0
1746561240160,CLRE 297,001,891888,Cuomo; Raphael Eduardo,9999,0,9999,0
1746561241185,CSE 191,A00,958773,Minnes Kemp; Mor Mia,9995,0,9999,4
1746561242212,CSE 197,001,959846,Minnes Kemp; Mor Mia,9990,0,9999,9
1746561243237,CSS 201S,A01,892054,Mignozzetti; Umberto,26,0,30,4
1746561244262,CSS 202S,A01,892056,Mignozzetti; Umberto,26,0,30,4
1746561245290,DSC 197,001,956898,Eldridge; Justin Matthew,9997,0,9999,2
1746561246317,DSC 297,001,958000,Mazumdar; Arya,9998,0,9999,1
1746561246317,DSC 297,002,959862,Wang; Yusu,9998,0,9999,1
1746561247346,EAP 100,A00,905686,Staff,9778,0,9999,221
1746561248374,ECE 45,A01,892618,Staff,0,0,65,65
1746561250423,ECE 111,A01,892719,Staff,4,0,65,61
1746561251450,ECE 197,001,957920,Mercier; Patrick Philip,9991,0,9999,8
1746561252476,ECON 178,A01,907814,Zhu; Ying,26,0,35,9
1746561253502,EDS 115,A00,895312,Staff,35,0,45,10
1746561254528,EDS 117,A01,895337,Staff,23,0,30,7
1746561255554,EDS 125,A00,895341,Jones; Gabrielle Anastasia,36,0,45,9
1746561256580,EDS 128A,A01,895459,Fargason; Sharon Gayle,44,0,45,1
1746561257608,EDS 128B,A01,895543,Pappas; Elizabeth,44,0,45,1
1746561258635,EDS 139,A00,897203,Pappas; Elizabeth,44,0,45,1
1746561258635,EDS 139,B00,897209,Fargason; Sharon Gayle,41,0,45,4
1746561259661,EDS 201,A00,895545,Staff,22,0,45,23
1746561260689,EDS 203,A01,895581,Halter; Christopher P.,22,0,45,23
1746561261714,EDS 204R,A01,895625,Heinzman; Erica M.,39,0,45,6
1746561261714,EDS 204R,B01,895693,Halter; Christopher P.,10,0,45,35
1746561262747,EDS 206R,A00,895694,Fargason; Sharon Gayle,1,0,30,29
1746561262747,EDS 206R,B00,895695,Choi; Bailey Miyeon,16,0,30,14
1746561263771,EDS 250,A00,895697,Hemans; Patricia Ann Benitez,22,0,45,23
1746561264795,EDS 281,A00,895701,Meyerott; Theresa Ann,1,0,15,14
1746561265823,EDS 284,A00,895736,Meyerott; Theresa Ann,1,0,15,14
1746561266849,EDS 286,A00,897210,Fine; Sarah,0,0,15,15
1746561267873,EDS 289C,A01,895770,Daly; Alan J.,1,0,15,14
1746561268899,EDS 290,A00,897211,Hofstetter; Carolyn,0,0,15,15
1746561269924,LIGM 5A,A00,896162,Fischer-Grunski; Eva K,12,0,20,8
1746561270950,LIGM 5B,A00,896260,Fischer-Grunski; Eva K,17,0,20,3
1746561271975,LIGM 5C,A00,896308,Fischer-Grunski; Eva K,18,0,20,2
1746561273003,LIIT 5AS,A00,896313,Carnelos; Chiara,18,0,20,2
1746561274027,LIIT 5BS,A00,896416,Carnelos; Chiara,20,0,20,0
1746561275052,LIIT 5CS,A00,896564,Carnelos; Chiara,20,0,20,0
1746561276079,LISP 5A,A00,896588,Munoz Sanchez; Alicia,3,0,20,17
1746561277103,LISP 5B,A00,896653,Munoz Sanchez; Alicia,7,0,20,13
1746561278129,LISP 5C,A00,896655,Munoz Sanchez; Alicia,0,1,20,20
1746561279157,MAE 197,001,957918,Kleissl; Jan,9996,0,9999,3
1746561279157,MAE 197,002,959806,Boechler; Nicholas Sebastia,9998,0,9999,1
1746561279157,MAE 197,003,959852,Mullin; Jennifer S,9998,0,9999,1
1746561280183,MATH 2,A01,957937,Staff,33,0,35,2
1746561281208,MATH 197,001,957876,Kedlaya; Kiran S.,9993,0,9999,6
1746561282233,MCWP 40,A00,892729,Duru; Nur,10,0,20,10
1746561282233,MCWP 40,B00,893304,Montejo; Carolina,14,0,20,6
1746561283260,MCWP 40R,A00,893757,Redela; Pamela Morgan,0,5,20,20
1746561284287,MCWP 50,A00,893758,Morshed; Michael James,0,0,20,20
1746561284287,MCWP 50,B00,893761,Bartulis; Jason Michael,17,0,20,3
1746561285317,MCWP 50R,A00,893766,Compas; Sean Matthew,0,1,20,20
1746561285317,MCWP 50R,B00,893769,Carter; Jennifer A,0,1,20,20
1746561285317,MCWP 50R,C00,893771,Krone; Jarret,0,3,20,20
1746561285317,MCWP 50R,D00,893772,Miller; Elizabeth Deen,0,0,20,20
1746561285317,MCWP 50R,E00,893775,Carter; Andrea L,0,1,20,20
1746561286341,MMW 11R,A01,892721,Herbst; Matthew,11,0,27,16
1746561286341,MMW 11R,A02,892722,Herbst; Matthew,0,0,0,3
1746561287366,MMW 12R,A01,892724,Herbst; Matthew,0,11,16,16
1746561287366,MMW 12R,A02,892725,Herbst; Matthew,0,10,16,16
1746561288390,MMW 13R,A01,892727,Staff,0,4,16,16
1746561288390,MMW 13R,A02,892728,Staff,0,4,16,16
1746561288390,MMW 13R,A03,958032,Staff,0,4,16,16
1746561288390,MMW 13R,A04,958033,Staff,0,4,16,16
1746561288390,MMW 13R,A05,958034,Staff,0,4,16,16
1746561289415,SIO 295LS,A00,894015,Staff,5,0,25,20
1746561290442,SIO 295S,A00,894020,Staff,5,0,25,20
1746561291467,SIOC 290S,B01,958918,Merrifield; Mark A,14,0,30,16
1746561292494,SIOC 291S,B01,958922,Gabriel; Corey John,14,0,30,16
1746561293522,SOCI 117,A01,895339,Staff,3,0,5,2
1746561294547,WES 237B,A00,894149,Staff,11,0,20,9
1746561296604,AESE 279B,A00,891859,Staff,13,0,35,22
1746561297630,AIP 197,001,891854,Vespa; Emanuel Ignacio,9999,0,9999,0
1746561298654,ANTH 289S,A00,891856,Gagneux; Pascal,12,0,12,0
1746561299682,BENG 196,001,957946,Engler; Adam J.,9996,0,9999,3
1746561300708,BISP 197,001,959851,Wilhelm; James E.,9998,0,9999,1
1746561301734,CAT 124RS,A01,956906,Staff,6,0,25,19
1746561302760,CAT 125RS,A01,922013,Staff,6,0,25,19
1746561303790,CLRE 250,A00,891860,Morris; Sheldon,9995,0,9999,4
1746561305841,CLRE 251R,A00,907817,Mehta; Ravindra L.,9994,0,9999,5
1746561306869,CLRE 252,A00,891864,Cuomo; Raphael Eduardo,9993,0,9999,6
1746561307898,CLRE 253,A00,891867,Vaida; Florin,9994,0,9999,5
1746561307898,CLRE 253,B00,907819,Staff,9999,0,9999,0
1746561308922,CLRE 259,A00,891868,Patel; Hemal,9998,0,9999,1
1746561309946,CLRE 260,A00,891872,Cuomo; Raphael Eduardo,9999,0,9999,0
1746561310972,CLRE 297,001,891888,Cuomo; Raphael Eduardo,9999,0,9999,0
1746561311999,CSE 191,A00,958773,Minnes Kemp; Mor Mia,9995,0,9999,4
1746561313027,CSE 197,001,959846,Minnes Kemp; Mor Mia,9990,0,9999,9
1746561314052,CSS 201S,A01,892054,Mignozzetti; Umberto,26,0,30,4
1746561315083,CSS 202S,A01,892056,Mignozzetti; Umberto,26,0,30,4
1746561316109,DSC 197,001,956898,Eldridge; Justin Matthew,9997,0,9999,2
1746561317137,DSC 297,001,958000,Mazumdar; Arya,9998,0,9999,1
1746561317137,DSC 297,002,959862,Wang; Yusu,9998,0,9999,1
1746561318165,EAP 100,A00,905686,Staff,9778,0,9999,221
1746561319193,ECE 45,A01,892618,Staff,0,0,65,65
1746561321247,ECE 111,A01,892719,Staff,4,0,65,61
1746561322272,ECE 197,001,957920,Mercier; Patrick Philip,9991,0,9999,8
1746561323299,ECON 178,A01,907814,Zhu; Ying,26,0,35,9
1746561324325,EDS 115,A00,895312,Staff,35,0,45,10
1746561325350,EDS 117,A01,895337,Staff,23,0,30,7
1746561326378,EDS 125,A00,895341,Jones; Gabrielle Anastasia,36,0,45,9
1746561327406,EDS 128A,A01,895459,Fargason; Sharon Gayle,44,0,45,1
1746561328429,EDS 128B,A01,895543,Pappas; Elizabeth,44,0,45,1
1746561329457,EDS 139,A00,897203,Pappas; Elizabeth,44,0,45,1
1746561329457,EDS 139,B00,897209,Fargason; Sharon Gayle,41,0,45,4
1746561330483,EDS 201,A00,895545,Staff,22,0,45,23
1746561331507,EDS 203,A01,895581,Halter; Christopher P.,22,0,45,23
1746561332536,EDS 204R,A01,895625,Heinzman; Erica M.,39,0,45,6
1746561332536,EDS 204R,B01,895693,Halter; Christopher P.,10,0,45,35
1746561333561,EDS 206R,A00,895694,Fargason; Sharon Gayle,1,0,30,29
1746561333561,EDS 206R,B00,895695,Choi; Bailey Miyeon,16,0,30,14
1746561334586,EDS 250,A00,895697,Hemans; Patricia Ann Benitez,22,0,45,23
1746561335612,EDS 281,A00,895701,Meyerott; Theresa Ann,1,0,15,14
1746561336640,EDS 284,A00,895736,Meyerott; Theresa Ann,1,0,15,14
1746561337668,EDS 286,A00,897210,Fine; Sarah,0,0,15,15
1746561338693,EDS 289C,A01,895770,Daly; Alan J.,1,0,15,14
1746561339720,EDS 290,A00,897211,Hofstetter; Carolyn,0,0,15,15
1746561340745,LIGM 5A,A00,896162,Fischer-Grunski; Eva K,12,0,20,8
1746561341775,LIGM 5B,A00,896260,Fischer-Grunski; Eva K,17,0,20,3
1746561342802,LIGM 5C,A00,896308,Fischer-Grunski; Eva K,18,0,20,2
1746561343829,LIIT 5AS,A00,896313,Carnelos; Chiara,18,0,20,2
1746561344854,LIIT 5BS,A00,896416,Carnelos; Chiara,20,0,20,0
1746561345878,LIIT 5CS,A00,896564,Carnelos; Chiara,20,0,20,0
1746561346902,LISP 5A,A00,896588,Munoz Sanchez; Alicia,3,0,20,17
1746561347930,LISP 5B,A00,896653,Munoz Sanchez; Alicia,7,0,20,13
1746561348955,LISP 5C,A00,896655,Munoz Sanchez; Alicia,0,1,20,20
1746561349981,MAE 197,001,957918,Kleissl; Jan,9996,0,9999,3
1746561349981,MAE 197,002,959806,Boechler; Nicholas Sebastia,9998,0,9999,1
1746561349981,MAE 197,003,959852,Mullin; Jennifer S,9998,0,9999,1
1746561351010,MATH 2,A01,957937,Staff,33,0,35,2
1746561352034,MATH 197,001,957876,Kedlaya; Kiran S.,9993,0,9999,6
1746561353061,MCWP 40,A00,892729,Duru; Nur,10,0,20,10
1746561353061,MCWP 40,B00,893304,Montejo; Carolina,14,0,20,6
1746561354087,MCWP 40R,A00,893757,Redela; Pamela Morgan,0,5,20,20
1746561355115,MCWP 50,A00,893758,Morshed; Michael James,0,0,20,20
1746561355115,MCWP 50,B00,893761,Bartulis; Jason Michael,17,0,20,3
1746561356139,MCWP 50R,A00,893766,Compas; Sean Matthew,0,1,20,20
1746561356139,MCWP 50R,B00,893769,Carter; Jennifer A,0,1,20,20
1746561356139,MCWP 50R,C00,893771,Krone; Jarret,0,3,20,20
1746561356139,MCWP 50R,D00,893772,Miller; Elizabeth Deen,0,0,20,20
1746561356139,MCWP 50R,E00,893775,Carter; Andrea L,0,1,20,20
1746561357164,MMW 11R,A01,892721,Herbst; Matthew,11,0,27,16
1746561357164,MMW 11R,A02,892722,Herbst; Matthew,0,0,0,3
1746561358189,MMW 12R,A01,892724,Herbst; Matthew,0,11,16,16
1746561358189,MMW 12R,A02,892725,Herbst; Matthew,0,10,16,16
1746561359214,MMW 13R,A01,892727,Staff,0,4,16,16
1746561359214,MMW 13R,A02,892728,Staff,0,4,16,16
1746561359214,MMW 13R,A03,958032,Staff,0,4,16,16
1746561359214,MMW 13R,A04,958033,Staff,0,4,16,16
1746561359214,MMW 13R,A05,958034,Staff,0,4,16,16
1746561360238,SIO 295LS,A00,894015,Staff,5,0,25,20
1746561361265,SIO 295S,A00,894020,Staff,5,0,25,20
1746561362293,SIOC 290S,B01,958918,Merrifield; Mark A,14,0,30,16
1746561363321,SIOC 291S,B01,958922,Gabriel; Corey John,14,0,30,16
1746561364345,SOCI 117,A01,895339,Staff,3,0,5,2
1746561365371,WES 237B,A00,894149,Staff,11,0,20,9
1746561367430,AESE 279B,A00,891859,Staff,13,0,35,22
1746561368454,AIP 197,001,891854,Vespa; Emanuel Ignacio,9999,0,9999,0
1746561369477,ANTH 289S,A00,891856,Gagneux; Pascal,12,0,12,0
1746561370507,BENG 196,001,957946,Engler; Adam J.,9996,0,9999,3
1746561371531,BISP 197,001,959851,Wilhelm; James E.,9998,0,9999,1
1746561372557,CAT 124RS,A01,956906,Staff,6,0,25,19
1746561373582,CAT 125RS,A01,922013,Staff,6,0,25,19
1746561374610,CLRE 250,A00,891860,Morris; Sheldon,9995,0,9999,4
1746561376665,CLRE 251R,A00,907817,Mehta; Ravindra L.,9994,0,9999,5
1746561377691,CLRE 252,A00,891864,Cuomo; Raphael Eduardo,9993,0,9999,6
1746561378732,CLRE 253,A00,891867,Vaida; Florin,9994,0,9999,5
1746561378732,CLRE 253,B00,907819,Staff,9999,0,9999,0
1746561379757,CLRE 259,A00,891868,Patel; Hemal,9998,0,9999,1
1746561380781,CLRE 260,A00,891872,Cuomo; Raphael Eduardo,9999,0,9999,0
1746561381809,CLRE 297,001,891888,Cuomo; Raphael Eduardo,9999,0,9999,0
1746561382835,CSE 191,A00,958773,Minnes Kemp; Mor Mia,9995,0,9999,4
1746561383862,CSE 197,001,959846,Minnes Kemp; Mor Mia,9990,0,9999,9
1746561384893,CSS 201S,A01,892054,Mignozzetti; Umberto,26,0,30,4
1746561385923,CSS 202S,A01,892056,Mignozzetti; Umberto,26,0,30,4
1746561386948,DSC 197,001,956898,Eldridge; Justin Matthew,9997,0,9999,2
1746561387973,DSC 297,001,958000,Mazumdar; Arya,9998,0,9999,1
1746561387973,DSC 297,002,959862,Wang; Yusu,9998,0,9999,1
1746561389000,EAP 100,A00,905686,Staff,9778,0,9999,221
1746561390028,ECE 45,A01,892618,Staff,0,0,65,65
1746561392079,ECE 111,A01,892719,Staff,4,0,65,61
1746561393104,ECE 197,001,957920,Mercier; Patrick Philip,9991,0,9999,8
1746561394133,ECON 178,A01,907814,Zhu; Ying,26,0,35,9
1746561395158,EDS 115,A00,895312,Staff,35,0,45,10
1746561396186,EDS 117,A01,895337,Staff,23,0,30,7
1746561397211,EDS 125,A00,895341,Jones; Gabrielle Anastasia,36,0,45,9
1746561398237,EDS 128A,A01,895459,Fargason; Sharon Gayle,44,0,45,1
1746561399261,EDS 128B,A01,895543,Pappas; Elizabeth,44,0,45,1
1746561400290,EDS 139,A00,897203,Pappas; Elizabeth,44,0,45,1
1746561400290,EDS 139,B00,897209,Fargason; Sharon Gayle,41,0,45,4
1746561401315,EDS 201,A00,895545,Staff,22,0,45,23
1746561402344,EDS 203,A01,895581,Halter; Christopher P.,22,0,45,23
1746561403369,EDS 204R,A01,895625,Heinzman; Erica M.,39,0,45,6
1746561403369,EDS 204R,B01,895693,Halter; Christopher P.,10,0,45,35
1746561404395,EDS 206R,A00,895694,Fargason; Sharon Gayle,1,0,30,29
1746561404395,EDS 206R,B00,895695,Choi; Bailey Miyeon,16,0,30,14
1746561405421,EDS 250,A00,895697,Hemans; Patricia Ann Benitez,22,0,45,23
1746561406445,EDS 281,A00,895701,Meyerott; Theresa Ann,1,0,15,14
1746561407470,EDS 284,A00,895736,Meyerott; Theresa Ann,1,0,15,14
1746561408500,EDS 286,A00,897210,Fine; Sarah,0,0,15,15
1746561409525,EDS 289C,A01,895770,Daly; Alan J.,1,0,15,14
1746561410552,EDS 290,A00,897211,Hofstetter; Carolyn,0,0,15,15
1746561411577,LIGM 5A,A00,896162,Fischer-Grunski; Eva K,12,0,20,8
1746561412605,LIGM 5B,A00,896260,Fischer-Grunski; Eva K,17,0,20,3
1746561413632,LIGM 5C,A00,896308,Fischer-Grunski; Eva K,18,0,20,2
1746561414663,LIIT 5AS,A00,896313,Carnelos; Chiara,18,0,20,2
1746561415692,LIIT 5BS,A00,896416,Carnelos; Chiara,20,0,20,0
1746561416717,LIIT 5CS,A00,896564,Carnelos; Chiara,20,0,20,0
1746561417744,LISP 5A,A00,896588,Munoz Sanchez; Alicia,3,0,20,17
1746561418770,LISP 5B,A00,896653,Munoz Sanchez; Alicia,7,0,20,13
1746561419799,LISP 5C,A00,896655,Munoz Sanchez; Alicia,0,1,20,20
1746561420826,MAE 197,001,957918,Kleissl; Jan,9996,0,9999,3
1746561420826,MAE 197,002,959806,Boechler; Nicholas Sebastia,9998,0,9999,1
1746561420826,MAE 197,003,959852,Mullin; Jennifer S,9998,0,9999,1
1746561421853,MATH 2,A01,957937,Staff,33,0,35,2
1746561422880,MATH 197,001,957876,Kedlaya; Kiran S.,9993,0,9999,6
1746561423907,MCWP 40,A00,892729,Duru; Nur,10,0,20,10
1746561423907,MCWP 40,B00,893304,Montejo; Carolina,14,0,20,6
1746561424934,MCWP 40R,A00,893757,Redela; Pamela Morgan,0,5,20,20
1746561425959,MCWP 50,A00,893758,Morshed; Michael James,0,0,20,20
1746561425959,MCWP 50,B00,893761,Bartulis; Jason Michael,17,0,20,3
1746561426986,MCWP 50R,A00,893766,Compas; Sean Matthew,0,1,20,20
1746561426986,MCWP 50R,B00,893769,Carter; Jennifer A,0,1,20,20
1746561426986,MCWP 50R,C00,893771,Krone; Jarret,0,3,20,20
1746561426986,MCWP 50R,D00,893772,Miller; Elizabeth Deen,0,0,20,20
1746561426986,MCWP 50R,E00,893775,Carter; Andrea L,0,1,20,20
1746561428013,MMW 11R,A01,892721,Herbst; Matthew,11,0,27,16
1746561428013,MMW 11R,A02,892722,Herbst; Matthew,0,0,0,3
1746561429040,MMW 12R,A01,892724,Herbst; Matthew,0,11,16,16
1746561429040,MMW 12R,A02,892725,Herbst; Matthew,0,10,16,16
1746561430066,MMW 13R,A01,892727,Staff,0,4,16,16
1746561430066,MMW 13R,A02,892728,Staff,0,4,16,16
1746561430066,MMW 13R,A03,958032,Staff,0,4,16,16
1746561430066,MMW 13R,A04,958033,Staff,0,4,16,16
1746561430066,MMW 13R,A05,958034,Staff,0,4,16,16
1746561431091,SIO 295LS,A00,894015,Staff,5,0,25,20
1746561432117,SIO 295S,A00,894020,Staff,5,0,25,20
1746561433144,SIOC 290S,B01,958918,Merrifield; Mark A,14,0,30,16
1746561434169,SIOC 291S,B01,958922,Gabriel; Corey John,14,0,30,16
1746561435197,SOCI 117,A01,895339,Staff,3,0,5,2
1746561436224,WES 237B,A00,894149,Staff,11,0,20,9
1746561438292,AESE 279B,A00,891859,Staff,13,0,35,22
1746561439318,AIP 197,001,891854,Vespa; Emanuel Ignacio,9999,0,9999,0
1746561440344,ANTH 289S,A00,891856,Gagneux; Pascal,12,0,12,0
1746561441370,BENG 196,001,957946,Engler; Adam J.,9996,0,9999,3
1746561442395,BISP 197,001,959851,Wilhelm; James E.,9998,0,9999,1
1746561443420,CAT 124RS,A01,956906,Staff,6,0,25,19
1746561444448,CAT 125RS,A01,922013,Staff,6,0,25,19
1746561445479,CLRE 250,A00,891860,Morris; Sheldon,9995,0,9999,4
1746561447537,CLRE 251R,A00,907817,Mehta; Ravindra L.,9994,0,9999,5
1746561448565,CLRE 252,A00,891864,Cuomo; Raphael Eduardo,9993,0,9999,6
1746561449591,CLRE 253,A00,891867,Vaida; Florin,9994,0,9999,5
1746561449591,CLRE 253,B00,907819,Staff,9999,0,9999,0
1746561450620,CLRE 259,A00,891868,Patel; Hemal,9998,0,9999,1
1746561451645,CLRE 260,A00,891872,Cuomo; Raphael Eduardo,9999,0,9999,0
1746561452671,CLRE 297,001,891888,Cuomo; Raphael Eduardo,9999,0,9999,0
1746561453700,CSE 191,A00,958773,Minnes Kemp; Mor Mia,9995,0,9999,4
1746561454729,CSE 197,001,959846,Minnes Kemp; Mor Mia,9990,0,9999,9
1746561455766,CSS 201S,A01,892054,Mignozzetti; Umberto,26,0,30,4
1746561456790,CSS 202S,A01,892056,Mignozzetti; Umberto,26,0,30,4
1746561457818,DSC 197,001,956898,Eldridge; Justin Matthew,9997,0,9999,2
1746561458848,DSC 297,001,958000,Mazumdar; Arya,9998,0,9999,1
1746561458848,DSC 297,002,959862,Wang; Yusu,9998,0,9999,1
1746561459873,EAP 100,A00,905686,Staff,9778,0,9999,221
1746561460901,ECE 45,A01,892618,Staff,0,0,65,65
1746561462954,ECE 111,A01,892719,Staff,4,0,65,61
1746561463980,ECE 197,001,957920,Mercier; Patrick Philip,9991,0,9999,8
1746561465013,ECON 178,A01,907814,Zhu; Ying,26,0,35,9
1746561466040,EDS 115,A00,895312,Staff,35,0,45,10
1746561467064,EDS 117,A01,895337,Staff,23,0,30,7
1746561468089,EDS 125,A00,895341,Jones; Gabrielle Anastasia,36,0,45,9
1746561469115,EDS 128A,A01,895459,Fargason; Sharon Gayle,44,0,45,1
1746561470140,EDS 128B,A01,895543,Pappas; Elizabeth,44,0,45,1
1746561471165,EDS 139,A00,897203,Pappas; Elizabeth,44,0,45,1
1746561471165,EDS 139,B00,897209,Fargason; Sharon Gayle,41,0,45,4
1746561472190,EDS 201,A00,895545,Staff,22,0,45,23
1746561473217,EDS 203,A01,895581,Halter; Christopher P.,22,0,45,23
1746561474245,EDS 204R,A01,895625,Heinzman; Erica M.,39,0,45,6
1746561474245,EDS 204R,B01,895693,Halter; Christopher P.,10,0,45,35
1746561475272,EDS 206R,A00,895694,Fargason; Sharon Gayle,1,0,30,29
1746561475272,EDS 206R,B00,895695,Choi; Bailey Miyeon,16,0,30,14
1746561476297,EDS 250,A00,895697,Hemans; Patricia Ann Benitez,22,0,45,23
1746561477325,EDS 281,A00,895701,Meyerott; Theresa Ann,1,0,15,14
1746561478350,EDS 284,A00,895736,Meyerott; Theresa Ann,1,0,15,14
1746561479376,EDS 286,A00,897210,Fine; Sarah,0,0,15,15
1746561480401,EDS 289C,A01,895770,Daly; Alan J.,1,0,15,14
1746561481426,EDS 290,A00,897211,Hofstetter; Carolyn,0,0,15,15
1746561482455,LIGM 5A,A00,896162,Fischer-Grunski; Eva K,12,0,20,8
1746561483485,LIGM 5B,A00,896260,Fischer-Grunski; Eva K,17,0,20,3
1746561484510,LIGM 5C,A00,896308,Fischer-Grunski; Eva K,18,0,20,2
1746561485534,LIIT 5AS,A00,896313,Carnelos; Chiara,18,0,20,2
1746561486560,LIIT 5BS,A00,896416,Carnelos; Chiara,20,0,20,0
1746561487590,LIIT 5CS,A00,896564,Carnelos; Chiara,20,0,20,0
1746561488617,LISP 5A,A00,896588,Munoz Sanchez; Alicia,3,0,20,17
1746561489645,LISP 5B,A00,896653,Munoz Sanchez; Alicia,7,0,20,13
1746561490675,LISP 5C,A00,896655,Munoz Sanchez; Alicia,0,1,20,20
1746561491701,MAE 197,001,957918,Kleissl; Jan,9996,0,9999,3
1746561491701,MAE 197,002,959806,Boechler; Nicholas Sebastia,9998,0,9999,1
1746561491701,MAE 197,003,959852,Mullin; Jennifer S,9998,0,9999,1
1746561492729,MATH 2,A01,957937,Staff,33,0,35,2
1746561493753,MATH 197,001,957876,Kedlaya; Kiran S.,9993,0,9999,6
1746561494780,MCWP 40,A00,892729,Duru; Nur,10,0,20,10
1746561494780,MCWP 40,B00,893304,Montejo; Carolina,14,0,20,6
1746561495806,MCWP 40R,A00,893757,Redela; Pamela Morgan,0,5,20,20
1746561496830,MCWP 50,A00,893758,Morshed; Michael James,0,0,20,20
1746561496830,MCWP 50,B00,893761,Bartulis; Jason Michael,17,0,20,3
1746561497859,MCWP 50R,A00,893766,Compas; Sean Matthew,0,1,20,20
1746561497859,MCWP 50R,B00,893769,Carter; Jennifer A,0,1,20,20
1746561497859,MCWP 50R,C00,893771,Krone; Jarret,0,3,20,20
1746561497859,MCWP 50R,D00,893772,Miller; Elizabeth Deen,0,0,20,20
1746561497859,MCWP 50R,E00,893775,Carter; Andrea L,0,1,20,20
1746561498886,MMW 11R,A01,892721,Herbst; Matthew,11,0,27,16
1746561498886,MMW 11R,A02,892722,Herbst; Matthew,0,0,0,3
1746561499911,MMW 12R,A01,892724,Herbst; Matthew,0,11,16,16
1746561499911,MMW 12R,A02,892725,Herbst; Matthew,0,10,16,16
1746561500940,MMW 13R,A01,892727,Staff,0,4,16,16
1746561500940,MMW 13R,A02,892728,Staff,0,4,16,16
1746561500940,MMW 13R,A03,958032,Staff,0,4,16,16
1746561500940,MMW 13R,A04,958033,Staff,0,4,16,16
1746561500940,MMW 13R,A05,958034,Staff,0,4,16,16
1746561501967,SIO 295LS,A00,894015,Staff,5,0,25,20
1746561502991,SIO 295S,A00,894020,Staff,5,0,25,20
1746561504017,SIOC 290S,B01,958918,Merrifield; Mark A,14,0,30,16
1746561505043,SIOC 291S,B01,958922,Gabriel; Corey John,14,0,30,16
1746561506069,SOCI 117,A01,895339,Staff,3,0,5,2
1746561507094,WES 237B,A00,894149,Staff,11,0,20,9
1746561509149,AESE 279B,A00,891859,Staff,13,0,35,22
1746561510177,AIP 197,001,891854,Vespa; Emanuel Ignacio,9999,0,9999,0
1746561511204,ANTH 289S,A00,891856,Gagneux; Pascal,12,0,12,0
1746561512234,BENG 196,001,957946,Engler; Adam J.,9996,0,9999,3
1746561513257,BISP 197,001,959851,Wilhelm; James E.,9998,0,9999,1
1746561514284,CAT 124RS,A01,956906,Staff,6,0,25,19
1746561515312,CAT 125RS,A01,922013,Staff,6,0,25,19
1746561516340,CLRE 250,A00,891860,Morris; Sheldon,9995,0,9999,4
1746561518390,CLRE 251R,A00,907817,Mehta; Ravindra L.,9994,0,9999,5
1746561519415,CLRE 252,A00,891864,Cuomo; Raphael Eduardo,9993,0,9999,6
1746561520440,CLRE 253,A00,891867,Vaida; Florin,9994,0,9999,5
1746561520440,CLRE 253,B00,907819,Staff,9999,0,9999,0
1746561521464,CLRE 259,A00,891868,Patel; Hemal,9998,0,9999,1
1746561522489,CLRE 260,A00,891872,Cuomo; Raphael Eduardo,9999,0,9999,0
1746561523514,CLRE 297,001,891888,Cuomo; Raphael Eduardo,9999,0,9999,0
1746561524539,CSE 191,A00,958773,Minnes Kemp; Mor Mia,9995,0,9999,4
1746561525567,CSE 197,001,959846,Minnes Kemp; Mor Mia,9990,0,9999,9
1746561526593,CSS 201S,A01,892054,Mignozzetti; Umberto,26,0,30,4
1746561527621,CSS 202S,A01,892056,Mignozzetti; Umberto,26,0,30,4
1746561528649,DSC 197,001,956898,Eldridge; Justin Matthew,9997,0,9999,2
1746561529675,DSC 297,001,958000,Mazumdar; Arya,9998,0,9999,1
1746561529675,DSC 297,002,959862,Wang; Yusu,9998,0,9999,1
1746561530701,EAP 100,A00,905686,Staff,9778,0,9999,221
1746561531729,ECE 45,A01,892618,Staff,0,0,65,65
1746561533781,ECE 111,A01,892719,Staff,4,0,65,61
1746561534807,ECE 197,001,957920,Mercier; Patrick Philip,9991,0,9999,8
1746561535831,ECON 178,A01,907814,Zhu; Ying,26,0,35,9
1746561536858,EDS 115,A00,895312,Staff,35,0,45,10
1746561537882,EDS 117,A01,895337,Staff,23,0,30,7
1746561538907,EDS 125,A00,895341,Jones; Gabrielle Anastasia,36,0,45,9
1746561539932,EDS 128A,A01,895459,Fargason; Sharon Gayle,44,0,45,1
1746561540957,EDS 128B,A01,895543,Pappas; Elizabeth,44,0,45,1
1746561541988,EDS 139,A00,897203,Pappas; Elizabeth,44,0,45,1
1746561541988,EDS 139,B00,897209,Fargason; Sharon Gayle,41,0,45,4
1746561543012,EDS 201,A00,895545,Staff,22,0,45,23
1746561544040,EDS 203,A01,895581,Halter; Christopher P.,22,0,45,23
1746561545064,EDS 204R,A01,895625,Heinzman; Erica M.,39,0,45,6
1746561545064,EDS 204R,B01,895693,Halter; Christopher P.,10,0,45,35
1746561546093,EDS 206R,A00,895694,Fargason; Sharon Gayle,1,0,30,29
1746561546093,EDS 206R,B00,895695,Choi; Bailey Miyeon,16,0,30,14
1746561547121,EDS 250,A00,895697,Hemans; Patricia Ann Benitez,22,0,45,23
1746561548146,EDS 281,A00,895701,Meyerott; Theresa Ann,1,0,15,14
1746561549170,EDS 284,A00,895736,Meyerott; Theresa Ann,1,0,15,14
1746561550195,EDS 286,A00,897210,Fine; Sarah,0,0,15,15
1746561551223,EDS 289C,A01,895770,Daly; Alan J.,1,0,15,14
1746561552248,EDS 290,A00,897211,Hofstetter; Carolyn,0,0,15,15
1746561553274,LIGM 5A,A00,896162,Fischer-Grunski; Eva K,12,0,20,8
1746561554299,LIGM 5B,A00,896260,Fischer-Grunski; Eva K,17,0,20,3
1746561555324,LIGM 5C,A00,896308,Fischer-Grunski; Eva K,18,0,20,2
1746561556351,LIIT 5AS,A00,896313,Carnelos; Chiara,18,0,20,2
1746561557380,LIIT 5BS,A00,896416,Carnelos; Chiara,20,0,20,0
1746561558408,LIIT 5CS,A00,896564,Carnelos; Chiara,20,0,20,0
1746561559498,LISP 5A,A00,896588,Munoz Sanchez; Alicia,3,0,20,17
1746561560526,LISP 5B,A00,896653,Munoz Sanchez; Alicia,7,0,20,13
1746561561551,LISP 5C,A00,896655,Munoz Sanchez; Alicia,0,1,20,20
1746561562580,MAE 197,001,957918,Kleissl; Jan,9996,0,9999,3
1746561562580,MAE 197,002,959806,Boechler; Nicholas Sebastia,9998,0,9999,1
1746561562580,MAE 197,003,959852,Mullin; Jennifer S,9998,0,9999,1
1746561563604,MATH 2,A01,957937,Staff,33,0,35,2
1746561564634,MATH 197,001,957876,Kedlaya; Kiran S.,9993,0,9999,6
1746561565664,MCWP 40,A00,892729,Duru; Nur,10,0,20,10
1746561565664,MCWP 40,B00,893304,Montejo; Carolina,14,0,20,6
1746561566693,MCWP 40R,A00,893757,Redela; Pamela Morgan,0,5,20,20
1746561567720,MCWP 50,A00,893758,Morshed; Michael James,0,0,20,20
1746561567720,MCWP 50,B00,893761,Bartulis; Jason Michael,17,0,20,3
1746561568752,MCWP 50R,A00,893766,Compas; Sean Matthew,0,1,20,20
1746561568752,MCWP 50R,B00,893769,Carter; Jennifer A,0,1,20,20
1746561568752,MCWP 50R,C00,893771,Krone; Jarret,0,3,20,20
1746561568752,MCWP 50R,D00,893772,Miller; Elizabeth Deen,0,0,20,20
1746561568752,MCWP 50R,E00,893775,Carter; Andrea L,0,1,20,20
1746561569780,MMW 11R,A01,892721,Herbst; Matthew,11,0,27,16
1746561569780,MMW 11R,A02,892722,Herbst; Matthew,0,0,0,3
1746561570810,MMW 12R,A01,892724,Herbst; Matthew,0,11,16,16
1746561570810,MMW 12R,A02,892725,Herbst; Matthew,0,10,16,16
1746561571839,MMW 13R,A01,892727,Staff,0,4,16,16
1746561571839,MMW 13R,A02,892728,Staff,0,4,16,16
1746561571839,MMW 13R,A03,958032,Staff,0,4,16,16
1746561571839,MMW 13R,A04,958033,Staff,0,4,16,16
1746561571839,MMW 13R,A05,958034,Staff,0,4,16,16
1746561572868,SIO 295LS,A00,894015,Staff,5,0,25,20
1746561573897,SIO 295S,A00,894020,Staff,5,0,25,20
1746561574922,SIOC 290S,B01,958918,Merrifield; Mark A,14,0,30,16
1746561575950,SIOC 291S,B01,958922,Gabriel; Corey John,14,0,30,16
1746561576976,SOCI 117,A01,895339,Staff,3,0,5,2
1746561578002,WES 237B,A00,894149,Staff,11,0,20,9
1746561580059,AESE 279B,A00,891859,Staff,13,0,35,22
1746561581084,AIP 197,001,891854,Vespa; Emanuel Ignacio,9999,0,9999,0
1746561582110,ANTH 289S,A00,891856,Gagneux; Pascal,12,0,12,0
1746561583135,BENG 196,001,957946,Engler; Adam J.,9996,0,9999,3
1746561584159,BISP 197,001,959851,Wilhelm; James E.,9998,0,9999,1
1746561585185,CAT 124RS,A01,956906,Staff,6,0,25,19
1746561586209,CAT 125RS,A01,922013,Staff,6,0,25,19
1746561587234,CLRE 250,A00,891860,Morris; Sheldon,9995,0,9999,4
1746561589285,CLRE 251R,A00,907817,Mehta; Ravindra L.,9994,0,9999,5
1746561590309,CLRE 252,A00,891864,Cuomo; Raphael Eduardo,9993,0,9999,6
1746561591333,CLRE 253,A00,891867,Vaida; Florin,9994,0,9999,5
1746561591333,CLRE 253,B00,907819,Staff,9999,0,9999,0
1746561592360,CLRE 259,A00,891868,Patel; Hemal,9998,0,9999,1
1746561593387,CLRE 260,A00,891872,Cuomo; Raphael Eduardo,9999,0,9999,0
1746561594414,CLRE 297,001,891888,Cuomo; Raphael Eduardo,9999,0,9999,0
1746561595439,CSE 191,A00,958773,Minnes Kemp; Mor Mia,9995,0,9999,4
1746561596464,CSE 197,001,959846,Minnes Kemp; Mor Mia,9990,0,9999,9
1746561597492,CSS 201S,A01,892054,Mignozzetti; Umberto,26,0,30,4
1746561598524,CSS 202S,A01,892056,Mignozzetti; Umberto,26,0,30,4
1746561599552,DSC 197,001,956898,Eldridge; Justin Matthew,9997,0,9999,2
1746561600579,DSC 297,001,958000,Mazumdar; Arya,9998,0,9999,1
1746561600579,DSC 297,002,959862,Wang; Yusu,9998,0,9999,1
1746561601605,EAP 100,A00,905686,Staff,9778,0,9999,221
1746561602630,ECE 45,A01,892618,Staff,0,0,65,65
1746561604682,ECE 111,A01,892719,Staff,4,0,65,61
1746561605707,ECE 197,001,957920,Mercier; Patrick Philip,9991,0,9999,8
1746561606731,ECON 178,A01,907814,Zhu; Ying,26,0,35,9
1746561607756,EDS 115,A00,895312,Staff,35,0,45,10
1746561608782,EDS 117,A01,895337,Staff,23,0,30,7
1746561609810,EDS 125,A00,895341,Jones; Gabrielle Anastasia,36,0,45,9
1746561610835,EDS 128A,A01,895459,Fargason; Sharon Gayle,44,0,45,1
1746561611864,EDS 128B,A01,895543,Pappas; Elizabeth,44,0,45,1
1746561612892,EDS 139,A00,897203,Pappas; Elizabeth,44,0,45,1
1746561612892,EDS 139,B00,897209,Fargason; Sharon Gayle,41,0,45,4
1746561613918,EDS 201,A00,895545,Staff,22,0,45,23
1746561614944,EDS 203,A01,895581,Halter; Christopher P.,22,0,45,23
1746561615973,EDS 204R,A01,895625,Heinzman; Erica M.,39,0,45,6
1746561615973,EDS 204R,B01,895693,Halter; Christopher P.,10,0,45,35
1746561616998,EDS 206R,A00,895694,Fargason; Sharon Gayle,1,0,30,29
1746561616998,EDS 206R,B00,895695,Choi; Bailey Miyeon,16,0,30,14
1746561618026,EDS 250,A00,895697,Hemans; Patricia Ann Benitez,22,0,45,23
1746561619051,EDS 281,A00,895701,Meyerott; Theresa Ann,1,0,15,14
1746561620075,EDS 284,A00,895736,Meyerott; Theresa Ann,1,0,15,14
1746561621101,EDS 286,A00,897210,Fine; Sarah,0,0,15,15
1746561622128,EDS 289C,A01,895770,Daly; Alan J.,1,0,15,14
1746561623154,EDS 290,A00,897211,Hofstetter; Carolyn,0,0,15,15
1746561624395,LIGM 5A,A00,896162,Fischer-Grunski; Eva K,12,0,20,8
1746561625420,LIGM 5B,A00,896260,Fischer-Grunski; Eva K,17,0,20,3
1746561626446,LIGM 5C,A00,896308,Fischer-Grunski; Eva K,18,0,20,2
1746561627475,LIIT 5AS,A00,896313,Carnelos; Chiara,18,0,20,2
1746561628503,LIIT 5BS,A00,896416,Carnelos; Chiara,20,0,20,0
1746561629738,LIIT 5CS,A00,896564,Carnelos; Chiara,20,0,20,0
1746561630767,LISP 5A,A00,896588,Munoz Sanchez; Alicia,3,0,20,17
1746561631793,LISP 5B,A00,896653,Munoz Sanchez; Alicia,7,0,20,13
1746561632820,LISP 5C,A00,896655,Munoz Sanchez; Alicia,0,1,20,20
1746561633848,MAE 197,001,957918,Kleissl; Jan,9996,0,9999,3
1746561633848,MAE 197,002,959806,Boechler; Nicholas Sebastia,9998,0,9999,1
1746561633848,MAE 197,003,959852,Mullin; Jennifer S,9998,0,9999,1
1746561634873,MATH 2,A01,957937,Staff,33,0,35,2
1746561635900,MATH 197,001,957876,Kedlaya; Kiran S.,9993,0,9999,6
1746561636925,MCWP 40,A00,892729,Duru; Nur,10,0,20,10
1746561636925,MCWP 40,B00,893304,Montejo; Carolina,14,0,20,6
1746561637951,MCWP 40R,A00,893757,Redela; Pamela Morgan,0,5,20,20
1746561638980,MCWP 50,A00,893758,Morshed; Michael James,0,0,20,20
1746561638980,MCWP 50,B00,893761,Bartulis; Jason Michael,17,0,20,3
1746561640014,MCWP 50R,A00,893766,Compas; Sean Matthew,0,1,20,20
1746561640014,MCWP 50R,B00,893769,Carter; Jennifer A,0,1,20,20
1746561640014,MCWP 50R,C00,893771,Krone; Jarret,0,3,20,20
1746561640014,MCWP 50R,D00,893772,Miller; Elizabeth Deen,0,0,20,20
1746561640014,MCWP 50R,E00,893775,Carter; Andrea L,0,1,20,20
1746561641039,MMW 11R,A01,892721,Herbst; Matthew,11,0,27,16
1746561641039,MMW 11R,A02,892722,Herbst; Matthew,0,0,0,3
1746561642067,MMW 12R,A01,892724,Herbst; Matthew,0,11,16,16
1746561642067,MMW 12R,A02,892725,Herbst; Matthew,0,10,16,16
1746561643095,MMW 13R,A01,892727,Staff,0,4,16,16
1746561643095,MMW 13R,A02,892728,Staff,0,4,16,16
1746561643095,MMW 13R,A03,958032,Staff,0,4,16,16
1746561643095,MMW 13R,A04,958033,Staff,0,4,16,16
1746561643095,MMW 13R,A05,958034,Staff,0,4,16,16
1746561644120,SIO 295LS,A00,894015,Staff,5,0,25,20
1746561645145,SIO 295S,A00,894020,Staff,5,0,25,20
1746561646170,SIOC 290S,B01,958918,Merrifield; Mark A,14,0,30,16
1746561647195,SIOC 291S,B01,958922,Gabriel; Corey John,14,0,30,16
1746561648220,SOCI 117,A01,895339,Staff,3,0,5,2
1746561649246,WES 237B,A00,894149,Staff,11,0,20,9
1746561651309,AESE 279B,A00,891859,Staff,13,0,35,22
1746561652339,AIP 197,001,891854,Vespa; Emanuel Ignacio,9999,0,9999,0
1746561653364,ANTH 289S,A00,891856,Gagneux; Pascal,12,0,12,0
1746561654388,BENG 196,001,957946,Engler; Adam J.,9996,0,9999,3
1746561655415,BISP 197,001,959851,Wilhelm; James E.,9998,0,9999,1
1746561656439,CAT 124RS,A01,956906,Staff,6,0,25,19
1746561657465,CAT 125RS,A01,922013,Staff,6,0,25,19
1746561658492,CLRE 250,A00,891860,Morris; Sheldon,9995,0,9999,4
1746561660543,CLRE 251R,A00,907817,Mehta; Ravindra L.,9994,0,9999,5
1746561661571,CLRE 252,A00,891864,Cuomo; Raphael Eduardo,9993,0,9999,6
1746561662598,CLRE 253,A00,891867,Vaida; Florin,9994,0,9999,5
1746561662598,CLRE 253,B00,907819,Staff,9999,0,9999,0
1746561663626,CLRE 259,A00,891868,Patel; Hemal,9998,0,9999,1
1746561664652,CLRE 260,A00,891872,Cuomo; Raphael Eduardo,9999,0,9999,0
1746561665676,CLRE 297,001,891888,Cuomo; Raphael Eduardo,9999,0,9999,0
1746561666704,CSE 191,A00,958773,Minnes Kemp; Mor Mia,9995,0,9999,4
1746561667727,CSE 197,001,959846,Minnes Kemp; Mor Mia,9990,0,9999,9
1746561668756,CSS 201S,A01,892054,Mignozzetti; Umberto,26,0,30,4
1746561669779,CSS 202S,A01,892056,Mignozzetti; Umberto,26,0,30,4
1746561670804,DSC 197,001,956898,Eldridge; Justin Matthew,9997,0,9999,2
1746561671830,DSC 297,001,958000,Mazumdar; Arya,9998,0,9999,1
1746561671830,DSC 297,002,959862,Wang; Yusu,9998,0,9999,1
1746561672854,EAP 100,A00,905686,Staff,9778,0,9999,221
1746561673882,ECE 45,A01,892618,Staff,0,0,65,65
1746561675934,ECE 111,A01,892719,Staff,4,0,65,61
1746561676959,ECE 197,001,957920,Mercier; Patrick Philip,9991,0,9999,8
1746561677986,ECON 178,A01,907814,Zhu; Ying,26,0,35,9
1746561679011,EDS 115,A00,895312,Staff,35,0,45,10
1746561680038,EDS 117,A01,895337,Staff,23,0,30,7
1746561681064,EDS 125,A00,895341,Jones; Gabrielle Anastasia,36,0,45,9
1746561682092,EDS 128A,A01,895459,Fargason; Sharon Gayle,44,0,45,1
1746561683116,EDS 128B,A01,895543,Pappas; Elizabeth,44,0,45,1
1746561684143,EDS 139,A00,897203,Pappas; Elizabeth,44,0,45,1
1746561684143,EDS 139,B00,897209,Fargason; Sharon Gayle,41,0,45,4
1746561685167,EDS 201,A00,895545,Staff,22,0,45,23
1746561686195,EDS 203,A01,895581,Halter; Christopher P.,22,0,45,23
1746561687219,EDS 204R,A01,895625,Heinzman; Erica M.,39,0,45,6
1746561687219,EDS 204R,B01,895693,Halter; Christopher P.,10,0,45,35
1746561688246,EDS 206R,A00,895694,Fargason; Sharon Gayle,1,0,30,29
1746561688246,EDS 206R,B00,895695,Choi; Bailey Miyeon,16,0,30,14
1746561689271,EDS 250,A00,895697,Hemans; Patricia Ann Benitez,22,0,45,23
1746561690296,EDS 281,A00,895701,Meyerott; Theresa Ann,1,0,15,14
1746561691321,EDS 284,A00,895736,Meyerott; Theresa Ann,1,0,15,14
1746561692348,EDS 286,A00,897210,Fine; Sarah,0,0,15,15
1746561693373,EDS 289C,A01,895770,Daly; Alan J.,1,0,15,14
1746561694397,EDS 290,A00,897211,Hofstetter; Carolyn,0,0,15,15
1746561695422,LIGM 5A,A00,896162,Fischer-Grunski; Eva K,12,0,20,8
1746561696451,LIGM 5B,A00,896260,Fischer-Grunski; Eva K,17,0,20,3
1746561697479,LIGM 5C,A00,896308,Fischer-Grunski; Eva K,18,0,20,2
1746561698506,LIIT 5AS,A00,896313,Carnelos; Chiara,18,0,20,2
1746561699532,LIIT 5BS,A00,896416,Carnelos; Chiara,20,0,20,0
1746561700557,LIIT 5CS,A00,896564,Carnelos; Chiara,20,0,20,0
1746561701583,LISP 5A,A00,896588,Munoz Sanchez; Alicia,3,0,20,17
1746561702606,LISP 5B,A00,896653,Munoz Sanchez; Alicia,7,0,20,13
1746561703632,LISP 5C,A00,896655,Munoz Sanchez; Alicia,0,1,20,20
1746561704656,MAE 197,001,957918,Kleissl; Jan,9996,0,9999,3
1746561704656,MAE 197,002,959806,Boechler; Nicholas Sebastia,9998,0,9999,1
1746561704656,MAE 197,003,959852,Mullin; Jennifer S,9998,0,9999,1
1746561705684,MATH 2,A01,957937,Staff,33,0,35,2
1746561706710,MATH 197,001,957876,Kedlaya; Kiran S.,9993,0,9999,6
1746561707734,MCWP 40,A00,892729,Duru; Nur,10,0,20,10
1746561707734,MCWP 40,B00,893304,Montejo; Carolina,14,0,20,6
1746561708758,MCWP 40R,A00,893757,Redela; Pamela Morgan,0,5,20,20
1746561709784,MCWP 50,A00,893758,Morshed; Michael James,0,0,20,20
1746561709784,MCWP 50,B00,893761,Bartulis; Jason Michael,17,0,20,3
1746561710813,MCWP 50R,A00,893766,Compas; Sean Matthew,0,1,20,20
1746561710813,MCWP 50R,B00,893769,Carter; Jennifer A,0,1,20,20
1746561710813,MCWP 50R,C00,893771,Krone; Jarret,0,3,20,20
1746561710813,MCWP 50R,D00,893772,Miller; Elizabeth Deen,0,0,20,20
1746561710813,MCWP 50R,E00,893775,Carter; Andrea L,0,1,20,20
1746561711837,MMW 11R,A01,892721,Herbst; Matthew,11,0,27,16
1746561711837,MMW 11R,A02,892722,Herbst; Matthew,0,0,0,3
1746561712862,MMW 12R,A01,892724,Herbst; Matthew,0,11,16,16
1746561712862,MMW 12R,A02,892725,Herbst; Matthew,0,10,16,16
1746561713890,MMW 13R,A01,892727,Staff,0,4,16,16
1746561713890,MMW 13R,A02,892728,Staff,0,4,16,16
1746561713890,MMW 13R,A03,958032,Staff,0,4,16,16
1746561713890,MMW 13R,A04,958033,Staff,0,4,16,16
1746561713890,MMW 13R,A05,958034,Staff,0,4,16,16
1746561714915,SIO 295LS,A00,894015,Staff,5,0,25,20
1746561715943,SIO 295S,A00,894020,Staff,5,0,25,20
1746561716971,SIOC 290S,B01,958918,Merrifield; Mark A,14,0,30,16
1746561718001,SIOC 291S,B01,958922,Gabriel; Corey John,14,0,30,16
1746561719026,SOCI 117,A01,895339,Staff,3,0,5,2
1746561720062,WES 237B,A00,894149,Staff,11,0,20,9
1746561722118,AESE 279B,A00,891859,Staff,13,0,35,22
1746561723143,AIP 197,001,891854,Vespa; Emanuel Ignacio,9999,0,9999,0
1746561724169,ANTH 289S,A00,891856,Gagneux; Pascal,12,0,12,0
1746561725195,BENG 196,001,957946,Engler; Adam J.,9996,0,9999,3
1746561726221,BISP 197,001,959851,Wilhelm; James E.,9998,0,9999,1
1746561727247,CAT 124RS,A01,956906,Staff,6,0,25,19
1746561728271,CAT 125RS,A01,922013,Staff,6,0,25,19
1746561729299,CLRE 250,A00,891860,Morris; Sheldon,9995,0,9999,4
1746561731353,CLRE 251R,A00,907817,Mehta; Ravindra L.,9994,0,9999,5
1746561732382,CLRE 252,A00,891864,Cuomo; Raphael Eduardo,9993,0,9999,6
1746561733409,CLRE 253,A00,891867,Vaida; Florin,9994,0,9999,5
1746561733409,CLRE 253,B00,907819,Staff,9999,0,9999,0
1746561734439,CLRE 259,A00,891868,Patel; Hemal,9998,0,9999,1
1746561735464,CLRE 260,A00,891872,Cuomo; Raphael Eduardo,9999,0,9999,0
1746561736489,CLRE 297,001,891888,Cuomo; Raphael Eduardo,9999,0,9999,0
1746561737512,CSE 191,A00,958773,Minnes Kemp; Mor Mia,9995,0,9999,4
1746561738539,CSE 197,001,959846,Minnes Kemp; Mor Mia,9990,0,9999,9
1746561739563,CSS 201S,A01,892054,Mignozzetti; Umberto,26,0,30,4
1746561740588,CSS 202S,A01,892056,Mignozzetti; Umberto,26,0,30,4
1746561741614,DSC 197,001,956898,Eldridge; Justin Matthew,9997,0,9999,2
1746561742643,DSC 297,001,958000,Mazumdar; Arya,9998,0,9999,1
1746561742643,DSC 297,002,959862,Wang; Yusu,9998,0,9999,1
1746561743669,EAP 100,A00,905686,Staff,9778,0,9999,221
1746561744695,ECE 45,A01,892618,Staff,0,0,65,65
1746561746748,ECE 111,A01,892719,Staff,4,0,65,61
1746561747774,ECE 197,001,957920,Mercier; Patrick Philip,9991,0,9999,8
1746561748799,ECON 178,A01,907814,Zhu; Ying,26,0,35,9
1746561749822,EDS 115,A00,895312,Staff,35,0,45,10
1746561750850,EDS 117,A01,895337,Staff,23,0,30,7
1746561751874,EDS 125,A00,895341,Jones; Gabrielle Anastasia,36,0,45,9
1746561752902,EDS 128A,A01,895459,Fargason; Sharon Gayle,44,0,45,1
1746561753925,EDS 128B,A01,895543,Pappas; Elizabeth,44,0,45,1
1746561754950,EDS 139,A00,897203,Pappas; Elizabeth,44,0,45,1
1746561754950,EDS 139,B00,897209,Fargason; Sharon Gayle,41,0,45,4
1746561755975,EDS 201,A00,895545,Staff,22,0,45,23
1746561757001,EDS 203,A01,895581,Halter; Christopher P.,22,0,45,23
1746561758028,EDS 204R,A01,895625,Heinzman; Erica M.,39,0,45,6
1746561758028,EDS 204R,B01,895693,Halter; Christopher P.,10,0,45,35
1746561759054,EDS 206R,A00,895694,Fargason; Sharon Gayle,1,0,30,29
1746561759054,EDS 206R,B00,895695,Choi; Bailey Miyeon,16,0,30,14
1746561760085,EDS 250,A00,895697,Hemans; Patricia Ann Benitez,22,0,45,23
1746561761110,EDS 281,A00,895701,Meyerott; Theresa Ann,1,0,15,14
1746561762135,EDS 284,A00,895736,Meyerott; Theresa Ann,1,0,15,14
1746561763159,EDS 286,A00,897210,Fine; Sarah,0,0,15,15
1746561764184,EDS 289C,A01,895770,Daly; Alan J.,1,0,15,14
1746561765212,EDS 290,A00,897211,Hofstetter; Carolyn,0,0,15,15
1746561766238,LIGM 5A,A00,896162,Fischer-Grunski; Eva K,12,0,20,8
1746561767268,LIGM 5B,A00,896260,Fischer-Grunski; Eva K,17,0,20,3
1746561768294,LIGM 5C,A00,896308,Fischer-Grunski; Eva K,18,0,20,2
1746561769319,LIIT 5AS,A00,896313,Carnelos; Chiara,18,0,20,2
1746561770344,LIIT 5BS,A00,896416,Carnelos; Chiara,20,0,20,0
1746561771373,LIIT 5CS,A00,896564,Carnelos; Chiara,20,0,20,0
1746561772397,LISP 5A,A00,896588,Munoz Sanchez; Alicia,3,0,20,17
1746561773626,LISP 5B,A00,896653,Munoz Sanchez; Alicia,7,0,20,13
1746561774656,LISP 5C,A00,896655,Munoz Sanchez; Alicia,0,1,20,20
1746561775679,MAE 197,001,957918,Kleissl; Jan,9996,0,9999,3
1746561775679,MAE 197,002,959806,Boechler; Nicholas Sebastia,9998,0,9999,1
1746561775679,MAE 197,003,959852,Mullin; Jennifer S,9998,0,9999,1
1746561776706,MATH 2,A01,957937,Staff,33,0,35,2
1746561777733,MATH 197,001,957876,Kedlaya; Kiran S.,9993,0,9999,6
1746561778760,MCWP 40,A00,892729,Duru; Nur,10,0,20,10
1746561778760,MCWP 40,B00,893304,Montejo; Carolina,14,0,20,6
1746561779784,MCWP 40R,A00,893757,Redela; Pamela Morgan,0,5,20,20
1746561780810,MCWP 50,A00,893758,Morshed; Michael James,0,0,20,20
1746561780810,MCWP 50,B00,893761,Bartulis; Jason Michael,17,0,20,3
1746561781835,MCWP 50R,A00,893766,Compas; Sean Matthew,0,1,20,20
1746561781835,MCWP 50R,B00,893769,Carter; Jennifer A,0,1,20,20
1746561781835,MCWP 50R,C00,893771,Krone; Jarret,0,3,20,20
1746561781835,MCWP 50R,D00,893772,Miller; Elizabeth Deen,0,0,20,20
1746561781835,MCWP 50R,E00,893775,Carter; Andrea L,0,1,20,20
1746561782860,MMW 11R,A01,892721,Herbst; Matthew,11,0,27,16
1746561782860,MMW 11R,A02,892722,Herbst; Matthew,0,0,0,3
1746561783888,MMW 12R,A01,892724,Herbst; Matthew,0,11,16,16
1746561783888,MMW 12R,A02,892725,Herbst; Matthew,0,10,16,16
1746561784914,MMW 13R,A01,892727,Staff,0,4,16,16
1746561784914,MMW 13R,A02,892728,Staff,0,4,16,16
1746561784914,MMW 13R,A03,958032,Staff,0,4,16,16
1746561784914,MMW 13R,A04,958033,Staff,0,4,16,16
1746561784914,MMW 13R,A05,958034,Staff,0,4,16,16
1746561785939,SIO 295LS,A00,894015,Staff,5,0,25,20
1746561786967,SIO 295S,A00,894020,Staff,5,0,25,20
1746561787992,SIOC 290S,B01,958918,Merrifield; Mark A,14,0,30,16
1746561789021,SIOC 291S,B01,958922,Gabriel; Corey John,14,0,30,16
1746561790047,SOCI 117,A01,895339,Staff,3,0,5,2
1746561791073,WES 237B,A00,894149,Staff,11,0,20,9
1746561793133,AESE 279B,A00,891859,Staff,13,0,35,22
1746561794160,AIP 197,001,891854,Vespa; Emanuel Ignacio,9999,0,9999,0
1746561795185,ANTH 289S,A00,891856,Gagneux; Pascal,12,0,12,0
1746561796209,BENG 196,001,957946,Engler; Adam J.,9996,0,9999,3
1746561797236,BISP 197,001,959851,Wilhelm; James E.,9998,0,9999,1
1746561798260,CAT 124RS,A01,956906,Staff,6,0,25,19
1746561799286,CAT 125RS,A01,922013,Staff,6,0,25,19
1746561800313,CLRE 250,A00,891860,Morris; Sheldon,9995,0,9999,4
1746561802366,CLRE 251R,A00,907817,Mehta; Ravindra L.,9994,0,9999,5
1746561803390,CLRE 252,A00,891864,Cuomo; Raphael Eduardo,9993,0,9999,6
1746561804417,CLRE 253,A00,891867,Vaida; Florin,9994,0,9999,5
1746561804417,CLRE 253,B00,907819,Staff,9999,0,9999,0
1746561805442,CLRE 259,A00,891868,Patel; Hemal,9998,0,9999,1
1746561806467,CLRE 260,A00,891872,Cuomo; Raphael Eduardo,9999,0,9999,0
1746561807493,CLRE 297,001,891888,Cuomo; Raphael Eduardo,9999,0,9999,0
1746561808519,CSE 191,A00,958773,Minnes Kemp; Mor Mia,9995,0,9999,4
1746561809545,CSE 197,001,959846,Minnes Kemp; Mor Mia,9990,0,9999,9
1746561810571,CSS 201S,A01,892054,Mignozzetti; Umberto,26,0,30,4
1746561811598,CSS 202S,A01,892056,Mignozzetti; Umberto,26,0,30,4
1746561812625,DSC 197,001,956898,Eldridge; Justin Matthew,9996,0,9999,3
1746561813652,DSC 297,001,958000,Mazumdar; Arya,9998,0,9999,1
1746561813652,DSC 297,002,959862,Wang; Yusu,9998,0,9999,1
1746561814678,EAP 100,A00,905686,Staff,9778,0,9999,221
1746561815709,ECE 45,A01,892618,Staff,0,0,65,65
1746561817763,ECE 111,A01,892719,Staff,4,0,65,61
1746561818789,ECE 197,001,957920,Mercier; Patrick Philip,9991,0,9999,8
1746561819815,ECON 178,A01,907814,Zhu; Ying,26,0,35,9
1746561820843,EDS 115,A00,895312,Staff,35,0,45,10
1746561821868,EDS 117,A01,895337,Staff,23,0,30,7
1746561822894,EDS 125,A00,895341,Jones; Gabrielle Anastasia,36,0,45,9
1746561823918,EDS 128A,A01,895459,Fargason; Sharon Gayle,44,0,45,1
1746561824947,EDS 128B,A01,895543,Pappas; Elizabeth,44,0,45,1
1746561825971,EDS 139,A00,897203,Pappas; Elizabeth,44,0,45,1
1746561825971,EDS 139,B00,897209,Fargason; Sharon Gayle,41,0,45,4
1746561826998,EDS 201,A00,895545,Staff,22,0,45,23
1746561828025,EDS 203,A01,895581,Halter; Christopher P.,22,0,45,23
1746561829054,EDS 204R,A01,895625,Heinzman; Erica M.,39,0,45,6
1746561829054,EDS 204R,B01,895693,Halter; Christopher P.,10,0,45,35
1746561830082,EDS 206R,A00,895694,Fargason; Sharon Gayle,1,0,30,29
1746561830082,EDS 206R,B00,895695,Choi; Bailey Miyeon,16,0,30,14
1746561831112,EDS 250,A00,895697,Hemans; Patricia Ann Benitez,22,0,45,23
1746561832137,EDS 281,A00,895701,Meyerott; Theresa Ann,1,0,15,14
1746561833163,EDS 284,A00,895736,Meyerott; Theresa Ann,1,0,15,14
1746561834192,EDS 286,A00,897210,Fine; Sarah,0,0,15,15
1746561835216,EDS 289C,A01,895770,Daly; Alan J.,1,0,15,14
1746561836239,EDS 290,A00,897211,Hofstetter; Carolyn,0,0,15,15
1746561837265,LIGM 5A,A00,896162,Fischer-Grunski; Eva K,12,0,20,8
1746561838289,LIGM 5B,A00,896260,Fischer-Grunski; Eva K,17,0,20,3
1746561839314,LIGM 5C,A00,896308,Fischer-Grunski; Eva K,18,0,20,2
1746561840338,LIIT 5AS,A00,896313,Carnelos; Chiara,18,0,20,2
1746561841369,LIIT 5BS,A00,896416,Carnelos; Chiara,20,0,20,0
1746561842406,LIIT 5CS,A00,896564,Carnelos; Chiara,20,0,20,0
1746561843432,LISP 5A,A00,896588,Munoz Sanchez; Alicia,3,0,20,17
1746561844458,LISP 5B,A00,896653,Munoz Sanchez; Alicia,7,0,20,13
1746561845483,LISP 5C,A00,896655,Munoz Sanchez; Alicia,0,1,20,20
1746561846511,MAE 197,001,957918,Kleissl; Jan,9996,0,9999,3
1746561846511,MAE 197,002,959806,Boechler; Nicholas Sebastia,9998,0,9999,1
1746561846511,MAE 197,003,959852,Mullin; Jennifer S,9998,0,9999,1
1746561847536,MATH 2,A01,957937,Staff,33,0,35,2
1746561848563,MATH 197,001,957876,Kedlaya; Kiran S.,9993,0,9999,6
1746561849588,MCWP 40,A00,892729,Duru; Nur,10,0,20,10
1746561849588,MCWP 40,B00,893304,Montejo; Carolina,14,0,20,6
1746561850616,MCWP 40R,A00,893757,Redela; Pamela Morgan,0,5,20,20
1746561851644,MCWP 50,A00,893758,Morshed; Michael James,0,0,20,20
1746561851644,MCWP 50,B00,893761,Bartulis; Jason Michael,17,0,20,3
1746561852673,MCWP 50R,A00,893766,Compas; Sean Matthew,0,1,20,20
1746561852673,MCWP 50R,B00,893769,Carter; Jennifer A,0,1,20,20
1746561852673,MCWP 50R,C00,893771,Krone; Jarret,0,3,20,20
1746561852673,MCWP 50R,D00,893772,Miller; Elizabeth Deen,0,0,20,20
1746561852673,MCWP 50R,E00,893775,Carter; Andrea L,0,1,20,20
1746561853697,MMW 11R,A01,892721,Herbst; Matthew,11,0,27,16
1746561853697,MMW 11R,A02,892722,Herbst; Matthew,0,0,0,3
1746561854721,MMW 12R,A01,892724,Herbst; Matthew,0,11,16,16
1746561854721,MMW 12R,A02,892725,Herbst; Matthew,0,10,16,16
1746561855752,MMW 13R,A01,892727,Staff,0,4,16,16
1746561855752,MMW 13R,A02,892728,Staff,0,4,16,16
1746561855752,MMW 13R,A03,958032,Staff,0,4,16,16
1746561855752,MMW 13R,A04,958033,Staff,0,4,16,16
1746561855752,MMW 13R,A05,958034,Staff,0,4,16,16
1746561856778,SIO 295LS,A00,894015,Staff,5,0,25,20
1746561857804,SIO 295S,A00,894020,Staff,5,0,25,20
1746561858829,SIOC 290S,B01,958918,Merrifield; Mark A,14,0,30,16
1746561859856,SIOC 291S,B01,958922,Gabriel; Corey John,14,0,30,16
1746561860880,SOCI 117,A01,895339,Staff,3,0,5,2
1746561861906,WES 237B,A00,894149,Staff,11,0,20,9
1746561863961,AESE 279B,A00,891859,Staff,13,0,35,22
1746561865028,AIP 197,001,891854,Vespa; Emanuel Ignacio,9999,0,9999,0
1746561866053,ANTH 289S,A00,891856,Gagneux; Pascal,12,0,12,0
1746561867077,BENG 196,001,957946,Engler; Adam J.,9996,0,9999,3
1746561868104,BISP 197,001,959851,Wilhelm; James E.,9998,0,9999,1
1746561869129,CAT 124RS,A01,956906,Staff,6,0,25,19
1746561870157,CAT 125RS,A01,922013,Staff,6,0,25,19
1746561871184,CLRE 250,A00,891860,Morris; Sheldon,9995,0,9999,4
1746561873238,CLRE 251R,A00,907817,Mehta; Ravindra L.,9994,0,9999,5
1746561874265,CLRE 252,A00,891864,Cuomo; Raphael Eduardo,9993,0,9999,6
1746561875290,CLRE 253,A00,891867,Vaida; Florin,9994,0,9999,5
1746561875290,CLRE 253,B00,907819,Staff,9999,0,9999,0
1746561876315,CLRE 259,A00,891868,Patel; Hemal,9998,0,9999,1
1746561877339,CLRE 260,A00,891872,Cuomo; Raphael Eduardo,9999,0,9999,0
1746561878364,CLRE 297,001,891888,Cuomo; Raphael Eduardo,9999,0,9999,0
1746561879391,CSE 191,A00,958773,Minnes Kemp; Mor Mia,9995,0,9999,4
1746561880419,CSE 197,001,959846,Minnes Kemp; Mor Mia,9990,0,9999,9
1746561881444,CSS 201S,A01,892054,Mignozzetti; Umberto,26,0,30,4
1746561882472,CSS 202S,A01,892056,Mignozzetti; Umberto,26,0,30,4
1746561883495,DSC 197,001,956898,Eldridge; Justin Matthew,9996,0,9999,3
1746561884522,DSC 297,001,958000,Mazumdar; Arya,9998,0,9999,1
1746561884522,DSC 297,002,959862,Wang; Yusu,9998,0,9999,1
1746561885549,EAP 100,A00,905686,Staff,9778,0,9999,221
1746561886577,ECE 45,A01,892618,Staff,0,0,65,65
1746561888628,ECE 111,A01,892719,Staff,4,0,65,61
1746561889653,ECE 197,001,957920,Mercier; Patrick Philip,9991,0,9999,8
1746561890679,ECON 178,A01,907814,Zhu; Ying,26,0,35,9
1746561891707,EDS 115,A00,895312,Staff,35,0,45,10
1746561892734,EDS 117,A01,895337,Staff,23,0,30,7
1746561893760,EDS 125,A00,895341,Jones; Gabrielle Anastasia,36,0,45,9
1746561894784,EDS 128A,A01,895459,Fargason; Sharon Gayle,44,0,45,1
1746561895813,EDS 128B,A01,895543,Pappas; Elizabeth,44,0,45,1
1746561896842,EDS 139,A00,897203,Pappas; Elizabeth,44,0,45,1
1746561896842,EDS 139,B00,897209,Fargason; Sharon Gayle,41,0,45,4
1746561897869,EDS 201,A00,895545,Staff,22,0,45,23
1746561898898,EDS 203,A01,895581,Halter; Christopher P.,22,0,45,23
1746561899926,EDS 204R,A01,895625,Heinzman; Erica M.,39,0,45,6
1746561899926,EDS 204R,B01,895693,Halter; Christopher P.,10,0,45,35
1746561900954,EDS 206R,A00,895694,Fargason; Sharon Gayle,1,0,30,29
1746561900954,EDS 206R,B00,895695,Choi; Bailey Miyeon,16,0,30,14
1746561901984,EDS 250,A00,895697,Hemans; Patricia Ann Benitez,22,0,45,23
1746561903013,EDS 281,A00,895701,Meyerott; Theresa Ann,1,0,15,14
1746561904038,EDS 284,A00,895736,Meyerott; Theresa Ann,1,0,15,14
1746561905064,EDS 286,A00,897210,Fine; Sarah,0,0,15,15
1746561906091,EDS 289C,A01,895770,Daly; Alan J.,1,0,15,14
1746561907116,EDS 290,A00,897211,Hofstetter; Carolyn,0,0,15,15
1746561908141,LIGM 5A,A00,896162,Fischer-Grunski; Eva K,12,0,20,8
1746561909170,LIGM 5B,A00,896260,Fischer-Grunski; Eva K,17,0,20,3
1746561910202,LIGM 5C,A00,896308,Fischer-Grunski; Eva K,18,0,20,2
1746561911233,LIIT 5AS,A00,896313,Carnelos; Chiara,18,0,20,2
1746561912261,LIIT 5BS,A00,896416,Carnelos; Chiara,20,0,20,0
1746561913287,LIIT 5CS,A00,896564,Carnelos; Chiara,20,0,20,0
1746561914314,LISP 5A,A00,896588,Munoz Sanchez; Alicia,3,0,20,17
1746561915341,LISP 5B,A00,896653,Munoz Sanchez; Alicia,7,0,20,13
1746561916370,LISP 5C,A00,896655,Munoz Sanchez; Alicia,0,1,20,20
1746561917615,MAE 197,001,957918,Kleissl; Jan,9996,0,9999,3
1746561917615,MAE 197,002,959806,Boechler; Nicholas Sebastia,9998,0,9999,1
1746561917615,MAE 197,003,959852,Mullin; Jennifer S,9998,0,9999,1
1746561918640,MATH 2,A01,957937,Staff,33,0,35,2
1746561919669,MATH 197,001,957876,Kedlaya; Kiran S.,9993,0,9999,6
1746561920696,MCWP 40,A00,892729,Duru; Nur,10,0,20,10
1746561920696,MCWP 40,B00,893304,Montejo; Carolina,14,0,20,6
1746561921723,MCWP 40R,A00,893757,Redela; Pamela Morgan,0,5,20,20
1746561922749,MCWP 50,A00,893758,Morshed; Michael James,0,0,20,20
1746561922749,MCWP 50,B00,893761,Bartulis; Jason Michael,17,0,20,3
1746561923778,MCWP 50R,A00,893766,Compas; Sean Matthew,0,1,20,20
1746561923778,MCWP 50R,B00,893769,Carter; Jennifer A,0,1,20,20
1746561923778,MCWP 50R,C00,893771,Krone; Jarret,0,3,20,20
1746561923778,MCWP 50R,D00,893772,Miller; Elizabeth Deen,0,0,20,20
1746561923778,MCWP 50R,E00,893775,Carter; Andrea L,0,1,20,20
1746561924803,MMW 11R,A01,892721,Herbst; Matthew,11,0,27,16
1746561924803,MMW 11R,A02,892722,Herbst; Matthew,0,0,0,3
1746561925830,MMW 12R,A01,892724,Herbst; Matthew,0,11,16,16
1746561925830,MMW 12R,A02,892725,Herbst; Matthew,0,10,16,16
1746561926856,MMW 13R,A01,892727,Staff,0,4,16,16
1746561926856,MMW 13R,A02,892728,Staff,0,4,16,16
1746561926856,MMW 13R,A03,958032,Staff,0,4,16,16
1746561926856,MMW 13R,A04,958033,Staff,0,4,16,16
1746561926856,MMW 13R,A05,958034,Staff,0,4,16,16
1746561927885,SIO 295LS,A00,894015,Staff,5,0,25,20
1746561928912,SIO 295S,A00,894020,Staff,5,0,25,20
1746561929938,SIOC 290S,B01,958918,Merrifield; Mark A,14,0,30,16
1746561930964,SIOC 291S,B01,958922,Gabriel; Corey John,14,0,30,16
1746561931991,SOCI 117,A01,895339,Staff,3,0,5,2
1746561933018,WES 237B,A00,894149,Staff,11,0,20,9
1746561935081,AESE 279B,A00,891859,Staff,13,0,35,22
1746561936106,AIP 197,001,891854,Vespa; Emanuel Ignacio,9999,0,9999,0
1746561937132,ANTH 289S,A00,891856,Gagneux; Pascal,12,0,12,0
1746561938156,BENG 196,001,957946,Engler; Adam J.,9996,0,9999,3
1746561939180,BISP 197,001,959851,Wilhelm; James E.,9998,0,9999,1
1746561940205,CAT 124RS,A01,956906,Staff,6,0,25,19
1746561941231,CAT 125RS,A01,922013,Staff,6,0,25,19
1746561942257,CLRE 250,A00,891860,Morris; Sheldon,9995,0,9999,4
1746561944307,CLRE 251R,A00,907817,Mehta; Ravindra L.,9994,0,9999,5
1746561945331,CLRE 252,A00,891864,Cuomo; Raphael Eduardo,9993,0,9999,6
1746561946356,CLRE 253,A00,891867,Vaida; Florin,9994,0,9999,5
1746561946356,CLRE 253,B00,907819,Staff,9999,0,9999,0
1746561947383,CLRE 259,A00,891868,Patel; Hemal,9998,0,9999,1
1746561948410,CLRE 260,A00,891872,Cuomo; Raphael Eduardo,9999,0,9999,0
1746561949433,CLRE 297,001,891888,Cuomo; Raphael Eduardo,9999,0,9999,0
1746561950461,CSE 191,A00,958773,Minnes Kemp; Mor Mia,9995,0,9999,4
1746561951487,CSE 197,001,959846,Minnes Kemp; Mor Mia,9990,0,9999,9
1746561952518,CSS 201S,A01,892054,Mignozzetti; Umberto,26,0,30,4
1746561953553,CSS 202S,A01,892056,Mignozzetti; Umberto,26,0,30,4
1746561954577,DSC 197,001,956898,Eldridge; Justin Matthew,9996,0,9999,3
1746561955604,DSC 297,001,958000,Mazumdar; Arya,9998,0,9999,1
1746561955604,DSC 297,002,959862,Wang; Yusu,9998,0,9999,1
1746561956632,EAP 100,A00,905686,Staff,9778,0,9999,221
1746561957660,ECE 45,A01,892618,Staff,0,0,65,65
1746561959713,ECE 111,A01,892719,Staff,4,0,65,61
1746561960742,ECE 197,001,957920,Mercier; Patrick Philip,9991,0,9999,8
1746561961766,ECON 178,A01,907814,Zhu; Ying,26,0,35,9
1746561962794,EDS 115,A00,895312,Staff,35,0,45,10
1746561963822,EDS 117,A01,895337,Staff,23,0,30,7
1746561964853,EDS 125,A00,895341,Jones; Gabrielle Anastasia,36,0,45,9
1746561965878,EDS 128A,A01,895459,Fargason; Sharon Gayle,44,0,45,1
1746561966903,EDS 128B,A01,895543,Pappas; Elizabeth,44,0,45,1
1746561967927,EDS 139,A00,897203,Pappas; Elizabeth,44,0,45,1
1746561967927,EDS 139,B00,897209,Fargason; Sharon Gayle,41,0,45,4
1746561968954,EDS 201,A00,895545,Staff,22,0,45,23
1746561969979,EDS 203,A01,895581,Halter; Christopher P.,22,0,45,23
1746561971005,EDS 204R,A01,895625,Heinzman; Erica M.,39,0,45,6
1746561971005,EDS 204R,B01,895693,Halter; Christopher P.,10,0,45,35
1746561972030,EDS 206R,A00,895694,Fargason; Sharon Gayle,1,0,30,29
1746561972030,EDS 206R,B00,895695,Choi; Bailey Miyeon,16,0,30,14
1746561973054,EDS 250,A00,895697,Hemans; Patricia Ann Benitez,22,0,45,23
1746561974082,EDS 281,A00,895701,Meyerott; Theresa Ann,1,0,15,14
1746561975109,EDS 284,A00,895736,Meyerott; Theresa Ann,1,0,15,14
1746561976134,EDS 286,A00,897210,Fine; Sarah,0,0,15,15
1746561977162,EDS 289C,A01,895770,Daly; Alan J.,1,0,15,14
1746561978192,EDS 290,A00,897211,Hofstetter; Carolyn,0,0,15,15
1746561979218,LIGM 5A,A00,896162,Fischer-Grunski; Eva K,12,0,20,8
1746561980249,LIGM 5B,A00,896260,Fischer-Grunski; Eva K,17,0,20,3
1746561981274,LIGM 5C,A00,896308,Fischer-Grunski; Eva K,18,0,20,2
1746561982299,LIIT 5AS,A00,896313,Carnelos; Chiara,18,0,20,2
1746561983363,LIIT 5BS,A00,896416,Carnelos; Chiara,20,0,20,0
1746561984393,LIIT 5CS,A00,896564,Carnelos; Chiara,20,0,20,0
1746561985420,LISP 5A,A00,896588,Munoz Sanchez; Alicia,3,0,20,17
1746561986445,LISP 5B,A00,896653,Munoz Sanchez; Alicia,7,0,20,13
1746561987475,LISP 5C,A00,896655,Munoz Sanchez; Alicia,0,1,20,20
1746561988502,MAE 197,001,957918,Kleissl; Jan,9996,0,9999,3
1746561988502,MAE 197,002,959806,Boechler; Nicholas Sebastia,9998,0,9999,1
1746561988502,MAE 197,003,959852,Mullin; Jennifer S,9998,0,9999,1
1746561989529,MATH 2,A01,957937,Staff,33,0,35,2
1746561990557,MATH 197,001,957876,Kedlaya; Kiran S.,9993,0,9999,6
1746561991582,MCWP 40,A00,892729,Duru; Nur,10,0,20,10
1746561991582,MCWP 40,B00,893304,Montejo; Carolina,14,0,20,6
1746561992606,MCWP 40R,A00,893757,Redela; Pamela Morgan,0,5,20,20
1746561993635,MCWP 50,A00,893758,Morshed; Michael James,0,0,20,20
1746561993635,MCWP 50,B00,893761,Bartulis; Jason Michael,17,0,20,3
1746561994663,MCWP 50R,A00,893766,Compas; Sean Matthew,0,1,20,20
1746561994663,MCWP 50R,B00,893769,Carter; Jennifer A,0,1,20,20
1746561994663,MCWP 50R,C00,893771,Krone; Jarret,0,3,20,20
1746561994663,MCWP 50R,D00,893772,Miller; Elizabeth Deen,0,0,20,20
1746561994663,MCWP 50R,E00,893775,Carter; Andrea L,0,1,20,20
1746561995689,MMW 11R,A01,892721,Herbst; Matthew,11,0,27,16
1746561995689,MMW 11R,A02,892722,Herbst; Matthew,0,0,0,3
1746561996714,MMW 12R,A01,892724,Herbst; Matthew,0,11,16,16
1746561996714,MMW 12R,A02,892725,Herbst; Matthew,0,10,16,16
1746561997743,MMW 13R,A01,892727,Staff,0,4,16,16
1746561997743,MMW 13R,A02,892728,Staff,0,4,16,16
1746561997743,MMW 13R,A03,958032,Staff,0,4,16,16
1746561997743,MMW 13R,A04,958033,Staff,0,4,16,16
1746561997743,MMW 13R,A05,958034,Staff,0,4,16,16
1746561998768,SIO 295LS,A00,894015,Staff,5,0,25,20
1746561999795,SIO 295S,A00,894020,Staff,5,0,25,20
1746562000825,SIOC 290S,B01,958918,Merrifield; Mark A,14,0,30,16
1746562001850,SIOC 291S,B01,958922,Gabriel; Corey John,14,0,30,16
1746562002876,SOCI 117,A01,895339,Staff,3,0,5,2
1746562003901,WES 237B,A00,894149,Staff,11,0,20,9
1746562005958,AESE 279B,A00,891859,Staff,13,0,35,22
1746562006982,AIP 197,001,891854,Vespa; Emanuel Ignacio,9999,0,9999,0
1746562008007,ANTH 289S,A00,891856,Gagneux; Pascal,12,0,12,0
1746562009031,BENG 196,001,957946,Engler; Adam J.,9996,0,9999,3
1746562010058,BISP 197,001,959851,Wilhelm; James E.,9998,0,9999,1
1746562011082,CAT 124RS,A01,956906,Staff,6,0,25,19
1746562012106,CAT 125RS,A01,922013,Staff,6,0,25,19
1746562013130,CLRE 250,A00,891860,Morris; Sheldon,9995,0,9999,4
1746562015186,CLRE 251R,A00,907817,Mehta; Ravindra L.,9994,0,9999,5
1746562016214,CLRE 252,A00,891864,Cuomo; Raphael Eduardo,9993,0,9999,6
1746562017239,CLRE 253,A00,891867,Vaida; Florin,9994,0,9999,5
1746562017239,CLRE 253,B00,907819,Staff,9999,0,9999,0
1746562018265,CLRE 259,A00,891868,Patel; Hemal,9998,0,9999,1
1746562019292,CLRE 260,A00,891872,Cuomo; Raphael Eduardo,9999,0,9999,0
1746562020319,CLRE 297,001,891888,Cuomo; Raphael Eduardo,9999,0,9999,0
1746562021347,CSE 191,A00,958773,Minnes Kemp; Mor Mia,9995,0,9999,4
1746562022373,CSE 197,001,959846,Minnes Kemp; Mor Mia,9990,0,9999,9
1746562023403,CSS 201S,A01,892054,Mignozzetti; Umberto,26,0,30,4
1746562024431,CSS 202S,A01,892056,Mignozzetti; Umberto,26,0,30,4
1746562025454,DSC 197,001,956898,Eldridge; Justin Matthew,9996,0,9999,3
1746562026481,DSC 297,001,958000,Mazumdar; Arya,9998,0,9999,1
1746562026481,DSC 297,002,959862,Wang; Yusu,9998,0,9999,1
1746562027506,EAP 100,A00,905686,Staff,9778,0,9999,221
1746562028531,ECE 45,A01,892618,Staff,0,0,65,65
1746562030585,ECE 111,A01,892719,Staff,4,0,65,61
1746562031610,ECE 197,001,957920,Mercier; Patrick Philip,9991,0,9999,8
1746562032637,ECON 178,A01,907814,Zhu; Ying,26,0,35,9
1746562033663,EDS 115,A00,895312,Staff,35,0,45,10
1746562034690,EDS 117,A01,895337,Staff,23,0,30,7
1746562035714,EDS 125,A00,895341,Jones; Gabrielle Anastasia,36,0,45,9
1746562036741,EDS 128A,A01,895459,Fargason; Sharon Gayle,44,0,45,1
1746562037767,EDS 128B,A01,895543,Pappas; Elizabeth,44,0,45,1
1746562038792,EDS 139,A00,897203,Pappas; Elizabeth,44,0,45,1
1746562038792,EDS 139,B00,897209,Fargason; Sharon Gayle,41,0,45,4
1746562039818,EDS 201,A00,895545,Staff,22,0,45,23
1746562040842,EDS 203,A01,895581,Halter; Christopher P.,22,0,45,23
1746562041866,EDS 204R,A01,895625,Heinzman; Erica M.,39,0,45,6
1746562041866,EDS 204R,B01,895693,Halter; Christopher P.,10,0,45,35
1746562042892,EDS 206R,A00,895694,Fargason; Sharon Gayle,1,0,30,29
1746562042892,EDS 206R,B00,895695,Choi; Bailey Miyeon,16,0,30,14
1746562043918,EDS 250,A00,895697,Hemans; Patricia Ann Benitez,22,0,45,23
1746562044945,EDS 281,A00,895701,Meyerott; Theresa Ann,1,0,15,14
1746562045971,EDS 284,A00,895736,Meyerott; Theresa Ann,1,0,15,14
1746562046998,EDS 286,A00,897210,Fine; Sarah,0,0,15,15
1746562048022,EDS 289C,A01,895770,Daly; Alan J.,1,0,15,14
1746562049050,EDS 290,A00,897211,Hofstetter; Carolyn,0,0,15,15
1746562050074,LIGM 5A,A00,896162,Fischer-Grunski; Eva K,12,0,20,8
1746562051099,LIGM 5B,A00,896260,Fischer-Grunski; Eva K,17,0,20,3
1746562052125,LIGM 5C,A00,896308,Fischer-Grunski; Eva K,18,0,20,2
1746562053154,LIIT 5AS,A00,896313,Carnelos; Chiara,18,0,20,2
1746562054177,LIIT 5BS,A00,896416,Carnelos; Chiara,20,0,20,0
1746562055203,LIIT 5CS,A00,896564,Carnelos; Chiara,20,0,20,0
1746562056231,LISP 5A,A00,896588,Munoz Sanchez; Alicia,3,0,20,17
1746562057257,LISP 5B,A00,896653,Munoz Sanchez; Alicia,7,0,20,13
1746562058284,LISP 5C,A00,896655,Munoz Sanchez; Alicia,0,1,20,20
1746562059309,MAE 197,001,957918,Kleissl; Jan,9996,0,9999,3
1746562059309,MAE 197,002,959806,Boechler; Nicholas Sebastia,9998,0,9999,1
1746562059309,MAE 197,003,959852,Mullin; Jennifer S,9998,0,9999,1
1746562060335,MATH 2,A01,957937,Staff,33,0,35,2
1746562061363,MATH 197,001,957876,Kedlaya; Kiran S.,9993,0,9999,6
1746562062398,MCWP 40,A00,892729,Duru; Nur,10,0,20,10
1746562062398,MCWP 40,B00,893304,Montejo; Carolina,14,0,20,6
1746562063423,MCWP 40R,A00,893757,Redela; Pamela Morgan,0,5,20,20
1746562064450,MCWP 50,A00,893758,Morshed; Michael James,0,0,20,20
1746562064450,MCWP 50,B00,893761,Bartulis; Jason Michael,17,0,20,3
1746562065480,MCWP 50R,A00,893766,Compas; Sean Matthew,0,1,20,20
1746562065480,MCWP 50R,B00,893769,Carter; Jennifer A,0,1,20,20
1746562065480,MCWP 50R,C00,893771,Krone; Jarret,0,3,20,20
1746562065480,MCWP 50R,D00,893772,Miller; Elizabeth Deen,0,0,20,20
1746562065480,MCWP 50R,E00,893775,Carter; Andrea L,0,1,20,20
1746562066504,MMW 11R,A01,892721,Herbst; Matthew,11,0,27,16
1746562066504,MMW 11R,A02,892722,Herbst; Matthew,0,0,0,3
1746562067529,MMW 12R,A01,892724,Herbst; Matthew,0,11,16,16
1746562067529,MMW 12R,A02,892725,Herbst; Matthew,0,10,16,16
1746562068558,MMW 13R,A01,892727,Staff,0,4,16,16
1746562068558,MMW 13R,A02,892728,Staff,0,4,16,16
1746562068558,MMW 13R,A03,958032,Staff,0,4,16,16
1746562068558,MMW 13R,A04,958033,Staff,0,4,16,16
1746562068558,MMW 13R,A05,958034,Staff,0,4,16,16
1746562069588,SIO 295LS,A00,894015,Staff,5,0,25,20
1746562070618,SIO 295S,A00,894020,Staff,5,0,25,20
1746562071648,SIOC 290S,B01,958918,Merrifield; Mark A,14,0,30,16
1746562072674,SIOC 291S,B01,958922,Gabriel; Corey John,14,0,30,16
1746562073697,SOCI 117,A01,895339,Staff,3,0,5,2
1746562074725,WES 237B,A00,894149,Staff,11,0,20,9
1746562076782,AESE 279B,A00,891859,Staff,13,0,35,22
1746562077806,AIP 197,001,891854,Vespa; Emanuel Ignacio,9999,0,9999,0
1746562078833,ANTH 289S,A00,891856,Gagneux; Pascal,12,0,12,0
1746562079860,BENG 196,001,957946,Engler; Adam J.,9996,0,9999,3
1746562080883,BISP 197,001,959851,Wilhelm; James E.,9998,0,9999,1
1746562081910,CAT 124RS,A01,956906,Staff,6,0,25,19
1746562082937,CAT 125RS,A01,922013,Staff,6,0,25,19
1746562083961,CLRE 250,A00,891860,Morris; Sheldon,9995,0,9999,4
1746562086017,CLRE 251R,A00,907817,Mehta; Ravindra L.,9994,0,9999,5
1746562087046,CLRE 252,A00,891864,Cuomo; Raphael Eduardo,9993,0,9999,6
1746562088074,CLRE 253,A00,891867,Vaida; Florin,9994,0,9999,5
1746562088074,CLRE 253,B00,907819,Staff,9999,0,9999,0
1746562089101,CLRE 259,A00,891868,Patel; Hemal,9998,0,9999,1
1746562090127,CLRE 260,A00,891872,Cuomo; Raphael Eduardo,9999,0,9999,0
1746562091150,CLRE 297,001,891888,Cuomo; Raphael Eduardo,9999,0,9999,0
1746562092175,CSE 191,A00,958773,Minnes Kemp; Mor Mia,9995,0,9999,4
1746562093202,CSE 197,001,959846,Minnes Kemp; Mor Mia,9990,0,9999,9
1746562094227,CSS 201S,A01,892054,Mignozzetti; Umberto,26,0,30,4
1746562095252,CSS 202S,A01,892056,Mignozzetti; Umberto,26,0,30,4
1746562096277,DSC 197,001,956898,Eldridge; Justin Matthew,9996,0,9999,3
1746562097303,DSC 297,001,958000,Mazumdar; Arya,9998,0,9999,1
1746562097303,DSC 297,002,959862,Wang; Yusu,9998,0,9999,1
1746562098329,EAP 100,A00,905686,Staff,9778,0,9999,221
1746562099357,ECE 45,A01,892618,Staff,0,0,65,65
1746562101409,ECE 111,A01,892719,Staff,4,0,65,61
1746562102437,ECE 197,001,957920,Mercier; Patrick Philip,9991,0,9999,8
1746562103462,ECON 178,A01,907814,Zhu; Ying,26,0,35,9
1746562104486,EDS 115,A00,895312,Staff,35,0,45,10
1746562105511,EDS 117,A01,895337,Staff,23,0,30,7
1746562106538,EDS 125,A00,895341,Jones; Gabrielle Anastasia,36,0,45,9
1746562107571,EDS 128A,A01,895459,Fargason; Sharon Gayle,44,0,45,1
1746562108600,EDS 128B,A01,895543,Pappas; Elizabeth,44,0,45,1
1746562109627,EDS 139,A00,897203,Pappas; Elizabeth,44,0,45,1
1746562109627,EDS 139,B00,897209,Fargason; Sharon Gayle,41,0,45,4
1746562110655,EDS 201,A00,895545,Staff,22,0,45,23
1746562111682,EDS 203,A01,895581,Halter; Christopher P.,22,0,45,23
1746562112707,EDS 204R,A01,895625,Heinzman; Erica M.,39,0,45,6
1746562112707,EDS 204R,B01,895693,Halter; Christopher P.,10,0,45,35
1746562113733,EDS 206R,A00,895694,Fargason; Sharon Gayle,1,0,30,29
1746562113733,EDS 206R,B00,895695,Choi; Bailey Miyeon,16,0,30,14
1746562114761,EDS 250,A00,895697,Hemans; Patricia Ann Benitez,22,0,45,23
1746562115788,EDS 281,A00,895701,Meyerott; Theresa Ann,1,0,15,14
1746562116812,EDS 284,A00,895736,Meyerott; Theresa Ann,1,0,15,14
1746562117838,EDS 286,A00,897210,Fine; Sarah,0,0,15,15
1746562118863,EDS 289C,A01,895770,Daly; Alan J.,1,0,15,14
1746562119887,EDS 290,A00,897211,Hofstetter; Carolyn,0,0,15,15
1746562120917,LIGM 5A,A00,896162,Fischer-Grunski; Eva K,12,0,20,8
1746562121942,LIGM 5B,A00,896260,Fischer-Grunski; Eva K,17,0,20,3
1746562122967,LIGM 5C,A00,896308,Fischer-Grunski; Eva K,18,0,20,2
1746562123992,LIIT 5AS,A00,896313,Carnelos; Chiara,18,0,20,2
1746562125018,LIIT 5BS,A00,896416,Carnelos; Chiara,20,0,20,0
1746562126044,LIIT 5CS,A00,896564,Carnelos; Chiara,20,0,20,0
1746562127072,LISP 5A,A00,896588,Munoz Sanchez; Alicia,3,0,20,17
1746562128101,LISP 5B,A00,896653,Munoz Sanchez; Alicia,7,0,20,13
1746562129127,LISP 5C,A00,896655,Munoz Sanchez; Alicia,0,1,20,20
1746562130152,MAE 197,001,957918,Kleissl; Jan,9996,0,9999,3
1746562130152,MAE 197,002,959806,Boechler; Nicholas Sebastia,9998,0,9999,1
1746562130152,MAE 197,003,959852,Mullin; Jennifer S,9998,0,9999,1
1746562131180,MATH 2,A01,957937,Staff,33,0,35,2
1746562132207,MATH 197,001,957876,Kedlaya; Kiran S.,9993,0,9999,6
1746562133234,MCWP 40,A00,892729,Duru; Nur,10,0,20,10
1746562133234,MCWP 40,B00,893304,Montejo; Carolina,14,0,20,6
1746562134262,MCWP 40R,A00,893757,Redela; Pamela Morgan,0,5,20,20
1746562135287,MCWP 50,A00,893758,Morshed; Michael James,0,0,20,20
1746562135287,MCWP 50,B00,893761,Bartulis; Jason Michael,17,0,20,3
1746562136313,MCWP 50R,A00,893766,Compas; Sean Matthew,0,1,20,20
1746562136313,MCWP 50R,B00,893769,Carter; Jennifer A,0,1,20,20
1746562136313,MCWP 50R,C00,893771,Krone; Jarret,0,3,20,20
1746562136313,MCWP 50R,D00,893772,Miller; Elizabeth Deen,0,0,20,20
1746562136313,MCWP 50R,E00,893775,Carter; Andrea L,0,1,20,20
1746562137336,MMW 11R,A01,892721,Herbst; Matthew,11,0,27,16
1746562137336,MMW 11R,A02,892722,Herbst; Matthew,0,0,0,3
1746562138361,MMW 12R,A01,892724,Herbst; Matthew,0,11,16,16
1746562138361,MMW 12R,A02,892725,Herbst; Matthew,0,10,16,16
1746562139393,MMW 13R,A01,892727,Staff,0,4,16,16
1746562139393,MMW 13R,A02,892728,Staff,0,4,16,16
1746562139393,MMW 13R,A03,958032,Staff,0,4,16,16
1746562139393,MMW 13R,A04,958033,Staff,0,4,16,16
1746562139393,MMW 13R,A05,958034,Staff,0,4,16,16
1746562140420,SIO 295LS,A00,894015,Staff,5,0,25,20
1746562141451,SIO 295S,A00,894020,Staff,5,0,25,20
1746562142480,SIOC 290S,B01,958918,Merrifield; Mark A,14,0,30,16
1746562143505,SIOC 291S,B01,958922,Gabriel; Corey John,14,0,30,16
1746562144531,SOCI 117,A01,895339,Staff,3,0,5,2
1746562145558,WES 237B,A00,894149,Staff,11,0,20,9
1746562147612,AESE 279B,A00,891859,Staff,13,0,35,22
1746562148641,AIP 197,001,891854,Vespa; Emanuel Ignacio,9999,0,9999,0
1746562149665,ANTH 289S,A00,891856,Gagneux; Pascal,12,0,12,0
1746562150690,BENG 196,001,957946,Engler; Adam J.,9996,0,9999,3
1746562151718,BISP 197,001,959851,Wilhelm; James E.,9998,0,9999,1
1746562152745,CAT 124RS,A01,956906,Staff,6,0,25,19
1746562153772,CAT 125RS,A01,922013,Staff,6,0,25,19
1746562154798,CLRE 250,A00,891860,Morris; Sheldon,9995,0,9999,4
1746562156852,CLRE 251R,A00,907817,Mehta; Ravindra L.,9994,0,9999,5
1746562157878,CLRE 252,A00,891864,Cuomo; Raphael Eduardo,9993,0,9999,6
1746562158905,CLRE 253,A00,891867,Vaida; Florin,9994,0,9999,5
1746562158905,CLRE 253,B00,907819,Staff,9999,0,9999,0
1746562159930,CLRE 259,A00,891868,Patel; Hemal,9998,0,9999,1
1746562160955,CLRE 260,A00,891872,Cuomo; Raphael Eduardo,9999,0,9999,0
1746562161980,CLRE 297,001,891888,Cuomo; Raphael Eduardo,9999,0,9999,0
1746562163005,CSE 191,A00,958773,Minnes Kemp; Mor Mia,9995,0,9999,4
1746562164031,CSE 197,001,959846,Minnes Kemp; Mor Mia,9990,0,9999,9
1746562165057,CSS 201S,A01,892054,Mignozzetti; Umberto,26,0,30,4
1746562166086,CSS 202S,A01,892056,Mignozzetti; Umberto,26,0,30,4
1746562167112,DSC 197,001,956898,Eldridge; Justin Matthew,9996,0,9999,3
1746562168138,DSC 297,001,958000,Mazumdar; Arya,9998,0,9999,1
1746562168138,DSC 297,002,959862,Wang; Yusu,9998,0,9999,1
1746562169164,EAP 100,A00,905686,Staff,9778,0,9999,221
1746562170192,ECE 45,A01,892618,Staff,0,0,65,65
1746562172243,ECE 111,A01,892719,Staff,4,0,65,61
1746562173269,ECE 197,001,957920,Mercier; Patrick Philip,9991,0,9999,8
1746562174294,ECON 178,A01,907814,Zhu; Ying,26,0,35,9
1746562175322,EDS 115,A00,895312,Staff,35,0,45,10
1746562176350,EDS 117,A01,895337,Staff,23,0,30,7
1746562177377,EDS 125,A00,895341,Jones; Gabrielle Anastasia,36,0,45,9
1746562178405,EDS 128A,A01,895459,Fargason; Sharon Gayle,44,0,45,1
1746562179432,EDS 128B,A01,895543,Pappas; Elizabeth,44,0,45,1
1746562180459,EDS 139,A00,897203,Pappas; Elizabeth,44,0,45,1
1746562180459,EDS 139,B00,897209,Fargason; Sharon Gayle,41,0,45,4
1746562181489,EDS 201,A00,895545,Staff,22,0,45,23
1746562182516,EDS 203,A01,895581,Halter; Christopher P.,22,0,45,23
1746562183546,EDS 204R,A01,895625,Heinzman; Erica M.,39,0,45,6
1746562183546,EDS 204R,B01,895693,Halter; Christopher P.,10,0,45,35
1746562184573,EDS 206R,A00,895694,Fargason; Sharon Gayle,1,0,30,29
1746562184573,EDS 206R,B00,895695,Choi; Bailey Miyeon,16,0,30,14
1746562185598,EDS 250,A00,895697,Hemans; Patricia Ann Benitez,22,0,45,23
1746562186623,EDS 281,A00,895701,Meyerott; Theresa Ann,1,0,15,14
1746562187648,EDS 284,A00,895736,Meyerott; Theresa Ann,1,0,15,14
1746562188674,EDS 286,A00,897210,Fine; Sarah,0,0,15,15
1746562189699,EDS 289C,A01,895770,Daly; Alan J.,1,0,15,14
1746562190727,EDS 290,A00,897211,Hofstetter; Carolyn,0,0,15,15
1746562191758,LIGM 5A,A00,896162,Fischer-Grunski; Eva K,12,0,20,8
1746562192785,LIGM 5B,A00,896260,Fischer-Grunski; Eva K,17,0,20,3
1746562193810,LIGM 5C,A00,896308,Fischer-Grunski; Eva K,18,0,20,2
1746562194839,LIIT 5AS,A00,896313,Carnelos; Chiara,18,0,20,2
1746562195865,LIIT 5BS,A00,896416,Carnelos; Chiara,20,0,20,0
1746562196894,LIIT 5CS,A00,896564,Carnelos; Chiara,20,0,20,0
1746562197923,LISP 5A,A00,896588,Munoz Sanchez; Alicia,3,0,20,17
1746562198950,LISP 5B,A00,896653,Munoz Sanchez; Alicia,7,0,20,13
1746562199976,LISP 5C,A00,896655,Munoz Sanchez; Alicia,0,1,20,20
1746562201005,MAE 197,001,957918,Kleissl; Jan,9996,0,9999,3
1746562201005,MAE 197,002,959806,Boechler; Nicholas Sebastia,9998,0,9999,1
1746562201005,MAE 197,003,959852,Mullin; Jennifer S,9998,0,9999,1
1746562202032,MATH 2,A01,957937,Staff,33,0,35,2
1746562203058,MATH 197,001,957876,Kedlaya; Kiran S.,9993,0,9999,6
1746562204086,MCWP 40,A00,892729,Duru; Nur,10,0,20,10
1746562204086,MCWP 40,B00,893304,Montejo; Carolina,14,0,20,6
1746562205112,MCWP 40R,A00,893757,Redela; Pamela Morgan,0,5,20,20
1746562206139,MCWP 50,A00,893758,Morshed; Michael James,0,0,20,20
1746562206139,MCWP 50,B00,893761,Bartulis; Jason Michael,17,0,20,3
1746562207164,MCWP 50R,A00,893766,Compas; Sean Matthew,0,1,20,20
1746562207164,MCWP 50R,B00,893769,Carter; Jennifer A,0,1,20,20
1746562207164,MCWP 50R,C00,893771,Krone; Jarret,0,3,20,20
1746562207164,MCWP 50R,D00,893772,Miller; Elizabeth Deen,0,0,20,20
1746562207164,MCWP 50R,E00,893775,Carter; Andrea L,0,1,20,20
1746562208188,MMW 11R,A01,892721,Herbst; Matthew,11,0,27,16
1746562208188,MMW 11R,A02,892722,Herbst; Matthew,0,0,0,3
1746562209216,MMW 12R,A01,892724,Herbst; Matthew,0,11,16,16
1746562209216,MMW 12R,A02,892725,Herbst; Matthew,0,10,16,16
1746562210243,MMW 13R,A01,892727,Staff,0,4,16,16
1746562210243,MMW 13R,A02,892728,Staff,0,4,16,16
1746562210243,MMW 13R,A03,958032,Staff,0,4,16,16
1746562210243,MMW 13R,A04,958033,Staff,0,4,16,16
1746562210243,MMW 13R,A05,958034,Staff,0,4,16,16
1746562211271,SIO 295LS,A00,894015,Staff,5,0,25,20
1746562212295,SIO 295S,A00,894020,Staff,5,0,25,20
1746562213326,SIOC 290S,B01,958918,Merrifield; Mark A,14,0,30,16
1746562214353,SIOC 291S,B01,958922,Gabriel; Corey John,14,0,30,16
1746562215378,SOCI 117,A01,895339,Staff,3,0,5,2
1746562216404,WES 237B,A00,894149,Staff,11,0,20,9
1746562218476,AESE 279B,A00,891859,Staff,13,0,35,22
1746562219504,AIP 197,001,891854,Vespa; Emanuel Ignacio,9999,0,9999,0
1746562220529,ANTH 289S,A00,891856,Gagneux; Pascal,12,0,12,0
1746562221557,BENG 196,001,957946,Engler; Adam J.,9996,0,9999,3
1746562222585,BISP 197,001,959851,Wilhelm; James E.,9998,0,9999,1
1746562223614,CAT 124RS,A01,956906,Staff,6,0,25,19
1746562224641,CAT 125RS,A01,922013,Staff,6,0,25,19
1746562225665,CLRE 250,A00,891860,Morris; Sheldon,9995,0,9999,4
1746562227723,CLRE 251R,A00,907817,Mehta; Ravindra L.,9994,0,9999,5
1746562228747,CLRE 252,A00,891864,Cuomo; Raphael Eduardo,9993,0,9999,6
1746562229776,CLRE 253,A00,891867,Vaida; Florin,9994,0,9999,5
1746562229776,CLRE 253,B00,907819,Staff,9999,0,9999,0
1746562230804,CLRE 259,A00,891868,Patel; Hemal,9998,0,9999,1
1746562231829,CLRE 260,A00,891872,Cuomo; Raphael Eduardo,9999,0,9999,0
1746562232857,CLRE 297,001,891888,Cuomo; Raphael Eduardo,9999,0,9999,0
1746562233884,CSE 191,A00,958773,Minnes Kemp; Mor Mia,9995,0,9999,4
1746562234911,CSE 197,001,959846,Minnes Kemp; Mor Mia,9990,0,9999,9
1746562235939,CSS 201S,A01,892054,Mignozzetti; Umberto,26,0,30,4
1746562236964,CSS 202S,A01,892056,Mignozzetti; Umberto,26,0,30,4
1746562237989,DSC 197,001,956898,Eldridge; Justin Matthew,9996,0,9999,3
1746562239015,DSC 297,001,958000,Mazumdar; Arya,9998,0,9999,1
1746562239015,DSC 297,002,959862,Wang; Yusu,9998,0,9999,1
1746562240040,EAP 100,A00,905686,Staff,9778,0,9999,221
1746562241067,ECE 45,A01,892618,Staff,0,0,65,65
1746562243124,ECE 111,A01,892719,Staff,4,0,65,61
1746562244149,ECE 197,001,957920,Mercier; Patrick Philip,9991,0,9999,8
1746562245177,ECON 178,A01,907814,Zhu; Ying,26,0,35,9
1746562246202,EDS 115,A00,895312,Staff,35,0,45,10
1746562247229,EDS 117,A01,895337,Staff,23,0,30,7
1746562248253,EDS 125,A00,895341,Jones; Gabrielle Anastasia,36,0,45,9
1746562249277,EDS 128A,A01,895459,Fargason; Sharon Gayle,44,0,45,1
1746562250301,EDS 128B,A01,895543,Pappas; Elizabeth,44,0,45,1
1746562251329,EDS 139,A00,897203,Pappas; Elizabeth,44,0,45,1
1746562251329,EDS 139,B00,897209,Fargason; Sharon Gayle,41,0,45,4
1746562252355,EDS 201,A00,895545,Staff,22,0,45,23
1746562253406,EDS 203,A01,895581,Halter; Christopher P.,22,0,45,23
1746562254431,EDS 204R,A01,895625,Heinzman; Erica M.,39,0,45,6
1746562254431,EDS 204R,B01,895693,Halter; Christopher P.,10,0,45,35
1746562255458,EDS 206R,A00,895694,Fargason; Sharon Gayle,1,0,30,29
1746562255458,EDS 206R,B00,895695,Choi; Bailey Miyeon,16,0,30,14
1746562256483,EDS 250,A00,895697,Hemans; Patricia Ann Benitez,22,0,45,23
1746562257510,EDS 281,A00,895701,Meyerott; Theresa Ann,1,0,15,14
1746562258536,EDS 284,A00,895736,Meyerott; Theresa Ann,1,0,15,14
1746562259562,EDS 286,A00,897210,Fine; Sarah,0,0,15,15
1746562260587,EDS 289C,A01,895770,Daly; Alan J.,1,0,15,14
1746562261612,EDS 290,A00,897211,Hofstetter; Carolyn,0,0,15,15
1746562262638,LIGM 5A,A00,896162,Fischer-Grunski; Eva K,12,0,20,8
1746562263662,LIGM 5B,A00,896260,Fischer-Grunski; Eva K,17,0,20,3
1746562264688,LIGM 5C,A00,896308,Fischer-Grunski; Eva K,18,0,20,2
1746562265714,LIIT 5AS,A00,896313,Carnelos; Chiara,18,0,20,2
1746562266742,LIIT 5BS,A00,896416,Carnelos; Chiara,20,0,20,0
1746562267770,LIIT 5CS,A00,896564,Carnelos; Chiara,20,0,20,0
1746562268794,LISP 5A,A00,896588,Munoz Sanchez; Alicia,3,0,20,17
1746562269820,LISP 5B,A00,896653,Munoz Sanchez; Alicia,7,0,20,13
1746562270847,LISP 5C,A00,896655,Munoz Sanchez; Alicia,0,1,20,20
1746562271874,MAE 197,001,957918,Kleissl; Jan,9996,0,9999,3
1746562271874,MAE 197,002,959806,Boechler; Nicholas Sebastia,9998,0,9999,1
1746562271874,MAE 197,003,959852,Mullin; Jennifer S,9998,0,9999,1
1746562272898,MATH 2,A01,957937,Staff,33,0,35,2
1746562273926,MATH 197,001,957876,Kedlaya; Kiran S.,9993,0,9999,6
1746562274950,MCWP 40,A00,892729,Duru; Nur,10,0,20,10
1746562274950,MCWP 40,B00,893304,Montejo; Carolina,14,0,20,6
1746562275978,MCWP 40R,A00,893757,Redela; Pamela Morgan,0,5,20,20
1746562277002,MCWP 50,A00,893758,Morshed; Michael James,0,0,20,20
1746562277002,MCWP 50,B00,893761,Bartulis; Jason Michael,17,0,20,3
1746562278031,MCWP 50R,A00,893766,Compas; Sean Matthew,0,1,20,20
1746562278031,MCWP 50R,B00,893769,Carter; Jennifer A,0,1,20,20
1746562278031,MCWP 50R,C00,893771,Krone; Jarret,0,3,20,20
1746562278031,MCWP 50R,D00,893772,Miller; Elizabeth Deen,0,0,20,20
1746562278031,MCWP 50R,E00,893775,Carter; Andrea L,0,1,20,20
1746562279056,MMW 11R,A01,892721,Herbst; Matthew,11,0,27,16
1746562279056,MMW 11R,A02,892722,Herbst; Matthew,0,0,0,3
1746562280083,MMW 12R,A01,892724,Herbst; Matthew,0,11,16,16
1746562280083,MMW 12R,A02,892725,Herbst; Matthew,0,10,16,16
1746562281108,MMW 13R,A01,892727,Staff,0,4,16,16
1746562281108,MMW 13R,A02,892728,Staff,0,4,16,16
1746562281108,MMW 13R,A03,958032,Staff,0,4,16,16
1746562281108,MMW 13R,A04,958033,Staff,0,4,16,16
1746562281108,MMW 13R,A05,958034,Staff,0,4,16,16
1746562282136,SIO 295LS,A00,894015,Staff,5,0,25,20
1746562283162,SIO 295S,A00,894020,Staff,5,0,25,20
1746562284191,SIOC 290S,B01,958918,Merrifield; Mark A,14,0,30,16
1746562285217,SIOC 291S,B01,958922,Gabriel; Corey John,14,0,30,16
1746562286243,SOCI 117,A01,895339,Staff,3,0,5,2
1746562287267,WES 237B,A00,894149,Staff,11,0,20,9
1746562289334,AESE 279B,A00,891859,Staff,13,0,35,22
1746562290359,AIP 197,001,891854,Vespa; Emanuel Ignacio,9999,0,9999,0
1746562291385,ANTH 289S,A00,891856,Gagneux; Pascal,12,0,12,0
1746562292424,BENG 196,001,957946,Engler; Adam J.,9996,0,9999,3
1746562293448,BISP 197,001,959851,Wilhelm; James E.,9998,0,9999,1
1746562294471,CAT 124RS,A01,956906,Staff,6,0,25,19
1746562295497,CAT 125RS,A01,922013,Staff,6,0,25,19
1746562296522,CLRE 250,A00,891860,Morris; Sheldon,9995,0,9999,4
1746562298574,CLRE 251R,A00,907817,Mehta; Ravindra L.,9994,0,9999,5
1746562299598,CLRE 252,A00,891864,Cuomo; Raphael Eduardo,9993,0,9999,6
1746562300623,CLRE 253,A00,891867,Vaida; Florin,9994,0,9999,5
1746562300623,CLRE 253,B00,907819,Staff,9999,0,9999,0
1746562301647,CLRE 259,A00,891868,Patel; Hemal,9998,0,9999,1
1746562302672,CLRE 260,A00,891872,Cuomo; Raphael Eduardo,9999,0,9999,0
1746562303696,CLRE 297,001,891888,Cuomo; Raphael Eduardo,9999,0,9999,0
1746562304721,CSE 191,A00,958773,Minnes Kemp; Mor Mia,9995,0,9999,4
1746562305748,CSE 197,001,959846,Minnes Kemp; Mor Mia,9990,0,9999,9
1746562306773,CSS 201S,A01,892054,Mignozzetti; Umberto,26,0,30,4
1746562307798,CSS 202S,A01,892056,Mignozzetti; Umberto,26,0,30,4
1746562308826,DSC 197,001,956898,Eldridge; Justin Matthew,9996,0,9999,3
1746562309856,DSC 297,001,958000,Mazumdar; Arya,9998,0,9999,1
1746562309856,DSC 297,002,959862,Wang; Yusu,9998,0,9999,1
1746562310883,EAP 100,A00,905686,Staff,9778,0,9999,221
1746562311908,ECE 45,A01,892618,Staff,0,0,65,65
1746562313958,ECE 111,A01,892719,Staff,4,0,65,61
1746562314987,ECE 197,001,957920,Mercier; Patrick Philip,9991,0,9999,8
1746562316012,ECON 178,A01,907814,Zhu; Ying,26,0,35,9
1746562317040,EDS 115,A00,895312,Staff,35,0,45,10
1746562318068,EDS 117,A01,895337,Staff,23,0,30,7
1746562319092,EDS 125,A00,895341,Jones; Gabrielle Anastasia,36,0,45,9
1746562320119,EDS 128A,A01,895459,Fargason; Sharon Gayle,44,0,45,1
1746562321143,EDS 128B,A01,895543,Pappas; Elizabeth,44,0,45,1
1746562322169,EDS 139,A00,897203,Pappas; Elizabeth,44,0,45,1
1746562322169,EDS 139,B00,897209,Fargason; Sharon Gayle,41,0,45,4
1746562323195,EDS 201,A00,895545,Staff,22,0,45,23
1746562324219,EDS 203,A01,895581,Halter; Christopher P.,22,0,45,23
1746562325248,EDS 204R,A01,895625,Heinzman; Erica M.,39,0,45,6
1746562325248,EDS 204R,B01,895693,Halter; Christopher P.,10,0,45,35
1746562326275,EDS 206R,A00,895694,Fargason; Sharon Gayle,1,0,30,29
1746562326275,EDS 206R,B00,895695,Choi; Bailey Miyeon,16,0,30,14
1746562327300,EDS 250,A00,895697,Hemans; Patricia Ann Benitez,22,0,45,23
1746562328328,EDS 281,A00,895701,Meyerott; Theresa Ann,1,0,15,14
1746562329353,EDS 284,A00,895736,Meyerott; Theresa Ann,1,0,15,14
1746562330381,EDS 286,A00,897210,Fine; Sarah,0,0,15,15
1746562331407,EDS 289C,A01,895770,Daly; Alan J.,1,0,15,14
1746562332432,EDS 290,A00,897211,Hofstetter; Carolyn,0,0,15,15
1746562333458,LIGM 5A,A00,896162,Fischer-Grunski; Eva K,12,0,20,8
1746562334484,LIGM 5B,A00,896260,Fischer-Grunski; Eva K,17,0,20,3
1746562335510,LIGM 5C,A00,896308,Fischer-Grunski; Eva K,18,0,20,2
1746562336536,LIIT 5AS,A00,896313,Carnelos; Chiara,18,0,20,2
1746562337561,LIIT 5BS,A00,896416,Carnelos; Chiara,20,0,20,0
1746562338586,LIIT 5CS,A00,896564,Carnelos; Chiara,20,0,20,0
1746562339611,LISP 5A,A00,896588,Munoz Sanchez; Alicia,3,0,20,17
1746562340637,LISP 5B,A00,896653,Munoz Sanchez; Alicia,7,0,20,13
1746562341662,LISP 5C,A00,896655,Munoz Sanchez; Alicia,0,1,20,20
1746562342690,MAE 197,001,957918,Kleissl; Jan,9996,0,9999,3
1746562342690,MAE 197,002,959806,Boechler; Nicholas Sebastia,9998,0,9999,1
1746562342690,MAE 197,003,959852,Mullin; Jennifer S,9998,0,9999,1
1746562343718,MATH 2,A01,957937,Staff,33,0,35,2
1746562344745,MATH 197,001,957876,Kedlaya; Kiran S.,9993,0,9999,6
1746562345774,MCWP 40,A00,892729,Duru; Nur,10,0,20,10
1746562345774,MCWP 40,B00,893304,Montejo; Carolina,14,0,20,6
1746562346801,MCWP 40R,A00,893757,Redela; Pamela Morgan,0,5,20,20
1746562347826,MCWP 50,A00,893758,Morshed; Michael James,0,0,20,20
1746562347826,MCWP 50,B00,893761,Bartulis; Jason Michael,17,0,20,3
1746562348853,MCWP 50R,A00,893766,Compas; Sean Matthew,0,1,20,20
1746562348853,MCWP 50R,B00,893769,Carter; Jennifer A,0,1,20,20
1746562348853,MCWP 50R,C00,893771,Krone; Jarret,0,3,20,20
1746562348853,MCWP 50R,D00,893772,Miller; Elizabeth Deen,0,0,20,20
1746562348853,MCWP 50R,E00,893775,Carter; Andrea L,0,1,20,20
1746562349877,MMW 11R,A01,892721,Herbst; Matthew,11,0,27,16
1746562349877,MMW 11R,A02,892722,Herbst; Matthew,0,0,0,3
1746562350903,MMW 12R,A01,892724,Herbst; Matthew,0,11,16,16
1746562350903,MMW 12R,A02,892725,Herbst; Matthew,0,10,16,16
1746562351928,MMW 13R,A01,892727,Staff,0,4,16,16
1746562351928,MMW 13R,A02,892728,Staff,0,4,16,16
1746562351928,MMW 13R,A03,958032,Staff,0,4,16,16
1746562351928,MMW 13R,A04,958033,Staff,0,4,16,16
1746562351928,MMW 13R,A05,958034,Staff,0,4,16,16
1746562352956,SIO 295LS,A00,894015,Staff,5,0,25,20
1746562353984,SIO 295S,A00,894020,Staff,5,0,25,20
1746562355010,SIOC 290S,B01,958918,Merrifield; Mark A,14,0,30,16
1746562356039,SIOC 291S,B01,958922,Gabriel; Corey John,14,0,30,16
1746562357066,SOCI 117,A01,895339,Staff,3,0,5,2
1746562358091,WES 237B,A00,894149,Staff,11,0,20,9
1746562360152,AESE 279B,A00,891859,Staff,13,0,35,22
1746562361177,AIP 197,001,891854,Vespa; Emanuel Ignacio,9999,0,9999,0
1746562362201,ANTH 289S,A00,891856,Gagneux; Pascal,12,0,12,0
1746562363225,BENG 196,001,957946,Engler; Adam J.,9996,0,9999,3
1746562364250,BISP 197,001,959851,Wilhelm; James E.,9998,0,9999,1
1746562365286,CAT 124RS,A01,956906,Staff,6,0,25,19
1746562366312,CAT 125RS,A01,922013,Staff,6,0,25,19
1746562367336,CLRE 250,A00,891860,Morris; Sheldon,9995,0,9999,4
1746562369388,CLRE 251R,A00,907817,Mehta; Ravindra L.,9994,0,9999,5
1746562370418,CLRE 252,A00,891864,Cuomo; Raphael Eduardo,9993,0,9999,6
1746562371443,CLRE 253,A00,891867,Vaida; Florin,9994,0,9999,5
1746562371443,CLRE 253,B00,907819,Staff,9999,0,9999,0
1746562372470,CLRE 259,A00,891868,Patel; Hemal,9998,0,9999,1
1746562373498,CLRE 260,A00,891872,Cuomo; Raphael Eduardo,9999,0,9999,0
1746562374524,CLRE 297,001,891888,Cuomo; Raphael Eduardo,9999,0,9999,0
1746562375552,CSE 191,A00,958773,Minnes Kemp; Mor Mia,9995,0,9999,4
1746562376578,CSE 197,001,959846,Minnes Kemp; Mor Mia,9990,0,9999,9
1746562377604,CSS 201S,A01,892054,Mignozzetti; Umberto,26,0,30,4
1746562378629,CSS 202S,A01,892056,Mignozzetti; Umberto,26,0,30,4
1746562379655,DSC 197,001,956898,Eldridge; Justin Matthew,9996,0,9999,3
1746562380680,DSC 297,001,958000,Mazumdar; Arya,9998,0,9999,1
1746562380680,DSC 297,002,959862,Wang; Yusu,9998,0,9999,1
1746562381707,EAP 100,A00,905686,Staff,9778,0,9999,221
1746562382735,ECE 45,A01,892618,Staff,0,0,65,65
1746562384785,ECE 111,A01,892719,Staff,4,0,65,61
1746562385810,ECE 197,001,957920,Mercier; Patrick Philip,9991,0,9999,8
1746562386836,ECON 178,A01,907814,Zhu; Ying,26,0,35,9
1746562387863,EDS 115,A00,895312,Staff,35,0,45,10
1746562388887,EDS 117,A01,895337,Staff,23,0,30,7
1746562389911,EDS 125,A00,895341,Jones; Gabrielle Anastasia,36,0,45,9
1746562390936,EDS 128A,A01,895459,Fargason; Sharon Gayle,44,0,45,1
1746562391964,EDS 128B,A01,895543,Pappas; Elizabeth,44,0,45,1
1746562392992,EDS 139,A00,897203,Pappas; Elizabeth,44,0,45,1
1746562392992,EDS 139,B00,897209,Fargason; Sharon Gayle,41,0,45,4
1746562394020,EDS 201,A00,895545,Staff,22,0,45,23
1746562395048,EDS 203,A01,895581,Halter; Christopher P.,22,0,45,23
1746562396076,EDS 204R,A01,895625,Heinzman; Erica M.,39,0,45,6
1746562396076,EDS 204R,B01,895693,Halter; Christopher P.,10,0,45,35
1746562397105,EDS 206R,A00,895694,Fargason; Sharon Gayle,1,0,30,29
1746562397105,EDS 206R,B00,895695,Choi; Bailey Miyeon,16,0,30,14
1746562398130,EDS 250,A00,895697,Hemans; Patricia Ann Benitez,22,0,45,23
1746562399154,EDS 281,A00,895701,Meyerott; Theresa Ann,1,0,15,14
1746562400179,EDS 284,A00,895736,Meyerott; Theresa Ann,1,0,15,14
1746562401203,EDS 286,A00,897210,Fine; Sarah,0,0,15,15
1746562402228,EDS 289C,A01,895770,Daly; Alan J.,1,0,15,14
1746562403253,EDS 290,A00,897211,Hofstetter; Carolyn,0,0,15,15
1746562404277,LIGM 5A,A00,896162,Fischer-Grunski; Eva K,12,0,20,8
1746562405314,LIGM 5B,A00,896260,Fischer-Grunski; Eva K,17,0,20,3
1746562406338,LIGM 5C,A00,896308,Fischer-Grunski; Eva K,18,0,20,2
1746562407363,LIIT 5AS,A00,896313,Carnelos; Chiara,18,0,20,2
1746562408387,LIIT 5BS,A00,896416,Carnelos; Chiara,20,0,20,0
1746562409414,LIIT 5CS,A00,896564,Carnelos; Chiara,20,0,20,0
1746562410439,LISP 5A,A00,896588,Munoz Sanchez; Alicia,3,0,20,17
1746562411465,LISP 5B,A00,896653,Munoz Sanchez; Alicia,7,0,20,13
1746562412489,LISP 5C,A00,896655,Munoz Sanchez; Alicia,0,1,20,20
1746562413518,MAE 197,001,957918,Kleissl; Jan,9996,0,9999,3
1746562413518,MAE 197,002,959806,Boechler; Nicholas Sebastia,9998,0,9999,1
1746562413518,MAE 197,003,959852,Mullin; Jennifer S,9998,0,9999,1
1746562414542,MATH 2,A01,957937,Staff,33,0,35,2
1746562415568,MATH 197,001,957876,Kedlaya; Kiran S.,9993,0,9999,6
1746562416597,MCWP 40,A00,892729,Duru; Nur,10,0,20,10
1746562416597,MCWP 40,B00,893304,Montejo; Carolina,14,0,20,6
1746562417623,MCWP 40R,A00,893757,Redela; Pamela Morgan,0,5,20,20
1746562418648,MCWP 50,A00,893758,Morshed; Michael James,0,0,20,20
1746562418648,MCWP 50,B00,893761,Bartulis; Jason Michael,17,0,20,3
1746562419678,MCWP 50R,A00,893766,Compas; Sean Matthew,0,1,20,20
1746562419678,MCWP 50R,B00,893769,Carter; Jennifer A,0,1,20,20
1746562419678,MCWP 50R,C00,893771,Krone; Jarret,0,3,20,20
1746562419678,MCWP 50R,D00,893772,Miller; Elizabeth Deen,0,0,20,20
1746562419678,MCWP 50R,E00,893775,Carter; Andrea L,0,1,20,20
1746562420706,MMW 11R,A01,892721,Herbst; Matthew,11,0,27,16
1746562420706,MMW 11R,A02,892722,Herbst; Matthew,0,0,0,3
1746562421734,MMW 12R,A01,892724,Herbst; Matthew,0,11,16,16
1746562421734,MMW 12R,A02,892725,Herbst; Matthew,0,10,16,16
1746562422760,MMW 13R,A01,892727,Staff,0,4,16,16
1746562422760,MMW 13R,A02,892728,Staff,0,4,16,16
1746562422760,MMW 13R,A03,958032,Staff,0,4,16,16
1746562422760,MMW 13R,A04,958033,Staff,0,4,16,16
1746562422760,MMW 13R,A05,958034,Staff,0,4,16,16
1746562423785,SIO 295LS,A00,894015,Staff,5,0,25,20
1746562424810,SIO 295S,A00,894020,Staff,5,0,25,20
1746562425838,SIOC 290S,B01,958918,Merrifield; Mark A,14,0,30,16
1746562426863,SIOC 291S,B01,958922,Gabriel; Corey John,14,0,30,16
1746562427891,SOCI 117,A01,895339,Staff,3,0,5,2
1746562429000,WES 237B,A00,894149,Staff,11,0,20,9
1746562431084,AESE 279B,A00,891859,Staff,13,0,35,22
1746562432110,AIP 197,001,891854,Vespa; Emanuel Ignacio,9999,0,9999,0
1746562433136,ANTH 289S,A00,891856,Gagneux; Pascal,12,0,12,0
1746562434163,BENG 196,001,957946,Engler; Adam J.,9996,0,9999,3
1746562435193,BISP 197,001,959851,Wilhelm; James E.,9998,0,9999,1
1746562436220,CAT 124RS,A01,956906,Staff,6,0,25,19
1746562437245,CAT 125RS,A01,922013,Staff,6,0,25,19
1746562438270,CLRE 250,A00,891860,Morris; Sheldon,9995,0,9999,4
1746562440319,CLRE 251R,A00,907817,Mehta; Ravindra L.,9994,0,9999,5
1746562441347,CLRE 252,A00,891864,Cuomo; Raphael Eduardo,9993,0,9999,6
1746562442373,CLRE 253,A00,891867,Vaida; Florin,9994,0,9999,5
1746562442373,CLRE 253,B00,907819,Staff,9999,0,9999,0
1746562443401,CLRE 259,A00,891868,Patel; Hemal,9998,0,9999,1
1746562444429,CLRE 260,A00,891872,Cuomo; Raphael Eduardo,9999,0,9999,0
1746562445457,CLRE 297,001,891888,Cuomo; Raphael Eduardo,9999,0,9999,0
1746562446491,CSE 191,A00,958773,Minnes Kemp; Mor Mia,9995,0,9999,4
1746562447516,CSE 197,001,959846,Minnes Kemp; Mor Mia,9990,0,9999,9
1746562448542,CSS 201S,A01,892054,Mignozzetti; Umberto,26,0,30,4
1746562449571,CSS 202S,A01,892056,Mignozzetti; Umberto,26,0,30,4
1746562450596,DSC 197,001,956898,Eldridge; Justin Matthew,9996,0,9999,3
1746562451626,DSC 297,001,958000,Mazumdar; Arya,9998,0,9999,1
1746562451626,DSC 297,002,959862,Wang; Yusu,9998,0,9999,1
1746562452650,EAP 100,A00,905686,Staff,9778,0,9999,221
1746562453675,ECE 45,A01,892618,Staff,0,0,65,65
1746562455728,ECE 111,A01,892719,Staff,4,0,65,61
1746562456756,ECE 197,001,957920,Mercier; Patrick Philip,9991,0,9999,8
1746562457785,ECON 178,A01,907814,Zhu; Ying,26,0,35,9
1746562458814,EDS 115,A00,895312,Staff,35,0,45,10
1746562459842,EDS 117,A01,895337,Staff,23,0,30,7
1746562460871,EDS 125,A00,895341,Jones; Gabrielle Anastasia,36,0,45,9
1746562461902,EDS 128A,A01,895459,Fargason; Sharon Gayle,44,0,45,1
1746562462929,EDS 128B,A01,895543,Pappas; Elizabeth,44,0,45,1
1746562463958,EDS 139,A00,897203,Pappas; Elizabeth,44,0,45,1
1746562463958,EDS 139,B00,897209,Fargason; Sharon Gayle,41,0,45,4
1746562464982,EDS 201,A00,895545,Staff,22,0,45,23
1746562466007,EDS 203,A01,895581,Halter; Christopher P.,22,0,45,23
1746562467033,EDS 204R,A01,895625,Heinzman; Erica M.,39,0,45,6
1746562467033,EDS 204R,B01,895693,Halter; Christopher P.,10,0,45,35
1746562468058,EDS 206R,A00,895694,Fargason; Sharon Gayle,1,0,30,29
1746562468058,EDS 206R,B00,895695,Choi; Bailey Miyeon,16,0,30,14
1746562469082,EDS 250,A00,895697,Hemans; Patricia Ann Benitez,22,0,45,23
1746562470106,EDS 281,A00,895701,Meyerott; Theresa Ann,1,0,15,14
1746562471130,EDS 284,A00,895736,Meyerott; Theresa Ann,1,0,15,14
1746562472155,EDS 286,A00,897210,Fine; Sarah,0,0,15,15
1746562473180,EDS 289C,A01,895770,Daly; Alan J.,1,0,15,14
1746562474206,EDS 290,A00,897211,Hofstetter; Carolyn,0,0,15,15
1746562475232,LIGM 5A,A00,896162,Fischer-Grunski; Eva K,12,0,20,8
1746562476262,LIGM 5B,A00,896260,Fischer-Grunski; Eva K,17,0,20,3
1746562477287,LIGM 5C,A00,896308,Fischer-Grunski; Eva K,18,0,20,2
1746562478312,LIIT 5AS,A00,896313,Carnelos; Chiara,18,0,20,2
1746562479338,LIIT 5BS,A00,896416,Carnelos; Chiara,20,0,20,0
1746562480364,LIIT 5CS,A00,896564,Carnelos; Chiara,20,0,20,0
1746562481392,LISP 5A,A00,896588,Munoz Sanchez; Alicia,3,0,20,17
1746562482422,LISP 5B,A00,896653,Munoz Sanchez; Alicia,7,0,20,13
1746562483455,LISP 5C,A00,896655,Munoz Sanchez; Alicia,0,1,20,20
1746562484479,MAE 197,001,957918,Kleissl; Jan,9996,0,9999,3
1746562484479,MAE 197,002,959806,Boechler; Nicholas Sebastia,9998,0,9999,1
1746562484479,MAE 197,003,959852,Mullin; Jennifer S,9998,0,9999,1
1746562485510,MATH 2,A01,957937,Staff,33,0,35,2
1746562486537,MATH 197,001,957876,Kedlaya; Kiran S.,9993,0,9999,6
1746562487565,MCWP 40,A00,892729,Duru; Nur,10,0,20,10
1746562487565,MCWP 40,B00,893304,Montejo; Carolina,14,0,20,6
1746562488589,MCWP 40R,A00,893757,Redela; Pamela Morgan,0,5,20,20
1746562489613,MCWP 50,A00,893758,Morshed; Michael James,0,0,20,20
1746562489613,MCWP 50,B00,893761,Bartulis; Jason Michael,17,0,20,3
1746562490640,MCWP 50R,A00,893766,Compas; Sean Matthew,0,1,20,20
1746562490640,MCWP 50R,B00,893769,Carter; Jennifer A,0,1,20,20
1746562490640,MCWP 50R,C00,893771,Krone; Jarret,0,3,20,20
1746562490640,MCWP 50R,D00,893772,Miller; Elizabeth Deen,0,0,20,20
1746562490640,MCWP 50R,E00,893775,Carter; Andrea L,0,1,20,20
1746562491671,MMW 11R,A01,892721,Herbst; Matthew,11,0,27,16
1746562491671,MMW 11R,A02,892722,Herbst; Matthew,0,0,0,3
1746562492696,MMW 12R,A01,892724,Herbst; Matthew,0,11,16,16
1746562492696,MMW 12R,A02,892725,Herbst; Matthew,0,10,16,16
1746562493722,MMW 13R,A01,892727,Staff,0,4,16,16
1746562493722,MMW 13R,A02,892728,Staff,0,4,16,16
1746562493722,MMW 13R,A03,958032,Staff,0,4,16,16
1746562493722,MMW 13R,A04,958033,Staff,0,4,16,16
1746562493722,MMW 13R,A05,958034,Staff,0,4,16,16
1746562494753,SIO 295LS,A00,894015,Staff,5,0,25,20
1746562495778,SIO 295S,A00,894020,Staff,5,0,25,20
1746562496805,SIOC 290S,B01,958918,Merrifield; Mark A,14,0,30,16
1746562497831,SIOC 291S,B01,958922,Gabriel; Corey John,14,0,30,16
1746562498857,SOCI 117,A01,895339,Staff,3,0,5,2
1746562499882,WES 237B,A00,894149,Staff,11,0,20,9
1746562501944,AESE 279B,A00,891859,Staff,13,0,35,22
1746562502970,AIP 197,001,891854,Vespa; Emanuel Ignacio,9999,0,9999,0
1746562503999,ANTH 289S,A00,891856,Gagneux; Pascal,12,0,12,0
1746562505026,BENG 196,001,957946,Engler; Adam J.,9996,0,9999,3
1746562506052,BISP 197,001,959851,Wilhelm; James E.,9998,0,9999,1
1746562507079,CAT 124RS,A01,956906,Staff,6,0,25,19
1746562508104,CAT 125RS,A01,922013,Staff,6,0,25,19
1746562509134,CLRE 250,A00,891860,Morris; Sheldon,9995,0,9999,4
1746562511190,CLRE 251R,A00,907817,Mehta; Ravindra L.,9994,0,9999,5
1746562512214,CLRE 252,A00,891864,Cuomo; Raphael Eduardo,9993,0,9999,6
1746562513243,CLRE 253,A00,891867,Vaida; Florin,9994,0,9999,5
1746562513243,CLRE 253,B00,907819,Staff,9999,0,9999,0
1746562514271,CLRE 259,A00,891868,Patel; Hemal,9998,0,9999,1
1746562515298,CLRE 260,A00,891872,Cuomo; Raphael Eduardo,9999,0,9999,0
1746562516326,CLRE 297,001,891888,Cuomo; Raphael Eduardo,9999,0,9999,0
1746562517357,CSE 191,A00,958773,Minnes Kemp; Mor Mia,9995,0,9999,4
1746562518384,CSE 197,001,959846,Minnes Kemp; Mor Mia,9990,0,9999,9
1746562519412,CSS 201S,A01,892054,Mignozzetti; Umberto,26,0,30,4
1746562520438,CSS 202S,A01,892056,Mignozzetti; Umberto,26,0,30,4
1746562521461,DSC 197,001,956898,Eldridge; Justin Matthew,9996,0,9999,3
1746562522486,DSC 297,001,958000,Mazumdar; Arya,9998,0,9999,1
1746562522486,DSC 297,002,959862,Wang; Yusu,9998,0,9999,1
1746562523509,EAP 100,A00,905686,Staff,9778,0,9999,221
1746562524537,ECE 45,A01,892618,Staff,0,0,65,65
1746562526591,ECE 111,A01,892719,Staff,4,0,65,61
1746562527617,ECE 197,001,957920,Mercier; Patrick Philip,9991,0,9999,8
1746562528647,ECON 178,A01,907814,Zhu; Ying,26,0,35,9
1746562529674,EDS 115,A00,895312,Staff,35,0,45,10
1746562530704,EDS 117,A01,895337,Staff,23,0,30,7
1746562531730,EDS 125,A00,895341,Jones; Gabrielle Anastasia,36,0,45,9
1746562532755,EDS 128A,A01,895459,Fargason; Sharon Gayle,44,0,45,1
1746562533784,EDS 128B,A01,895543,Pappas; Elizabeth,44,0,45,1
1746562534811,EDS 139,A00,897203,Pappas; Elizabeth,44,0,45,1
1746562534811,EDS 139,B00,897209,Fargason; Sharon Gayle,41,0,45,4
1746562535837,EDS 201,A00,895545,Staff,22,0,45,23
1746562536863,EDS 203,A01,895581,Halter; Christopher P.,22,0,45,23
1746562537888,EDS 204R,A01,895625,Heinzman; Erica M.,39,0,45,6
1746562537888,EDS 204R,B01,895693,Halter; Christopher P.,10,0,45,35
1746562538920,EDS 206R,A00,895694,Fargason; Sharon Gayle,1,0,30,29
1746562538920,EDS 206R,B00,895695,Choi; Bailey Miyeon,16,0,30,14
1746562539946,EDS 250,A00,895697,Hemans; Patricia Ann Benitez,22,0,45,23
1746562540971,EDS 281,A00,895701,Meyerott; Theresa Ann,1,0,15,14
1746562541995,EDS 284,A00,895736,Meyerott; Theresa Ann,1,0,15,14
1746562543025,EDS 286,A00,897210,Fine; Sarah,0,0,15,15
1746562544051,EDS 289C,A01,895770,Daly; Alan J.,1,0,15,14
1746562545078,EDS 290,A00,897211,Hofstetter; Carolyn,0,0,15,15
1746562546103,LIGM 5A,A00,896162,Fischer-Grunski; Eva K,12,0,20,8
1746562547128,LIGM 5B,A00,896260,Fischer-Grunski; Eva K,17,0,20,3
1746562548155,LIGM 5C,A00,896308,Fischer-Grunski; Eva K,18,0,20,2
1746562549182,LIIT 5AS,A00,896313,Carnelos; Chiara,18,0,20,2
1746562550210,LIIT 5BS,A00,896416,Carnelos; Chiara,20,0,20,0
1746562551235,LIIT 5CS,A00,896564,Carnelos; Chiara,20,0,20,0
1746562552264,LISP 5A,A00,896588,Munoz Sanchez; Alicia,3,0,20,17
1746562553290,LISP 5B,A00,896653,Munoz Sanchez; Alicia,7,0,20,13
1746562554315,LISP 5C,A00,896655,Munoz Sanchez; Alicia,0,1,20,20
1746562555340,MAE 197,001,957918,Kleissl; Jan,9996,0,9999,3
1746562555340,MAE 197,002,959806,Boechler; Nicholas Sebastia,9998,0,9999,1
1746562555340,MAE 197,003,959852,Mullin; Jennifer S,9998,0,9999,1
1746562556367,MATH 2,A01,957937,Staff,33,0,35,2
1746562557393,MATH 197,001,957876,Kedlaya; Kiran S.,9993,0,9999,6
1746562558421,MCWP 40,A00,892729,Duru; Nur,10,0,20,10
1746562558421,MCWP 40,B00,893304,Montejo; Carolina,14,0,20,6
1746562559446,MCWP 40R,A00,893757,Redela; Pamela Morgan,0,5,20,20
1746562560472,MCWP 50,A00,893758,Morshed; Michael James,0,0,20,20
1746562560472,MCWP 50,B00,893761,Bartulis; Jason Michael,17,0,20,3
1746562561502,MCWP 50R,A00,893766,Compas; Sean Matthew,0,1,20,20
1746562561502,MCWP 50R,B00,893769,Carter; Jennifer A,0,1,20,20
1746562561502,MCWP 50R,C00,893771,Krone; Jarret,0,3,20,20
1746562561502,MCWP 50R,D00,893772,Miller; Elizabeth Deen,0,0,20,20
1746562561502,MCWP 50R,E00,893775,Carter; Andrea L,0,1,20,20
1746562562531,MMW 11R,A01,892721,Herbst; Matthew,11,0,27,16
1746562562531,MMW 11R,A02,892722,Herbst; Matthew,0,0,0,3
1746562563558,MMW 12R,A01,892724,Herbst; Matthew,0,11,16,16
1746562563558,MMW 12R,A02,892725,Herbst; Matthew,0,10,16,16
1746562564582,MMW 13R,A01,892727,Staff,0,4,16,16
1746562564582,MMW 13R,A02,892728,Staff,0,4,16,16
1746562564582,MMW 13R,A03,958032,Staff,0,4,16,16
1746562564582,MMW 13R,A04,958033,Staff,0,4,16,16
1746562564582,MMW 13R,A05,958034,Staff,0,4,16,16
1746562565609,SIO 295LS,A00,894015,Staff,5,0,25,20
1746562566634,SIO 295S,A00,894020,Staff,5,0,25,20
1746562567660,SIOC 290S,B01,958918,Merrifield; Mark A,14,0,30,16
1746562568687,SIOC 291S,B01,958922,Gabriel; Corey John,14,0,30,16
1746562569716,SOCI 117,A01,895339,Staff,3,0,5,2
1746562570740,WES 237B,A00,894149,Staff,11,0,20,9
1746562572798,AESE 279B,A00,891859,Staff,13,0,35,22
1746562573822,AIP 197,001,891854,Vespa; Emanuel Ignacio,9999,0,9999,0
1746562574852,ANTH 289S,A00,891856,Gagneux; Pascal,12,0,12,0
1746562575882,BENG 196,001,957946,Engler; Adam J.,9996,0,9999,3
1746562576906,BISP 197,001,959851,Wilhelm; James E.,9998,0,9999,1
1746562577932,CAT 124RS,A01,956906,Staff,6,0,25,19
1746562578960,CAT 125RS,A01,922013,Staff,6,0,25,19
1746562579988,CLRE 250,A00,891860,Morris; Sheldon,9995,0,9999,4
1746562582043,CLRE 251R,A00,907817,Mehta; Ravindra L.,9994,0,9999,5
1746562583068,CLRE 252,A00,891864,Cuomo; Raphael Eduardo,9993,0,9999,6
1746562584094,CLRE 253,A00,891867,Vaida; Florin,9994,0,9999,5
1746562584094,CLRE 253,B00,907819,Staff,9999,0,9999,0
1746562585124,CLRE 259,A00,891868,Patel; Hemal,9998,0,9999,1
1746562586148,CLRE 260,A00,891872,Cuomo; Raphael Eduardo,9999,0,9999,0
1746562587177,CLRE 297,001,891888,Cuomo; Raphael Eduardo,9999,0,9999,0
1746562588205,CSE 191,A00,958773,Minnes Kemp; Mor Mia,9995,0,9999,4
1746562589231,CSE 197,001,959846,Minnes Kemp; Mor Mia,9990,0,9999,9
1746562590256,CSS 201S,A01,892054,Mignozzetti; Umberto,26,0,30,4
1746562591285,CSS 202S,A01,892056,Mignozzetti; Umberto,26,0,30,4
1746562592311,DSC 197,001,956898,Eldridge; Justin Matthew,9996,0,9999,3
1746562593340,DSC 297,001,958000,Mazumdar; Arya,9998,0,9999,1
1746562593340,DSC 297,002,959862,Wang; Yusu,9998,0,9999,1
1746562594365,EAP 100,A00,905686,Staff,9778,0,9999,221
1746562595393,ECE 45,A01,892618,Staff,0,0,65,65
1746562597450,ECE 111,A01,892719,Staff,4,0,65,61
1746562598476,ECE 197,001,957920,Mercier; Patrick Philip,9991,0,9999,8
1746562599506,ECON 178,A01,907814,Zhu; Ying,26,0,35,9
1746562600533,EDS 115,A00,895312,Staff,35,0,45,10
1746562601557,EDS 117,A01,895337,Staff,23,0,30,7
1746562602582,EDS 125,A00,895341,Jones; Gabrielle Anastasia,36,0,45,9
1746562603608,EDS 128A,A01,895459,Fargason; Sharon Gayle,44,0,45,1
1746562604633,EDS 128B,A01,895543,Pappas; Elizabeth,44,0,45,1
1746562605660,EDS 139,A00,897203,Pappas; Elizabeth,44,0,45,1
1746562605660,EDS 139,B00,897209,Fargason; Sharon Gayle,41,0,45,4
1746562606684,EDS 201,A00,895545,Staff,22,0,45,23
1746562607710,EDS 203,A01,895581,Halter; Christopher P.,22,0,45,23
1746562608734,EDS 204R,A01,895625,Heinzman; Erica M.,39,0,45,6
1746562608734,EDS 204R,B01,895693,Halter; Christopher P.,10,0,45,35
1746562609764,EDS 206R,A00,895694,Fargason; Sharon Gayle,1,0,30,29
1746562609764,EDS 206R,B00,895695,Choi; Bailey Miyeon,16,0,30,14
1746562610790,EDS 250,A00,895697,Hemans; Patricia Ann Benitez,22,0,45,23
1746562611817,EDS 281,A00,895701,Meyerott; Theresa Ann,1,0,15,14
1746562612843,EDS 284,A00,895736,Meyerott; Theresa Ann,1,0,15,14
1746562613870,EDS 286,A00,897210,Fine; Sarah,0,0,15,15
1746562614897,EDS 289C,A01,895770,Daly; Alan J.,1,0,15,14
1746562615922,EDS 290,A00,897211,Hofstetter; Carolyn,0,0,15,15
1746562616946,LIGM 5A,A00,896162,Fischer-Grunski; Eva K,12,0,20,8
1746562617974,LIGM 5B,A00,896260,Fischer-Grunski; Eva K,17,0,20,3
1746562619001,LIGM 5C,A00,896308,Fischer-Grunski; Eva K,18,0,20,2
1746562620029,LIIT 5AS,A00,896313,Carnelos; Chiara,18,0,20,2
1746562621060,LIIT 5BS,A00,896416,Carnelos; Chiara,20,0,20,0
1746562622086,LIIT 5CS,A00,896564,Carnelos; Chiara,20,0,20,0
1746562623113,LISP 5A,A00,896588,Munoz Sanchez; Alicia,3,0,20,17
1746562624139,LISP 5B,A00,896653,Munoz Sanchez; Alicia,7,0,20,13
1746562625166,LISP 5C,A00,896655,Munoz Sanchez; Alicia,0,1,20,20
1746562626195,MAE 197,001,957918,Kleissl; Jan,9996,0,9999,3
1746562626195,MAE 197,002,959806,Boechler; Nicholas Sebastia,9998,0,9999,1
1746562626195,MAE 197,003,959852,Mullin; Jennifer S,9998,0,9999,1
1746562627221,MATH 2,A01,957937,Staff,33,0,35,2
1746562628244,MATH 197,001,957876,Kedlaya; Kiran S.,9993,0,9999,6
1746562629272,MCWP 40,A00,892729,Duru; Nur,10,0,20,10
1746562629272,MCWP 40,B00,893304,Montejo; Carolina,14,0,20,6
1746562630301,MCWP 40R,A00,893757,Redela; Pamela Morgan,0,5,20,20
1746562631330,MCWP 50,A00,893758,Morshed; Michael James,0,0,20,20
1746562631330,MCWP 50,B00,893761,Bartulis; Jason Michael,17,0,20,3
1746562632355,MCWP 50R,A00,893766,Compas; Sean Matthew,0,1,20,20
1746562632355,MCWP 50R,B00,893769,Carter; Jennifer A,0,1,20,20
1746562632355,MCWP 50R,C00,893771,Krone; Jarret,0,3,20,20
1746562632355,MCWP 50R,D00,893772,Miller; Elizabeth Deen,0,0,20,20
1746562632355,MCWP 50R,E00,893775,Carter; Andrea L,0,1,20,20
1746562633379,MMW 11R,A01,892721,Herbst; Matthew,11,0,27,16
1746562633379,MMW 11R,A02,892722,Herbst; Matthew,0,0,0,3
1746562634404,MMW 12R,A01,892724,Herbst; Matthew,0,11,16,16
1746562634404,MMW 12R,A02,892725,Herbst; Matthew,0,10,16,16
1746562635430,MMW 13R,A01,892727,Staff,0,4,16,16
1746562635430,MMW 13R,A02,892728,Staff,0,4,16,16
1746562635430,MMW 13R,A03,958032,Staff,0,4,16,16
1746562635430,MMW 13R,A04,958033,Staff,0,4,16,16
1746562635430,MMW 13R,A05,958034,Staff,0,4,16,16
1746562636454,SIO 295LS,A00,894015,Staff,5,0,25,20
1746562637480,SIO 295S,A00,894020,Staff,5,0,25,20
1746562638506,SIOC 290S,B01,958918,Merrifield; Mark A,14,0,30,16
1746562639532,SIOC 291S,B01,958922,Gabriel; Corey John,14,0,30,16
1746562640557,SOCI 117,A01,895339,Staff,3,0,5,2
1746562641582,WES 237B,A00,894149,Staff,11,0,20,9
1746562643640,AESE 279B,A00,891859,Staff,13,0,35,22
1746562644667,AIP 197,001,891854,Vespa; Emanuel Ignacio,9999,0,9999,0
1746562645693,ANTH 289S,A00,891856,Gagneux; Pascal,12,0,12,0
1746562646717,BENG 196,001,957946,Engler; Adam J.,9996,0,9999,3
1746562647745,BISP 197,001,959851,Wilhelm; James E.,9998,0,9999,1
1746562648771,CAT 124RS,A01,956906,Staff,6,0,25,19
1746562649798,CAT 125RS,A01,922013,Staff,6,0,25,19
1746562650824,CLRE 250,A00,891860,Morris; Sheldon,9995,0,9999,4
1746562652879,CLRE 251R,A00,907817,Mehta; Ravindra L.,9994,0,9999,5
1746562653908,CLRE 252,A00,891864,Cuomo; Raphael Eduardo,9993,0,9999,6
1746562654933,CLRE 253,A00,891867,Vaida; Florin,9994,0,9999,5
1746562654933,CLRE 253,B00,907819,Staff,9999,0,9999,0
1746562655960,CLRE 259,A00,891868,Patel; Hemal,9998,0,9999,1
1746562656985,CLRE 260,A00,891872,Cuomo; Raphael Eduardo,9999,0,9999,0
1746562658010,CLRE 297,001,891888,Cuomo; Raphael Eduardo,9999,0,9999,0
1746562659039,CSE 191,A00,958773,Minnes Kemp; Mor Mia,9995,0,9999,4
1746562660064,CSE 197,001,959846,Minnes Kemp; Mor Mia,9990,0,9999,9
1746562661090,CSS 201S,A01,892054,Mignozzetti; Umberto,26,0,30,4
1746562662115,CSS 202S,A01,892056,Mignozzetti; Umberto,26,0,30,4
1746562663142,DSC 197,001,956898,Eldridge; Justin Matthew,9996,0,9999,3
1746562664172,DSC 297,001,958000,Mazumdar; Arya,9998,0,9999,1
1746562664172,DSC 297,002,959862,Wang; Yusu,9998,0,9999,1
1746562665198,EAP 100,A00,905686,Staff,9778,0,9999,221
1746562666223,ECE 45,A01,892618,Staff,0,0,65,65
1746562668274,ECE 111,A01,892719,Staff,4,0,65,61
1746562669297,ECE 197,001,957920,Mercier; Patrick Philip,9991,0,9999,8
1746562670325,ECON 178,A01,907814,Zhu; Ying,26,0,35,9
1746562671354,EDS 115,A00,895312,Staff,35,0,45,10
1746562672382,EDS 117,A01,895337,Staff,23,0,30,7
1746562673410,EDS 125,A00,895341,Jones; Gabrielle Anastasia,36,0,45,9
1746562674438,EDS 128A,A01,895459,Fargason; Sharon Gayle,44,0,45,1
1746562675464,EDS 128B,A01,895543,Pappas; Elizabeth,44,0,45,1
1746562676490,EDS 139,A00,897203,Pappas; Elizabeth,44,0,45,1
1746562676490,EDS 139,B00,897209,Fargason; Sharon Gayle,41,0,45,4
1746562677514,EDS 201,A00,895545,Staff,22,0,45,23
1746562678539,EDS 203,A01,895581,Halter; Christopher P.,22,0,45,23
1746562679565,EDS 204R,A01,895625,Heinzman; Erica M.,39,0,45,6
1746562679565,EDS 204R,B01,895693,Halter; Christopher P.,10,0,45,35
1746562680593,EDS 206R,A00,895694,Fargason; Sharon Gayle,1,0,30,29
1746562680593,EDS 206R,B00,895695,Choi; Bailey Miyeon,16,0,30,14
1746562681621,EDS 250,A00,895697,Hemans; Patricia Ann Benitez,22,0,45,23
1746562682645,EDS 281,A00,895701,Meyerott; Theresa Ann,1,0,15,14
1746562683674,EDS 284,A00,895736,Meyerott; Theresa Ann,1,0,15,14
1746562684698,EDS 286,A00,897210,Fine; Sarah,0,0,15,15
1746562685722,EDS 289C,A01,895770,Daly; Alan J.,1,0,15,14
1746562686749,EDS 290,A00,897211,Hofstetter; Carolyn,0,0,15,15
1746562687777,LIGM 5A,A00,896162,Fischer-Grunski; Eva K,12,0,20,8
1746562688807,LIGM 5B,A00,896260,Fischer-Grunski; Eva K,17,0,20,3
1746562689836,LIGM 5C,A00,896308,Fischer-Grunski; Eva K,18,0,20,2
1746562690866,LIIT 5AS,A00,896313,Carnelos; Chiara,18,0,20,2
1746562691892,LIIT 5BS,A00,896416,Carnelos; Chiara,20,0,20,0
1746562692917,LIIT 5CS,A00,896564,Carnelos; Chiara,20,0,20,0
1746562693944,LISP 5A,A00,896588,Munoz Sanchez; Alicia,3,0,20,17
1746562694975,LISP 5B,A00,896653,Munoz Sanchez; Alicia,7,0,20,13
1746562696003,LISP 5C,A00,896655,Munoz Sanchez; Alicia,0,1,20,20
1746562697031,MAE 197,001,957918,Kleissl; Jan,9996,0,9999,3
1746562697031,MAE 197,002,959806,Boechler; Nicholas Sebastia,9998,0,9999,1
1746562697031,MAE 197,003,959852,Mullin; Jennifer S,9998,0,9999,1
1746562698059,MATH 2,A01,957937,Staff,33,0,35,2
1746562699086,MATH 197,001,957876,Kedlaya; Kiran S.,9993,0,9999,6
1746562700115,MCWP 40,A00,892729,Duru; Nur,10,0,20,10
1746562700115,MCWP 40,B00,893304,Montejo; Carolina,14,0,20,6
1746562701140,MCWP 40R,A00,893757,Redela; Pamela Morgan,0,5,20,20
1746562702166,MCWP 50,A00,893758,Morshed; Michael James,0,0,20,20
1746562702166,MCWP 50,B00,893761,Bartulis; Jason Michael,17,0,20,3
1746562703192,MCWP 50R,A00,893766,Compas; Sean Matthew,0,1,20,20
1746562703192,MCWP 50R,B00,893769,Carter; Jennifer A,0,1,20,20
1746562703192,MCWP 50R,C00,893771,Krone; Jarret,0,3,20,20
1746562703192,MCWP 50R,D00,893772,Miller; Elizabeth Deen,0,0,20,20
1746562703192,MCWP 50R,E00,893775,Carter; Andrea L,0,1,20,20
1746562704221,MMW 11R,A01,892721,Herbst; Matthew,11,0,27,16
1746562704221,MMW 11R,A02,892722,Herbst; Matthew,0,0,0,3
1746562705247,MMW 12R,A01,892724,Herbst; Matthew,0,11,16,16
1746562705247,MMW 12R,A02,892725,Herbst; Matthew,0,10,16,16
1746562706272,MMW 13R,A01,892727,Staff,0,4,16,16
1746562706272,MMW 13R,A02,892728,Staff,0,4,16,16
1746562706272,MMW 13R,A03,958032,Staff,0,4,16,16
1746562706272,MMW 13R,A04,958033,Staff,0,4,16,16
1746562706272,MMW 13R,A05,958034,Staff,0,4,16,16
1746562707298,SIO 295LS,A00,894015,Staff,5,0,25,20
1746562708324,SIO 295S,A00,894020,Staff,5,0,25,20
1746562709349,SIOC 290S,B01,958918,Merrifield; Mark A,14,0,30,16
1746562710375,SIOC 291S,B01,958922,Gabriel; Corey John,14,0,30,16
1746562711400,SOCI 117,A01,895339,Staff,3,0,5,2
1746562712427,WES 237B,A00,894149,Staff,11,0,20,9
1746562714490,AESE 279B,A00,891859,Staff,13,0,35,22
1746562715514,AIP 197,001,891854,Vespa; Emanuel Ignacio,9999,0,9999,0
1746562716540,ANTH 289S,A00,891856,Gagneux; Pascal,12,0,12,0
1746562717564,BENG 196,001,957946,Engler; Adam J.,9996,0,9999,3
1746562718602,BISP 197,001,959851,Wilhelm; James E.,9998,0,9999,1
1746562719627,CAT 124RS,A01,956906,Staff,6,0,25,19
1746562720654,CAT 125RS,A01,922013,Staff,6,0,25,19
1746562721680,CLRE 250,A00,891860,Morris; Sheldon,9995,0,9999,4
1746562723736,CLRE 251R,A00,907817,Mehta; Ravindra L.,9994,0,9999,5
1746562724761,CLRE 252,A00,891864,Cuomo; Raphael Eduardo,9993,0,9999,6
1746562725789,CLRE 253,A00,891867,Vaida; Florin,9994,0,9999,5
1746562725789,CLRE 253,B00,907819,Staff,9999,0,9999,0
1746562726814,CLRE 259,A00,891868,Patel; Hemal,9998,0,9999,1
1746562727842,CLRE 260,A00,891872,Cuomo; Raphael Eduardo,9999,0,9999,0
1746562728866,CLRE 297,001,891888,Cuomo; Raphael Eduardo,9999,0,9999,0
1746562729890,CSE 191,A00,958773,Minnes Kemp; Mor Mia,9995,0,9999,4
1746562730919,CSE 197,001,959846,Minnes Kemp; Mor Mia,9990,0,9999,9
1746562731949,CSS 201S,A01,892054,Mignozzetti; Umberto,26,0,30,4
1746562732973,CSS 202S,A01,892056,Mignozzetti; Umberto,26,0,30,4
1746562733999,DSC 197,001,956898,Eldridge; Justin Matthew,9996,0,9999,3
1746562735028,DSC 297,001,958000,Mazumdar; Arya,9998,0,9999,1
1746562735028,DSC 297,002,959862,Wang; Yusu,9998,0,9999,1
1746562736057,EAP 100,A00,905686,Staff,9778,0,9999,221
1746562737082,ECE 45,A01,892618,Staff,0,0,65,65
1746562739134,ECE 111,A01,892719,Staff,4,0,65,61
1746562740159,ECE 197,001,957920,Mercier; Patrick Philip,9991,0,9999,8
1746562741186,ECON 178,A01,907814,Zhu; Ying,26,0,35,9
1746562742213,EDS 115,A00,895312,Staff,35,0,45,10
1746562743241,EDS 117,A01,895337,Staff,23,0,30,7
1746562744268,EDS 125,A00,895341,Jones; Gabrielle Anastasia,36,0,45,9
1746562745296,EDS 128A,A01,895459,Fargason; Sharon Gayle,44,0,45,1
1746562746322,EDS 128B,A01,895543,Pappas; Elizabeth,44,0,45,1
1746562747349,EDS 139,A00,897203,Pappas; Elizabeth,44,0,45,1
1746562747349,EDS 139,B00,897209,Fargason; Sharon Gayle,41,0,45,4
1746562748375,EDS 201,A00,895545,Staff,22,0,45,23
1746562749400,EDS 203,A01,895581,Halter; Christopher P.,22,0,45,23
1746562750433,EDS 204R,A01,895625,Heinzman; Erica M.,39,0,45,6
1746562750433,EDS 204R,B01,895693,Halter; Christopher P.,10,0,45,35
1746562751463,EDS 206R,A00,895694,Fargason; Sharon Gayle,1,0,30,29
1746562751463,EDS 206R,B00,895695,Choi; Bailey Miyeon,16,0,30,14
1746562752488,EDS 250,A00,895697,Hemans; Patricia Ann Benitez,22,0,45,23
1746562753513,EDS 281,A00,895701,Meyerott; Theresa Ann,1,0,15,14
1746562754538,EDS 284,A00,895736,Meyerott; Theresa Ann,1,0,15,14
1746562755566,EDS 286,A00,897210,Fine; Sarah,0,0,15,15
1746562756594,EDS 289C,A01,895770,Daly; Alan J.,1,0,15,14
1746562757619,EDS 290,A00,897211,Hofstetter; Carolyn,0,0,15,15
1746562758648,LIGM 5A,A00,896162,Fischer-Grunski; Eva K,12,0,20,8
1746562759673,LIGM 5B,A00,896260,Fischer-Grunski; Eva K,17,0,20,3
1746562760700,LIGM 5C,A00,896308,Fischer-Grunski; Eva K,18,0,20,2
1746562761725,LIIT 5AS,A00,896313,Carnelos; Chiara,18,0,20,2
1746562762753,LIIT 5BS,A00,896416,Carnelos; Chiara,20,0,20,0
1746562763777,LIIT 5CS,A00,896564,Carnelos; Chiara,20,0,20,0
1746562764802,LISP 5A,A00,896588,Munoz Sanchez; Alicia,3,0,20,17
1746562765831,LISP 5B,A00,896653,Munoz Sanchez; Alicia,7,0,20,13
1746562766860,LISP 5C,A00,896655,Munoz Sanchez; Alicia,0,1,20,20
1746562767886,MAE 197,001,957918,Kleissl; Jan,9996,0,9999,3
1746562767886,MAE 197,002,959806,Boechler; Nicholas Sebastia,9998,0,9999,1
1746562767886,MAE 197,003,959852,Mullin; Jennifer S,9998,0,9999,1
1746562768918,MATH 2,A01,957937,Staff,33,0,35,2
1746562769944,MATH 197,001,957876,Kedlaya; Kiran S.,9993,0,9999,6
1746562770970,MCWP 40,A00,892729,Duru; Nur,10,0,20,10
1746562770970,MCWP 40,B00,893304,Montejo; Carolina,14,0,20,6
1746562771997,MCWP 40R,A00,893757,Redela; Pamela Morgan,0,5,20,20
1746562773022,MCWP 50,A00,893758,Morshed; Michael James,0,0,20,20
1746562773022,MCWP 50,B00,893761,Bartulis; Jason Michael,17,0,20,3
1746562774047,MCWP 50R,A00,893766,Compas; Sean Matthew,0,1,20,20
1746562774047,MCWP 50R,B00,893769,Carter; Jennifer A,0,1,20,20
1746562774047,MCWP 50R,C00,893771,Krone; Jarret,0,3,20,20
1746562774047,MCWP 50R,D00,893772,Miller; Elizabeth Deen,0,0,20,20
1746562774047,MCWP 50R,E00,893775,Carter; Andrea L,0,1,20,20
1746562775075,MMW 11R,A01,892721,Herbst; Matthew,11,0,27,16
1746562775075,MMW 11R,A02,892722,Herbst; Matthew,0,0,0,3
1746562776103,MMW 12R,A01,892724,Herbst; Matthew,0,11,16,16
1746562776103,MMW 12R,A02,892725,Herbst; Matthew,0,10,16,16
1746562777128,MMW 13R,A01,892727,Staff,0,4,16,16
1746562777128,MMW 13R,A02,892728,Staff,0,4,16,16
1746562777128,MMW 13R,A03,958032,Staff,0,4,16,16
1746562777128,MMW 13R,A04,958033,Staff,0,4,16,16
1746562777128,MMW 13R,A05,958034,Staff,0,4,16,16
1746562778152,SIO 295LS,A00,894015,Staff,5,0,25,20
1746562779181,SIO 295S,A00,894020,Staff,5,0,25,20
1746562780206,SIOC 290S,B01,958918,Merrifield; Mark A,14,0,30,16
1746562781233,SIOC 291S,B01,958922,Gabriel; Corey John,14,0,30,16
1746562782258,SOCI 117,A01,895339,Staff,3,0,5,2
1746562783283,WES 237B,A00,894149,Staff,11,0,20,9
1746562785351,AESE 279B,A00,891859,Staff,13,0,35,22
1746562786375,AIP 197,001,891854,Vespa; Emanuel Ignacio,9999,0,9999,0
1746562787403,ANTH 289S,A00,891856,Gagneux; Pascal,12,0,12,0
1746562788428,BENG 196,001,957946,Engler; Adam J.,9996,0,9999,3
1746562789452,BISP 197,001,959851,Wilhelm; James E.,9998,0,9999,1
1746562790481,CAT 124RS,A01,956906,Staff,6,0,25,19
1746562791508,CAT 125RS,A01,922013,Staff,6,0,25,19
1746562792534,CLRE 250,A00,891860,Morris; Sheldon,9995,0,9999,4
1746562794589,CLRE 251R,A00,907817,Mehta; Ravindra L.,9994,0,9999,5
1746562795621,CLRE 252,A00,891864,Cuomo; Raphael Eduardo,9993,0,9999,6
1746562796646,CLRE 253,A00,891867,Vaida; Florin,9994,0,9999,5
1746562796646,CLRE 253,B00,907819,Staff,9999,0,9999,0
1746562797672,CLRE 259,A00,891868,Patel; Hemal,9998,0,9999,1
1746562798696,CLRE 260,A00,891872,Cuomo; Raphael Eduardo,9999,0,9999,0
1746562799725,CLRE 297,001,891888,Cuomo; Raphael Eduardo,9999,0,9999,0
1746562800750,CSE 191,A00,958773,Minnes Kemp; Mor Mia,9995,0,9999,4
1746562801776,CSE 197,001,959846,Minnes Kemp; Mor Mia,9990,0,9999,9
1746562802802,CSS 201S,A01,892054,Mignozzetti; Umberto,26,0,30,4
1746562803828,CSS 202S,A01,892056,Mignozzetti; Umberto,26,0,30,4
1746562804852,DSC 197,001,956898,Eldridge; Justin Matthew,9996,0,9999,3
1746562805878,DSC 297,001,958000,Mazumdar; Arya,9998,0,9999,1
1746562805878,DSC 297,002,959862,Wang; Yusu,9998,0,9999,1
1746562806903,EAP 100,A00,905686,Staff,9778,0,9999,221
1746562807932,ECE 45,A01,892618,Staff,0,0,65,65
1746562809981,ECE 111,A01,892719,Staff,4,0,65,61
1746562811007,ECE 197,001,957920,Mercier; Patrick Philip,9991,0,9999,8
1746562812032,ECON 178,A01,907814,Zhu; Ying,26,0,35,9
1746562813058,EDS 115,A00,895312,Staff,35,0,45,10
1746562814084,EDS 117,A01,895337,Staff,23,0,30,7
1746562815109,EDS 125,A00,895341,Jones; Gabrielle Anastasia,36,0,45,9
1746562816136,EDS 128A,A01,895459,Fargason; Sharon Gayle,44,0,45,1
1746562817166,EDS 128B,A01,895543,Pappas; Elizabeth,44,0,45,1
1746562818194,EDS 139,A00,897203,Pappas; Elizabeth,44,0,45,1
1746562818194,EDS 139,B00,897209,Fargason; Sharon Gayle,41,0,45,4
1746562819218,EDS 201,A00,895545,Staff,22,0,45,23
1746562820259,EDS 203,A01,895581,Halter; Christopher P.,22,0,45,23
1746562821287,EDS 204R,A01,895625,Heinzman; Erica M.,39,0,45,6
1746562821287,EDS 204R,B01,895693,Halter; Christopher P.,10,0,45,35
1746562822315,EDS 206R,A00,895694,Fargason; Sharon Gayle,1,0,30,29
1746562822315,EDS 206R,B00,895695,Choi; Bailey Miyeon,16,0,30,14
1746562823340,EDS 250,A00,895697,Hemans; Patricia Ann Benitez,22,0,45,23
1746562824368,EDS 281,A00,895701,Meyerott; Theresa Ann,1,0,15,14
1746562825393,EDS 284,A00,895736,Meyerott; Theresa Ann,1,0,15,14
1746562826418,EDS 286,A00,897210,Fine; Sarah,0,0,15,15
1746562827444,EDS 289C,A01,895770,Daly; Alan J.,1,0,15,14
1746562828469,EDS 290,A00,897211,Hofstetter; Carolyn,0,0,15,15
1746562829497,LIGM 5A,A00,896162,Fischer-Grunski; Eva K,12,0,20,8
1746562830524,LIGM 5B,A00,896260,Fischer-Grunski; Eva K,17,0,20,3
1746562831551,LIGM 5C,A00,896308,Fischer-Grunski; Eva K,18,0,20,2
1746562832576,LIIT 5AS,A00,896313,Carnelos; Chiara,18,0,20,2
1746562833604,LIIT 5BS,A00,896416,Carnelos; Chiara,20,0,20,0
1746562834632,LIIT 5CS,A00,896564,Carnelos; Chiara,20,0,20,0
1746562835661,LISP 5A,A00,896588,Munoz Sanchez; Alicia,3,0,20,17
1746562836688,LISP 5B,A00,896653,Munoz Sanchez; Alicia,7,0,20,13
1746562837714,LISP 5C,A00,896655,Munoz Sanchez; Alicia,0,1,20,20
1746562838740,MAE 197,001,957918,Kleissl; Jan,9996,0,9999,3
1746562838740,MAE 197,002,959806,Boechler; Nicholas Sebastia,9998,0,9999,1
1746562838740,MAE 197,003,959852,Mullin; Jennifer S,9998,0,9999,1
1746562839764,MATH 2,A01,957937,Staff,33,0,35,2
1746562840790,MATH 197,001,957876,Kedlaya; Kiran S.,9993,0,9999,6
1746562841817,MCWP 40,A00,892729,Duru; Nur,10,0,20,10
1746562841817,MCWP 40,B00,893304,Montejo; Carolina,14,0,20,6
1746562842845,MCWP 40R,A00,893757,Redela; Pamela Morgan,0,5,20,20
1746562843874,MCWP 50,A00,893758,Morshed; Michael James,0,0,20,20
1746562843874,MCWP 50,B00,893761,Bartulis; Jason Michael,17,0,20,3
1746562844901,MCWP 50R,A00,893766,Compas; Sean Matthew,0,1,20,20
1746562844901,MCWP 50R,B00,893769,Carter; Jennifer A,0,1,20,20
1746562844901,MCWP 50R,C00,893771,Krone; Jarret,0,3,20,20
1746562844901,MCWP 50R,D00,893772,Miller; Elizabeth Deen,0,0,20,20
1746562844901,MCWP 50R,E00,893775,Carter; Andrea L,0,1,20,20
1746562845930,MMW 11R,A01,892721,Herbst; Matthew,11,0,27,16
1746562845930,MMW 11R,A02,892722,Herbst; Matthew,0,0,0,3
1746562846954,MMW 12R,A01,892724,Herbst; Matthew,0,11,16,16
1746562846954,MMW 12R,A02,892725,Herbst; Matthew,0,10,16,16
1746562847981,MMW 13R,A01,892727,Staff,0,4,16,16
1746562847981,MMW 13R,A02,892728,Staff,0,4,16,16
1746562847981,MMW 13R,A03,958032,Staff,0,4,16,16
1746562847981,MMW 13R,A04,958033,Staff,0,4,16,16
1746562847981,MMW 13R,A05,958034,Staff,0,4,16,16
1746562849005,SIO 295LS,A00,894015,Staff,5,0,25,20
1746562850031,SIO 295S,A00,894020,Staff,5,0,25,20
1746562851061,SIOC 290S,B01,958918,Merrifield; Mark A,14,0,30,16
1746562852093,SIOC 291S,B01,958922,Gabriel; Corey John,14,0,30,16
1746562853121,SOCI 117,A01,895339,Staff,3,0,5,2
1746562854145,WES 237B,A00,894149,Staff,11,0,20,9
1746562856202,AESE 279B,A00,891859,Staff,13,0,35,22
1746562857229,AIP 197,001,891854,Vespa; Emanuel Ignacio,9999,0,9999,0
1746562858258,ANTH 289S,A00,891856,Gagneux; Pascal,12,0,12,0
1746562859283,BENG 196,001,957946,Engler; Adam J.,9996,0,9999,3
1746562860311,BISP 197,001,959851,Wilhelm; James E.,9998,0,9999,1
1746562861339,CAT 124RS,A01,956906,Staff,6,0,25,19
1746562862364,CAT 125RS,A01,922013,Staff,6,0,25,19
1746562863391,CLRE 250,A00,891860,Morris; Sheldon,9995,0,9999,4
1746562865449,CLRE 251R,A00,907817,Mehta; Ravindra L.,9994,0,9999,5
1746562866476,CLRE 252,A00,891864,Cuomo; Raphael Eduardo,9993,0,9999,6
1746562867504,CLRE 253,A00,891867,Vaida; Florin,9994,0,9999,5
1746562867504,CLRE 253,B00,907819,Staff,9999,0,9999,0
1746562868532,CLRE 259,A00,891868,Patel; Hemal,9998,0,9999,1
1746562869558,CLRE 260,A00,891872,Cuomo; Raphael Eduardo,9999,0,9999,0
1746562870583,CLRE 297,001,891888,Cuomo; Raphael Eduardo,9999,0,9999,0
1746562871611,CSE 191,A00,958773,Minnes Kemp; Mor Mia,9995,0,9999,4
1746562872640,CSE 197,001,959846,Minnes Kemp; Mor Mia,9990,0,9999,9
1746562873668,CSS 201S,A01,892054,Mignozzetti; Umberto,26,0,30,4
1746562874696,CSS 202S,A01,892056,Mignozzetti; Umberto,26,0,30,4
1746562875724,DSC 197,001,956898,Eldridge; Justin Matthew,9996,0,9999,3
1746562876750,DSC 297,001,958000,Mazumdar; Arya,9998,0,9999,1
1746562876750,DSC 297,002,959862,Wang; Yusu,9998,0,9999,1
1746562877777,EAP 100,A00,905686,Staff,9778,0,9999,221
1746562878802,ECE 45,A01,892618,Staff,0,0,65,65
1746562880853,ECE 111,A01,892719,Staff,4,0,65,61
1746562881878,ECE 197,001,957920,Mercier; Patrick Philip,9991,0,9999,8
1746562882904,ECON 178,A01,907814,Zhu; Ying,26,0,35,9
1746562883931,EDS 115,A00,895312,Staff,35,0,45,10
1746562884959,EDS 117,A01,895337,Staff,23,0,30,7
1746562885991,EDS 125,A00,895341,Jones; Gabrielle Anastasia,36,0,45,9
1746562887016,EDS 128A,A01,895459,Fargason; Sharon Gayle,44,0,45,1
1746562888045,EDS 128B,A01,895543,Pappas; Elizabeth,44,0,45,1
1746562889109,EDS 139,A00,897203,Pappas; Elizabeth,44,0,45,1
1746562889109,EDS 139,B00,897209,Fargason; Sharon Gayle,41,0,45,4
1746562890135,EDS 201,A00,895545,Staff,22,0,45,23
1746562891161,EDS 203,A01,895581,Halter; Christopher P.,22,0,45,23
1746562892185,EDS 204R,A01,895625,Heinzman; Erica M.,39,0,45,6
1746562892185,EDS 204R,B01,895693,Halter; Christopher P.,10,0,45,35
1746562893210,EDS 206R,A00,895694,Fargason; Sharon Gayle,1,0,30,29
1746562893210,EDS 206R,B00,895695,Choi; Bailey Miyeon,16,0,30,14
1746562894235,EDS 250,A00,895697,Hemans; Patricia Ann Benitez,22,0,45,23
1746562895263,EDS 281,A00,895701,Meyerott; Theresa Ann,1,0,15,14
1746562896288,EDS 284,A00,895736,Meyerott; Theresa Ann,1,0,15,14
1746562897313,EDS 286,A00,897210,Fine; Sarah,0,0,15,15
1746562898341,EDS 289C,A01,895770,Daly; Alan J.,1,0,15,14
1746562899366,EDS 290,A00,897211,Hofstetter; Carolyn,0,0,15,15
1746562900394,LIGM 5A,A00,896162,Fischer-Grunski; Eva K,12,0,20,8
1746562901423,LIGM 5B,A00,896260,Fischer-Grunski; Eva K,17,0,20,3
1746562902454,LIGM 5C,A00,896308,Fischer-Grunski; Eva K,18,0,20,2
1746562903482,LIIT 5AS,A00,896313,Carnelos; Chiara,18,0,20,2
1746562904509,LIIT 5BS,A00,896416,Carnelos; Chiara,20,0,20,0
1746562905536,LIIT 5CS,A00,896564,Carnelos; Chiara,20,0,20,0
1746562906562,LISP 5A,A00,896588,Munoz Sanchez; Alicia,3,0,20,17
1746562907592,LISP 5B,A00,896653,Munoz Sanchez; Alicia,7,0,20,13
1746562908619,LISP 5C,A00,896655,Munoz Sanchez; Alicia,0,1,20,20
1746562909645,MAE 197,001,957918,Kleissl; Jan,9996,0,9999,3
1746562909645,MAE 197,002,959806,Boechler; Nicholas Sebastia,9998,0,9999,1
1746562909645,MAE 197,003,959852,Mullin; Jennifer S,9998,0,9999,1
1746562910675,MATH 2,A01,957937,Staff,33,0,35,2
1746562911700,MATH 197,001,957876,Kedlaya; Kiran S.,9993,0,9999,6
1746562912725,MCWP 40,A00,892729,Duru; Nur,10,0,20,10
1746562912725,MCWP 40,B00,893304,Montejo; Carolina,14,0,20,6
1746562913749,MCWP 40R,A00,893757,Redela; Pamela Morgan,0,5,20,20
1746562914775,MCWP 50,A00,893758,Morshed; Michael James,0,0,20,20
1746562914775,MCWP 50,B00,893761,Bartulis; Jason Michael,17,0,20,3
1746562915800,MCWP 50R,A00,893766,Compas; Sean Matthew,0,1,20,20
1746562915800,MCWP 50R,B00,893769,Carter; Jennifer A,0,1,20,20
1746562915800,MCWP 50R,C00,893771,Krone; Jarret,0,3,20,20
1746562915800,MCWP 50R,D00,893772,Miller; Elizabeth Deen,0,0,20,20
1746562915800,MCWP 50R,E00,893775,Carter; Andrea L,0,1,20,20
1746562916829,MMW 11R,A01,892721,Herbst; Matthew,11,0,27,16
1746562916829,MMW 11R,A02,892722,Herbst; Matthew,0,0,0,3
1746562917858,MMW 12R,A01,892724,Herbst; Matthew,0,11,16,16
1746562917858,MMW 12R,A02,892725,Herbst; Matthew,0,10,16,16
1746562918886,MMW 13R,A01,892727,Staff,0,4,16,16
1746562918886,MMW 13R,A02,892728,Staff,0,4,16,16
1746562918886,MMW 13R,A03,958032,Staff,0,4,16,16
1746562918886,MMW 13R,A04,958033,Staff,0,4,16,16
1746562918886,MMW 13R,A05,958034,Staff,0,4,16,16
1746562919915,SIO 295LS,A00,894015,Staff,5,0,25,20
1746562920942,SIO 295S,A00,894020,Staff,5,0,25,20
1746562921967,SIOC 290S,B01,958918,Merrifield; Mark A,14,0,30,16
1746562922991,SIOC 291S,B01,958922,Gabriel; Corey John,14,0,30,16
1746562924016,SOCI 117,A01,895339,Staff,3,0,5,2
1746562925041,WES 237B,A00,894149,Staff,11,0,20,9
1746562927108,AESE 279B,A00,891859,Staff,13,0,35,22
1746562928137,AIP 197,001,891854,Vespa; Emanuel Ignacio,9999,0,9999,0
1746562929161,ANTH 289S,A00,891856,Gagneux; Pascal,12,0,12,0
1746562930186,BENG 196,001,957946,Engler; Adam J.,9996,0,9999,3
1746562931213,BISP 197,001,959851,Wilhelm; James E.,9998,0,9999,1
1746562932238,CAT 124RS,A01,956906,Staff,6,0,25,19
1746562933267,CAT 125RS,A01,922013,Staff,6,0,25,19
1746562934291,CLRE 250,A00,891860,Morris; Sheldon,9995,0,9999,4
1746562936345,CLRE 251R,A00,907817,Mehta; Ravindra L.,9994,0,9999,5
1746562937369,CLRE 252,A00,891864,Cuomo; Raphael Eduardo,9993,0,9999,6
1746562938394,CLRE 253,A00,891867,Vaida; Florin,9994,0,9999,5
1746562938394,CLRE 253,B00,907819,Staff,9999,0,9999,0
1746562939418,CLRE 259,A00,891868,Patel; Hemal,9998,0,9999,1
1746562940443,CLRE 260,A00,891872,Cuomo; Raphael Eduardo,9999,0,9999,0
1746562941468,CLRE 297,001,891888,Cuomo; Raphael Eduardo,9999,0,9999,0
1746562942493,CSE 191,A00,958773,Minnes Kemp; Mor Mia,9995,0,9999,4
1746562943517,CSE 197,001,959846,Minnes Kemp; Mor Mia,9990,0,9999,9
1746562944544,CSS 201S,A01,892054,Mignozzetti; Umberto,26,0,30,4
1746562945572,CSS 202S,A01,892056,Mignozzetti; Umberto,26,0,30,4
1746562946596,DSC 197,001,956898,Eldridge; Justin Matthew,9996,0,9999,3
1746562947621,DSC 297,001,958000,Mazumdar; Arya,9998,0,9999,1
1746562947621,DSC 297,002,959862,Wang; Yusu,9998,0,9999,1
1746562948648,EAP 100,A00,905686,Staff,9778,0,9999,221
1746562949677,ECE 45,A01,892618,Staff,0,0,65,65
1746562951727,ECE 111,A01,892719,Staff,4,0,65,61
1746562952750,ECE 197,001,957920,Mercier; Patrick Philip,9991,0,9999,8
1746562953780,ECON 178,A01,907814,Zhu; Ying,26,0,35,9
1746562954806,EDS 115,A00,895312,Staff,35,0,45,10
1746562955832,EDS 117,A01,895337,Staff,23,0,30,7
1746562956858,EDS 125,A00,895341,Jones; Gabrielle Anastasia,36,0,45,9
1746562957886,EDS 128A,A01,895459,Fargason; Sharon Gayle,44,0,45,1
1746562958911,EDS 128B,A01,895543,Pappas; Elizabeth,44,0,45,1
1746562959936,EDS 139,A00,897203,Pappas; Elizabeth,44,0,45,1
1746562959936,EDS 139,B00,897209,Fargason; Sharon Gayle,41,0,45,4
1746562960967,EDS 201,A00,895545,Staff,22,0,45,23
1746562961993,EDS 203,A01,895581,Halter; Christopher P.,22,0,45,23
1746562963019,EDS 204R,A01,895625,Heinzman; Erica M.,39,0,45,6
1746562963019,EDS 204R,B01,895693,Halter; Christopher P.,10,0,45,35
1746562964044,EDS 206R,A00,895694,Fargason; Sharon Gayle,1,0,30,29
1746562964044,EDS 206R,B00,895695,Choi; Bailey Miyeon,16,0,30,14
1746562965071,EDS 250,A00,895697,Hemans; Patricia Ann Benitez,22,0,45,23
1746562966098,EDS 281,A00,895701,Meyerott; Theresa Ann,1,0,15,14
1746562967126,EDS 284,A00,895736,Meyerott; Theresa Ann,1,0,15,14
1746562968156,EDS 286,A00,897210,Fine; Sarah,0,0,15,15
1746562969182,EDS 289C,A01,895770,Daly; Alan J.,1,0,15,14
1746562970207,EDS 290,A00,897211,Hofstetter; Carolyn,0,0,15,15
1746562971233,LIGM 5A,A00,896162,Fischer-Grunski; Eva K,12,0,20,8
1746562972258,LIGM 5B,A00,896260,Fischer-Grunski; Eva K,17,0,20,3
1746562973283,LIGM 5C,A00,896308,Fischer-Grunski; Eva K,18,0,20,2
1746562974309,LIIT 5AS,A00,896313,Carnelos; Chiara,18,0,20,2
1746562975333,LIIT 5BS,A00,896416,Carnelos; Chiara,20,0,20,0
1746562976358,LIIT 5CS,A00,896564,Carnelos; Chiara,20,0,20,0
1746562977383,LISP 5A,A00,896588,Munoz Sanchez; Alicia,3,0,20,17
1746562978408,LISP 5B,A00,896653,Munoz Sanchez; Alicia,7,0,20,13
1746562979438,LISP 5C,A00,896655,Munoz Sanchez; Alicia,0,1,20,20
1746562980473,MAE 197,001,957918,Kleissl; Jan,9996,0,9999,3
1746562980473,MAE 197,002,959806,Boechler; Nicholas Sebastia,9998,0,9999,1
1746562980473,MAE 197,003,959852,Mullin; Jennifer S,9998,0,9999,1
1746562981498,MATH 2,A01,957937,Staff,33,0,35,2
1746562982524,MATH 197,001,957876,Kedlaya; Kiran S.,9993,0,9999,6
1746562983551,MCWP 40,A00,892729,Duru; Nur,10,0,20,10
1746562983551,MCWP 40,B00,893304,Montejo; Carolina,14,0,20,6
1746562984574,MCWP 40R,A00,893757,Redela; Pamela Morgan,0,5,20,20
1746562985603,MCWP 50,A00,893758,Morshed; Michael James,0,0,20,20
1746562985603,MCWP 50,B00,893761,Bartulis; Jason Michael,17,0,20,3
1746562986632,MCWP 50R,A00,893766,Compas; Sean Matthew,0,1,20,20
1746562986632,MCWP 50R,B00,893769,Carter; Jennifer A,0,1,20,20
1746562986632,MCWP 50R,C00,893771,Krone; Jarret,0,3,20,20
1746562986632,MCWP 50R,D00,893772,Miller; Elizabeth Deen,0,0,20,20
1746562986632,MCWP 50R,E00,893775,Carter; Andrea L,0,1,20,20
1746562987656,MMW 11R,A01,892721,Herbst; Matthew,11,0,27,16
1746562987656,MMW 11R,A02,892722,Herbst; Matthew,0,0,0,3
1746562988688,MMW 12R,A01,892724,Herbst; Matthew,0,11,16,16
1746562988688,MMW 12R,A02,892725,Herbst; Matthew,0,10,16,16
1746562989715,MMW 13R,A01,892727,Staff,0,4,16,16
1746562989715,MMW 13R,A02,892728,Staff,0,4,16,16
1746562989715,MMW 13R,A03,958032,Staff,0,4,16,16
1746562989715,MMW 13R,A04,958033,Staff,0,4,16,16
1746562989715,MMW 13R,A05,958034,Staff,0,4,16,16
1746562990740,SIO 295LS,A00,894015,Staff,5,0,25,20
1746562991766,SIO 295S,A00,894020,Staff,5,0,25,20
1746562992848,SIOC 290S,B01,958918,Merrifield; Mark A,14,0,30,16
1746562993876,SIOC 291S,B01,958922,Gabriel; Corey John,14,0,30,16
1746562994903,SOCI 117,A01,895339,Staff,3,0,5,2
1746562995929,WES 237B,A00,894149,Staff,11,0,20,9
1746562997995,AESE 279B,A00,891859,Staff,13,0,35,22
1746562999021,AIP 197,001,891854,Vespa; Emanuel Ignacio,9999,0,9999,0
1746563000046,ANTH 289S,A00,891856,Gagneux; Pascal,12,0,12,0
1746563001071,BENG 196,001,957946,Engler; Adam J.,9996,0,9999,3
1746563002094,BISP 197,001,959851,Wilhelm; James E.,9998,0,9999,1
1746563003122,CAT 124RS,A01,956906,Staff,6,0,25,19
1746563004150,CAT 125RS,A01,922013,Staff,6,0,25,19
1746563005178,CLRE 250,A00,891860,Morris; Sheldon,9995,0,9999,4
1746563007228,CLRE 251R,A00,907817,Mehta; Ravindra L.,9994,0,9999,5
1746563008257,CLRE 252,A00,891864,Cuomo; Raphael Eduardo,9993,0,9999,6
1746563009285,CLRE 253,A00,891867,Vaida; Florin,9994,0,9999,5
1746563009285,CLRE 253,B00,907819,Staff,9999,0,9999,0
1746563010311,CLRE 259,A00,891868,Patel; Hemal,9998,0,9999,1
1746563011336,CLRE 260,A00,891872,Cuomo; Raphael Eduardo,9999,0,9999,0
1746563012361,CLRE 297,001,891888,Cuomo; Raphael Eduardo,9999,0,9999,0
1746563013387,CSE 191,A00,958773,Minnes Kemp; Mor Mia,9995,0,9999,4
1746563014411,CSE 197,001,959846,Minnes Kemp; Mor Mia,9990,0,9999,9
1746563015437,CSS 201S,A01,892054,Mignozzetti; Umberto,26,0,30,4
1746563016463,CSS 202S,A01,892056,Mignozzetti; Umberto,26,0,30,4
1746563017489,DSC 197,001,956898,Eldridge; Justin Matthew,9996,0,9999,3
1746563018514,DSC 297,001,958000,Mazumdar; Arya,9998,0,9999,1
1746563018514,DSC 297,002,959862,Wang; Yusu,9998,0,9999,1
1746563019540,EAP 100,A00,905686,Staff,9778,0,9999,221
1746563020564,ECE 45,A01,892618,Staff,0,0,65,65
1746563022617,ECE 111,A01,892719,Staff,4,0,65,61
1746563023645,ECE 197,001,957920,Mercier; Patrick Philip,9991,0,9999,8
1746563024675,ECON 178,A01,907814,Zhu; Ying,26,0,35,9
1746563025701,EDS 115,A00,895312,Staff,35,0,45,10
1746563026730,EDS 117,A01,895337,Staff,23,0,30,7
1746563027757,EDS 125,A00,895341,Jones; Gabrielle Anastasia,36,0,45,9
1746563028785,EDS 128A,A01,895459,Fargason; Sharon Gayle,44,0,45,1
1746563029811,EDS 128B,A01,895543,Pappas; Elizabeth,44,0,45,1
1746563030838,EDS 139,A00,897203,Pappas; Elizabeth,44,0,45,1
1746563030838,EDS 139,B00,897209,Fargason; Sharon Gayle,41,0,45,4
1746563031866,EDS 201,A00,895545,Staff,22,0,45,23
1746563032889,EDS 203,A01,895581,Halter; Christopher P.,22,0,45,23
1746563033915,EDS 204R,A01,895625,Heinzman; Erica M.,39,0,45,6
1746563033915,EDS 204R,B01,895693,Halter; Christopher P.,10,0,45,35
1746563034940,EDS 206R,A00,895694,Fargason; Sharon Gayle,1,0,30,29
1746563034940,EDS 206R,B00,895695,Choi; Bailey Miyeon,16,0,30,14
1746563035966,EDS 250,A00,895697,Hemans; Patricia Ann Benitez,22,0,45,23
1746563036990,EDS 281,A00,895701,Meyerott; Theresa Ann,1,0,15,14
1746563038015,EDS 284,A00,895736,Meyerott; Theresa Ann,1,0,15,14
1746563039043,EDS 286,A00,897210,Fine; Sarah,0,0,15,15
1746563040069,EDS 289C,A01,895770,Daly; Alan J.,1,0,15,14
1746563041095,EDS 290,A00,897211,Hofstetter; Carolyn,0,0,15,15
1746563042121,LIGM 5A,A00,896162,Fischer-Grunski; Eva K,12,0,20,8
1746563043151,LIGM 5B,A00,896260,Fischer-Grunski; Eva K,17,0,20,3
1746563044180,LIGM 5C,A00,896308,Fischer-Grunski; Eva K,18,0,20,2
1746563045205,LIIT 5AS,A00,896313,Carnelos; Chiara,18,0,20,2
1746563046233,LIIT 5BS,A00,896416,Carnelos; Chiara,20,0,20,0
1746563047261,LIIT 5CS,A00,896564,Carnelos; Chiara,20,0,20,0
1746563048290,LISP 5A,A00,896588,Munoz Sanchez; Alicia,3,0,20,17
1746563049320,LISP 5B,A00,896653,Munoz Sanchez; Alicia,7,0,20,13
1746563050349,LISP 5C,A00,896655,Munoz Sanchez; Alicia,0,1,20,20
1746563051374,MAE 197,001,957918,Kleissl; Jan,9996,0,9999,3
1746563051374,MAE 197,002,959806,Boechler; Nicholas Sebastia,9998,0,9999,1
1746563051374,MAE 197,003,959852,Mullin; Jennifer S,9998,0,9999,1
1746563052399,MATH 2,A01,957937,Staff,33,0,35,2
1746563053424,MATH 197,001,957876,Kedlaya; Kiran S.,9993,0,9999,6
1746563054452,MCWP 40,A00,892729,Duru; Nur,10,0,20,10
1746563054452,MCWP 40,B00,893304,Montejo; Carolina,14,0,20,6
1746563055478,MCWP 40R,A00,893757,Redela; Pamela Morgan,0,5,20,20
1746563056505,MCWP 50,A00,893758,Morshed; Michael James,0,0,20,20
1746563056505,MCWP 50,B00,893761,Bartulis; Jason Michael,17,0,20,3
1746563057535,MCWP 50R,A00,893766,Compas; Sean Matthew,0,1,20,20
1746563057535,MCWP 50R,B00,893769,Carter; Jennifer A,0,1,20,20
1746563057535,MCWP 50R,C00,893771,Krone; Jarret,0,3,20,20
1746563057535,MCWP 50R,D00,893772,Miller; Elizabeth Deen,0,0,20,20
1746563057535,MCWP 50R,E00,893775,Carter; Andrea L,0,1,20,20
1746563058562,MMW 11R,A01,892721,Herbst; Matthew,11,0,27,16
1746563058562,MMW 11R,A02,892722,Herbst; Matthew,0,0,0,3
1746563059591,MMW 12R,A01,892724,Herbst; Matthew,0,11,16,16
1746563059591,MMW 12R,A02,892725,Herbst; Matthew,0,10,16,16
1746563060621,MMW 13R,A01,892727,Staff,0,4,16,16
1746563060621,MMW 13R,A02,892728,Staff,0,4,16,16
1746563060621,MMW 13R,A03,958032,Staff,0,4,16,16
1746563060621,MMW 13R,A04,958033,Staff,0,4,16,16
1746563060621,MMW 13R,A05,958034,Staff,0,4,16,16
1746563061648,SIO 295LS,A00,894015,Staff,5,0,25,20
1746563062674,SIO 295S,A00,894020,Staff,5,0,25,20
1746563063701,SIOC 290S,B01,958918,Merrifield; Mark A,14,0,30,16
1746563064726,SIOC 291S,B01,958922,Gabriel; Corey John,14,0,30,16
1746563065756,SOCI 117,A01,895339,Staff,3,0,5,2
1746563066781,WES 237B,A00,894149,Staff,11,0,20,9
1746563068840,AESE 279B,A00,891859,Staff,13,0,35,22
1746563069868,AIP 197,001,891854,Vespa; Emanuel Ignacio,9999,0,9999,0
1746563070894,ANTH 289S,A00,891856,Gagneux; Pascal,12,0,12,0
1746563071919,BENG 196,001,957946,Engler; Adam J.,9996,0,9999,3
1746563072947,BISP 197,001,959851,Wilhelm; James E.,9998,0,9999,1
1746563073971,CAT 124RS,A01,956906,Staff,6,0,25,19
1746563075000,CAT 125RS,A01,922013,Staff,6,0,25,19
1746563076028,CLRE 250,A00,891860,Morris; Sheldon,9995,0,9999,4
1746563078081,CLRE 251R,A00,907817,Mehta; Ravindra L.,9994,0,9999,5
1746563079106,CLRE 252,A00,891864,Cuomo; Raphael Eduardo,9993,0,9999,6
1746563080135,CLRE 253,A00,891867,Vaida; Florin,9994,0,9999,5
1746563080135,CLRE 253,B00,907819,Staff,9999,0,9999,0
1746563081163,CLRE 259,A00,891868,Patel; Hemal,9998,0,9999,1
1746563082189,CLRE 260,A00,891872,Cuomo; Raphael Eduardo,9999,0,9999,0
1746563083216,CLRE 297,001,891888,Cuomo; Raphael Eduardo,9999,0,9999,0
1746563084241,CSE 191,A00,958773,Minnes Kemp; Mor Mia,9995,0,9999,4
1746563085268,CSE 197,001,959846,Minnes Kemp; Mor Mia,9990,0,9999,9
1746563086294,CSS 201S,A01,892054,Mignozzetti; Umberto,26,0,30,4
1746563087322,CSS 202S,A01,892056,Mignozzetti; Umberto,26,0,30,4
1746563088350,DSC 197,001,956898,Eldridge; Justin Matthew,9996,0,9999,3
1746563089377,DSC 297,001,958000,Mazumdar; Arya,9998,0,9999,1
1746563089377,DSC 297,002,959862,Wang; Yusu,9998,0,9999,1
1746563090402,EAP 100,A00,905686,Staff,9778,0,9999,221
1746563091430,ECE 45,A01,892618,Staff,0,0,65,65
1746563093482,ECE 111,A01,892719,Staff,4,0,65,61
1746563094509,ECE 197,001,957920,Mercier; Patrick Philip,9991,0,9999,8
1746563095533,ECON 178,A01,907814,Zhu; Ying,26,0,35,9
1746563096598,EDS 115,A00,895312,Staff,35,0,45,10
1746563097626,EDS 117,A01,895337,Staff,23,0,30,7
1746563098653,EDS 125,A00,895341,Jones; Gabrielle Anastasia,36,0,45,9
1746563099680,EDS 128A,A01,895459,Fargason; Sharon Gayle,44,0,45,1
1746563100709,EDS 128B,A01,895543,Pappas; Elizabeth,44,0,45,1
1746563101737,EDS 139,A00,897203,Pappas; Elizabeth,44,0,45,1
1746563101737,EDS 139,B00,897209,Fargason; Sharon Gayle,41,0,45,4
1746563102766,EDS 201,A00,895545,Staff,22,0,45,23
1746563103793,EDS 203,A01,895581,Halter; Christopher P.,22,0,45,23
1746563104817,EDS 204R,A01,895625,Heinzman; Erica M.,39,0,45,6
1746563104817,EDS 204R,B01,895693,Halter; Christopher P.,10,0,45,35
1746563105848,EDS 206R,A00,895694,Fargason; Sharon Gayle,1,0,30,29
1746563105848,EDS 206R,B00,895695,Choi; Bailey Miyeon,16,0,30,14
1746563106872,EDS 250,A00,895697,Hemans; Patricia Ann Benitez,22,0,45,23
1746563107899,EDS 281,A00,895701,Meyerott; Theresa Ann,1,0,15,14
1746563108926,EDS 284,A00,895736,Meyerott; Theresa Ann,1,0,15,14
1746563109952,EDS 286,A00,897210,Fine; Sarah,0,0,15,15
1746563110978,EDS 289C,A01,895770,Daly; Alan J.,1,0,15,14
1746563112005,EDS 290,A00,897211,Hofstetter; Carolyn,0,0,15,15
1746563113048,LIGM 5A,A00,896162,Fischer-Grunski; Eva K,12,0,20,8
1746563114078,LIGM 5B,A00,896260,Fischer-Grunski; Eva K,17,0,20,3
1746563115106,LIGM 5C,A00,896308,Fischer-Grunski; Eva K,18,0,20,2
1746563116133,LIIT 5AS,A00,896313,Carnelos; Chiara,18,0,20,2
1746563117158,LIIT 5BS,A00,896416,Carnelos; Chiara,20,0,20,0
1746563118183,LIIT 5CS,A00,896564,Carnelos; Chiara,20,0,20,0
1746563119208,LISP 5A,A00,896588,Munoz Sanchez; Alicia,3,0,20,17
1746563120239,LISP 5B,A00,896653,Munoz Sanchez; Alicia,7,0,20,13
1746563121267,LISP 5C,A00,896655,Munoz Sanchez; Alicia,0,1,20,20
1746563122292,MAE 197,001,957918,Kleissl; Jan,9996,0,9999,3
1746563122292,MAE 197,002,959806,Boechler; Nicholas Sebastia,9998,0,9999,1
1746563122292,MAE 197,003,959852,Mullin; Jennifer S,9998,0,9999,1
1746563123317,MATH 2,A01,957937,Staff,33,0,35,2
1746563124345,MATH 197,001,957876,Kedlaya; Kiran S.,9993,0,9999,6
1746563125371,MCWP 40,A00,892729,Duru; Nur,10,0,20,10
1746563125371,MCWP 40,B00,893304,Montejo; Carolina,14,0,20,6
1746563126395,MCWP 40R,A00,893757,Redela; Pamela Morgan,0,5,20,20
1746563127420,MCWP 50,A00,893758,Morshed; Michael James,0,0,20,20
1746563127420,MCWP 50,B00,893761,Bartulis; Jason Michael,17,0,20,3
1746563128449,MCWP 50R,A00,893766,Compas; Sean Matthew,0,1,20,20
1746563128449,MCWP 50R,B00,893769,Carter; Jennifer A,0,1,20,20
1746563128449,MCWP 50R,C00,893771,Krone; Jarret,0,3,20,20
1746563128449,MCWP 50R,D00,893772,Miller; Elizabeth Deen,0,0,20,20
1746563128449,MCWP 50R,E00,893775,Carter; Andrea L,0,1,20,20
1746563129475,MMW 11R,A01,892721,Herbst; Matthew,11,0,27,16
1746563129475,MMW 11R,A02,892722,Herbst; Matthew,0,0,0,3
1746563130505,MMW 12R,A01,892724,Herbst; Matthew,0,11,16,16
1746563130505,MMW 12R,A02,892725,Herbst; Matthew,0,10,16,16
1746563131533,MMW 13R,A01,892727,Staff,0,4,16,16
1746563131533,MMW 13R,A02,892728,Staff,0,4,16,16
1746563131533,MMW 13R,A03,958032,Staff,0,4,16,16
1746563131533,MMW 13R,A04,958033,Staff,0,4,16,16
1746563131533,MMW 13R,A05,958034,Staff,0,4,16,16
1746563132559,SIO 295LS,A00,894015,Staff,5,0,25,20
1746563133585,SIO 295S,A00,894020,Staff,5,0,25,20
1746563134614,SIOC 290S,B01,958918,Merrifield; Mark A,14,0,30,16
1746563135641,SIOC 291S,B01,958922,Gabriel; Corey John,14,0,30,16
1746563136668,SOCI 117,A01,895339,Staff,3,0,5,2
1746563137695,WES 237B,A00,894149,Staff,11,0,20,9
1746563139756,AESE 279B,A00,891859,Staff,13,0,35,22
1746563140782,AIP 197,001,891854,Vespa; Emanuel Ignacio,9999,0,9999,0
1746563141806,ANTH 289S,A00,891856,Gagneux; Pascal,12,0,12,0
1746563142831,BENG 196,001,957946,Engler; Adam J.,9996,0,9999,3
1746563143855,BISP 197,001,959851,Wilhelm; James E.,9998,0,9999,1
1746563144880,CAT 124RS,A01,956906,Staff,6,0,25,19
1746563145906,CAT 125RS,A01,922013,Staff,6,0,25,19
1746563146931,CLRE 250,A00,891860,Morris; Sheldon,9995,0,9999,4
1746563148988,CLRE 251R,A00,907817,Mehta; Ravindra L.,9994,0,9999,5
1746563150015,CLRE 252,A00,891864,Cuomo; Raphael Eduardo,9993,0,9999,6
1746563151043,CLRE 253,A00,891867,Vaida; Florin,9994,0,9999,5
1746563151043,CLRE 253,B00,907819,Staff,9999,0,9999,0
1746563152071,CLRE 259,A00,891868,Patel; Hemal,9998,0,9999,1
1746563153097,CLRE 260,A00,891872,Cuomo; Raphael Eduardo,9999,0,9999,0
1746563154124,CLRE 297,001,891888,Cuomo; Raphael Eduardo,9999,0,9999,0
1746563155153,CSE 191,A00,958773,Minnes Kemp; Mor Mia,9995,0,9999,4
1746563156177,CSE 197,001,959846,Minnes Kemp; Mor Mia,9990,0,9999,9
1746563157204,CSS 201S,A01,892054,Mignozzetti; Umberto,26,0,30,4
1746563158232,CSS 202S,A01,892056,Mignozzetti; Umberto,26,0,30,4
1746563159257,DSC 197,001,956898,Eldridge; Justin Matthew,9996,0,9999,3
1746563160283,DSC 297,001,958000,Mazumdar; Arya,9998,0,9999,1
1746563160283,DSC 297,002,959862,Wang; Yusu,9998,0,9999,1
1746563161309,EAP 100,A00,905686,Staff,9778,0,9999,221
1746563162338,ECE 45,A01,892618,Staff,0,0,65,65
1746563164391,ECE 111,A01,892719,Staff,4,0,65,61
1746563165421,ECE 197,001,957920,Mercier; Patrick Philip,9991,0,9999,8
1746563166450,ECON 178,A01,907814,Zhu; Ying,26,0,35,9
1746563167473,EDS 115,A00,895312,Staff,35,0,45,10
1746563168502,EDS 117,A01,895337,Staff,23,0,30,7
1746563169529,EDS 125,A00,895341,Jones; Gabrielle Anastasia,36,0,45,9
1746563170558,EDS 128A,A01,895459,Fargason; Sharon Gayle,44,0,45,1
1746563171587,EDS 128B,A01,895543,Pappas; Elizabeth,44,0,45,1
1746563172615,EDS 139,A00,897203,Pappas; Elizabeth,44,0,45,1
1746563172615,EDS 139,B00,897209,Fargason; Sharon Gayle,41,0,45,4
1746563173639,EDS 201,A00,895545,Staff,22,0,45,23
1746563174666,EDS 203,A01,895581,Halter; Christopher P.,22,0,45,23
1746563175692,EDS 204R,A01,895625,Heinzman; Erica M.,39,0,45,6
1746563175692,EDS 204R,B01,895693,Halter; Christopher P.,10,0,45,35
1746563176719,EDS 206R,A00,895694,Fargason; Sharon Gayle,1,0,30,29
1746563176719,EDS 206R,B00,895695,Choi; Bailey Miyeon,16,0,30,14
1746563177744,EDS 250,A00,895697,Hemans; Patricia Ann Benitez,22,0,45,23
1746563178771,EDS 281,A00,895701,Meyerott; Theresa Ann,1,0,15,14
1746563179797,EDS 284,A00,895736,Meyerott; Theresa Ann,1,0,15,14
1746563180824,EDS 286,A00,897210,Fine; Sarah,0,0,15,15
1746563181851,EDS 289C,A01,895770,Daly; Alan J.,1,0,15,14
1746563182877,EDS 290,A00,897211,Hofstetter; Carolyn,0,0,15,15
1746563183906,LIGM 5A,A00,896162,Fischer-Grunski; Eva K,12,0,20,8
1746563184934,LIGM 5B,A00,896260,Fischer-Grunski; Eva K,17,0,20,3
1746563185963,LIGM 5C,A00,896308,Fischer-Grunski; Eva K,18,0,20,2
1746563186991,LIIT 5AS,A00,896313,Carnelos; Chiara,18,0,20,2
1746563188016,LIIT 5BS,A00,896416,Carnelos; Chiara,20,0,20,0
1746563189044,LIIT 5CS,A00,896564,Carnelos; Chiara,20,0,20,0
1746563190069,LISP 5A,A00,896588,Munoz Sanchez; Alicia,3,0,20,17
1746563191098,LISP 5B,A00,896653,Munoz Sanchez; Alicia,7,0,20,13
1746563192124,LISP 5C,A00,896655,Munoz Sanchez; Alicia,0,1,20,20
1746563193149,MAE 197,001,957918,Kleissl; Jan,9996,0,9999,3
1746563193149,MAE 197,002,959806,Boechler; Nicholas Sebastia,9998,0,9999,1
1746563193149,MAE 197,003,959852,Mullin; Jennifer S,9998,0,9999,1
1746563194177,MATH 2,A01,957937,Staff,33,0,35,2
1746563195201,MATH 197,001,957876,Kedlaya; Kiran S.,9993,0,9999,6
1746563196230,MCWP 40,A00,892729,Duru; Nur,10,0,20,10
1746563196230,MCWP 40,B00,893304,Montejo; Carolina,14,0,20,6
1746563197254,MCWP 40R,A00,893757,Redela; Pamela Morgan,0,5,20,20
1746563198281,MCWP 50,A00,893758,Morshed; Michael James,0,0,20,20
1746563198281,MCWP 50,B00,893761,Bartulis; Jason Michael,17,0,20,3
1746563199306,MCWP 50R,A00,893766,Compas; Sean Matthew,0,1,20,20
1746563199306,MCWP 50R,B00,893769,Carter; Jennifer A,0,1,20,20
1746563199306,MCWP 50R,C00,893771,Krone; Jarret,0,3,20,20
1746563199306,MCWP 50R,D00,893772,Miller; Elizabeth Deen,0,0,20,20
1746563199306,MCWP 50R,E00,893775,Carter; Andrea L,0,1,20,20
1746563200389,MMW 11R,A01,892721,Herbst; Matthew,11,0,27,16
1746563200389,MMW 11R,A02,892722,Herbst; Matthew,0,0,0,3
1746563201418,MMW 12R,A01,892724,Herbst; Matthew,0,11,16,16
1746563201418,MMW 12R,A02,892725,Herbst; Matthew,0,10,16,16
1746563202442,MMW 13R,A01,892727,Staff,0,4,16,16
1746563202442,MMW 13R,A02,892728,Staff,0,4,16,16
1746563202442,MMW 13R,A03,958032,Staff,0,4,16,16
1746563202442,MMW 13R,A04,958033,Staff,0,4,16,16
1746563202442,MMW 13R,A05,958034,Staff,0,4,16,16
1746563203471,SIO 295LS,A00,894015,Staff,5,0,25,20
1746563204498,SIO 295S,A00,894020,Staff,5,0,25,20
1746563205528,SIOC 290S,B01,958918,Merrifield; Mark A,14,0,30,16
1746563206556,SIOC 291S,B01,958922,Gabriel; Corey John,14,0,30,16
1746563207581,SOCI 117,A01,895339,Staff,3,0,5,2
1746563208625,WES 237B,A00,894149,Staff,11,0,20,9
1746563210683,AESE 279B,A00,891859,Staff,13,0,35,22
1746563211708,AIP 197,001,891854,Vespa; Emanuel Ignacio,9999,0,9999,0
1746563212736,ANTH 289S,A00,891856,Gagneux; Pascal,12,0,12,0
1746563213761,BENG 196,001,957946,Engler; Adam J.,9996,0,9999,3
1746563214788,BISP 197,001,959851,Wilhelm; James E.,9998,0,9999,1
1746563215813,CAT 124RS,A01,956906,Staff,6,0,25,19
1746563216837,CAT 125RS,A01,922013,Staff,6,0,25,19
1746563217865,CLRE 250,A00,891860,Morris; Sheldon,9995,0,9999,4
1746563219915,CLRE 251R,A00,907817,Mehta; Ravindra L.,9994,0,9999,5
1746563220943,CLRE 252,A00,891864,Cuomo; Raphael Eduardo,9993,0,9999,6
1746563221968,CLRE 253,A00,891867,Vaida; Florin,9994,0,9999,5
1746563221968,CLRE 253,B00,907819,Staff,9999,0,9999,0
1746563222994,CLRE 259,A00,891868,Patel; Hemal,9998,0,9999,1
1746563224019,CLRE 260,A00,891872,Cuomo; Raphael Eduardo,9999,0,9999,0
1746563225052,CLRE 297,001,891888,Cuomo; Raphael Eduardo,9999,0,9999,0
1746563226078,CSE 191,A00,958773,Minnes Kemp; Mor Mia,9995,0,9999,4
1746563227106,CSE 197,001,959846,Minnes Kemp; Mor Mia,9990,0,9999,9
1746563228131,CSS 201S,A01,892054,Mignozzetti; Umberto,26,0,30,4
1746563229156,CSS 202S,A01,892056,Mignozzetti; Umberto,26,0,30,4
1746563230181,DSC 197,001,956898,Eldridge; Justin Matthew,9996,0,9999,3
1746563231209,DSC 297,001,958000,Mazumdar; Arya,9998,0,9999,1
1746563231209,DSC 297,002,959862,Wang; Yusu,9998,0,9999,1
1746563232237,EAP 100,A00,905686,Staff,9778,0,9999,221
1746563233262,ECE 45,A01,892618,Staff,0,0,65,65
1746563235317,ECE 111,A01,892719,Staff,4,0,65,61
1746563236341,ECE 197,001,957920,Mercier; Patrick Philip,9991,0,9999,8
1746563237366,ECON 178,A01,907814,Zhu; Ying,26,0,35,9
1746563238393,EDS 115,A00,895312,Staff,35,0,45,10
1746563239419,EDS 117,A01,895337,Staff,23,0,30,7
1746563240445,EDS 125,A00,895341,Jones; Gabrielle Anastasia,36,0,45,9
1746563241469,EDS 128A,A01,895459,Fargason; Sharon Gayle,44,0,45,1
1746563242500,EDS 128B,A01,895543,Pappas; Elizabeth,44,0,45,1
1746563243529,EDS 139,A00,897203,Pappas; Elizabeth,44,0,45,1
1746563243529,EDS 139,B00,897209,Fargason; Sharon Gayle,41,0,45,4
1746563244554,EDS 201,A00,895545,Staff,22,0,45,23
1746563245580,EDS 203,A01,895581,Halter; Christopher P.,22,0,45,23
1746563246604,EDS 204R,A01,895625,Heinzman; Erica M.,39,0,45,6
1746563246604,EDS 204R,B01,895693,Halter; Christopher P.,10,0,45,35
1746563247628,EDS 206R,A00,895694,Fargason; Sharon Gayle,1,0,30,29
1746563247628,EDS 206R,B00,895695,Choi; Bailey Miyeon,16,0,30,14
1746563248656,EDS 250,A00,895697,Hemans; Patricia Ann Benitez,22,0,45,23
1746563249681,EDS 281,A00,895701,Meyerott; Theresa Ann,1,0,15,14
1746563250707,EDS 284,A00,895736,Meyerott; Theresa Ann,1,0,15,14
1746563251735,EDS 286,A00,897210,Fine; Sarah,0,0,15,15
1746563252760,EDS 289C,A01,895770,Daly; Alan J.,1,0,15,14
1746563253785,EDS 290,A00,897211,Hofstetter; Carolyn,0,0,15,15
1746563254811,LIGM 5A,A00,896162,Fischer-Grunski; Eva K,12,0,20,8
1746563255840,LIGM 5B,A00,896260,Fischer-Grunski; Eva K,17,0,20,3
1746563256864,LIGM 5C,A00,896308,Fischer-Grunski; Eva K,18,0,20,2
1746563257889,LIIT 5AS,A00,896313,Carnelos; Chiara,18,0,20,2
1746563258915,LIIT 5BS,A00,896416,Carnelos; Chiara,20,0,20,0
1746563259946,LIIT 5CS,A00,896564,Carnelos; Chiara,20,0,20,0
1746563260975,LISP 5A,A00,896588,Munoz Sanchez; Alicia,3,0,20,17
1746563262001,LISP 5B,A00,896653,Munoz Sanchez; Alicia,7,0,20,13
1746563263026,LISP 5C,A00,896655,Munoz Sanchez; Alicia,0,1,20,20
1746563264052,MAE 197,001,957918,Kleissl; Jan,9996,0,9999,3
1746563264052,MAE 197,002,959806,Boechler; Nicholas Sebastia,9998,0,9999,1
1746563264052,MAE 197,003,959852,Mullin; Jennifer S,9998,0,9999,1
1746563265080,MATH 2,A01,957937,Staff,33,0,35,2
1746563266110,MATH 197,001,957876,Kedlaya; Kiran S.,9993,0,9999,6
1746563267136,MCWP 40,A00,892729,Duru; Nur,10,0,20,10
1746563267136,MCWP 40,B00,893304,Montejo; Carolina,14,0,20,6
1746563268161,MCWP 40R,A00,893757,Redela; Pamela Morgan,0,5,20,20
1746563269187,MCWP 50,A00,893758,Morshed; Michael James,0,0,20,20
1746563269187,MCWP 50,B00,893761,Bartulis; Jason Michael,17,0,20,3
1746563270212,MCWP 50R,A00,893766,Compas; Sean Matthew,0,1,20,20
1746563270212,MCWP 50R,B00,893769,Carter; Jennifer A,0,1,20,20
1746563270212,MCWP 50R,C00,893771,Krone; Jarret,0,3,20,20
1746563270212,MCWP 50R,D00,893772,Miller; Elizabeth Deen,0,0,20,20
1746563270212,MCWP 50R,E00,893775,Carter; Andrea L,0,1,20,20
1746563271237,MMW 11R,A01,892721,Herbst; Matthew,11,0,27,16
1746563271237,MMW 11R,A02,892722,Herbst; Matthew,0,0,0,3
1746563272264,MMW 12R,A01,892724,Herbst; Matthew,0,11,16,16
1746563272264,MMW 12R,A02,892725,Herbst; Matthew,0,10,16,16
1746563273290,MMW 13R,A01,892727,Staff,0,4,16,16
1746563273290,MMW 13R,A02,892728,Staff,0,4,16,16
1746563273290,MMW 13R,A03,958032,Staff,0,4,16,16
1746563273290,MMW 13R,A04,958033,Staff,0,4,16,16
1746563273290,MMW 13R,A05,958034,Staff,0,4,16,16
1746563274316,SIO 295LS,A00,894015,Staff,5,0,25,20
1746563275342,SIO 295S,A00,894020,Staff,5,0,25,20
1746563276367,SIOC 290S,B01,958918,Merrifield; Mark A,14,0,30,16
1746563277394,SIOC 291S,B01,958922,Gabriel; Corey John,14,0,30,16
1746563278422,SOCI 117,A01,895339,Staff,3,0,5,2
1746563279446,WES 237B,A00,894149,Staff,11,0,20,9
1746563281509,AESE 279B,A00,891859,Staff,13,0,35,22
1746563282537,AIP 197,001,891854,Vespa; Emanuel Ignacio,9999,0,9999,0
1746563283564,ANTH 289S,A00,891856,Gagneux; Pascal,12,0,12,0
1746563284591,BENG 196,001,957946,Engler; Adam J.,9996,0,9999,3
1746563285646,BISP 197,001,959851,Wilhelm; James E.,9998,0,9999,1
1746563286675,CAT 124RS,A01,956906,Staff,6,0,25,19
1746563287700,CAT 125RS,A01,922013,Staff,6,0,25,19
1746563288724,CLRE 250,A00,891860,Morris; Sheldon,9995,0,9999,4
1746563290781,CLRE 251R,A00,907817,Mehta; Ravindra L.,9994,0,9999,5
1746563291805,CLRE 252,A00,891864,Cuomo; Raphael Eduardo,9993,0,9999,6
1746563292834,CLRE 253,A00,891867,Vaida; Florin,9994,0,9999,5
1746563292834,CLRE 253,B00,907819,Staff,9999,0,9999,0
1746563293862,CLRE 259,A00,891868,Patel; Hemal,9998,0,9999,1
1746563294888,CLRE 260,A00,891872,Cuomo; Raphael Eduardo,9999,0,9999,0
1746563295918,CLRE 297,001,891888,Cuomo; Raphael Eduardo,9999,0,9999,0
1746563296944,CSE 191,A00,958773,Minnes Kemp; Mor Mia,9995,0,9999,4
1746563297968,CSE 197,001,959846,Minnes Kemp; Mor Mia,9990,0,9999,9
1746563298994,CSS 201S,A01,892054,Mignozzetti; Umberto,26,0,30,4
1746563300021,CSS 202S,A01,892056,Mignozzetti; Umberto,26,0,30,4
1746563301049,DSC 197,001,956898,Eldridge; Justin Matthew,9996,0,9999,3
1746563302076,DSC 297,001,958000,Mazumdar; Arya,9998,0,9999,1
1746563302076,DSC 297,002,959862,Wang; Yusu,9998,0,9999,1
1746563303102,EAP 100,A00,905686,Staff,9778,0,9999,221
1746563304169,ECE 45,A01,892618,Staff,0,0,65,65
1746563306222,ECE 111,A01,892719,Staff,4,0,65,61
1746563307247,ECE 197,001,957920,Mercier; Patrick Philip,9991,0,9999,8
1746563308275,ECON 178,A01,907814,Zhu; Ying,26,0,35,9
1746563309300,EDS 115,A00,895312,Staff,35,0,45,10
1746563310339,EDS 117,A01,895337,Staff,23,0,30,7
1746563311366,EDS 125,A00,895341,Jones; Gabrielle Anastasia,36,0,45,9
1746563312391,EDS 128A,A01,895459,Fargason; Sharon Gayle,44,0,45,1
1746563313416,EDS 128B,A01,895543,Pappas; Elizabeth,44,0,45,1
1746563314442,EDS 139,A00,897203,Pappas; Elizabeth,44,0,45,1
1746563314442,EDS 139,B00,897209,Fargason; Sharon Gayle,41,0,45,4
1746563315467,EDS 201,A00,895545,Staff,22,0,45,23
1746563316495,EDS 203,A01,895581,Halter; Christopher P.,22,0,45,23
1746563317522,EDS 204R,A01,895625,Heinzman; Erica M.,39,0,45,6
1746563317522,EDS 204R,B01,895693,Halter; Christopher P.,10,0,45,35
1746563318547,EDS 206R,A00,895694,Fargason; Sharon Gayle,1,0,30,29
1746563318547,EDS 206R,B00,895695,Choi; Bailey Miyeon,16,0,30,14
1746563319572,EDS 250,A00,895697,Hemans; Patricia Ann Benitez,22,0,45,23
1746563320599,EDS 281,A00,895701,Meyerott; Theresa Ann,1,0,15,14
1746563321623,EDS 284,A00,895736,Meyerott; Theresa Ann,1,0,15,14
1746563322648,EDS 286,A00,897210,Fine; Sarah,0,0,15,15
1746563323676,EDS 289C,A01,895770,Daly; Alan J.,1,0,15,14
1746563324702,EDS 290,A00,897211,Hofstetter; Carolyn,0,0,15,15
1746563325730,LIGM 5A,A00,896162,Fischer-Grunski; Eva K,12,0,20,8
1746563326757,LIGM 5B,A00,896260,Fischer-Grunski; Eva K,17,0,20,3
1746563327782,LIGM 5C,A00,896308,Fischer-Grunski; Eva K,18,0,20,2
1746563328807,LIIT 5AS,A00,896313,Carnelos; Chiara,18,0,20,2
1746563329835,LIIT 5BS,A00,896416,Carnelos; Chiara,20,0,20,0
1746563330861,LIIT 5CS,A00,896564,Carnelos; Chiara,20,0,20,0
1746563331887,LISP 5A,A00,896588,Munoz Sanchez; Alicia,3,0,20,17
1746563332913,LISP 5B,A00,896653,Munoz Sanchez; Alicia,7,0,20,13
1746563333942,LISP 5C,A00,896655,Munoz Sanchez; Alicia,0,1,20,20
1746563334969,MAE 197,001,957918,Kleissl; Jan,9996,0,9999,3
1746563334969,MAE 197,002,959806,Boechler; Nicholas Sebastia,9998,0,9999,1
1746563334969,MAE 197,003,959852,Mullin; Jennifer S,9998,0,9999,1
1746563336000,MATH 2,A01,957937,Staff,33,0,35,2
1746563337029,MATH 197,001,957876,Kedlaya; Kiran S.,9993,0,9999,6
1746563338055,MCWP 40,A00,892729,Duru; Nur,10,0,20,10
1746563338055,MCWP 40,B00,893304,Montejo; Carolina,14,0,20,6
1746563339082,MCWP 40R,A00,893757,Redela; Pamela Morgan,0,5,20,20
1746563340107,MCWP 50,A00,893758,Morshed; Michael James,0,0,20,20
1746563340107,MCWP 50,B00,893761,Bartulis; Jason Michael,17,0,20,3
1746563341136,MCWP 50R,A00,893766,Compas; Sean Matthew,0,1,20,20
1746563341136,MCWP 50R,B00,893769,Carter; Jennifer A,0,1,20,20
1746563341136,MCWP 50R,C00,893771,Krone; Jarret,0,3,20,20
1746563341136,MCWP 50R,D00,893772,Miller; Elizabeth Deen,0,0,20,20
1746563341136,MCWP 50R,E00,893775,Carter; Andrea L,0,1,20,20
1746563342162,MMW 11R,A01,892721,Herbst; Matthew,11,0,27,16
1746563342162,MMW 11R,A02,892722,Herbst; Matthew,0,0,0,3
1746563343186,MMW 12R,A01,892724,Herbst; Matthew,0,11,16,16
1746563343186,MMW 12R,A02,892725,Herbst; Matthew,0,10,16,16
1746563344213,MMW 13R,A01,892727,Staff,0,4,16,16
1746563344213,MMW 13R,A02,892728,Staff,0,4,16,16
1746563344213,MMW 13R,A03,958032,Staff,0,4,16,16
1746563344213,MMW 13R,A04,958033,Staff,0,4,16,16
1746563344213,MMW 13R,A05,958034,Staff,0,4,16,16
1746563345237,SIO 295LS,A00,894015,Staff,5,0,25,20
1746563346263,SIO 295S,A00,894020,Staff,5,0,25,20
1746563347289,SIOC 290S,B01,958918,Merrifield; Mark A,14,0,30,16
1746563348316,SIOC 291S,B01,958922,Gabriel; Corey John,14,0,30,16
1746563349346,SOCI 117,A01,895339,Staff,3,0,5,2
1746563350371,WES 237B,A00,894149,Staff,11,0,20,9
1746563352437,AESE 279B,A00,891859,Staff,13,0,35,22
1746563353464,AIP 197,001,891854,Vespa; Emanuel Ignacio,9999,0,9999,0
1746563354489,ANTH 289S,A00,891856,Gagneux; Pascal,12,0,12,0
1746563355516,BENG 196,001,957946,Engler; Adam J.,9996,0,9999,3
1746563356544,BISP 197,001,959851,Wilhelm; James E.,9998,0,9999,1
1746563357569,CAT 124RS,A01,956906,Staff,6,0,25,19
1746563358597,CAT 125RS,A01,922013,Staff,6,0,25,19
1746563359623,CLRE 250,A00,891860,Morris; Sheldon,9995,0,9999,4
1746563361675,CLRE 251R,A00,907817,Mehta; Ravindra L.,9994,0,9999,5
1746563362700,CLRE 252,A00,891864,Cuomo; Raphael Eduardo,9993,0,9999,6
1746563363726,CLRE 253,A00,891867,Vaida; Florin,9994,0,9999,5
1746563363726,CLRE 253,B00,907819,Staff,9999,0,9999,0
1746563364750,CLRE 259,A00,891868,Patel; Hemal,9998,0,9999,1
1746563365776,CLRE 260,A00,891872,Cuomo; Raphael Eduardo,9999,0,9999,0
1746563366800,CLRE 297,001,891888,Cuomo; Raphael Eduardo,9999,0,9999,0
1746563367825,CSE 191,A00,958773,Minnes Kemp; Mor Mia,9995,0,9999,4
1746563368854,CSE 197,001,959846,Minnes Kemp; Mor Mia,9990,0,9999,9
1746563369884,CSS 201S,A01,892054,Mignozzetti; Umberto,26,0,30,4
1746563370914,CSS 202S,A01,892056,Mignozzetti; Umberto,26,0,30,4
1746563371941,DSC 197,001,956898,Eldridge; Justin Matthew,9996,0,9999,3
1746563372969,DSC 297,001,958000,Mazumdar; Arya,9998,0,9999,1
1746563372969,DSC 297,002,959862,Wang; Yusu,9998,0,9999,1
1746563373995,EAP 100,A00,905686,Staff,9778,0,9999,221
1746563375030,ECE 45,A01,892618,Staff,0,0,65,65
1746563377117,ECE 111,A01,892719,Staff,4,0,65,61
1746563378144,ECE 197,001,957920,Mercier; Patrick Philip,9991,0,9999,8
1746563379170,ECON 178,A01,907814,Zhu; Ying,26,0,35,9
1746563380198,EDS 115,A00,895312,Staff,35,0,45,10
1746563381227,EDS 117,A01,895337,Staff,23,0,30,7
1746563382252,EDS 125,A00,895341,Jones; Gabrielle Anastasia,36,0,45,9
1746563383279,EDS 128A,A01,895459,Fargason; Sharon Gayle,44,0,45,1
1746563384307,EDS 128B,A01,895543,Pappas; Elizabeth,44,0,45,1
1746563385333,EDS 139,A00,897203,Pappas; Elizabeth,44,0,45,1
1746563385333,EDS 139,B00,897209,Fargason; Sharon Gayle,41,0,45,4
1746563386356,EDS 201,A00,895545,Staff,22,0,45,23
1746563387381,EDS 203,A01,895581,Halter; Christopher P.,22,0,45,23
1746563388406,EDS 204R,A01,895625,Heinzman; Erica M.,39,0,45,6
1746563388406,EDS 204R,B01,895693,Halter; Christopher P.,10,0,45,35
1746563389431,EDS 206R,A00,895694,Fargason; Sharon Gayle,1,0,30,29
1746563389431,EDS 206R,B00,895695,Choi; Bailey Miyeon,16,0,30,14
1746563390460,EDS 250,A00,895697,Hemans; Patricia Ann Benitez,22,0,45,23
1746563391484,EDS 281,A00,895701,Meyerott; Theresa Ann,1,0,15,14
1746563392509,EDS 284,A00,895736,Meyerott; Theresa Ann,1,0,15,14
1746563393536,EDS 286,A00,897210,Fine; Sarah,0,0,15,15
1746563394561,EDS 289C,A01,895770,Daly; Alan J.,1,0,15,14
1746563395588,EDS 290,A00,897211,Hofstetter; Carolyn,0,0,15,15
1746563396616,LIGM 5A,A00,896162,Fischer-Grunski; Eva K,12,0,20,8
1746563397641,LIGM 5B,A00,896260,Fischer-Grunski; Eva K,17,0,20,3
1746563398674,LIGM 5C,A00,896308,Fischer-Grunski; Eva K,18,0,20,2
1746563399704,LIIT 5AS,A00,896313,Carnelos; Chiara,18,0,20,2
1746563400733,LIIT 5BS,A00,896416,Carnelos; Chiara,20,0,20,0
1746563401758,LIIT 5CS,A00,896564,Carnelos; Chiara,20,0,20,0
1746563402783,LISP 5A,A00,896588,Munoz Sanchez; Alicia,3,0,20,17
1746563403810,LISP 5B,A00,896653,Munoz Sanchez; Alicia,7,0,20,13
1746563404839,LISP 5C,A00,896655,Munoz Sanchez; Alicia,0,1,20,20
1746563405864,MAE 197,001,957918,Kleissl; Jan,9996,0,9999,3
1746563405864,MAE 197,002,959806,Boechler; Nicholas Sebastia,9998,0,9999,1
1746563405864,MAE 197,003,959852,Mullin; Jennifer S,9998,0,9999,1
1746563406894,MATH 2,A01,957937,Staff,33,0,35,2
1746563407920,MATH 197,001,957876,Kedlaya; Kiran S.,9993,0,9999,6
1746563408947,MCWP 40,A00,892729,Duru; Nur,10,0,20,10
1746563408947,MCWP 40,B00,893304,Montejo; Carolina,14,0,20,6
1746563409975,MCWP 40R,A00,893757,Redela; Pamela Morgan,0,5,20,20
1746563411003,MCWP 50,A00,893758,Morshed; Michael James,0,0,20,20
1746563411003,MCWP 50,B00,893761,Bartulis; Jason Michael,17,0,20,3
1746563412028,MCWP 50R,A00,893766,Compas; Sean Matthew,0,1,20,20
1746563412028,MCWP 50R,B00,893769,Carter; Jennifer A,0,1,20,20
1746563412028,MCWP 50R,C00,893771,Krone; Jarret,0,3,20,20
1746563412028,MCWP 50R,D00,893772,Miller; Elizabeth Deen,0,0,20,20
1746563412028,MCWP 50R,E00,893775,Carter; Andrea L,0,1,20,20
1746563413057,MMW 11R,A01,892721,Herbst; Matthew,11,0,27,16
1746563413057,MMW 11R,A02,892722,Herbst; Matthew,0,0,0,3
1746563414086,MMW 12R,A01,892724,Herbst; Matthew,0,11,16,16
1746563414086,MMW 12R,A02,892725,Herbst; Matthew,0,10,16,16
1746563415115,MMW 13R,A01,892727,Staff,0,4,16,16
1746563415115,MMW 13R,A02,892728,Staff,0,4,16,16
1746563415115,MMW 13R,A03,958032,Staff,0,4,16,16
1746563415115,MMW 13R,A04,958033,Staff,0,4,16,16
1746563415115,MMW 13R,A05,958034,Staff,0,4,16,16
1746563416143,SIO 295LS,A00,894015,Staff,5,0,25,20
1746563417167,SIO 295S,A00,894020,Staff,5,0,25,20
1746563418193,SIOC 290S,B01,958918,Merrifield; Mark A,14,0,30,16
1746563419218,SIOC 291S,B01,958922,Gabriel; Corey John,14,0,30,16
1746563420244,SOCI 117,A01,895339,Staff,3,0,5,2
1746563421268,WES 237B,A00,894149,Staff,11,0,20,9
1746563423328,AESE 279B,A00,891859,Staff,13,0,35,22
1746563424353,AIP 197,001,891854,Vespa; Emanuel Ignacio,9999,0,9999,0
1746563425384,ANTH 289S,A00,891856,Gagneux; Pascal,12,0,12,0
1746563426413,BENG 196,001,957946,Engler; Adam J.,9996,0,9999,3
1746563427439,BISP 197,001,959851,Wilhelm; James E.,9998,0,9999,1
1746563428466,CAT 124RS,A01,956906,Staff,6,0,25,19
1746563429490,CAT 125RS,A01,922013,Staff,6,0,25,19
1746563430515,CLRE 250,A00,891860,Morris; Sheldon,9995,0,9999,4
1746563432570,CLRE 251R,A00,907817,Mehta; Ravindra L.,9994,0,9999,5
1746563433595,CLRE 252,A00,891864,Cuomo; Raphael Eduardo,9993,0,9999,6
1746563434619,CLRE 253,A00,891867,Vaida; Florin,9994,0,9999,5
1746563434619,CLRE 253,B00,907819,Staff,9999,0,9999,0
1746563435650,CLRE 259,A00,891868,Patel; Hemal,9998,0,9999,1
1746563436675,CLRE 260,A00,891872,Cuomo; Raphael Eduardo,9999,0,9999,0
1746563437699,CLRE 297,001,891888,Cuomo; Raphael Eduardo,9999,0,9999,0
1746563438727,CSE 191,A00,958773,Minnes Kemp; Mor Mia,9995,0,9999,4
1746563439755,CSE 197,001,959846,Minnes Kemp; Mor Mia,9990,0,9999,9
1746563440780,CSS 201S,A01,892054,Mignozzetti; Umberto,26,0,30,4
1746563441812,CSS 202S,A01,892056,Mignozzetti; Umberto,26,0,30,4
1746563442836,DSC 197,001,956898,Eldridge; Justin Matthew,9996,0,9999,3
1746563443865,DSC 297,001,958000,Mazumdar; Arya,9998,0,9999,1
1746563443865,DSC 297,002,959862,Wang; Yusu,9998,0,9999,1
1746563444893,EAP 100,A00,905686,Staff,9778,0,9999,221
1746563445919,ECE 45,A01,892618,Staff,0,0,65,65
1746563447972,ECE 111,A01,892719,Staff,4,0,65,61
1746563448998,ECE 197,001,957920,Mercier; Patrick Philip,9991,0,9999,8
1746563450060,ECON 178,A01,907814,Zhu; Ying,26,0,35,9
1746563451085,EDS 115,A00,895312,Staff,35,0,45,10
1746563452110,EDS 117,A01,895337,Staff,23,0,30,7
1746563453135,EDS 125,A00,895341,Jones; Gabrielle Anastasia,36,0,45,9
1746563454158,EDS 128A,A01,895459,Fargason; Sharon Gayle,44,0,45,1
1746563455183,EDS 128B,A01,895543,Pappas; Elizabeth,44,0,45,1
1746563456208,EDS 139,A00,897203,Pappas; Elizabeth,44,0,45,1
1746563456208,EDS 139,B00,897209,Fargason; Sharon Gayle,41,0,45,4
1746563457234,EDS 201,A00,895545,Staff,22,0,45,23
1746563458263,EDS 203,A01,895581,Halter; Christopher P.,22,0,45,23
1746563459289,EDS 204R,A01,895625,Heinzman; Erica M.,39,0,45,6
1746563459289,EDS 204R,B01,895693,Halter; Christopher P.,10,0,45,35
1746563460316,EDS 206R,A00,895694,Fargason; Sharon Gayle,1,0,30,29
1746563460316,EDS 206R,B00,895695,Choi; Bailey Miyeon,16,0,30,14
1746563461343,EDS 250,A00,895697,Hemans; Patricia Ann Benitez,22,0,45,23
1746563462368,EDS 281,A00,895701,Meyerott; Theresa Ann,1,0,15,14
1746563463394,EDS 284,A00,895736,Meyerott; Theresa Ann,1,0,15,14
1746563464420,EDS 286,A00,897210,Fine; Sarah,0,0,15,15
1746563465444,EDS 289C,A01,895770,Daly; Alan J.,1,0,15,14
1746563466471,EDS 290,A00,897211,Hofstetter; Carolyn,0,0,15,15
1746563467500,LIGM 5A,A00,896162,Fischer-Grunski; Eva K,12,0,20,8
1746563468524,LIGM 5B,A00,896260,Fischer-Grunski; Eva K,17,0,20,3
1746563469549,LIGM 5C,A00,896308,Fischer-Grunski; Eva K,18,0,20,2
1746563470574,LIIT 5AS,A00,896313,Carnelos; Chiara,18,0,20,2
1746563471600,LIIT 5BS,A00,896416,Carnelos; Chiara,20,0,20,0
1746563472623,LIIT 5CS,A00,896564,Carnelos; Chiara,20,0,20,0
1746563473649,LISP 5A,A00,896588,Munoz Sanchez; Alicia,3,0,20,17
1746563474677,LISP 5B,A00,896653,Munoz Sanchez; Alicia,7,0,20,13
1746563475700,LISP 5C,A00,896655,Munoz Sanchez; Alicia,0,1,20,20
1746563476728,MAE 197,001,957918,Kleissl; Jan,9996,0,9999,3
1746563476728,MAE 197,002,959806,Boechler; Nicholas Sebastia,9998,0,9999,1
1746563476728,MAE 197,003,959852,Mullin; Jennifer S,9998,0,9999,1
1746563477756,MATH 2,A01,957937,Staff,33,0,35,2
1746563478783,MATH 197,001,957876,Kedlaya; Kiran S.,9993,0,9999,6
1746563479808,MCWP 40,A00,892729,Duru; Nur,10,0,20,10
1746563479808,MCWP 40,B00,893304,Montejo; Carolina,14,0,20,6
1746563480836,MCWP 40R,A00,893757,Redela; Pamela Morgan,0,5,20,20
1746563481861,MCWP 50,A00,893758,Morshed; Michael James,0,0,20,20
1746563481861,MCWP 50,B00,893761,Bartulis; Jason Michael,17,0,20,3
1746563482891,MCWP 50R,A00,893766,Compas; Sean Matthew,0,1,20,20
1746563482891,MCWP 50R,B00,893769,Carter; Jennifer A,0,1,20,20
1746563482891,MCWP 50R,C00,893771,Krone; Jarret,0,3,20,20
1746563482891,MCWP 50R,D00,893772,Miller; Elizabeth Deen,0,0,20,20
1746563482891,MCWP 50R,E00,893775,Carter; Andrea L,0,1,20,20
1746563483919,MMW 11R,A01,892721,Herbst; Matthew,11,0,27,16
1746563483919,MMW 11R,A02,892722,Herbst; Matthew,0,0,0,3
1746563484944,MMW 12R,A01,892724,Herbst; Matthew,0,11,16,16
1746563484944,MMW 12R,A02,892725,Herbst; Matthew,0,10,16,16
1746563485972,MMW 13R,A01,892727,Staff,0,4,16,16
1746563485972,MMW 13R,A02,892728,Staff,0,4,16,16
1746563485972,MMW 13R,A03,958032,Staff,0,4,16,16
1746563485972,MMW 13R,A04,958033,Staff,0,4,16,16
1746563485972,MMW 13R,A05,958034,Staff,0,4,16,16
1746563487000,SIO 295LS,A00,894015,Staff,5,0,25,20
1746563488023,SIO 295S,A00,894020,Staff,5,0,25,20
1746563489052,SIOC 290S,B01,958918,Merrifield; Mark A,14,0,30,16
1746563490081,SIOC 291S,B01,958922,Gabriel; Corey John,14,0,30,16
1746563491104,SOCI 117,A01,895339,Staff,3,0,5,2
1746563492131,WES 237B,A00,894149,Staff,11,0,20,9
1746563494187,AESE 279B,A00,891859,Staff,13,0,35,22
1746563495218,AIP 197,001,891854,Vespa; Emanuel Ignacio,9999,0,9999,0
1746563496242,ANTH 289S,A00,891856,Gagneux; Pascal,12,0,12,0
1746563497291,BENG 196,001,957946,Engler; Adam J.,9996,0,9999,3
1746563498316,BISP 197,001,959851,Wilhelm; James E.,9998,0,9999,1
1746563499342,CAT 124RS,A01,956906,Staff,6,0,25,19
1746563500366,CAT 125RS,A01,922013,Staff,6,0,25,19
1746563501391,CLRE 250,A00,891860,Morris; Sheldon,9995,0,9999,4
1746563503454,CLRE 251R,A00,907817,Mehta; Ravindra L.,9994,0,9999,5
1746563504479,CLRE 252,A00,891864,Cuomo; Raphael Eduardo,9993,0,9999,6
1746563505504,CLRE 253,A00,891867,Vaida; Florin,9994,0,9999,5
1746563505504,CLRE 253,B00,907819,Staff,9999,0,9999,0
1746563506531,CLRE 259,A00,891868,Patel; Hemal,9998,0,9999,1
1746563507557,CLRE 260,A00,891872,Cuomo; Raphael Eduardo,9999,0,9999,0
1746563508581,CLRE 297,001,891888,Cuomo; Raphael Eduardo,9999,0,9999,0
1746563509607,CSE 191,A00,958773,Minnes Kemp; Mor Mia,9995,0,9999,4
1746563510636,CSE 197,001,959846,Minnes Kemp; Mor Mia,9990,0,9999,9
1746563511662,CSS 201S,A01,892054,Mignozzetti; Umberto,26,0,30,4
1746563512691,CSS 202S,A01,892056,Mignozzetti; Umberto,26,0,30,4
1746563513716,DSC 197,001,956898,Eldridge; Justin Matthew,9996,0,9999,3
1746563514743,DSC 297,001,958000,Mazumdar; Arya,9998,0,9999,1
1746563514743,DSC 297,002,959862,Wang; Yusu,9998,0,9999,1
1746563515770,EAP 100,A00,905686,Staff,9778,0,9999,221
1746563516798,ECE 45,A01,892618,Staff,0,0,65,65
1746563518849,ECE 111,A01,892719,Staff,4,0,65,61
1746563519875,ECE 197,001,957920,Mercier; Patrick Philip,9991,0,9999,8
1746563520901,ECON 178,A01,907814,Zhu; Ying,26,0,35,9
1746563521928,EDS 115,A00,895312,Staff,35,0,45,10
1746563522958,EDS 117,A01,895337,Staff,23,0,30,7
1746563523982,EDS 125,A00,895341,Jones; Gabrielle Anastasia,36,0,45,9
1746563525005,EDS 128A,A01,895459,Fargason; Sharon Gayle,44,0,45,1
1746563526033,EDS 128B,A01,895543,Pappas; Elizabeth,44,0,45,1
1746563527061,EDS 139,A00,897203,Pappas; Elizabeth,44,0,45,1
1746563527061,EDS 139,B00,897209,Fargason; Sharon Gayle,41,0,45,4
1746563528084,EDS 201,A00,895545,Staff,22,0,45,23
1746563529112,EDS 203,A01,895581,Halter; Christopher P.,22,0,45,23
1746563530139,EDS 204R,A01,895625,Heinzman; Erica M.,39,0,45,6
1746563530139,EDS 204R,B01,895693,Halter; Christopher P.,10,0,45,35
1746563531166,EDS 206R,A00,895694,Fargason; Sharon Gayle,1,0,30,29
1746563531166,EDS 206R,B00,895695,Choi; Bailey Miyeon,16,0,30,14
1746563532190,EDS 250,A00,895697,Hemans; Patricia Ann Benitez,22,0,45,23
1746563533214,EDS 281,A00,895701,Meyerott; Theresa Ann,1,0,15,14
1746563534239,EDS 284,A00,895736,Meyerott; Theresa Ann,1,0,15,14
1746563535268,EDS 286,A00,897210,Fine; Sarah,0,0,15,15
1746563536296,EDS 289C,A01,895770,Daly; Alan J.,1,0,15,14
1746563537321,EDS 290,A00,897211,Hofstetter; Carolyn,0,0,15,15
1746563538349,LIGM 5A,A00,896162,Fischer-Grunski; Eva K,12,0,20,8
1746563539382,LIGM 5B,A00,896260,Fischer-Grunski; Eva K,17,0,20,3
1746563540406,LIGM 5C,A00,896308,Fischer-Grunski; Eva K,18,0,20,2
1746563541431,LIIT 5AS,A00,896313,Carnelos; Chiara,18,0,20,2
1746563542455,LIIT 5BS,A00,896416,Carnelos; Chiara,20,0,20,0
1746563543484,LIIT 5CS,A00,896564,Carnelos; Chiara,20,0,20,0
1746563544509,LISP 5A,A00,896588,Munoz Sanchez; Alicia,3,0,20,17
1746563545536,LISP 5B,A00,896653,Munoz Sanchez; Alicia,7,0,20,13
1746563546560,LISP 5C,A00,896655,Munoz Sanchez; Alicia,0,1,20,20
1746563547585,MAE 197,001,957918,Kleissl; Jan,9996,0,9999,3
1746563547585,MAE 197,002,959806,Boechler; Nicholas Sebastia,9998,0,9999,1
1746563547585,MAE 197,003,959852,Mullin; Jennifer S,9998,0,9999,1
1746563548614,MATH 2,A01,957937,Staff,33,0,35,2
1746563549639,MATH 197,001,957876,Kedlaya; Kiran S.,9993,0,9999,6
1746563550664,MCWP 40,A00,892729,Duru; Nur,10,0,20,10
1746563550664,MCWP 40,B00,893304,Montejo; Carolina,14,0,20,6
1746563551692,MCWP 40R,A00,893757,Redela; Pamela Morgan,0,5,20,20
1746563552720,MCWP 50,A00,893758,Morshed; Michael James,0,0,20,20
1746563552720,MCWP 50,B00,893761,Bartulis; Jason Michael,17,0,20,3
1746563553750,MCWP 50R,A00,893766,Compas; Sean Matthew,0,1,20,20
1746563553750,MCWP 50R,B00,893769,Carter; Jennifer A,0,1,20,20
1746563553750,MCWP 50R,C00,893771,Krone; Jarret,0,3,20,20
1746563553750,MCWP 50R,D00,893772,Miller; Elizabeth Deen,0,0,20,20
1746563553750,MCWP 50R,E00,893775,Carter; Andrea L,0,1,20,20
1746563554774,MMW 11R,A01,892721,Herbst; Matthew,11,0,27,16
1746563554774,MMW 11R,A02,892722,Herbst; Matthew,0,0,0,3
1746563555801,MMW 12R,A01,892724,Herbst; Matthew,0,11,16,16
1746563555801,MMW 12R,A02,892725,Herbst; Matthew,0,10,16,16
1746563556826,MMW 13R,A01,892727,Staff,0,4,16,16
1746563556826,MMW 13R,A02,892728,Staff,0,4,16,16
1746563556826,MMW 13R,A03,958032,Staff,0,4,16,16
1746563556826,MMW 13R,A04,958033,Staff,0,4,16,16
1746563556826,MMW 13R,A05,958034,Staff,0,4,16,16
1746563557852,SIO 295LS,A00,894015,Staff,5,0,25,20
1746563558877,SIO 295S,A00,894020,Staff,5,0,25,20
1746563559905,SIOC 290S,B01,958918,Merrifield; Mark A,14,0,30,16
1746563560934,SIOC 291S,B01,958922,Gabriel; Corey John,14,0,30,16
1746563561959,SOCI 117,A01,895339,Staff,3,0,5,2
1746563562985,WES 237B,A00,894149,Staff,11,0,20,9
1746563565047,AESE 279B,A00,891859,Staff,13,0,35,22
1746563566071,AIP 197,001,891854,Vespa; Emanuel Ignacio,9999,0,9999,0
1746563567095,ANTH 289S,A00,891856,Gagneux; Pascal,12,0,12,0
1746563568122,BENG 196,001,957946,Engler; Adam J.,9996,0,9999,3
1746563569150,BISP 197,001,959851,Wilhelm; James E.,9998,0,9999,1
1746563570178,CAT 124RS,A01,956906,Staff,6,0,25,19
1746563571203,CAT 125RS,A01,922013,Staff,6,0,25,19
1746563572230,CLRE 250,A00,891860,Morris; Sheldon,9995,0,9999,4
1746563574287,CLRE 251R,A00,907817,Mehta; Ravindra L.,9994,0,9999,5
1746563575316,CLRE 252,A00,891864,Cuomo; Raphael Eduardo,9993,0,9999,6
1746563576341,CLRE 253,A00,891867,Vaida; Florin,9994,0,9999,5
1746563576341,CLRE 253,B00,907819,Staff,9999,0,9999,0
1746563577370,CLRE 259,A00,891868,Patel; Hemal,9998,0,9999,1
1746563578416,CLRE 260,A00,891872,Cuomo; Raphael Eduardo,9999,0,9999,0
1746563579446,CLRE 297,001,891888,Cuomo; Raphael Eduardo,9999,0,9999,0
1746563580471,CSE 191,A00,958773,Minnes Kemp; Mor Mia,9995,0,9999,4
1746563581496,CSE 197,001,959846,Minnes Kemp; Mor Mia,9990,0,9999,9
1746563582526,CSS 201S,A01,892054,Mignozzetti; Umberto,26,0,30,4
1746563583556,CSS 202S,A01,892056,Mignozzetti; Umberto,26,0,30,4
1746563584583,DSC 197,001,956898,Eldridge; Justin Matthew,9996,0,9999,3
1746563585608,DSC 297,001,958000,Mazumdar; Arya,9998,0,9999,1
1746563585608,DSC 297,002,959862,Wang; Yusu,9998,0,9999,1
1746563586633,EAP 100,A00,905686,Staff,9778,0,9999,221
1746563587660,ECE 45,A01,892618,Staff,0,0,65,65
1746563589710,ECE 111,A01,892719,Staff,4,0,65,61
1746563590737,ECE 197,001,957920,Mercier; Patrick Philip,9991,0,9999,8
1746563591761,ECON 178,A01,907814,Zhu; Ying,26,0,35,9
1746563592786,EDS 115,A00,895312,Staff,35,0,45,10
1746563593813,EDS 117,A01,895337,Staff,23,0,30,7
1746563594840,EDS 125,A00,895341,Jones; Gabrielle Anastasia,36,0,45,9
1746563595868,EDS 128A,A01,895459,Fargason; Sharon Gayle,44,0,45,1
1746563596894,EDS 128B,A01,895543,Pappas; Elizabeth,44,0,45,1
1746563597922,EDS 139,A00,897203,Pappas; Elizabeth,44,0,45,1
1746563597922,EDS 139,B00,897209,Fargason; Sharon Gayle,41,0,45,4
1746563598947,EDS 201,A00,895545,Staff,22,0,45,23
1746563599975,EDS 203,A01,895581,Halter; Christopher P.,22,0,45,23
1746563600999,EDS 204R,A01,895625,Heinzman; Erica M.,39,0,45,6
1746563600999,EDS 204R,B01,895693,Halter; Christopher P.,10,0,45,35
1746563602027,EDS 206R,A00,895694,Fargason; Sharon Gayle,1,0,30,29
1746563602027,EDS 206R,B00,895695,Choi; Bailey Miyeon,16,0,30,14
1746563603053,EDS 250,A00,895697,Hemans; Patricia Ann Benitez,22,0,45,23
1746563604079,EDS 281,A00,895701,Meyerott; Theresa Ann,1,0,15,14
1746563605106,EDS 284,A00,895736,Meyerott; Theresa Ann,1,0,15,14
1746563606133,EDS 286,A00,897210,Fine; Sarah,0,0,15,15
1746563607159,EDS 289C,A01,895770,Daly; Alan J.,1,0,15,14
1746563608186,EDS 290,A00,897211,Hofstetter; Carolyn,0,0,15,15
1746563609214,LIGM 5A,A00,896162,Fischer-Grunski; Eva K,12,0,20,8
1746563610238,LIGM 5B,A00,896260,Fischer-Grunski; Eva K,17,0,20,3
1746563611266,LIGM 5C,A00,896308,Fischer-Grunski; Eva K,18,0,20,2
1746563612290,LIIT 5AS,A00,896313,Carnelos; Chiara,18,0,20,2
1746563613315,LIIT 5BS,A00,896416,Carnelos; Chiara,20,0,20,0
1746563614341,LIIT 5CS,A00,896564,Carnelos; Chiara,20,0,20,0
1746563615367,LISP 5A,A00,896588,Munoz Sanchez; Alicia,3,0,20,17
1746563616395,LISP 5B,A00,896653,Munoz Sanchez; Alicia,7,0,20,13
1746563617421,LISP 5C,A00,896655,Munoz Sanchez; Alicia,0,1,20,20
1746563618448,MAE 197,001,957918,Kleissl; Jan,9996,0,9999,3
1746563618448,MAE 197,002,959806,Boechler; Nicholas Sebastia,9998,0,9999,1
1746563618448,MAE 197,003,959852,Mullin; Jennifer S,9998,0,9999,1
1746563619473,MATH 2,A01,957937,Staff,33,0,35,2
1746563620499,MATH 197,001,957876,Kedlaya; Kiran S.,9993,0,9999,6
1746563621525,MCWP 40,A00,892729,Duru; Nur,10,0,20,10
1746563621525,MCWP 40,B00,893304,Montejo; Carolina,14,0,20,6
1746563622551,MCWP 40R,A00,893757,Redela; Pamela Morgan,0,5,20,20
1746563623634,MCWP 50,A00,893758,Morshed; Michael James,0,0,20,20
1746563623634,MCWP 50,B00,893761,Bartulis; Jason Michael,17,0,20,3
1746563624660,MCWP 50R,A00,893766,Compas; Sean Matthew,0,1,20,20
1746563624660,MCWP 50R,B00,893769,Carter; Jennifer A,0,1,20,20
1746563624660,MCWP 50R,C00,893771,Krone; Jarret,0,3,20,20
1746563624660,MCWP 50R,D00,893772,Miller; Elizabeth Deen,0,0,20,20
1746563624660,MCWP 50R,E00,893775,Carter; Andrea L,0,1,20,20
1746563625685,MMW 11R,A01,892721,Herbst; Matthew,11,0,27,16
1746563625685,MMW 11R,A02,892722,Herbst; Matthew,0,0,0,3
1746563626712,MMW 12R,A01,892724,Herbst; Matthew,0,11,16,16
1746563626712,MMW 12R,A02,892725,Herbst; Matthew,0,10,16,16
1746563627737,MMW 13R,A01,892727,Staff,0,4,16,16
1746563627737,MMW 13R,A02,892728,Staff,0,4,16,16
1746563627737,MMW 13R,A03,958032,Staff,0,4,16,16
1746563627737,MMW 13R,A04,958033,Staff,0,4,16,16
1746563627737,MMW 13R,A05,958034,Staff,0,4,16,16
1746563628764,SIO 295LS,A00,894015,Staff,5,0,25,20
1746563629789,SIO 295S,A00,894020,Staff,5,0,25,20
1746563630818,SIOC 290S,B01,958918,Merrifield; Mark A,14,0,30,16
1746563631844,SIOC 291S,B01,958922,Gabriel; Corey John,14,0,30,16
1746563632870,SOCI 117,A01,895339,Staff,3,0,5,2
1746563633898,WES 237B,A00,894149,Staff,11,0,20,9
1746563635966,AESE 279B,A00,891859,Staff,13,0,35,22
1746563636993,AIP 197,001,891854,Vespa; Emanuel Ignacio,9999,0,9999,0
1746563638024,ANTH 289S,A00,891856,Gagneux; Pascal,12,0,12,0
1746563639049,BENG 196,001,957946,Engler; Adam J.,9996,0,9999,3
1746563640078,BISP 197,001,959851,Wilhelm; James E.,9998,0,9999,1
1746563641104,CAT 124RS,A01,956906,Staff,6,0,25,19
1746563642130,CAT 125RS,A01,922013,Staff,6,0,25,19
1746563643157,CLRE 250,A00,891860,Morris; Sheldon,9995,0,9999,4
1746563645209,CLRE 251R,A00,907817,Mehta; Ravindra L.,9994,0,9999,5
1746563646239,CLRE 252,A00,891864,Cuomo; Raphael Eduardo,9993,0,9999,6
1746563647264,CLRE 253,A00,891867,Vaida; Florin,9994,0,9999,5
1746563647264,CLRE 253,B00,907819,Staff,9999,0,9999,0
1746563648292,CLRE 259,A00,891868,Patel; Hemal,9998,0,9999,1
1746563649323,CLRE 260,A00,891872,Cuomo; Raphael Eduardo,9999,0,9999,0
1746563650352,CLRE 297,001,891888,Cuomo; Raphael Eduardo,9999,0,9999,0
1746563651381,CSE 191,A00,958773,Minnes Kemp; Mor Mia,9995,0,9999,4
1746563652407,CSE 197,001,959846,Minnes Kemp; Mor Mia,9990,0,9999,9
1746563653438,CSS 201S,A01,892054,Mignozzetti; Umberto,26,0,30,4
1746563654466,CSS 202S,A01,892056,Mignozzetti; Umberto,26,0,30,4
1746563655494,DSC 197,001,956898,Eldridge; Justin Matthew,9996,0,9999,3
1746563656522,DSC 297,001,958000,Mazumdar; Arya,9998,0,9999,1
1746563656522,DSC 297,002,959862,Wang; Yusu,9998,0,9999,1
1746563657549,EAP 100,A00,905686,Staff,9778,0,9999,221
1746563658576,ECE 45,A01,892618,Staff,0,0,65,65
1746563660634,ECE 111,A01,892719,Staff,4,0,65,61
1746563661658,ECE 197,001,957920,Mercier; Patrick Philip,9991,0,9999,8
1746563662684,ECON 178,A01,907814,Zhu; Ying,26,0,35,9
1746563663711,EDS 115,A00,895312,Staff,35,0,45,10
1746563664737,EDS 117,A01,895337,Staff,23,0,30,7
1746563665764,EDS 125,A00,895341,Jones; Gabrielle Anastasia,36,0,45,9
1746563666792,EDS 128A,A01,895459,Fargason; Sharon Gayle,44,0,45,1
1746563667820,EDS 128B,A01,895543,Pappas; Elizabeth,44,0,45,1
1746563668845,EDS 139,A00,897203,Pappas; Elizabeth,44,0,45,1
1746563668845,EDS 139,B00,897209,Fargason; Sharon Gayle,41,0,45,4
1746563669872,EDS 201,A00,895545,Staff,22,0,45,23
1746563670896,EDS 203,A01,895581,Halter; Christopher P.,22,0,45,23
1746563671923,EDS 204R,A01,895625,Heinzman; Erica M.,39,0,45,6
1746563671923,EDS 204R,B01,895693,Halter; Christopher P.,10,0,45,35
1746563672949,EDS 206R,A00,895694,Fargason; Sharon Gayle,1,0,30,29
1746563672949,EDS 206R,B00,895695,Choi; Bailey Miyeon,16,0,30,14
1746563673980,EDS 250,A00,895697,Hemans; Patricia Ann Benitez,22,0,45,23
1746563675008,EDS 281,A00,895701,Meyerott; Theresa Ann,1,0,15,14
1746563676033,EDS 284,A00,895736,Meyerott; Theresa Ann,1,0,15,14
1746563677059,EDS 286,A00,897210,Fine; Sarah,0,0,15,15
1746563678087,EDS 289C,A01,895770,Daly; Alan J.,1,0,15,14
1746563679116,EDS 290,A00,897211,Hofstetter; Carolyn,0,0,15,15
1746563680146,LIGM 5A,A00,896162,Fischer-Grunski; Eva K,12,0,20,8
1746563681174,LIGM 5B,A00,896260,Fischer-Grunski; Eva K,17,0,20,3
1746563682203,LIGM 5C,A00,896308,Fischer-Grunski; Eva K,18,0,20,2
1746563683231,LIIT 5AS,A00,896313,Carnelos; Chiara,18,0,20,2
1746563684257,LIIT 5BS,A00,896416,Carnelos; Chiara,20,0,20,0
1746563685282,LIIT 5CS,A00,896564,Carnelos; Chiara,20,0,20,0
1746563686307,LISP 5A,A00,896588,Munoz Sanchez; Alicia,3,0,20,17
1746563687337,LISP 5B,A00,896653,Munoz Sanchez; Alicia,7,0,20,13
1746563688362,LISP 5C,A00,896655,Munoz Sanchez; Alicia,0,1,20,20
1746563689385,MAE 197,001,957918,Kleissl; Jan,9996,0,9999,3
1746563689385,MAE 197,002,959806,Boechler; Nicholas Sebastia,9998,0,9999,1
1746563689385,MAE 197,003,959852,Mullin; Jennifer S,9998,0,9999,1
1746563690411,MATH 2,A01,957937,Staff,33,0,35,2
1746563691437,MATH 197,001,957876,Kedlaya; Kiran S.,9993,0,9999,6
1746563692523,MCWP 40,A00,892729,Duru; Nur,10,0,20,10
1746563692523,MCWP 40,B00,893304,Montejo; Carolina,14,0,20,6
1746563693548,MCWP 40R,A00,893757,Redela; Pamela Morgan,0,5,20,20
1746563694573,MCWP 50,A00,893758,Morshed; Michael James,0,0,20,20
1746563694573,MCWP 50,B00,893761,Bartulis; Jason Michael,17,0,20,3
1746563695597,MCWP 50R,A00,893766,Compas; Sean Matthew,0,1,20,20
1746563695597,MCWP 50R,B00,893769,Carter; Jennifer A,0,1,20,20
1746563695597,MCWP 50R,C00,893771,Krone; Jarret,0,3,20,20
1746563695597,MCWP 50R,D00,893772,Miller; Elizabeth Deen,0,0,20,20
1746563695597,MCWP 50R,E00,893775,Carter; Andrea L,0,1,20,20
1746563696625,MMW 11R,A01,892721,Herbst; Matthew,11,0,27,16
1746563696625,MMW 11R,A02,892722,Herbst; Matthew,0,0,0,3
1746563697652,MMW 12R,A01,892724,Herbst; Matthew,0,11,16,16
1746563697652,MMW 12R,A02,892725,Herbst; Matthew,0,10,16,16
1746563698680,MMW 13R,A01,892727,Staff,0,4,16,16
1746563698680,MMW 13R,A02,892728,Staff,0,4,16,16
1746563698680,MMW 13R,A03,958032,Staff,0,4,16,16
1746563698680,MMW 13R,A04,958033,Staff,0,4,16,16
1746563698680,MMW 13R,A05,958034,Staff,0,4,16,16
1746563699709,SIO 295LS,A00,894015,Staff,5,0,25,20
1746563700736,SIO 295S,A00,894020,Staff,5,0,25,20
1746563701766,SIOC 290S,B01,958918,Merrifield; Mark A,14,0,30,16
1746563702790,SIOC 291S,B01,958922,Gabriel; Corey John,14,0,30,16
1746563703820,SOCI 117,A01,895339,Staff,3,0,5,2
1746563704848,WES 237B,A00,894149,Staff,11,0,20,9
1746563706902,AESE 279B,A00,891859,Staff,13,0,35,22
1746563707930,AIP 197,001,891854,Vespa; Emanuel Ignacio,9999,0,9999,0
1746563708957,ANTH 289S,A00,891856,Gagneux; Pascal,12,0,12,0
1746563709983,BENG 196,001,957946,Engler; Adam J.,9996,0,9999,3
1746563711011,BISP 197,001,959851,Wilhelm; James E.,9998,0,9999,1
1746563712036,CAT 124RS,A01,956906,Staff,6,0,25,19
1746563713061,CAT 125RS,A01,922013,Staff,6,0,25,19
1746563714087,CLRE 250,A00,891860,Morris; Sheldon,9995,0,9999,4
1746563716140,CLRE 251R,A00,907817,Mehta; Ravindra L.,9994,0,9999,5
1746563717164,CLRE 252,A00,891864,Cuomo; Raphael Eduardo,9993,0,9999,6
1746563718192,CLRE 253,A00,891867,Vaida; Florin,9994,0,9999,5
1746563718192,CLRE 253,B00,907819,Staff,9999,0,9999,0
1746563719217,CLRE 259,A00,891868,Patel; Hemal,9998,0,9999,1
1746563720242,CLRE 260,A00,891872,Cuomo; Raphael Eduardo,9999,0,9999,0
1746563721270,CLRE 297,001,891888,Cuomo; Raphael Eduardo,9999,0,9999,0
1746563722295,CSE 191,A00,958773,Minnes Kemp; Mor Mia,9995,0,9999,4
1746563723319,CSE 197,001,959846,Minnes Kemp; Mor Mia,9990,0,9999,9
1746563724347,CSS 201S,A01,892054,Mignozzetti; Umberto,26,0,30,4
1746563725373,CSS 202S,A01,892056,Mignozzetti; Umberto,26,0,30,4
1746563726398,DSC 197,001,956898,Eldridge; Justin Matthew,9996,0,9999,3
1746563727422,DSC 297,001,958000,Mazumdar; Arya,9998,0,9999,1
1746563727422,DSC 297,002,959862,Wang; Yusu,9998,0,9999,1
1746563728447,EAP 100,A00,905686,Staff,9778,0,9999,221
1746563729473,ECE 45,A01,892618,Staff,0,0,65,65
1746563731527,ECE 111,A01,892719,Staff,4,0,65,61
1746563732552,ECE 197,001,957920,Mercier; Patrick Philip,9991,0,9999,8
1746563733579,ECON 178,A01,907814,Zhu; Ying,26,0,35,9
1746563734603,EDS 115,A00,895312,Staff,35,0,45,10
1746563735630,EDS 117,A01,895337,Staff,23,0,30,7
1746563736654,EDS 125,A00,895341,Jones; Gabrielle Anastasia,36,0,45,9
1746563737681,EDS 128A,A01,895459,Fargason; Sharon Gayle,44,0,45,1
1746563738707,EDS 128B,A01,895543,Pappas; Elizabeth,44,0,45,1
1746563739731,EDS 139,A00,897203,Pappas; Elizabeth,44,0,45,1
1746563739731,EDS 139,B00,897209,Fargason; Sharon Gayle,41,0,45,4
1746563740756,EDS 201,A00,895545,Staff,22,0,45,23
1746563741779,EDS 203,A01,895581,Halter; Christopher P.,22,0,45,23
1746563742804,EDS 204R,A01,895625,Heinzman; Erica M.,39,0,45,6
1746563742804,EDS 204R,B01,895693,Halter; Christopher P.,10,0,45,35
1746563743828,EDS 206R,A00,895694,Fargason; Sharon Gayle,1,0,30,29
1746563743828,EDS 206R,B00,895695,Choi; Bailey Miyeon,16,0,30,14
1746563744855,EDS 250,A00,895697,Hemans; Patricia Ann Benitez,22,0,45,23
1746563745881,EDS 281,A00,895701,Meyerott; Theresa Ann,1,0,15,14
1746563746907,EDS 284,A00,895736,Meyerott; Theresa Ann,1,0,15,14
1746563747935,EDS 286,A00,897210,Fine; Sarah,0,0,15,15
1746563748959,EDS 289C,A01,895770,Daly; Alan J.,1,0,15,14
1746563749992,EDS 290,A00,897211,Hofstetter; Carolyn,0,0,15,15
1746563751021,LIGM 5A,A00,896162,Fischer-Grunski; Eva K,12,0,20,8
1746563752047,LIGM 5B,A00,896260,Fischer-Grunski; Eva K,17,0,20,3
1746563753073,LIGM 5C,A00,896308,Fischer-Grunski; Eva K,18,0,20,2
1746563754097,LIIT 5AS,A00,896313,Carnelos; Chiara,18,0,20,2
1746563755123,LIIT 5BS,A00,896416,Carnelos; Chiara,20,0,20,0
1746563756151,LIIT 5CS,A00,896564,Carnelos; Chiara,20,0,20,0
1746563757180,LISP 5A,A00,896588,Munoz Sanchez; Alicia,3,0,20,17
1746563758205,LISP 5B,A00,896653,Munoz Sanchez; Alicia,7,0,20,13
1746563759234,LISP 5C,A00,896655,Munoz Sanchez; Alicia,0,1,20,20
1746563760266,MAE 197,001,957918,Kleissl; Jan,9996,0,9999,3
1746563760266,MAE 197,002,959806,Boechler; Nicholas Sebastia,9998,0,9999,1
1746563760266,MAE 197,003,959852,Mullin; Jennifer S,9998,0,9999,1
1746563761301,MATH 2,A01,957937,Staff,33,0,35,2
1746563762325,MATH 197,001,957876,Kedlaya; Kiran S.,9993,0,9999,6
1746563763354,MCWP 40,A00,892729,Duru; Nur,10,0,20,10
1746563763354,MCWP 40,B00,893304,Montejo; Carolina,14,0,20,6
1746563764380,MCWP 40R,A00,893757,Redela; Pamela Morgan,0,5,20,20
1746563765404,MCWP 50,A00,893758,Morshed; Michael James,0,0,20,20
1746563765404,MCWP 50,B00,893761,Bartulis; Jason Michael,17,0,20,3
1746563766435,MCWP 50R,A00,893766,Compas; Sean Matthew,0,1,20,20
1746563766435,MCWP 50R,B00,893769,Carter; Jennifer A,0,1,20,20
1746563766435,MCWP 50R,C00,893771,Krone; Jarret,0,3,20,20
1746563766435,MCWP 50R,D00,893772,Miller; Elizabeth Deen,0,0,20,20
1746563766435,MCWP 50R,E00,893775,Carter; Andrea L,0,1,20,20
1746563767462,MMW 11R,A01,892721,Herbst; Matthew,11,0,27,16
1746563767462,MMW 11R,A02,892722,Herbst; Matthew,0,0,0,3
1746563768489,MMW 12R,A01,892724,Herbst; Matthew,0,11,16,16
1746563768489,MMW 12R,A02,892725,Herbst; Matthew,0,10,16,16
1746563769514,MMW 13R,A01,892727,Staff,0,4,16,16
1746563769514,MMW 13R,A02,892728,Staff,0,4,16,16
1746563769514,MMW 13R,A03,958032,Staff,0,4,16,16
1746563769514,MMW 13R,A04,958033,Staff,0,4,16,16
1746563769514,MMW 13R,A05,958034,Staff,0,4,16,16
1746563770538,SIO 295LS,A00,894015,Staff,5,0,25,20
1746563771566,SIO 295S,A00,894020,Staff,5,0,25,20
1746563772590,SIOC 290S,B01,958918,Merrifield; Mark A,14,0,30,16
1746563773620,SIOC 291S,B01,958922,Gabriel; Corey John,14,0,30,16
1746563774645,SOCI 117,A01,895339,Staff,3,0,5,2
1746563775669,WES 237B,A00,894149,Staff,11,0,20,9
1746563777724,AESE 279B,A00,891859,Staff,13,0,35,22
1746563778749,AIP 197,001,891854,Vespa; Emanuel Ignacio,9999,0,9999,0
1746563779777,ANTH 289S,A00,891856,Gagneux; Pascal,12,0,12,0
1746563780805,BENG 196,001,957946,Engler; Adam J.,9996,0,9999,3
1746563781831,BISP 197,001,959851,Wilhelm; James E.,9998,0,9999,1
1746563782858,CAT 124RS,A01,956906,Staff,6,0,25,19
1746563783881,CAT 125RS,A01,922013,Staff,6,0,25,19
1746563784906,CLRE 250,A00,891860,Morris; Sheldon,9995,0,9999,4
1746563786959,CLRE 251R,A00,907817,Mehta; Ravindra L.,9994,0,9999,5
1746563787984,CLRE 252,A00,891864,Cuomo; Raphael Eduardo,9993,0,9999,6
1746563789008,CLRE 253,A00,891867,Vaida; Florin,9994,0,9999,5
1746563789008,CLRE 253,B00,907819,Staff,9999,0,9999,0
1746563790036,CLRE 259,A00,891868,Patel; Hemal,9998,0,9999,1
1746563791063,CLRE 260,A00,891872,Cuomo; Raphael Eduardo,9999,0,9999,0
1746563792088,CLRE 297,001,891888,Cuomo; Raphael Eduardo,9999,0,9999,0
1746563793114,CSE 191,A00,958773,Minnes Kemp; Mor Mia,9995,0,9999,4
1746563794139,CSE 197,001,959846,Minnes Kemp; Mor Mia,9990,0,9999,9
1746563795163,CSS 201S,A01,892054,Mignozzetti; Umberto,26,0,30,4
1746563796188,CSS 202S,A01,892056,Mignozzetti; Umberto,26,0,30,4
1746563797212,DSC 197,001,956898,Eldridge; Justin Matthew,9996,0,9999,3
1746563798240,DSC 297,001,958000,Mazumdar; Arya,9998,0,9999,1
1746563798240,DSC 297,002,959862,Wang; Yusu,9998,0,9999,1
1746563799268,EAP 100,A00,905686,Staff,9778,0,9999,221
1746563800296,ECE 45,A01,892618,Staff,0,0,65,65
1746563802351,ECE 111,A01,892719,Staff,4,0,65,61
1746563803375,ECE 197,001,957920,Mercier; Patrick Philip,9991,0,9999,8
1746563804404,ECON 178,A01,907814,Zhu; Ying,26,0,35,9
1746563805431,EDS 115,A00,895312,Staff,35,0,45,10
1746563806454,EDS 117,A01,895337,Staff,23,0,30,7
1746563807480,EDS 125,A00,895341,Jones; Gabrielle Anastasia,36,0,45,9
1746563808508,EDS 128A,A01,895459,Fargason; Sharon Gayle,44,0,45,1
1746563809537,EDS 128B,A01,895543,Pappas; Elizabeth,44,0,45,1
1746563810561,EDS 139,A00,897203,Pappas; Elizabeth,44,0,45,1
1746563810561,EDS 139,B00,897209,Fargason; Sharon Gayle,41,0,45,4
1746563811585,EDS 201,A00,895545,Staff,22,0,45,23
1746563812607,EDS 203,A01,895581,Halter; Christopher P.,22,0,45,23
1746563813631,EDS 204R,A01,895625,Heinzman; Erica M.,39,0,45,6
1746563813631,EDS 204R,B01,895693,Halter; Christopher P.,10,0,45,35
1746563814655,EDS 206R,A00,895694,Fargason; Sharon Gayle,1,0,30,29
1746563814655,EDS 206R,B00,895695,Choi; Bailey Miyeon,16,0,30,14
1746563815680,EDS 250,A00,895697,Hemans; Patricia Ann Benitez,22,0,45,23
1746563816705,EDS 281,A00,895701,Meyerott; Theresa Ann,1,0,15,14
1746563817734,EDS 284,A00,895736,Meyerott; Theresa Ann,1,0,15,14
1746563818757,EDS 286,A00,897210,Fine; Sarah,0,0,15,15
1746563819782,EDS 289C,A01,895770,Daly; Alan J.,1,0,15,14
1746563820807,EDS 290,A00,897211,Hofstetter; Carolyn,0,0,15,15
1746563821835,LIGM 5A,A00,896162,Fischer-Grunski; Eva K,12,0,20,8
1746563822861,LIGM 5B,A00,896260,Fischer-Grunski; Eva K,17,0,20,3
1746563823885,LIGM 5C,A00,896308,Fischer-Grunski; Eva K,18,0,20,2
1746563824910,LIIT 5AS,A00,896313,Carnelos; Chiara,18,0,20,2
1746563825936,LIIT 5BS,A00,896416,Carnelos; Chiara,20,0,20,0
1746563826960,LIIT 5CS,A00,896564,Carnelos; Chiara,20,0,20,0
1746563827988,LISP 5A,A00,896588,Munoz Sanchez; Alicia,3,0,20,17
1746563829011,LISP 5B,A00,896653,Munoz Sanchez; Alicia,7,0,20,13
1746563830036,LISP 5C,A00,896655,Munoz Sanchez; Alicia,0,1,20,20
1746563831064,MAE 197,001,957918,Kleissl; Jan,9996,0,9999,3
1746563831064,MAE 197,002,959806,Boechler; Nicholas Sebastia,9998,0,9999,1
1746563831064,MAE 197,003,959852,Mullin; Jennifer S,9998,0,9999,1
1746563832092,MATH 2,A01,957937,Staff,33,0,35,2
1746563833118,MATH 197,001,957876,Kedlaya; Kiran S.,9993,0,9999,6
1746563834144,MCWP 40,A00,892729,Duru; Nur,10,0,20,10
1746563834144,MCWP 40,B00,893304,Montejo; Carolina,14,0,20,6
1746563835168,MCWP 40R,A00,893757,Redela; Pamela Morgan,0,5,20,20
1746563836198,MCWP 50,A00,893758,Morshed; Michael James,0,0,20,20
1746563836198,MCWP 50,B00,893761,Bartulis; Jason Michael,17,0,20,3
1746563837225,MCWP 50R,A00,893766,Compas; Sean Matthew,0,1,20,20
1746563837225,MCWP 50R,B00,893769,Carter; Jennifer A,0,1,20,20
1746563837225,MCWP 50R,C00,893771,Krone; Jarret,0,3,20,20
1746563837225,MCWP 50R,D00,893772,Miller; Elizabeth Deen,0,0,20,20
1746563837225,MCWP 50R,E00,893775,Carter; Andrea L,0,1,20,20
1746563838252,MMW 11R,A01,892721,Herbst; Matthew,11,0,27,16
1746563838252,MMW 11R,A02,892722,Herbst; Matthew,0,0,0,3
1746563839276,MMW 12R,A01,892724,Herbst; Matthew,0,11,16,16
1746563839276,MMW 12R,A02,892725,Herbst; Matthew,0,10,16,16
1746563840305,MMW 13R,A01,892727,Staff,0,4,16,16
1746563840305,MMW 13R,A02,892728,Staff,0,4,16,16
1746563840305,MMW 13R,A03,958032,Staff,0,4,16,16
1746563840305,MMW 13R,A04,958033,Staff,0,4,16,16
1746563840305,MMW 13R,A05,958034,Staff,0,4,16,16
1746563841332,SIO 295LS,A00,894015,Staff,5,0,25,20
1746563842356,SIO 295S,A00,894020,Staff,5,0,25,20
1746563843382,SIOC 290S,B01,958918,Merrifield; Mark A,14,0,30,16
1746563844412,SIOC 291S,B01,958922,Gabriel; Corey John,14,0,30,16
1746563845439,SOCI 117,A01,895339,Staff,3,0,5,2
1746563846467,WES 237B,A00,894149,Staff,11,0,20,9
1746563848532,AESE 279B,A00,891859,Staff,13,0,35,22
1746563849558,AIP 197,001,891854,Vespa; Emanuel Ignacio,9999,0,9999,0
1746563850581,ANTH 289S,A00,891856,Gagneux; Pascal,12,0,12,0
1746563851604,BENG 196,001,957946,Engler; Adam J.,9996,0,9999,3
1746563852630,BISP 197,001,959851,Wilhelm; James E.,9998,0,9999,1
1746563853655,CAT 124RS,A01,956906,Staff,6,0,25,19
1746563854681,CAT 125RS,A01,922013,Staff,6,0,25,19
1746563855708,CLRE 250,A00,891860,Morris; Sheldon,9995,0,9999,4
1746563857755,CLRE 251R,A00,907817,Mehta; Ravindra L.,9994,0,9999,5
1746563858781,CLRE 252,A00,891864,Cuomo; Raphael Eduardo,9993,0,9999,6
1746563859806,CLRE 253,A00,891867,Vaida; Florin,9994,0,9999,5
1746563859806,CLRE 253,B00,907819,Staff,9999,0,9999,0
1746563860834,CLRE 259,A00,891868,Patel; Hemal,9998,0,9999,1
1746563861858,CLRE 260,A00,891872,Cuomo; Raphael Eduardo,9999,0,9999,0
1746563862886,CLRE 297,001,891888,Cuomo; Raphael Eduardo,9999,0,9999,0
1746563863917,CSE 191,A00,958773,Minnes Kemp; Mor Mia,9995,0,9999,4
1746563864946,CSE 197,001,959846,Minnes Kemp; Mor Mia,9990,0,9999,9
1746563865977,CSS 201S,A01,892054,Mignozzetti; Umberto,26,0,30,4
1746563867003,CSS 202S,A01,892056,Mignozzetti; Umberto,26,0,30,4
1746563868028,DSC 197,001,956898,Eldridge; Justin Matthew,9996,0,9999,3
1746563869055,DSC 297,001,958000,Mazumdar; Arya,9998,0,9999,1
1746563869055,DSC 297,002,959862,Wang; Yusu,9998,0,9999,1
1746563870089,EAP 100,A00,905686,Staff,9778,0,9999,221
1746563871119,ECE 45,A01,892618,Staff,0,0,65,65
1746563873170,ECE 111,A01,892719,Staff,4,0,65,61
1746563874203,ECE 197,001,957920,Mercier; Patrick Philip,9991,0,9999,8
1746563875232,ECON 178,A01,907814,Zhu; Ying,26,0,35,9
1746563876260,EDS 115,A00,895312,Staff,35,0,45,10
1746563877284,EDS 117,A01,895337,Staff,23,0,30,7
1746563878308,EDS 125,A00,895341,Jones; Gabrielle Anastasia,36,0,45,9
1746563879333,EDS 128A,A01,895459,Fargason; Sharon Gayle,44,0,45,1
1746563880360,EDS 128B,A01,895543,Pappas; Elizabeth,44,0,45,1
1746563881384,EDS 139,A00,897203,Pappas; Elizabeth,44,0,45,1
1746563881384,EDS 139,B00,897209,Fargason; Sharon Gayle,41,0,45,4
1746563882422,EDS 201,A00,895545,Staff,22,0,45,23
1746563883446,EDS 203,A01,895581,Halter; Christopher P.,22,0,45,23
1746563884472,EDS 204R,A01,895625,Heinzman; Erica M.,39,0,45,6
1746563884472,EDS 204R,B01,895693,Halter; Christopher P.,10,0,45,35
1746563885496,EDS 206R,A00,895694,Fargason; Sharon Gayle,1,0,30,29
1746563885496,EDS 206R,B00,895695,Choi; Bailey Miyeon,16,0,30,14
1746563886523,EDS 250,A00,895697,Hemans; Patricia Ann Benitez,22,0,45,23
1746563887548,EDS 281,A00,895701,Meyerott; Theresa Ann,1,0,15,14
1746563888574,EDS 284,A00,895736,Meyerott; Theresa Ann,1,0,15,14
1746563889601,EDS 286,A00,897210,Fine; Sarah,0,0,15,15
1746563890628,EDS 289C,A01,895770,Daly; Alan J.,1,0,15,14
1746563891656,EDS 290,A00,897211,Hofstetter; Carolyn,0,0,15,15
1746563892683,LIGM 5A,A00,896162,Fischer-Grunski; Eva K,12,0,20,8
1746563893714,LIGM 5B,A00,896260,Fischer-Grunski; Eva K,17,0,20,3
1746563894739,LIGM 5C,A00,896308,Fischer-Grunski; Eva K,18,0,20,2
1746563895767,LIIT 5AS,A00,896313,Carnelos; Chiara,18,0,20,2
1746563896794,LIIT 5BS,A00,896416,Carnelos; Chiara,20,0,20,0
1746563897821,LIIT 5CS,A00,896564,Carnelos; Chiara,20,0,20,0
1746563898845,LISP 5A,A00,896588,Munoz Sanchez; Alicia,3,0,20,17
1746563899869,LISP 5B,A00,896653,Munoz Sanchez; Alicia,7,0,20,13
1746563900898,LISP 5C,A00,896655,Munoz Sanchez; Alicia,0,1,20,20
1746563901927,MAE 197,001,957918,Kleissl; Jan,9996,0,9999,3
1746563901927,MAE 197,002,959806,Boechler; Nicholas Sebastia,9998,0,9999,1
1746563901927,MAE 197,003,959852,Mullin; Jennifer S,9998,0,9999,1
1746563902952,MATH 2,A01,957937,Staff,33,0,35,2
1746563903976,MATH 197,001,957876,Kedlaya; Kiran S.,9993,0,9999,6
1746563905003,MCWP 40,A00,892729,Duru; Nur,10,0,20,10
1746563905003,MCWP 40,B00,893304,Montejo; Carolina,14,0,20,6
1746563906032,MCWP 40R,A00,893757,Redela; Pamela Morgan,0,5,20,20
1746563907060,MCWP 50,A00,893758,Morshed; Michael James,0,0,20,20
1746563907060,MCWP 50,B00,893761,Bartulis; Jason Michael,17,0,20,3
1746563908088,MCWP 50R,A00,893766,Compas; Sean Matthew,0,1,20,20
1746563908088,MCWP 50R,B00,893769,Carter; Jennifer A,0,1,20,20
1746563908088,MCWP 50R,C00,893771,Krone; Jarret,0,3,20,20
1746563908088,MCWP 50R,D00,893772,Miller; Elizabeth Deen,0,0,20,20
1746563908088,MCWP 50R,E00,893775,Carter; Andrea L,0,1,20,20
1746563909114,MMW 11R,A01,892721,Herbst; Matthew,11,0,27,16
1746563909114,MMW 11R,A02,892722,Herbst; Matthew,0,0,0,3
1746563910139,MMW 12R,A01,892724,Herbst; Matthew,0,11,16,16
1746563910139,MMW 12R,A02,892725,Herbst; Matthew,0,10,16,16
1746563911168,MMW 13R,A01,892727,Staff,0,4,16,16
1746563911168,MMW 13R,A02,892728,Staff,0,4,16,16
1746563911168,MMW 13R,A03,958032,Staff,0,4,16,16
1746563911168,MMW 13R,A04,958033,Staff,0,4,16,16
1746563911168,MMW 13R,A05,958034,Staff,0,4,16,16
1746563912196,SIO 295LS,A00,894015,Staff,5,0,25,20
1746563913223,SIO 295S,A00,894020,Staff,5,0,25,20
1746563914251,SIOC 290S,B01,958918,Merrifield; Mark A,14,0,30,16
1746563915281,SIOC 291S,B01,958922,Gabriel; Corey John,14,0,30,16
1746563916306,SOCI 117,A01,895339,Staff,3,0,5,2
1746563917331,WES 237B,A00,894149,Staff,11,0,20,9
1746563919399,AESE 279B,A00,891859,Staff,13,0,35,22
1746563920424,AIP 197,001,891854,Vespa; Emanuel Ignacio,9999,0,9999,0
1746563921449,ANTH 289S,A00,891856,Gagneux; Pascal,12,0,12,0
1746563922473,BENG 196,001,957946,Engler; Adam J.,9996,0,9999,3
1746563923497,BISP 197,001,959851,Wilhelm; James E.,9998,0,9999,1
1746563924522,CAT 124RS,A01,956906,Staff,6,0,25,19
1746563925547,CAT 125RS,A01,922013,Staff,6,0,25,19
1746563926575,CLRE 250,A00,891860,Morris; Sheldon,9995,0,9999,4
1746563928626,CLRE 251R,A00,907817,Mehta; Ravindra L.,9994,0,9999,5
1746563929651,CLRE 252,A00,891864,Cuomo; Raphael Eduardo,9993,0,9999,6
1746563930675,CLRE 253,A00,891867,Vaida; Florin,9994,0,9999,5
1746563930675,CLRE 253,B00,907819,Staff,9999,0,9999,0
1746563931700,CLRE 259,A00,891868,Patel; Hemal,9998,0,9999,1
1746563932727,CLRE 260,A00,891872,Cuomo; Raphael Eduardo,9999,0,9999,0
1746563933753,CLRE 297,001,891888,Cuomo; Raphael Eduardo,9999,0,9999,0
1746563934784,CSE 191,A00,958773,Minnes Kemp; Mor Mia,9995,0,9999,4
1746563935812,CSE 197,001,959846,Minnes Kemp; Mor Mia,9990,0,9999,9
1746563936837,CSS 201S,A01,892054,Mignozzetti; Umberto,26,0,30,4
1746563937861,CSS 202S,A01,892056,Mignozzetti; Umberto,26,0,30,4
1746563938887,DSC 197,001,956898,Eldridge; Justin Matthew,9996,0,9999,3
1746563939915,DSC 297,001,958000,Mazumdar; Arya,9998,0,9999,1
1746563939915,DSC 297,002,959862,Wang; Yusu,9998,0,9999,1
1746563940942,EAP 100,A00,905686,Staff,9778,0,9999,221
1746563941972,ECE 45,A01,892618,Staff,0,0,65,65
1746563944028,ECE 111,A01,892719,Staff,4,0,65,61
1746563945054,ECE 197,001,957920,Mercier; Patrick Philip,9991,0,9999,8
1746563946079,ECON 178,A01,907814,Zhu; Ying,26,0,35,9
1746563947108,EDS 115,A00,895312,Staff,35,0,45,10
1746563948136,EDS 117,A01,895337,Staff,23,0,30,7
1746563949166,EDS 125,A00,895341,Jones; Gabrielle Anastasia,36,0,45,9
1746563950191,EDS 128A,A01,895459,Fargason; Sharon Gayle,44,0,45,1
1746563951219,EDS 128B,A01,895543,Pappas; Elizabeth,44,0,45,1
1746563952242,EDS 139,A00,897203,Pappas; Elizabeth,44,0,45,1
1746563952242,EDS 139,B00,897209,Fargason; Sharon Gayle,41,0,45,4
1746563953267,EDS 201,A00,895545,Staff,22,0,45,23
1746563954294,EDS 203,A01,895581,Halter; Christopher P.,22,0,45,23
1746563955321,EDS 204R,A01,895625,Heinzman; Erica M.,39,0,45,6
1746563955321,EDS 204R,B01,895693,Halter; Christopher P.,10,0,45,35
1746563956348,EDS 206R,A00,895694,Fargason; Sharon Gayle,1,0,30,29
1746563956348,EDS 206R,B00,895695,Choi; Bailey Miyeon,16,0,30,14
1746563957375,EDS 250,A00,895697,Hemans; Patricia Ann Benitez,22,0,45,23
1746563958403,EDS 281,A00,895701,Meyerott; Theresa Ann,1,0,15,14
1746563959432,EDS 284,A00,895736,Meyerott; Theresa Ann,1,0,15,14
1746563960457,EDS 286,A00,897210,Fine; Sarah,0,0,15,15
1746563961482,EDS 289C,A01,895770,Daly; Alan J.,1,0,15,14
1746563962510,EDS 290,A00,897211,Hofstetter; Carolyn,0,0,15,15
1746563963537,LIGM 5A,A00,896162,Fischer-Grunski; Eva K,12,0,20,8
1746563964566,LIGM 5B,A00,896260,Fischer-Grunski; Eva K,17,0,20,3
1746563965592,LIGM 5C,A00,896308,Fischer-Grunski; Eva K,18,0,20,2
1746563966622,LIIT 5AS,A00,896313,Carnelos; Chiara,18,0,20,2
1746563967648,LIIT 5BS,A00,896416,Carnelos; Chiara,20,0,20,0
1746563968673,LIIT 5CS,A00,896564,Carnelos; Chiara,20,0,20,0
1746563969701,LISP 5A,A00,896588,Munoz Sanchez; Alicia,3,0,20,17
1746563970727,LISP 5B,A00,896653,Munoz Sanchez; Alicia,7,0,20,13
1746563971755,LISP 5C,A00,896655,Munoz Sanchez; Alicia,0,1,20,20
1746563972784,MAE 197,001,957918,Kleissl; Jan,9996,0,9999,3
1746563972784,MAE 197,002,959806,Boechler; Nicholas Sebastia,9998,0,9999,1
1746563972784,MAE 197,003,959852,Mullin; Jennifer S,9998,0,9999,1
1746563973814,MATH 2,A01,957937,Staff,33,0,35,2
1746563974841,MATH 197,001,957876,Kedlaya; Kiran S.,9993,0,9999,6
1746563975869,MCWP 40,A00,892729,Duru; Nur,10,0,20,10
1746563975869,MCWP 40,B00,893304,Montejo; Carolina,14,0,20,6
1746563976895,MCWP 40R,A00,893757,Redela; Pamela Morgan,0,5,20,20
1746563977922,MCWP 50,A00,893758,Morshed; Michael James,0,0,20,20
1746563977922,MCWP 50,B00,893761,Bartulis; Jason Michael,17,0,20,3
1746563978949,MCWP 50R,A00,893766,Compas; Sean Matthew,0,1,20,20
1746563978949,MCWP 50R,B00,893769,Carter; Jennifer A,0,1,20,20
1746563978949,MCWP 50R,C00,893771,Krone; Jarret,0,3,20,20
1746563978949,MCWP 50R,D00,893772,Miller; Elizabeth Deen,0,0,20,20
1746563978949,MCWP 50R,E00,893775,Carter; Andrea L,0,1,20,20
1746563979973,MMW 11R,A01,892721,Herbst; Matthew,11,0,27,16
1746563979973,MMW 11R,A02,892722,Herbst; Matthew,0,0,0,3
1746563980999,MMW 12R,A01,892724,Herbst; Matthew,0,11,16,16
1746563980999,MMW 12R,A02,892725,Herbst; Matthew,0,10,16,16
1746563982026,MMW 13R,A01,892727,Staff,0,4,16,16
1746563982026,MMW 13R,A02,892728,Staff,0,4,16,16
1746563982026,MMW 13R,A03,958032,Staff,0,4,16,16
1746563982026,MMW 13R,A04,958033,Staff,0,4,16,16
1746563982026,MMW 13R,A05,958034,Staff,0,4,16,16
1746563983051,SIO 295LS,A00,894015,Staff,5,0,25,20
1746563984077,SIO 295S,A00,894020,Staff,5,0,25,20
1746563985108,SIOC 290S,B01,958918,Merrifield; Mark A,14,0,30,16
1746563986132,SIOC 291S,B01,958922,Gabriel; Corey John,14,0,30,16
1746563987159,SOCI 117,A01,895339,Staff,3,0,5,2
1746563988184,WES 237B,A00,894149,Staff,11,0,20,9
1746563990252,AESE 279B,A00,891859,Staff,13,0,35,22
1746563991276,AIP 197,001,891854,Vespa; Emanuel Ignacio,9999,0,9999,0
1746563992305,ANTH 289S,A00,891856,Gagneux; Pascal,12,0,12,0
1746563993329,BENG 196,001,957946,Engler; Adam J.,9996,0,9999,3
1746563994356,BISP 197,001,959851,Wilhelm; James E.,9998,0,9999,1
1746563995379,CAT 124RS,A01,956906,Staff,6,0,25,19
1746563996404,CAT 125RS,A01,922013,Staff,6,0,25,19
1746563997427,CLRE 250,A00,891860,Morris; Sheldon,9995,0,9999,4
1746563999485,CLRE 251R,A00,907817,Mehta; Ravindra L.,9994,0,9999,5
1746564000511,CLRE 252,A00,891864,Cuomo; Raphael Eduardo,9993,0,9999,6
1746564001536,CLRE 253,A00,891867,Vaida; Florin,9994,0,9999,5
1746564001536,CLRE 253,B00,907819,Staff,9999,0,9999,0
1746564002563,CLRE 259,A00,891868,Patel; Hemal,9998,0,9999,1
1746564003590,CLRE 260,A00,891872,Cuomo; Raphael Eduardo,9999,0,9999,0
1746564004613,CLRE 297,001,891888,Cuomo; Raphael Eduardo,9999,0,9999,0
1746564005643,CSE 191,A00,958773,Minnes Kemp; Mor Mia,9995,0,9999,4
1746564006666,CSE 197,001,959846,Minnes Kemp; Mor Mia,9990,0,9999,9
1746564007697,CSS 201S,A01,892054,Mignozzetti; Umberto,26,0,30,4
1746564008721,CSS 202S,A01,892056,Mignozzetti; Umberto,26,0,30,4
1746564009746,DSC 197,001,956898,Eldridge; Justin Matthew,9996,0,9999,3
1746564010773,DSC 297,001,958000,Mazumdar; Arya,9998,0,9999,1
1746564010773,DSC 297,002,959862,Wang; Yusu,9998,0,9999,1
1746564011801,EAP 100,A00,905686,Staff,9778,0,9999,221
1746564012828,ECE 45,A01,892618,Staff,0,0,65,65
1746564014880,ECE 111,A01,892719,Staff,4,0,65,61
1746564015904,ECE 197,001,957920,Mercier; Patrick Philip,9991,0,9999,8
1746564016932,ECON 178,A01,907814,Zhu; Ying,26,0,35,9
1746564017959,EDS 115,A00,895312,Staff,35,0,45,10
1746564018983,EDS 117,A01,895337,Staff,23,0,30,7
1746564020007,EDS 125,A00,895341,Jones; Gabrielle Anastasia,36,0,45,9
1746564021032,EDS 128A,A01,895459,Fargason; Sharon Gayle,44,0,45,1
1746564022062,EDS 128B,A01,895543,Pappas; Elizabeth,44,0,45,1
1746564023090,EDS 139,A00,897203,Pappas; Elizabeth,44,0,45,1
1746564023090,EDS 139,B00,897209,Fargason; Sharon Gayle,41,0,45,4
1746564024116,EDS 201,A00,895545,Staff,22,0,45,23
1746564025141,EDS 203,A01,895581,Halter; Christopher P.,22,0,45,23
1746564026169,EDS 204R,A01,895625,Heinzman; Erica M.,39,0,45,6
1746564026169,EDS 204R,B01,895693,Halter; Christopher P.,10,0,45,35
1746564027198,EDS 206R,A00,895694,Fargason; Sharon Gayle,1,0,30,29
1746564027198,EDS 206R,B00,895695,Choi; Bailey Miyeon,16,0,30,14
1746564028223,EDS 250,A00,895697,Hemans; Patricia Ann Benitez,22,0,45,23
1746564029249,EDS 281,A00,895701,Meyerott; Theresa Ann,1,0,15,14
1746564030276,EDS 284,A00,895736,Meyerott; Theresa Ann,1,0,15,14
1746564031307,EDS 286,A00,897210,Fine; Sarah,0,0,15,15
1746564032335,EDS 289C,A01,895770,Daly; Alan J.,1,0,15,14
1746564033359,EDS 290,A00,897211,Hofstetter; Carolyn,0,0,15,15
1746564034385,LIGM 5A,A00,896162,Fischer-Grunski; Eva K,12,0,20,8
1746564035415,LIGM 5B,A00,896260,Fischer-Grunski; Eva K,17,0,20,3
1746564036441,LIGM 5C,A00,896308,Fischer-Grunski; Eva K,18,0,20,2
1746564037467,LIIT 5AS,A00,896313,Carnelos; Chiara,18,0,20,2
1746564038493,LIIT 5BS,A00,896416,Carnelos; Chiara,20,0,20,0
1746564039519,LIIT 5CS,A00,896564,Carnelos; Chiara,20,0,20,0
1746564040543,LISP 5A,A00,896588,Munoz Sanchez; Alicia,3,0,20,17
1746564041569,LISP 5B,A00,896653,Munoz Sanchez; Alicia,7,0,20,13
1746564042599,LISP 5C,A00,896655,Munoz Sanchez; Alicia,0,1,20,20
1746564043624,MAE 197,001,957918,Kleissl; Jan,9996,0,9999,3
1746564043624,MAE 197,002,959806,Boechler; Nicholas Sebastia,9998,0,9999,1
1746564043624,MAE 197,003,959852,Mullin; Jennifer S,9998,0,9999,1
1746564044650,MATH 2,A01,957937,Staff,33,0,35,2
1746564045675,MATH 197,001,957876,Kedlaya; Kiran S.,9993,0,9999,6
1746564046701,MCWP 40,A00,892729,Duru; Nur,10,0,20,10
1746564046701,MCWP 40,B00,893304,Montejo; Carolina,14,0,20,6
1746564047725,MCWP 40R,A00,893757,Redela; Pamela Morgan,0,5,20,20
1746564048749,MCWP 50,A00,893758,Morshed; Michael James,0,0,20,20
1746564048749,MCWP 50,B00,893761,Bartulis; Jason Michael,17,0,20,3
1746564049773,MCWP 50R,A00,893766,Compas; Sean Matthew,0,1,20,20
1746564049773,MCWP 50R,B00,893769,Carter; Jennifer A,0,1,20,20
1746564049773,MCWP 50R,C00,893771,Krone; Jarret,0,3,20,20
1746564049773,MCWP 50R,D00,893772,Miller; Elizabeth Deen,0,0,20,20
1746564049773,MCWP 50R,E00,893775,Carter; Andrea L,0,1,20,20
1746564050803,MMW 11R,A01,892721,Herbst; Matthew,11,0,27,16
1746564050803,MMW 11R,A02,892722,Herbst; Matthew,0,0,0,3
1746564051832,MMW 12R,A01,892724,Herbst; Matthew,0,11,16,16
1746564051832,MMW 12R,A02,892725,Herbst; Matthew,0,10,16,16
1746564052857,MMW 13R,A01,892727,Staff,0,4,16,16
1746564052857,MMW 13R,A02,892728,Staff,0,4,16,16
1746564052857,MMW 13R,A03,958032,Staff,0,4,16,16
1746564052857,MMW 13R,A04,958033,Staff,0,4,16,16
1746564052857,MMW 13R,A05,958034,Staff,0,4,16,16
1746564053886,SIO 295LS,A00,894015,Staff,5,0,25,20
1746564054910,SIO 295S,A00,894020,Staff,5,0,25,20
1746564055937,SIOC 290S,B01,958918,Merrifield; Mark A,14,0,30,16
1746564056974,SIOC 291S,B01,958922,Gabriel; Corey John,14,0,30,16
1746564058000,SOCI 117,A01,895339,Staff,3,0,5,2
1746564059029,WES 237B,A00,894149,Staff,11,0,20,9
1746564061082,AESE 279B,A00,891859,Staff,13,0,35,22
1746564062112,AIP 197,001,891854,Vespa; Emanuel Ignacio,9999,0,9999,0
1746564063137,ANTH 289S,A00,891856,Gagneux; Pascal,12,0,12,0
1746564064166,BENG 196,001,957946,Engler; Adam J.,9996,0,9999,3
1746564065192,BISP 197,001,959851,Wilhelm; James E.,9998,0,9999,1
1746564066224,CAT 124RS,A01,956906,Staff,6,0,25,19
1746564067248,CAT 125RS,A01,922013,Staff,6,0,25,19
1746564068277,CLRE 250,A00,891860,Morris; Sheldon,9995,0,9999,4
1746564070331,CLRE 251R,A00,907817,Mehta; Ravindra L.,9994,0,9999,5
1746564071357,CLRE 252,A00,891864,Cuomo; Raphael Eduardo,9993,0,9999,6
1746564072381,CLRE 253,A00,891867,Vaida; Florin,9994,0,9999,5
1746564072381,CLRE 253,B00,907819,Staff,9999,0,9999,0
1746564073404,CLRE 259,A00,891868,Patel; Hemal,9998,0,9999,1
1746564074429,CLRE 260,A00,891872,Cuomo; Raphael Eduardo,9999,0,9999,0
1746564075454,CLRE 297,001,891888,Cuomo; Raphael Eduardo,9999,0,9999,0
1746564076479,CSE 191,A00,958773,Minnes Kemp; Mor Mia,9995,0,9999,4
1746564077503,CSE 197,001,959846,Minnes Kemp; Mor Mia,9990,0,9999,9
1746564078529,CSS 201S,A01,892054,Mignozzetti; Umberto,26,0,30,4
1746564079557,CSS 202S,A01,892056,Mignozzetti; Umberto,26,0,30,4
1746564080580,DSC 197,001,956898,Eldridge; Justin Matthew,9996,0,9999,3
1746564081609,DSC 297,001,958000,Mazumdar; Arya,9998,0,9999,1
1746564081609,DSC 297,002,959862,Wang; Yusu,9998,0,9999,1
1746564093532,EAP 100,A00,905686,Staff,9778,0,9999,221
1746564094565,ECE 45,A01,892618,Staff,0,0,65,65
1746564096663,ECE 111,A01,892719,Staff,4,0,65,61
1746564097687,ECE 197,001,957920,Mercier; Patrick Philip,9991,0,9999,8
1746564098713,ECON 178,A01,907814,Zhu; Ying,26,0,35,9
1746564099737,EDS 115,A00,895312,Staff,35,0,45,10
1746564100761,EDS 117,A01,895337,Staff,23,0,30,7
1746564101786,EDS 125,A00,895341,Jones; Gabrielle Anastasia,36,0,45,9
1746564102810,EDS 128A,A01,895459,Fargason; Sharon Gayle,44,0,45,1
1746564103838,EDS 128B,A01,895543,Pappas; Elizabeth,44,0,45,1
1746564104863,EDS 139,A00,897203,Pappas; Elizabeth,44,0,45,1
1746564104863,EDS 139,B00,897209,Fargason; Sharon Gayle,41,0,45,4
1746564105892,EDS 201,A00,895545,Staff,22,0,45,23
1746564106917,EDS 203,A01,895581,Halter; Christopher P.,22,0,45,23
1746564107942,EDS 204R,A01,895625,Heinzman; Erica M.,39,0,45,6
1746564107942,EDS 204R,B01,895693,Halter; Christopher P.,10,0,45,35
1746564108967,EDS 206R,A00,895694,Fargason; Sharon Gayle,1,0,30,29
1746564108967,EDS 206R,B00,895695,Choi; Bailey Miyeon,16,0,30,14
1746564109993,EDS 250,A00,895697,Hemans; Patricia Ann Benitez,22,0,45,23
1746564111017,EDS 281,A00,895701,Meyerott; Theresa Ann,1,0,15,14
1746564112044,EDS 284,A00,895736,Meyerott; Theresa Ann,1,0,15,14
1746564113069,EDS 286,A00,897210,Fine; Sarah,0,0,15,15
1746564114098,EDS 289C,A01,895770,Daly; Alan J.,1,0,15,14
1746564115123,EDS 290,A00,897211,Hofstetter; Carolyn,0,0,15,15
1746564116152,LIGM 5A,A00,896162,Fischer-Grunski; Eva K,12,0,20,8
1746564117177,LIGM 5B,A00,896260,Fischer-Grunski; Eva K,17,0,20,3
1746564118205,LIGM 5C,A00,896308,Fischer-Grunski; Eva K,18,0,20,2
1746564119230,LIIT 5AS,A00,896313,Carnelos; Chiara,18,0,20,2
1746564120255,LIIT 5BS,A00,896416,Carnelos; Chiara,20,0,20,0
1746564121282,LIIT 5CS,A00,896564,Carnelos; Chiara,20,0,20,0
1746564122306,LISP 5A,A00,896588,Munoz Sanchez; Alicia,3,0,20,17
1746564123330,LISP 5B,A00,896653,Munoz Sanchez; Alicia,7,0,20,13
1746564124369,LISP 5C,A00,896655,Munoz Sanchez; Alicia,0,1,20,20
1746564125396,MAE 197,001,957918,Kleissl; Jan,9996,0,9999,3
1746564125396,MAE 197,002,959806,Boechler; Nicholas Sebastia,9998,0,9999,1
1746564125396,MAE 197,003,959852,Mullin; Jennifer S,9998,0,9999,1
1746564126422,MATH 2,A01,957937,Staff,33,0,35,2
1746564127447,MATH 197,001,957876,Kedlaya; Kiran S.,9993,0,9999,6
1746564128470,MCWP 40,A00,892729,Duru; Nur,10,0,20,10
1746564128470,MCWP 40,B00,893304,Montejo; Carolina,14,0,20,6
1746564129495,MCWP 40R,A00,893757,Redela; Pamela Morgan,0,5,20,20
1746564130518,MCWP 50,A00,893758,Morshed; Michael James,0,0,20,20
1746564130518,MCWP 50,B00,893761,Bartulis; Jason Michael,17,0,20,3
1746564131543,MCWP 50R,A00,893766,Compas; Sean Matthew,0,1,20,20
1746564131543,MCWP 50R,B00,893769,Carter; Jennifer A,0,1,20,20
1746564131543,MCWP 50R,C00,893771,Krone; Jarret,0,3,20,20
1746564131543,MCWP 50R,D00,893772,Miller; Elizabeth Deen,0,0,20,20
1746564131543,MCWP 50R,E00,893775,Carter; Andrea L,0,1,20,20
1746564132571,MMW 11R,A01,892721,Herbst; Matthew,11,0,27,16
1746564132571,MMW 11R,A02,892722,Herbst; Matthew,0,0,0,3
1746564133597,MMW 12R,A01,892724,Herbst; Matthew,0,11,16,16
1746564133597,MMW 12R,A02,892725,Herbst; Matthew,0,10,16,16
1746564134621,MMW 13R,A01,892727,Staff,0,4,16,16
1746564134621,MMW 13R,A02,892728,Staff,0,4,16,16
1746564134621,MMW 13R,A03,958032,Staff,0,4,16,16
1746564134621,MMW 13R,A04,958033,Staff,0,4,16,16
1746564134621,MMW 13R,A05,958034,Staff,0,4,16,16
1746564135645,SIO 295LS,A00,894015,Staff,5,0,25,20
1746564136674,SIO 295S,A00,894020,Staff,5,0,25,20
1746564137704,SIOC 290S,B01,958918,Merrifield; Mark A,14,0,30,16
1746564138728,SIOC 291S,B01,958922,Gabriel; Corey John,14,0,30,16
1746564139752,SOCI 117,A01,895339,Staff,3,0,5,2
1746564140779,WES 237B,A00,894149,Staff,11,0,20,9
1746564142837,AESE 279B,A00,891859,Staff,13,0,35,22
1746564143860,AIP 197,001,891854,Vespa; Emanuel Ignacio,9999,0,9999,0
1746564144887,ANTH 289S,A00,891856,Gagneux; Pascal,12,0,12,0
1746564145912,BENG 196,001,957946,Engler; Adam J.,9996,0,9999,3
1746564146938,BISP 197,001,959851,Wilhelm; James E.,9998,0,9999,1
1746564147965,CAT 124RS,A01,956906,Staff,6,0,25,19
1746564148989,CAT 125RS,A01,922013,Staff,6,0,25,19
1746564150016,CLRE 250,A00,891860,Morris; Sheldon,9995,0,9999,4
1746564152064,CLRE 251R,A00,907817,Mehta; Ravindra L.,9994,0,9999,5
1746564153091,CLRE 252,A00,891864,Cuomo; Raphael Eduardo,9993,0,9999,6
1746564154115,CLRE 253,A00,891867,Vaida; Florin,9994,0,9999,5
1746564154115,CLRE 253,B00,907819,Staff,9999,0,9999,0
1746564155146,CLRE 259,A00,891868,Patel; Hemal,9998,0,9999,1
1746564156172,CLRE 260,A00,891872,Cuomo; Raphael Eduardo,9999,0,9999,0
1746564157199,CLRE 297,001,891888,Cuomo; Raphael Eduardo,9999,0,9999,0
1746564158226,CSE 191,A00,958773,Minnes Kemp; Mor Mia,9995,0,9999,4
1746564159252,CSE 197,001,959846,Minnes Kemp; Mor Mia,9990,0,9999,9
1746564160281,CSS 201S,A01,892054,Mignozzetti; Umberto,26,0,30,4
1746564161308,CSS 202S,A01,892056,Mignozzetti; Umberto,26,0,30,4
1746564162331,DSC 197,001,956898,Eldridge; Justin Matthew,9996,0,9999,3
1746564163357,DSC 297,001,958000,Mazumdar; Arya,9998,0,9999,1
1746564163357,DSC 297,002,959862,Wang; Yusu,9998,0,9999,1
1746564164385,EAP 100,A00,905686,Staff,9778,0,9999,221
1746564165412,ECE 45,A01,892618,Staff,0,0,65,65
1746564167463,ECE 111,A01,892719,Staff,4,0,65,61
1746564168490,ECE 197,001,957920,Mercier; Patrick Philip,9991,0,9999,8
1746564169516,ECON 178,A01,907814,Zhu; Ying,26,0,35,9
1746564170545,EDS 115,A00,895312,Staff,35,0,45,10
1746564171572,EDS 117,A01,895337,Staff,23,0,30,7
1746564172599,EDS 125,A00,895341,Jones; Gabrielle Anastasia,36,0,45,9
1746564173624,EDS 128A,A01,895459,Fargason; Sharon Gayle,44,0,45,1
1746564174654,EDS 128B,A01,895543,Pappas; Elizabeth,44,0,45,1
1746564175680,EDS 139,A00,897203,Pappas; Elizabeth,44,0,45,1
1746564175680,EDS 139,B00,897209,Fargason; Sharon Gayle,41,0,45,4
1746564176706,EDS 201,A00,895545,Staff,22,0,45,23
1746564177732,EDS 203,A01,895581,Halter; Christopher P.,22,0,45,23
1746564178757,EDS 204R,A01,895625,Heinzman; Erica M.,39,0,45,6
1746564178757,EDS 204R,B01,895693,Halter; Christopher P.,10,0,45,35
1746564179787,EDS 206R,A00,895694,Fargason; Sharon Gayle,1,0,30,29
1746564179787,EDS 206R,B00,895695,Choi; Bailey Miyeon,16,0,30,14
1746564180813,EDS 250,A00,895697,Hemans; Patricia Ann Benitez,22,0,45,23
1746564181836,EDS 281,A00,895701,Meyerott; Theresa Ann,1,0,15,14
1746564182862,EDS 284,A00,895736,Meyerott; Theresa Ann,1,0,15,14
1746564183891,EDS 286,A00,897210,Fine; Sarah,0,0,15,15
1746564184916,EDS 289C,A01,895770,Daly; Alan J.,1,0,15,14
1746564185942,EDS 290,A00,897211,Hofstetter; Carolyn,0,0,15,15
1746564186967,LIGM 5A,A00,896162,Fischer-Grunski; Eva K,12,0,20,8
1746564187997,LIGM 5B,A00,896260,Fischer-Grunski; Eva K,17,0,20,3
1746564189023,LIGM 5C,A00,896308,Fischer-Grunski; Eva K,18,0,20,2
1746564190048,LIIT 5AS,A00,896313,Carnelos; Chiara,18,0,20,2
1746564191073,LIIT 5BS,A00,896416,Carnelos; Chiara,20,0,20,0
1746564192103,LIIT 5CS,A00,896564,Carnelos; Chiara,20,0,20,0
1746564193128,LISP 5A,A00,896588,Munoz Sanchez; Alicia,3,0,20,17
1746564194155,LISP 5B,A00,896653,Munoz Sanchez; Alicia,7,0,20,13
1746564195179,LISP 5C,A00,896655,Munoz Sanchez; Alicia,0,1,20,20
1746564196205,MAE 197,001,957918,Kleissl; Jan,9996,0,9999,3
1746564196205,MAE 197,002,959806,Boechler; Nicholas Sebastia,9998,0,9999,1
1746564196205,MAE 197,003,959852,Mullin; Jennifer S,9998,0,9999,1
1746564197229,MATH 2,A01,957937,Staff,33,0,35,2
1746564198256,MATH 197,001,957876,Kedlaya; Kiran S.,9993,0,9999,6
1746564199281,MCWP 40,A00,892729,Duru; Nur,10,0,20,10
1746564199281,MCWP 40,B00,893304,Montejo; Carolina,14,0,20,6
1746564200307,MCWP 40R,A00,893757,Redela; Pamela Morgan,0,5,20,20
1746564201334,MCWP 50,A00,893758,Morshed; Michael James,0,0,20,20
1746564201334,MCWP 50,B00,893761,Bartulis; Jason Michael,17,0,20,3
1746564202363,MCWP 50R,A00,893766,Compas; Sean Matthew,0,1,20,20
1746564202363,MCWP 50R,B00,893769,Carter; Jennifer A,0,1,20,20
1746564202363,MCWP 50R,C00,893771,Krone; Jarret,0,3,20,20
1746564202363,MCWP 50R,D00,893772,Miller; Elizabeth Deen,0,0,20,20
1746564202363,MCWP 50R,E00,893775,Carter; Andrea L,0,1,20,20
1746564203387,MMW 11R,A01,892721,Herbst; Matthew,11,0,27,16
1746564203387,MMW 11R,A02,892722,Herbst; Matthew,0,0,0,3
1746564204411,MMW 12R,A01,892724,Herbst; Matthew,0,11,16,16
1746564204411,MMW 12R,A02,892725,Herbst; Matthew,0,10,16,16
1746564205435,MMW 13R,A01,892727,Staff,0,4,16,16
1746564205435,MMW 13R,A02,892728,Staff,0,4,16,16
1746564205435,MMW 13R,A03,958032,Staff,0,4,16,16
1746564205435,MMW 13R,A04,958033,Staff,0,4,16,16
1746564205435,MMW 13R,A05,958034,Staff,0,4,16,16
1746564206463,SIO 295LS,A00,894015,Staff,5,0,25,20
1746564207490,SIO 295S,A00,894020,Staff,5,0,25,20
1746564208515,SIOC 290S,B01,958918,Merrifield; Mark A,14,0,30,16
1746564209545,SIOC 291S,B01,958922,Gabriel; Corey John,14,0,30,16
1746564210576,SOCI 117,A01,895339,Staff,3,0,5,2
1746564211601,WES 237B,A00,894149,Staff,11,0,20,9
1746564213658,AESE 279B,A00,891859,Staff,13,0,35,22
1746564214681,AIP 197,001,891854,Vespa; Emanuel Ignacio,9999,0,9999,0
1746564215710,ANTH 289S,A00,891856,Gagneux; Pascal,12,0,12,0
1746564216800,BENG 196,001,957946,Engler; Adam J.,9996,0,9999,3
1746564217826,BISP 197,001,959851,Wilhelm; James E.,9998,0,9999,1
1746564218853,CAT 124RS,A01,956906,Staff,6,0,25,19
1746564219881,CAT 125RS,A01,922013,Staff,6,0,25,19
1746564220915,CLRE 250,A00,891860,Morris; Sheldon,9995,0,9999,4
1746564222965,CLRE 251R,A00,907817,Mehta; Ravindra L.,9994,0,9999,5
1746564223990,CLRE 252,A00,891864,Cuomo; Raphael Eduardo,9993,0,9999,6
1746564225020,CLRE 253,A00,891867,Vaida; Florin,9994,0,9999,5
1746564225020,CLRE 253,B00,907819,Staff,9999,0,9999,0
1746564226047,CLRE 259,A00,891868,Patel; Hemal,9998,0,9999,1
1746564227073,CLRE 260,A00,891872,Cuomo; Raphael Eduardo,9999,0,9999,0
1746564228105,CLRE 297,001,891888,Cuomo; Raphael Eduardo,9999,0,9999,0
1746564229131,CSE 191,A00,958773,Minnes Kemp; Mor Mia,9995,0,9999,4
1746564230162,CSE 197,001,959846,Minnes Kemp; Mor Mia,9990,0,9999,9
1746564231186,CSS 201S,A01,892054,Mignozzetti; Umberto,26,0,30,4
1746564232228,CSS 202S,A01,892056,Mignozzetti; Umberto,26,0,30,4
1746564233252,DSC 197,001,956898,Eldridge; Justin Matthew,9996,0,9999,3
1746564234276,DSC 297,001,958000,Mazumdar; Arya,9998,0,9999,1
1746564234276,DSC 297,002,959862,Wang; Yusu,9998,0,9999,1
1746564235302,EAP 100,A00,905686,Staff,9778,0,9999,221
1746564236327,ECE 45,A01,892618,Staff,0,0,65,65
1746564238383,ECE 111,A01,892719,Staff,4,0,65,61
1746564239410,ECE 197,001,957920,Mercier; Patrick Philip,9991,0,9999,8
1746564240435,ECON 178,A01,907814,Zhu; Ying,26,0,35,9
1746564241458,EDS 115,A00,895312,Staff,35,0,45,10
1746564242482,EDS 117,A01,895337,Staff,23,0,30,7
1746564243506,EDS 125,A00,895341,Jones; Gabrielle Anastasia,36,0,45,9
1746564244531,EDS 128A,A01,895459,Fargason; Sharon Gayle,44,0,45,1
1746564245554,EDS 128B,A01,895543,Pappas; Elizabeth,44,0,45,1
1746564246579,EDS 139,A00,897203,Pappas; Elizabeth,44,0,45,1
1746564246579,EDS 139,B00,897209,Fargason; Sharon Gayle,41,0,45,4
1746564247604,EDS 201,A00,895545,Staff,22,0,45,23
1746564248629,EDS 203,A01,895581,Halter; Christopher P.,22,0,45,23
1746564249652,EDS 204R,A01,895625,Heinzman; Erica M.,39,0,45,6
1746564249652,EDS 204R,B01,895693,Halter; Christopher P.,10,0,45,35
1746564250677,EDS 206R,A00,895694,Fargason; Sharon Gayle,1,0,30,29
1746564250677,EDS 206R,B00,895695,Choi; Bailey Miyeon,16,0,30,14
1746564251703,EDS 250,A00,895697,Hemans; Patricia Ann Benitez,22,0,45,23
1746564252729,EDS 281,A00,895701,Meyerott; Theresa Ann,1,0,15,14
1746564253754,EDS 284,A00,895736,Meyerott; Theresa Ann,1,0,15,14
1746564254780,EDS 286,A00,897210,Fine; Sarah,0,0,15,15
1746564255806,EDS 289C,A01,895770,Daly; Alan J.,1,0,15,14
1746564256832,EDS 290,A00,897211,Hofstetter; Carolyn,0,0,15,15
1746564257857,LIGM 5A,A00,896162,Fischer-Grunski; Eva K,12,0,20,8
1746564258882,LIGM 5B,A00,896260,Fischer-Grunski; Eva K,17,0,20,3
1746564259908,LIGM 5C,A00,896308,Fischer-Grunski; Eva K,18,0,20,2
1746564260938,LIIT 5AS,A00,896313,Carnelos; Chiara,18,0,20,2
1746564261964,LIIT 5BS,A00,896416,Carnelos; Chiara,20,0,20,0
1746564262988,LIIT 5CS,A00,896564,Carnelos; Chiara,20,0,20,0
1746564264014,LISP 5A,A00,896588,Munoz Sanchez; Alicia,3,0,20,17
1746564265039,LISP 5B,A00,896653,Munoz Sanchez; Alicia,7,0,20,13
1746564266068,LISP 5C,A00,896655,Munoz Sanchez; Alicia,0,1,20,20
1746564267099,MAE 197,001,957918,Kleissl; Jan,9996,0,9999,3
1746564267099,MAE 197,002,959806,Boechler; Nicholas Sebastia,9998,0,9999,1
1746564267099,MAE 197,003,959852,Mullin; Jennifer S,9998,0,9999,1
1746564268126,MATH 2,A01,957937,Staff,33,0,35,2
1746564269151,MATH 197,001,957876,Kedlaya; Kiran S.,9993,0,9999,6
1746564270177,MCWP 40,A00,892729,Duru; Nur,10,0,20,10
1746564270177,MCWP 40,B00,893304,Montejo; Carolina,14,0,20,6
1746564271219,MCWP 40R,A00,893757,Redela; Pamela Morgan,0,5,20,20
1746564272246,MCWP 50,A00,893758,Morshed; Michael James,0,0,20,20
1746564272246,MCWP 50,B00,893761,Bartulis; Jason Michael,17,0,20,3
1746564273272,MCWP 50R,A00,893766,Compas; Sean Matthew,0,1,20,20
1746564273272,MCWP 50R,B00,893769,Carter; Jennifer A,0,1,20,20
1746564273272,MCWP 50R,C00,893771,Krone; Jarret,0,3,20,20
1746564273272,MCWP 50R,D00,893772,Miller; Elizabeth Deen,0,0,20,20
1746564273272,MCWP 50R,E00,893775,Carter; Andrea L,0,1,20,20
1746564274298,MMW 11R,A01,892721,Herbst; Matthew,11,0,27,16
1746564274298,MMW 11R,A02,892722,Herbst; Matthew,0,0,0,3
1746564275322,MMW 12R,A01,892724,Herbst; Matthew,0,11,16,16
1746564275322,MMW 12R,A02,892725,Herbst; Matthew,0,10,16,16
1746564276346,MMW 13R,A01,892727,Staff,0,4,16,16
1746564276346,MMW 13R,A02,892728,Staff,0,4,16,16
1746564276346,MMW 13R,A03,958032,Staff,0,4,16,16
1746564276346,MMW 13R,A04,958033,Staff,0,4,16,16
1746564276346,MMW 13R,A05,958034,Staff,0,4,16,16
1746564277370,SIO 295LS,A00,894015,Staff,5,0,25,20
1746564278394,SIO 295S,A00,894020,Staff,5,0,25,20
1746564279421,SIOC 290S,B01,958918,Merrifield; Mark A,14,0,30,16
1746564280445,SIOC 291S,B01,958922,Gabriel; Corey John,14,0,30,16
1746564281470,SOCI 117,A01,895339,Staff,3,0,5,2
1746564282494,WES 237B,A00,894149,Staff,11,0,20,9
1746564284553,AESE 279B,A00,891859,Staff,13,0,35,22
1746564285577,AIP 197,001,891854,Vespa; Emanuel Ignacio,9999,0,9999,0
1746564286602,ANTH 289S,A00,891856,Gagneux; Pascal,12,0,12,0
1746564287626,BENG 196,001,957946,Engler; Adam J.,9996,0,9999,3
1746564288652,BISP 197,001,959851,Wilhelm; James E.,9998,0,9999,1
1746564289677,CAT 124RS,A01,956906,Staff,6,0,25,19
1746564290760,CAT 125RS,A01,922013,Staff,6,0,25,19
1746564291787,CLRE 250,A00,891860,Morris; Sheldon,9995,0,9999,4
1746564293838,CLRE 251R,A00,907817,Mehta; Ravindra L.,9994,0,9999,5
1746564294865,CLRE 252,A00,891864,Cuomo; Raphael Eduardo,9993,0,9999,6
1746564295889,CLRE 253,A00,891867,Vaida; Florin,9994,0,9999,5
1746564295889,CLRE 253,B00,907819,Staff,9999,0,9999,0
1746564296913,CLRE 259,A00,891868,Patel; Hemal,9998,0,9999,1
1746564297942,CLRE 260,A00,891872,Cuomo; Raphael Eduardo,9999,0,9999,0
1746564298971,CLRE 297,001,891888,Cuomo; Raphael Eduardo,9999,0,9999,0
1746564299995,CSE 191,A00,958773,Minnes Kemp; Mor Mia,9995,0,9999,4
1746564301021,CSE 197,001,959846,Minnes Kemp; Mor Mia,9990,0,9999,9
1746564302047,CSS 201S,A01,892054,Mignozzetti; Umberto,26,0,30,4
1746564303072,CSS 202S,A01,892056,Mignozzetti; Umberto,26,0,30,4
1746564304099,DSC 197,001,956898,Eldridge; Justin Matthew,9996,0,9999,3
1746564305123,DSC 297,001,958000,Mazumdar; Arya,9998,0,9999,1
1746564305123,DSC 297,002,959862,Wang; Yusu,9998,0,9999,1
1746564306150,EAP 100,A00,905686,Staff,9778,0,9999,221
1746564307180,ECE 45,A01,892618,Staff,0,0,65,65
1746564309232,ECE 111,A01,892719,Staff,4,0,65,61
1746564310258,ECE 197,001,957920,Mercier; Patrick Philip,9991,0,9999,8
1746564311287,ECON 178,A01,907814,Zhu; Ying,26,0,35,9
1746564312312,EDS 115,A00,895312,Staff,35,0,45,10
1746564313337,EDS 117,A01,895337,Staff,23,0,30,7
1746564314363,EDS 125,A00,895341,Jones; Gabrielle Anastasia,36,0,45,9
1746564315389,EDS 128A,A01,895459,Fargason; Sharon Gayle,44,0,45,1
1746564316414,EDS 128B,A01,895543,Pappas; Elizabeth,44,0,45,1
1746564317440,EDS 139,A00,897203,Pappas; Elizabeth,44,0,45,1
1746564317440,EDS 139,B00,897209,Fargason; Sharon Gayle,41,0,45,4
1746564318468,EDS 201,A00,895545,Staff,22,0,45,23
1746564319493,EDS 203,A01,895581,Halter; Christopher P.,22,0,45,23
1746564320521,EDS 204R,A01,895625,Heinzman; Erica M.,39,0,45,6
1746564320521,EDS 204R,B01,895693,Halter; Christopher P.,10,0,45,35
1746564321548,EDS 206R,A00,895694,Fargason; Sharon Gayle,1,0,30,29
1746564321548,EDS 206R,B00,895695,Choi; Bailey Miyeon,16,0,30,14
1746564322573,EDS 250,A00,895697,Hemans; Patricia Ann Benitez,22,0,45,23
1746564323599,EDS 281,A00,895701,Meyerott; Theresa Ann,1,0,15,14
1746564324625,EDS 284,A00,895736,Meyerott; Theresa Ann,1,0,15,14
1746564325653,EDS 286,A00,897210,Fine; Sarah,0,0,15,15
1746564326676,EDS 289C,A01,895770,Daly; Alan J.,1,0,15,14
1746564327910,EDS 290,A00,897211,Hofstetter; Carolyn,0,0,15,15
1746564328938,LIGM 5A,A00,896162,Fischer-Grunski; Eva K,12,0,20,8
1746564329966,LIGM 5B,A00,896260,Fischer-Grunski; Eva K,17,0,20,3
1746564331031,LIGM 5C,A00,896308,Fischer-Grunski; Eva K,18,0,20,2
1746564332058,LIIT 5AS,A00,896313,Carnelos; Chiara,18,0,20,2
1746564333082,LIIT 5BS,A00,896416,Carnelos; Chiara,20,0,20,0
1746564334108,LIIT 5CS,A00,896564,Carnelos; Chiara,20,0,20,0
1746564335137,LISP 5A,A00,896588,Munoz Sanchez; Alicia,3,0,20,17
1746564336163,LISP 5B,A00,896653,Munoz Sanchez; Alicia,7,0,20,13
1746564337189,LISP 5C,A00,896655,Munoz Sanchez; Alicia,0,1,20,20
1746564338214,MAE 197,001,957918,Kleissl; Jan,9996,0,9999,3
1746564338214,MAE 197,002,959806,Boechler; Nicholas Sebastia,9998,0,9999,1
1746564338214,MAE 197,003,959852,Mullin; Jennifer S,9998,0,9999,1
1746564339239,MATH 2,A01,957937,Staff,33,0,35,2
1746564340265,MATH 197,001,957876,Kedlaya; Kiran S.,9993,0,9999,6
1746564341294,MCWP 40,A00,892729,Duru; Nur,10,0,20,10
1746564341294,MCWP 40,B00,893304,Montejo; Carolina,14,0,20,6
1746564342321,MCWP 40R,A00,893757,Redela; Pamela Morgan,0,5,20,20
1746564343352,MCWP 50,A00,893758,Morshed; Michael James,0,0,20,20
1746564343352,MCWP 50,B00,893761,Bartulis; Jason Michael,17,0,20,3
1746564344382,MCWP 50R,A00,893766,Compas; Sean Matthew,0,1,20,20
1746564344382,MCWP 50R,B00,893769,Carter; Jennifer A,0,1,20,20
1746564344382,MCWP 50R,C00,893771,Krone; Jarret,0,3,20,20
1746564344382,MCWP 50R,D00,893772,Miller; Elizabeth Deen,0,0,20,20
1746564344382,MCWP 50R,E00,893775,Carter; Andrea L,0,1,20,20
1746564345409,MMW 11R,A01,892721,Herbst; Matthew,11,0,27,16
1746564345409,MMW 11R,A02,892722,Herbst; Matthew,0,0,0,3
1746564346649,MMW 12R,A01,892724,Herbst; Matthew,0,11,16,16
1746564346649,MMW 12R,A02,892725,Herbst; Matthew,0,10,16,16
1746564347679,MMW 13R,A01,892727,Staff,0,4,16,16
1746564347679,MMW 13R,A02,892728,Staff,0,4,16,16
1746564347679,MMW 13R,A03,958032,Staff,0,4,16,16
1746564347679,MMW 13R,A04,958033,Staff,0,4,16,16
1746564347679,MMW 13R,A05,958034,Staff,0,4,16,16
1746564348706,SIO 295LS,A00,894015,Staff,5,0,25,20
1746564349732,SIO 295S,A00,894020,Staff,5,0,25,20
1746564350906,SIOC 290S,B01,958918,Merrifield; Mark A,14,0,30,16
1746564352418,SIOC 291S,B01,958922,Gabriel; Corey John,14,0,30,16
1746564353444,SOCI 117,A01,895339,Staff,3,0,5,2
1746564359358,WES 237B,A00,894149,Staff,11,0,20,9
1746564361422,AESE 279B,A00,891859,Staff,13,0,35,22
1746564362914,AIP 197,001,891854,Vespa; Emanuel Ignacio,9999,0,9999,0
1746564363956,ANTH 289S,A00,891856,Gagneux; Pascal,12,0,12,0
1746564364985,BENG 196,001,957946,Engler; Adam J.,9996,0,9999,3
1746564371793,BISP 197,001,959851,Wilhelm; James E.,9998,0,9999,1
1746564372820,CAT 124RS,A01,956906,Staff,6,0,25,19
1746564377784,CAT 125RS,A01,922013,Staff,6,0,25,19
1746564383785,CLRE 250,A00,891860,Morris; Sheldon,9995,0,9999,4
1746564397590,CLRE 251R,A00,907817,Mehta; Ravindra L.,9994,0,9999,5
1746564402387,CLRE 252,A00,891864,Cuomo; Raphael Eduardo,9993,0,9999,6
1746564406748,CLRE 253,A00,891867,Vaida; Florin,9994,0,9999,5
1746564406748,CLRE 253,B00,907819,Staff,9999,0,9999,0
1746564412490,CLRE 259,A00,891868,Patel; Hemal,9998,0,9999,1
1746564417852,CLRE 260,A00,891872,Cuomo; Raphael Eduardo,9999,0,9999,0
1746564422728,CLRE 297,001,891888,Cuomo; Raphael Eduardo,9999,0,9999,0
1746564426654,CSE 191,A00,958773,Minnes Kemp; Mor Mia,9995,0,9999,4
1746564432576,CSE 197,001,959846,Minnes Kemp; Mor Mia,9990,0,9999,9
1746564437570,CSS 201S,A01,892054,Mignozzetti; Umberto,26,0,30,4
1746564442564,CSS 202S,A01,892056,Mignozzetti; Umberto,26,0,30,4
1746564449083,DSC 197,001,956898,Eldridge; Justin Matthew,9996,0,9999,3
1746564450106,DSC 297,001,958000,Mazumdar; Arya,9998,0,9999,1
1746564450106,DSC 297,002,959862,Wang; Yusu,9998,0,9999,1
1746564456461,EAP 100,A00,905686,Staff,9778,0,9999,221
1746564462539,ECE 45,A01,892618,Staff,0,0,65,65
1746564468877,ECE 111,A01,892719,Staff,4,0,65,61
1746564475132,ECE 197,001,957920,Mercier; Patrick Philip,9991,0,9999,8
1746564476159,ECON 178,A01,907814,Zhu; Ying,26,0,35,9
1746564477184,EDS 115,A00,895312,Staff,35,0,45,10
1746564482062,EDS 117,A01,895337,Staff,23,0,30,7
1746564483095,EDS 125,A00,895341,Jones; Gabrielle Anastasia,36,0,45,9
1746564488031,EDS 128A,A01,895459,Fargason; Sharon Gayle,44,0,45,1
1746564489057,EDS 128B,A01,895543,Pappas; Elizabeth,44,0,45,1
1746564494131,EDS 139,A00,897203,Pappas; Elizabeth,44,0,45,1
1746564494131,EDS 139,B00,897209,Fargason; Sharon Gayle,41,0,45,4
1746564495160,EDS 201,A00,895545,Staff,22,0,45,23
1746564499727,EDS 203,A01,895581,Halter; Christopher P.,22,0,45,23
1746564500752,EDS 204R,A01,895625,Heinzman; Erica M.,39,0,45,6
1746564500752,EDS 204R,B01,895693,Halter; Christopher P.,10,0,45,35
1746564506046,EDS 206R,A00,895694,Fargason; Sharon Gayle,1,0,30,29
1746564506046,EDS 206R,B00,895695,Choi; Bailey Miyeon,16,0,30,14
1746564507076,EDS 250,A00,895697,Hemans; Patricia Ann Benitez,22,0,45,23
1746564508107,EDS 281,A00,895701,Meyerott; Theresa Ann,1,0,15,14
1746564512246,EDS 284,A00,895736,Meyerott; Theresa Ann,1,0,15,14
1746564513270,EDS 286,A00,897210,Fine; Sarah,0,0,15,15
1746564519074,EDS 289C,A01,895770,Daly; Alan J.,1,0,15,14
1746564520098,EDS 290,A00,897211,Hofstetter; Carolyn,0,0,15,15
1746564525233,LIGM 5A,A00,896162,Fischer-Grunski; Eva K,12,0,20,8
1746564530944,LIGM 5B,A00,896260,Fischer-Grunski; Eva K,17,0,20,3
1746564536785,LIGM 5C,A00,896308,Fischer-Grunski; Eva K,18,0,20,2
1746564537813,LIIT 5AS,A00,896313,Carnelos; Chiara,18,0,20,2
1746564543536,LIIT 5BS,A00,896416,Carnelos; Chiara,20,0,20,0
1746564548972,LIIT 5CS,A00,896564,Carnelos; Chiara,20,0,20,0
1746564554402,LISP 5A,A00,896588,Munoz Sanchez; Alicia,3,0,20,17
1746564555426,LISP 5B,A00,896653,Munoz Sanchez; Alicia,7,0,20,13
1746564560143,LISP 5C,A00,896655,Munoz Sanchez; Alicia,0,1,20,20
1746564565739,MAE 197,001,957918,Kleissl; Jan,9996,0,9999,3
1746564565739,MAE 197,002,959806,Boechler; Nicholas Sebastia,9998,0,9999,1
1746564565739,MAE 197,003,959852,Mullin; Jennifer S,9998,0,9999,1
1746564570447,MATH 2,A01,957937,Staff,33,0,35,2
1746564571472,MATH 197,001,957876,Kedlaya; Kiran S.,9993,0,9999,6
1746564575577,MCWP 40,A00,892729,Duru; Nur,10,0,20,10
1746564575577,MCWP 40,B00,893304,Montejo; Carolina,14,0,20,6
1746564580970,MCWP 40R,A00,893757,Redela; Pamela Morgan,0,5,20,20
1746564586476,MCWP 50,A00,893758,Morshed; Michael James,0,0,20,20
1746564586476,MCWP 50,B00,893761,Bartulis; Jason Michael,17,0,20,3
1746564592471,MCWP 50R,A00,893766,Compas; Sean Matthew,0,1,20,20
1746564592471,MCWP 50R,B00,893769,Carter; Jennifer A,0,1,20,20
1746564592471,MCWP 50R,C00,893771,Krone; Jarret,0,3,20,20
1746564592471,MCWP 50R,D00,893772,Miller; Elizabeth Deen,0,0,20,20
1746564592471,MCWP 50R,E00,893775,Carter; Andrea L,0,1,20,20
1746564597100,MMW 11R,A01,892721,Herbst; Matthew,11,0,27,16
1746564597100,MMW 11R,A02,892722,Herbst; Matthew,0,0,0,3
1746564601984,MMW 12R,A01,892724,Herbst; Matthew,0,11,16,16
1746564601984,MMW 12R,A02,892725,Herbst; Matthew,0,10,16,16
1746564608152,MMW 13R,A01,892727,Staff,0,4,16,16
1746564608152,MMW 13R,A02,892728,Staff,0,4,16,16
1746564608152,MMW 13R,A03,958032,Staff,0,4,16,16
1746564608152,MMW 13R,A04,958033,Staff,0,4,16,16
1746564608152,MMW 13R,A05,958034,Staff,0,4,16,16
1746564614190,SIO 295LS,A00,894015,Staff,5,0,25,20
1746564619347,SIO 295S,A00,894020,Staff,5,0,25,20
1746564625076,SIOC 290S,B01,958918,Merrifield; Mark A,14,0,30,16
1746564629625,SIOC 291S,B01,958922,Gabriel; Corey John,14,0,30,16
1746564634147,SOCI 117,A01,895339,Staff,3,0,5,2
1746564639077,WES 237B,A00,894149,Staff,11,0,20,9
1746564648445,AESE 279B,A00,891859,Staff,13,0,35,22
1746564653165,AIP 197,001,891854,Vespa; Emanuel Ignacio,9999,0,9999,0
1746564658165,ANTH 289S,A00,891856,Gagneux; Pascal,12,0,12,0
1746564663349,BENG 196,001,957946,Engler; Adam J.,9996,0,9999,3
1746564668982,BISP 197,001,959851,Wilhelm; James E.,9998,0,9999,1
1746564674997,CAT 124RS,A01,956906,Staff,6,0,25,19
1746564680229,CAT 125RS,A01,922013,Staff,6,0,25,19
1746564685921,CLRE 250,A00,891860,Morris; Sheldon,9995,0,9999,4
1746564696763,CLRE 251R,A00,907817,Mehta; Ravindra L.,9994,0,9999,5
1746564701100,CLRE 252,A00,891864,Cuomo; Raphael Eduardo,9993,0,9999,6
1746564705718,CLRE 253,A00,891867,Vaida; Florin,9994,0,9999,5
1746564705718,CLRE 253,B00,907819,Staff,9999,0,9999,0
1746564710835,CLRE 259,A00,891868,Patel; Hemal,9998,0,9999,1
1746564717239,CLRE 260,A00,891872,Cuomo; Raphael Eduardo,9999,0,9999,0
1746564722336,CLRE 297,001,891888,Cuomo; Raphael Eduardo,9999,0,9999,0
1746564728276,CSE 191,A00,958773,Minnes Kemp; Mor Mia,9995,0,9999,4
1746564733767,CSE 197,001,959846,Minnes Kemp; Mor Mia,9990,0,9999,9
1746564738969,CSS 201S,A01,892054,Mignozzetti; Umberto,26,0,30,4
1746564743905,CSS 202S,A01,892056,Mignozzetti; Umberto,26,0,30,4
1746564749523,DSC 197,001,956898,Eldridge; Justin Matthew,9996,0,9999,3
1746564754030,DSC 297,001,958000,Mazumdar; Arya,9998,0,9999,1
1746564754030,DSC 297,002,959862,Wang; Yusu,9998,0,9999,1
1746564760348,EAP 100,A00,905686,Staff,9778,0,9999,221
1746564766840,ECE 45,A01,892618,Staff,0,0,65,65
1746564778564,ECE 111,A01,892719,Staff,4,0,65,61
1746564783228,ECE 197,001,957920,Mercier; Patrick Philip,9991,0,9999,8
1746564789253,ECON 178,A01,907814,Zhu; Ying,26,0,35,9
1746564794355,EDS 115,A00,895312,Staff,35,0,45,10
1746564799641,EDS 117,A01,895337,Staff,23,0,30,7
1746564805430,EDS 125,A00,895341,Jones; Gabrielle Anastasia,36,0,45,9
1746564810446,EDS 128A,A01,895459,Fargason; Sharon Gayle,44,0,45,1
1746564814136,EDS 128B,A01,895543,Pappas; Elizabeth,44,0,45,1
1746564819605,EDS 139,A00,897203,Pappas; Elizabeth,44,0,45,1
1746564819605,EDS 139,B00,897209,Fargason; Sharon Gayle,41,0,45,4
1746564825485,EDS 201,A00,895545,Staff,22,0,45,23
1746564829857,EDS 203,A01,895581,Halter; Christopher P.,22,0,45,23
1746564835251,EDS 204R,A01,895625,Heinzman; Erica M.,39,0,45,6
1746564835251,EDS 204R,B01,895693,Halter; Christopher P.,10,0,45,35
1746564840065,EDS 206R,A00,895694,Fargason; Sharon Gayle,1,0,30,29
1746564840065,EDS 206R,B00,895695,Choi; Bailey Miyeon,16,0,30,14
1746564846694,EDS 250,A00,895697,Hemans; Patricia Ann Benitez,22,0,45,23
1746564852126,EDS 281,A00,895701,Meyerott; Theresa Ann,1,0,15,14
1746564855927,EDS 284,A00,895736,Meyerott; Theresa Ann,1,0,15,14
1746564859689,EDS 286,A00,897210,Fine; Sarah,0,0,15,15
1746564864650,EDS 289C,A01,895770,Daly; Alan J.,1,0,15,14
1746564868470,EDS 290,A00,897211,Hofstetter; Carolyn,0,0,15,15
1746564873524,LIGM 5A,A00,896162,Fischer-Grunski; Eva K,12,0,20,8
1746564878413,LIGM 5B,A00,896260,Fischer-Grunski; Eva K,17,0,20,3
1746564884564,LIGM 5C,A00,896308,Fischer-Grunski; Eva K,18,0,20,2
1746564888288,LIIT 5AS,A00,896313,Carnelos; Chiara,18,0,20,2
1746564893587,LIIT 5BS,A00,896416,Carnelos; Chiara,20,0,20,0
1746564898839,LIIT 5CS,A00,896564,Carnelos; Chiara,20,0,20,0
1746564903732,LISP 5A,A00,896588,Munoz Sanchez; Alicia,3,0,20,17
1746564908015,LISP 5B,A00,896653,Munoz Sanchez; Alicia,7,0,20,13
1746564911771,LISP 5C,A00,896655,Munoz Sanchez; Alicia,0,1,20,20
1746564917185,MAE 197,001,957918,Kleissl; Jan,9996,0,9999,3
1746564917185,MAE 197,002,959806,Boechler; Nicholas Sebastia,9998,0,9999,1
1746564917185,MAE 197,003,959852,Mullin; Jennifer S,9998,0,9999,1
1746564922565,MATH 2,A01,957937,Staff,33,0,35,2
1746564926259,MATH 197,001,957876,Kedlaya; Kiran S.,9993,0,9999,6
1746564931153,MCWP 40,A00,892729,Duru; Nur,10,0,20,10
1746564931153,MCWP 40,B00,893304,Montejo; Carolina,14,0,20,6
1746564934986,MCWP 40R,A00,893757,Redela; Pamela Morgan,0,5,20,20
1746564940097,MCWP 50,A00,893758,Morshed; Michael James,0,0,20,20
1746564940097,MCWP 50,B00,893761,Bartulis; Jason Michael,17,0,20,3
1746564944976,MCWP 50R,A00,893766,Compas; Sean Matthew,0,1,20,20
1746564944976,MCWP 50R,B00,893769,Carter; Jennifer A,0,1,20,20
1746564944976,MCWP 50R,C00,893771,Krone; Jarret,0,3,20,20
1746564944976,MCWP 50R,D00,893772,Miller; Elizabeth Deen,0,0,20,20
1746564944976,MCWP 50R,E00,893775,Carter; Andrea L,0,1,20,20
1746564948918,MMW 11R,A01,892721,Herbst; Matthew,11,0,27,16
1746564948918,MMW 11R,A02,892722,Herbst; Matthew,0,0,0,3
1746564952910,MMW 12R,A01,892724,Herbst; Matthew,0,11,16,16
1746564952910,MMW 12R,A02,892725,Herbst; Matthew,0,10,16,16
1746564956837,MMW 13R,A01,892727,Staff,0,4,16,16
1746564956837,MMW 13R,A02,892728,Staff,0,4,16,16
1746564956837,MMW 13R,A03,958032,Staff,0,4,16,16
1746564956837,MMW 13R,A04,958033,Staff,0,4,16,16
1746564956837,MMW 13R,A05,958034,Staff,0,4,16,16
1746564960839,SIO 295LS,A00,894015,Staff,5,0,25,20
1746564966043,SIO 295S,A00,894020,Staff,5,0,25,20
1746564971458,SIOC 290S,B01,958918,Merrifield; Mark A,14,0,30,16
1746564976655,SIOC 291S,B01,958922,Gabriel; Corey John,14,0,30,16
1746564981764,SOCI 117,A01,895339,Staff,3,0,5,2
1746564986194,WES 237B,A00,894149,Staff,11,0,20,9
1746564996409,AESE 279B,A00,891859,Staff,13,0,35,22
1746565000806,AIP 197,001,891854,Vespa; Emanuel Ignacio,9999,0,9999,0
1746565005346,ANTH 289S,A00,891856,Gagneux; Pascal,12,0,12,0
1746565009774,BENG 196,001,957946,Engler; Adam J.,9996,0,9999,3
1746565013731,BISP 197,001,959851,Wilhelm; James E.,9998,0,9999,1
1746565017720,CAT 124RS,A01,956906,Staff,6,0,25,19
1746565028444,CAT 125RS,A01,922013,Staff,6,0,25,19
1746565034077,CLRE 250,A00,891860,Morris; Sheldon,9995,0,9999,4
1746565045807,CLRE 251R,A00,907817,Mehta; Ravindra L.,9994,0,9999,5
1746565051588,CLRE 252,A00,891864,Cuomo; Raphael Eduardo,9993,0,9999,6
1746565057462,CLRE 253,A00,891867,Vaida; Florin,9994,0,9999,5
1746565057462,CLRE 253,B00,907819,Staff,9999,0,9999,0
1746565064601,CLRE 259,A00,891868,Patel; Hemal,9998,0,9999,1
1746565069524,CLRE 260,A00,891872,Cuomo; Raphael Eduardo,9999,0,9999,0
1746565075960,CLRE 297,001,891888,Cuomo; Raphael Eduardo,9999,0,9999,0
1746565081092,CSE 191,A00,958773,Minnes Kemp; Mor Mia,9995,0,9999,4
1746565086212,CSE 197,001,959846,Minnes Kemp; Mor Mia,9990,0,9999,9
1746565091939,CSS 201S,A01,892054,Mignozzetti; Umberto,26,0,30,4
1746565096906,CSS 202S,A01,892056,Mignozzetti; Umberto,26,0,30,4
1746565101994,DSC 197,001,956898,Eldridge; Justin Matthew,9996,0,9999,3
1746565107272,DSC 297,001,958000,Mazumdar; Arya,9998,0,9999,1
1746565107272,DSC 297,002,959862,Wang; Yusu,9998,0,9999,1
1746565111283,EAP 100,A00,905686,Staff,9778,0,9999,221
1746565116039,ECE 45,A01,892618,Staff,0,0,65,65
1746565124566,ECE 111,A01,892719,Staff,4,0,65,61
1746565128229,ECE 197,001,957920,Mercier; Patrick Philip,9991,0,9999,8
1746565133032,ECON 178,A01,907814,Zhu; Ying,26,0,35,9
1746565137624,EDS 115,A00,895312,Staff,35,0,45,10
1746565143832,EDS 117,A01,895337,Staff,23,0,30,7
1746565149937,EDS 125,A00,895341,Jones; Gabrielle Anastasia,36,0,45,9
1746565155319,EDS 128A,A01,895459,Fargason; Sharon Gayle,44,0,45,1
1746565159994,EDS 128B,A01,895543,Pappas; Elizabeth,44,0,45,1
1746565165222,EDS 139,A00,897203,Pappas; Elizabeth,44,0,45,1
1746565165222,EDS 139,B00,897209,Fargason; Sharon Gayle,41,0,45,4
1746565169909,EDS 201,A00,895545,Staff,22,0,45,23
1746565175102,EDS 203,A01,895581,Halter; Christopher P.,22,0,45,23
1746565179994,EDS 204R,A01,895625,Heinzman; Erica M.,39,0,45,6
1746565179994,EDS 204R,B01,895693,Halter; Christopher P.,10,0,45,35
1746565184833,EDS 206R,A00,895694,Fargason; Sharon Gayle,1,0,30,29
1746565184833,EDS 206R,B00,895695,Choi; Bailey Miyeon,16,0,30,14
1746565189730,EDS 250,A00,895697,Hemans; Patricia Ann Benitez,22,0,45,23
1746565195680,EDS 281,A00,895701,Meyerott; Theresa Ann,1,0,15,14
1746565200425,EDS 284,A00,895736,Meyerott; Theresa Ann,1,0,15,14
1746565204623,EDS 286,A00,897210,Fine; Sarah,0,0,15,15
1746565209864,EDS 289C,A01,895770,Daly; Alan J.,1,0,15,14
1746565216108,EDS 290,A00,897211,Hofstetter; Carolyn,0,0,15,15
1746565221217,LIGM 5A,A00,896162,Fischer-Grunski; Eva K,12,0,20,8
1746565225663,LIGM 5B,A00,896260,Fischer-Grunski; Eva K,17,0,20,3
1746565231212,LIGM 5C,A00,896308,Fischer-Grunski; Eva K,18,0,20,2
1746565236160,LIIT 5AS,A00,896313,Carnelos; Chiara,18,0,20,2
1746565241304,LIIT 5BS,A00,896416,Carnelos; Chiara,20,0,20,0
1746565246175,LIIT 5CS,A00,896564,Carnelos; Chiara,20,0,20,0
1746565252259,LISP 5A,A00,896588,Munoz Sanchez; Alicia,3,0,20,17
1746565256011,LISP 5B,A00,896653,Munoz Sanchez; Alicia,7,0,20,13
1746565261666,LISP 5C,A00,896655,Munoz Sanchez; Alicia,0,1,20,20
1746565265309,MAE 197,001,957918,Kleissl; Jan,9996,0,9999,3
1746565265309,MAE 197,002,959806,Boechler; Nicholas Sebastia,9998,0,9999,1
1746565265309,MAE 197,003,959852,Mullin; Jennifer S,9998,0,9999,1
1746565270657,MATH 2,A01,957937,Staff,33,0,35,2
1746565275206,MATH 197,001,957876,Kedlaya; Kiran S.,9993,0,9999,6
1746565280273,MCWP 40,A00,892729,Duru; Nur,10,0,20,10
1746565280273,MCWP 40,B00,893304,Montejo; Carolina,14,0,20,6
1746565285113,MCWP 40R,A00,893757,Redela; Pamela Morgan,0,5,20,20
1746565290560,MCWP 50,A00,893758,Morshed; Michael James,0,0,20,20
1746565290560,MCWP 50,B00,893761,Bartulis; Jason Michael,17,0,20,3
1746565296323,MCWP 50R,A00,893766,Compas; Sean Matthew,0,1,20,20
1746565296323,MCWP 50R,B00,893769,Carter; Jennifer A,0,1,20,20
1746565296323,MCWP 50R,C00,893771,Krone; Jarret,0,3,20,20
1746565296323,MCWP 50R,D00,893772,Miller; Elizabeth Deen,0,0,20,20
1746565296323,MCWP 50R,E00,893775,Carter; Andrea L,0,1,20,20
1746565301362,MMW 11R,A01,892721,Herbst; Matthew,11,0,27,16
1746565301362,MMW 11R,A02,892722,Herbst; Matthew,0,0,0,3
1746565307112,MMW 12R,A01,892724,Herbst; Matthew,0,11,16,16
1746565307112,MMW 12R,A02,892725,Herbst; Matthew,0,10,16,16
1746565312151,MMW 13R,A01,892727,Staff,0,4,16,16
1746565312151,MMW 13R,A02,892728,Staff,0,4,16,16
1746565312151,MMW 13R,A03,958032,Staff,0,4,16,16
1746565312151,MMW 13R,A04,958033,Staff,0,4,16,16
1746565312151,MMW 13R,A05,958034,Staff,0,4,16,16
1746565316696,SIO 295LS,A00,894015,Staff,5,0,25,20
1746565322058,SIO 295S,A00,894020,Staff,5,0,25,20
1746565327417,SIOC 290S,B01,958918,Merrifield; Mark A,14,0,30,16
1746565332218,SIOC 291S,B01,958922,Gabriel; Corey John,14,0,30,16
1746565337136,SOCI 117,A01,895339,Staff,3,0,5,2
1746565342437,WES 237B,A00,894149,Staff,11,0,20,9
1746565352214,AESE 279B,A00,891859,Staff,13,0,35,22
1746565357328,AIP 197,001,891854,Vespa; Emanuel Ignacio,9999,0,9999,0
1746565362340,ANTH 289S,A00,891856,Gagneux; Pascal,12,0,12,0
1746565366058,BENG 196,001,957946,Engler; Adam J.,9996,0,9999,3
1746565370712,BISP 197,001,959851,Wilhelm; James E.,9998,0,9999,1
1746565375699,CAT 124RS,A01,956906,Staff,6,0,25,19
1746565381177,CAT 125RS,A01,922013,Staff,6,0,25,19
1746565385002,CLRE 250,A00,891860,Morris; Sheldon,9995,0,9999,4
1746565395550,CLRE 251R,A00,907817,Mehta; Ravindra L.,9994,0,9999,5
1746565400248,CLRE 252,A00,891864,Cuomo; Raphael Eduardo,9993,0,9999,6
1746565405692,CLRE 253,A00,891867,Vaida; Florin,9994,0,9999,5
1746565405692,CLRE 253,B00,907819,Staff,9999,0,9999,0
1746565410410,CLRE 259,A00,891868,Patel; Hemal,9998,0,9999,1
1746565416265,CLRE 260,A00,891872,Cuomo; Raphael Eduardo,9999,0,9999,0
1746565422162,CLRE 297,001,891888,Cuomo; Raphael Eduardo,9999,0,9999,0
1746565427704,CSE 191,A00,958773,Minnes Kemp; Mor Mia,9995,0,9999,4
1746565434095,CSE 197,001,959846,Minnes Kemp; Mor Mia,9990,0,9999,9
1746565440030,CSS 201S,A01,892054,Mignozzetti; Umberto,26,0,30,4
1746565445476,CSS 202S,A01,892056,Mignozzetti; Umberto,26,0,30,4
1746565450298,DSC 197,001,956898,Eldridge; Justin Matthew,9996,0,9999,3
1746565455487,DSC 297,001,958000,Mazumdar; Arya,9998,0,9999,1
1746565455487,DSC 297,002,959862,Wang; Yusu,9998,0,9999,1
1746565460574,EAP 100,A00,905686,Staff,9778,0,9999,221
1746565465422,ECE 45,A01,892618,Staff,0,0,65,65
1746565474609,ECE 111,A01,892719,Staff,4,0,65,61
1746565480193,ECE 197,001,957920,Mercier; Patrick Philip,9991,0,9999,8
1746565489812,ECON 178,A01,907814,Zhu; Ying,26,0,35,9
1746565495462,EDS 115,A00,895312,Staff,35,0,45,10
1746565500736,EDS 117,A01,895337,Staff,23,0,30,7
1746565505735,EDS 125,A00,895341,Jones; Gabrielle Anastasia,36,0,45,9
1746565510654,EDS 128A,A01,895459,Fargason; Sharon Gayle,44,0,45,1
1746565515560,EDS 128B,A01,895543,Pappas; Elizabeth,44,0,45,1
1746565520760,EDS 139,A00,897203,Pappas; Elizabeth,44,0,45,1
1746565520760,EDS 139,B00,897209,Fargason; Sharon Gayle,41,0,45,4
1746565525260,EDS 201,A00,895545,Staff,22,0,45,23
1746565530035,EDS 203,A01,895581,Halter; Christopher P.,22,0,45,23
1746565534753,EDS 204R,A01,895625,Heinzman; Erica M.,39,0,45,6
1746565534753,EDS 204R,B01,895693,Halter; Christopher P.,10,0,45,35
1746565539421,EDS 206R,A00,895694,Fargason; Sharon Gayle,1,0,30,29
1746565539421,EDS 206R,B00,895695,Choi; Bailey Miyeon,16,0,30,14
1746565544414,EDS 250,A00,895697,Hemans; Patricia Ann Benitez,22,0,45,23
1746565547927,EDS 281,A00,895701,Meyerott; Theresa Ann,1,0,15,14
1746565553235,EDS 284,A00,895736,Meyerott; Theresa Ann,1,0,15,14
1746565557036,EDS 286,A00,897210,Fine; Sarah,0,0,15,15
1746565562205,EDS 289C,A01,895770,Daly; Alan J.,1,0,15,14
1746565567045,EDS 290,A00,897211,Hofstetter; Carolyn,0,0,15,15
1746565577557,LIGM 5A,A00,896162,Fischer-Grunski; Eva K,12,0,20,8
1746565582403,LIGM 5B,A00,896260,Fischer-Grunski; Eva K,17,0,20,3
1746565586039,LIGM 5C,A00,896308,Fischer-Grunski; Eva K,18,0,20,2
1746565589625,LIIT 5AS,A00,896313,Carnelos; Chiara,18,0,20,2
1746565594367,LIIT 5BS,A00,896416,Carnelos; Chiara,20,0,20,0
1746565599307,LIIT 5CS,A00,896564,Carnelos; Chiara,20,0,20,0
1746565603982,LISP 5A,A00,896588,Munoz Sanchez; Alicia,3,0,20,17
1746565609206,LISP 5B,A00,896653,Munoz Sanchez; Alicia,7,0,20,13
1746565613988,LISP 5C,A00,896655,Munoz Sanchez; Alicia,0,1,20,20
1746565619102,MAE 197,001,957918,Kleissl; Jan,9996,0,9999,3
1746565619102,MAE 197,002,959806,Boechler; Nicholas Sebastia,9998,0,9999,1
1746565619102,MAE 197,003,959852,Mullin; Jennifer S,9998,0,9999,1
1746565624707,MATH 2,A01,957937,Staff,33,0,35,2
1746565629677,MATH 197,001,957876,Kedlaya; Kiran S.,9993,0,9999,6
1746565634271,MCWP 40,A00,892729,Duru; Nur,10,0,20,10
1746565634271,MCWP 40,B00,893304,Montejo; Carolina,14,0,20,6
1746565639288,MCWP 40R,A00,893757,Redela; Pamela Morgan,0,5,20,20
1746565644202,MCWP 50,A00,893758,Morshed; Michael James,0,0,20,20
1746565644202,MCWP 50,B00,893761,Bartulis; Jason Michael,17,0,20,3
1746565648834,MCWP 50R,A00,893766,Compas; Sean Matthew,0,1,20,20
1746565648834,MCWP 50R,B00,893769,Carter; Jennifer A,0,1,20,20
1746565648834,MCWP 50R,C00,893771,Krone; Jarret,0,3,20,20
1746565648834,MCWP 50R,D00,893772,Miller; Elizabeth Deen,0,0,20,20
1746565648834,MCWP 50R,E00,893775,Carter; Andrea L,0,1,20,20
1746565652335,MMW 11R,A01,892721,Herbst; Matthew,11,0,27,16
1746565652335,MMW 11R,A02,892722,Herbst; Matthew,0,0,0,3
1746565659303,MMW 12R,A01,892724,Herbst; Matthew,0,11,16,16
1746565659303,MMW 12R,A02,892725,Herbst; Matthew,0,10,16,16
1746565662813,MMW 13R,A01,892727,Staff,0,4,16,16
1746565662813,MMW 13R,A02,892728,Staff,0,4,16,16
1746565662813,MMW 13R,A03,958032,Staff,0,4,16,16
1746565662813,MMW 13R,A04,958033,Staff,0,4,16,16
1746565662813,MMW 13R,A05,958034,Staff,0,4,16,16
1746565666554,SIO 295LS,A00,894015,Staff,5,0,25,20
1746565671644,SIO 295S,A00,894020,Staff,5,0,25,20
1746565676956,SIOC 290S,B01,958918,Merrifield; Mark A,14,0,30,16
1746565685815,SIOC 291S,B01,958922,Gabriel; Corey John,14,0,30,16
1746565690326,SOCI 117,A01,895339,Staff,3,0,5,2
1746565693942,WES 237B,A00,894149,Staff,11,0,20,9
1746565703583,AESE 279B,A00,891859,Staff,13,0,35,22
1746565709006,AIP 197,001,891854,Vespa; Emanuel Ignacio,9999,0,9999,0
1746565712626,ANTH 289S,A00,891856,Gagneux; Pascal,12,0,12,0
1746565716265,BENG 196,001,957946,Engler; Adam J.,9996,0,9999,3
1746565719859,BISP 197,001,959851,Wilhelm; James E.,9998,0,9999,1
1746565727174,CAT 124RS,A01,956906,Staff,6,0,25,19
1746565741643,CAT 125RS,A01,922013,Staff,6,0,25,19
1746565754519,CLRE 250,A00,891860,Morris; Sheldon,9995,0,9999,4
