time,subj_course_id,sec_code,sec_id,prof,available,waitlist,total,enrolled_ct
1746566605784,AESE 279B,A00,891859,Staff,13,0,35,22
1746566606814,AIP 197,001,891854,Vespa; Emanuel Ignacio,9999,0,9999,0
1746566607843,ANTH 289S,A00,891856,Gagneux; Pascal,12,0,12,0
1746566608872,BENG 196,001,957946,Engler; Adam J.,9996,0,9999,3
1746566609902,BISP 197,001,959851,Wilhelm; James E.,9998,0,9999,1
1746566610930,CAT 124RS,A01,956906,Staff,6,0,25,19
1746566611958,CAT 125RS,A01,922013,Staff,6,0,25,19
1746566612985,CLRE 250,A00,891860,Morris; Sheldon,9995,0,9999,4
1746566615043,CLRE 251R,A00,907817,Mehta; Ravindra L.,9994,0,9999,5
1746566616075,CLRE 252,A00,891864,Cuomo; Raphael Eduardo,9993,0,9999,6
1746566617102,CLRE 253,A00,891867,Vaida; Florin,9994,0,9999,5
1746566617102,CLRE 253,B00,907819,Staff,9999,0,9999,0
1746566618131,CLRE 259,A00,891868,Patel; Hemal,9998,0,9999,1
1746566619158,CLRE 260,A00,891872,Cuomo; Raphael Eduardo,9999,0,9999,0
1746566620186,CLRE 297,001,891888,Cuomo; Raphael Eduardo,9999,0,9999,0
1746566621214,CSE 191,A00,958773,Minnes Kemp; Mor Mia,9995,0,9999,4
1746566622243,CSE 197,001,959846,Minnes Kemp; Mor Mia,9990,0,9999,9
1746566623269,CSS 201S,A01,892054,Mignozzetti; Umberto,25,0,30,5
1746566624298,CSS 202S,A01,892056,Mignozzetti; Umberto,25,0,30,5
1746566625325,DSC 197,001,956898,Eldridge; Justin Matthew,9996,0,9999,3
1746566626352,DSC 297,001,958000,Mazumdar; Arya,9998,0,9999,1
1746566626352,DSC 297,002,959862,Wang; Yusu,9998,0,9999,1
1746566627379,EAP 100,A00,905686,Staff,9778,0,9999,221
1746566628406,ECE 45,A01,892618,Staff,0,0,65,65
1746566630463,ECE 111,A01,892719,Staff,4,0,65,61
1746566631493,ECE 197,001,957920,Mercier; Patrick Philip,9991,0,9999,8
1746566632522,ECON 178,A01,907814,Zhu; Ying,26,0,35,9
1746566633551,EDS 115,A00,895312,Staff,35,0,45,10
1746566634580,EDS 117,A01,895337,Staff,23,0,30,7
1746566635612,EDS 125,A00,895341,Jones; Gabrielle Anastasia,36,0,45,9
1746566636642,EDS 128A,A01,895459,Fargason; Sharon Gayle,44,0,45,1
1746566637672,EDS 128B,A01,895543,Pappas; Elizabeth,44,0,45,1
1746566638703,EDS 139,A00,897203,Pappas; Elizabeth,44,0,45,1
1746566638703,EDS 139,B00,897209,Fargason; Sharon Gayle,41,0,45,4
1746566639730,EDS 201,A00,895545,Staff,22,0,45,23
1746566640761,EDS 203,A01,895581,Halter; Christopher P.,22,0,45,23
1746566641795,EDS 204R,A01,895625,Heinzman; Erica M.,39,0,45,6
1746566641795,EDS 204R,B01,895693,Halter; Christopher P.,10,0,45,35
1746566642823,EDS 206R,A00,895694,Fargason; Sharon Gayle,1,0,30,29
1746566642823,EDS 206R,B00,895695,Choi; Bailey Miyeon,16,0,30,14
1746566643851,EDS 250,A00,895697,Hemans; Patricia Ann Benitez,22,0,45,23
1746566644878,EDS 281,A00,895701,Meyerott; Theresa Ann,1,0,15,14
1746566645905,EDS 284,A00,895736,Meyerott; Theresa Ann,1,0,15,14
1746566646938,EDS 286,A00,897210,Fine; Sarah,0,0,15,15
1746566647976,EDS 289C,A01,895770,Daly; Alan J.,1,0,15,14
1746566649004,EDS 290,A00,897211,Hofstetter; Carolyn,0,0,15,15
1746566650039,LIGM 5A,A00,896162,Fischer-Grunski; Eva K,12,0,20,8
1746566651069,LIGM 5B,A00,896260,Fischer-Grunski; Eva K,17,0,20,3
1746566652101,LIGM 5C,A00,896308,Fischer-Grunski; Eva K,18,0,20,2
1746566653130,LIIT 5AS,A00,896313,Carnelos; Chiara,18,0,20,2
1746566654160,LIIT 5BS,A00,896416,Carnelos; Chiara,20,0,20,0
1746566655191,LIIT 5CS,A00,896564,Carnelos; Chiara,20,0,20,0
1746566656222,LISP 5A,A00,896588,Munoz Sanchez; Alicia,3,0,20,17
1746566657251,LISP 5B,A00,896653,Munoz Sanchez; Alicia,7,0,20,13
1746566658281,LISP 5C,A00,896655,Munoz Sanchez; Alicia,0,1,20,20
1746566659306,MAE 197,001,957918,Kleissl; Jan,9996,0,9999,3
1746566659306,MAE 197,002,959806,Boechler; Nicholas Sebastia,9998,0,9999,1
1746566659306,MAE 197,003,959852,Mullin; Jennifer S,9998,0,9999,1
1746566660334,MATH 2,A01,957937,Staff,33,0,35,2
1746566661370,MATH 197,001,957876,Kedlaya; Kiran S.,9993,0,9999,6
1746566662413,MCWP 40,A00,892729,Duru; Nur,10,0,20,10
1746566662413,MCWP 40,B00,893304,Montejo; Carolina,14,0,20,6
1746566663439,MCWP 40R,A00,893757,Redela; Pamela Morgan,0,5,20,20
1746566664466,MCWP 50,A00,893758,Morshed; Michael James,0,0,20,20
1746566664466,MCWP 50,B00,893761,Bartulis; Jason Michael,17,0,20,3
1746566665502,MCWP 50R,A00,893766,Compas; Sean Matthew,0,1,20,20
1746566665502,MCWP 50R,B00,893769,Carter; Jennifer A,0,1,20,20
1746566665502,MCWP 50R,C00,893771,Krone; Jarret,0,3,20,20
1746566665502,MCWP 50R,D00,893772,Miller; Elizabeth Deen,0,0,20,20
1746566665502,MCWP 50R,E00,893775,Carter; Andrea L,0,1,20,20
1746566666531,MMW 11R,A01,892721,Herbst; Matthew,11,0,27,16
1746566666531,MMW 11R,A02,892722,Herbst; Matthew,0,0,0,3
1746566667556,MMW 12R,A01,892724,Herbst; Matthew,0,11,16,16
1746566667556,MMW 12R,A02,892725,Herbst; Matthew,0,10,16,16
1746566668584,MMW 13R,A01,892727,Staff,0,4,16,16
1746566668584,MMW 13R,A02,892728,Staff,0,4,16,16
1746566668584,MMW 13R,A03,958032,Staff,0,4,16,16
1746566668584,MMW 13R,A04,958033,Staff,0,4,16,16
1746566668584,MMW 13R,A05,958034,Staff,0,4,16,16
1746566669616,SIO 295LS,A00,894015,Staff,5,0,25,20
1746566670647,SIO 295S,A00,894020,Staff,5,0,25,20
1746566671680,SIOC 290S,B01,958918,Merrifield; Mark A,14,0,30,16
1746566672713,SIOC 291S,B01,958922,Gabriel; Corey John,14,0,30,16
1746566673741,SOCI 117,A01,895339,Staff,3,0,5,2
1746566674772,WES 237B,A00,894149,Staff,11,0,20,9
1746566676848,AESE 279B,A00,891859,Staff,13,0,35,22
1746566677874,AIP 197,001,891854,Vespa; Emanuel Ignacio,9999,0,9999,0
1746566678901,ANTH 289S,A00,891856,Gagneux; Pascal,12,0,12,0
1746566679928,BENG 196,001,957946,Engler; Adam J.,9996,0,9999,3
1746566680958,BISP 197,001,959851,Wilhelm; James E.,9998,0,9999,1
1746566681989,CAT 124RS,A01,956906,Staff,6,0,25,19
1746566683017,CAT 125RS,A01,922013,Staff,6,0,25,19
1746566684046,CLRE 250,A00,891860,Morris; Sheldon,9995,0,9999,4
1746566686105,CLRE 251R,A00,907817,Mehta; Ravindra L.,9994,0,9999,5
1746566687132,CLRE 252,A00,891864,Cuomo; Raphael Eduardo,9993,0,9999,6
1746566688159,CLRE 253,A00,891867,Vaida; Florin,9994,0,9999,5
1746566688159,CLRE 253,B00,907819,Staff,9999,0,9999,0
1746566689190,CLRE 259,A00,891868,Patel; Hemal,9998,0,9999,1
1746566690220,CLRE 260,A00,891872,Cuomo; Raphael Eduardo,9999,0,9999,0
1746566691252,CLRE 297,001,891888,Cuomo; Raphael Eduardo,9999,0,9999,0
1746566692279,CSE 191,A00,958773,Minnes Kemp; Mor Mia,9995,0,9999,4
1746566693307,CSE 197,001,959846,Minnes Kemp; Mor Mia,9990,0,9999,9
1746566694337,CSS 201S,A01,892054,Mignozzetti; Umberto,25,0,30,5
1746566695371,CSS 202S,A01,892056,Mignozzetti; Umberto,25,0,30,5
1746566696409,DSC 197,001,956898,Eldridge; Justin Matthew,9996,0,9999,3
1746566697437,DSC 297,001,958000,Mazumdar; Arya,9998,0,9999,1
1746566697437,DSC 297,002,959862,Wang; Yusu,9998,0,9999,1
1746566698464,EAP 100,A00,905686,Staff,9778,0,9999,221
1746566699493,ECE 45,A01,892618,Staff,0,0,65,65
1746566701547,ECE 111,A01,892719,Staff,4,0,65,61
1746566702576,ECE 197,001,957920,Mercier; Patrick Philip,9991,0,9999,8
1746566703612,ECON 178,A01,907814,Zhu; Ying,26,0,35,9
1746566704639,EDS 115,A00,895312,Staff,35,0,45,10
1746566705666,EDS 117,A01,895337,Staff,23,0,30,7
1746566706691,EDS 125,A00,895341,Jones; Gabrielle Anastasia,36,0,45,9
1746566707721,EDS 128A,A01,895459,Fargason; Sharon Gayle,44,0,45,1
1746566708749,EDS 128B,A01,895543,Pappas; Elizabeth,44,0,45,1
1746566709776,EDS 139,A00,897203,Pappas; Elizabeth,44,0,45,1
1746566709776,EDS 139,B00,897209,Fargason; Sharon Gayle,41,0,45,4
1746566710803,EDS 201,A00,895545,Staff,22,0,45,23
1746566711848,EDS 203,A01,895581,Halter; Christopher P.,22,0,45,23
1746566712875,EDS 204R,A01,895625,Heinzman; Erica M.,39,0,45,6
1746566712875,EDS 204R,B01,895693,Halter; Christopher P.,10,0,45,35
1746566726096,EDS 206R,A00,895694,Fargason; Sharon Gayle,1,0,30,29
1746566726096,EDS 206R,B00,895695,Choi; Bailey Miyeon,16,0,30,14
1746566727131,EDS 250,A00,895697,Hemans; Patricia Ann Benitez,22,0,45,23
1746566728156,EDS 281,A00,895701,Meyerott; Theresa Ann,1,0,15,14
1746566729188,EDS 284,A00,895736,Meyerott; Theresa Ann,1,0,15,14
1746566730214,EDS 286,A00,897210,Fine; Sarah,0,0,15,15
1746566731245,EDS 289C,A01,895770,Daly; Alan J.,1,0,15,14
1746566732275,EDS 290,A00,897211,Hofstetter; Carolyn,0,0,15,15
1746566733302,LIGM 5A,A00,896162,Fischer-Grunski; Eva K,12,0,20,8
1746566734335,LIGM 5B,A00,896260,Fischer-Grunski; Eva K,17,0,20,3
1746566735360,LIGM 5C,A00,896308,Fischer-Grunski; Eva K,18,0,20,2
1746566748946,LIIT 5AS,A00,896313,Carnelos; Chiara,18,0,20,2
1746566749974,LIIT 5BS,A00,896416,Carnelos; Chiara,20,0,20,0
1746566750999,LIIT 5CS,A00,896564,Carnelos; Chiara,20,0,20,0
1746566752028,LISP 5A,A00,896588,Munoz Sanchez; Alicia,3,0,20,17
1746566753058,LISP 5B,A00,896653,Munoz Sanchez; Alicia,7,0,20,13
1746566754084,LISP 5C,A00,896655,Munoz Sanchez; Alicia,0,1,20,20
1746566755113,MAE 197,001,957918,Kleissl; Jan,9996,0,9999,3
1746566755113,MAE 197,002,959806,Boechler; Nicholas Sebastia,9998,0,9999,1
1746566755113,MAE 197,003,959852,Mullin; Jennifer S,9998,0,9999,1
1746566756143,MATH 2,A01,957937,Staff,33,0,35,2
1746566757174,MATH 197,001,957876,Kedlaya; Kiran S.,9993,0,9999,6
1746566758204,MCWP 40,A00,892729,Duru; Nur,10,0,20,10
1746566758204,MCWP 40,B00,893304,Montejo; Carolina,14,0,20,6
1746566760641,MCWP 40R,A00,893757,Redela; Pamela Morgan,0,5,20,20
1746566761667,MCWP 50,A00,893758,Morshed; Michael James,0,0,20,20
1746566761667,MCWP 50,B00,893761,Bartulis; Jason Michael,17,0,20,3
1746566762699,MCWP 50R,A00,893766,Compas; Sean Matthew,0,1,20,20
1746566762699,MCWP 50R,B00,893769,Carter; Jennifer A,0,1,20,20
1746566762699,MCWP 50R,C00,893771,Krone; Jarret,0,3,20,20
1746566762699,MCWP 50R,D00,893772,Miller; Elizabeth Deen,0,0,20,20
1746566762699,MCWP 50R,E00,893775,Carter; Andrea L,0,1,20,20
1746566763727,MMW 11R,A01,892721,Herbst; Matthew,11,0,27,16
1746566763727,MMW 11R,A02,892722,Herbst; Matthew,0,0,0,3
1746566764756,MMW 12R,A01,892724,Herbst; Matthew,0,11,16,16
1746566764756,MMW 12R,A02,892725,Herbst; Matthew,0,10,16,16
1746566765785,MMW 13R,A01,892727,Staff,0,4,16,16
1746566765785,MMW 13R,A02,892728,Staff,0,4,16,16
1746566765785,MMW 13R,A03,958032,Staff,0,4,16,16
1746566765785,MMW 13R,A04,958033,Staff,0,4,16,16
1746566765785,MMW 13R,A05,958034,Staff,0,4,16,16
1746566766818,SIO 295LS,A00,894015,Staff,5,0,25,20
1746566767847,SIO 295S,A00,894020,Staff,5,0,25,20
1746566768875,SIOC 290S,B01,958918,Merrifield; Mark A,14,0,30,16
1746566769900,SIOC 291S,B01,958922,Gabriel; Corey John,14,0,30,16
1746566770928,SOCI 117,A01,895339,Staff,3,0,5,2
1746566771956,WES 237B,A00,894149,Staff,11,0,20,9
1746566774031,AESE 279B,A00,891859,Staff,13,0,35,22
1746566775058,AIP 197,001,891854,Vespa; Emanuel Ignacio,9999,0,9999,0
1746566776086,ANTH 289S,A00,891856,Gagneux; Pascal,12,0,12,0
1746566777113,BENG 196,001,957946,Engler; Adam J.,9996,0,9999,3
1746566778143,BISP 197,001,959851,Wilhelm; James E.,9998,0,9999,1
1746566779168,CAT 124RS,A01,956906,Staff,6,0,25,19
1746566780197,CAT 125RS,A01,922013,Staff,6,0,25,19
1746566781224,CLRE 250,A00,891860,Morris; Sheldon,9995,0,9999,4
1746566783278,CLRE 251R,A00,907817,Mehta; Ravindra L.,9994,0,9999,5
1746566784306,CLRE 252,A00,891864,Cuomo; Raphael Eduardo,9993,0,9999,6
1746566785333,CLRE 253,A00,891867,Vaida; Florin,9994,0,9999,5
1746566785333,CLRE 253,B00,907819,Staff,9999,0,9999,0
1746566786361,CLRE 259,A00,891868,Patel; Hemal,9998,0,9999,1
1746566788771,CLRE 260,A00,891872,Cuomo; Raphael Eduardo,9999,0,9999,0
1746566789800,CLRE 297,001,891888,Cuomo; Raphael Eduardo,9999,0,9999,0
1746566790828,CSE 191,A00,958773,Minnes Kemp; Mor Mia,9995,0,9999,4
1746566791859,CSE 197,001,959846,Minnes Kemp; Mor Mia,9990,0,9999,9
1746566792885,CSS 201S,A01,892054,Mignozzetti; Umberto,25,0,30,5
1746566793916,CSS 202S,A01,892056,Mignozzetti; Umberto,25,0,30,5
1746566794942,DSC 197,001,956898,Eldridge; Justin Matthew,9996,0,9999,3
1746566795967,DSC 297,001,958000,Mazumdar; Arya,9998,0,9999,1
1746566795967,DSC 297,002,959862,Wang; Yusu,9998,0,9999,1
1746566796998,EAP 100,A00,905686,Staff,9778,0,9999,221
1746566798028,ECE 45,A01,892618,Staff,0,0,65,65
1746566800092,ECE 111,A01,892719,Staff,4,0,65,61
1746566801122,ECE 197,001,957920,Mercier; Patrick Philip,9991,0,9999,8
1746566802152,ECON 178,A01,907814,Zhu; Ying,26,0,35,9
1746566803180,EDS 115,A00,895312,Staff,35,0,45,10
1746566804209,EDS 117,A01,895337,Staff,23,0,30,7
1746566805238,EDS 125,A00,895341,Jones; Gabrielle Anastasia,36,0,45,9
1746566806264,EDS 128A,A01,895459,Fargason; Sharon Gayle,44,0,45,1
1746566807293,EDS 128B,A01,895543,Pappas; Elizabeth,44,0,45,1
1746566808317,EDS 139,A00,897203,Pappas; Elizabeth,44,0,45,1
1746566808317,EDS 139,B00,897209,Fargason; Sharon Gayle,41,0,45,4
1746566809343,EDS 201,A00,895545,Staff,22,0,45,23
1746566810370,EDS 203,A01,895581,Halter; Christopher P.,22,0,45,23
1746566811398,EDS 204R,A01,895625,Heinzman; Erica M.,39,0,45,6
1746566811398,EDS 204R,B01,895693,Halter; Christopher P.,10,0,45,35
1746566812423,EDS 206R,A00,895694,Fargason; Sharon Gayle,1,0,30,29
1746566812423,EDS 206R,B00,895695,Choi; Bailey Miyeon,16,0,30,14
1746566813451,EDS 250,A00,895697,Hemans; Patricia Ann Benitez,22,0,45,23
1746566814478,EDS 281,A00,895701,Meyerott; Theresa Ann,1,0,15,14
1746566815505,EDS 284,A00,895736,Meyerott; Theresa Ann,1,0,15,14
1746566816538,EDS 286,A00,897210,Fine; Sarah,0,0,15,15
1746566817565,EDS 289C,A01,895770,Daly; Alan J.,1,0,15,14
1746566818606,EDS 290,A00,897211,Hofstetter; Carolyn,0,0,15,15
1746566819631,LIGM 5A,A00,896162,Fischer-Grunski; Eva K,12,0,20,8
1746566820657,LIGM 5B,A00,896260,Fischer-Grunski; Eva K,17,0,20,3
1746566821683,LIGM 5C,A00,896308,Fischer-Grunski; Eva K,18,0,20,2
1746566822711,LIIT 5AS,A00,896313,Carnelos; Chiara,18,0,20,2
1746566823741,LIIT 5BS,A00,896416,Carnelos; Chiara,20,0,20,0
1746566824766,LIIT 5CS,A00,896564,Carnelos; Chiara,20,0,20,0
1746566825791,LISP 5A,A00,896588,Munoz Sanchez; Alicia,3,0,20,17
1746566826817,LISP 5B,A00,896653,Munoz Sanchez; Alicia,7,0,20,13
1746566827861,LISP 5C,A00,896655,Munoz Sanchez; Alicia,0,1,20,20
1746566828884,MAE 197,001,957918,Kleissl; Jan,9996,0,9999,3
1746566828884,MAE 197,002,959806,Boechler; Nicholas Sebastia,9998,0,9999,1
1746566828884,MAE 197,003,959852,Mullin; Jennifer S,9998,0,9999,1
1746566829913,MATH 2,A01,957937,Staff,33,0,35,2
1746566830938,MATH 197,001,957876,Kedlaya; Kiran S.,9993,0,9999,6
1746566831970,MCWP 40,A00,892729,Duru; Nur,10,0,20,10
1746566831970,MCWP 40,B00,893304,Montejo; Carolina,14,0,20,6
1746566832997,MCWP 40R,A00,893757,Redela; Pamela Morgan,0,5,20,20
1746566834025,MCWP 50,A00,893758,Morshed; Michael James,0,0,20,20
1746566834025,MCWP 50,B00,893761,Bartulis; Jason Michael,17,0,20,3
1746566835051,MCWP 50R,A00,893766,Compas; Sean Matthew,0,1,20,20
1746566835051,MCWP 50R,B00,893769,Carter; Jennifer A,0,1,20,20
1746566835051,MCWP 50R,C00,893771,Krone; Jarret,0,3,20,20
1746566835051,MCWP 50R,D00,893772,Miller; Elizabeth Deen,0,0,20,20
1746566835051,MCWP 50R,E00,893775,Carter; Andrea L,0,1,20,20
1746566836077,MMW 11R,A01,892721,Herbst; Matthew,11,0,27,16
1746566836077,MMW 11R,A02,892722,Herbst; Matthew,0,0,0,3
1746566837104,MMW 12R,A01,892724,Herbst; Matthew,0,11,16,16
1746566837104,MMW 12R,A02,892725,Herbst; Matthew,0,10,16,16
1746566838130,MMW 13R,A01,892727,Staff,0,4,16,16
1746566838130,MMW 13R,A02,892728,Staff,0,4,16,16
1746566838130,MMW 13R,A03,958032,Staff,0,4,16,16
1746566838130,MMW 13R,A04,958033,Staff,0,4,16,16
1746566838130,MMW 13R,A05,958034,Staff,0,4,16,16
1746566839160,SIO 295LS,A00,894015,Staff,5,0,25,20
1746566840190,SIO 295S,A00,894020,Staff,5,0,25,20
1746566841215,SIOC 290S,B01,958918,Merrifield; Mark A,14,0,30,16
1746566842247,SIOC 291S,B01,958922,Gabriel; Corey John,14,0,30,16
1746566843278,SOCI 117,A01,895339,Staff,3,0,5,2
1746566844303,WES 237B,A00,894149,Staff,11,0,20,9
1746566846367,AESE 279B,A00,891859,Staff,13,0,35,22
1746566847395,AIP 197,001,891854,Vespa; Emanuel Ignacio,9999,0,9999,0
1746566848423,ANTH 289S,A00,891856,Gagneux; Pascal,12,0,12,0
1746566849449,BENG 196,001,957946,Engler; Adam J.,9996,0,9999,3
1746566850476,BISP 197,001,959851,Wilhelm; James E.,9998,0,9999,1
1746566851505,CAT 124RS,A01,956906,Staff,6,0,25,19
1746566852533,CAT 125RS,A01,922013,Staff,6,0,25,19
1746566853559,CLRE 250,A00,891860,Morris; Sheldon,9995,0,9999,4
1746566855612,CLRE 251R,A00,907817,Mehta; Ravindra L.,9994,0,9999,5
1746566856638,CLRE 252,A00,891864,Cuomo; Raphael Eduardo,9993,0,9999,6
1746566857665,CLRE 253,A00,891867,Vaida; Florin,9994,0,9999,5
1746566857665,CLRE 253,B00,907819,Staff,9999,0,9999,0
1746566858694,CLRE 259,A00,891868,Patel; Hemal,9998,0,9999,1
1746566859720,CLRE 260,A00,891872,Cuomo; Raphael Eduardo,9999,0,9999,0
1746566860748,CLRE 297,001,891888,Cuomo; Raphael Eduardo,9999,0,9999,0
1746566861776,CSE 191,A00,958773,Minnes Kemp; Mor Mia,9995,0,9999,4
1746566862804,CSE 197,001,959846,Minnes Kemp; Mor Mia,9990,0,9999,9
1746566863832,CSS 201S,A01,892054,Mignozzetti; Umberto,25,0,30,5
1746566864863,CSS 202S,A01,892056,Mignozzetti; Umberto,25,0,30,5
1746566865891,DSC 197,001,956898,Eldridge; Justin Matthew,9996,0,9999,3
1746566866925,DSC 297,001,958000,Mazumdar; Arya,9998,0,9999,1
1746566866925,DSC 297,002,959862,Wang; Yusu,9998,0,9999,1
1746566867953,EAP 100,A00,905686,Staff,9778,0,9999,221
1746566868979,ECE 45,A01,892618,Staff,0,0,65,65
1746566871035,ECE 111,A01,892719,Staff,4,0,65,61
1746566872060,ECE 197,001,957920,Mercier; Patrick Philip,9991,0,9999,8
1746566873086,ECON 178,A01,907814,Zhu; Ying,26,0,35,9
1746566874113,EDS 115,A00,895312,Staff,35,0,45,10
1746566875142,EDS 117,A01,895337,Staff,23,0,30,7
1746566876172,EDS 125,A00,895341,Jones; Gabrielle Anastasia,36,0,45,9
1746566877200,EDS 128A,A01,895459,Fargason; Sharon Gayle,44,0,45,1
1746566878224,EDS 128B,A01,895543,Pappas; Elizabeth,44,0,45,1
1746566879254,EDS 139,A00,897203,Pappas; Elizabeth,44,0,45,1
1746566879254,EDS 139,B00,897209,Fargason; Sharon Gayle,41,0,45,4
1746566880284,EDS 201,A00,895545,Staff,22,0,45,23
1746566881310,EDS 203,A01,895581,Halter; Christopher P.,22,0,45,23
1746566882343,EDS 204R,A01,895625,Heinzman; Erica M.,39,0,45,6
1746566882343,EDS 204R,B01,895693,Halter; Christopher P.,10,0,45,35
1746566883375,EDS 206R,A00,895694,Fargason; Sharon Gayle,1,0,30,29
1746566883375,EDS 206R,B00,895695,Choi; Bailey Miyeon,16,0,30,14
1746566884401,EDS 250,A00,895697,Hemans; Patricia Ann Benitez,22,0,45,23
1746566885426,EDS 281,A00,895701,Meyerott; Theresa Ann,1,0,15,14
1746566886453,EDS 284,A00,895736,Meyerott; Theresa Ann,1,0,15,14
1746566887481,EDS 286,A00,897210,Fine; Sarah,0,0,15,15
1746566888507,EDS 289C,A01,895770,Daly; Alan J.,1,0,15,14
1746566889533,EDS 290,A00,897211,Hofstetter; Carolyn,0,0,15,15
1746566890562,LIGM 5A,A00,896162,Fischer-Grunski; Eva K,12,0,20,8
1746566891589,LIGM 5B,A00,896260,Fischer-Grunski; Eva K,17,0,20,3
1746566892616,LIGM 5C,A00,896308,Fischer-Grunski; Eva K,18,0,20,2
1746566893646,LIIT 5AS,A00,896313,Carnelos; Chiara,18,0,20,2
1746566894676,LIIT 5BS,A00,896416,Carnelos; Chiara,20,0,20,0
1746566895703,LIIT 5CS,A00,896564,Carnelos; Chiara,20,0,20,0
1746566896732,LISP 5A,A00,896588,Munoz Sanchez; Alicia,3,0,20,17
1746566897761,LISP 5B,A00,896653,Munoz Sanchez; Alicia,7,0,20,13
1746566898787,LISP 5C,A00,896655,Munoz Sanchez; Alicia,0,1,20,20
1746566899819,MAE 197,001,957918,Kleissl; Jan,9996,0,9999,3
1746566899819,MAE 197,002,959806,Boechler; Nicholas Sebastia,9998,0,9999,1
1746566899819,MAE 197,003,959852,Mullin; Jennifer S,9998,0,9999,1
1746566900845,MATH 2,A01,957937,Staff,33,0,35,2
1746566901874,MATH 197,001,957876,Kedlaya; Kiran S.,9993,0,9999,6
1746566902901,MCWP 40,A00,892729,Duru; Nur,10,0,20,10
1746566902901,MCWP 40,B00,893304,Montejo; Carolina,14,0,20,6
1746566903926,MCWP 40R,A00,893757,Redela; Pamela Morgan,0,5,20,20
1746566904953,MCWP 50,A00,893758,Morshed; Michael James,0,0,20,20
1746566904953,MCWP 50,B00,893761,Bartulis; Jason Michael,17,0,20,3
1746566905979,MCWP 50R,A00,893766,Compas; Sean Matthew,0,1,20,20
1746566905979,MCWP 50R,B00,893769,Carter; Jennifer A,0,1,20,20
1746566905979,MCWP 50R,C00,893771,Krone; Jarret,0,3,20,20
1746566905979,MCWP 50R,D00,893772,Miller; Elizabeth Deen,0,0,20,20
1746566905979,MCWP 50R,E00,893775,Carter; Andrea L,0,1,20,20
1746566907013,MMW 11R,A01,892721,Herbst; Matthew,11,0,27,16
1746566907013,MMW 11R,A02,892722,Herbst; Matthew,0,0,0,3
1746566908041,MMW 12R,A01,892724,Herbst; Matthew,0,11,16,16
1746566908041,MMW 12R,A02,892725,Herbst; Matthew,0,10,16,16
1746566909070,MMW 13R,A01,892727,Staff,0,4,16,16
1746566909070,MMW 13R,A02,892728,Staff,0,4,16,16
1746566909070,MMW 13R,A03,958032,Staff,0,4,16,16
1746566909070,MMW 13R,A04,958033,Staff,0,4,16,16
1746566909070,MMW 13R,A05,958034,Staff,0,4,16,16
1746566910099,SIO 295LS,A00,894015,Staff,5,0,25,20
1746566911172,SIO 295S,A00,894020,Staff,5,0,25,20
1746566912204,SIOC 290S,B01,958918,Merrifield; Mark A,14,0,30,16
1746566913233,SIOC 291S,B01,958922,Gabriel; Corey John,14,0,30,16
1746566914260,SOCI 117,A01,895339,Staff,3,0,5,2
1746566915284,WES 237B,A00,894149,Staff,11,0,20,9
1746566917348,AESE 279B,A00,891859,Staff,13,0,35,22
1746566918372,AIP 197,001,891854,Vespa; Emanuel Ignacio,9999,0,9999,0
1746566919396,ANTH 289S,A00,891856,Gagneux; Pascal,12,0,12,0
1746566920420,BENG 196,001,957946,Engler; Adam J.,9996,0,9999,3
1746566921447,BISP 197,001,959851,Wilhelm; James E.,9998,0,9999,1
1746566922474,CAT 124RS,A01,956906,Staff,6,0,25,19
1746566923506,CAT 125RS,A01,922013,Staff,6,0,25,19
1746566924534,CLRE 250,A00,891860,Morris; Sheldon,9995,0,9999,4
1746566926593,CLRE 251R,A00,907817,Mehta; Ravindra L.,9994,0,9999,5
1746566927624,CLRE 252,A00,891864,Cuomo; Raphael Eduardo,9993,0,9999,6
1746566928656,CLRE 253,A00,891867,Vaida; Florin,9994,0,9999,5
1746566928656,CLRE 253,B00,907819,Staff,9999,0,9999,0
1746566929685,CLRE 259,A00,891868,Patel; Hemal,9998,0,9999,1
1746566930713,CLRE 260,A00,891872,Cuomo; Raphael Eduardo,9999,0,9999,0
1746566931738,CLRE 297,001,891888,Cuomo; Raphael Eduardo,9999,0,9999,0
1746566932762,CSE 191,A00,958773,Minnes Kemp; Mor Mia,9995,0,9999,4
1746566933791,CSE 197,001,959846,Minnes Kemp; Mor Mia,9990,0,9999,9
1746566934819,CSS 201S,A01,892054,Mignozzetti; Umberto,25,0,30,5
1746566935848,CSS 202S,A01,892056,Mignozzetti; Umberto,25,0,30,5
1746566936874,DSC 197,001,956898,Eldridge; Justin Matthew,9996,0,9999,3
1746566937903,DSC 297,001,958000,Mazumdar; Arya,9998,0,9999,1
1746566937903,DSC 297,002,959862,Wang; Yusu,9998,0,9999,1
1746566938932,EAP 100,A00,905686,Staff,9778,0,9999,221
1746566939957,ECE 45,A01,892618,Staff,0,0,65,65
1746566942010,ECE 111,A01,892719,Staff,4,0,65,61
1746566943036,ECE 197,001,957920,Mercier; Patrick Philip,9991,0,9999,8
1746566944063,ECON 178,A01,907814,Zhu; Ying,26,0,35,9
1746566945092,EDS 115,A00,895312,Staff,35,0,45,10
1746566946121,EDS 117,A01,895337,Staff,23,0,30,7
1746566947152,EDS 125,A00,895341,Jones; Gabrielle Anastasia,36,0,45,9
1746566948178,EDS 128A,A01,895459,Fargason; Sharon Gayle,44,0,45,1
1746566949205,EDS 128B,A01,895543,Pappas; Elizabeth,44,0,45,1
1746566950232,EDS 139,A00,897203,Pappas; Elizabeth,44,0,45,1
1746566950232,EDS 139,B00,897209,Fargason; Sharon Gayle,41,0,45,4
1746566951261,EDS 201,A00,895545,Staff,22,0,45,23
1746566952285,EDS 203,A01,895581,Halter; Christopher P.,22,0,45,23
1746566953311,EDS 204R,A01,895625,Heinzman; Erica M.,39,0,45,6
1746566953311,EDS 204R,B01,895693,Halter; Christopher P.,10,0,45,35
1746566954341,EDS 206R,A00,895694,Fargason; Sharon Gayle,1,0,30,29
1746566954341,EDS 206R,B00,895695,Choi; Bailey Miyeon,16,0,30,14
1746566955366,EDS 250,A00,895697,Hemans; Patricia Ann Benitez,22,0,45,23
1746566956395,EDS 281,A00,895701,Meyerott; Theresa Ann,1,0,15,14
1746566957421,EDS 284,A00,895736,Meyerott; Theresa Ann,1,0,15,14
1746566958451,EDS 286,A00,897210,Fine; Sarah,0,0,15,15
1746566959476,EDS 289C,A01,895770,Daly; Alan J.,1,0,15,14
1746566960504,EDS 290,A00,897211,Hofstetter; Carolyn,0,0,15,15
1746566961529,LIGM 5A,A00,896162,Fischer-Grunski; Eva K,12,0,20,8
1746566962563,LIGM 5B,A00,896260,Fischer-Grunski; Eva K,17,0,20,3
1746566963588,LIGM 5C,A00,896308,Fischer-Grunski; Eva K,18,0,20,2
1746566964614,LIIT 5AS,A00,896313,Carnelos; Chiara,18,0,20,2
1746566965641,LIIT 5BS,A00,896416,Carnelos; Chiara,20,0,20,0
1746566966671,LIIT 5CS,A00,896564,Carnelos; Chiara,20,0,20,0
1746566967699,LISP 5A,A00,896588,Munoz Sanchez; Alicia,3,0,20,17
1746566968725,LISP 5B,A00,896653,Munoz Sanchez; Alicia,7,0,20,13
1746566969751,LISP 5C,A00,896655,Munoz Sanchez; Alicia,0,1,20,20
1746566970777,MAE 197,001,957918,Kleissl; Jan,9996,0,9999,3
1746566970777,MAE 197,002,959806,Boechler; Nicholas Sebastia,9998,0,9999,1
1746566970777,MAE 197,003,959852,Mullin; Jennifer S,9998,0,9999,1
1746566971805,MATH 2,A01,957937,Staff,33,0,35,2
1746566972832,MATH 197,001,957876,Kedlaya; Kiran S.,9993,0,9999,6
1746566973860,MCWP 40,A00,892729,Duru; Nur,10,0,20,10
1746566973860,MCWP 40,B00,893304,Montejo; Carolina,14,0,20,6
1746566974887,MCWP 40R,A00,893757,Redela; Pamela Morgan,0,5,20,20
1746566975914,MCWP 50,A00,893758,Morshed; Michael James,0,0,20,20
1746566975914,MCWP 50,B00,893761,Bartulis; Jason Michael,17,0,20,3
1746566976943,MCWP 50R,A00,893766,Compas; Sean Matthew,0,1,20,20
1746566976943,MCWP 50R,B00,893769,Carter; Jennifer A,0,1,20,20
1746566976943,MCWP 50R,C00,893771,Krone; Jarret,0,3,20,20
1746566976943,MCWP 50R,D00,893772,Miller; Elizabeth Deen,0,0,20,20
1746566976943,MCWP 50R,E00,893775,Carter; Andrea L,0,1,20,20
1746566977969,MMW 11R,A01,892721,Herbst; Matthew,11,0,27,16
1746566977969,MMW 11R,A02,892722,Herbst; Matthew,0,0,0,3
1746566978997,MMW 12R,A01,892724,Herbst; Matthew,0,11,16,16
1746566978997,MMW 12R,A02,892725,Herbst; Matthew,0,10,16,16
1746566980024,MMW 13R,A01,892727,Staff,0,4,16,16
1746566980024,MMW 13R,A02,892728,Staff,0,4,16,16
1746566980024,MMW 13R,A03,958032,Staff,0,4,16,16
1746566980024,MMW 13R,A04,958033,Staff,0,4,16,16
1746566980024,MMW 13R,A05,958034,Staff,0,4,16,16
1746566981059,SIO 295LS,A00,894015,Staff,5,0,25,20
1746566982087,SIO 295S,A00,894020,Staff,5,0,25,20
1746566983115,SIOC 290S,B01,958918,Merrifield; Mark A,14,0,30,16
1746566984142,SIOC 291S,B01,958922,Gabriel; Corey John,14,0,30,16
1746566985171,SOCI 117,A01,895339,Staff,3,0,5,2
1746566986199,WES 237B,A00,894149,Staff,11,0,20,9
1746566988274,AESE 279B,A00,891859,Staff,13,0,35,22
1746566989305,AIP 197,001,891854,Vespa; Emanuel Ignacio,9999,0,9999,0
1746566990333,ANTH 289S,A00,891856,Gagneux; Pascal,12,0,12,0
1746566991359,BENG 196,001,957946,Engler; Adam J.,9996,0,9999,3
1746566992387,BISP 197,001,959851,Wilhelm; James E.,9998,0,9999,1
1746566993413,CAT 124RS,A01,956906,Staff,6,0,25,19
1746566994439,CAT 125RS,A01,922013,Staff,6,0,25,19
1746566995465,CLRE 250,A00,891860,Morris; Sheldon,9995,0,9999,4
1746566997519,CLRE 251R,A00,907817,Mehta; Ravindra L.,9994,0,9999,5
1746566998544,CLRE 252,A00,891864,Cuomo; Raphael Eduardo,9993,0,9999,6
1746566999570,CLRE 253,A00,891867,Vaida; Florin,9994,0,9999,5
1746566999570,CLRE 253,B00,907819,Staff,9999,0,9999,0
1746567000598,CLRE 259,A00,891868,Patel; Hemal,9998,0,9999,1
1746567001629,CLRE 260,A00,891872,Cuomo; Raphael Eduardo,9999,0,9999,0
1746567002658,CLRE 297,001,891888,Cuomo; Raphael Eduardo,9999,0,9999,0
1746567003682,CSE 191,A00,958773,Minnes Kemp; Mor Mia,9995,0,9999,4
1746567004717,CSE 197,001,959846,Minnes Kemp; Mor Mia,9990,0,9999,9
1746567005748,CSS 201S,A01,892054,Mignozzetti; Umberto,25,0,30,5
1746567006775,CSS 202S,A01,892056,Mignozzetti; Umberto,25,0,30,5
1746567007800,DSC 197,001,956898,Eldridge; Justin Matthew,9996,0,9999,3
1746567008832,DSC 297,001,958000,Mazumdar; Arya,9998,0,9999,1
1746567008832,DSC 297,002,959862,Wang; Yusu,9998,0,9999,1
1746567009858,EAP 100,A00,905686,Staff,9778,0,9999,221
1746567010884,ECE 45,A01,892618,Staff,0,0,65,65
1746567012935,ECE 111,A01,892719,Staff,4,0,65,61
1746567013964,ECE 197,001,957920,Mercier; Patrick Philip,9991,0,9999,8
1746567014989,ECON 178,A01,907814,Zhu; Ying,26,0,35,9
1746567016014,EDS 115,A00,895312,Staff,35,0,45,10
1746567017044,EDS 117,A01,895337,Staff,23,0,30,7
1746567018069,EDS 125,A00,895341,Jones; Gabrielle Anastasia,36,0,45,9
1746567019098,EDS 128A,A01,895459,Fargason; Sharon Gayle,44,0,45,1
1746567020123,EDS 128B,A01,895543,Pappas; Elizabeth,44,0,45,1
1746567021149,EDS 139,A00,897203,Pappas; Elizabeth,44,0,45,1
1746567021149,EDS 139,B00,897209,Fargason; Sharon Gayle,41,0,45,4
1746567022177,EDS 201,A00,895545,Staff,22,0,45,23
1746567023201,EDS 203,A01,895581,Halter; Christopher P.,22,0,45,23
1746567024227,EDS 204R,A01,895625,Heinzman; Erica M.,39,0,45,6
1746567024227,EDS 204R,B01,895693,Halter; Christopher P.,10,0,45,35
1746567025258,EDS 206R,A00,895694,Fargason; Sharon Gayle,1,0,30,29
1746567025258,EDS 206R,B00,895695,Choi; Bailey Miyeon,16,0,30,14
1746567026287,EDS 250,A00,895697,Hemans; Patricia Ann Benitez,22,0,45,23
1746567027314,EDS 281,A00,895701,Meyerott; Theresa Ann,1,0,15,14
1746567028340,EDS 284,A00,895736,Meyerott; Theresa Ann,1,0,15,14
1746567029365,EDS 286,A00,897210,Fine; Sarah,0,0,15,15
1746567030397,EDS 289C,A01,895770,Daly; Alan J.,1,0,15,14
1746567031423,EDS 290,A00,897211,Hofstetter; Carolyn,0,0,15,15
1746567032449,LIGM 5A,A00,896162,Fischer-Grunski; Eva K,12,0,20,8
1746567033476,LIGM 5B,A00,896260,Fischer-Grunski; Eva K,17,0,20,3
1746567034504,LIGM 5C,A00,896308,Fischer-Grunski; Eva K,18,0,20,2
1746567035536,LIIT 5AS,A00,896313,Carnelos; Chiara,18,0,20,2
1746567036568,LIIT 5BS,A00,896416,Carnelos; Chiara,20,0,20,0
1746567037594,LIIT 5CS,A00,896564,Carnelos; Chiara,20,0,20,0
1746567038624,LISP 5A,A00,896588,Munoz Sanchez; Alicia,3,0,20,17
1746567039654,LISP 5B,A00,896653,Munoz Sanchez; Alicia,7,0,20,13
1746567040682,LISP 5C,A00,896655,Munoz Sanchez; Alicia,0,1,20,20
1746567041709,MAE 197,001,957918,Kleissl; Jan,9996,0,9999,3
1746567041709,MAE 197,002,959806,Boechler; Nicholas Sebastia,9998,0,9999,1
1746567041709,MAE 197,003,959852,Mullin; Jennifer S,9998,0,9999,1
1746567042738,MATH 2,A01,957937,Staff,33,0,35,2
1746567043764,MATH 197,001,957876,Kedlaya; Kiran S.,9993,0,9999,6
1746567044792,MCWP 40,A00,892729,Duru; Nur,10,0,20,10
1746567044792,MCWP 40,B00,893304,Montejo; Carolina,14,0,20,6
1746567045819,MCWP 40R,A00,893757,Redela; Pamela Morgan,0,5,20,20
1746567046844,MCWP 50,A00,893758,Morshed; Michael James,0,0,20,20
1746567046844,MCWP 50,B00,893761,Bartulis; Jason Michael,17,0,20,3
1746567047876,MCWP 50R,A00,893766,Compas; Sean Matthew,0,1,20,20
1746567047876,MCWP 50R,B00,893769,Carter; Jennifer A,0,1,20,20
1746567047876,MCWP 50R,C00,893771,Krone; Jarret,0,3,20,20
1746567047876,MCWP 50R,D00,893772,Miller; Elizabeth Deen,0,0,20,20
1746567047876,MCWP 50R,E00,893775,Carter; Andrea L,0,1,20,20
1746567048904,MMW 11R,A01,892721,Herbst; Matthew,11,0,27,16
1746567048904,MMW 11R,A02,892722,Herbst; Matthew,0,0,0,3
1746567049936,MMW 12R,A01,892724,Herbst; Matthew,0,11,16,16
1746567049936,MMW 12R,A02,892725,Herbst; Matthew,0,10,16,16
1746567050961,MMW 13R,A01,892727,Staff,0,4,16,16
1746567050961,MMW 13R,A02,892728,Staff,0,4,16,16
1746567050961,MMW 13R,A03,958032,Staff,0,4,16,16
1746567050961,MMW 13R,A04,958033,Staff,0,4,16,16
1746567050961,MMW 13R,A05,958034,Staff,0,4,16,16
1746567051989,SIO 295LS,A00,894015,Staff,5,0,25,20
1746567053017,SIO 295S,A00,894020,Staff,5,0,25,20
1746567054045,SIOC 290S,B01,958918,Merrifield; Mark A,14,0,30,16
1746567055073,SIOC 291S,B01,958922,Gabriel; Corey John,14,0,30,16
1746567056099,SOCI 117,A01,895339,Staff,3,0,5,2
1746567057130,WES 237B,A00,894149,Staff,11,0,20,9
1746567059191,AESE 279B,A00,891859,Staff,13,0,35,22
1746567060217,AIP 197,001,891854,Vespa; Emanuel Ignacio,9999,0,9999,0
1746567061244,ANTH 289S,A00,891856,Gagneux; Pascal,12,0,12,0
1746567062274,BENG 196,001,957946,Engler; Adam J.,9996,0,9999,3
1746567063300,BISP 197,001,959851,Wilhelm; James E.,9998,0,9999,1
1746567064326,CAT 124RS,A01,956906,Staff,6,0,25,19
1746567065354,CAT 125RS,A01,922013,Staff,6,0,25,19
1746567066379,CLRE 250,A00,891860,Morris; Sheldon,9995,0,9999,4
1746567068433,CLRE 251R,A00,907817,Mehta; Ravindra L.,9994,0,9999,5
1746567069459,CLRE 252,A00,891864,Cuomo; Raphael Eduardo,9993,0,9999,6
1746567070490,CLRE 253,A00,891867,Vaida; Florin,9994,0,9999,5
1746567070490,CLRE 253,B00,907819,Staff,9999,0,9999,0
1746567071520,CLRE 259,A00,891868,Patel; Hemal,9998,0,9999,1
1746567072552,CLRE 260,A00,891872,Cuomo; Raphael Eduardo,9999,0,9999,0
1746567073579,CLRE 297,001,891888,Cuomo; Raphael Eduardo,9999,0,9999,0
1746567074608,CSE 191,A00,958773,Minnes Kemp; Mor Mia,9995,0,9999,4
1746567075636,CSE 197,001,959846,Minnes Kemp; Mor Mia,9990,0,9999,9
1746567076663,CSS 201S,A01,892054,Mignozzetti; Umberto,25,0,30,5
1746567077723,CSS 202S,A01,892056,Mignozzetti; Umberto,25,0,30,5
1746567078752,DSC 197,001,956898,Eldridge; Justin Matthew,9996,0,9999,3
1746567079780,DSC 297,001,958000,Mazumdar; Arya,9998,0,9999,1
1746567079780,DSC 297,002,959862,Wang; Yusu,9998,0,9999,1
1746567080806,EAP 100,A00,905686,Staff,9778,0,9999,221
1746567081834,ECE 45,A01,892618,Staff,0,0,65,65
1746567083899,ECE 111,A01,892719,Staff,4,0,65,61
1746567084930,ECE 197,001,957920,Mercier; Patrick Philip,9991,0,9999,8
1746567085964,ECON 178,A01,907814,Zhu; Ying,26,0,35,9
1746567086989,EDS 115,A00,895312,Staff,35,0,45,10
1746567088017,EDS 117,A01,895337,Staff,23,0,30,7
1746567089046,EDS 125,A00,895341,Jones; Gabrielle Anastasia,36,0,45,9
1746567090079,EDS 128A,A01,895459,Fargason; Sharon Gayle,44,0,45,1
1746567091106,EDS 128B,A01,895543,Pappas; Elizabeth,44,0,45,1
1746567092131,EDS 139,A00,897203,Pappas; Elizabeth,44,0,45,1
1746567092131,EDS 139,B00,897209,Fargason; Sharon Gayle,41,0,45,4
1746567093158,EDS 201,A00,895545,Staff,22,0,45,23
1746567094187,EDS 203,A01,895581,Halter; Christopher P.,22,0,45,23
1746567095217,EDS 204R,A01,895625,Heinzman; Erica M.,39,0,45,6
1746567095217,EDS 204R,B01,895693,Halter; Christopher P.,10,0,45,35
1746567096270,EDS 206R,A00,895694,Fargason; Sharon Gayle,1,0,30,29
1746567096270,EDS 206R,B00,895695,Choi; Bailey Miyeon,16,0,30,14
1746567097294,EDS 250,A00,895697,Hemans; Patricia Ann Benitez,22,0,45,23
1746567098320,EDS 281,A00,895701,Meyerott; Theresa Ann,1,0,15,14
1746567099345,EDS 284,A00,895736,Meyerott; Theresa Ann,1,0,15,14
1746567100370,EDS 286,A00,897210,Fine; Sarah,0,0,15,15
1746567101396,EDS 289C,A01,895770,Daly; Alan J.,1,0,15,14
1746567102430,EDS 290,A00,897211,Hofstetter; Carolyn,0,0,15,15
1746567103455,LIGM 5A,A00,896162,Fischer-Grunski; Eva K,12,0,20,8
1746567104480,LIGM 5B,A00,896260,Fischer-Grunski; Eva K,17,0,20,3
1746567105503,LIGM 5C,A00,896308,Fischer-Grunski; Eva K,18,0,20,2
1746567106530,LIIT 5AS,A00,896313,Carnelos; Chiara,18,0,20,2
1746567107556,LIIT 5BS,A00,896416,Carnelos; Chiara,20,0,20,0
1746567108588,LIIT 5CS,A00,896564,Carnelos; Chiara,20,0,20,0
1746567109619,LISP 5A,A00,896588,Munoz Sanchez; Alicia,3,0,20,17
1746567110647,LISP 5B,A00,896653,Munoz Sanchez; Alicia,7,0,20,13
1746567111675,LISP 5C,A00,896655,Munoz Sanchez; Alicia,0,1,20,20
1746567112700,MAE 197,001,957918,Kleissl; Jan,9996,0,9999,3
1746567112700,MAE 197,002,959806,Boechler; Nicholas Sebastia,9998,0,9999,1
1746567112700,MAE 197,003,959852,Mullin; Jennifer S,9998,0,9999,1
1746567113730,MATH 2,A01,957937,Staff,33,0,35,2
1746567114757,MATH 197,001,957876,Kedlaya; Kiran S.,9993,0,9999,6
1746567115783,MCWP 40,A00,892729,Duru; Nur,10,0,20,10
1746567115783,MCWP 40,B00,893304,Montejo; Carolina,14,0,20,6
1746567116810,MCWP 40R,A00,893757,Redela; Pamela Morgan,0,5,20,20
1746567117836,MCWP 50,A00,893758,Morshed; Michael James,0,0,20,20
1746567117836,MCWP 50,B00,893761,Bartulis; Jason Michael,17,0,20,3
1746567118867,MCWP 50R,A00,893766,Compas; Sean Matthew,0,1,20,20
1746567118867,MCWP 50R,B00,893769,Carter; Jennifer A,0,1,20,20
1746567118867,MCWP 50R,C00,893771,Krone; Jarret,0,3,20,20
1746567118867,MCWP 50R,D00,893772,Miller; Elizabeth Deen,0,0,20,20
1746567118867,MCWP 50R,E00,893775,Carter; Andrea L,0,1,20,20
1746567119894,MMW 11R,A01,892721,Herbst; Matthew,11,0,27,16
1746567119894,MMW 11R,A02,892722,Herbst; Matthew,0,0,0,3
1746567120924,MMW 12R,A01,892724,Herbst; Matthew,0,11,16,16
1746567120924,MMW 12R,A02,892725,Herbst; Matthew,0,10,16,16
1746567121951,MMW 13R,A01,892727,Staff,0,4,16,16
1746567121951,MMW 13R,A02,892728,Staff,0,4,16,16
1746567121951,MMW 13R,A03,958032,Staff,0,4,16,16
1746567121951,MMW 13R,A04,958033,Staff,0,4,16,16
1746567121951,MMW 13R,A05,958034,Staff,0,4,16,16
1746567122978,SIO 295LS,A00,894015,Staff,5,0,25,20
1746567124004,SIO 295S,A00,894020,Staff,5,0,25,20
1746567125035,SIOC 290S,B01,958918,Merrifield; Mark A,14,0,30,16
1746567126061,SIOC 291S,B01,958922,Gabriel; Corey John,14,0,30,16
1746567127090,SOCI 117,A01,895339,Staff,3,0,5,2
1746567128118,WES 237B,A00,894149,Staff,11,0,20,9
1746567130182,AESE 279B,A00,891859,Staff,13,0,35,22
1746567131218,AIP 197,001,891854,Vespa; Emanuel Ignacio,9999,0,9999,0
1746567132256,ANTH 289S,A00,891856,Gagneux; Pascal,12,0,12,0
1746567133282,BENG 196,001,957946,Engler; Adam J.,9996,0,9999,3
1746567134311,BISP 197,001,959851,Wilhelm; James E.,9998,0,9999,1
1746567135340,CAT 124RS,A01,956906,Staff,6,0,25,19
1746567136367,CAT 125RS,A01,922013,Staff,6,0,25,19
1746567137392,CLRE 250,A00,891860,Morris; Sheldon,9995,0,9999,4
1746567139446,CLRE 251R,A00,907817,Mehta; Ravindra L.,9994,0,9999,5
1746567140472,CLRE 252,A00,891864,Cuomo; Raphael Eduardo,9993,0,9999,6
1746567141498,CLRE 253,A00,891867,Vaida; Florin,9994,0,9999,5
1746567141498,CLRE 253,B00,907819,Staff,9999,0,9999,0
1746567142525,CLRE 259,A00,891868,Patel; Hemal,9998,0,9999,1
1746567143553,CLRE 260,A00,891872,Cuomo; Raphael Eduardo,9999,0,9999,0
1746567144580,CLRE 297,001,891888,Cuomo; Raphael Eduardo,9999,0,9999,0
1746567145606,CSE 191,A00,958773,Minnes Kemp; Mor Mia,9995,0,9999,4
1746567146632,CSE 197,001,959846,Minnes Kemp; Mor Mia,9990,0,9999,9
1746567147659,CSS 201S,A01,892054,Mignozzetti; Umberto,25,0,30,5
1746567148690,CSS 202S,A01,892056,Mignozzetti; Umberto,25,0,30,5
1746567149717,DSC 197,001,956898,Eldridge; Justin Matthew,9996,0,9999,3
1746567150746,DSC 297,001,958000,Mazumdar; Arya,9998,0,9999,1
1746567150746,DSC 297,002,959862,Wang; Yusu,9998,0,9999,1
1746567151774,EAP 100,A00,905686,Staff,9778,0,9999,221
1746567152806,ECE 45,A01,892618,Staff,0,0,65,65
1746567154865,ECE 111,A01,892719,Staff,4,0,65,61
1746567155894,ECE 197,001,957920,Mercier; Patrick Philip,9991,0,9999,8
1746567156920,ECON 178,A01,907814,Zhu; Ying,26,0,35,9
1746567157946,EDS 115,A00,895312,Staff,35,0,45,10
1746567158973,EDS 117,A01,895337,Staff,23,0,30,7
1746567160004,EDS 125,A00,895341,Jones; Gabrielle Anastasia,36,0,45,9
1746567161033,EDS 128A,A01,895459,Fargason; Sharon Gayle,44,0,45,1
1746567162062,EDS 128B,A01,895543,Pappas; Elizabeth,44,0,45,1
1746567163089,EDS 139,A00,897203,Pappas; Elizabeth,44,0,45,1
1746567163089,EDS 139,B00,897209,Fargason; Sharon Gayle,41,0,45,4
1746567164115,EDS 201,A00,895545,Staff,22,0,45,23
1746567165144,EDS 203,A01,895581,Halter; Christopher P.,22,0,45,23
1746567166173,EDS 204R,A01,895625,Heinzman; Erica M.,39,0,45,6
1746567166173,EDS 204R,B01,895693,Halter; Christopher P.,10,0,45,35
1746567167198,EDS 206R,A00,895694,Fargason; Sharon Gayle,1,0,30,29
1746567167198,EDS 206R,B00,895695,Choi; Bailey Miyeon,16,0,30,14
1746567168226,EDS 250,A00,895697,Hemans; Patricia Ann Benitez,22,0,45,23
1746567169252,EDS 281,A00,895701,Meyerott; Theresa Ann,1,0,15,14
1746567170281,EDS 284,A00,895736,Meyerott; Theresa Ann,1,0,15,14
1746567171310,EDS 286,A00,897210,Fine; Sarah,0,0,15,15
1746567172336,EDS 289C,A01,895770,Daly; Alan J.,1,0,15,14
1746567173362,EDS 290,A00,897211,Hofstetter; Carolyn,0,0,15,15
1746567174393,LIGM 5A,A00,896162,Fischer-Grunski; Eva K,12,0,20,8
1746567175422,LIGM 5B,A00,896260,Fischer-Grunski; Eva K,17,0,20,3
1746567176449,LIGM 5C,A00,896308,Fischer-Grunski; Eva K,18,0,20,2
1746567177478,LIIT 5AS,A00,896313,Carnelos; Chiara,18,0,20,2
1746567178508,LIIT 5BS,A00,896416,Carnelos; Chiara,20,0,20,0
1746567179542,LIIT 5CS,A00,896564,Carnelos; Chiara,20,0,20,0
1746567180571,LISP 5A,A00,896588,Munoz Sanchez; Alicia,3,0,20,17
1746567181597,LISP 5B,A00,896653,Munoz Sanchez; Alicia,7,0,20,13
1746567182627,LISP 5C,A00,896655,Munoz Sanchez; Alicia,0,1,20,20
1746567183654,MAE 197,001,957918,Kleissl; Jan,9996,0,9999,3
1746567183654,MAE 197,002,959806,Boechler; Nicholas Sebastia,9998,0,9999,1
1746567183654,MAE 197,003,959852,Mullin; Jennifer S,9998,0,9999,1
1746567184680,MATH 2,A01,957937,Staff,33,0,35,2
1746567185706,MATH 197,001,957876,Kedlaya; Kiran S.,9993,0,9999,6
1746567186736,MCWP 40,A00,892729,Duru; Nur,10,0,20,10
1746567186736,MCWP 40,B00,893304,Montejo; Carolina,14,0,20,6
1746567187762,MCWP 40R,A00,893757,Redela; Pamela Morgan,0,5,20,20
1746567188791,MCWP 50,A00,893758,Morshed; Michael James,0,0,20,20
1746567188791,MCWP 50,B00,893761,Bartulis; Jason Michael,17,0,20,3
1746567189818,MCWP 50R,A00,893766,Compas; Sean Matthew,0,1,20,20
1746567189818,MCWP 50R,B00,893769,Carter; Jennifer A,0,1,20,20
1746567189818,MCWP 50R,C00,893771,Krone; Jarret,0,3,20,20
1746567189818,MCWP 50R,D00,893772,Miller; Elizabeth Deen,0,0,20,20
1746567189818,MCWP 50R,E00,893775,Carter; Andrea L,0,1,20,20
1746567190846,MMW 11R,A01,892721,Herbst; Matthew,11,0,27,16
1746567190846,MMW 11R,A02,892722,Herbst; Matthew,0,0,0,3
1746567191875,MMW 12R,A01,892724,Herbst; Matthew,0,11,16,16
1746567191875,MMW 12R,A02,892725,Herbst; Matthew,0,10,16,16
1746567192904,MMW 13R,A01,892727,Staff,0,4,16,16
1746567192904,MMW 13R,A02,892728,Staff,0,4,16,16
1746567192904,MMW 13R,A03,958032,Staff,0,4,16,16
1746567192904,MMW 13R,A04,958033,Staff,0,4,16,16
1746567192904,MMW 13R,A05,958034,Staff,0,4,16,16
1746567193929,SIO 295LS,A00,894015,Staff,5,0,25,20
1746567194957,SIO 295S,A00,894020,Staff,5,0,25,20
1746567195983,SIOC 290S,B01,958918,Merrifield; Mark A,14,0,30,16
1746567197010,SIOC 291S,B01,958922,Gabriel; Corey John,14,0,30,16
1746567198034,SOCI 117,A01,895339,Staff,3,0,5,2
1746567199059,WES 237B,A00,894149,Staff,11,0,20,9
1746567201125,AESE 279B,A00,891859,Staff,13,0,35,22
1746567202151,AIP 197,001,891854,Vespa; Emanuel Ignacio,9999,0,9999,0
1746567203180,ANTH 289S,A00,891856,Gagneux; Pascal,12,0,12,0
1746567204205,BENG 196,001,957946,Engler; Adam J.,9996,0,9999,3
1746567205231,BISP 197,001,959851,Wilhelm; James E.,9998,0,9999,1
1746567206260,CAT 124RS,A01,956906,Staff,6,0,25,19
1746567207290,CAT 125RS,A01,922013,Staff,6,0,25,19
1746567208315,CLRE 250,A00,891860,Morris; Sheldon,9995,0,9999,4
1746567210378,CLRE 251R,A00,907817,Mehta; Ravindra L.,9994,0,9999,5
1746567211403,CLRE 252,A00,891864,Cuomo; Raphael Eduardo,9993,0,9999,6
1746567212430,CLRE 253,A00,891867,Vaida; Florin,9994,0,9999,5
1746567212430,CLRE 253,B00,907819,Staff,9999,0,9999,0
1746567213456,CLRE 259,A00,891868,Patel; Hemal,9998,0,9999,1
1746567214485,CLRE 260,A00,891872,Cuomo; Raphael Eduardo,9999,0,9999,0
1746567215514,CLRE 297,001,891888,Cuomo; Raphael Eduardo,9999,0,9999,0
1746567216541,CSE 191,A00,958773,Minnes Kemp; Mor Mia,9995,0,9999,4
1746567217568,CSE 197,001,959846,Minnes Kemp; Mor Mia,9990,0,9999,9
1746567218595,CSS 201S,A01,892054,Mignozzetti; Umberto,25,0,30,5
1746567219625,CSS 202S,A01,892056,Mignozzetti; Umberto,25,0,30,5
1746567220653,DSC 197,001,956898,Eldridge; Justin Matthew,9996,0,9999,3
1746567221681,DSC 297,001,958000,Mazumdar; Arya,9998,0,9999,1
1746567221681,DSC 297,002,959862,Wang; Yusu,9998,0,9999,1
1746567222713,EAP 100,A00,905686,Staff,9778,0,9999,221
1746567223739,ECE 45,A01,892618,Staff,0,0,65,65
1746567225791,ECE 111,A01,892719,Staff,4,0,65,61
1746567226820,ECE 197,001,957920,Mercier; Patrick Philip,9991,0,9999,8
1746567227847,ECON 178,A01,907814,Zhu; Ying,26,0,35,9
1746567228872,EDS 115,A00,895312,Staff,35,0,45,10
1746567229898,EDS 117,A01,895337,Staff,23,0,30,7
1746567230924,EDS 125,A00,895341,Jones; Gabrielle Anastasia,36,0,45,9
1746567231955,EDS 128A,A01,895459,Fargason; Sharon Gayle,44,0,45,1
1746567232981,EDS 128B,A01,895543,Pappas; Elizabeth,44,0,45,1
1746567234006,EDS 139,A00,897203,Pappas; Elizabeth,44,0,45,1
1746567234006,EDS 139,B00,897209,Fargason; Sharon Gayle,41,0,45,4
1746567235032,EDS 201,A00,895545,Staff,22,0,45,23
1746567236059,EDS 203,A01,895581,Halter; Christopher P.,22,0,45,23
1746567237085,EDS 204R,A01,895625,Heinzman; Erica M.,39,0,45,6
1746567237085,EDS 204R,B01,895693,Halter; Christopher P.,10,0,45,35
1746567238159,EDS 206R,A00,895694,Fargason; Sharon Gayle,1,0,30,29
1746567238159,EDS 206R,B00,895695,Choi; Bailey Miyeon,16,0,30,14
1746567239188,EDS 250,A00,895697,Hemans; Patricia Ann Benitez,22,0,45,23
1746567240215,EDS 281,A00,895701,Meyerott; Theresa Ann,1,0,15,14
1746567241238,EDS 284,A00,895736,Meyerott; Theresa Ann,1,0,15,14
1746567242270,EDS 286,A00,897210,Fine; Sarah,0,0,15,15
1746567243299,EDS 289C,A01,895770,Daly; Alan J.,1,0,15,14
1746567244321,EDS 290,A00,897211,Hofstetter; Carolyn,0,0,15,15
1746567245347,LIGM 5A,A00,896162,Fischer-Grunski; Eva K,12,0,20,8
1746567246374,LIGM 5B,A00,896260,Fischer-Grunski; Eva K,17,0,20,3
1746567247401,LIGM 5C,A00,896308,Fischer-Grunski; Eva K,18,0,20,2
1746567248428,LIIT 5AS,A00,896313,Carnelos; Chiara,18,0,20,2
1746567249454,LIIT 5BS,A00,896416,Carnelos; Chiara,20,0,20,0
1746567250483,LIIT 5CS,A00,896564,Carnelos; Chiara,20,0,20,0
1746567251511,LISP 5A,A00,896588,Munoz Sanchez; Alicia,3,0,20,17
1746567252536,LISP 5B,A00,896653,Munoz Sanchez; Alicia,7,0,20,13
1746567253565,LISP 5C,A00,896655,Munoz Sanchez; Alicia,0,1,20,20
1746567254596,MAE 197,001,957918,Kleissl; Jan,9996,0,9999,3
1746567254596,MAE 197,002,959806,Boechler; Nicholas Sebastia,9998,0,9999,1
1746567254596,MAE 197,003,959852,Mullin; Jennifer S,9998,0,9999,1
1746567255625,MATH 2,A01,957937,Staff,33,0,35,2
1746567256652,MATH 197,001,957876,Kedlaya; Kiran S.,9993,0,9999,6
1746567257679,MCWP 40,A00,892729,Duru; Nur,10,0,20,10
1746567257679,MCWP 40,B00,893304,Montejo; Carolina,14,0,20,6
1746567258706,MCWP 40R,A00,893757,Redela; Pamela Morgan,0,5,20,20
1746567259735,MCWP 50,A00,893758,Morshed; Michael James,0,0,20,20
1746567259735,MCWP 50,B00,893761,Bartulis; Jason Michael,17,0,20,3
1746567260761,MCWP 50R,A00,893766,Compas; Sean Matthew,0,1,20,20
1746567260761,MCWP 50R,B00,893769,Carter; Jennifer A,0,1,20,20
1746567260761,MCWP 50R,C00,893771,Krone; Jarret,0,3,20,20
1746567260761,MCWP 50R,D00,893772,Miller; Elizabeth Deen,0,0,20,20
1746567260761,MCWP 50R,E00,893775,Carter; Andrea L,0,1,20,20
1746567261786,MMW 11R,A01,892721,Herbst; Matthew,11,0,27,16
1746567261786,MMW 11R,A02,892722,Herbst; Matthew,0,0,0,3
1746567262812,MMW 12R,A01,892724,Herbst; Matthew,0,11,16,16
1746567262812,MMW 12R,A02,892725,Herbst; Matthew,0,10,16,16
1746567263838,MMW 13R,A01,892727,Staff,0,4,16,16
1746567263838,MMW 13R,A02,892728,Staff,0,4,16,16
1746567263838,MMW 13R,A03,958032,Staff,0,4,16,16
1746567263838,MMW 13R,A04,958033,Staff,0,4,16,16
1746567263838,MMW 13R,A05,958034,Staff,0,4,16,16
1746567264870,SIO 295LS,A00,894015,Staff,5,0,25,20
1746567265897,SIO 295S,A00,894020,Staff,5,0,25,20
1746567266929,SIOC 290S,B01,958918,Merrifield; Mark A,14,0,30,16
1746567267955,SIOC 291S,B01,958922,Gabriel; Corey John,14,0,30,16
1746567268983,SOCI 117,A01,895339,Staff,3,0,5,2
1746567270016,WES 237B,A00,894149,Staff,11,0,20,9
1746567272074,AESE 279B,A00,891859,Staff,13,0,35,22
1746567273099,AIP 197,001,891854,Vespa; Emanuel Ignacio,9999,0,9999,0
1746567274128,ANTH 289S,A00,891856,Gagneux; Pascal,12,0,12,0
1746567275158,BENG 196,001,957946,Engler; Adam J.,9996,0,9999,3
1746567276183,BISP 197,001,959851,Wilhelm; James E.,9998,0,9999,1
1746567277210,CAT 124RS,A01,956906,Staff,6,0,25,19
1746567278235,CAT 125RS,A01,922013,Staff,6,0,25,19
1746567279327,CLRE 250,A00,891860,Morris; Sheldon,9995,0,9999,4
1746567281380,CLRE 251R,A00,907817,Mehta; Ravindra L.,9994,0,9999,5
1746567282414,CLRE 252,A00,891864,Cuomo; Raphael Eduardo,9993,0,9999,6
1746567283441,CLRE 253,A00,891867,Vaida; Florin,9994,0,9999,5
1746567283441,CLRE 253,B00,907819,Staff,9999,0,9999,0
1746567284464,CLRE 259,A00,891868,Patel; Hemal,9998,0,9999,1
1746567285491,CLRE 260,A00,891872,Cuomo; Raphael Eduardo,9999,0,9999,0
1746567286516,CLRE 297,001,891888,Cuomo; Raphael Eduardo,9999,0,9999,0
1746567287545,CSE 191,A00,958773,Minnes Kemp; Mor Mia,9995,0,9999,4
1746567288570,CSE 197,001,959846,Minnes Kemp; Mor Mia,9990,0,9999,9
1746567289596,CSS 201S,A01,892054,Mignozzetti; Umberto,25,0,30,5
1746567290625,CSS 202S,A01,892056,Mignozzetti; Umberto,25,0,30,5
1746567291653,DSC 197,001,956898,Eldridge; Justin Matthew,9996,0,9999,3
1746567292680,DSC 297,001,958000,Mazumdar; Arya,9998,0,9999,1
1746567292680,DSC 297,002,959862,Wang; Yusu,9998,0,9999,1
1746567293707,EAP 100,A00,905686,Staff,9778,0,9999,221
1746567294732,ECE 45,A01,892618,Staff,0,0,65,65
1746567296787,ECE 111,A01,892719,Staff,4,0,65,61
1746567297815,ECE 197,001,957920,Mercier; Patrick Philip,9991,0,9999,8
1746567298840,ECON 178,A01,907814,Zhu; Ying,26,0,35,9
1746567299864,EDS 115,A00,895312,Staff,35,0,45,10
1746567300888,EDS 117,A01,895337,Staff,23,0,30,7
1746567301915,EDS 125,A00,895341,Jones; Gabrielle Anastasia,36,0,45,9
1746567302944,EDS 128A,A01,895459,Fargason; Sharon Gayle,44,0,45,1
1746567303970,EDS 128B,A01,895543,Pappas; Elizabeth,44,0,45,1
1746567304997,EDS 139,A00,897203,Pappas; Elizabeth,44,0,45,1
1746567304997,EDS 139,B00,897209,Fargason; Sharon Gayle,41,0,45,4
1746567306022,EDS 201,A00,895545,Staff,22,0,45,23
1746567307048,EDS 203,A01,895581,Halter; Christopher P.,22,0,45,23
1746567308073,EDS 204R,A01,895625,Heinzman; Erica M.,39,0,45,6
1746567308073,EDS 204R,B01,895693,Halter; Christopher P.,10,0,45,35
1746567309099,EDS 206R,A00,895694,Fargason; Sharon Gayle,1,0,30,29
1746567309099,EDS 206R,B00,895695,Choi; Bailey Miyeon,16,0,30,14
1746567310123,EDS 250,A00,895697,Hemans; Patricia Ann Benitez,22,0,45,23
1746567311149,EDS 281,A00,895701,Meyerott; Theresa Ann,1,0,15,14
1746567312176,EDS 284,A00,895736,Meyerott; Theresa Ann,1,0,15,14
1746567313206,EDS 286,A00,897210,Fine; Sarah,0,0,15,15
1746567314233,EDS 289C,A01,895770,Daly; Alan J.,1,0,15,14
1746567315258,EDS 290,A00,897211,Hofstetter; Carolyn,0,0,15,15
1746567316282,LIGM 5A,A00,896162,Fischer-Grunski; Eva K,12,0,20,8
1746567317306,LIGM 5B,A00,896260,Fischer-Grunski; Eva K,17,0,20,3
1746567318332,LIGM 5C,A00,896308,Fischer-Grunski; Eva K,18,0,20,2
1746567319356,LIIT 5AS,A00,896313,Carnelos; Chiara,18,0,20,2
1746567320386,LIIT 5BS,A00,896416,Carnelos; Chiara,20,0,20,0
1746567321412,LIIT 5CS,A00,896564,Carnelos; Chiara,20,0,20,0
1746567322443,LISP 5A,A00,896588,Munoz Sanchez; Alicia,3,0,20,17
1746567323469,LISP 5B,A00,896653,Munoz Sanchez; Alicia,7,0,20,13
1746567324495,LISP 5C,A00,896655,Munoz Sanchez; Alicia,0,1,20,20
1746567325529,MAE 197,001,957918,Kleissl; Jan,9996,0,9999,3
1746567325529,MAE 197,002,959806,Boechler; Nicholas Sebastia,9998,0,9999,1
1746567325529,MAE 197,003,959852,Mullin; Jennifer S,9998,0,9999,1
1746567326559,MATH 2,A01,957937,Staff,33,0,35,2
1746567327587,MATH 197,001,957876,Kedlaya; Kiran S.,9993,0,9999,6
1746567328618,MCWP 40,A00,892729,Duru; Nur,10,0,20,10
1746567328618,MCWP 40,B00,893304,Montejo; Carolina,14,0,20,6
1746567329646,MCWP 40R,A00,893757,Redela; Pamela Morgan,0,5,20,20
1746567330671,MCWP 50,A00,893758,Morshed; Michael James,0,0,20,20
1746567330671,MCWP 50,B00,893761,Bartulis; Jason Michael,17,0,20,3
1746567331698,MCWP 50R,A00,893766,Compas; Sean Matthew,0,1,20,20
1746567331698,MCWP 50R,B00,893769,Carter; Jennifer A,0,1,20,20
1746567331698,MCWP 50R,C00,893771,Krone; Jarret,0,3,20,20
1746567331698,MCWP 50R,D00,893772,Miller; Elizabeth Deen,0,0,20,20
1746567331698,MCWP 50R,E00,893775,Carter; Andrea L,0,1,20,20
1746567332726,MMW 11R,A01,892721,Herbst; Matthew,11,0,27,16
1746567332726,MMW 11R,A02,892722,Herbst; Matthew,0,0,0,3
1746567333753,MMW 12R,A01,892724,Herbst; Matthew,0,11,16,16
1746567333753,MMW 12R,A02,892725,Herbst; Matthew,0,10,16,16
1746567334784,MMW 13R,A01,892727,Staff,0,4,16,16
1746567334784,MMW 13R,A02,892728,Staff,0,4,16,16
1746567334784,MMW 13R,A03,958032,Staff,0,4,16,16
1746567334784,MMW 13R,A04,958033,Staff,0,4,16,16
1746567334784,MMW 13R,A05,958034,Staff,0,4,16,16
1746567335814,SIO 295LS,A00,894015,Staff,5,0,25,20
1746567336842,SIO 295S,A00,894020,Staff,5,0,25,20
1746567337870,SIOC 290S,B01,958918,Merrifield; Mark A,14,0,30,16
1746567338898,SIOC 291S,B01,958922,Gabriel; Corey John,14,0,30,16
1746567339927,SOCI 117,A01,895339,Staff,3,0,5,2
1746567340955,WES 237B,A00,894149,Staff,11,0,20,9
1746567343020,AESE 279B,A00,891859,Staff,13,0,35,22
1746567344045,AIP 197,001,891854,Vespa; Emanuel Ignacio,9999,0,9999,0
1746567345070,ANTH 289S,A00,891856,Gagneux; Pascal,12,0,12,0
1746567346097,BENG 196,001,957946,Engler; Adam J.,9996,0,9999,3
1746567347122,BISP 197,001,959851,Wilhelm; James E.,9998,0,9999,1
1746567348147,CAT 124RS,A01,956906,Staff,6,0,25,19
1746567349174,CAT 125RS,A01,922013,Staff,6,0,25,19
1746567350204,CLRE 250,A00,891860,Morris; Sheldon,9995,0,9999,4
1746567352259,CLRE 251R,A00,907817,Mehta; Ravindra L.,9994,0,9999,5
1746567353285,CLRE 252,A00,891864,Cuomo; Raphael Eduardo,9993,0,9999,6
1746567354315,CLRE 253,A00,891867,Vaida; Florin,9994,0,9999,5
1746567354315,CLRE 253,B00,907819,Staff,9999,0,9999,0
1746567355344,CLRE 259,A00,891868,Patel; Hemal,9998,0,9999,1
1746567356373,CLRE 260,A00,891872,Cuomo; Raphael Eduardo,9999,0,9999,0
1746567357399,CLRE 297,001,891888,Cuomo; Raphael Eduardo,9999,0,9999,0
1746567358426,CSE 191,A00,958773,Minnes Kemp; Mor Mia,9995,0,9999,4
1746567359482,CSE 197,001,959846,Minnes Kemp; Mor Mia,9990,0,9999,9
1746567360512,CSS 201S,A01,892054,Mignozzetti; Umberto,25,0,30,5
1746567361541,CSS 202S,A01,892056,Mignozzetti; Umberto,25,0,30,5
1746567362571,DSC 197,001,956898,Eldridge; Justin Matthew,9996,0,9999,3
1746567363597,DSC 297,001,958000,Mazumdar; Arya,9998,0,9999,1
1746567363597,DSC 297,002,959862,Wang; Yusu,9998,0,9999,1
1746567364624,EAP 100,A00,905686,Staff,9778,0,9999,221
1746567365648,ECE 45,A01,892618,Staff,0,0,65,65
1746567367706,ECE 111,A01,892719,Staff,4,0,65,61
1746567368735,ECE 197,001,957920,Mercier; Patrick Philip,9991,0,9999,8
1746567369766,ECON 178,A01,907814,Zhu; Ying,26,0,35,9
1746567370791,EDS 115,A00,895312,Staff,35,0,45,10
1746567371817,EDS 117,A01,895337,Staff,23,0,30,7
1746567372847,EDS 125,A00,895341,Jones; Gabrielle Anastasia,36,0,45,9
1746567373872,EDS 128A,A01,895459,Fargason; Sharon Gayle,44,0,45,1
1746567374897,EDS 128B,A01,895543,Pappas; Elizabeth,44,0,45,1
1746567375921,EDS 139,A00,897203,Pappas; Elizabeth,44,0,45,1
1746567375921,EDS 139,B00,897209,Fargason; Sharon Gayle,41,0,45,4
1746567376947,EDS 201,A00,895545,Staff,22,0,45,23
1746567377975,EDS 203,A01,895581,Halter; Christopher P.,22,0,45,23
1746567379002,EDS 204R,A01,895625,Heinzman; Erica M.,39,0,45,6
1746567379002,EDS 204R,B01,895693,Halter; Christopher P.,10,0,45,35
1746567380030,EDS 206R,A00,895694,Fargason; Sharon Gayle,1,0,30,29
1746567380030,EDS 206R,B00,895695,Choi; Bailey Miyeon,16,0,30,14
1746567381060,EDS 250,A00,895697,Hemans; Patricia Ann Benitez,22,0,45,23
1746567382085,EDS 281,A00,895701,Meyerott; Theresa Ann,1,0,15,14
1746567383110,EDS 284,A00,895736,Meyerott; Theresa Ann,1,0,15,14
1746567384141,EDS 286,A00,897210,Fine; Sarah,0,0,15,15
1746567385168,EDS 289C,A01,895770,Daly; Alan J.,1,0,15,14
1746567386192,EDS 290,A00,897211,Hofstetter; Carolyn,0,0,15,15
1746567387221,LIGM 5A,A00,896162,Fischer-Grunski; Eva K,12,0,20,8
1746567388251,LIGM 5B,A00,896260,Fischer-Grunski; Eva K,17,0,20,3
1746567389277,LIGM 5C,A00,896308,Fischer-Grunski; Eva K,18,0,20,2
1746567390301,LIIT 5AS,A00,896313,Carnelos; Chiara,18,0,20,2
1746567391326,LIIT 5BS,A00,896416,Carnelos; Chiara,20,0,20,0
1746567392353,LIIT 5CS,A00,896564,Carnelos; Chiara,20,0,20,0
1746567393381,LISP 5A,A00,896588,Munoz Sanchez; Alicia,3,0,20,17
1746567394412,LISP 5B,A00,896653,Munoz Sanchez; Alicia,7,0,20,13
1746567395437,LISP 5C,A00,896655,Munoz Sanchez; Alicia,0,1,20,20
1746567396464,MAE 197,001,957918,Kleissl; Jan,9996,0,9999,3
1746567396464,MAE 197,002,959806,Boechler; Nicholas Sebastia,9998,0,9999,1
1746567396464,MAE 197,003,959852,Mullin; Jennifer S,9998,0,9999,1
1746567397495,MATH 2,A01,957937,Staff,33,0,35,2
1746567398725,MATH 197,001,957876,Kedlaya; Kiran S.,9993,0,9999,6
1746567399753,MCWP 40,A00,892729,Duru; Nur,10,0,20,10
1746567399753,MCWP 40,B00,893304,Montejo; Carolina,14,0,20,6
1746567400783,MCWP 40R,A00,893757,Redela; Pamela Morgan,0,5,20,20
1746567401809,MCWP 50,A00,893758,Morshed; Michael James,0,0,20,20
1746567401809,MCWP 50,B00,893761,Bartulis; Jason Michael,17,0,20,3
1746567402836,MCWP 50R,A00,893766,Compas; Sean Matthew,0,1,20,20
1746567402836,MCWP 50R,B00,893769,Carter; Jennifer A,0,1,20,20
1746567402836,MCWP 50R,C00,893771,Krone; Jarret,0,3,20,20
1746567402836,MCWP 50R,D00,893772,Miller; Elizabeth Deen,0,0,20,20
1746567402836,MCWP 50R,E00,893775,Carter; Andrea L,0,1,20,20
1746567403861,MMW 11R,A01,892721,Herbst; Matthew,11,0,27,16
1746567403861,MMW 11R,A02,892722,Herbst; Matthew,0,0,0,3
1746567404888,MMW 12R,A01,892724,Herbst; Matthew,0,11,16,16
1746567404888,MMW 12R,A02,892725,Herbst; Matthew,0,10,16,16
1746567405914,MMW 13R,A01,892727,Staff,0,4,16,16
1746567405914,MMW 13R,A02,892728,Staff,0,4,16,16
1746567405914,MMW 13R,A03,958032,Staff,0,4,16,16
1746567405914,MMW 13R,A04,958033,Staff,0,4,16,16
1746567405914,MMW 13R,A05,958034,Staff,0,4,16,16
1746567406942,SIO 295LS,A00,894015,Staff,5,0,25,20
1746567407968,SIO 295S,A00,894020,Staff,5,0,25,20
1746567408994,SIOC 290S,B01,958918,Merrifield; Mark A,14,0,30,16
1746567410023,SIOC 291S,B01,958922,Gabriel; Corey John,14,0,30,16
1746567411049,SOCI 117,A01,895339,Staff,3,0,5,2
1746567412076,WES 237B,A00,894149,Staff,11,0,20,9
1746567414139,AESE 279B,A00,891859,Staff,13,0,35,22
1746567415164,AIP 197,001,891854,Vespa; Emanuel Ignacio,9999,0,9999,0
1746567416190,ANTH 289S,A00,891856,Gagneux; Pascal,12,0,12,0
1746567417217,BENG 196,001,957946,Engler; Adam J.,9996,0,9999,3
1746567418244,BISP 197,001,959851,Wilhelm; James E.,9998,0,9999,1
1746567419270,CAT 124RS,A01,956906,Staff,6,0,25,19
1746567420296,CAT 125RS,A01,922013,Staff,6,0,25,19
1746567421322,CLRE 250,A00,891860,Morris; Sheldon,9995,0,9999,4
1746567423380,CLRE 251R,A00,907817,Mehta; Ravindra L.,9994,0,9999,5
1746567424404,CLRE 252,A00,891864,Cuomo; Raphael Eduardo,9993,0,9999,6
1746567425429,CLRE 253,A00,891867,Vaida; Florin,9994,0,9999,5
1746567425429,CLRE 253,B00,907819,Staff,9999,0,9999,0
1746567426453,CLRE 259,A00,891868,Patel; Hemal,9998,0,9999,1
1746567427478,CLRE 260,A00,891872,Cuomo; Raphael Eduardo,9999,0,9999,0
1746567428505,CLRE 297,001,891888,Cuomo; Raphael Eduardo,9999,0,9999,0
1746567429535,CSE 191,A00,958773,Minnes Kemp; Mor Mia,9995,0,9999,4
1746567430562,CSE 197,001,959846,Minnes Kemp; Mor Mia,9990,0,9999,9
1746567431587,CSS 201S,A01,892054,Mignozzetti; Umberto,25,0,30,5
1746567432617,CSS 202S,A01,892056,Mignozzetti; Umberto,25,0,30,5
1746567433645,DSC 197,001,956898,Eldridge; Justin Matthew,9996,0,9999,3
1746567434669,DSC 297,001,958000,Mazumdar; Arya,9998,0,9999,1
1746567434669,DSC 297,002,959862,Wang; Yusu,9998,0,9999,1
1746567435695,EAP 100,A00,905686,Staff,9778,0,9999,221
1746567436722,ECE 45,A01,892618,Staff,0,0,65,65
1746567438772,ECE 111,A01,892719,Staff,4,0,65,61
1746567439799,ECE 197,001,957920,Mercier; Patrick Philip,9991,0,9999,8
1746567440826,ECON 178,A01,907814,Zhu; Ying,26,0,35,9
1746567441850,EDS 115,A00,895312,Staff,35,0,45,10
1746567442877,EDS 117,A01,895337,Staff,23,0,30,7
1746567443902,EDS 125,A00,895341,Jones; Gabrielle Anastasia,36,0,45,9
1746567444931,EDS 128A,A01,895459,Fargason; Sharon Gayle,44,0,45,1
1746567445961,EDS 128B,A01,895543,Pappas; Elizabeth,44,0,45,1
1746567446990,EDS 139,A00,897203,Pappas; Elizabeth,44,0,45,1
1746567446990,EDS 139,B00,897209,Fargason; Sharon Gayle,41,0,45,4
1746567448017,EDS 201,A00,895545,Staff,22,0,45,23
1746567449046,EDS 203,A01,895581,Halter; Christopher P.,22,0,45,23
1746567450071,EDS 204R,A01,895625,Heinzman; Erica M.,39,0,45,6
1746567450071,EDS 204R,B01,895693,Halter; Christopher P.,10,0,45,35
1746567451096,EDS 206R,A00,895694,Fargason; Sharon Gayle,1,0,30,29
1746567451096,EDS 206R,B00,895695,Choi; Bailey Miyeon,16,0,30,14
1746567452123,EDS 250,A00,895697,Hemans; Patricia Ann Benitez,22,0,45,23
1746567453151,EDS 281,A00,895701,Meyerott; Theresa Ann,1,0,15,14
1746567454176,EDS 284,A00,895736,Meyerott; Theresa Ann,1,0,15,14
1746567455201,EDS 286,A00,897210,Fine; Sarah,0,0,15,15
1746567456230,EDS 289C,A01,895770,Daly; Alan J.,1,0,15,14
1746567457259,EDS 290,A00,897211,Hofstetter; Carolyn,0,0,15,15
1746567458284,LIGM 5A,A00,896162,Fischer-Grunski; Eva K,12,0,20,8
1746567459310,LIGM 5B,A00,896260,Fischer-Grunski; Eva K,17,0,20,3
1746567460334,LIGM 5C,A00,896308,Fischer-Grunski; Eva K,18,0,20,2
1746567461358,LIIT 5AS,A00,896313,Carnelos; Chiara,18,0,20,2
1746567462388,LIIT 5BS,A00,896416,Carnelos; Chiara,20,0,20,0
1746567463416,LIIT 5CS,A00,896564,Carnelos; Chiara,20,0,20,0
1746567464442,LISP 5A,A00,896588,Munoz Sanchez; Alicia,3,0,20,17
1746567465469,LISP 5B,A00,896653,Munoz Sanchez; Alicia,7,0,20,13
1746567466494,LISP 5C,A00,896655,Munoz Sanchez; Alicia,0,1,20,20
1746567467523,MAE 197,001,957918,Kleissl; Jan,9996,0,9999,3
1746567467523,MAE 197,002,959806,Boechler; Nicholas Sebastia,9998,0,9999,1
1746567467523,MAE 197,003,959852,Mullin; Jennifer S,9998,0,9999,1
1746567468549,MATH 2,A01,957937,Staff,33,0,35,2
1746567469576,MATH 197,001,957876,Kedlaya; Kiran S.,9993,0,9999,6
1746567470602,MCWP 40,A00,892729,Duru; Nur,10,0,20,10
1746567470602,MCWP 40,B00,893304,Montejo; Carolina,14,0,20,6
1746567471630,MCWP 40R,A00,893757,Redela; Pamela Morgan,0,5,20,20
1746567472655,MCWP 50,A00,893758,Morshed; Michael James,0,0,20,20
1746567472655,MCWP 50,B00,893761,Bartulis; Jason Michael,17,0,20,3
1746567473683,MCWP 50R,A00,893766,Compas; Sean Matthew,0,1,20,20
1746567473683,MCWP 50R,B00,893769,Carter; Jennifer A,0,1,20,20
1746567473683,MCWP 50R,C00,893771,Krone; Jarret,0,3,20,20
1746567473683,MCWP 50R,D00,893772,Miller; Elizabeth Deen,0,0,20,20
1746567473683,MCWP 50R,E00,893775,Carter; Andrea L,0,1,20,20
1746567474712,MMW 11R,A01,892721,Herbst; Matthew,11,0,27,16
1746567474712,MMW 11R,A02,892722,Herbst; Matthew,0,0,0,3
1746567475738,MMW 12R,A01,892724,Herbst; Matthew,0,11,16,16
1746567475738,MMW 12R,A02,892725,Herbst; Matthew,0,10,16,16
1746567476765,MMW 13R,A01,892727,Staff,0,4,16,16
1746567476765,MMW 13R,A02,892728,Staff,0,4,16,16
1746567476765,MMW 13R,A03,958032,Staff,0,4,16,16
1746567476765,MMW 13R,A04,958033,Staff,0,4,16,16
1746567476765,MMW 13R,A05,958034,Staff,0,4,16,16
1746567477793,SIO 295LS,A00,894015,Staff,5,0,25,20
1746567478818,SIO 295S,A00,894020,Staff,5,0,25,20
1746567479849,SIOC 290S,B01,958918,Merrifield; Mark A,14,0,30,16
1746567480878,SIOC 291S,B01,958922,Gabriel; Corey John,14,0,30,16
1746567481905,SOCI 117,A01,895339,Staff,3,0,5,2
1746567482931,WES 237B,A00,894149,Staff,11,0,20,9
1746567484995,AESE 279B,A00,891859,Staff,13,0,35,22
1746567486023,AIP 197,001,891854,Vespa; Emanuel Ignacio,9999,0,9999,0
1746567487049,ANTH 289S,A00,891856,Gagneux; Pascal,12,0,12,0
1746567488074,BENG 196,001,957946,Engler; Adam J.,9996,0,9999,3
1746567489098,BISP 197,001,959851,Wilhelm; James E.,9998,0,9999,1
1746567490126,CAT 124RS,A01,956906,Staff,6,0,25,19
1746567491155,CAT 125RS,A01,922013,Staff,6,0,25,19
1746567492181,CLRE 250,A00,891860,Morris; Sheldon,9995,0,9999,4
1746567494237,CLRE 251R,A00,907817,Mehta; Ravindra L.,9994,0,9999,5
1746567495262,CLRE 252,A00,891864,Cuomo; Raphael Eduardo,9993,0,9999,6
1746567496344,CLRE 253,A00,891867,Vaida; Florin,9994,0,9999,5
1746567496344,CLRE 253,B00,907819,Staff,9999,0,9999,0
1746567497374,CLRE 259,A00,891868,Patel; Hemal,9998,0,9999,1
1746567498401,CLRE 260,A00,891872,Cuomo; Raphael Eduardo,9999,0,9999,0
1746567499427,CLRE 297,001,891888,Cuomo; Raphael Eduardo,9999,0,9999,0
1746567500453,CSE 191,A00,958773,Minnes Kemp; Mor Mia,9995,0,9999,4
1746567501480,CSE 197,001,959846,Minnes Kemp; Mor Mia,9990,0,9999,9
1746567502510,CSS 201S,A01,892054,Mignozzetti; Umberto,25,0,30,5
1746567503540,CSS 202S,A01,892056,Mignozzetti; Umberto,25,0,30,5
1746567504566,DSC 197,001,956898,Eldridge; Justin Matthew,9996,0,9999,3
1746567505591,DSC 297,001,958000,Mazumdar; Arya,9998,0,9999,1
1746567505591,DSC 297,002,959862,Wang; Yusu,9998,0,9999,1
1746567506617,EAP 100,A00,905686,Staff,9778,0,9999,221
1746567507647,ECE 45,A01,892618,Staff,0,0,65,65
1746567509700,ECE 111,A01,892719,Staff,4,0,65,61
1746567510727,ECE 197,001,957920,Mercier; Patrick Philip,9991,0,9999,8
1746567511753,ECON 178,A01,907814,Zhu; Ying,26,0,35,9
1746567512779,EDS 115,A00,895312,Staff,35,0,45,10
1746567513807,EDS 117,A01,895337,Staff,23,0,30,7
1746567514833,EDS 125,A00,895341,Jones; Gabrielle Anastasia,36,0,45,9
1746567515860,EDS 128A,A01,895459,Fargason; Sharon Gayle,44,0,45,1
1746567516887,EDS 128B,A01,895543,Pappas; Elizabeth,44,0,45,1
1746567517914,EDS 139,A00,897203,Pappas; Elizabeth,44,0,45,1
1746567517914,EDS 139,B00,897209,Fargason; Sharon Gayle,41,0,45,4
1746567518940,EDS 201,A00,895545,Staff,22,0,45,23
1746567519964,EDS 203,A01,895581,Halter; Christopher P.,22,0,45,23
1746567520994,EDS 204R,A01,895625,Heinzman; Erica M.,39,0,45,6
1746567520994,EDS 204R,B01,895693,Halter; Christopher P.,10,0,45,35
1746567522021,EDS 206R,A00,895694,Fargason; Sharon Gayle,1,0,30,29
1746567522021,EDS 206R,B00,895695,Choi; Bailey Miyeon,16,0,30,14
1746567523047,EDS 250,A00,895697,Hemans; Patricia Ann Benitez,22,0,45,23
1746567524073,EDS 281,A00,895701,Meyerott; Theresa Ann,1,0,15,14
1746567525098,EDS 284,A00,895736,Meyerott; Theresa Ann,1,0,15,14
1746567526126,EDS 286,A00,897210,Fine; Sarah,0,0,15,15
1746567527154,EDS 289C,A01,895770,Daly; Alan J.,1,0,15,14
1746567528180,EDS 290,A00,897211,Hofstetter; Carolyn,0,0,15,15
1746567529208,LIGM 5A,A00,896162,Fischer-Grunski; Eva K,12,0,20,8
1746567530237,LIGM 5B,A00,896260,Fischer-Grunski; Eva K,17,0,20,3
1746567531262,LIGM 5C,A00,896308,Fischer-Grunski; Eva K,18,0,20,2
1746567532292,LIIT 5AS,A00,896313,Carnelos; Chiara,18,0,20,2
1746567533317,LIIT 5BS,A00,896416,Carnelos; Chiara,20,0,20,0
1746567534343,LIIT 5CS,A00,896564,Carnelos; Chiara,20,0,20,0
1746567535372,LISP 5A,A00,896588,Munoz Sanchez; Alicia,3,0,20,17
1746567536398,LISP 5B,A00,896653,Munoz Sanchez; Alicia,7,0,20,13
1746567537429,LISP 5C,A00,896655,Munoz Sanchez; Alicia,0,1,20,20
1746567538455,MAE 197,001,957918,Kleissl; Jan,9996,0,9999,3
1746567538455,MAE 197,002,959806,Boechler; Nicholas Sebastia,9998,0,9999,1
1746567538455,MAE 197,003,959852,Mullin; Jennifer S,9998,0,9999,1
1746567539485,MATH 2,A01,957937,Staff,33,0,35,2
1746567540516,MATH 197,001,957876,Kedlaya; Kiran S.,9993,0,9999,6
1746567541549,MCWP 40,A00,892729,Duru; Nur,10,0,20,10
1746567541549,MCWP 40,B00,893304,Montejo; Carolina,14,0,20,6
1746567542575,MCWP 40R,A00,893757,Redela; Pamela Morgan,0,5,20,20
1746567543603,MCWP 50,A00,893758,Morshed; Michael James,0,0,20,20
1746567543603,MCWP 50,B00,893761,Bartulis; Jason Michael,17,0,20,3
1746567544629,MCWP 50R,A00,893766,Compas; Sean Matthew,0,1,20,20
1746567544629,MCWP 50R,B00,893769,Carter; Jennifer A,0,1,20,20
1746567544629,MCWP 50R,C00,893771,Krone; Jarret,0,3,20,20
1746567544629,MCWP 50R,D00,893772,Miller; Elizabeth Deen,0,0,20,20
1746567544629,MCWP 50R,E00,893775,Carter; Andrea L,0,1,20,20
1746567545655,MMW 11R,A01,892721,Herbst; Matthew,11,0,27,16
1746567545655,MMW 11R,A02,892722,Herbst; Matthew,0,0,0,3
1746567546681,MMW 12R,A01,892724,Herbst; Matthew,0,11,16,16
1746567546681,MMW 12R,A02,892725,Herbst; Matthew,0,10,16,16
1746567547709,MMW 13R,A01,892727,Staff,0,4,16,16
1746567547709,MMW 13R,A02,892728,Staff,0,4,16,16
1746567547709,MMW 13R,A03,958032,Staff,0,4,16,16
1746567547709,MMW 13R,A04,958033,Staff,0,4,16,16
1746567547709,MMW 13R,A05,958034,Staff,0,4,16,16
1746567548738,SIO 295LS,A00,894015,Staff,5,0,25,20
1746567549765,SIO 295S,A00,894020,Staff,5,0,25,20
1746567550795,SIOC 290S,B01,958918,Merrifield; Mark A,14,0,30,16
1746567551934,SIOC 291S,B01,958922,Gabriel; Corey John,14,0,30,16
1746567552961,SOCI 117,A01,895339,Staff,3,0,5,2
1746567553987,WES 237B,A00,894149,Staff,11,0,20,9
1746567556072,AESE 279B,A00,891859,Staff,13,0,35,22
1746567557101,AIP 197,001,891854,Vespa; Emanuel Ignacio,9999,0,9999,0
1746567558127,ANTH 289S,A00,891856,Gagneux; Pascal,12,0,12,0
1746567559152,BENG 196,001,957946,Engler; Adam J.,9996,0,9999,3
1746567560177,BISP 197,001,959851,Wilhelm; James E.,9998,0,9999,1
1746567561204,CAT 124RS,A01,956906,Staff,6,0,25,19
1746567562230,CAT 125RS,A01,922013,Staff,6,0,25,19
1746567563258,CLRE 250,A00,891860,Morris; Sheldon,9995,0,9999,4
1746567565309,CLRE 251R,A00,907817,Mehta; Ravindra L.,9994,0,9999,5
1746567566335,CLRE 252,A00,891864,Cuomo; Raphael Eduardo,9993,0,9999,6
1746567567359,CLRE 253,A00,891867,Vaida; Florin,9994,0,9999,5
1746567567359,CLRE 253,B00,907819,Staff,9999,0,9999,0
1746567568392,CLRE 259,A00,891868,Patel; Hemal,9998,0,9999,1
1746567569419,CLRE 260,A00,891872,Cuomo; Raphael Eduardo,9999,0,9999,0
1746567570442,CLRE 297,001,891888,Cuomo; Raphael Eduardo,9999,0,9999,0
1746567571467,CSE 191,A00,958773,Minnes Kemp; Mor Mia,9995,0,9999,4
1746567572494,CSE 197,001,959846,Minnes Kemp; Mor Mia,9990,0,9999,9
1746567573520,CSS 201S,A01,892054,Mignozzetti; Umberto,25,0,30,5
1746567574549,CSS 202S,A01,892056,Mignozzetti; Umberto,25,0,30,5
1746567575576,DSC 197,001,956898,Eldridge; Justin Matthew,9996,0,9999,3
1746567576603,DSC 297,001,958000,Mazumdar; Arya,9998,0,9999,1
1746567576603,DSC 297,002,959862,Wang; Yusu,9998,0,9999,1
1746567577627,EAP 100,A00,905686,Staff,9778,0,9999,221
1746567578653,ECE 45,A01,892618,Staff,0,0,65,65
1746567580712,ECE 111,A01,892719,Staff,4,0,65,61
1746567581736,ECE 197,001,957920,Mercier; Patrick Philip,9991,0,9999,8
1746567582762,ECON 178,A01,907814,Zhu; Ying,26,0,35,9
1746567583789,EDS 115,A00,895312,Staff,35,0,45,10
1746567584819,EDS 117,A01,895337,Staff,23,0,30,7
1746567585845,EDS 125,A00,895341,Jones; Gabrielle Anastasia,36,0,45,9
1746567586875,EDS 128A,A01,895459,Fargason; Sharon Gayle,44,0,45,1
1746567587903,EDS 128B,A01,895543,Pappas; Elizabeth,44,0,45,1
1746567588930,EDS 139,A00,897203,Pappas; Elizabeth,44,0,45,1
1746567588930,EDS 139,B00,897209,Fargason; Sharon Gayle,41,0,45,4
1746567589960,EDS 201,A00,895545,Staff,22,0,45,23
1746567590984,EDS 203,A01,895581,Halter; Christopher P.,22,0,45,23
1746567592010,EDS 204R,A01,895625,Heinzman; Erica M.,39,0,45,6
1746567592010,EDS 204R,B01,895693,Halter; Christopher P.,10,0,45,35
1746567593038,EDS 206R,A00,895694,Fargason; Sharon Gayle,1,0,30,29
1746567593038,EDS 206R,B00,895695,Choi; Bailey Miyeon,16,0,30,14
1746567594062,EDS 250,A00,895697,Hemans; Patricia Ann Benitez,22,0,45,23
1746567595091,EDS 281,A00,895701,Meyerott; Theresa Ann,1,0,15,14
1746567596116,EDS 284,A00,895736,Meyerott; Theresa Ann,1,0,15,14
1746567597143,EDS 286,A00,897210,Fine; Sarah,0,0,15,15
1746567598168,EDS 289C,A01,895770,Daly; Alan J.,1,0,15,14
1746567599195,EDS 290,A00,897211,Hofstetter; Carolyn,0,0,15,15
1746567600220,LIGM 5A,A00,896162,Fischer-Grunski; Eva K,12,0,20,8
1746567601246,LIGM 5B,A00,896260,Fischer-Grunski; Eva K,17,0,20,3
1746567602271,LIGM 5C,A00,896308,Fischer-Grunski; Eva K,18,0,20,2
1746567603299,LIIT 5AS,A00,896313,Carnelos; Chiara,18,0,20,2
1746567604324,LIIT 5BS,A00,896416,Carnelos; Chiara,20,0,20,0
1746567605391,LIIT 5CS,A00,896564,Carnelos; Chiara,20,0,20,0
1746567606425,LISP 5A,A00,896588,Munoz Sanchez; Alicia,3,0,20,17
1746567607454,LISP 5B,A00,896653,Munoz Sanchez; Alicia,7,0,20,13
1746567608483,LISP 5C,A00,896655,Munoz Sanchez; Alicia,0,1,20,20
1746567609512,MAE 197,001,957918,Kleissl; Jan,9996,0,9999,3
1746567609512,MAE 197,002,959806,Boechler; Nicholas Sebastia,9998,0,9999,1
1746567609512,MAE 197,003,959852,Mullin; Jennifer S,9998,0,9999,1
1746567610540,MATH 2,A01,957937,Staff,33,0,35,2
1746567611565,MATH 197,001,957876,Kedlaya; Kiran S.,9993,0,9999,6
1746567612593,MCWP 40,A00,892729,Duru; Nur,10,0,20,10
1746567612593,MCWP 40,B00,893304,Montejo; Carolina,14,0,20,6
1746567613622,MCWP 40R,A00,893757,Redela; Pamela Morgan,0,5,20,20
1746567614648,MCWP 50,A00,893758,Morshed; Michael James,0,0,20,20
1746567614648,MCWP 50,B00,893761,Bartulis; Jason Michael,17,0,20,3
1746567615673,MCWP 50R,A00,893766,Compas; Sean Matthew,0,1,20,20
1746567615673,MCWP 50R,B00,893769,Carter; Jennifer A,0,1,20,20
1746567615673,MCWP 50R,C00,893771,Krone; Jarret,0,3,20,20
1746567615673,MCWP 50R,D00,893772,Miller; Elizabeth Deen,0,0,20,20
1746567615673,MCWP 50R,E00,893775,Carter; Andrea L,0,1,20,20
1746567616704,MMW 11R,A01,892721,Herbst; Matthew,11,0,27,16
1746567616704,MMW 11R,A02,892722,Herbst; Matthew,0,0,0,3
1746567617731,MMW 12R,A01,892724,Herbst; Matthew,0,11,16,16
1746567617731,MMW 12R,A02,892725,Herbst; Matthew,0,10,16,16
1746567618757,MMW 13R,A01,892727,Staff,0,4,16,16
1746567618757,MMW 13R,A02,892728,Staff,0,4,16,16
1746567618757,MMW 13R,A03,958032,Staff,0,4,16,16
1746567618757,MMW 13R,A04,958033,Staff,0,4,16,16
1746567618757,MMW 13R,A05,958034,Staff,0,4,16,16
1746567619783,SIO 295LS,A00,894015,Staff,5,0,25,20
1746567620808,SIO 295S,A00,894020,Staff,5,0,25,20
1746567621834,SIOC 290S,B01,958918,Merrifield; Mark A,14,0,30,16
1746567622866,SIOC 291S,B01,958922,Gabriel; Corey John,14,0,30,16
1746567623894,SOCI 117,A01,895339,Staff,3,0,5,2
1746567624921,WES 237B,A00,894149,Staff,11,0,20,9
1746567626992,AESE 279B,A00,891859,Staff,13,0,35,22
1746567628019,AIP 197,001,891854,Vespa; Emanuel Ignacio,9999,0,9999,0
1746567629045,ANTH 289S,A00,891856,Gagneux; Pascal,12,0,12,0
1746567630074,BENG 196,001,957946,Engler; Adam J.,9996,0,9999,3
1746567631098,BISP 197,001,959851,Wilhelm; James E.,9998,0,9999,1
1746567632124,CAT 124RS,A01,956906,Staff,6,0,25,19
1746567633155,CAT 125RS,A01,922013,Staff,6,0,25,19
1746567634181,CLRE 250,A00,891860,Morris; Sheldon,9995,0,9999,4
1746567636237,CLRE 251R,A00,907817,Mehta; Ravindra L.,9994,0,9999,5
1746567637266,CLRE 252,A00,891864,Cuomo; Raphael Eduardo,9993,0,9999,6
1746567638291,CLRE 253,A00,891867,Vaida; Florin,9994,0,9999,5
1746567638291,CLRE 253,B00,907819,Staff,9999,0,9999,0
1746567639316,CLRE 259,A00,891868,Patel; Hemal,9998,0,9999,1
1746567640354,CLRE 260,A00,891872,Cuomo; Raphael Eduardo,9999,0,9999,0
1746567641382,CLRE 297,001,891888,Cuomo; Raphael Eduardo,9999,0,9999,0
1746567642420,CSE 191,A00,958773,Minnes Kemp; Mor Mia,9995,0,9999,4
1746567643445,CSE 197,001,959846,Minnes Kemp; Mor Mia,9990,0,9999,9
1746567644471,CSS 201S,A01,892054,Mignozzetti; Umberto,25,0,30,5
1746567645501,CSS 202S,A01,892056,Mignozzetti; Umberto,25,0,30,5
1746567646529,DSC 197,001,956898,Eldridge; Justin Matthew,9996,0,9999,3
1746567647556,DSC 297,001,958000,Mazumdar; Arya,9998,0,9999,1
1746567647556,DSC 297,002,959862,Wang; Yusu,9998,0,9999,1
1746567648580,EAP 100,A00,905686,Staff,9778,0,9999,221
1746567649605,ECE 45,A01,892618,Staff,0,0,65,65
1746567651663,ECE 111,A01,892719,Staff,4,0,65,61
1746567652690,ECE 197,001,957920,Mercier; Patrick Philip,9991,0,9999,8
1746567653720,ECON 178,A01,907814,Zhu; Ying,26,0,35,9
1746567654747,EDS 115,A00,895312,Staff,35,0,45,10
1746567655774,EDS 117,A01,895337,Staff,23,0,30,7
1746567656804,EDS 125,A00,895341,Jones; Gabrielle Anastasia,36,0,45,9
1746567657829,EDS 128A,A01,895459,Fargason; Sharon Gayle,44,0,45,1
1746567658855,EDS 128B,A01,895543,Pappas; Elizabeth,44,0,45,1
1746567659882,EDS 139,A00,897203,Pappas; Elizabeth,44,0,45,1
1746567659882,EDS 139,B00,897209,Fargason; Sharon Gayle,41,0,45,4
1746567660909,EDS 201,A00,895545,Staff,22,0,45,23
1746567661933,EDS 203,A01,895581,Halter; Christopher P.,22,0,45,23
1746567662958,EDS 204R,A01,895625,Heinzman; Erica M.,39,0,45,6
1746567662958,EDS 204R,B01,895693,Halter; Christopher P.,10,0,45,35
1746567663988,EDS 206R,A00,895694,Fargason; Sharon Gayle,1,0,30,29
1746567663988,EDS 206R,B00,895695,Choi; Bailey Miyeon,16,0,30,14
1746567665015,EDS 250,A00,895697,Hemans; Patricia Ann Benitez,22,0,45,23
1746567666043,EDS 281,A00,895701,Meyerott; Theresa Ann,1,0,15,14
1746567667067,EDS 284,A00,895736,Meyerott; Theresa Ann,1,0,15,14
1746567668091,EDS 286,A00,897210,Fine; Sarah,0,0,15,15
1746567669120,EDS 289C,A01,895770,Daly; Alan J.,1,0,15,14
1746567670148,EDS 290,A00,897211,Hofstetter; Carolyn,0,0,15,15
1746567671173,LIGM 5A,A00,896162,Fischer-Grunski; Eva K,12,0,20,8
1746567672199,LIGM 5B,A00,896260,Fischer-Grunski; Eva K,17,0,20,3
1746567673224,LIGM 5C,A00,896308,Fischer-Grunski; Eva K,18,0,20,2
1746567674253,LIIT 5AS,A00,896313,Carnelos; Chiara,18,0,20,2
1746567675279,LIIT 5BS,A00,896416,Carnelos; Chiara,20,0,20,0
1746567676307,LIIT 5CS,A00,896564,Carnelos; Chiara,20,0,20,0
1746567677331,LISP 5A,A00,896588,Munoz Sanchez; Alicia,3,0,20,17
1746567678360,LISP 5B,A00,896653,Munoz Sanchez; Alicia,7,0,20,13
1746567679385,LISP 5C,A00,896655,Munoz Sanchez; Alicia,0,1,20,20
1746567680411,MAE 197,001,957918,Kleissl; Jan,9996,0,9999,3
1746567680411,MAE 197,002,959806,Boechler; Nicholas Sebastia,9998,0,9999,1
1746567680411,MAE 197,003,959852,Mullin; Jennifer S,9998,0,9999,1
1746567681439,MATH 2,A01,957937,Staff,33,0,35,2
1746567682465,MATH 197,001,957876,Kedlaya; Kiran S.,9993,0,9999,6
1746567683490,MCWP 40,A00,892729,Duru; Nur,10,0,20,10
1746567683490,MCWP 40,B00,893304,Montejo; Carolina,14,0,20,6
1746567684519,MCWP 40R,A00,893757,Redela; Pamela Morgan,0,5,20,20
1746567685545,MCWP 50,A00,893758,Morshed; Michael James,0,0,20,20
1746567685545,MCWP 50,B00,893761,Bartulis; Jason Michael,17,0,20,3
1746567686572,MCWP 50R,A00,893766,Compas; Sean Matthew,0,1,20,20
1746567686572,MCWP 50R,B00,893769,Carter; Jennifer A,0,1,20,20
1746567686572,MCWP 50R,C00,893771,Krone; Jarret,0,3,20,20
1746567686572,MCWP 50R,D00,893772,Miller; Elizabeth Deen,0,0,20,20
1746567686572,MCWP 50R,E00,893775,Carter; Andrea L,0,1,20,20
1746567687600,MMW 11R,A01,892721,Herbst; Matthew,11,0,27,16
1746567687600,MMW 11R,A02,892722,Herbst; Matthew,0,0,0,3
1746567688628,MMW 12R,A01,892724,Herbst; Matthew,0,11,16,16
1746567688628,MMW 12R,A02,892725,Herbst; Matthew,0,10,16,16
1746567689656,MMW 13R,A01,892727,Staff,0,4,16,16
1746567689656,MMW 13R,A02,892728,Staff,0,4,16,16
1746567689656,MMW 13R,A03,958032,Staff,0,4,16,16
1746567689656,MMW 13R,A04,958033,Staff,0,4,16,16
1746567689656,MMW 13R,A05,958034,Staff,0,4,16,16
1746567690681,SIO 295LS,A00,894015,Staff,5,0,25,20
1746567691710,SIO 295S,A00,894020,Staff,5,0,25,20
1746567692742,SIOC 290S,B01,958918,Merrifield; Mark A,14,0,30,16
1746567693768,SIOC 291S,B01,958922,Gabriel; Corey John,14,0,30,16
1746567694792,SOCI 117,A01,895339,Staff,3,0,5,2
1746567695818,WES 237B,A00,894149,Staff,11,0,20,9
1746567697874,AESE 279B,A00,891859,Staff,13,0,35,22
1746567698904,AIP 197,001,891854,Vespa; Emanuel Ignacio,9999,0,9999,0
1746567699931,ANTH 289S,A00,891856,Gagneux; Pascal,12,0,12,0
1746567700956,BENG 196,001,957946,Engler; Adam J.,9996,0,9999,3
1746567701985,BISP 197,001,959851,Wilhelm; James E.,9998,0,9999,1
1746567703017,CAT 124RS,A01,956906,Staff,6,0,25,19
1746567704043,CAT 125RS,A01,922013,Staff,6,0,25,19
1746567705073,CLRE 250,A00,891860,Morris; Sheldon,9995,0,9999,4
1746567707130,CLRE 251R,A00,907817,Mehta; Ravindra L.,9994,0,9999,5
1746567708160,CLRE 252,A00,891864,Cuomo; Raphael Eduardo,9993,0,9999,6
1746567709186,CLRE 253,A00,891867,Vaida; Florin,9994,0,9999,5
1746567709186,CLRE 253,B00,907819,Staff,9999,0,9999,0
1746567710210,CLRE 259,A00,891868,Patel; Hemal,9998,0,9999,1
1746567711239,CLRE 260,A00,891872,Cuomo; Raphael Eduardo,9999,0,9999,0
1746567712263,CLRE 297,001,891888,Cuomo; Raphael Eduardo,9999,0,9999,0
1746567713290,CSE 191,A00,958773,Minnes Kemp; Mor Mia,9995,0,9999,4
1746567714320,CSE 197,001,959846,Minnes Kemp; Mor Mia,9990,0,9999,9
1746567715345,CSS 201S,A01,892054,Mignozzetti; Umberto,25,0,30,5
1746567716370,CSS 202S,A01,892056,Mignozzetti; Umberto,25,0,30,5
1746567717396,DSC 197,001,956898,Eldridge; Justin Matthew,9996,0,9999,3
1746567718421,DSC 297,001,958000,Mazumdar; Arya,9998,0,9999,1
1746567718421,DSC 297,002,959862,Wang; Yusu,9998,0,9999,1
1746567719447,EAP 100,A00,905686,Staff,9778,0,9999,221
1746567720474,ECE 45,A01,892618,Staff,0,0,65,65
1746567722528,ECE 111,A01,892719,Staff,4,0,65,61
1746567723558,ECE 197,001,957920,Mercier; Patrick Philip,9991,0,9999,8
1746567724584,ECON 178,A01,907814,Zhu; Ying,26,0,35,9
1746567725612,EDS 115,A00,895312,Staff,35,0,45,10
1746567726642,EDS 117,A01,895337,Staff,23,0,30,7
1746567727669,EDS 125,A00,895341,Jones; Gabrielle Anastasia,36,0,45,9
1746567728698,EDS 128A,A01,895459,Fargason; Sharon Gayle,44,0,45,1
1746567729723,EDS 128B,A01,895543,Pappas; Elizabeth,44,0,45,1
1746567730754,EDS 139,A00,897203,Pappas; Elizabeth,44,0,45,1
1746567730754,EDS 139,B00,897209,Fargason; Sharon Gayle,41,0,45,4
1746567731779,EDS 201,A00,895545,Staff,22,0,45,23
1746567732807,EDS 203,A01,895581,Halter; Christopher P.,22,0,45,23
1746567733834,EDS 204R,A01,895625,Heinzman; Erica M.,39,0,45,6
1746567733834,EDS 204R,B01,895693,Halter; Christopher P.,10,0,45,35
1746567734864,EDS 206R,A00,895694,Fargason; Sharon Gayle,1,0,30,29
1746567734864,EDS 206R,B00,895695,Choi; Bailey Miyeon,16,0,30,14
1746567735894,EDS 250,A00,895697,Hemans; Patricia Ann Benitez,22,0,45,23
1746567736919,EDS 281,A00,895701,Meyerott; Theresa Ann,1,0,15,14
1746567737944,EDS 284,A00,895736,Meyerott; Theresa Ann,1,0,15,14
1746567738973,EDS 286,A00,897210,Fine; Sarah,0,0,15,15
1746567740003,EDS 289C,A01,895770,Daly; Alan J.,1,0,15,14
1746567741029,EDS 290,A00,897211,Hofstetter; Carolyn,0,0,15,15
1746567742080,LIGM 5A,A00,896162,Fischer-Grunski; Eva K,12,0,20,8
1746567743107,LIGM 5B,A00,896260,Fischer-Grunski; Eva K,17,0,20,3
1746567744134,LIGM 5C,A00,896308,Fischer-Grunski; Eva K,18,0,20,2
1746567745157,LIIT 5AS,A00,896313,Carnelos; Chiara,18,0,20,2
1746567746184,LIIT 5BS,A00,896416,Carnelos; Chiara,20,0,20,0
1746567747213,LIIT 5CS,A00,896564,Carnelos; Chiara,20,0,20,0
1746567748238,LISP 5A,A00,896588,Munoz Sanchez; Alicia,3,0,20,17
1746567749264,LISP 5B,A00,896653,Munoz Sanchez; Alicia,7,0,20,13
1746567750289,LISP 5C,A00,896655,Munoz Sanchez; Alicia,0,1,20,20
1746567751315,MAE 197,001,957918,Kleissl; Jan,9996,0,9999,3
1746567751315,MAE 197,002,959806,Boechler; Nicholas Sebastia,9998,0,9999,1
1746567751315,MAE 197,003,959852,Mullin; Jennifer S,9998,0,9999,1
1746567752342,MATH 2,A01,957937,Staff,33,0,35,2
1746567753370,MATH 197,001,957876,Kedlaya; Kiran S.,9993,0,9999,6
1746567754396,MCWP 40,A00,892729,Duru; Nur,10,0,20,10
1746567754396,MCWP 40,B00,893304,Montejo; Carolina,14,0,20,6
1746567755421,MCWP 40R,A00,893757,Redela; Pamela Morgan,0,5,20,20
1746567756446,MCWP 50,A00,893758,Morshed; Michael James,0,0,20,20
1746567756446,MCWP 50,B00,893761,Bartulis; Jason Michael,17,0,20,3
1746567757474,MCWP 50R,A00,893766,Compas; Sean Matthew,0,1,20,20
1746567757474,MCWP 50R,B00,893769,Carter; Jennifer A,0,1,20,20
1746567757474,MCWP 50R,C00,893771,Krone; Jarret,0,3,20,20
1746567757474,MCWP 50R,D00,893772,Miller; Elizabeth Deen,0,0,20,20
1746567757474,MCWP 50R,E00,893775,Carter; Andrea L,0,1,20,20
1746567758502,MMW 11R,A01,892721,Herbst; Matthew,11,0,27,16
1746567758502,MMW 11R,A02,892722,Herbst; Matthew,0,0,0,3
1746567759527,MMW 12R,A01,892724,Herbst; Matthew,0,11,16,16
1746567759527,MMW 12R,A02,892725,Herbst; Matthew,0,10,16,16
1746567760555,MMW 13R,A01,892727,Staff,0,4,16,16
1746567760555,MMW 13R,A02,892728,Staff,0,4,16,16
1746567760555,MMW 13R,A03,958032,Staff,0,4,16,16
1746567760555,MMW 13R,A04,958033,Staff,0,4,16,16
1746567760555,MMW 13R,A05,958034,Staff,0,4,16,16
1746567761582,SIO 295LS,A00,894015,Staff,5,0,25,20
1746567762607,SIO 295S,A00,894020,Staff,5,0,25,20
1746567763632,SIOC 290S,B01,958918,Merrifield; Mark A,14,0,30,16
1746567764657,SIOC 291S,B01,958922,Gabriel; Corey John,14,0,30,16
1746567765685,SOCI 117,A01,895339,Staff,3,0,5,2
1746567766714,WES 237B,A00,894149,Staff,11,0,20,9
1746567768771,AESE 279B,A00,891859,Staff,13,0,35,22
1746567769815,AIP 197,001,891854,Vespa; Emanuel Ignacio,9999,0,9999,0
1746567770843,ANTH 289S,A00,891856,Gagneux; Pascal,12,0,12,0
1746567771870,BENG 196,001,957946,Engler; Adam J.,9996,0,9999,3
1746567772902,BISP 197,001,959851,Wilhelm; James E.,9998,0,9999,1
1746567773927,CAT 124RS,A01,956906,Staff,6,0,25,19
1746567774953,CAT 125RS,A01,922013,Staff,6,0,25,19
1746567775978,CLRE 250,A00,891860,Morris; Sheldon,9995,0,9999,4
1746567778030,CLRE 251R,A00,907817,Mehta; Ravindra L.,9994,0,9999,5
1746567779057,CLRE 252,A00,891864,Cuomo; Raphael Eduardo,9993,0,9999,6
1746567780082,CLRE 253,A00,891867,Vaida; Florin,9994,0,9999,5
1746567780082,CLRE 253,B00,907819,Staff,9999,0,9999,0
1746567781108,CLRE 259,A00,891868,Patel; Hemal,9998,0,9999,1
1746567782139,CLRE 260,A00,891872,Cuomo; Raphael Eduardo,9999,0,9999,0
1746567783164,CLRE 297,001,891888,Cuomo; Raphael Eduardo,9999,0,9999,0
1746567784192,CSE 191,A00,958773,Minnes Kemp; Mor Mia,9995,0,9999,4
1746567785221,CSE 197,001,959846,Minnes Kemp; Mor Mia,9990,0,9999,9
1746567786247,CSS 201S,A01,892054,Mignozzetti; Umberto,25,0,30,5
1746567787271,CSS 202S,A01,892056,Mignozzetti; Umberto,25,0,30,5
1746567788296,DSC 197,001,956898,Eldridge; Justin Matthew,9996,0,9999,3
1746567789328,DSC 297,001,958000,Mazumdar; Arya,9998,0,9999,1
1746567789328,DSC 297,002,959862,Wang; Yusu,9998,0,9999,1
1746567790353,EAP 100,A00,905686,Staff,9778,0,9999,221
1746567791380,ECE 45,A01,892618,Staff,0,0,65,65
1746567793440,ECE 111,A01,892719,Staff,4,0,65,61
1746567794465,ECE 197,001,957920,Mercier; Patrick Philip,9991,0,9999,8
1746567795492,ECON 178,A01,907814,Zhu; Ying,26,0,35,9
1746567796517,EDS 115,A00,895312,Staff,35,0,45,10
1746567797544,EDS 117,A01,895337,Staff,23,0,30,7
1746567798571,EDS 125,A00,895341,Jones; Gabrielle Anastasia,36,0,45,9
1746567799598,EDS 128A,A01,895459,Fargason; Sharon Gayle,44,0,45,1
1746567800624,EDS 128B,A01,895543,Pappas; Elizabeth,44,0,45,1
1746567801655,EDS 139,A00,897203,Pappas; Elizabeth,44,0,45,1
1746567801655,EDS 139,B00,897209,Fargason; Sharon Gayle,41,0,45,4
1746567802679,EDS 201,A00,895545,Staff,22,0,45,23
1746567803704,EDS 203,A01,895581,Halter; Christopher P.,22,0,45,23
1746567804734,EDS 204R,A01,895625,Heinzman; Erica M.,39,0,45,6
1746567804734,EDS 204R,B01,895693,Halter; Christopher P.,10,0,45,35
1746567805765,EDS 206R,A00,895694,Fargason; Sharon Gayle,1,0,30,29
1746567805765,EDS 206R,B00,895695,Choi; Bailey Miyeon,16,0,30,14
1746567806793,EDS 250,A00,895697,Hemans; Patricia Ann Benitez,22,0,45,23
1746567807820,EDS 281,A00,895701,Meyerott; Theresa Ann,1,0,15,14
1746567808848,EDS 284,A00,895736,Meyerott; Theresa Ann,1,0,15,14
1746567809878,EDS 286,A00,897210,Fine; Sarah,0,0,15,15
1746567810905,EDS 289C,A01,895770,Daly; Alan J.,1,0,15,14
1746567811934,EDS 290,A00,897211,Hofstetter; Carolyn,0,0,15,15
1746567812963,LIGM 5A,A00,896162,Fischer-Grunski; Eva K,12,0,20,8
1746567813989,LIGM 5B,A00,896260,Fischer-Grunski; Eva K,17,0,20,3
1746567815017,LIGM 5C,A00,896308,Fischer-Grunski; Eva K,18,0,20,2
1746567816048,LIIT 5AS,A00,896313,Carnelos; Chiara,18,0,20,2
1746567817076,LIIT 5BS,A00,896416,Carnelos; Chiara,20,0,20,0
1746567818101,LIIT 5CS,A00,896564,Carnelos; Chiara,20,0,20,0
1746567819129,LISP 5A,A00,896588,Munoz Sanchez; Alicia,3,0,20,17
1746567820154,LISP 5B,A00,896653,Munoz Sanchez; Alicia,7,0,20,13
1746567821178,LISP 5C,A00,896655,Munoz Sanchez; Alicia,0,1,20,20
1746567822208,MAE 197,001,957918,Kleissl; Jan,9996,0,9999,3
1746567822208,MAE 197,002,959806,Boechler; Nicholas Sebastia,9998,0,9999,1
1746567822208,MAE 197,003,959852,Mullin; Jennifer S,9998,0,9999,1
1746567823272,MATH 2,A01,957937,Staff,33,0,35,2
1746567824300,MATH 197,001,957876,Kedlaya; Kiran S.,9993,0,9999,6
1746567825325,MCWP 40,A00,892729,Duru; Nur,10,0,20,10
1746567825325,MCWP 40,B00,893304,Montejo; Carolina,14,0,20,6
1746567826352,MCWP 40R,A00,893757,Redela; Pamela Morgan,0,5,20,20
1746567827380,MCWP 50,A00,893758,Morshed; Michael James,0,0,20,20
1746567827380,MCWP 50,B00,893761,Bartulis; Jason Michael,17,0,20,3
1746567828405,MCWP 50R,A00,893766,Compas; Sean Matthew,0,1,20,20
1746567828405,MCWP 50R,B00,893769,Carter; Jennifer A,0,1,20,20
1746567828405,MCWP 50R,C00,893771,Krone; Jarret,0,3,20,20
1746567828405,MCWP 50R,D00,893772,Miller; Elizabeth Deen,0,0,20,20
1746567828405,MCWP 50R,E00,893775,Carter; Andrea L,0,1,20,20
1746567829431,MMW 11R,A01,892721,Herbst; Matthew,11,0,27,16
1746567829431,MMW 11R,A02,892722,Herbst; Matthew,0,0,0,3
1746567830462,MMW 12R,A01,892724,Herbst; Matthew,0,11,16,16
1746567830462,MMW 12R,A02,892725,Herbst; Matthew,0,10,16,16
1746567831492,MMW 13R,A01,892727,Staff,0,4,16,16
1746567831492,MMW 13R,A02,892728,Staff,0,4,16,16
1746567831492,MMW 13R,A03,958032,Staff,0,4,16,16
1746567831492,MMW 13R,A04,958033,Staff,0,4,16,16
1746567831492,MMW 13R,A05,958034,Staff,0,4,16,16
1746567832518,SIO 295LS,A00,894015,Staff,5,0,25,20
1746567833547,SIO 295S,A00,894020,Staff,5,0,25,20
1746567834575,SIOC 290S,B01,958918,Merrifield; Mark A,14,0,30,16
1746567835600,SIOC 291S,B01,958922,Gabriel; Corey John,14,0,30,16
1746567836626,SOCI 117,A01,895339,Staff,3,0,5,2
1746567837651,WES 237B,A00,894149,Staff,11,0,20,9
1746567839713,AESE 279B,A00,891859,Staff,13,0,35,22
1746567840737,AIP 197,001,891854,Vespa; Emanuel Ignacio,9999,0,9999,0
1746567841763,ANTH 289S,A00,891856,Gagneux; Pascal,12,0,12,0
1746567842789,BENG 196,001,957946,Engler; Adam J.,9996,0,9999,3
1746567843824,BISP 197,001,959851,Wilhelm; James E.,9998,0,9999,1
1746567844850,CAT 124RS,A01,956906,Staff,6,0,25,19
1746567845880,CAT 125RS,A01,922013,Staff,6,0,25,19
1746567846907,CLRE 250,A00,891860,Morris; Sheldon,9995,0,9999,4
1746567848960,CLRE 251R,A00,907817,Mehta; Ravindra L.,9994,0,9999,5
1746567849988,CLRE 252,A00,891864,Cuomo; Raphael Eduardo,9993,0,9999,6
1746567851014,CLRE 253,A00,891867,Vaida; Florin,9994,0,9999,5
1746567851014,CLRE 253,B00,907819,Staff,9999,0,9999,0
1746567852039,CLRE 259,A00,891868,Patel; Hemal,9998,0,9999,1
1746567853068,CLRE 260,A00,891872,Cuomo; Raphael Eduardo,9999,0,9999,0
1746567854093,CLRE 297,001,891888,Cuomo; Raphael Eduardo,9999,0,9999,0
1746567855122,CSE 191,A00,958773,Minnes Kemp; Mor Mia,9995,0,9999,4
1746567856147,CSE 197,001,959846,Minnes Kemp; Mor Mia,9990,0,9999,9
1746567857177,CSS 201S,A01,892054,Mignozzetti; Umberto,25,0,30,5
1746567858204,CSS 202S,A01,892056,Mignozzetti; Umberto,25,0,30,5
1746567859228,DSC 197,001,956898,Eldridge; Justin Matthew,9996,0,9999,3
1746567860254,DSC 297,001,958000,Mazumdar; Arya,9998,0,9999,1
1746567860254,DSC 297,002,959862,Wang; Yusu,9998,0,9999,1
1746567861281,EAP 100,A00,905686,Staff,9778,0,9999,221
1746567862307,ECE 45,A01,892618,Staff,0,0,65,65
1746567864357,ECE 111,A01,892719,Staff,4,0,65,61
1746567865382,ECE 197,001,957920,Mercier; Patrick Philip,9991,0,9999,8
1746567866413,ECON 178,A01,907814,Zhu; Ying,26,0,35,9
1746567867437,EDS 115,A00,895312,Staff,35,0,45,10
1746567868460,EDS 117,A01,895337,Staff,23,0,30,7
1746567869487,EDS 125,A00,895341,Jones; Gabrielle Anastasia,36,0,45,9
1746567870511,EDS 128A,A01,895459,Fargason; Sharon Gayle,44,0,45,1
1746567871539,EDS 128B,A01,895543,Pappas; Elizabeth,44,0,45,1
1746567872567,EDS 139,A00,897203,Pappas; Elizabeth,44,0,45,1
1746567872567,EDS 139,B00,897209,Fargason; Sharon Gayle,41,0,45,4
1746567873592,EDS 201,A00,895545,Staff,22,0,45,23
1746567874620,EDS 203,A01,895581,Halter; Christopher P.,22,0,45,23
1746567875645,EDS 204R,A01,895625,Heinzman; Erica M.,39,0,45,6
1746567875645,EDS 204R,B01,895693,Halter; Christopher P.,10,0,45,35
1746567876684,EDS 206R,A00,895694,Fargason; Sharon Gayle,1,0,30,29
1746567876684,EDS 206R,B00,895695,Choi; Bailey Miyeon,16,0,30,14
1746567877709,EDS 250,A00,895697,Hemans; Patricia Ann Benitez,22,0,45,23
1746567878735,EDS 281,A00,895701,Meyerott; Theresa Ann,1,0,15,14
1746567879760,EDS 284,A00,895736,Meyerott; Theresa Ann,1,0,15,14
1746567880786,EDS 286,A00,897210,Fine; Sarah,0,0,15,15
1746567881814,EDS 289C,A01,895770,Daly; Alan J.,1,0,15,14
1746567882843,EDS 290,A00,897211,Hofstetter; Carolyn,0,0,15,15
1746567883869,LIGM 5A,A00,896162,Fischer-Grunski; Eva K,12,0,20,8
1746567884895,LIGM 5B,A00,896260,Fischer-Grunski; Eva K,17,0,20,3
1746567885919,LIGM 5C,A00,896308,Fischer-Grunski; Eva K,18,0,20,2
1746567886946,LIIT 5AS,A00,896313,Carnelos; Chiara,18,0,20,2
1746567887973,LIIT 5BS,A00,896416,Carnelos; Chiara,20,0,20,0
1746567889002,LIIT 5CS,A00,896564,Carnelos; Chiara,20,0,20,0
1746567890031,LISP 5A,A00,896588,Munoz Sanchez; Alicia,3,0,20,17
1746567891060,LISP 5B,A00,896653,Munoz Sanchez; Alicia,7,0,20,13
1746567892083,LISP 5C,A00,896655,Munoz Sanchez; Alicia,0,1,20,20
1746567893111,MAE 197,001,957918,Kleissl; Jan,9996,0,9999,3
1746567893111,MAE 197,002,959806,Boechler; Nicholas Sebastia,9998,0,9999,1
1746567893111,MAE 197,003,959852,Mullin; Jennifer S,9998,0,9999,1
1746567894135,MATH 2,A01,957937,Staff,33,0,35,2
1746567895164,MATH 197,001,957876,Kedlaya; Kiran S.,9993,0,9999,6
1746567896189,MCWP 40,A00,892729,Duru; Nur,10,0,20,10
1746567896189,MCWP 40,B00,893304,Montejo; Carolina,14,0,20,6
1746567897214,MCWP 40R,A00,893757,Redela; Pamela Morgan,0,5,20,20
1746567898237,MCWP 50,A00,893758,Morshed; Michael James,0,0,20,20
1746567898237,MCWP 50,B00,893761,Bartulis; Jason Michael,17,0,20,3
1746567899265,MCWP 50R,A00,893766,Compas; Sean Matthew,0,1,20,20
1746567899265,MCWP 50R,B00,893769,Carter; Jennifer A,0,1,20,20
1746567899265,MCWP 50R,C00,893771,Krone; Jarret,0,3,20,20
1746567899265,MCWP 50R,D00,893772,Miller; Elizabeth Deen,0,0,20,20
1746567899265,MCWP 50R,E00,893775,Carter; Andrea L,0,1,20,20
1746567900289,MMW 11R,A01,892721,Herbst; Matthew,11,0,27,16
1746567900289,MMW 11R,A02,892722,Herbst; Matthew,0,0,0,3
1746567901313,MMW 12R,A01,892724,Herbst; Matthew,0,11,16,16
1746567901313,MMW 12R,A02,892725,Herbst; Matthew,0,10,16,16
1746567902339,MMW 13R,A01,892727,Staff,0,4,16,16
1746567902339,MMW 13R,A02,892728,Staff,0,4,16,16
1746567902339,MMW 13R,A03,958032,Staff,0,4,16,16
1746567902339,MMW 13R,A04,958033,Staff,0,4,16,16
1746567902339,MMW 13R,A05,958034,Staff,0,4,16,16
1746567903364,SIO 295LS,A00,894015,Staff,5,0,25,20
1746567904388,SIO 295S,A00,894020,Staff,5,0,25,20
1746567905413,SIOC 290S,B01,958918,Merrifield; Mark A,14,0,30,16
1746567906451,SIOC 291S,B01,958922,Gabriel; Corey John,14,0,30,16
1746567907478,SOCI 117,A01,895339,Staff,3,0,5,2
1746567908505,WES 237B,A00,894149,Staff,11,0,20,9
1746567910560,AESE 279B,A00,891859,Staff,13,0,35,22
1746567911585,AIP 197,001,891854,Vespa; Emanuel Ignacio,9999,0,9999,0
1746567912611,ANTH 289S,A00,891856,Gagneux; Pascal,12,0,12,0
1746567913639,BENG 196,001,957946,Engler; Adam J.,9996,0,9999,3
1746567914665,BISP 197,001,959851,Wilhelm; James E.,9998,0,9999,1
1746567915692,CAT 124RS,A01,956906,Staff,6,0,25,19
1746567916715,CAT 125RS,A01,922013,Staff,6,0,25,19
1746567917743,CLRE 250,A00,891860,Morris; Sheldon,9995,0,9999,4
1746567919858,CLRE 251R,A00,907817,Mehta; Ravindra L.,9994,0,9999,5
1746567920887,CLRE 252,A00,891864,Cuomo; Raphael Eduardo,9993,0,9999,6
1746567921913,CLRE 253,A00,891867,Vaida; Florin,9994,0,9999,5
1746567921913,CLRE 253,B00,907819,Staff,9999,0,9999,0
1746567922939,CLRE 259,A00,891868,Patel; Hemal,9998,0,9999,1
1746567923965,CLRE 260,A00,891872,Cuomo; Raphael Eduardo,9999,0,9999,0
1746567924992,CLRE 297,001,891888,Cuomo; Raphael Eduardo,9999,0,9999,0
1746567926019,CSE 191,A00,958773,Minnes Kemp; Mor Mia,9995,0,9999,4
1746567927048,CSE 197,001,959846,Minnes Kemp; Mor Mia,9990,0,9999,9
1746567928074,CSS 201S,A01,892054,Mignozzetti; Umberto,25,0,30,5
1746567929104,CSS 202S,A01,892056,Mignozzetti; Umberto,25,0,30,5
1746567930129,DSC 197,001,956898,Eldridge; Justin Matthew,9996,0,9999,3
1746567931158,DSC 297,001,958000,Mazumdar; Arya,9998,0,9999,1
1746567931158,DSC 297,002,959862,Wang; Yusu,9998,0,9999,1
1746567932184,EAP 100,A00,905686,Staff,9778,0,9999,221
1746567933210,ECE 45,A01,892618,Staff,0,0,65,65
1746567935259,ECE 111,A01,892719,Staff,4,0,65,61
1746567936290,ECE 197,001,957920,Mercier; Patrick Philip,9991,0,9999,8
1746567937322,ECON 178,A01,907814,Zhu; Ying,26,0,35,9
1746567938345,EDS 115,A00,895312,Staff,35,0,45,10
1746567939375,EDS 117,A01,895337,Staff,23,0,30,7
1746567940405,EDS 125,A00,895341,Jones; Gabrielle Anastasia,36,0,45,9
1746567941432,EDS 128A,A01,895459,Fargason; Sharon Gayle,44,0,45,1
1746567942459,EDS 128B,A01,895543,Pappas; Elizabeth,44,0,45,1
1746567943483,EDS 139,A00,897203,Pappas; Elizabeth,44,0,45,1
1746567943483,EDS 139,B00,897209,Fargason; Sharon Gayle,41,0,45,4
1746567944515,EDS 201,A00,895545,Staff,22,0,45,23
1746567945546,EDS 203,A01,895581,Halter; Christopher P.,22,0,45,23
1746567946572,EDS 204R,A01,895625,Heinzman; Erica M.,39,0,45,6
1746567946572,EDS 204R,B01,895693,Halter; Christopher P.,10,0,45,35
1746567947596,EDS 206R,A00,895694,Fargason; Sharon Gayle,1,0,30,29
1746567947596,EDS 206R,B00,895695,Choi; Bailey Miyeon,16,0,30,14
1746567948624,EDS 250,A00,895697,Hemans; Patricia Ann Benitez,22,0,45,23
1746567949649,EDS 281,A00,895701,Meyerott; Theresa Ann,1,0,15,14
1746567950675,EDS 284,A00,895736,Meyerott; Theresa Ann,1,0,15,14
1746567951703,EDS 286,A00,897210,Fine; Sarah,0,0,15,15
1746567952728,EDS 289C,A01,895770,Daly; Alan J.,1,0,15,14
1746567953756,EDS 290,A00,897211,Hofstetter; Carolyn,0,0,15,15
1746567954783,LIGM 5A,A00,896162,Fischer-Grunski; Eva K,12,0,20,8
1746567955811,LIGM 5B,A00,896260,Fischer-Grunski; Eva K,17,0,20,3
1746567956835,LIGM 5C,A00,896308,Fischer-Grunski; Eva K,18,0,20,2
1746567957859,LIIT 5AS,A00,896313,Carnelos; Chiara,18,0,20,2
1746567958886,LIIT 5BS,A00,896416,Carnelos; Chiara,20,0,20,0
1746567959912,LIIT 5CS,A00,896564,Carnelos; Chiara,20,0,20,0
1746567960942,LISP 5A,A00,896588,Munoz Sanchez; Alicia,3,0,20,17
1746567961968,LISP 5B,A00,896653,Munoz Sanchez; Alicia,7,0,20,13
1746567962998,LISP 5C,A00,896655,Munoz Sanchez; Alicia,0,1,20,20
1746567964028,MAE 197,001,957918,Kleissl; Jan,9996,0,9999,3
1746567964028,MAE 197,002,959806,Boechler; Nicholas Sebastia,9998,0,9999,1
1746567964028,MAE 197,003,959852,Mullin; Jennifer S,9998,0,9999,1
1746567965051,MATH 2,A01,957937,Staff,33,0,35,2
1746567966080,MATH 197,001,957876,Kedlaya; Kiran S.,9993,0,9999,6
1746567967111,MCWP 40,A00,892729,Duru; Nur,10,0,20,10
1746567967111,MCWP 40,B00,893304,Montejo; Carolina,14,0,20,6
1746567968135,MCWP 40R,A00,893757,Redela; Pamela Morgan,0,5,20,20
1746567969161,MCWP 50,A00,893758,Morshed; Michael James,0,0,20,20
1746567969161,MCWP 50,B00,893761,Bartulis; Jason Michael,17,0,20,3
1746567970188,MCWP 50R,A00,893766,Compas; Sean Matthew,0,1,20,20
1746567970188,MCWP 50R,B00,893769,Carter; Jennifer A,0,1,20,20
1746567970188,MCWP 50R,C00,893771,Krone; Jarret,0,3,20,20
1746567970188,MCWP 50R,D00,893772,Miller; Elizabeth Deen,0,0,20,20
1746567970188,MCWP 50R,E00,893775,Carter; Andrea L,0,1,20,20
1746567971219,MMW 11R,A01,892721,Herbst; Matthew,11,0,27,16
1746567971219,MMW 11R,A02,892722,Herbst; Matthew,0,0,0,3
1746567972246,MMW 12R,A01,892724,Herbst; Matthew,0,11,16,16
1746567972246,MMW 12R,A02,892725,Herbst; Matthew,0,10,16,16
1746567973270,MMW 13R,A01,892727,Staff,0,4,16,16
1746567973270,MMW 13R,A02,892728,Staff,0,4,16,16
1746567973270,MMW 13R,A03,958032,Staff,0,4,16,16
1746567973270,MMW 13R,A04,958033,Staff,0,4,16,16
1746567973270,MMW 13R,A05,958034,Staff,0,4,16,16
1746567974299,SIO 295LS,A00,894015,Staff,5,0,25,20
1746567975323,SIO 295S,A00,894020,Staff,5,0,25,20
1746567976349,SIOC 290S,B01,958918,Merrifield; Mark A,14,0,30,16
1746567977376,SIOC 291S,B01,958922,Gabriel; Corey John,14,0,30,16
1746567978399,SOCI 117,A01,895339,Staff,3,0,5,2
1746567979450,WES 237B,A00,894149,Staff,11,0,20,9
1746567981509,AESE 279B,A00,891859,Staff,13,0,35,22
1746567982533,AIP 197,001,891854,Vespa; Emanuel Ignacio,9999,0,9999,0
1746567983564,ANTH 289S,A00,891856,Gagneux; Pascal,12,0,12,0
1746567984590,BENG 196,001,957946,Engler; Adam J.,9996,0,9999,3
1746567985615,BISP 197,001,959851,Wilhelm; James E.,9998,0,9999,1
1746567986648,CAT 124RS,A01,956906,Staff,6,0,25,19
1746567987674,CAT 125RS,A01,922013,Staff,6,0,25,19
1746567988702,CLRE 250,A00,891860,Morris; Sheldon,9995,0,9999,4
1746567990752,CLRE 251R,A00,907817,Mehta; Ravindra L.,9994,0,9999,5
1746567991776,CLRE 252,A00,891864,Cuomo; Raphael Eduardo,9993,0,9999,6
1746567992799,CLRE 253,A00,891867,Vaida; Florin,9994,0,9999,5
1746567992799,CLRE 253,B00,907819,Staff,9999,0,9999,0
1746567993823,CLRE 259,A00,891868,Patel; Hemal,9998,0,9999,1
1746567994846,CLRE 260,A00,891872,Cuomo; Raphael Eduardo,9999,0,9999,0
1746567995874,CLRE 297,001,891888,Cuomo; Raphael Eduardo,9999,0,9999,0
1746567996898,CSE 191,A00,958773,Minnes Kemp; Mor Mia,9995,0,9999,4
1746567997921,CSE 197,001,959846,Minnes Kemp; Mor Mia,9990,0,9999,9
1746567998949,CSS 201S,A01,892054,Mignozzetti; Umberto,25,0,30,5
1746567999976,CSS 202S,A01,892056,Mignozzetti; Umberto,25,0,30,5
1746568001004,DSC 197,001,956898,Eldridge; Justin Matthew,9996,0,9999,3
1746568002032,DSC 297,001,958000,Mazumdar; Arya,9998,0,9999,1
1746568002032,DSC 297,002,959862,Wang; Yusu,9998,0,9999,1
1746568003057,EAP 100,A00,905686,Staff,9778,0,9999,221
1746568004085,ECE 45,A01,892618,Staff,0,0,65,65
1746568006138,ECE 111,A01,892719,Staff,4,0,65,61
1746568007163,ECE 197,001,957920,Mercier; Patrick Philip,9991,0,9999,8
1746568008194,ECON 178,A01,907814,Zhu; Ying,26,0,35,9
1746568009223,EDS 115,A00,895312,Staff,35,0,45,10
1746568010249,EDS 117,A01,895337,Staff,23,0,30,7
1746568011278,EDS 125,A00,895341,Jones; Gabrielle Anastasia,36,0,45,9
1746568012303,EDS 128A,A01,895459,Fargason; Sharon Gayle,44,0,45,1
1746568013333,EDS 128B,A01,895543,Pappas; Elizabeth,44,0,45,1
1746568014363,EDS 139,A00,897203,Pappas; Elizabeth,44,0,45,1
1746568014363,EDS 139,B00,897209,Fargason; Sharon Gayle,41,0,45,4
1746568015387,EDS 201,A00,895545,Staff,22,0,45,23
1746568016412,EDS 203,A01,895581,Halter; Christopher P.,22,0,45,23
1746568017443,EDS 204R,A01,895625,Heinzman; Erica M.,39,0,45,6
1746568017443,EDS 204R,B01,895693,Halter; Christopher P.,10,0,45,35
1746568018471,EDS 206R,A00,895694,Fargason; Sharon Gayle,1,0,30,29
1746568018471,EDS 206R,B00,895695,Choi; Bailey Miyeon,16,0,30,14
1746568019495,EDS 250,A00,895697,Hemans; Patricia Ann Benitez,22,0,45,23
1746568020536,EDS 281,A00,895701,Meyerott; Theresa Ann,1,0,15,14
1746568021563,EDS 284,A00,895736,Meyerott; Theresa Ann,1,0,15,14
1746568022590,EDS 286,A00,897210,Fine; Sarah,0,0,15,15
1746568023617,EDS 289C,A01,895770,Daly; Alan J.,1,0,15,14
1746568024642,EDS 290,A00,897211,Hofstetter; Carolyn,0,0,15,15
1746568025665,LIGM 5A,A00,896162,Fischer-Grunski; Eva K,12,0,20,8
1746568026696,LIGM 5B,A00,896260,Fischer-Grunski; Eva K,17,0,20,3
1746568027724,LIGM 5C,A00,896308,Fischer-Grunski; Eva K,18,0,20,2
1746568028753,LIIT 5AS,A00,896313,Carnelos; Chiara,18,0,20,2
1746568029781,LIIT 5BS,A00,896416,Carnelos; Chiara,20,0,20,0
1746568030809,LIIT 5CS,A00,896564,Carnelos; Chiara,20,0,20,0
1746568031836,LISP 5A,A00,896588,Munoz Sanchez; Alicia,3,0,20,17
1746568032861,LISP 5B,A00,896653,Munoz Sanchez; Alicia,7,0,20,13
1746568033885,LISP 5C,A00,896655,Munoz Sanchez; Alicia,0,1,20,20
1746568034909,MAE 197,001,957918,Kleissl; Jan,9996,0,9999,3
1746568034909,MAE 197,002,959806,Boechler; Nicholas Sebastia,9998,0,9999,1
1746568034909,MAE 197,003,959852,Mullin; Jennifer S,9998,0,9999,1
1746568035936,MATH 2,A01,957937,Staff,33,0,35,2
1746568036959,MATH 197,001,957876,Kedlaya; Kiran S.,9993,0,9999,6
1746568037984,MCWP 40,A00,892729,Duru; Nur,10,0,20,10
1746568037984,MCWP 40,B00,893304,Montejo; Carolina,14,0,20,6
1746568039014,MCWP 40R,A00,893757,Redela; Pamela Morgan,0,5,20,20
1746568040041,MCWP 50,A00,893758,Morshed; Michael James,0,0,20,20
1746568040041,MCWP 50,B00,893761,Bartulis; Jason Michael,17,0,20,3
1746568041069,MCWP 50R,A00,893766,Compas; Sean Matthew,0,1,20,20
1746568041069,MCWP 50R,B00,893769,Carter; Jennifer A,0,1,20,20
1746568041069,MCWP 50R,C00,893771,Krone; Jarret,0,3,20,20
1746568041069,MCWP 50R,D00,893772,Miller; Elizabeth Deen,0,0,20,20
1746568041069,MCWP 50R,E00,893775,Carter; Andrea L,0,1,20,20
1746568042096,MMW 11R,A01,892721,Herbst; Matthew,11,0,27,16
1746568042096,MMW 11R,A02,892722,Herbst; Matthew,0,0,0,3
1746568043120,MMW 12R,A01,892724,Herbst; Matthew,0,11,16,16
1746568043120,MMW 12R,A02,892725,Herbst; Matthew,0,10,16,16
1746568044148,MMW 13R,A01,892727,Staff,0,4,16,16
1746568044148,MMW 13R,A02,892728,Staff,0,4,16,16
1746568044148,MMW 13R,A03,958032,Staff,0,4,16,16
1746568044148,MMW 13R,A04,958033,Staff,0,4,16,16
1746568044148,MMW 13R,A05,958034,Staff,0,4,16,16
1746568045176,SIO 295LS,A00,894015,Staff,5,0,25,20
1746568046204,SIO 295S,A00,894020,Staff,5,0,25,20
1746568047235,SIOC 290S,B01,958918,Merrifield; Mark A,14,0,30,16
1746568048264,SIOC 291S,B01,958922,Gabriel; Corey John,14,0,30,16
1746568049291,SOCI 117,A01,895339,Staff,3,0,5,2
1746568050331,WES 237B,A00,894149,Staff,11,0,20,9
1746568052403,AESE 279B,A00,891859,Staff,13,0,35,22
1746568053430,AIP 197,001,891854,Vespa; Emanuel Ignacio,9999,0,9999,0
1746568054458,ANTH 289S,A00,891856,Gagneux; Pascal,12,0,12,0
1746568055483,BENG 196,001,957946,Engler; Adam J.,9996,0,9999,3
1746568056508,BISP 197,001,959851,Wilhelm; James E.,9998,0,9999,1
1746568057533,CAT 124RS,A01,956906,Staff,6,0,25,19
1746568058558,CAT 125RS,A01,922013,Staff,6,0,25,19
1746568059583,CLRE 250,A00,891860,Morris; Sheldon,9995,0,9999,4
1746568061632,CLRE 251R,A00,907817,Mehta; Ravindra L.,9994,0,9999,5
1746568062656,CLRE 252,A00,891864,Cuomo; Raphael Eduardo,9993,0,9999,6
1746568063681,CLRE 253,A00,891867,Vaida; Florin,9994,0,9999,5
1746568063681,CLRE 253,B00,907819,Staff,9999,0,9999,0
1746568064711,CLRE 259,A00,891868,Patel; Hemal,9998,0,9999,1
1746568065737,CLRE 260,A00,891872,Cuomo; Raphael Eduardo,9999,0,9999,0
1746568066764,CLRE 297,001,891888,Cuomo; Raphael Eduardo,9999,0,9999,0
1746568067791,CSE 191,A00,958773,Minnes Kemp; Mor Mia,9995,0,9999,4
1746568068814,CSE 197,001,959846,Minnes Kemp; Mor Mia,9990,0,9999,9
1746568069845,CSS 201S,A01,892054,Mignozzetti; Umberto,25,0,30,5
1746568070869,CSS 202S,A01,892056,Mignozzetti; Umberto,25,0,30,5
1746568071895,DSC 197,001,956898,Eldridge; Justin Matthew,9996,0,9999,3
1746568072918,DSC 297,001,958000,Mazumdar; Arya,9998,0,9999,1
1746568072918,DSC 297,002,959862,Wang; Yusu,9998,0,9999,1
1746568073945,EAP 100,A00,905686,Staff,9778,0,9999,221
1746568074976,ECE 45,A01,892618,Staff,0,0,65,65
1746568077027,ECE 111,A01,892719,Staff,4,0,65,61
1746568078051,ECE 197,001,957920,Mercier; Patrick Philip,9991,0,9999,8
1746568079086,ECON 178,A01,907814,Zhu; Ying,26,0,35,9
1746568080116,EDS 115,A00,895312,Staff,35,0,45,10
1746568081139,EDS 117,A01,895337,Staff,23,0,30,7
1746568082164,EDS 125,A00,895341,Jones; Gabrielle Anastasia,36,0,45,9
1746568083189,EDS 128A,A01,895459,Fargason; Sharon Gayle,44,0,45,1
1746568084218,EDS 128B,A01,895543,Pappas; Elizabeth,44,0,45,1
1746568085241,EDS 139,A00,897203,Pappas; Elizabeth,44,0,45,1
1746568085241,EDS 139,B00,897209,Fargason; Sharon Gayle,41,0,45,4
1746568086267,EDS 201,A00,895545,Staff,22,0,45,23
1746568087290,EDS 203,A01,895581,Halter; Christopher P.,22,0,45,23
1746568088320,EDS 204R,A01,895625,Heinzman; Erica M.,39,0,45,6
1746568088320,EDS 204R,B01,895693,Halter; Christopher P.,10,0,45,35
1746568089346,EDS 206R,A00,895694,Fargason; Sharon Gayle,1,0,30,29
1746568089346,EDS 206R,B00,895695,Choi; Bailey Miyeon,16,0,30,14
1746568090373,EDS 250,A00,895697,Hemans; Patricia Ann Benitez,22,0,45,23
1746568091400,EDS 281,A00,895701,Meyerott; Theresa Ann,1,0,15,14
1746568092429,EDS 284,A00,895736,Meyerott; Theresa Ann,1,0,15,14
1746568093454,EDS 286,A00,897210,Fine; Sarah,0,0,15,15
1746568094480,EDS 289C,A01,895770,Daly; Alan J.,1,0,15,14
1746568095507,EDS 290,A00,897211,Hofstetter; Carolyn,0,0,15,15
1746568096538,LIGM 5A,A00,896162,Fischer-Grunski; Eva K,12,0,20,8
1746568097561,LIGM 5B,A00,896260,Fischer-Grunski; Eva K,17,0,20,3
1746568098592,LIGM 5C,A00,896308,Fischer-Grunski; Eva K,18,0,20,2
1746568099616,LIIT 5AS,A00,896313,Carnelos; Chiara,18,0,20,2
1746568100640,LIIT 5BS,A00,896416,Carnelos; Chiara,20,0,20,0
1746568101665,LIIT 5CS,A00,896564,Carnelos; Chiara,20,0,20,0
1746568102694,LISP 5A,A00,896588,Munoz Sanchez; Alicia,3,0,20,17
1746568103743,LISP 5B,A00,896653,Munoz Sanchez; Alicia,7,0,20,13
1746568104769,LISP 5C,A00,896655,Munoz Sanchez; Alicia,0,1,20,20
1746568105794,MAE 197,001,957918,Kleissl; Jan,9996,0,9999,3
1746568105794,MAE 197,002,959806,Boechler; Nicholas Sebastia,9998,0,9999,1
1746568105794,MAE 197,003,959852,Mullin; Jennifer S,9998,0,9999,1
1746568106823,MATH 2,A01,957937,Staff,33,0,35,2
1746568107849,MATH 197,001,957876,Kedlaya; Kiran S.,9993,0,9999,6
1746568108873,MCWP 40,A00,892729,Duru; Nur,10,0,20,10
1746568108873,MCWP 40,B00,893304,Montejo; Carolina,14,0,20,6
1746568109897,MCWP 40R,A00,893757,Redela; Pamela Morgan,0,5,20,20
1746568110926,MCWP 50,A00,893758,Morshed; Michael James,0,0,20,20
1746568110926,MCWP 50,B00,893761,Bartulis; Jason Michael,17,0,20,3
1746568111981,MCWP 50R,A00,893766,Compas; Sean Matthew,0,1,20,20
1746568111981,MCWP 50R,B00,893769,Carter; Jennifer A,0,1,20,20
1746568111981,MCWP 50R,C00,893771,Krone; Jarret,0,3,20,20
1746568111981,MCWP 50R,D00,893772,Miller; Elizabeth Deen,0,0,20,20
1746568111981,MCWP 50R,E00,893775,Carter; Andrea L,0,1,20,20
1746568113006,MMW 11R,A01,892721,Herbst; Matthew,11,0,27,16
1746568113006,MMW 11R,A02,892722,Herbst; Matthew,0,0,0,3
1746568114029,MMW 12R,A01,892724,Herbst; Matthew,0,11,16,16
1746568114029,MMW 12R,A02,892725,Herbst; Matthew,0,10,16,16
1746568115057,MMW 13R,A01,892727,Staff,0,4,16,16
1746568115057,MMW 13R,A02,892728,Staff,0,4,16,16
1746568115057,MMW 13R,A03,958032,Staff,0,4,16,16
1746568115057,MMW 13R,A04,958033,Staff,0,4,16,16
1746568115057,MMW 13R,A05,958034,Staff,0,4,16,16
1746568116087,SIO 295LS,A00,894015,Staff,5,0,25,20
1746568117112,SIO 295S,A00,894020,Staff,5,0,25,20
1746568118138,SIOC 290S,B01,958918,Merrifield; Mark A,14,0,30,16
1746568119163,SIOC 291S,B01,958922,Gabriel; Corey John,14,0,30,16
1746568120187,SOCI 117,A01,895339,Staff,3,0,5,2
1746568121211,WES 237B,A00,894149,Staff,11,0,20,9
1746568123274,AESE 279B,A00,891859,Staff,13,0,35,22
1746568124302,AIP 197,001,891854,Vespa; Emanuel Ignacio,9999,0,9999,0
1746568125330,ANTH 289S,A00,891856,Gagneux; Pascal,12,0,12,0
1746568126358,BENG 196,001,957946,Engler; Adam J.,9996,0,9999,3
1746568127386,BISP 197,001,959851,Wilhelm; James E.,9998,0,9999,1
1746568128414,CAT 124RS,A01,956906,Staff,6,0,25,19
1746568129439,CAT 125RS,A01,922013,Staff,6,0,25,19
1746568130463,CLRE 250,A00,891860,Morris; Sheldon,9995,0,9999,4
1746568132515,CLRE 251R,A00,907817,Mehta; Ravindra L.,9994,0,9999,5
1746568133544,CLRE 252,A00,891864,Cuomo; Raphael Eduardo,9993,0,9999,6
1746568134568,CLRE 253,A00,891867,Vaida; Florin,9994,0,9999,5
1746568134568,CLRE 253,B00,907819,Staff,9999,0,9999,0
1746568135597,CLRE 259,A00,891868,Patel; Hemal,9998,0,9999,1
1746568136623,CLRE 260,A00,891872,Cuomo; Raphael Eduardo,9999,0,9999,0
1746568137648,CLRE 297,001,891888,Cuomo; Raphael Eduardo,9999,0,9999,0
1746568138673,CSE 191,A00,958773,Minnes Kemp; Mor Mia,9995,0,9999,4
1746568139701,CSE 197,001,959846,Minnes Kemp; Mor Mia,9990,0,9999,9
1746568140726,CSS 201S,A01,892054,Mignozzetti; Umberto,25,0,30,5
1746568141755,CSS 202S,A01,892056,Mignozzetti; Umberto,25,0,30,5
1746568142782,DSC 197,001,956898,Eldridge; Justin Matthew,9996,0,9999,3
1746568143808,DSC 297,001,958000,Mazumdar; Arya,9998,0,9999,1
1746568143808,DSC 297,002,959862,Wang; Yusu,9998,0,9999,1
1746568144834,EAP 100,A00,905686,Staff,9778,0,9999,221
1746568145864,ECE 45,A01,892618,Staff,0,0,65,65
1746568147916,ECE 111,A01,892719,Staff,4,0,65,61
1746568148943,ECE 197,001,957920,Mercier; Patrick Philip,9991,0,9999,8
1746568149971,ECON 178,A01,907814,Zhu; Ying,26,0,35,9
1746568151001,EDS 115,A00,895312,Staff,35,0,45,10
1746568152029,EDS 117,A01,895337,Staff,23,0,30,7
1746568153058,EDS 125,A00,895341,Jones; Gabrielle Anastasia,36,0,45,9
1746568154082,EDS 128A,A01,895459,Fargason; Sharon Gayle,44,0,45,1
1746568155109,EDS 128B,A01,895543,Pappas; Elizabeth,44,0,45,1
1746568156138,EDS 139,A00,897203,Pappas; Elizabeth,44,0,45,1
1746568156138,EDS 139,B00,897209,Fargason; Sharon Gayle,41,0,45,4
1746568157163,EDS 201,A00,895545,Staff,22,0,45,23
1746568158189,EDS 203,A01,895581,Halter; Christopher P.,22,0,45,23
1746568159215,EDS 204R,A01,895625,Heinzman; Erica M.,39,0,45,6
1746568159215,EDS 204R,B01,895693,Halter; Christopher P.,10,0,45,35
1746568160240,EDS 206R,A00,895694,Fargason; Sharon Gayle,1,0,30,29
1746568160240,EDS 206R,B00,895695,Choi; Bailey Miyeon,16,0,30,14
1746568161269,EDS 250,A00,895697,Hemans; Patricia Ann Benitez,22,0,45,23
1746568162294,EDS 281,A00,895701,Meyerott; Theresa Ann,1,0,15,14
1746568163320,EDS 284,A00,895736,Meyerott; Theresa Ann,1,0,15,14
1746568164344,EDS 286,A00,897210,Fine; Sarah,0,0,15,15
1746568165369,EDS 289C,A01,895770,Daly; Alan J.,1,0,15,14
1746568166397,EDS 290,A00,897211,Hofstetter; Carolyn,0,0,15,15
1746568167422,LIGM 5A,A00,896162,Fischer-Grunski; Eva K,12,0,20,8
1746568168447,LIGM 5B,A00,896260,Fischer-Grunski; Eva K,17,0,20,3
1746568169470,LIGM 5C,A00,896308,Fischer-Grunski; Eva K,18,0,20,2
1746568170500,LIIT 5AS,A00,896313,Carnelos; Chiara,18,0,20,2
1746568171528,LIIT 5BS,A00,896416,Carnelos; Chiara,20,0,20,0
1746568172553,LIIT 5CS,A00,896564,Carnelos; Chiara,20,0,20,0
1746568173582,LISP 5A,A00,896588,Munoz Sanchez; Alicia,3,0,20,17
1746568174610,LISP 5B,A00,896653,Munoz Sanchez; Alicia,7,0,20,13
1746568175640,LISP 5C,A00,896655,Munoz Sanchez; Alicia,0,1,20,20
1746568176671,MAE 197,001,957918,Kleissl; Jan,9996,0,9999,3
1746568176671,MAE 197,002,959806,Boechler; Nicholas Sebastia,9998,0,9999,1
1746568176671,MAE 197,003,959852,Mullin; Jennifer S,9998,0,9999,1
1746568177698,MATH 2,A01,957937,Staff,33,0,35,2
1746568178723,MATH 197,001,957876,Kedlaya; Kiran S.,9993,0,9999,6
1746568179751,MCWP 40,A00,892729,Duru; Nur,10,0,20,10
1746568179751,MCWP 40,B00,893304,Montejo; Carolina,14,0,20,6
1746568180776,MCWP 40R,A00,893757,Redela; Pamela Morgan,0,5,20,20
1746568181800,MCWP 50,A00,893758,Morshed; Michael James,0,0,20,20
1746568181800,MCWP 50,B00,893761,Bartulis; Jason Michael,17,0,20,3
1746568182827,MCWP 50R,A00,893766,Compas; Sean Matthew,0,1,20,20
1746568182827,MCWP 50R,B00,893769,Carter; Jennifer A,0,1,20,20
1746568182827,MCWP 50R,C00,893771,Krone; Jarret,0,3,20,20
1746568182827,MCWP 50R,D00,893772,Miller; Elizabeth Deen,0,0,20,20
1746568182827,MCWP 50R,E00,893775,Carter; Andrea L,0,1,20,20
1746568183856,MMW 11R,A01,892721,Herbst; Matthew,11,0,27,16
1746568183856,MMW 11R,A02,892722,Herbst; Matthew,0,0,0,3
1746568184881,MMW 12R,A01,892724,Herbst; Matthew,0,11,16,16
1746568184881,MMW 12R,A02,892725,Herbst; Matthew,0,10,16,16
1746568185906,MMW 13R,A01,892727,Staff,0,4,16,16
1746568185906,MMW 13R,A02,892728,Staff,0,4,16,16
1746568185906,MMW 13R,A03,958032,Staff,0,4,16,16
1746568185906,MMW 13R,A04,958033,Staff,0,4,16,16
1746568185906,MMW 13R,A05,958034,Staff,0,4,16,16
1746568186933,SIO 295LS,A00,894015,Staff,5,0,25,20
1746568187958,SIO 295S,A00,894020,Staff,5,0,25,20
1746568188985,SIOC 290S,B01,958918,Merrifield; Mark A,14,0,30,16
1746568190014,SIOC 291S,B01,958922,Gabriel; Corey John,14,0,30,16
1746568191042,SOCI 117,A01,895339,Staff,3,0,5,2
1746568192068,WES 237B,A00,894149,Staff,11,0,20,9
1746568194128,AESE 279B,A00,891859,Staff,13,0,35,22
1746568195153,AIP 197,001,891854,Vespa; Emanuel Ignacio,9999,0,9999,0
1746568196178,ANTH 289S,A00,891856,Gagneux; Pascal,12,0,12,0
1746568197203,BENG 196,001,957946,Engler; Adam J.,9996,0,9999,3
1746568198227,BISP 197,001,959851,Wilhelm; James E.,9998,0,9999,1
1746568199252,CAT 124RS,A01,956906,Staff,6,0,25,19
1746568200277,CAT 125RS,A01,922013,Staff,6,0,25,19
1746568201305,CLRE 250,A00,891860,Morris; Sheldon,9995,0,9999,4
1746568203360,CLRE 251R,A00,907817,Mehta; Ravindra L.,9994,0,9999,5
1746568204389,CLRE 252,A00,891864,Cuomo; Raphael Eduardo,9993,0,9999,6
1746568205414,CLRE 253,A00,891867,Vaida; Florin,9994,0,9999,5
1746568205414,CLRE 253,B00,907819,Staff,9999,0,9999,0
1746568206443,CLRE 259,A00,891868,Patel; Hemal,9998,0,9999,1
1746568207469,CLRE 260,A00,891872,Cuomo; Raphael Eduardo,9999,0,9999,0
1746568208494,CLRE 297,001,891888,Cuomo; Raphael Eduardo,9999,0,9999,0
1746568209519,CSE 191,A00,958773,Minnes Kemp; Mor Mia,9995,0,9999,4
1746568210549,CSE 197,001,959846,Minnes Kemp; Mor Mia,9990,0,9999,9
1746568211574,CSS 201S,A01,892054,Mignozzetti; Umberto,25,0,30,5
1746568212601,CSS 202S,A01,892056,Mignozzetti; Umberto,25,0,30,5
1746568213626,DSC 197,001,956898,Eldridge; Justin Matthew,9996,0,9999,3
1746568214652,DSC 297,001,958000,Mazumdar; Arya,9998,0,9999,1
1746568214652,DSC 297,002,959862,Wang; Yusu,9998,0,9999,1
1746568215682,EAP 100,A00,905686,Staff,9778,0,9999,221
1746568216709,ECE 45,A01,892618,Staff,0,0,65,65
1746568218763,ECE 111,A01,892719,Staff,4,0,65,61
1746568219788,ECE 197,001,957920,Mercier; Patrick Philip,9991,0,9999,8
1746568220813,ECON 178,A01,907814,Zhu; Ying,26,0,35,9
1746568221840,EDS 115,A00,895312,Staff,35,0,45,10
1746568222865,EDS 117,A01,895337,Staff,23,0,30,7
1746568223894,EDS 125,A00,895341,Jones; Gabrielle Anastasia,36,0,45,9
1746568224925,EDS 128A,A01,895459,Fargason; Sharon Gayle,44,0,45,1
1746568225953,EDS 128B,A01,895543,Pappas; Elizabeth,44,0,45,1
1746568226983,EDS 139,A00,897203,Pappas; Elizabeth,44,0,45,1
1746568226983,EDS 139,B00,897209,Fargason; Sharon Gayle,41,0,45,4
1746568228010,EDS 201,A00,895545,Staff,22,0,45,23
1746568229034,EDS 203,A01,895581,Halter; Christopher P.,22,0,45,23
1746568230059,EDS 204R,A01,895625,Heinzman; Erica M.,39,0,45,6
1746568230059,EDS 204R,B01,895693,Halter; Christopher P.,10,0,45,35
1746568231084,EDS 206R,A00,895694,Fargason; Sharon Gayle,1,0,30,29
1746568231084,EDS 206R,B00,895695,Choi; Bailey Miyeon,16,0,30,14
1746568232110,EDS 250,A00,895697,Hemans; Patricia Ann Benitez,22,0,45,23
1746568233138,EDS 281,A00,895701,Meyerott; Theresa Ann,1,0,15,14
1746568234164,EDS 284,A00,895736,Meyerott; Theresa Ann,1,0,15,14
1746568235192,EDS 286,A00,897210,Fine; Sarah,0,0,15,15
1746568236217,EDS 289C,A01,895770,Daly; Alan J.,1,0,15,14
1746568237245,EDS 290,A00,897211,Hofstetter; Carolyn,0,0,15,15
1746568238271,LIGM 5A,A00,896162,Fischer-Grunski; Eva K,12,0,20,8
1746568239302,LIGM 5B,A00,896260,Fischer-Grunski; Eva K,17,0,20,3
1746568240329,LIGM 5C,A00,896308,Fischer-Grunski; Eva K,18,0,20,2
1746568241354,LIIT 5AS,A00,896313,Carnelos; Chiara,18,0,20,2
1746568242381,LIIT 5BS,A00,896416,Carnelos; Chiara,20,0,20,0
1746568243406,LIIT 5CS,A00,896564,Carnelos; Chiara,20,0,20,0
1746568244432,LISP 5A,A00,896588,Munoz Sanchez; Alicia,3,0,20,17
1746568245456,LISP 5B,A00,896653,Munoz Sanchez; Alicia,7,0,20,13
1746568246481,LISP 5C,A00,896655,Munoz Sanchez; Alicia,0,1,20,20
1746568247507,MAE 197,001,957918,Kleissl; Jan,9996,0,9999,3
1746568247507,MAE 197,002,959806,Boechler; Nicholas Sebastia,9998,0,9999,1
1746568247507,MAE 197,003,959852,Mullin; Jennifer S,9998,0,9999,1
1746568248531,MATH 2,A01,957937,Staff,33,0,35,2
1746568249559,MATH 197,001,957876,Kedlaya; Kiran S.,9993,0,9999,6
1746568250584,MCWP 40,A00,892729,Duru; Nur,10,0,20,10
1746568250584,MCWP 40,B00,893304,Montejo; Carolina,14,0,20,6
1746568251611,MCWP 40R,A00,893757,Redela; Pamela Morgan,0,5,20,20
1746568252638,MCWP 50,A00,893758,Morshed; Michael James,0,0,20,20
1746568252638,MCWP 50,B00,893761,Bartulis; Jason Michael,17,0,20,3
1746568253667,MCWP 50R,A00,893766,Compas; Sean Matthew,0,1,20,20
1746568253667,MCWP 50R,B00,893769,Carter; Jennifer A,0,1,20,20
1746568253667,MCWP 50R,C00,893771,Krone; Jarret,0,3,20,20
1746568253667,MCWP 50R,D00,893772,Miller; Elizabeth Deen,0,0,20,20
1746568253667,MCWP 50R,E00,893775,Carter; Andrea L,0,1,20,20
1746568254693,MMW 11R,A01,892721,Herbst; Matthew,11,0,27,16
1746568254693,MMW 11R,A02,892722,Herbst; Matthew,0,0,0,3
1746568255718,MMW 12R,A01,892724,Herbst; Matthew,0,11,16,16
1746568255718,MMW 12R,A02,892725,Herbst; Matthew,0,10,16,16
1746568256747,MMW 13R,A01,892727,Staff,0,4,16,16
1746568256747,MMW 13R,A02,892728,Staff,0,4,16,16
1746568256747,MMW 13R,A03,958032,Staff,0,4,16,16
1746568256747,MMW 13R,A04,958033,Staff,0,4,16,16
1746568256747,MMW 13R,A05,958034,Staff,0,4,16,16
1746568257771,SIO 295LS,A00,894015,Staff,5,0,25,20
1746568258802,SIO 295S,A00,894020,Staff,5,0,25,20
1746568259826,SIOC 290S,B01,958918,Merrifield; Mark A,14,0,30,16
1746568260851,SIOC 291S,B01,958922,Gabriel; Corey John,14,0,30,16
1746568261876,SOCI 117,A01,895339,Staff,3,0,5,2
1746568262904,WES 237B,A00,894149,Staff,11,0,20,9
1746568264972,AESE 279B,A00,891859,Staff,13,0,35,22
1746568265996,AIP 197,001,891854,Vespa; Emanuel Ignacio,9999,0,9999,0
1746568267021,ANTH 289S,A00,891856,Gagneux; Pascal,12,0,12,0
1746568268050,BENG 196,001,957946,Engler; Adam J.,9996,0,9999,3
1746568269078,BISP 197,001,959851,Wilhelm; James E.,9998,0,9999,1
1746568270105,CAT 124RS,A01,956906,Staff,6,0,25,19
1746568271134,CAT 125RS,A01,922013,Staff,6,0,25,19
1746568272163,CLRE 250,A00,891860,Morris; Sheldon,9995,0,9999,4
1746568274215,CLRE 251R,A00,907817,Mehta; Ravindra L.,9994,0,9999,5
1746568275243,CLRE 252,A00,891864,Cuomo; Raphael Eduardo,9993,0,9999,6
1746568276268,CLRE 253,A00,891867,Vaida; Florin,9994,0,9999,5
1746568276268,CLRE 253,B00,907819,Staff,9999,0,9999,0
1746568277294,CLRE 259,A00,891868,Patel; Hemal,9998,0,9999,1
1746568278319,CLRE 260,A00,891872,Cuomo; Raphael Eduardo,9999,0,9999,0
1746568279345,CLRE 297,001,891888,Cuomo; Raphael Eduardo,9999,0,9999,0
1746568280370,CSE 191,A00,958773,Minnes Kemp; Mor Mia,9995,0,9999,4
1746568281419,CSE 197,001,959846,Minnes Kemp; Mor Mia,9990,0,9999,9
1746568282449,CSS 201S,A01,892054,Mignozzetti; Umberto,25,0,30,5
1746568283476,CSS 202S,A01,892056,Mignozzetti; Umberto,25,0,30,5
1746568284500,DSC 197,001,956898,Eldridge; Justin Matthew,9996,0,9999,3
1746568285525,DSC 297,001,958000,Mazumdar; Arya,9998,0,9999,1
1746568285525,DSC 297,002,959862,Wang; Yusu,9998,0,9999,1
1746568286549,EAP 100,A00,905686,Staff,9778,0,9999,221
1746568287575,ECE 45,A01,892618,Staff,0,0,65,65
1746568289626,ECE 111,A01,892719,Staff,4,0,65,61
1746568290650,ECE 197,001,957920,Mercier; Patrick Philip,9991,0,9999,8
1746568291681,ECON 178,A01,907814,Zhu; Ying,26,0,35,9
1746568292708,EDS 115,A00,895312,Staff,35,0,45,10
1746568293737,EDS 117,A01,895337,Staff,23,0,30,7
1746568294762,EDS 125,A00,895341,Jones; Gabrielle Anastasia,36,0,45,9
1746568295786,EDS 128A,A01,895459,Fargason; Sharon Gayle,44,0,45,1
1746568296816,EDS 128B,A01,895543,Pappas; Elizabeth,44,0,45,1
1746568297841,EDS 139,A00,897203,Pappas; Elizabeth,44,0,45,1
1746568297841,EDS 139,B00,897209,Fargason; Sharon Gayle,41,0,45,4
1746568298883,EDS 201,A00,895545,Staff,22,0,45,23
1746568299908,EDS 203,A01,895581,Halter; Christopher P.,22,0,45,23
1746568300937,EDS 204R,A01,895625,Heinzman; Erica M.,39,0,45,6
1746568300937,EDS 204R,B01,895693,Halter; Christopher P.,10,0,45,35
1746568301964,EDS 206R,A00,895694,Fargason; Sharon Gayle,1,0,30,29
1746568301964,EDS 206R,B00,895695,Choi; Bailey Miyeon,16,0,30,14
1746568302990,EDS 250,A00,895697,Hemans; Patricia Ann Benitez,22,0,45,23
1746568304020,EDS 281,A00,895701,Meyerott; Theresa Ann,1,0,15,14
1746568305047,EDS 284,A00,895736,Meyerott; Theresa Ann,1,0,15,14
1746568306074,EDS 286,A00,897210,Fine; Sarah,0,0,15,15
1746568307102,EDS 289C,A01,895770,Daly; Alan J.,1,0,15,14
1746568308127,EDS 290,A00,897211,Hofstetter; Carolyn,0,0,15,15
1746568309152,LIGM 5A,A00,896162,Fischer-Grunski; Eva K,12,0,20,8
1746568310177,LIGM 5B,A00,896260,Fischer-Grunski; Eva K,17,0,20,3
1746568311205,LIGM 5C,A00,896308,Fischer-Grunski; Eva K,18,0,20,2
1746568312229,LIIT 5AS,A00,896313,Carnelos; Chiara,18,0,20,2
1746568313256,LIIT 5BS,A00,896416,Carnelos; Chiara,20,0,20,0
1746568314285,LIIT 5CS,A00,896564,Carnelos; Chiara,20,0,20,0
1746568315314,LISP 5A,A00,896588,Munoz Sanchez; Alicia,3,0,20,17
1746568316339,LISP 5B,A00,896653,Munoz Sanchez; Alicia,7,0,20,13
1746568317368,LISP 5C,A00,896655,Munoz Sanchez; Alicia,0,1,20,20
1746568318416,MAE 197,001,957918,Kleissl; Jan,9996,0,9999,3
1746568318416,MAE 197,002,959806,Boechler; Nicholas Sebastia,9998,0,9999,1
1746568318416,MAE 197,003,959852,Mullin; Jennifer S,9998,0,9999,1
1746568319445,MATH 2,A01,957937,Staff,33,0,35,2
1746568320473,MATH 197,001,957876,Kedlaya; Kiran S.,9993,0,9999,6
1746568321497,MCWP 40,A00,892729,Duru; Nur,10,0,20,10
1746568321497,MCWP 40,B00,893304,Montejo; Carolina,14,0,20,6
1746568322523,MCWP 40R,A00,893757,Redela; Pamela Morgan,0,5,20,20
1746568323549,MCWP 50,A00,893758,Morshed; Michael James,0,0,20,20
1746568323549,MCWP 50,B00,893761,Bartulis; Jason Michael,17,0,20,3
1746568324574,MCWP 50R,A00,893766,Compas; Sean Matthew,0,1,20,20
1746568324574,MCWP 50R,B00,893769,Carter; Jennifer A,0,1,20,20
1746568324574,MCWP 50R,C00,893771,Krone; Jarret,0,3,20,20
1746568324574,MCWP 50R,D00,893772,Miller; Elizabeth Deen,0,0,20,20
1746568324574,MCWP 50R,E00,893775,Carter; Andrea L,0,1,20,20
1746568325601,MMW 11R,A01,892721,Herbst; Matthew,11,0,27,16
1746568325601,MMW 11R,A02,892722,Herbst; Matthew,0,0,0,3
1746568326626,MMW 12R,A01,892724,Herbst; Matthew,0,11,16,16
1746568326626,MMW 12R,A02,892725,Herbst; Matthew,0,10,16,16
1746568327651,MMW 13R,A01,892727,Staff,0,4,16,16
1746568327651,MMW 13R,A02,892728,Staff,0,4,16,16
1746568327651,MMW 13R,A03,958032,Staff,0,4,16,16
1746568327651,MMW 13R,A04,958033,Staff,0,4,16,16
1746568327651,MMW 13R,A05,958034,Staff,0,4,16,16
1746568328679,SIO 295LS,A00,894015,Staff,5,0,25,20
1746568329703,SIO 295S,A00,894020,Staff,5,0,25,20
1746568330728,SIOC 290S,B01,958918,Merrifield; Mark A,14,0,30,16
1746568331753,SIOC 291S,B01,958922,Gabriel; Corey John,14,0,30,16
1746568332781,SOCI 117,A01,895339,Staff,3,0,5,2
1746568333808,WES 237B,A00,894149,Staff,11,0,20,9
1746568335866,AESE 279B,A00,891859,Staff,13,0,35,22
1746568336895,AIP 197,001,891854,Vespa; Emanuel Ignacio,9999,0,9999,0
1746568337921,ANTH 289S,A00,891856,Gagneux; Pascal,12,0,12,0
1746568338945,BENG 196,001,957946,Engler; Adam J.,9996,0,9999,3
1746568339981,BISP 197,001,959851,Wilhelm; James E.,9998,0,9999,1
1746568341010,CAT 124RS,A01,956906,Staff,6,0,25,19
1746568342036,CAT 125RS,A01,922013,Staff,6,0,25,19
1746568343062,CLRE 250,A00,891860,Morris; Sheldon,9995,0,9999,4
1746568345111,CLRE 251R,A00,907817,Mehta; Ravindra L.,9994,0,9999,5
1746568346138,CLRE 252,A00,891864,Cuomo; Raphael Eduardo,9993,0,9999,6
1746568347164,CLRE 253,A00,891867,Vaida; Florin,9994,0,9999,5
1746568347164,CLRE 253,B00,907819,Staff,9999,0,9999,0
1746568348190,CLRE 259,A00,891868,Patel; Hemal,9998,0,9999,1
1746568349216,CLRE 260,A00,891872,Cuomo; Raphael Eduardo,9999,0,9999,0
1746568350241,CLRE 297,001,891888,Cuomo; Raphael Eduardo,9999,0,9999,0
1746568351268,CSE 191,A00,958773,Minnes Kemp; Mor Mia,9995,0,9999,4
1746568352295,CSE 197,001,959846,Minnes Kemp; Mor Mia,9990,0,9999,9
1746568353325,CSS 201S,A01,892054,Mignozzetti; Umberto,25,0,30,5
1746568354355,CSS 202S,A01,892056,Mignozzetti; Umberto,25,0,30,5
1746568355382,DSC 197,001,956898,Eldridge; Justin Matthew,9996,0,9999,3
1746568356409,DSC 297,001,958000,Mazumdar; Arya,9998,0,9999,1
1746568356409,DSC 297,002,959862,Wang; Yusu,9998,0,9999,1
1746568357434,EAP 100,A00,905686,Staff,9778,0,9999,221
1746568358465,ECE 45,A01,892618,Staff,0,0,65,65
1746568360515,ECE 111,A01,892719,Staff,4,0,65,61
1746568361539,ECE 197,001,957920,Mercier; Patrick Philip,9991,0,9999,8
1746568362569,ECON 178,A01,907814,Zhu; Ying,26,0,35,9
1746568363596,EDS 115,A00,895312,Staff,35,0,45,10
1746568364621,EDS 117,A01,895337,Staff,23,0,30,7
1746568365649,EDS 125,A00,895341,Jones; Gabrielle Anastasia,36,0,45,9
1746568366678,EDS 128A,A01,895459,Fargason; Sharon Gayle,44,0,45,1
1746568367706,EDS 128B,A01,895543,Pappas; Elizabeth,44,0,45,1
1746568368733,EDS 139,A00,897203,Pappas; Elizabeth,44,0,45,1
1746568368733,EDS 139,B00,897209,Fargason; Sharon Gayle,41,0,45,4
1746568369757,EDS 201,A00,895545,Staff,22,0,45,23
1746568370781,EDS 203,A01,895581,Halter; Christopher P.,22,0,45,23
1746568371808,EDS 204R,A01,895625,Heinzman; Erica M.,39,0,45,6
1746568371808,EDS 204R,B01,895693,Halter; Christopher P.,10,0,45,35
1746568372986,EDS 206R,A00,895694,Fargason; Sharon Gayle,1,0,30,29
1746568372986,EDS 206R,B00,895695,Choi; Bailey Miyeon,16,0,30,14
1746568374011,EDS 250,A00,895697,Hemans; Patricia Ann Benitez,22,0,45,23
1746568375042,EDS 281,A00,895701,Meyerott; Theresa Ann,1,0,15,14
1746568376067,EDS 284,A00,895736,Meyerott; Theresa Ann,1,0,15,14
1746568377092,EDS 286,A00,897210,Fine; Sarah,0,0,15,15
1746568378118,EDS 289C,A01,895770,Daly; Alan J.,1,0,15,14
1746568379144,EDS 290,A00,897211,Hofstetter; Carolyn,0,0,15,15
1746568380170,LIGM 5A,A00,896162,Fischer-Grunski; Eva K,12,0,20,8
1746568381194,LIGM 5B,A00,896260,Fischer-Grunski; Eva K,17,0,20,3
1746568382226,LIGM 5C,A00,896308,Fischer-Grunski; Eva K,18,0,20,2
1746568383256,LIIT 5AS,A00,896313,Carnelos; Chiara,18,0,20,2
1746568384280,LIIT 5BS,A00,896416,Carnelos; Chiara,20,0,20,0
1746568385311,LIIT 5CS,A00,896564,Carnelos; Chiara,20,0,20,0
1746568386340,LISP 5A,A00,896588,Munoz Sanchez; Alicia,3,0,20,17
1746568387366,LISP 5B,A00,896653,Munoz Sanchez; Alicia,7,0,20,13
1746568388396,LISP 5C,A00,896655,Munoz Sanchez; Alicia,0,1,20,20
1746568389423,MAE 197,001,957918,Kleissl; Jan,9996,0,9999,3
1746568389423,MAE 197,002,959806,Boechler; Nicholas Sebastia,9998,0,9999,1
1746568389423,MAE 197,003,959852,Mullin; Jennifer S,9998,0,9999,1
1746568390448,MATH 2,A01,957937,Staff,33,0,35,2
1746568391478,MATH 197,001,957876,Kedlaya; Kiran S.,9993,0,9999,6
1746568392507,MCWP 40,A00,892729,Duru; Nur,10,0,20,10
1746568392507,MCWP 40,B00,893304,Montejo; Carolina,14,0,20,6
1746568393533,MCWP 40R,A00,893757,Redela; Pamela Morgan,0,5,20,20
1746568394559,MCWP 50,A00,893758,Morshed; Michael James,0,0,20,20
1746568394559,MCWP 50,B00,893761,Bartulis; Jason Michael,17,0,20,3
1746568395587,MCWP 50R,A00,893766,Compas; Sean Matthew,0,1,20,20
1746568395587,MCWP 50R,B00,893769,Carter; Jennifer A,0,1,20,20
1746568395587,MCWP 50R,C00,893771,Krone; Jarret,0,3,20,20
1746568395587,MCWP 50R,D00,893772,Miller; Elizabeth Deen,0,0,20,20
1746568395587,MCWP 50R,E00,893775,Carter; Andrea L,0,1,20,20
1746568396616,MMW 11R,A01,892721,Herbst; Matthew,11,0,27,16
1746568396616,MMW 11R,A02,892722,Herbst; Matthew,0,0,0,3
1746568397646,MMW 12R,A01,892724,Herbst; Matthew,0,11,16,16
1746568397646,MMW 12R,A02,892725,Herbst; Matthew,0,10,16,16
1746568398672,MMW 13R,A01,892727,Staff,0,4,16,16
1746568398672,MMW 13R,A02,892728,Staff,0,4,16,16
1746568398672,MMW 13R,A03,958032,Staff,0,4,16,16
1746568398672,MMW 13R,A04,958033,Staff,0,4,16,16
1746568398672,MMW 13R,A05,958034,Staff,0,4,16,16
1746568399698,SIO 295LS,A00,894015,Staff,5,0,25,20
1746568400722,SIO 295S,A00,894020,Staff,5,0,25,20
1746568401754,SIOC 290S,B01,958918,Merrifield; Mark A,14,0,30,16
1746568402785,SIOC 291S,B01,958922,Gabriel; Corey John,14,0,30,16
1746568403814,SOCI 117,A01,895339,Staff,3,0,5,2
1746568404838,WES 237B,A00,894149,Staff,11,0,20,9
1746568406904,AESE 279B,A00,891859,Staff,13,0,35,22
1746568407929,AIP 197,001,891854,Vespa; Emanuel Ignacio,9999,0,9999,0
1746568408954,ANTH 289S,A00,891856,Gagneux; Pascal,12,0,12,0
1746568409983,BENG 196,001,957946,Engler; Adam J.,9996,0,9999,3
1746568411008,BISP 197,001,959851,Wilhelm; James E.,9998,0,9999,1
1746568412037,CAT 124RS,A01,956906,Staff,6,0,25,19
1746568413062,CAT 125RS,A01,922013,Staff,6,0,25,19
1746568414091,CLRE 250,A00,891860,Morris; Sheldon,9995,0,9999,4
1746568416141,CLRE 251R,A00,907817,Mehta; Ravindra L.,9994,0,9999,5
1746568417171,CLRE 252,A00,891864,Cuomo; Raphael Eduardo,9993,0,9999,6
1746568418194,CLRE 253,A00,891867,Vaida; Florin,9994,0,9999,5
1746568418194,CLRE 253,B00,907819,Staff,9999,0,9999,0
1746568419218,CLRE 259,A00,891868,Patel; Hemal,9998,0,9999,1
1746568420243,CLRE 260,A00,891872,Cuomo; Raphael Eduardo,9999,0,9999,0
1746568421270,CLRE 297,001,891888,Cuomo; Raphael Eduardo,9999,0,9999,0
1746568422296,CSE 191,A00,958773,Minnes Kemp; Mor Mia,9995,0,9999,4
1746568423322,CSE 197,001,959846,Minnes Kemp; Mor Mia,9990,0,9999,9
1746568424351,CSS 201S,A01,892054,Mignozzetti; Umberto,25,0,30,5
1746568425377,CSS 202S,A01,892056,Mignozzetti; Umberto,25,0,30,5
1746568426402,DSC 197,001,956898,Eldridge; Justin Matthew,9996,0,9999,3
1746568427428,DSC 297,001,958000,Mazumdar; Arya,9998,0,9999,1
1746568427428,DSC 297,002,959862,Wang; Yusu,9998,0,9999,1
1746568428455,EAP 100,A00,905686,Staff,9778,0,9999,221
1746568429482,ECE 45,A01,892618,Staff,0,0,65,65
1746568431532,ECE 111,A01,892719,Staff,4,0,65,61
1746568432584,ECE 197,001,957920,Mercier; Patrick Philip,9991,0,9999,8
1746568433613,ECON 178,A01,907814,Zhu; Ying,26,0,35,9
1746568434638,EDS 115,A00,895312,Staff,35,0,45,10
1746568435666,EDS 117,A01,895337,Staff,23,0,30,7
1746568436692,EDS 125,A00,895341,Jones; Gabrielle Anastasia,36,0,45,9
1746568437722,EDS 128A,A01,895459,Fargason; Sharon Gayle,44,0,45,1
1746568438751,EDS 128B,A01,895543,Pappas; Elizabeth,44,0,45,1
1746568439776,EDS 139,A00,897203,Pappas; Elizabeth,44,0,45,1
1746568439776,EDS 139,B00,897209,Fargason; Sharon Gayle,41,0,45,4
1746568440803,EDS 201,A00,895545,Staff,22,0,45,23
1746568441832,EDS 203,A01,895581,Halter; Christopher P.,22,0,45,23
1746568442856,EDS 204R,A01,895625,Heinzman; Erica M.,39,0,45,6
1746568442856,EDS 204R,B01,895693,Halter; Christopher P.,10,0,45,35
1746568443882,EDS 206R,A00,895694,Fargason; Sharon Gayle,1,0,30,29
1746568443882,EDS 206R,B00,895695,Choi; Bailey Miyeon,16,0,30,14
1746568444909,EDS 250,A00,895697,Hemans; Patricia Ann Benitez,22,0,45,23
1746568445936,EDS 281,A00,895701,Meyerott; Theresa Ann,1,0,15,14
1746568446961,EDS 284,A00,895736,Meyerott; Theresa Ann,1,0,15,14
1746568447987,EDS 286,A00,897210,Fine; Sarah,0,0,15,15
1746568449014,EDS 289C,A01,895770,Daly; Alan J.,1,0,15,14
1746568450039,EDS 290,A00,897211,Hofstetter; Carolyn,0,0,15,15
1746568451066,LIGM 5A,A00,896162,Fischer-Grunski; Eva K,12,0,20,8
1746568452093,LIGM 5B,A00,896260,Fischer-Grunski; Eva K,17,0,20,3
1746568453122,LIGM 5C,A00,896308,Fischer-Grunski; Eva K,18,0,20,2
1746568454151,LIIT 5AS,A00,896313,Carnelos; Chiara,18,0,20,2
1746568455178,LIIT 5BS,A00,896416,Carnelos; Chiara,20,0,20,0
1746568456203,LIIT 5CS,A00,896564,Carnelos; Chiara,20,0,20,0
1746568457229,LISP 5A,A00,896588,Munoz Sanchez; Alicia,3,0,20,17
1746568458255,LISP 5B,A00,896653,Munoz Sanchez; Alicia,7,0,20,13
1746568459280,LISP 5C,A00,896655,Munoz Sanchez; Alicia,0,1,20,20
1746568460305,MAE 197,001,957918,Kleissl; Jan,9996,0,9999,3
1746568460305,MAE 197,002,959806,Boechler; Nicholas Sebastia,9998,0,9999,1
1746568460305,MAE 197,003,959852,Mullin; Jennifer S,9998,0,9999,1
1746568461329,MATH 2,A01,957937,Staff,33,0,35,2
1746568462353,MATH 197,001,957876,Kedlaya; Kiran S.,9993,0,9999,6
1746568463378,MCWP 40,A00,892729,Duru; Nur,10,0,20,10
1746568463378,MCWP 40,B00,893304,Montejo; Carolina,14,0,20,6
1746568464402,MCWP 40R,A00,893757,Redela; Pamela Morgan,0,5,20,20
1746568465433,MCWP 50,A00,893758,Morshed; Michael James,0,0,20,20
1746568465433,MCWP 50,B00,893761,Bartulis; Jason Michael,17,0,20,3
1746568466465,MCWP 50R,A00,893766,Compas; Sean Matthew,0,1,20,20
1746568466465,MCWP 50R,B00,893769,Carter; Jennifer A,0,1,20,20
1746568466465,MCWP 50R,C00,893771,Krone; Jarret,0,3,20,20
1746568466465,MCWP 50R,D00,893772,Miller; Elizabeth Deen,0,0,20,20
1746568466465,MCWP 50R,E00,893775,Carter; Andrea L,0,1,20,20
1746568467494,MMW 11R,A01,892721,Herbst; Matthew,11,0,27,16
1746568467494,MMW 11R,A02,892722,Herbst; Matthew,0,0,0,3
1746568468517,MMW 12R,A01,892724,Herbst; Matthew,0,11,16,16
1746568468517,MMW 12R,A02,892725,Herbst; Matthew,0,10,16,16
1746568469550,MMW 13R,A01,892727,Staff,0,4,16,16
1746568469550,MMW 13R,A02,892728,Staff,0,4,16,16
1746568469550,MMW 13R,A03,958032,Staff,0,4,16,16
1746568469550,MMW 13R,A04,958033,Staff,0,4,16,16
1746568469550,MMW 13R,A05,958034,Staff,0,4,16,16
1746568470575,SIO 295LS,A00,894015,Staff,5,0,25,20
1746568471604,SIO 295S,A00,894020,Staff,5,0,25,20
1746568472633,SIOC 290S,B01,958918,Merrifield; Mark A,14,0,30,16
1746568473660,SIOC 291S,B01,958922,Gabriel; Corey John,14,0,30,16
1746568474687,SOCI 117,A01,895339,Staff,3,0,5,2
1746568475711,WES 237B,A00,894149,Staff,11,0,20,9
1746568477776,AESE 279B,A00,891859,Staff,13,0,35,22
1746568478801,AIP 197,001,891854,Vespa; Emanuel Ignacio,9999,0,9999,0
1746568479826,ANTH 289S,A00,891856,Gagneux; Pascal,12,0,12,0
1746568480854,BENG 196,001,957946,Engler; Adam J.,9996,0,9999,3
1746568481880,BISP 197,001,959851,Wilhelm; James E.,9998,0,9999,1
1746568482905,CAT 124RS,A01,956906,Staff,6,0,25,19
1746568483932,CAT 125RS,A01,922013,Staff,6,0,25,19
1746568484956,CLRE 250,A00,891860,Morris; Sheldon,9995,0,9999,4
1746568487005,CLRE 251R,A00,907817,Mehta; Ravindra L.,9994,0,9999,5
1746568488029,CLRE 252,A00,891864,Cuomo; Raphael Eduardo,9993,0,9999,6
1746568489057,CLRE 253,A00,891867,Vaida; Florin,9994,0,9999,5
1746568489057,CLRE 253,B00,907819,Staff,9999,0,9999,0
1746568490081,CLRE 259,A00,891868,Patel; Hemal,9998,0,9999,1
1746568491106,CLRE 260,A00,891872,Cuomo; Raphael Eduardo,9999,0,9999,0
1746568492133,CLRE 297,001,891888,Cuomo; Raphael Eduardo,9999,0,9999,0
1746568493161,CSE 191,A00,958773,Minnes Kemp; Mor Mia,9995,0,9999,4
1746568494187,CSE 197,001,959846,Minnes Kemp; Mor Mia,9990,0,9999,9
1746568495211,CSS 201S,A01,892054,Mignozzetti; Umberto,25,0,30,5
1746568496236,CSS 202S,A01,892056,Mignozzetti; Umberto,25,0,30,5
1746568497261,DSC 197,001,956898,Eldridge; Justin Matthew,9996,0,9999,3
1746568498288,DSC 297,001,958000,Mazumdar; Arya,9998,0,9999,1
1746568498288,DSC 297,002,959862,Wang; Yusu,9998,0,9999,1
1746568499315,EAP 100,A00,905686,Staff,9778,0,9999,221
1746568500345,ECE 45,A01,892618,Staff,0,0,65,65
1746568502412,ECE 111,A01,892719,Staff,4,0,65,61
1746568503439,ECE 197,001,957920,Mercier; Patrick Philip,9991,0,9999,8
1746568504469,ECON 178,A01,907814,Zhu; Ying,26,0,35,9
1746568505493,EDS 115,A00,895312,Staff,35,0,45,10
1746568506517,EDS 117,A01,895337,Staff,23,0,30,7
1746568507546,EDS 125,A00,895341,Jones; Gabrielle Anastasia,36,0,45,9
1746568508574,EDS 128A,A01,895459,Fargason; Sharon Gayle,44,0,45,1
1746568509598,EDS 128B,A01,895543,Pappas; Elizabeth,44,0,45,1
1746568510622,EDS 139,A00,897203,Pappas; Elizabeth,44,0,45,1
1746568510622,EDS 139,B00,897209,Fargason; Sharon Gayle,41,0,45,4
1746568511647,EDS 201,A00,895545,Staff,22,0,45,23
1746568512676,EDS 203,A01,895581,Halter; Christopher P.,22,0,45,23
1746568513700,EDS 204R,A01,895625,Heinzman; Erica M.,39,0,45,6
1746568513700,EDS 204R,B01,895693,Halter; Christopher P.,10,0,45,35
1746568514724,EDS 206R,A00,895694,Fargason; Sharon Gayle,1,0,30,29
1746568514724,EDS 206R,B00,895695,Choi; Bailey Miyeon,16,0,30,14
1746568515752,EDS 250,A00,895697,Hemans; Patricia Ann Benitez,22,0,45,23
1746568516780,EDS 281,A00,895701,Meyerott; Theresa Ann,1,0,15,14
1746568517811,EDS 284,A00,895736,Meyerott; Theresa Ann,1,0,15,14
1746568518839,EDS 286,A00,897210,Fine; Sarah,0,0,15,15
1746568519869,EDS 289C,A01,895770,Daly; Alan J.,1,0,15,14
1746568520895,EDS 290,A00,897211,Hofstetter; Carolyn,0,0,15,15
1746568521920,LIGM 5A,A00,896162,Fischer-Grunski; Eva K,12,0,20,8
1746568522946,LIGM 5B,A00,896260,Fischer-Grunski; Eva K,17,0,20,3
1746568523975,LIGM 5C,A00,896308,Fischer-Grunski; Eva K,18,0,20,2
1746568525001,LIIT 5AS,A00,896313,Carnelos; Chiara,18,0,20,2
1746568526025,LIIT 5BS,A00,896416,Carnelos; Chiara,20,0,20,0
1746568527056,LIIT 5CS,A00,896564,Carnelos; Chiara,20,0,20,0
1746568528082,LISP 5A,A00,896588,Munoz Sanchez; Alicia,3,0,20,17
1746568529107,LISP 5B,A00,896653,Munoz Sanchez; Alicia,7,0,20,13
1746568530133,LISP 5C,A00,896655,Munoz Sanchez; Alicia,0,1,20,20
1746568531158,MAE 197,001,957918,Kleissl; Jan,9996,0,9999,3
1746568531158,MAE 197,002,959806,Boechler; Nicholas Sebastia,9998,0,9999,1
1746568531158,MAE 197,003,959852,Mullin; Jennifer S,9998,0,9999,1
1746568532185,MATH 2,A01,957937,Staff,33,0,35,2
1746568533210,MATH 197,001,957876,Kedlaya; Kiran S.,9993,0,9999,6
1746568534234,MCWP 40,A00,892729,Duru; Nur,10,0,20,10
1746568534234,MCWP 40,B00,893304,Montejo; Carolina,14,0,20,6
1746568535259,MCWP 40R,A00,893757,Redela; Pamela Morgan,0,5,20,20
1746568536286,MCWP 50,A00,893758,Morshed; Michael James,0,0,20,20
1746568536286,MCWP 50,B00,893761,Bartulis; Jason Michael,17,0,20,3
1746568537312,MCWP 50R,A00,893766,Compas; Sean Matthew,0,1,20,20
1746568537312,MCWP 50R,B00,893769,Carter; Jennifer A,0,1,20,20
1746568537312,MCWP 50R,C00,893771,Krone; Jarret,0,3,20,20
1746568537312,MCWP 50R,D00,893772,Miller; Elizabeth Deen,0,0,20,20
1746568537312,MCWP 50R,E00,893775,Carter; Andrea L,0,1,20,20
1746568538335,MMW 11R,A01,892721,Herbst; Matthew,11,0,27,16
1746568538335,MMW 11R,A02,892722,Herbst; Matthew,0,0,0,3
1746568539360,MMW 12R,A01,892724,Herbst; Matthew,0,11,16,16
1746568539360,MMW 12R,A02,892725,Herbst; Matthew,0,10,16,16
1746568540384,MMW 13R,A01,892727,Staff,0,4,16,16
1746568540384,MMW 13R,A02,892728,Staff,0,4,16,16
1746568540384,MMW 13R,A03,958032,Staff,0,4,16,16
1746568540384,MMW 13R,A04,958033,Staff,0,4,16,16
1746568540384,MMW 13R,A05,958034,Staff,0,4,16,16
1746568541415,SIO 295LS,A00,894015,Staff,5,0,25,20
1746568542445,SIO 295S,A00,894020,Staff,5,0,25,20
1746568543469,SIOC 290S,B01,958918,Merrifield; Mark A,14,0,30,16
1746568544495,SIOC 291S,B01,958922,Gabriel; Corey John,14,0,30,16
1746568545522,SOCI 117,A01,895339,Staff,3,0,5,2
1746568546548,WES 237B,A00,894149,Staff,11,0,20,9
1746568548614,AESE 279B,A00,891859,Staff,13,0,35,22
1746568549638,AIP 197,001,891854,Vespa; Emanuel Ignacio,9999,0,9999,0
1746568550662,ANTH 289S,A00,891856,Gagneux; Pascal,12,0,12,0
1746568551687,BENG 196,001,957946,Engler; Adam J.,9996,0,9999,3
1746568552712,BISP 197,001,959851,Wilhelm; James E.,9998,0,9999,1
1746568553735,CAT 124RS,A01,956906,Staff,6,0,25,19
1746568554763,CAT 125RS,A01,922013,Staff,6,0,25,19
1746568555787,CLRE 250,A00,891860,Morris; Sheldon,9995,0,9999,4
1746568557837,CLRE 251R,A00,907817,Mehta; Ravindra L.,9994,0,9999,5
1746568558865,CLRE 252,A00,891864,Cuomo; Raphael Eduardo,9993,0,9999,6
1746568559895,CLRE 253,A00,891867,Vaida; Florin,9994,0,9999,5
1746568559895,CLRE 253,B00,907819,Staff,9999,0,9999,0
1746568560920,CLRE 259,A00,891868,Patel; Hemal,9998,0,9999,1
1746568561945,CLRE 260,A00,891872,Cuomo; Raphael Eduardo,9999,0,9999,0
1746568562969,CLRE 297,001,891888,Cuomo; Raphael Eduardo,9999,0,9999,0
1746568563995,CSE 191,A00,958773,Minnes Kemp; Mor Mia,9995,0,9999,4
1746568565021,CSE 197,001,959846,Minnes Kemp; Mor Mia,9990,0,9999,9
1746568566050,CSS 201S,A01,892054,Mignozzetti; Umberto,25,0,30,5
1746568567076,CSS 202S,A01,892056,Mignozzetti; Umberto,25,0,30,5
1746568568102,DSC 197,001,956898,Eldridge; Justin Matthew,9996,0,9999,3
1746568569131,DSC 297,001,958000,Mazumdar; Arya,9998,0,9999,1
1746568569131,DSC 297,002,959862,Wang; Yusu,9998,0,9999,1
1746568570158,EAP 100,A00,905686,Staff,9778,0,9999,221
1746568571187,ECE 45,A01,892618,Staff,0,0,65,65
1746568573239,ECE 111,A01,892719,Staff,4,0,65,61
1746568574268,ECE 197,001,957920,Mercier; Patrick Philip,9991,0,9999,8
1746568575295,ECON 178,A01,907814,Zhu; Ying,26,0,35,9
1746568576322,EDS 115,A00,895312,Staff,35,0,45,10
1746568577350,EDS 117,A01,895337,Staff,23,0,30,7
1746568578375,EDS 125,A00,895341,Jones; Gabrielle Anastasia,36,0,45,9
1746568579399,EDS 128A,A01,895459,Fargason; Sharon Gayle,44,0,45,1
1746568580428,EDS 128B,A01,895543,Pappas; Elizabeth,44,0,45,1
1746568581455,EDS 139,A00,897203,Pappas; Elizabeth,44,0,45,1
1746568581455,EDS 139,B00,897209,Fargason; Sharon Gayle,41,0,45,4
1746568582480,EDS 201,A00,895545,Staff,22,0,45,23
1746568583506,EDS 203,A01,895581,Halter; Christopher P.,22,0,45,23
1746568584531,EDS 204R,A01,895625,Heinzman; Erica M.,39,0,45,6
1746568584531,EDS 204R,B01,895693,Halter; Christopher P.,10,0,45,35
1746568585556,EDS 206R,A00,895694,Fargason; Sharon Gayle,1,0,30,29
1746568585556,EDS 206R,B00,895695,Choi; Bailey Miyeon,16,0,30,14
1746568586582,EDS 250,A00,895697,Hemans; Patricia Ann Benitez,22,0,45,23
1746568587610,EDS 281,A00,895701,Meyerott; Theresa Ann,1,0,15,14
1746568588636,EDS 284,A00,895736,Meyerott; Theresa Ann,1,0,15,14
1746568589662,EDS 286,A00,897210,Fine; Sarah,0,0,15,15
1746568590690,EDS 289C,A01,895770,Daly; Alan J.,1,0,15,14
1746568591717,EDS 290,A00,897211,Hofstetter; Carolyn,0,0,15,15
1746568592741,LIGM 5A,A00,896162,Fischer-Grunski; Eva K,12,0,20,8
1746568593769,LIGM 5B,A00,896260,Fischer-Grunski; Eva K,17,0,20,3
1746568594793,LIGM 5C,A00,896308,Fischer-Grunski; Eva K,18,0,20,2
1746568595818,LIIT 5AS,A00,896313,Carnelos; Chiara,18,0,20,2
1746568596847,LIIT 5BS,A00,896416,Carnelos; Chiara,20,0,20,0
1746568597873,LIIT 5CS,A00,896564,Carnelos; Chiara,20,0,20,0
1746568598898,LISP 5A,A00,896588,Munoz Sanchez; Alicia,3,0,20,17
1746568599923,LISP 5B,A00,896653,Munoz Sanchez; Alicia,7,0,20,13
1746568600948,LISP 5C,A00,896655,Munoz Sanchez; Alicia,0,1,20,20
1746568601974,MAE 197,001,957918,Kleissl; Jan,9996,0,9999,3
1746568601974,MAE 197,002,959806,Boechler; Nicholas Sebastia,9998,0,9999,1
1746568601974,MAE 197,003,959852,Mullin; Jennifer S,9998,0,9999,1
1746568603002,MATH 2,A01,957937,Staff,33,0,35,2
1746568604026,MATH 197,001,957876,Kedlaya; Kiran S.,9993,0,9999,6
1746568605057,MCWP 40,A00,892729,Duru; Nur,10,0,20,10
1746568605057,MCWP 40,B00,893304,Montejo; Carolina,14,0,20,6
1746568606084,MCWP 40R,A00,893757,Redela; Pamela Morgan,0,5,20,20
1746568607111,MCWP 50,A00,893758,Morshed; Michael James,0,0,20,20
1746568607111,MCWP 50,B00,893761,Bartulis; Jason Michael,17,0,20,3
1746568608138,MCWP 50R,A00,893766,Compas; Sean Matthew,0,1,20,20
1746568608138,MCWP 50R,B00,893769,Carter; Jennifer A,0,1,20,20
1746568608138,MCWP 50R,C00,893771,Krone; Jarret,0,3,20,20
1746568608138,MCWP 50R,D00,893772,Miller; Elizabeth Deen,0,0,20,20
1746568608138,MCWP 50R,E00,893775,Carter; Andrea L,0,1,20,20
1746568609163,MMW 11R,A01,892721,Herbst; Matthew,11,0,27,16
1746568609163,MMW 11R,A02,892722,Herbst; Matthew,0,0,0,3
1746568610194,MMW 12R,A01,892724,Herbst; Matthew,0,11,16,16
1746568610194,MMW 12R,A02,892725,Herbst; Matthew,0,10,16,16
1746568611221,MMW 13R,A01,892727,Staff,0,4,16,16
1746568611221,MMW 13R,A02,892728,Staff,0,4,16,16
1746568611221,MMW 13R,A03,958032,Staff,0,4,16,16
1746568611221,MMW 13R,A04,958033,Staff,0,4,16,16
1746568611221,MMW 13R,A05,958034,Staff,0,4,16,16
1746568612246,SIO 295LS,A00,894015,Staff,5,0,25,20
1746568613277,SIO 295S,A00,894020,Staff,5,0,25,20
1746568614310,SIOC 290S,B01,958918,Merrifield; Mark A,14,0,30,16
1746568615341,SIOC 291S,B01,958922,Gabriel; Corey John,14,0,30,16
1746568616369,SOCI 117,A01,895339,Staff,3,0,5,2
1746568617392,WES 237B,A00,894149,Staff,11,0,20,9
1746568619463,AESE 279B,A00,891859,Staff,13,0,35,22
1746568620489,AIP 197,001,891854,Vespa; Emanuel Ignacio,9999,0,9999,0
1746568621516,ANTH 289S,A00,891856,Gagneux; Pascal,12,0,12,0
1746568622541,BENG 196,001,957946,Engler; Adam J.,9996,0,9999,3
1746568623622,BISP 197,001,959851,Wilhelm; James E.,9998,0,9999,1
1746568624647,CAT 124RS,A01,956906,Staff,6,0,25,19
1746568625673,CAT 125RS,A01,922013,Staff,6,0,25,19
1746568626701,CLRE 250,A00,891860,Morris; Sheldon,9995,0,9999,4
1746568628756,CLRE 251R,A00,907817,Mehta; Ravindra L.,9994,0,9999,5
1746568629785,CLRE 252,A00,891864,Cuomo; Raphael Eduardo,9993,0,9999,6
1746568630815,CLRE 253,A00,891867,Vaida; Florin,9994,0,9999,5
1746568630815,CLRE 253,B00,907819,Staff,9999,0,9999,0
1746568631840,CLRE 259,A00,891868,Patel; Hemal,9998,0,9999,1
1746568632871,CLRE 260,A00,891872,Cuomo; Raphael Eduardo,9999,0,9999,0
1746568633895,CLRE 297,001,891888,Cuomo; Raphael Eduardo,9999,0,9999,0
1746568634920,CSE 191,A00,958773,Minnes Kemp; Mor Mia,9995,0,9999,4
1746568635951,CSE 197,001,959846,Minnes Kemp; Mor Mia,9990,0,9999,9
1746568636978,CSS 201S,A01,892054,Mignozzetti; Umberto,25,0,30,5
1746568638003,CSS 202S,A01,892056,Mignozzetti; Umberto,25,0,30,5
1746568639029,DSC 197,001,956898,Eldridge; Justin Matthew,9996,0,9999,3
1746568640059,DSC 297,001,958000,Mazumdar; Arya,9998,0,9999,1
1746568640059,DSC 297,002,959862,Wang; Yusu,9998,0,9999,1
1746568641088,EAP 100,A00,905686,Staff,9778,0,9999,221
1746568642115,ECE 45,A01,892618,Staff,0,0,65,65
1746568644167,ECE 111,A01,892719,Staff,4,0,65,61
1746568645192,ECE 197,001,957920,Mercier; Patrick Philip,9991,0,9999,8
1746568646221,ECON 178,A01,907814,Zhu; Ying,26,0,35,9
1746568647247,EDS 115,A00,895312,Staff,35,0,45,10
1746568648275,EDS 117,A01,895337,Staff,23,0,30,7
1746568649301,EDS 125,A00,895341,Jones; Gabrielle Anastasia,36,0,45,9
1746568650327,EDS 128A,A01,895459,Fargason; Sharon Gayle,44,0,45,1
1746568651356,EDS 128B,A01,895543,Pappas; Elizabeth,44,0,45,1
1746568652384,EDS 139,A00,897203,Pappas; Elizabeth,44,0,45,1
1746568652384,EDS 139,B00,897209,Fargason; Sharon Gayle,41,0,45,4
1746568653410,EDS 201,A00,895545,Staff,22,0,45,23
1746568654439,EDS 203,A01,895581,Halter; Christopher P.,22,0,45,23
1746568655464,EDS 204R,A01,895625,Heinzman; Erica M.,39,0,45,6
1746568655464,EDS 204R,B01,895693,Halter; Christopher P.,10,0,45,35
1746568656488,EDS 206R,A00,895694,Fargason; Sharon Gayle,1,0,30,29
1746568656488,EDS 206R,B00,895695,Choi; Bailey Miyeon,16,0,30,14
1746568657517,EDS 250,A00,895697,Hemans; Patricia Ann Benitez,22,0,45,23
1746568658542,EDS 281,A00,895701,Meyerott; Theresa Ann,1,0,15,14
1746568659571,EDS 284,A00,895736,Meyerott; Theresa Ann,1,0,15,14
1746568660595,EDS 286,A00,897210,Fine; Sarah,0,0,15,15
1746568661624,EDS 289C,A01,895770,Daly; Alan J.,1,0,15,14
1746568662650,EDS 290,A00,897211,Hofstetter; Carolyn,0,0,15,15
1746568663679,LIGM 5A,A00,896162,Fischer-Grunski; Eva K,12,0,20,8
1746568664706,LIGM 5B,A00,896260,Fischer-Grunski; Eva K,17,0,20,3
1746568665732,LIGM 5C,A00,896308,Fischer-Grunski; Eva K,18,0,20,2
1746568666758,LIIT 5AS,A00,896313,Carnelos; Chiara,18,0,20,2
1746568667786,LIIT 5BS,A00,896416,Carnelos; Chiara,20,0,20,0
1746568668814,LIIT 5CS,A00,896564,Carnelos; Chiara,20,0,20,0
1746568669840,LISP 5A,A00,896588,Munoz Sanchez; Alicia,3,0,20,17
1746568670865,LISP 5B,A00,896653,Munoz Sanchez; Alicia,7,0,20,13
1746568671892,LISP 5C,A00,896655,Munoz Sanchez; Alicia,0,1,20,20
1746568672918,MAE 197,001,957918,Kleissl; Jan,9996,0,9999,3
1746568672918,MAE 197,002,959806,Boechler; Nicholas Sebastia,9998,0,9999,1
1746568672918,MAE 197,003,959852,Mullin; Jennifer S,9998,0,9999,1
1746568673943,MATH 2,A01,957937,Staff,33,0,35,2
1746568674972,MATH 197,001,957876,Kedlaya; Kiran S.,9993,0,9999,6
1746568675998,MCWP 40,A00,892729,Duru; Nur,10,0,20,10
1746568675998,MCWP 40,B00,893304,Montejo; Carolina,14,0,20,6
1746568677023,MCWP 40R,A00,893757,Redela; Pamela Morgan,0,5,20,20
1746568678049,MCWP 50,A00,893758,Morshed; Michael James,0,0,20,20
1746568678049,MCWP 50,B00,893761,Bartulis; Jason Michael,17,0,20,3
1746568679076,MCWP 50R,A00,893766,Compas; Sean Matthew,0,1,20,20
1746568679076,MCWP 50R,B00,893769,Carter; Jennifer A,0,1,20,20
1746568679076,MCWP 50R,C00,893771,Krone; Jarret,0,3,20,20
1746568679076,MCWP 50R,D00,893772,Miller; Elizabeth Deen,0,0,20,20
1746568679076,MCWP 50R,E00,893775,Carter; Andrea L,0,1,20,20
1746568680108,MMW 11R,A01,892721,Herbst; Matthew,11,0,27,16
1746568680108,MMW 11R,A02,892722,Herbst; Matthew,0,0,0,3
1746568681133,MMW 12R,A01,892724,Herbst; Matthew,0,11,16,16
1746568681133,MMW 12R,A02,892725,Herbst; Matthew,0,10,16,16
1746568682161,MMW 13R,A01,892727,Staff,0,4,16,16
1746568682161,MMW 13R,A02,892728,Staff,0,4,16,16
1746568682161,MMW 13R,A03,958032,Staff,0,4,16,16
1746568682161,MMW 13R,A04,958033,Staff,0,4,16,16
1746568682161,MMW 13R,A05,958034,Staff,0,4,16,16
1746568683186,SIO 295LS,A00,894015,Staff,5,0,25,20
1746568684215,SIO 295S,A00,894020,Staff,5,0,25,20
1746568685242,SIOC 290S,B01,958918,Merrifield; Mark A,14,0,30,16
1746568686273,SIOC 291S,B01,958922,Gabriel; Corey John,14,0,30,16
1746568687301,SOCI 117,A01,895339,Staff,3,0,5,2
1746568688330,WES 237B,A00,894149,Staff,11,0,20,9
1746568690401,AESE 279B,A00,891859,Staff,13,0,35,22
1746568691429,AIP 197,001,891854,Vespa; Emanuel Ignacio,9999,0,9999,0
1746568692461,ANTH 289S,A00,891856,Gagneux; Pascal,12,0,12,0
1746568693486,BENG 196,001,957946,Engler; Adam J.,9996,0,9999,3
1746568694518,BISP 197,001,959851,Wilhelm; James E.,9998,0,9999,1
1746568695542,CAT 124RS,A01,956906,Staff,6,0,25,19
1746568696572,CAT 125RS,A01,922013,Staff,6,0,25,19
1746568697600,CLRE 250,A00,891860,Morris; Sheldon,9995,0,9999,4
1746568699654,CLRE 251R,A00,907817,Mehta; Ravindra L.,9994,0,9999,5
1746568700683,CLRE 252,A00,891864,Cuomo; Raphael Eduardo,9993,0,9999,6
1746568701713,CLRE 253,A00,891867,Vaida; Florin,9994,0,9999,5
1746568701713,CLRE 253,B00,907819,Staff,9999,0,9999,0
1746568702745,CLRE 259,A00,891868,Patel; Hemal,9998,0,9999,1
1746568703771,CLRE 260,A00,891872,Cuomo; Raphael Eduardo,9999,0,9999,0
1746568704794,CLRE 297,001,891888,Cuomo; Raphael Eduardo,9999,0,9999,0
1746568705824,CSE 191,A00,958773,Minnes Kemp; Mor Mia,9995,0,9999,4
1746568706855,CSE 197,001,959846,Minnes Kemp; Mor Mia,9990,0,9999,9
1746568707884,CSS 201S,A01,892054,Mignozzetti; Umberto,25,0,30,5
1746568708912,CSS 202S,A01,892056,Mignozzetti; Umberto,25,0,30,5
1746568709936,DSC 197,001,956898,Eldridge; Justin Matthew,9996,0,9999,3
1746568710962,DSC 297,001,958000,Mazumdar; Arya,9998,0,9999,1
1746568710962,DSC 297,002,959862,Wang; Yusu,9998,0,9999,1
1746568711986,EAP 100,A00,905686,Staff,9778,0,9999,221
1746568713012,ECE 45,A01,892618,Staff,0,0,65,65
1746568715068,ECE 111,A01,892719,Staff,4,0,65,61
1746568716094,ECE 197,001,957920,Mercier; Patrick Philip,9991,0,9999,8
1746568717119,ECON 178,A01,907814,Zhu; Ying,26,0,35,9
1746568718146,EDS 115,A00,895312,Staff,35,0,45,10
1746568719169,EDS 117,A01,895337,Staff,23,0,30,7
1746568720194,EDS 125,A00,895341,Jones; Gabrielle Anastasia,36,0,45,9
1746568721222,EDS 128A,A01,895459,Fargason; Sharon Gayle,44,0,45,1
1746568722251,EDS 128B,A01,895543,Pappas; Elizabeth,44,0,45,1
1746568723277,EDS 139,A00,897203,Pappas; Elizabeth,44,0,45,1
1746568723277,EDS 139,B00,897209,Fargason; Sharon Gayle,41,0,45,4
1746568724302,EDS 201,A00,895545,Staff,22,0,45,23
1746568725329,EDS 203,A01,895581,Halter; Christopher P.,22,0,45,23
1746568726352,EDS 204R,A01,895625,Heinzman; Erica M.,39,0,45,6
1746568726352,EDS 204R,B01,895693,Halter; Christopher P.,10,0,45,35
1746568727375,EDS 206R,A00,895694,Fargason; Sharon Gayle,1,0,30,29
1746568727375,EDS 206R,B00,895695,Choi; Bailey Miyeon,16,0,30,14
1746568728401,EDS 250,A00,895697,Hemans; Patricia Ann Benitez,22,0,45,23
1746568729426,EDS 281,A00,895701,Meyerott; Theresa Ann,1,0,15,14
1746568730451,EDS 284,A00,895736,Meyerott; Theresa Ann,1,0,15,14
1746568731480,EDS 286,A00,897210,Fine; Sarah,0,0,15,15
1746568732505,EDS 289C,A01,895770,Daly; Alan J.,1,0,15,14
1746568733532,EDS 290,A00,897211,Hofstetter; Carolyn,0,0,15,15
1746568734558,LIGM 5A,A00,896162,Fischer-Grunski; Eva K,12,0,20,8
1746568735586,LIGM 5B,A00,896260,Fischer-Grunski; Eva K,17,0,20,3
1746568736615,LIGM 5C,A00,896308,Fischer-Grunski; Eva K,18,0,20,2
1746568737640,LIIT 5AS,A00,896313,Carnelos; Chiara,18,0,20,2
1746568738668,LIIT 5BS,A00,896416,Carnelos; Chiara,20,0,20,0
1746568739697,LIIT 5CS,A00,896564,Carnelos; Chiara,20,0,20,0
1746568740722,LISP 5A,A00,896588,Munoz Sanchez; Alicia,3,0,20,17
1746568741748,LISP 5B,A00,896653,Munoz Sanchez; Alicia,7,0,20,13
1746568742778,LISP 5C,A00,896655,Munoz Sanchez; Alicia,0,1,20,20
1746568743803,MAE 197,001,957918,Kleissl; Jan,9996,0,9999,3
1746568743803,MAE 197,002,959806,Boechler; Nicholas Sebastia,9998,0,9999,1
1746568743803,MAE 197,003,959852,Mullin; Jennifer S,9998,0,9999,1
1746568744832,MATH 2,A01,957937,Staff,33,0,35,2
1746568745857,MATH 197,001,957876,Kedlaya; Kiran S.,9993,0,9999,6
1746568746887,MCWP 40,A00,892729,Duru; Nur,10,0,20,10
1746568746887,MCWP 40,B00,893304,Montejo; Carolina,14,0,20,6
1746568747915,MCWP 40R,A00,893757,Redela; Pamela Morgan,0,5,20,20
1746568748941,MCWP 50,A00,893758,Morshed; Michael James,0,0,20,20
1746568748941,MCWP 50,B00,893761,Bartulis; Jason Michael,17,0,20,3
1746568749966,MCWP 50R,A00,893766,Compas; Sean Matthew,0,1,20,20
1746568749966,MCWP 50R,B00,893769,Carter; Jennifer A,0,1,20,20
1746568749966,MCWP 50R,C00,893771,Krone; Jarret,0,3,20,20
1746568749966,MCWP 50R,D00,893772,Miller; Elizabeth Deen,0,0,20,20
1746568749966,MCWP 50R,E00,893775,Carter; Andrea L,0,1,20,20
1746568750992,MMW 11R,A01,892721,Herbst; Matthew,11,0,27,16
1746568750992,MMW 11R,A02,892722,Herbst; Matthew,0,0,0,3
1746568752021,MMW 12R,A01,892724,Herbst; Matthew,0,11,16,16
1746568752021,MMW 12R,A02,892725,Herbst; Matthew,0,10,16,16
1746568753046,MMW 13R,A01,892727,Staff,0,4,16,16
1746568753046,MMW 13R,A02,892728,Staff,0,4,16,16
1746568753046,MMW 13R,A03,958032,Staff,0,4,16,16
1746568753046,MMW 13R,A04,958033,Staff,0,4,16,16
1746568753046,MMW 13R,A05,958034,Staff,0,4,16,16
1746568754076,SIO 295LS,A00,894015,Staff,5,0,25,20
1746568755102,SIO 295S,A00,894020,Staff,5,0,25,20
1746568756132,SIOC 290S,B01,958918,Merrifield; Mark A,14,0,30,16
1746568757182,SIOC 291S,B01,958922,Gabriel; Corey John,14,0,30,16
1746568758207,SOCI 117,A01,895339,Staff,3,0,5,2
1746568759233,WES 237B,A00,894149,Staff,11,0,20,9
1746568763839,AESE 279B,A00,891859,Staff,13,0,35,22
1746568764866,AIP 197,001,891854,Vespa; Emanuel Ignacio,9999,0,9999,0
1746568765890,ANTH 289S,A00,891856,Gagneux; Pascal,12,0,12,0
1746568766915,BENG 196,001,957946,Engler; Adam J.,9996,0,9999,3
1746568767939,BISP 197,001,959851,Wilhelm; James E.,9998,0,9999,1
1746568768965,CAT 124RS,A01,956906,Staff,6,0,25,19
1746568769992,CAT 125RS,A01,922013,Staff,6,0,25,19
1746568771021,CLRE 250,A00,891860,Morris; Sheldon,9995,0,9999,4
1746568773074,CLRE 251R,A00,907817,Mehta; Ravindra L.,9994,0,9999,5
1746568774100,CLRE 252,A00,891864,Cuomo; Raphael Eduardo,9993,0,9999,6
1746568775127,CLRE 253,A00,891867,Vaida; Florin,9994,0,9999,5
1746568775127,CLRE 253,B00,907819,Staff,9999,0,9999,0
1746568776155,CLRE 259,A00,891868,Patel; Hemal,9998,0,9999,1
1746568777184,CLRE 260,A00,891872,Cuomo; Raphael Eduardo,9999,0,9999,0
1746568778212,CLRE 297,001,891888,Cuomo; Raphael Eduardo,9999,0,9999,0
1746568779237,CSE 191,A00,958773,Minnes Kemp; Mor Mia,9995,0,9999,4
1746568780264,CSE 197,001,959846,Minnes Kemp; Mor Mia,9990,0,9999,9
1746568781297,CSS 201S,A01,892054,Mignozzetti; Umberto,25,0,30,5
1746568782327,CSS 202S,A01,892056,Mignozzetti; Umberto,25,0,30,5
1746568783351,DSC 197,001,956898,Eldridge; Justin Matthew,9996,0,9999,3
1746568784380,DSC 297,001,958000,Mazumdar; Arya,9998,0,9999,1
1746568784380,DSC 297,002,959862,Wang; Yusu,9998,0,9999,1
1746568785404,EAP 100,A00,905686,Staff,9778,0,9999,221
1746568786429,ECE 45,A01,892618,Staff,0,0,65,65
1746568788482,ECE 111,A01,892719,Staff,4,0,65,61
1746568789508,ECE 197,001,957920,Mercier; Patrick Philip,9991,0,9999,8
1746568790536,ECON 178,A01,907814,Zhu; Ying,26,0,35,9
1746568791564,EDS 115,A00,895312,Staff,35,0,45,10
1746568792588,EDS 117,A01,895337,Staff,23,0,30,7
1746568793612,EDS 125,A00,895341,Jones; Gabrielle Anastasia,36,0,45,9
1746568794637,EDS 128A,A01,895459,Fargason; Sharon Gayle,44,0,45,1
1746568795666,EDS 128B,A01,895543,Pappas; Elizabeth,44,0,45,1
1746568796693,EDS 139,A00,897203,Pappas; Elizabeth,44,0,45,1
1746568796693,EDS 139,B00,897209,Fargason; Sharon Gayle,41,0,45,4
1746568797718,EDS 201,A00,895545,Staff,22,0,45,23
1746568798745,EDS 203,A01,895581,Halter; Christopher P.,22,0,45,23
1746568799770,EDS 204R,A01,895625,Heinzman; Erica M.,39,0,45,6
1746568799770,EDS 204R,B01,895693,Halter; Christopher P.,10,0,45,35
1746568800795,EDS 206R,A00,895694,Fargason; Sharon Gayle,1,0,30,29
1746568800795,EDS 206R,B00,895695,Choi; Bailey Miyeon,16,0,30,14
1746568801821,EDS 250,A00,895697,Hemans; Patricia Ann Benitez,22,0,45,23
1746568802845,EDS 281,A00,895701,Meyerott; Theresa Ann,1,0,15,14
1746568803874,EDS 284,A00,895736,Meyerott; Theresa Ann,1,0,15,14
1746568804902,EDS 286,A00,897210,Fine; Sarah,0,0,15,15
1746568805931,EDS 289C,A01,895770,Daly; Alan J.,1,0,15,14
1746568806954,EDS 290,A00,897211,Hofstetter; Carolyn,0,0,15,15
1746568807984,LIGM 5A,A00,896162,Fischer-Grunski; Eva K,12,0,20,8
1746568809012,LIGM 5B,A00,896260,Fischer-Grunski; Eva K,17,0,20,3
1746568810042,LIGM 5C,A00,896308,Fischer-Grunski; Eva K,18,0,20,2
1746568811067,LIIT 5AS,A00,896313,Carnelos; Chiara,18,0,20,2
1746568812091,LIIT 5BS,A00,896416,Carnelos; Chiara,20,0,20,0
1746568813119,LIIT 5CS,A00,896564,Carnelos; Chiara,20,0,20,0
1746568814149,LISP 5A,A00,896588,Munoz Sanchez; Alicia,3,0,20,17
1746568815179,LISP 5B,A00,896653,Munoz Sanchez; Alicia,7,0,20,13
1746568816203,LISP 5C,A00,896655,Munoz Sanchez; Alicia,0,1,20,20
1746568817233,MAE 197,001,957918,Kleissl; Jan,9996,0,9999,3
1746568817233,MAE 197,002,959806,Boechler; Nicholas Sebastia,9998,0,9999,1
1746568817233,MAE 197,003,959852,Mullin; Jennifer S,9998,0,9999,1
1746568818261,MATH 2,A01,957937,Staff,33,0,35,2
1746568819291,MATH 197,001,957876,Kedlaya; Kiran S.,9993,0,9999,6
1746568820316,MCWP 40,A00,892729,Duru; Nur,10,0,20,10
1746568820316,MCWP 40,B00,893304,Montejo; Carolina,14,0,20,6
1746568821345,MCWP 40R,A00,893757,Redela; Pamela Morgan,0,5,20,20
1746568822369,MCWP 50,A00,893758,Morshed; Michael James,0,0,20,20
1746568822369,MCWP 50,B00,893761,Bartulis; Jason Michael,17,0,20,3
1746568823396,MCWP 50R,A00,893766,Compas; Sean Matthew,0,1,20,20
1746568823396,MCWP 50R,B00,893769,Carter; Jennifer A,0,1,20,20
1746568823396,MCWP 50R,C00,893771,Krone; Jarret,0,3,20,20
1746568823396,MCWP 50R,D00,893772,Miller; Elizabeth Deen,0,0,20,20
1746568823396,MCWP 50R,E00,893775,Carter; Andrea L,0,1,20,20
1746568824425,MMW 11R,A01,892721,Herbst; Matthew,11,0,27,16
1746568824425,MMW 11R,A02,892722,Herbst; Matthew,0,0,0,3
1746568825453,MMW 12R,A01,892724,Herbst; Matthew,0,11,16,16
1746568825453,MMW 12R,A02,892725,Herbst; Matthew,0,10,16,16
1746568826478,MMW 13R,A01,892727,Staff,0,4,16,16
1746568826478,MMW 13R,A02,892728,Staff,0,4,16,16
1746568826478,MMW 13R,A03,958032,Staff,0,4,16,16
1746568826478,MMW 13R,A04,958033,Staff,0,4,16,16
1746568826478,MMW 13R,A05,958034,Staff,0,4,16,16
1746568827715,SIO 295LS,A00,894015,Staff,5,0,25,20
1746568828739,SIO 295S,A00,894020,Staff,5,0,25,20
1746568829775,SIOC 290S,B01,958918,Merrifield; Mark A,14,0,30,16
1746568830800,SIOC 291S,B01,958922,Gabriel; Corey John,14,0,30,16
1746568831825,SOCI 117,A01,895339,Staff,3,0,5,2
1746568832851,WES 237B,A00,894149,Staff,11,0,20,9
1746568834934,AESE 279B,A00,891859,Staff,13,0,35,22
1746568835959,AIP 197,001,891854,Vespa; Emanuel Ignacio,9999,0,9999,0
1746568836985,ANTH 289S,A00,891856,Gagneux; Pascal,12,0,12,0
1746568838010,BENG 196,001,957946,Engler; Adam J.,9996,0,9999,3
1746568839037,BISP 197,001,959851,Wilhelm; James E.,9998,0,9999,1
1746568840066,CAT 124RS,A01,956906,Staff,6,0,25,19
1746568841094,CAT 125RS,A01,922013,Staff,6,0,25,19
1746568842121,CLRE 250,A00,891860,Morris; Sheldon,9995,0,9999,4
1746568844174,CLRE 251R,A00,907817,Mehta; Ravindra L.,9994,0,9999,5
1746568845199,CLRE 252,A00,891864,Cuomo; Raphael Eduardo,9993,0,9999,6
1746568846227,CLRE 253,A00,891867,Vaida; Florin,9994,0,9999,5
1746568846227,CLRE 253,B00,907819,Staff,9999,0,9999,0
1746568847252,CLRE 259,A00,891868,Patel; Hemal,9998,0,9999,1
1746568848277,CLRE 260,A00,891872,Cuomo; Raphael Eduardo,9999,0,9999,0
1746568849302,CLRE 297,001,891888,Cuomo; Raphael Eduardo,9999,0,9999,0
1746568850328,CSE 191,A00,958773,Minnes Kemp; Mor Mia,9995,0,9999,4
1746568851358,CSE 197,001,959846,Minnes Kemp; Mor Mia,9990,0,9999,9
1746568852387,CSS 201S,A01,892054,Mignozzetti; Umberto,25,0,30,5
1746568853414,CSS 202S,A01,892056,Mignozzetti; Umberto,25,0,30,5
1746568854442,DSC 197,001,956898,Eldridge; Justin Matthew,9996,0,9999,3
1746568855470,DSC 297,001,958000,Mazumdar; Arya,9998,0,9999,1
1746568855470,DSC 297,002,959862,Wang; Yusu,9998,0,9999,1
1746568856503,EAP 100,A00,905686,Staff,9778,0,9999,221
1746568857534,ECE 45,A01,892618,Staff,0,0,65,65
1746568859587,ECE 111,A01,892719,Staff,4,0,65,61
1746568860614,ECE 197,001,957920,Mercier; Patrick Philip,9991,0,9999,8
1746568861640,ECON 178,A01,907814,Zhu; Ying,26,0,35,9
1746568862665,EDS 115,A00,895312,Staff,35,0,45,10
1746568863695,EDS 117,A01,895337,Staff,23,0,30,7
1746568864721,EDS 125,A00,895341,Jones; Gabrielle Anastasia,36,0,45,9
1746568865751,EDS 128A,A01,895459,Fargason; Sharon Gayle,44,0,45,1
1746568866779,EDS 128B,A01,895543,Pappas; Elizabeth,44,0,45,1
1746568867805,EDS 139,A00,897203,Pappas; Elizabeth,44,0,45,1
1746568867805,EDS 139,B00,897209,Fargason; Sharon Gayle,41,0,45,4
1746568868830,EDS 201,A00,895545,Staff,22,0,45,23
1746568869859,EDS 203,A01,895581,Halter; Christopher P.,22,0,45,23
1746568870884,EDS 204R,A01,895625,Heinzman; Erica M.,39,0,45,6
1746568870884,EDS 204R,B01,895693,Halter; Christopher P.,10,0,45,35
1746568871909,EDS 206R,A00,895694,Fargason; Sharon Gayle,1,0,30,29
1746568871909,EDS 206R,B00,895695,Choi; Bailey Miyeon,16,0,30,14
1746568872934,EDS 250,A00,895697,Hemans; Patricia Ann Benitez,22,0,45,23
1746568873960,EDS 281,A00,895701,Meyerott; Theresa Ann,1,0,15,14
1746568874985,EDS 284,A00,895736,Meyerott; Theresa Ann,1,0,15,14
1746568876010,EDS 286,A00,897210,Fine; Sarah,0,0,15,15
1746568877035,EDS 289C,A01,895770,Daly; Alan J.,1,0,15,14
1746568878061,EDS 290,A00,897211,Hofstetter; Carolyn,0,0,15,15
1746568879089,LIGM 5A,A00,896162,Fischer-Grunski; Eva K,12,0,20,8
1746568880115,LIGM 5B,A00,896260,Fischer-Grunski; Eva K,17,0,20,3
1746568881141,LIGM 5C,A00,896308,Fischer-Grunski; Eva K,18,0,20,2
1746568882166,LIIT 5AS,A00,896313,Carnelos; Chiara,18,0,20,2
1746568883193,LIIT 5BS,A00,896416,Carnelos; Chiara,20,0,20,0
1746568884219,LIIT 5CS,A00,896564,Carnelos; Chiara,20,0,20,0
1746568885248,LISP 5A,A00,896588,Munoz Sanchez; Alicia,3,0,20,17
1746568886274,LISP 5B,A00,896653,Munoz Sanchez; Alicia,7,0,20,13
1746568887303,LISP 5C,A00,896655,Munoz Sanchez; Alicia,0,1,20,20
1746568888331,MAE 197,001,957918,Kleissl; Jan,9996,0,9999,3
1746568888331,MAE 197,002,959806,Boechler; Nicholas Sebastia,9998,0,9999,1
1746568888331,MAE 197,003,959852,Mullin; Jennifer S,9998,0,9999,1
1746568889360,MATH 2,A01,957937,Staff,33,0,35,2
1746568890387,MATH 197,001,957876,Kedlaya; Kiran S.,9993,0,9999,6
1746568891412,MCWP 40,A00,892729,Duru; Nur,10,0,20,10
1746568891412,MCWP 40,B00,893304,Montejo; Carolina,14,0,20,6
1746568892440,MCWP 40R,A00,893757,Redela; Pamela Morgan,0,5,20,20
1746568893470,MCWP 50,A00,893758,Morshed; Michael James,0,0,20,20
1746568893470,MCWP 50,B00,893761,Bartulis; Jason Michael,17,0,20,3
1746568894500,MCWP 50R,A00,893766,Compas; Sean Matthew,0,1,20,20
1746568894500,MCWP 50R,B00,893769,Carter; Jennifer A,0,1,20,20
1746568894500,MCWP 50R,C00,893771,Krone; Jarret,0,3,20,20
1746568894500,MCWP 50R,D00,893772,Miller; Elizabeth Deen,0,0,20,20
1746568894500,MCWP 50R,E00,893775,Carter; Andrea L,0,1,20,20
1746568895524,MMW 11R,A01,892721,Herbst; Matthew,11,0,27,16
1746568895524,MMW 11R,A02,892722,Herbst; Matthew,0,0,0,3
1746568896553,MMW 12R,A01,892724,Herbst; Matthew,0,11,16,16
1746568896553,MMW 12R,A02,892725,Herbst; Matthew,0,10,16,16
1746568897577,MMW 13R,A01,892727,Staff,0,4,16,16
1746568897577,MMW 13R,A02,892728,Staff,0,4,16,16
1746568897577,MMW 13R,A03,958032,Staff,0,4,16,16
1746568897577,MMW 13R,A04,958033,Staff,0,4,16,16
1746568897577,MMW 13R,A05,958034,Staff,0,4,16,16
1746568898602,SIO 295LS,A00,894015,Staff,5,0,25,20
1746568899627,SIO 295S,A00,894020,Staff,5,0,25,20
1746568900659,SIOC 290S,B01,958918,Merrifield; Mark A,14,0,30,16
1746568901685,SIOC 291S,B01,958922,Gabriel; Corey John,14,0,30,16
1746568902753,SOCI 117,A01,895339,Staff,3,0,5,2
1746568903780,WES 237B,A00,894149,Staff,11,0,20,9
1746568905837,AESE 279B,A00,891859,Staff,13,0,35,22
1746568906866,AIP 197,001,891854,Vespa; Emanuel Ignacio,9999,0,9999,0
1746568907894,ANTH 289S,A00,891856,Gagneux; Pascal,12,0,12,0
1746568908923,BENG 196,001,957946,Engler; Adam J.,9996,0,9999,3
1746568909950,BISP 197,001,959851,Wilhelm; James E.,9998,0,9999,1
1746568910978,CAT 124RS,A01,956906,Staff,6,0,25,19
1746568912005,CAT 125RS,A01,922013,Staff,6,0,25,19
1746568913029,CLRE 250,A00,891860,Morris; Sheldon,9995,0,9999,4
1746568915082,CLRE 251R,A00,907817,Mehta; Ravindra L.,9994,0,9999,5
1746568916112,CLRE 252,A00,891864,Cuomo; Raphael Eduardo,9993,0,9999,6
1746568917137,CLRE 253,A00,891867,Vaida; Florin,9994,0,9999,5
1746568917137,CLRE 253,B00,907819,Staff,9999,0,9999,0
1746568918166,CLRE 259,A00,891868,Patel; Hemal,9998,0,9999,1
1746568919194,CLRE 260,A00,891872,Cuomo; Raphael Eduardo,9999,0,9999,0
1746568920224,CLRE 297,001,891888,Cuomo; Raphael Eduardo,9999,0,9999,0
1746568921248,CSE 191,A00,958773,Minnes Kemp; Mor Mia,9995,0,9999,4
1746568922273,CSE 197,001,959846,Minnes Kemp; Mor Mia,9990,0,9999,9
1746568923305,CSS 201S,A01,892054,Mignozzetti; Umberto,25,0,30,5
1746568924330,CSS 202S,A01,892056,Mignozzetti; Umberto,25,0,30,5
1746568925356,DSC 197,001,956898,Eldridge; Justin Matthew,9996,0,9999,3
1746568926381,DSC 297,001,958000,Mazumdar; Arya,9998,0,9999,1
1746568926381,DSC 297,002,959862,Wang; Yusu,9998,0,9999,1
1746568927408,EAP 100,A00,905686,Staff,9778,0,9999,221
1746568928439,ECE 45,A01,892618,Staff,0,0,65,65
1746568930497,ECE 111,A01,892719,Staff,4,0,65,61
1746568931525,ECE 197,001,957920,Mercier; Patrick Philip,9991,0,9999,8
1746568932552,ECON 178,A01,907814,Zhu; Ying,26,0,35,9
1746568933580,EDS 115,A00,895312,Staff,35,0,45,10
1746568934608,EDS 117,A01,895337,Staff,23,0,30,7
1746568935638,EDS 125,A00,895341,Jones; Gabrielle Anastasia,36,0,45,9
1746568936668,EDS 128A,A01,895459,Fargason; Sharon Gayle,44,0,45,1
1746568937693,EDS 128B,A01,895543,Pappas; Elizabeth,44,0,45,1
1746568938718,EDS 139,A00,897203,Pappas; Elizabeth,44,0,45,1
1746568938718,EDS 139,B00,897209,Fargason; Sharon Gayle,41,0,45,4
1746568939744,EDS 201,A00,895545,Staff,22,0,45,23
1746568940770,EDS 203,A01,895581,Halter; Christopher P.,22,0,45,23
1746568941795,EDS 204R,A01,895625,Heinzman; Erica M.,39,0,45,6
1746568941795,EDS 204R,B01,895693,Halter; Christopher P.,10,0,45,35
1746568942820,EDS 206R,A00,895694,Fargason; Sharon Gayle,1,0,30,29
1746568942820,EDS 206R,B00,895695,Choi; Bailey Miyeon,16,0,30,14
1746568943845,EDS 250,A00,895697,Hemans; Patricia Ann Benitez,22,0,45,23
1746568944869,EDS 281,A00,895701,Meyerott; Theresa Ann,1,0,15,14
1746568945895,EDS 284,A00,895736,Meyerott; Theresa Ann,1,0,15,14
1746568946920,EDS 286,A00,897210,Fine; Sarah,0,0,15,15
1746568947946,EDS 289C,A01,895770,Daly; Alan J.,1,0,15,14
1746568948972,EDS 290,A00,897211,Hofstetter; Carolyn,0,0,15,15
1746568950003,LIGM 5A,A00,896162,Fischer-Grunski; Eva K,12,0,20,8
1746568951033,LIGM 5B,A00,896260,Fischer-Grunski; Eva K,17,0,20,3
1746568952059,LIGM 5C,A00,896308,Fischer-Grunski; Eva K,18,0,20,2
1746568953084,LIIT 5AS,A00,896313,Carnelos; Chiara,18,0,20,2
1746568954113,LIIT 5BS,A00,896416,Carnelos; Chiara,20,0,20,0
1746568955141,LIIT 5CS,A00,896564,Carnelos; Chiara,20,0,20,0
1746568956165,LISP 5A,A00,896588,Munoz Sanchez; Alicia,3,0,20,17
1746568957188,LISP 5B,A00,896653,Munoz Sanchez; Alicia,7,0,20,13
1746568958220,LISP 5C,A00,896655,Munoz Sanchez; Alicia,0,1,20,20
1746568959244,MAE 197,001,957918,Kleissl; Jan,9996,0,9999,3
1746568959244,MAE 197,002,959806,Boechler; Nicholas Sebastia,9998,0,9999,1
1746568959244,MAE 197,003,959852,Mullin; Jennifer S,9998,0,9999,1
1746568960267,MATH 2,A01,957937,Staff,33,0,35,2
1746568961298,MATH 197,001,957876,Kedlaya; Kiran S.,9993,0,9999,6
1746568962326,MCWP 40,A00,892729,Duru; Nur,10,0,20,10
1746568962326,MCWP 40,B00,893304,Montejo; Carolina,14,0,20,6
1746568963355,MCWP 40R,A00,893757,Redela; Pamela Morgan,0,5,20,20
1746568964382,MCWP 50,A00,893758,Morshed; Michael James,0,0,20,20
1746568964382,MCWP 50,B00,893761,Bartulis; Jason Michael,17,0,20,3
1746568965409,MCWP 50R,A00,893766,Compas; Sean Matthew,0,1,20,20
1746568965409,MCWP 50R,B00,893769,Carter; Jennifer A,0,1,20,20
1746568965409,MCWP 50R,C00,893771,Krone; Jarret,0,3,20,20
1746568965409,MCWP 50R,D00,893772,Miller; Elizabeth Deen,0,0,20,20
1746568965409,MCWP 50R,E00,893775,Carter; Andrea L,0,1,20,20
1746568966437,MMW 11R,A01,892721,Herbst; Matthew,11,0,27,16
1746568966437,MMW 11R,A02,892722,Herbst; Matthew,0,0,0,3
1746568967465,MMW 12R,A01,892724,Herbst; Matthew,0,11,16,16
1746568967465,MMW 12R,A02,892725,Herbst; Matthew,0,10,16,16
1746568968494,MMW 13R,A01,892727,Staff,0,4,16,16
1746568968494,MMW 13R,A02,892728,Staff,0,4,16,16
1746568968494,MMW 13R,A03,958032,Staff,0,4,16,16
1746568968494,MMW 13R,A04,958033,Staff,0,4,16,16
1746568968494,MMW 13R,A05,958034,Staff,0,4,16,16
1746568969519,SIO 295LS,A00,894015,Staff,5,0,25,20
1746568970544,SIO 295S,A00,894020,Staff,5,0,25,20
1746568971575,SIOC 290S,B01,958918,Merrifield; Mark A,14,0,30,16
1746568972604,SIOC 291S,B01,958922,Gabriel; Corey John,14,0,30,16
1746568973630,SOCI 117,A01,895339,Staff,3,0,5,2
1746568974654,WES 237B,A00,894149,Staff,11,0,20,9
1746568976727,AESE 279B,A00,891859,Staff,13,0,35,22
1746568977754,AIP 197,001,891854,Vespa; Emanuel Ignacio,9999,0,9999,0
1746568978781,ANTH 289S,A00,891856,Gagneux; Pascal,12,0,12,0
1746568979809,BENG 196,001,957946,Engler; Adam J.,9996,0,9999,3
1746568980839,BISP 197,001,959851,Wilhelm; James E.,9998,0,9999,1
1746568981866,CAT 124RS,A01,956906,Staff,6,0,25,19
1746568982891,CAT 125RS,A01,922013,Staff,6,0,25,19
1746568983915,CLRE 250,A00,891860,Morris; Sheldon,9995,0,9999,4
1746568985968,CLRE 251R,A00,907817,Mehta; Ravindra L.,9994,0,9999,5
1746568986993,CLRE 252,A00,891864,Cuomo; Raphael Eduardo,9993,0,9999,6
1746568988022,CLRE 253,A00,891867,Vaida; Florin,9994,0,9999,5
1746568988022,CLRE 253,B00,907819,Staff,9999,0,9999,0
1746568989047,CLRE 259,A00,891868,Patel; Hemal,9998,0,9999,1
1746568990073,CLRE 260,A00,891872,Cuomo; Raphael Eduardo,9999,0,9999,0
1746568991101,CLRE 297,001,891888,Cuomo; Raphael Eduardo,9999,0,9999,0
1746568992129,CSE 191,A00,958773,Minnes Kemp; Mor Mia,9995,0,9999,4
1746568993158,CSE 197,001,959846,Minnes Kemp; Mor Mia,9990,0,9999,9
1746568994188,CSS 201S,A01,892054,Mignozzetti; Umberto,25,0,30,5
1746568995218,CSS 202S,A01,892056,Mignozzetti; Umberto,25,0,30,5
1746568996243,DSC 197,001,956898,Eldridge; Justin Matthew,9996,0,9999,3
1746568997272,DSC 297,001,958000,Mazumdar; Arya,9998,0,9999,1
1746568997272,DSC 297,002,959862,Wang; Yusu,9998,0,9999,1
1746568998301,EAP 100,A00,905686,Staff,9778,0,9999,221
1746568999327,ECE 45,A01,892618,Staff,0,0,65,65
1746569001380,ECE 111,A01,892719,Staff,4,0,65,61
1746569002418,ECE 197,001,957920,Mercier; Patrick Philip,9991,0,9999,8
1746569003442,ECON 178,A01,907814,Zhu; Ying,26,0,35,9
1746569004470,EDS 115,A00,895312,Staff,35,0,45,10
1746569005495,EDS 117,A01,895337,Staff,23,0,30,7
1746569006566,EDS 125,A00,895341,Jones; Gabrielle Anastasia,36,0,45,9
1746569007594,EDS 128A,A01,895459,Fargason; Sharon Gayle,44,0,45,1
1746569008620,EDS 128B,A01,895543,Pappas; Elizabeth,44,0,45,1
1746569009649,EDS 139,A00,897203,Pappas; Elizabeth,44,0,45,1
1746569009649,EDS 139,B00,897209,Fargason; Sharon Gayle,41,0,45,4
1746569010676,EDS 201,A00,895545,Staff,22,0,45,23
1746569011700,EDS 203,A01,895581,Halter; Christopher P.,22,0,45,23
1746569012726,EDS 204R,A01,895625,Heinzman; Erica M.,39,0,45,6
1746569012726,EDS 204R,B01,895693,Halter; Christopher P.,10,0,45,35
1746569013753,EDS 206R,A00,895694,Fargason; Sharon Gayle,1,0,30,29
1746569013753,EDS 206R,B00,895695,Choi; Bailey Miyeon,16,0,30,14
1746569014779,EDS 250,A00,895697,Hemans; Patricia Ann Benitez,22,0,45,23
1746569015806,EDS 281,A00,895701,Meyerott; Theresa Ann,1,0,15,14
1746569016833,EDS 284,A00,895736,Meyerott; Theresa Ann,1,0,15,14
1746569017861,EDS 286,A00,897210,Fine; Sarah,0,0,15,15
1746569018886,EDS 289C,A01,895770,Daly; Alan J.,1,0,15,14
1746569019910,EDS 290,A00,897211,Hofstetter; Carolyn,0,0,15,15
1746569020938,LIGM 5A,A00,896162,Fischer-Grunski; Eva K,12,0,20,8
1746569021963,LIGM 5B,A00,896260,Fischer-Grunski; Eva K,17,0,20,3
1746569022990,LIGM 5C,A00,896308,Fischer-Grunski; Eva K,18,0,20,2
1746569024021,LIIT 5AS,A00,896313,Carnelos; Chiara,18,0,20,2
1746569025049,LIIT 5BS,A00,896416,Carnelos; Chiara,20,0,20,0
1746569026074,LIIT 5CS,A00,896564,Carnelos; Chiara,20,0,20,0
1746569027101,LISP 5A,A00,896588,Munoz Sanchez; Alicia,3,0,20,17
1746569028126,LISP 5B,A00,896653,Munoz Sanchez; Alicia,7,0,20,13
1746569029152,LISP 5C,A00,896655,Munoz Sanchez; Alicia,0,1,20,20
1746569030181,MAE 197,001,957918,Kleissl; Jan,9996,0,9999,3
1746569030181,MAE 197,002,959806,Boechler; Nicholas Sebastia,9998,0,9999,1
1746569030181,MAE 197,003,959852,Mullin; Jennifer S,9998,0,9999,1
1746569031208,MATH 2,A01,957937,Staff,33,0,35,2
1746569032235,MATH 197,001,957876,Kedlaya; Kiran S.,9993,0,9999,6
1746569033261,MCWP 40,A00,892729,Duru; Nur,10,0,20,10
1746569033261,MCWP 40,B00,893304,Montejo; Carolina,14,0,20,6
1746569034286,MCWP 40R,A00,893757,Redela; Pamela Morgan,0,5,20,20
1746569035315,MCWP 50,A00,893758,Morshed; Michael James,0,0,20,20
1746569035315,MCWP 50,B00,893761,Bartulis; Jason Michael,17,0,20,3
1746569036341,MCWP 50R,A00,893766,Compas; Sean Matthew,0,1,20,20
1746569036341,MCWP 50R,B00,893769,Carter; Jennifer A,0,1,20,20
1746569036341,MCWP 50R,C00,893771,Krone; Jarret,0,3,20,20
1746569036341,MCWP 50R,D00,893772,Miller; Elizabeth Deen,0,0,20,20
1746569036341,MCWP 50R,E00,893775,Carter; Andrea L,0,1,20,20
1746569037367,MMW 11R,A01,892721,Herbst; Matthew,11,0,27,16
1746569037367,MMW 11R,A02,892722,Herbst; Matthew,0,0,0,3
1746569038395,MMW 12R,A01,892724,Herbst; Matthew,0,11,16,16
1746569038395,MMW 12R,A02,892725,Herbst; Matthew,0,10,16,16
1746569039423,MMW 13R,A01,892727,Staff,0,4,16,16
1746569039423,MMW 13R,A02,892728,Staff,0,4,16,16
1746569039423,MMW 13R,A03,958032,Staff,0,4,16,16
1746569039423,MMW 13R,A04,958033,Staff,0,4,16,16
1746569039423,MMW 13R,A05,958034,Staff,0,4,16,16
1746569040449,SIO 295LS,A00,894015,Staff,5,0,25,20
1746569041474,SIO 295S,A00,894020,Staff,5,0,25,20
1746569042499,SIOC 290S,B01,958918,Merrifield; Mark A,14,0,30,16
1746569043531,SIOC 291S,B01,958922,Gabriel; Corey John,14,0,30,16
1746569044555,SOCI 117,A01,895339,Staff,3,0,5,2
1746569045584,WES 237B,A00,894149,Staff,11,0,20,9
1746569047639,AESE 279B,A00,891859,Staff,13,0,35,22
1746569048665,AIP 197,001,891854,Vespa; Emanuel Ignacio,9999,0,9999,0
1746569049692,ANTH 289S,A00,891856,Gagneux; Pascal,12,0,12,0
1746569050719,BENG 196,001,957946,Engler; Adam J.,9996,0,9999,3
1746569051745,BISP 197,001,959851,Wilhelm; James E.,9998,0,9999,1
1746569052769,CAT 124RS,A01,956906,Staff,6,0,25,19
1746569053794,CAT 125RS,A01,922013,Staff,6,0,25,19
1746569054821,CLRE 250,A00,891860,Morris; Sheldon,9995,0,9999,4
1746569056876,CLRE 251R,A00,907817,Mehta; Ravindra L.,9994,0,9999,5
1746569057901,CLRE 252,A00,891864,Cuomo; Raphael Eduardo,9993,0,9999,6
1746569058926,CLRE 253,A00,891867,Vaida; Florin,9994,0,9999,5
1746569058926,CLRE 253,B00,907819,Staff,9999,0,9999,0
1746569059956,CLRE 259,A00,891868,Patel; Hemal,9998,0,9999,1
1746569060982,CLRE 260,A00,891872,Cuomo; Raphael Eduardo,9999,0,9999,0
1746569062009,CLRE 297,001,891888,Cuomo; Raphael Eduardo,9999,0,9999,0
1746569063036,CSE 191,A00,958773,Minnes Kemp; Mor Mia,9995,0,9999,4
1746569064062,CSE 197,001,959846,Minnes Kemp; Mor Mia,9990,0,9999,9
1746569065086,CSS 201S,A01,892054,Mignozzetti; Umberto,25,0,30,5
1746569066114,CSS 202S,A01,892056,Mignozzetti; Umberto,25,0,30,5
1746569067143,DSC 197,001,956898,Eldridge; Justin Matthew,9996,0,9999,3
1746569068173,DSC 297,001,958000,Mazumdar; Arya,9998,0,9999,1
1746569068173,DSC 297,002,959862,Wang; Yusu,9998,0,9999,1
1746569069197,EAP 100,A00,905686,Staff,9778,0,9999,221
1746569070226,ECE 45,A01,892618,Staff,0,0,65,65
1746569072279,ECE 111,A01,892719,Staff,4,0,65,61
1746569073308,ECE 197,001,957920,Mercier; Patrick Philip,9991,0,9999,8
1746569074333,ECON 178,A01,907814,Zhu; Ying,26,0,35,9
1746569075359,EDS 115,A00,895312,Staff,35,0,45,10
1746569076385,EDS 117,A01,895337,Staff,23,0,30,7
1746569077413,EDS 125,A00,895341,Jones; Gabrielle Anastasia,36,0,45,9
1746569078440,EDS 128A,A01,895459,Fargason; Sharon Gayle,44,0,45,1
1746569079464,EDS 128B,A01,895543,Pappas; Elizabeth,44,0,45,1
1746569080490,EDS 139,A00,897203,Pappas; Elizabeth,44,0,45,1
1746569080490,EDS 139,B00,897209,Fargason; Sharon Gayle,41,0,45,4
1746569081514,EDS 201,A00,895545,Staff,22,0,45,23
1746569082542,EDS 203,A01,895581,Halter; Christopher P.,22,0,45,23
1746569083568,EDS 204R,A01,895625,Heinzman; Erica M.,39,0,45,6
1746569083568,EDS 204R,B01,895693,Halter; Christopher P.,10,0,45,35
1746569084595,EDS 206R,A00,895694,Fargason; Sharon Gayle,1,0,30,29
1746569084595,EDS 206R,B00,895695,Choi; Bailey Miyeon,16,0,30,14
1746569085625,EDS 250,A00,895697,Hemans; Patricia Ann Benitez,22,0,45,23
1746569086649,EDS 281,A00,895701,Meyerott; Theresa Ann,1,0,15,14
1746569087676,EDS 284,A00,895736,Meyerott; Theresa Ann,1,0,15,14
1746569088702,EDS 286,A00,897210,Fine; Sarah,0,0,15,15
1746569089727,EDS 289C,A01,895770,Daly; Alan J.,1,0,15,14
1746569090753,EDS 290,A00,897211,Hofstetter; Carolyn,0,0,15,15
1746569091779,LIGM 5A,A00,896162,Fischer-Grunski; Eva K,12,0,20,8
1746569092809,LIGM 5B,A00,896260,Fischer-Grunski; Eva K,17,0,20,3
1746569093838,LIGM 5C,A00,896308,Fischer-Grunski; Eva K,18,0,20,2
1746569094866,LIIT 5AS,A00,896313,Carnelos; Chiara,18,0,20,2
1746569095896,LIIT 5BS,A00,896416,Carnelos; Chiara,20,0,20,0
1746569096925,LIIT 5CS,A00,896564,Carnelos; Chiara,20,0,20,0
1746569097953,LISP 5A,A00,896588,Munoz Sanchez; Alicia,3,0,20,17
1746569098978,LISP 5B,A00,896653,Munoz Sanchez; Alicia,7,0,20,13
1746569100003,LISP 5C,A00,896655,Munoz Sanchez; Alicia,0,1,20,20
1746569101029,MAE 197,001,957918,Kleissl; Jan,9996,0,9999,3
1746569101029,MAE 197,002,959806,Boechler; Nicholas Sebastia,9998,0,9999,1
1746569101029,MAE 197,003,959852,Mullin; Jennifer S,9998,0,9999,1
1746569102059,MATH 2,A01,957937,Staff,33,0,35,2
1746569103089,MATH 197,001,957876,Kedlaya; Kiran S.,9993,0,9999,6
1746569104122,MCWP 40,A00,892729,Duru; Nur,10,0,20,10
1746569104122,MCWP 40,B00,893304,Montejo; Carolina,14,0,20,6
1746569105152,MCWP 40R,A00,893757,Redela; Pamela Morgan,0,5,20,20
1746569106181,MCWP 50,A00,893758,Morshed; Michael James,0,0,20,20
1746569106181,MCWP 50,B00,893761,Bartulis; Jason Michael,17,0,20,3
1746569107210,MCWP 50R,A00,893766,Compas; Sean Matthew,0,1,20,20
1746569107210,MCWP 50R,B00,893769,Carter; Jennifer A,0,1,20,20
1746569107210,MCWP 50R,C00,893771,Krone; Jarret,0,3,20,20
1746569107210,MCWP 50R,D00,893772,Miller; Elizabeth Deen,0,0,20,20
1746569107210,MCWP 50R,E00,893775,Carter; Andrea L,0,1,20,20
1746569108239,MMW 11R,A01,892721,Herbst; Matthew,11,0,27,16
1746569108239,MMW 11R,A02,892722,Herbst; Matthew,0,0,0,3
1746569109265,MMW 12R,A01,892724,Herbst; Matthew,0,11,16,16
1746569109265,MMW 12R,A02,892725,Herbst; Matthew,0,10,16,16
1746569110332,MMW 13R,A01,892727,Staff,0,4,16,16
1746569110332,MMW 13R,A02,892728,Staff,0,4,16,16
1746569110332,MMW 13R,A03,958032,Staff,0,4,16,16
1746569110332,MMW 13R,A04,958033,Staff,0,4,16,16
1746569110332,MMW 13R,A05,958034,Staff,0,4,16,16
1746569111358,SIO 295LS,A00,894015,Staff,5,0,25,20
1746569112383,SIO 295S,A00,894020,Staff,5,0,25,20
1746569113407,SIOC 290S,B01,958918,Merrifield; Mark A,14,0,30,16
1746569114438,SIOC 291S,B01,958922,Gabriel; Corey John,14,0,30,16
1746569115466,SOCI 117,A01,895339,Staff,3,0,5,2
1746569116494,WES 237B,A00,894149,Staff,11,0,20,9
1746569118552,AESE 279B,A00,891859,Staff,13,0,35,22
1746569119577,AIP 197,001,891854,Vespa; Emanuel Ignacio,9999,0,9999,0
1746569120602,ANTH 289S,A00,891856,Gagneux; Pascal,12,0,12,0
1746569121628,BENG 196,001,957946,Engler; Adam J.,9996,0,9999,3
1746569122652,BISP 197,001,959851,Wilhelm; James E.,9998,0,9999,1
1746569123680,CAT 124RS,A01,956906,Staff,6,0,25,19
1746569124706,CAT 125RS,A01,922013,Staff,6,0,25,19
1746569125737,CLRE 250,A00,891860,Morris; Sheldon,9995,0,9999,4
1746569127791,CLRE 251R,A00,907817,Mehta; Ravindra L.,9994,0,9999,5
1746569128816,CLRE 252,A00,891864,Cuomo; Raphael Eduardo,9993,0,9999,6
1746569129843,CLRE 253,A00,891867,Vaida; Florin,9994,0,9999,5
1746569129843,CLRE 253,B00,907819,Staff,9999,0,9999,0
1746569130889,CLRE 259,A00,891868,Patel; Hemal,9998,0,9999,1
1746569131915,CLRE 260,A00,891872,Cuomo; Raphael Eduardo,9999,0,9999,0
1746569132941,CLRE 297,001,891888,Cuomo; Raphael Eduardo,9999,0,9999,0
1746569133967,CSE 191,A00,958773,Minnes Kemp; Mor Mia,9995,0,9999,4
1746569134996,CSE 197,001,959846,Minnes Kemp; Mor Mia,9990,0,9999,9
1746569136026,CSS 201S,A01,892054,Mignozzetti; Umberto,25,0,30,5
1746569137052,CSS 202S,A01,892056,Mignozzetti; Umberto,25,0,30,5
1746569138079,DSC 197,001,956898,Eldridge; Justin Matthew,9996,0,9999,3
1746569139107,DSC 297,001,958000,Mazumdar; Arya,9998,0,9999,1
1746569139107,DSC 297,002,959862,Wang; Yusu,9998,0,9999,1
1746569140135,EAP 100,A00,905686,Staff,9778,0,9999,221
1746569141164,ECE 45,A01,892618,Staff,0,0,65,65
1746569143216,ECE 111,A01,892719,Staff,4,0,65,61
1746569144245,ECE 197,001,957920,Mercier; Patrick Philip,9991,0,9999,8
1746569145278,ECON 178,A01,907814,Zhu; Ying,26,0,35,9
1746569146304,EDS 115,A00,895312,Staff,35,0,45,10
1746569147330,EDS 117,A01,895337,Staff,23,0,30,7
1746569148355,EDS 125,A00,895341,Jones; Gabrielle Anastasia,36,0,45,9
1746569149380,EDS 128A,A01,895459,Fargason; Sharon Gayle,44,0,45,1
1746569150404,EDS 128B,A01,895543,Pappas; Elizabeth,44,0,45,1
1746569151430,EDS 139,A00,897203,Pappas; Elizabeth,44,0,45,1
1746569151430,EDS 139,B00,897209,Fargason; Sharon Gayle,41,0,45,4
1746569152454,EDS 201,A00,895545,Staff,22,0,45,23
1746569153482,EDS 203,A01,895581,Halter; Christopher P.,22,0,45,23
1746569154509,EDS 204R,A01,895625,Heinzman; Erica M.,39,0,45,6
1746569154509,EDS 204R,B01,895693,Halter; Christopher P.,10,0,45,35
1746569155536,EDS 206R,A00,895694,Fargason; Sharon Gayle,1,0,30,29
1746569155536,EDS 206R,B00,895695,Choi; Bailey Miyeon,16,0,30,14
1746569156565,EDS 250,A00,895697,Hemans; Patricia Ann Benitez,22,0,45,23
1746569157591,EDS 281,A00,895701,Meyerott; Theresa Ann,1,0,15,14
1746569158616,EDS 284,A00,895736,Meyerott; Theresa Ann,1,0,15,14
1746569159642,EDS 286,A00,897210,Fine; Sarah,0,0,15,15
1746569160667,EDS 289C,A01,895770,Daly; Alan J.,1,0,15,14
1746569161695,EDS 290,A00,897211,Hofstetter; Carolyn,0,0,15,15
1746569162719,LIGM 5A,A00,896162,Fischer-Grunski; Eva K,12,0,20,8
1746569163745,LIGM 5B,A00,896260,Fischer-Grunski; Eva K,17,0,20,3
1746569164774,LIGM 5C,A00,896308,Fischer-Grunski; Eva K,18,0,20,2
1746569165800,LIIT 5AS,A00,896313,Carnelos; Chiara,18,0,20,2
1746569166829,LIIT 5BS,A00,896416,Carnelos; Chiara,20,0,20,0
1746569167856,LIIT 5CS,A00,896564,Carnelos; Chiara,20,0,20,0
1746569168881,LISP 5A,A00,896588,Munoz Sanchez; Alicia,3,0,20,17
1746569169906,LISP 5B,A00,896653,Munoz Sanchez; Alicia,7,0,20,13
1746569170935,LISP 5C,A00,896655,Munoz Sanchez; Alicia,0,1,20,20
1746569171960,MAE 197,001,957918,Kleissl; Jan,9996,0,9999,3
1746569171960,MAE 197,002,959806,Boechler; Nicholas Sebastia,9998,0,9999,1
1746569171960,MAE 197,003,959852,Mullin; Jennifer S,9998,0,9999,1
1746569172990,MATH 2,A01,957937,Staff,33,0,35,2
1746569174015,MATH 197,001,957876,Kedlaya; Kiran S.,9993,0,9999,6
1746569175042,MCWP 40,A00,892729,Duru; Nur,10,0,20,10
1746569175042,MCWP 40,B00,893304,Montejo; Carolina,14,0,20,6
1746569176067,MCWP 40R,A00,893757,Redela; Pamela Morgan,0,5,20,20
1746569177096,MCWP 50,A00,893758,Morshed; Michael James,0,0,20,20
1746569177096,MCWP 50,B00,893761,Bartulis; Jason Michael,17,0,20,3
1746569178128,MCWP 50R,A00,893766,Compas; Sean Matthew,0,1,20,20
1746569178128,MCWP 50R,B00,893769,Carter; Jennifer A,0,1,20,20
1746569178128,MCWP 50R,C00,893771,Krone; Jarret,0,3,20,20
1746569178128,MCWP 50R,D00,893772,Miller; Elizabeth Deen,0,0,20,20
1746569178128,MCWP 50R,E00,893775,Carter; Andrea L,0,1,20,20
1746569179157,MMW 11R,A01,892721,Herbst; Matthew,11,0,27,16
1746569179157,MMW 11R,A02,892722,Herbst; Matthew,0,0,0,3
1746569180184,MMW 12R,A01,892724,Herbst; Matthew,0,11,16,16
1746569180184,MMW 12R,A02,892725,Herbst; Matthew,0,10,16,16
1746569181212,MMW 13R,A01,892727,Staff,0,4,16,16
1746569181212,MMW 13R,A02,892728,Staff,0,4,16,16
1746569181212,MMW 13R,A03,958032,Staff,0,4,16,16
1746569181212,MMW 13R,A04,958033,Staff,0,4,16,16
1746569181212,MMW 13R,A05,958034,Staff,0,4,16,16
1746569182239,SIO 295LS,A00,894015,Staff,5,0,25,20
1746569183265,SIO 295S,A00,894020,Staff,5,0,25,20
1746569184295,SIOC 290S,B01,958918,Merrifield; Mark A,14,0,30,16
1746569185326,SIOC 291S,B01,958922,Gabriel; Corey John,14,0,30,16
1746569186353,SOCI 117,A01,895339,Staff,3,0,5,2
1746569187382,WES 237B,A00,894149,Staff,11,0,20,9
1746569189451,AESE 279B,A00,891859,Staff,13,0,35,22
1746569190476,AIP 197,001,891854,Vespa; Emanuel Ignacio,9999,0,9999,0
1746569191500,ANTH 289S,A00,891856,Gagneux; Pascal,12,0,12,0
1746569192527,BENG 196,001,957946,Engler; Adam J.,9996,0,9999,3
1746569193554,BISP 197,001,959851,Wilhelm; James E.,9998,0,9999,1
1746569194579,CAT 124RS,A01,956906,Staff,6,0,25,19
1746569195607,CAT 125RS,A01,922013,Staff,6,0,25,19
1746569196633,CLRE 250,A00,891860,Morris; Sheldon,9995,0,9999,4
1746569198694,CLRE 251R,A00,907817,Mehta; Ravindra L.,9994,0,9999,5
1746569199724,CLRE 252,A00,891864,Cuomo; Raphael Eduardo,9993,0,9999,6
1746569200749,CLRE 253,A00,891867,Vaida; Florin,9994,0,9999,5
1746569200749,CLRE 253,B00,907819,Staff,9999,0,9999,0
1746569201778,CLRE 259,A00,891868,Patel; Hemal,9998,0,9999,1
1746569202802,CLRE 260,A00,891872,Cuomo; Raphael Eduardo,9999,0,9999,0
1746569203829,CLRE 297,001,891888,Cuomo; Raphael Eduardo,9999,0,9999,0
1746569204853,CSE 191,A00,958773,Minnes Kemp; Mor Mia,9995,0,9999,4
1746569205882,CSE 197,001,959846,Minnes Kemp; Mor Mia,9990,0,9999,9
1746569206907,CSS 201S,A01,892054,Mignozzetti; Umberto,25,0,30,5
1746569207935,CSS 202S,A01,892056,Mignozzetti; Umberto,25,0,30,5
1746569208961,DSC 197,001,956898,Eldridge; Justin Matthew,9996,0,9999,3
1746569209986,DSC 297,001,958000,Mazumdar; Arya,9998,0,9999,1
1746569209986,DSC 297,002,959862,Wang; Yusu,9998,0,9999,1
1746569211015,EAP 100,A00,905686,Staff,9778,0,9999,221
1746569212043,ECE 45,A01,892618,Staff,0,0,65,65
1746569214092,ECE 111,A01,892719,Staff,4,0,65,61
1746569215120,ECE 197,001,957920,Mercier; Patrick Philip,9991,0,9999,8
1746569216147,ECON 178,A01,907814,Zhu; Ying,26,0,35,9
1746569217172,EDS 115,A00,895312,Staff,35,0,45,10
1746569218196,EDS 117,A01,895337,Staff,23,0,30,7
1746569219221,EDS 125,A00,895341,Jones; Gabrielle Anastasia,36,0,45,9
1746569220246,EDS 128A,A01,895459,Fargason; Sharon Gayle,44,0,45,1
1746569221271,EDS 128B,A01,895543,Pappas; Elizabeth,44,0,45,1
1746569222296,EDS 139,A00,897203,Pappas; Elizabeth,44,0,45,1
1746569222296,EDS 139,B00,897209,Fargason; Sharon Gayle,41,0,45,4
1746569223321,EDS 201,A00,895545,Staff,22,0,45,23
1746569224348,EDS 203,A01,895581,Halter; Christopher P.,22,0,45,23
1746569225378,EDS 204R,A01,895625,Heinzman; Erica M.,39,0,45,6
1746569225378,EDS 204R,B01,895693,Halter; Christopher P.,10,0,45,35
1746569226407,EDS 206R,A00,895694,Fargason; Sharon Gayle,1,0,30,29
1746569226407,EDS 206R,B00,895695,Choi; Bailey Miyeon,16,0,30,14
1746569227433,EDS 250,A00,895697,Hemans; Patricia Ann Benitez,22,0,45,23
1746569228463,EDS 281,A00,895701,Meyerott; Theresa Ann,1,0,15,14
1746569229487,EDS 284,A00,895736,Meyerott; Theresa Ann,1,0,15,14
1746569230517,EDS 286,A00,897210,Fine; Sarah,0,0,15,15
1746569231546,EDS 289C,A01,895770,Daly; Alan J.,1,0,15,14
1746569232574,EDS 290,A00,897211,Hofstetter; Carolyn,0,0,15,15
1746569233602,LIGM 5A,A00,896162,Fischer-Grunski; Eva K,12,0,20,8
1746569234629,LIGM 5B,A00,896260,Fischer-Grunski; Eva K,17,0,20,3
1746569235658,LIGM 5C,A00,896308,Fischer-Grunski; Eva K,18,0,20,2
1746569236684,LIIT 5AS,A00,896313,Carnelos; Chiara,18,0,20,2
1746569237708,LIIT 5BS,A00,896416,Carnelos; Chiara,20,0,20,0
1746569238734,LIIT 5CS,A00,896564,Carnelos; Chiara,20,0,20,0
1746569239764,LISP 5A,A00,896588,Munoz Sanchez; Alicia,3,0,20,17
1746569240788,LISP 5B,A00,896653,Munoz Sanchez; Alicia,7,0,20,13
1746569241817,LISP 5C,A00,896655,Munoz Sanchez; Alicia,0,1,20,20
1746569242844,MAE 197,001,957918,Kleissl; Jan,9996,0,9999,3
1746569242844,MAE 197,002,959806,Boechler; Nicholas Sebastia,9998,0,9999,1
1746569242844,MAE 197,003,959852,Mullin; Jennifer S,9998,0,9999,1
1746569243868,MATH 2,A01,957937,Staff,33,0,35,2
1746569244897,MATH 197,001,957876,Kedlaya; Kiran S.,9993,0,9999,6
1746569245926,MCWP 40,A00,892729,Duru; Nur,10,0,20,10
1746569245926,MCWP 40,B00,893304,Montejo; Carolina,14,0,20,6
1746569246950,MCWP 40R,A00,893757,Redela; Pamela Morgan,0,5,20,20
1746569247978,MCWP 50,A00,893758,Morshed; Michael James,0,0,20,20
1746569247978,MCWP 50,B00,893761,Bartulis; Jason Michael,17,0,20,3
1746569249005,MCWP 50R,A00,893766,Compas; Sean Matthew,0,1,20,20
1746569249005,MCWP 50R,B00,893769,Carter; Jennifer A,0,1,20,20
1746569249005,MCWP 50R,C00,893771,Krone; Jarret,0,3,20,20
1746569249005,MCWP 50R,D00,893772,Miller; Elizabeth Deen,0,0,20,20
1746569249005,MCWP 50R,E00,893775,Carter; Andrea L,0,1,20,20
1746569250034,MMW 11R,A01,892721,Herbst; Matthew,11,0,27,16
1746569250034,MMW 11R,A02,892722,Herbst; Matthew,0,0,0,3
1746569251061,MMW 12R,A01,892724,Herbst; Matthew,0,11,16,16
1746569251061,MMW 12R,A02,892725,Herbst; Matthew,0,10,16,16
1746569252085,MMW 13R,A01,892727,Staff,0,4,16,16
1746569252085,MMW 13R,A02,892728,Staff,0,4,16,16
1746569252085,MMW 13R,A03,958032,Staff,0,4,16,16
1746569252085,MMW 13R,A04,958033,Staff,0,4,16,16
1746569252085,MMW 13R,A05,958034,Staff,0,4,16,16
1746569253110,SIO 295LS,A00,894015,Staff,5,0,25,20
1746569254136,SIO 295S,A00,894020,Staff,5,0,25,20
1746569255161,SIOC 290S,B01,958918,Merrifield; Mark A,14,0,30,16
1746569256188,SIOC 291S,B01,958922,Gabriel; Corey John,14,0,30,16
1746569257215,SOCI 117,A01,895339,Staff,3,0,5,2
1746569258242,WES 237B,A00,894149,Staff,11,0,20,9
1746569260309,AESE 279B,A00,891859,Staff,13,0,35,22
1746569261336,AIP 197,001,891854,Vespa; Emanuel Ignacio,9999,0,9999,0
1746569262399,ANTH 289S,A00,891856,Gagneux; Pascal,12,0,12,0
1746569263425,BENG 196,001,957946,Engler; Adam J.,9996,0,9999,3
1746569264451,BISP 197,001,959851,Wilhelm; James E.,9998,0,9999,1
1746569265477,CAT 124RS,A01,956906,Staff,6,0,25,19
1746569266624,CAT 125RS,A01,922013,Staff,6,0,25,19
1746569267651,CLRE 250,A00,891860,Morris; Sheldon,9995,0,9999,4
1746569269705,CLRE 251R,A00,907817,Mehta; Ravindra L.,9994,0,9999,5
1746569270730,CLRE 252,A00,891864,Cuomo; Raphael Eduardo,9993,0,9999,6
1746569271757,CLRE 253,A00,891867,Vaida; Florin,9994,0,9999,5
1746569271757,CLRE 253,B00,907819,Staff,9999,0,9999,0
1746569272785,CLRE 259,A00,891868,Patel; Hemal,9998,0,9999,1
1746569273813,CLRE 260,A00,891872,Cuomo; Raphael Eduardo,9999,0,9999,0
1746569274839,CLRE 297,001,891888,Cuomo; Raphael Eduardo,9999,0,9999,0
1746569275864,CSE 191,A00,958773,Minnes Kemp; Mor Mia,9995,0,9999,4
1746569276888,CSE 197,001,959846,Minnes Kemp; Mor Mia,9990,0,9999,9
1746569277917,CSS 201S,A01,892054,Mignozzetti; Umberto,25,0,30,5
1746569278947,CSS 202S,A01,892056,Mignozzetti; Umberto,25,0,30,5
1746569279988,DSC 197,001,956898,Eldridge; Justin Matthew,9996,0,9999,3
1746569281041,DSC 297,001,958000,Mazumdar; Arya,9998,0,9999,1
1746569281041,DSC 297,002,959862,Wang; Yusu,9998,0,9999,1
1746569282067,EAP 100,A00,905686,Staff,9778,0,9999,221
1746569283096,ECE 45,A01,892618,Staff,0,0,65,65
1746569285150,ECE 111,A01,892719,Staff,4,0,65,61
1746569286175,ECE 197,001,957920,Mercier; Patrick Philip,9991,0,9999,8
1746569287203,ECON 178,A01,907814,Zhu; Ying,26,0,35,9
1746569288231,EDS 115,A00,895312,Staff,35,0,45,10
1746569289260,EDS 117,A01,895337,Staff,23,0,30,7
1746569290286,EDS 125,A00,895341,Jones; Gabrielle Anastasia,36,0,45,9
1746569291317,EDS 128A,A01,895459,Fargason; Sharon Gayle,44,0,45,1
1746569292341,EDS 128B,A01,895543,Pappas; Elizabeth,44,0,45,1
1746569293367,EDS 139,A00,897203,Pappas; Elizabeth,44,0,45,1
1746569293367,EDS 139,B00,897209,Fargason; Sharon Gayle,41,0,45,4
1746569294396,EDS 201,A00,895545,Staff,22,0,45,23
1746569295422,EDS 203,A01,895581,Halter; Christopher P.,22,0,45,23
1746569296448,EDS 204R,A01,895625,Heinzman; Erica M.,39,0,45,6
1746569296448,EDS 204R,B01,895693,Halter; Christopher P.,10,0,45,35
1746569297474,EDS 206R,A00,895694,Fargason; Sharon Gayle,1,0,30,29
1746569297474,EDS 206R,B00,895695,Choi; Bailey Miyeon,16,0,30,14
1746569298498,EDS 250,A00,895697,Hemans; Patricia Ann Benitez,22,0,45,23
1746569299523,EDS 281,A00,895701,Meyerott; Theresa Ann,1,0,15,14
1746569300548,EDS 284,A00,895736,Meyerott; Theresa Ann,1,0,15,14
1746569301573,EDS 286,A00,897210,Fine; Sarah,0,0,15,15
1746569302600,EDS 289C,A01,895770,Daly; Alan J.,1,0,15,14
1746569303628,EDS 290,A00,897211,Hofstetter; Carolyn,0,0,15,15
1746569304659,LIGM 5A,A00,896162,Fischer-Grunski; Eva K,12,0,20,8
1746569305687,LIGM 5B,A00,896260,Fischer-Grunski; Eva K,17,0,20,3
1746569306714,LIGM 5C,A00,896308,Fischer-Grunski; Eva K,18,0,20,2
1746569307740,LIIT 5AS,A00,896313,Carnelos; Chiara,18,0,20,2
1746569308770,LIIT 5BS,A00,896416,Carnelos; Chiara,20,0,20,0
1746569309799,LIIT 5CS,A00,896564,Carnelos; Chiara,20,0,20,0
1746569310826,LISP 5A,A00,896588,Munoz Sanchez; Alicia,3,0,20,17
1746569311852,LISP 5B,A00,896653,Munoz Sanchez; Alicia,7,0,20,13
1746569312882,LISP 5C,A00,896655,Munoz Sanchez; Alicia,0,1,20,20
1746569313912,MAE 197,001,957918,Kleissl; Jan,9996,0,9999,3
1746569313912,MAE 197,002,959806,Boechler; Nicholas Sebastia,9998,0,9999,1
1746569313912,MAE 197,003,959852,Mullin; Jennifer S,9998,0,9999,1
1746569314937,MATH 2,A01,957937,Staff,33,0,35,2
1746569315967,MATH 197,001,957876,Kedlaya; Kiran S.,9993,0,9999,6
1746569316997,MCWP 40,A00,892729,Duru; Nur,10,0,20,10
1746569316997,MCWP 40,B00,893304,Montejo; Carolina,14,0,20,6
1746569318021,MCWP 40R,A00,893757,Redela; Pamela Morgan,0,5,20,20
1746569319049,MCWP 50,A00,893758,Morshed; Michael James,0,0,20,20
1746569319049,MCWP 50,B00,893761,Bartulis; Jason Michael,17,0,20,3
1746569320075,MCWP 50R,A00,893766,Compas; Sean Matthew,0,1,20,20
1746569320075,MCWP 50R,B00,893769,Carter; Jennifer A,0,1,20,20
1746569320075,MCWP 50R,C00,893771,Krone; Jarret,0,3,20,20
1746569320075,MCWP 50R,D00,893772,Miller; Elizabeth Deen,0,0,20,20
1746569320075,MCWP 50R,E00,893775,Carter; Andrea L,0,1,20,20
1746569321106,MMW 11R,A01,892721,Herbst; Matthew,11,0,27,16
1746569321106,MMW 11R,A02,892722,Herbst; Matthew,0,0,0,3
1746569322131,MMW 12R,A01,892724,Herbst; Matthew,0,11,16,16
1746569322131,MMW 12R,A02,892725,Herbst; Matthew,0,10,16,16
1746569323161,MMW 13R,A01,892727,Staff,0,4,16,16
1746569323161,MMW 13R,A02,892728,Staff,0,4,16,16
1746569323161,MMW 13R,A03,958032,Staff,0,4,16,16
1746569323161,MMW 13R,A04,958033,Staff,0,4,16,16
1746569323161,MMW 13R,A05,958034,Staff,0,4,16,16
1746569324187,SIO 295LS,A00,894015,Staff,5,0,25,20
1746569325214,SIO 295S,A00,894020,Staff,5,0,25,20
1746569326244,SIOC 290S,B01,958918,Merrifield; Mark A,14,0,30,16
1746569327270,SIOC 291S,B01,958922,Gabriel; Corey John,14,0,30,16
1746569328296,SOCI 117,A01,895339,Staff,3,0,5,2
1746569329321,WES 237B,A00,894149,Staff,11,0,20,9
1746569331381,AESE 279B,A00,891859,Staff,13,0,35,22
1746569332407,AIP 197,001,891854,Vespa; Emanuel Ignacio,9999,0,9999,0
1746569333436,ANTH 289S,A00,891856,Gagneux; Pascal,12,0,12,0
1746569334461,BENG 196,001,957946,Engler; Adam J.,9996,0,9999,3
1746569335485,BISP 197,001,959851,Wilhelm; James E.,9998,0,9999,1
1746569336513,CAT 124RS,A01,956906,Staff,6,0,25,19
1746569337539,CAT 125RS,A01,922013,Staff,6,0,25,19
1746569338566,CLRE 250,A00,891860,Morris; Sheldon,9995,0,9999,4
1746569340620,CLRE 251R,A00,907817,Mehta; Ravindra L.,9994,0,9999,5
1746569341650,CLRE 252,A00,891864,Cuomo; Raphael Eduardo,9993,0,9999,6
1746569342677,CLRE 253,A00,891867,Vaida; Florin,9994,0,9999,5
1746569342677,CLRE 253,B00,907819,Staff,9999,0,9999,0
1746569343705,CLRE 259,A00,891868,Patel; Hemal,9998,0,9999,1
1746569344729,CLRE 260,A00,891872,Cuomo; Raphael Eduardo,9999,0,9999,0
1746569345758,CLRE 297,001,891888,Cuomo; Raphael Eduardo,9999,0,9999,0
1746569346784,CSE 191,A00,958773,Minnes Kemp; Mor Mia,9995,0,9999,4
1746569347812,CSE 197,001,959846,Minnes Kemp; Mor Mia,9990,0,9999,9
1746569348837,CSS 201S,A01,892054,Mignozzetti; Umberto,25,0,30,5
1746569349862,CSS 202S,A01,892056,Mignozzetti; Umberto,25,0,30,5
1746569350887,DSC 197,001,956898,Eldridge; Justin Matthew,9996,0,9999,3
1746569351917,DSC 297,001,958000,Mazumdar; Arya,9998,0,9999,1
1746569351917,DSC 297,002,959862,Wang; Yusu,9998,0,9999,1
1746569352944,EAP 100,A00,905686,Staff,9778,0,9999,221
1746569353972,ECE 45,A01,892618,Staff,0,0,65,65
1746569356029,ECE 111,A01,892719,Staff,4,0,65,61
1746569357055,ECE 197,001,957920,Mercier; Patrick Philip,9991,0,9999,8
1746569358080,ECON 178,A01,907814,Zhu; Ying,26,0,35,9
1746569359108,EDS 115,A00,895312,Staff,35,0,45,10
1746569360134,EDS 117,A01,895337,Staff,23,0,30,7
1746569361163,EDS 125,A00,895341,Jones; Gabrielle Anastasia,36,0,45,9
1746569362187,EDS 128A,A01,895459,Fargason; Sharon Gayle,44,0,45,1
1746569363217,EDS 128B,A01,895543,Pappas; Elizabeth,44,0,45,1
1746569364240,EDS 139,A00,897203,Pappas; Elizabeth,44,0,45,1
1746569364240,EDS 139,B00,897209,Fargason; Sharon Gayle,41,0,45,4
1746569365269,EDS 201,A00,895545,Staff,22,0,45,23
1746569366348,EDS 203,A01,895581,Halter; Christopher P.,22,0,45,23
1746569367376,EDS 204R,A01,895625,Heinzman; Erica M.,39,0,45,6
1746569367376,EDS 204R,B01,895693,Halter; Christopher P.,10,0,45,35
1746569368399,EDS 206R,A00,895694,Fargason; Sharon Gayle,1,0,30,29
1746569368399,EDS 206R,B00,895695,Choi; Bailey Miyeon,16,0,30,14
1746569369424,EDS 250,A00,895697,Hemans; Patricia Ann Benitez,22,0,45,23
1746569370449,EDS 281,A00,895701,Meyerott; Theresa Ann,1,0,15,14
1746569371476,EDS 284,A00,895736,Meyerott; Theresa Ann,1,0,15,14
1746569372502,EDS 286,A00,897210,Fine; Sarah,0,0,15,15
1746569373526,EDS 289C,A01,895770,Daly; Alan J.,1,0,15,14
1746569374553,EDS 290,A00,897211,Hofstetter; Carolyn,0,0,15,15
1746569375583,LIGM 5A,A00,896162,Fischer-Grunski; Eva K,12,0,20,8
1746569376614,LIGM 5B,A00,896260,Fischer-Grunski; Eva K,17,0,20,3
1746569377640,LIGM 5C,A00,896308,Fischer-Grunski; Eva K,18,0,20,2
1746569378670,LIIT 5AS,A00,896313,Carnelos; Chiara,18,0,20,2
1746569379697,LIIT 5BS,A00,896416,Carnelos; Chiara,20,0,20,0
1746569380723,LIIT 5CS,A00,896564,Carnelos; Chiara,20,0,20,0
1746569381748,LISP 5A,A00,896588,Munoz Sanchez; Alicia,3,0,20,17
1746569382774,LISP 5B,A00,896653,Munoz Sanchez; Alicia,7,0,20,13
1746569383803,LISP 5C,A00,896655,Munoz Sanchez; Alicia,0,1,20,20
1746569384827,MAE 197,001,957918,Kleissl; Jan,9996,0,9999,3
1746569384827,MAE 197,002,959806,Boechler; Nicholas Sebastia,9998,0,9999,1
1746569384827,MAE 197,003,959852,Mullin; Jennifer S,9998,0,9999,1
1746569385855,MATH 2,A01,957937,Staff,33,0,35,2
1746569386887,MATH 197,001,957876,Kedlaya; Kiran S.,9993,0,9999,6
1746569387912,MCWP 40,A00,892729,Duru; Nur,10,0,20,10
1746569387912,MCWP 40,B00,893304,Montejo; Carolina,14,0,20,6
1746569388939,MCWP 40R,A00,893757,Redela; Pamela Morgan,0,5,20,20
1746569389967,MCWP 50,A00,893758,Morshed; Michael James,0,0,20,20
1746569389967,MCWP 50,B00,893761,Bartulis; Jason Michael,17,0,20,3
1746569390992,MCWP 50R,A00,893766,Compas; Sean Matthew,0,1,20,20
1746569390992,MCWP 50R,B00,893769,Carter; Jennifer A,0,1,20,20
1746569390992,MCWP 50R,C00,893771,Krone; Jarret,0,3,20,20
1746569390992,MCWP 50R,D00,893772,Miller; Elizabeth Deen,0,0,20,20
1746569390992,MCWP 50R,E00,893775,Carter; Andrea L,0,1,20,20
1746569392023,MMW 11R,A01,892721,Herbst; Matthew,11,0,27,16
1746569392023,MMW 11R,A02,892722,Herbst; Matthew,0,0,0,3
1746569393051,MMW 12R,A01,892724,Herbst; Matthew,0,11,16,16
1746569393051,MMW 12R,A02,892725,Herbst; Matthew,0,10,16,16
1746569394080,MMW 13R,A01,892727,Staff,0,4,16,16
1746569394080,MMW 13R,A02,892728,Staff,0,4,16,16
1746569394080,MMW 13R,A03,958032,Staff,0,4,16,16
1746569394080,MMW 13R,A04,958033,Staff,0,4,16,16
1746569394080,MMW 13R,A05,958034,Staff,0,4,16,16
1746569395106,SIO 295LS,A00,894015,Staff,5,0,25,20
1746569396135,SIO 295S,A00,894020,Staff,5,0,25,20
1746569397161,SIOC 290S,B01,958918,Merrifield; Mark A,14,0,30,16
1746569398187,SIOC 291S,B01,958922,Gabriel; Corey John,14,0,30,16
1746569399212,SOCI 117,A01,895339,Staff,3,0,5,2
1746569400237,WES 237B,A00,894149,Staff,11,0,20,9
1746569402302,AESE 279B,A00,891859,Staff,13,0,35,22
1746569403330,AIP 197,001,891854,Vespa; Emanuel Ignacio,9999,0,9999,0
1746569404354,ANTH 289S,A00,891856,Gagneux; Pascal,12,0,12,0
1746569405382,BENG 196,001,957946,Engler; Adam J.,9996,0,9999,3
1746569406415,BISP 197,001,959851,Wilhelm; James E.,9998,0,9999,1
1746569407440,CAT 124RS,A01,956906,Staff,6,0,25,19
1746569408465,CAT 125RS,A01,922013,Staff,6,0,25,19
1746569409489,CLRE 250,A00,891860,Morris; Sheldon,9995,0,9999,4
1746569411551,CLRE 251R,A00,907817,Mehta; Ravindra L.,9994,0,9999,5
1746569412581,CLRE 252,A00,891864,Cuomo; Raphael Eduardo,9993,0,9999,6
1746569413611,CLRE 253,A00,891867,Vaida; Florin,9994,0,9999,5
1746569413611,CLRE 253,B00,907819,Staff,9999,0,9999,0
1746569414636,CLRE 259,A00,891868,Patel; Hemal,9998,0,9999,1
1746569415661,CLRE 260,A00,891872,Cuomo; Raphael Eduardo,9999,0,9999,0
1746569416686,CLRE 297,001,891888,Cuomo; Raphael Eduardo,9999,0,9999,0
1746569417714,CSE 191,A00,958773,Minnes Kemp; Mor Mia,9995,0,9999,4
1746569418741,CSE 197,001,959846,Minnes Kemp; Mor Mia,9990,0,9999,9
1746569419767,CSS 201S,A01,892054,Mignozzetti; Umberto,25,0,30,5
1746569420791,CSS 202S,A01,892056,Mignozzetti; Umberto,25,0,30,5
1746569421820,DSC 197,001,956898,Eldridge; Justin Matthew,9996,0,9999,3
1746569422850,DSC 297,001,958000,Mazumdar; Arya,9998,0,9999,1
1746569422850,DSC 297,002,959862,Wang; Yusu,9998,0,9999,1
1746569423874,EAP 100,A00,905686,Staff,9778,0,9999,221
1746569424903,ECE 45,A01,892618,Staff,0,0,65,65
1746569426955,ECE 111,A01,892719,Staff,4,0,65,61
1746569428022,ECE 197,001,957920,Mercier; Patrick Philip,9991,0,9999,8
1746569429052,ECON 178,A01,907814,Zhu; Ying,26,0,35,9
1746569430078,EDS 115,A00,895312,Staff,35,0,45,10
1746569431124,EDS 117,A01,895337,Staff,23,0,30,7
1746569432151,EDS 125,A00,895341,Jones; Gabrielle Anastasia,36,0,45,9
1746569433179,EDS 128A,A01,895459,Fargason; Sharon Gayle,44,0,45,1
1746569434209,EDS 128B,A01,895543,Pappas; Elizabeth,44,0,45,1
1746569435234,EDS 139,A00,897203,Pappas; Elizabeth,44,0,45,1
1746569435234,EDS 139,B00,897209,Fargason; Sharon Gayle,41,0,45,4
1746569436263,EDS 201,A00,895545,Staff,22,0,45,23
1746569437288,EDS 203,A01,895581,Halter; Christopher P.,22,0,45,23
1746569438317,EDS 204R,A01,895625,Heinzman; Erica M.,39,0,45,6
1746569438317,EDS 204R,B01,895693,Halter; Christopher P.,10,0,45,35
1746569439343,EDS 206R,A00,895694,Fargason; Sharon Gayle,1,0,30,29
1746569439343,EDS 206R,B00,895695,Choi; Bailey Miyeon,16,0,30,14
1746569440374,EDS 250,A00,895697,Hemans; Patricia Ann Benitez,22,0,45,23
1746569441399,EDS 281,A00,895701,Meyerott; Theresa Ann,1,0,15,14
1746569442425,EDS 284,A00,895736,Meyerott; Theresa Ann,1,0,15,14
1746569443449,EDS 286,A00,897210,Fine; Sarah,0,0,15,15
1746569444481,EDS 289C,A01,895770,Daly; Alan J.,1,0,15,14
1746569445510,EDS 290,A00,897211,Hofstetter; Carolyn,0,0,15,15
1746569446539,LIGM 5A,A00,896162,Fischer-Grunski; Eva K,12,0,20,8
1746569447568,LIGM 5B,A00,896260,Fischer-Grunski; Eva K,17,0,20,3
1746569448596,LIGM 5C,A00,896308,Fischer-Grunski; Eva K,18,0,20,2
1746569449623,LIIT 5AS,A00,896313,Carnelos; Chiara,18,0,20,2
1746569450652,LIIT 5BS,A00,896416,Carnelos; Chiara,20,0,20,0
1746569451680,LIIT 5CS,A00,896564,Carnelos; Chiara,20,0,20,0
1746569452706,LISP 5A,A00,896588,Munoz Sanchez; Alicia,3,0,20,17
1746569453731,LISP 5B,A00,896653,Munoz Sanchez; Alicia,7,0,20,13
1746569454760,LISP 5C,A00,896655,Munoz Sanchez; Alicia,0,1,20,20
1746569455790,MAE 197,001,957918,Kleissl; Jan,9996,0,9999,3
1746569455790,MAE 197,002,959806,Boechler; Nicholas Sebastia,9998,0,9999,1
1746569455790,MAE 197,003,959852,Mullin; Jennifer S,9998,0,9999,1
1746569456814,MATH 2,A01,957937,Staff,33,0,35,2
1746569457838,MATH 197,001,957876,Kedlaya; Kiran S.,9993,0,9999,6
1746569458865,MCWP 40,A00,892729,Duru; Nur,10,0,20,10
1746569458865,MCWP 40,B00,893304,Montejo; Carolina,14,0,20,6
1746569459892,MCWP 40R,A00,893757,Redela; Pamela Morgan,0,5,20,20
1746569460922,MCWP 50,A00,893758,Morshed; Michael James,0,0,20,20
1746569460922,MCWP 50,B00,893761,Bartulis; Jason Michael,17,0,20,3
1746569461947,MCWP 50R,A00,893766,Compas; Sean Matthew,0,1,20,20
1746569461947,MCWP 50R,B00,893769,Carter; Jennifer A,0,1,20,20
1746569461947,MCWP 50R,C00,893771,Krone; Jarret,0,3,20,20
1746569461947,MCWP 50R,D00,893772,Miller; Elizabeth Deen,0,0,20,20
1746569461947,MCWP 50R,E00,893775,Carter; Andrea L,0,1,20,20
1746569462974,MMW 11R,A01,892721,Herbst; Matthew,11,0,27,16
1746569462974,MMW 11R,A02,892722,Herbst; Matthew,0,0,0,3
1746569464000,MMW 12R,A01,892724,Herbst; Matthew,0,11,16,16
1746569464000,MMW 12R,A02,892725,Herbst; Matthew,0,10,16,16
1746569465030,MMW 13R,A01,892727,Staff,0,4,16,16
1746569465030,MMW 13R,A02,892728,Staff,0,4,16,16
1746569465030,MMW 13R,A03,958032,Staff,0,4,16,16
1746569465030,MMW 13R,A04,958033,Staff,0,4,16,16
1746569465030,MMW 13R,A05,958034,Staff,0,4,16,16
1746569466054,SIO 295LS,A00,894015,Staff,5,0,25,20
1746569467081,SIO 295S,A00,894020,Staff,5,0,25,20
1746569468109,SIOC 290S,B01,958918,Merrifield; Mark A,14,0,30,16
1746569469137,SIOC 291S,B01,958922,Gabriel; Corey John,14,0,30,16
1746569470167,SOCI 117,A01,895339,Staff,3,0,5,2
1746569471195,WES 237B,A00,894149,Staff,11,0,20,9
1746569473266,AESE 279B,A00,891859,Staff,13,0,35,22
1746569474290,AIP 197,001,891854,Vespa; Emanuel Ignacio,9999,0,9999,0
1746569475314,ANTH 289S,A00,891856,Gagneux; Pascal,12,0,12,0
1746569476338,BENG 196,001,957946,Engler; Adam J.,9996,0,9999,3
1746569477366,BISP 197,001,959851,Wilhelm; James E.,9998,0,9999,1
1746569478395,CAT 124RS,A01,956906,Staff,6,0,25,19
1746569479418,CAT 125RS,A01,922013,Staff,6,0,25,19
1746569480445,CLRE 250,A00,891860,Morris; Sheldon,9995,0,9999,4
1746569482497,CLRE 251R,A00,907817,Mehta; Ravindra L.,9994,0,9999,5
1746569483524,CLRE 252,A00,891864,Cuomo; Raphael Eduardo,9993,0,9999,6
1746569484552,CLRE 253,A00,891867,Vaida; Florin,9994,0,9999,5
1746569484552,CLRE 253,B00,907819,Staff,9999,0,9999,0
1746569485579,CLRE 259,A00,891868,Patel; Hemal,9998,0,9999,1
1746569486604,CLRE 260,A00,891872,Cuomo; Raphael Eduardo,9999,0,9999,0
1746569487636,CLRE 297,001,891888,Cuomo; Raphael Eduardo,9999,0,9999,0
1746569488665,CSE 191,A00,958773,Minnes Kemp; Mor Mia,9995,0,9999,4
1746569489690,CSE 197,001,959846,Minnes Kemp; Mor Mia,9990,0,9999,9
1746569490719,CSS 201S,A01,892054,Mignozzetti; Umberto,25,0,30,5
1746569491748,CSS 202S,A01,892056,Mignozzetti; Umberto,25,0,30,5
1746569492774,DSC 197,001,956898,Eldridge; Justin Matthew,9996,0,9999,3
1746569493800,DSC 297,001,958000,Mazumdar; Arya,9998,0,9999,1
1746569493800,DSC 297,002,959862,Wang; Yusu,9998,0,9999,1
1746569494828,EAP 100,A00,905686,Staff,9778,0,9999,221
1746569495856,ECE 45,A01,892618,Staff,0,0,65,65
1746569497908,ECE 111,A01,892719,Staff,4,0,65,61
1746569498937,ECE 197,001,957920,Mercier; Patrick Philip,9991,0,9999,8
1746569499962,ECON 178,A01,907814,Zhu; Ying,26,0,35,9
1746569500987,EDS 115,A00,895312,Staff,35,0,45,10
1746569502012,EDS 117,A01,895337,Staff,23,0,30,7
1746569503041,EDS 125,A00,895341,Jones; Gabrielle Anastasia,36,0,45,9
1746569504065,EDS 128A,A01,895459,Fargason; Sharon Gayle,44,0,45,1
1746569505090,EDS 128B,A01,895543,Pappas; Elizabeth,44,0,45,1
1746569506114,EDS 139,A00,897203,Pappas; Elizabeth,44,0,45,1
1746569506114,EDS 139,B00,897209,Fargason; Sharon Gayle,41,0,45,4
1746569507141,EDS 201,A00,895545,Staff,22,0,45,23
1746569508168,EDS 203,A01,895581,Halter; Christopher P.,22,0,45,23
1746569509198,EDS 204R,A01,895625,Heinzman; Erica M.,39,0,45,6
1746569509198,EDS 204R,B01,895693,Halter; Christopher P.,10,0,45,35
1746569510225,EDS 206R,A00,895694,Fargason; Sharon Gayle,1,0,30,29
1746569510225,EDS 206R,B00,895695,Choi; Bailey Miyeon,16,0,30,14
1746569511251,EDS 250,A00,895697,Hemans; Patricia Ann Benitez,22,0,45,23
1746569512408,EDS 281,A00,895701,Meyerott; Theresa Ann,1,0,15,14
1746569513436,EDS 284,A00,895736,Meyerott; Theresa Ann,1,0,15,14
1746569514462,EDS 286,A00,897210,Fine; Sarah,0,0,15,15
1746569515486,EDS 289C,A01,895770,Daly; Alan J.,1,0,15,14
1746569516512,EDS 290,A00,897211,Hofstetter; Carolyn,0,0,15,15
1746569517537,LIGM 5A,A00,896162,Fischer-Grunski; Eva K,12,0,20,8
1746569518567,LIGM 5B,A00,896260,Fischer-Grunski; Eva K,17,0,20,3
1746569519595,LIGM 5C,A00,896308,Fischer-Grunski; Eva K,18,0,20,2
1746569520621,LIIT 5AS,A00,896313,Carnelos; Chiara,18,0,20,2
1746569521646,LIIT 5BS,A00,896416,Carnelos; Chiara,20,0,20,0
1746569522698,LIIT 5CS,A00,896564,Carnelos; Chiara,20,0,20,0
1746569523724,LISP 5A,A00,896588,Munoz Sanchez; Alicia,3,0,20,17
1746569524748,LISP 5B,A00,896653,Munoz Sanchez; Alicia,7,0,20,13
1746569525774,LISP 5C,A00,896655,Munoz Sanchez; Alicia,0,1,20,20
1746569526815,MAE 197,001,957918,Kleissl; Jan,9996,0,9999,3
1746569526815,MAE 197,002,959806,Boechler; Nicholas Sebastia,9998,0,9999,1
1746569526815,MAE 197,003,959852,Mullin; Jennifer S,9998,0,9999,1
1746569527845,MATH 2,A01,957937,Staff,33,0,35,2
1746569528873,MATH 197,001,957876,Kedlaya; Kiran S.,9993,0,9999,6
1746569529901,MCWP 40,A00,892729,Duru; Nur,10,0,20,10
1746569529901,MCWP 40,B00,893304,Montejo; Carolina,14,0,20,6
1746569530926,MCWP 40R,A00,893757,Redela; Pamela Morgan,0,5,20,20
1746569531950,MCWP 50,A00,893758,Morshed; Michael James,0,0,20,20
1746569531950,MCWP 50,B00,893761,Bartulis; Jason Michael,17,0,20,3
1746569532977,MCWP 50R,A00,893766,Compas; Sean Matthew,0,1,20,20
1746569532977,MCWP 50R,B00,893769,Carter; Jennifer A,0,1,20,20
1746569532977,MCWP 50R,C00,893771,Krone; Jarret,0,3,20,20
1746569532977,MCWP 50R,D00,893772,Miller; Elizabeth Deen,0,0,20,20
1746569532977,MCWP 50R,E00,893775,Carter; Andrea L,0,1,20,20
1746569534002,MMW 11R,A01,892721,Herbst; Matthew,11,0,27,16
1746569534002,MMW 11R,A02,892722,Herbst; Matthew,0,0,0,3
1746569535036,MMW 12R,A01,892724,Herbst; Matthew,0,11,16,16
1746569535036,MMW 12R,A02,892725,Herbst; Matthew,0,10,16,16
1746569536060,MMW 13R,A01,892727,Staff,0,4,16,16
1746569536060,MMW 13R,A02,892728,Staff,0,4,16,16
1746569536060,MMW 13R,A03,958032,Staff,0,4,16,16
1746569536060,MMW 13R,A04,958033,Staff,0,4,16,16
1746569536060,MMW 13R,A05,958034,Staff,0,4,16,16
1746569537088,SIO 295LS,A00,894015,Staff,5,0,25,20
1746569538112,SIO 295S,A00,894020,Staff,5,0,25,20
1746569539142,SIOC 290S,B01,958918,Merrifield; Mark A,14,0,30,16
1746569540170,SIOC 291S,B01,958922,Gabriel; Corey John,14,0,30,16
1746569541211,SOCI 117,A01,895339,Staff,3,0,5,2
1746569542238,WES 237B,A00,894149,Staff,11,0,20,9
1746569544308,AESE 279B,A00,891859,Staff,13,0,35,22
1746569545335,AIP 197,001,891854,Vespa; Emanuel Ignacio,9999,0,9999,0
1746569546363,ANTH 289S,A00,891856,Gagneux; Pascal,12,0,12,0
1746569547390,BENG 196,001,957946,Engler; Adam J.,9996,0,9999,3
1746569548416,BISP 197,001,959851,Wilhelm; James E.,9998,0,9999,1
1746569549446,CAT 124RS,A01,956906,Staff,6,0,25,19
1746569550475,CAT 125RS,A01,922013,Staff,6,0,25,19
1746569551502,CLRE 250,A00,891860,Morris; Sheldon,9995,0,9999,4
1746569553552,CLRE 251R,A00,907817,Mehta; Ravindra L.,9994,0,9999,5
1746569554580,CLRE 252,A00,891864,Cuomo; Raphael Eduardo,9993,0,9999,6
1746569555607,CLRE 253,A00,891867,Vaida; Florin,9994,0,9999,5
1746569555607,CLRE 253,B00,907819,Staff,9999,0,9999,0
1746569556635,CLRE 259,A00,891868,Patel; Hemal,9998,0,9999,1
1746569557659,CLRE 260,A00,891872,Cuomo; Raphael Eduardo,9999,0,9999,0
1746569558683,CLRE 297,001,891888,Cuomo; Raphael Eduardo,9999,0,9999,0
1746569559708,CSE 191,A00,958773,Minnes Kemp; Mor Mia,9995,0,9999,4
1746569560736,CSE 197,001,959846,Minnes Kemp; Mor Mia,9990,0,9999,9
1746569561765,CSS 201S,A01,892054,Mignozzetti; Umberto,25,0,30,5
1746569562792,CSS 202S,A01,892056,Mignozzetti; Umberto,25,0,30,5
1746569563821,DSC 197,001,956898,Eldridge; Justin Matthew,9996,0,9999,3
1746569564851,DSC 297,001,958000,Mazumdar; Arya,9998,0,9999,1
1746569564851,DSC 297,002,959862,Wang; Yusu,9998,0,9999,1
1746569565878,EAP 100,A00,905686,Staff,9778,0,9999,221
1746569566908,ECE 45,A01,892618,Staff,0,0,65,65
1746569568959,ECE 111,A01,892719,Staff,4,0,65,61
1746569569985,ECE 197,001,957920,Mercier; Patrick Philip,9991,0,9999,8
1746569571014,ECON 178,A01,907814,Zhu; Ying,26,0,35,9
1746569572039,EDS 115,A00,895312,Staff,35,0,45,10
1746569573068,EDS 117,A01,895337,Staff,23,0,30,7
1746569574096,EDS 125,A00,895341,Jones; Gabrielle Anastasia,36,0,45,9
1746569575126,EDS 128A,A01,895459,Fargason; Sharon Gayle,44,0,45,1
1746569576153,EDS 128B,A01,895543,Pappas; Elizabeth,44,0,45,1
1746569577180,EDS 139,A00,897203,Pappas; Elizabeth,44,0,45,1
1746569577180,EDS 139,B00,897209,Fargason; Sharon Gayle,41,0,45,4
1746569578204,EDS 201,A00,895545,Staff,22,0,45,23
1746569579233,EDS 203,A01,895581,Halter; Christopher P.,22,0,45,23
1746569580313,EDS 204R,A01,895625,Heinzman; Erica M.,39,0,45,6
1746569580313,EDS 204R,B01,895693,Halter; Christopher P.,10,0,45,35
1746569581342,EDS 206R,A00,895694,Fargason; Sharon Gayle,1,0,30,29
1746569581342,EDS 206R,B00,895695,Choi; Bailey Miyeon,16,0,30,14
1746569582371,EDS 250,A00,895697,Hemans; Patricia Ann Benitez,22,0,45,23
1746569583396,EDS 281,A00,895701,Meyerott; Theresa Ann,1,0,15,14
1746569584424,EDS 284,A00,895736,Meyerott; Theresa Ann,1,0,15,14
1746569585454,EDS 286,A00,897210,Fine; Sarah,0,0,15,15
1746569586478,EDS 289C,A01,895770,Daly; Alan J.,1,0,15,14
1746569587506,EDS 290,A00,897211,Hofstetter; Carolyn,0,0,15,15
1746569588533,LIGM 5A,A00,896162,Fischer-Grunski; Eva K,12,0,20,8
1746569589558,LIGM 5B,A00,896260,Fischer-Grunski; Eva K,17,0,20,3
1746569590588,LIGM 5C,A00,896308,Fischer-Grunski; Eva K,18,0,20,2
1746569591617,LIIT 5AS,A00,896313,Carnelos; Chiara,18,0,20,2
1746569592649,LIIT 5BS,A00,896416,Carnelos; Chiara,20,0,20,0
1746569593675,LIIT 5CS,A00,896564,Carnelos; Chiara,20,0,20,0
1746569594705,LISP 5A,A00,896588,Munoz Sanchez; Alicia,3,0,20,17
1746569595730,LISP 5B,A00,896653,Munoz Sanchez; Alicia,7,0,20,13
1746569596757,LISP 5C,A00,896655,Munoz Sanchez; Alicia,0,1,20,20
1746569597786,MAE 197,001,957918,Kleissl; Jan,9996,0,9999,3
1746569597786,MAE 197,002,959806,Boechler; Nicholas Sebastia,9998,0,9999,1
1746569597786,MAE 197,003,959852,Mullin; Jennifer S,9998,0,9999,1
1746569598815,MATH 2,A01,957937,Staff,33,0,35,2
1746569599842,MATH 197,001,957876,Kedlaya; Kiran S.,9993,0,9999,6
1746569600868,MCWP 40,A00,892729,Duru; Nur,10,0,20,10
1746569600868,MCWP 40,B00,893304,Montejo; Carolina,14,0,20,6
1746569601897,MCWP 40R,A00,893757,Redela; Pamela Morgan,0,5,20,20
1746569602926,MCWP 50,A00,893758,Morshed; Michael James,0,0,20,20
1746569602926,MCWP 50,B00,893761,Bartulis; Jason Michael,17,0,20,3
1746569603953,MCWP 50R,A00,893766,Compas; Sean Matthew,0,1,20,20
1746569603953,MCWP 50R,B00,893769,Carter; Jennifer A,0,1,20,20
1746569603953,MCWP 50R,C00,893771,Krone; Jarret,0,3,20,20
1746569603953,MCWP 50R,D00,893772,Miller; Elizabeth Deen,0,0,20,20
1746569603953,MCWP 50R,E00,893775,Carter; Andrea L,0,1,20,20
1746569604978,MMW 11R,A01,892721,Herbst; Matthew,11,0,27,16
1746569604978,MMW 11R,A02,892722,Herbst; Matthew,0,0,0,3
1746569606007,MMW 12R,A01,892724,Herbst; Matthew,0,11,16,16
1746569606007,MMW 12R,A02,892725,Herbst; Matthew,0,10,16,16
1746569607038,MMW 13R,A01,892727,Staff,0,4,16,16
1746569607038,MMW 13R,A02,892728,Staff,0,4,16,16
1746569607038,MMW 13R,A03,958032,Staff,0,4,16,16
1746569607038,MMW 13R,A04,958033,Staff,0,4,16,16
1746569607038,MMW 13R,A05,958034,Staff,0,4,16,16
1746569608064,SIO 295LS,A00,894015,Staff,5,0,25,20
1746569609091,SIO 295S,A00,894020,Staff,5,0,25,20
1746569610121,SIOC 290S,B01,958918,Merrifield; Mark A,14,0,30,16
1746569611150,SIOC 291S,B01,958922,Gabriel; Corey John,14,0,30,16
1746569612175,SOCI 117,A01,895339,Staff,3,0,5,2
1746569613204,WES 237B,A00,894149,Staff,11,0,20,9
1746569615269,AESE 279B,A00,891859,Staff,13,0,35,22
1746569616293,AIP 197,001,891854,Vespa; Emanuel Ignacio,9999,0,9999,0
1746569617317,ANTH 289S,A00,891856,Gagneux; Pascal,12,0,12,0
1746569618344,BENG 196,001,957946,Engler; Adam J.,9996,0,9999,3
1746569619370,BISP 197,001,959851,Wilhelm; James E.,9998,0,9999,1
1746569620397,CAT 124RS,A01,956906,Staff,6,0,25,19
1746569621428,CAT 125RS,A01,922013,Staff,6,0,25,19
1746569622452,CLRE 250,A00,891860,Morris; Sheldon,9995,0,9999,4
1746569624507,CLRE 251R,A00,907817,Mehta; Ravindra L.,9994,0,9999,5
1746569625532,CLRE 252,A00,891864,Cuomo; Raphael Eduardo,9993,0,9999,6
1746569626561,CLRE 253,A00,891867,Vaida; Florin,9994,0,9999,5
1746569626561,CLRE 253,B00,907819,Staff,9999,0,9999,0
1746569627590,CLRE 259,A00,891868,Patel; Hemal,9998,0,9999,1
1746569628617,CLRE 260,A00,891872,Cuomo; Raphael Eduardo,9999,0,9999,0
1746569629643,CLRE 297,001,891888,Cuomo; Raphael Eduardo,9999,0,9999,0
1746569630671,CSE 191,A00,958773,Minnes Kemp; Mor Mia,9995,0,9999,4
1746569631696,CSE 197,001,959846,Minnes Kemp; Mor Mia,9990,0,9999,9
1746569632728,CSS 201S,A01,892054,Mignozzetti; Umberto,25,0,30,5
1746569633756,CSS 202S,A01,892056,Mignozzetti; Umberto,25,0,30,5
1746569634784,DSC 197,001,956898,Eldridge; Justin Matthew,9996,0,9999,3
1746569635807,DSC 297,001,958000,Mazumdar; Arya,9998,0,9999,1
1746569635807,DSC 297,002,959862,Wang; Yusu,9998,0,9999,1
1746569636836,EAP 100,A00,905686,Staff,9778,0,9999,221
1746569637862,ECE 45,A01,892618,Staff,0,0,65,65
1746569639916,ECE 111,A01,892719,Staff,5,0,65,60
1746569640942,ECE 197,001,957920,Mercier; Patrick Philip,9991,0,9999,8
1746569641968,ECON 178,A01,907814,Zhu; Ying,26,0,35,9
1746569642993,EDS 115,A00,895312,Staff,35,0,45,10
1746569644020,EDS 117,A01,895337,Staff,23,0,30,7
1746569645045,EDS 125,A00,895341,Jones; Gabrielle Anastasia,36,0,45,9
1746569646075,EDS 128A,A01,895459,Fargason; Sharon Gayle,44,0,45,1
1746569647101,EDS 128B,A01,895543,Pappas; Elizabeth,44,0,45,1
1746569648131,EDS 139,A00,897203,Pappas; Elizabeth,44,0,45,1
1746569648131,EDS 139,B00,897209,Fargason; Sharon Gayle,41,0,45,4
1746569649197,EDS 201,A00,895545,Staff,22,0,45,23
1746569650222,EDS 203,A01,895581,Halter; Christopher P.,22,0,45,23
1746569651247,EDS 204R,A01,895625,Heinzman; Erica M.,39,0,45,6
1746569651247,EDS 204R,B01,895693,Halter; Christopher P.,10,0,45,35
1746569652277,EDS 206R,A00,895694,Fargason; Sharon Gayle,1,0,30,29
1746569652277,EDS 206R,B00,895695,Choi; Bailey Miyeon,16,0,30,14
1746569653307,EDS 250,A00,895697,Hemans; Patricia Ann Benitez,22,0,45,23
1746569654334,EDS 281,A00,895701,Meyerott; Theresa Ann,1,0,15,14
1746569655360,EDS 284,A00,895736,Meyerott; Theresa Ann,1,0,15,14
1746569656387,EDS 286,A00,897210,Fine; Sarah,0,0,15,15
1746569657415,EDS 289C,A01,895770,Daly; Alan J.,1,0,15,14
1746569658444,EDS 290,A00,897211,Hofstetter; Carolyn,0,0,15,15
1746569659473,LIGM 5A,A00,896162,Fischer-Grunski; Eva K,12,0,20,8
1746569660499,LIGM 5B,A00,896260,Fischer-Grunski; Eva K,17,0,20,3
1746569661529,LIGM 5C,A00,896308,Fischer-Grunski; Eva K,18,0,20,2
1746569662555,LIIT 5AS,A00,896313,Carnelos; Chiara,18,0,20,2
1746569663587,LIIT 5BS,A00,896416,Carnelos; Chiara,20,0,20,0
1746569664614,LIIT 5CS,A00,896564,Carnelos; Chiara,20,0,20,0
1746569665639,LISP 5A,A00,896588,Munoz Sanchez; Alicia,2,0,20,18
1746569666665,LISP 5B,A00,896653,Munoz Sanchez; Alicia,7,0,20,13
1746569667691,LISP 5C,A00,896655,Munoz Sanchez; Alicia,0,1,20,20
1746569668718,MAE 197,001,957918,Kleissl; Jan,9996,0,9999,3
1746569668718,MAE 197,002,959806,Boechler; Nicholas Sebastia,9998,0,9999,1
1746569668718,MAE 197,003,959852,Mullin; Jennifer S,9998,0,9999,1
1746569669743,MATH 2,A01,957937,Staff,33,0,35,2
1746569670766,MATH 197,001,957876,Kedlaya; Kiran S.,9993,0,9999,6
1746569671795,MCWP 40,A00,892729,Duru; Nur,10,0,20,10
1746569671795,MCWP 40,B00,893304,Montejo; Carolina,14,0,20,6
1746569672819,MCWP 40R,A00,893757,Redela; Pamela Morgan,0,5,20,20
1746569673849,MCWP 50,A00,893758,Morshed; Michael James,0,0,20,20
1746569673849,MCWP 50,B00,893761,Bartulis; Jason Michael,17,0,20,3
1746569674879,MCWP 50R,A00,893766,Compas; Sean Matthew,0,1,20,20
1746569674879,MCWP 50R,B00,893769,Carter; Jennifer A,0,1,20,20
1746569674879,MCWP 50R,C00,893771,Krone; Jarret,0,3,20,20
1746569674879,MCWP 50R,D00,893772,Miller; Elizabeth Deen,0,0,20,20
1746569674879,MCWP 50R,E00,893775,Carter; Andrea L,0,1,20,20
1746569675906,MMW 11R,A01,892721,Herbst; Matthew,11,0,27,16
1746569675906,MMW 11R,A02,892722,Herbst; Matthew,0,0,0,3
1746569676935,MMW 12R,A01,892724,Herbst; Matthew,0,11,16,16
1746569676935,MMW 12R,A02,892725,Herbst; Matthew,0,10,16,16
1746569677961,MMW 13R,A01,892727,Staff,0,4,16,16
1746569677961,MMW 13R,A02,892728,Staff,0,4,16,16
1746569677961,MMW 13R,A03,958032,Staff,0,4,16,16
1746569677961,MMW 13R,A04,958033,Staff,0,4,16,16
1746569677961,MMW 13R,A05,958034,Staff,0,4,16,16
1746569678990,SIO 295LS,A00,894015,Staff,5,0,25,20
1746569680015,SIO 295S,A00,894020,Staff,5,0,25,20
1746569681041,SIOC 290S,B01,958918,Merrifield; Mark A,14,0,30,16
1746569682070,SIOC 291S,B01,958922,Gabriel; Corey John,14,0,30,16
1746569683192,SOCI 117,A01,895339,Staff,3,0,5,2
1746569684217,WES 237B,A00,894149,Staff,11,0,20,9
1746569686280,AESE 279B,A00,891859,Staff,13,0,35,22
1746569687305,AIP 197,001,891854,Vespa; Emanuel Ignacio,9999,0,9999,0
1746569688333,ANTH 289S,A00,891856,Gagneux; Pascal,12,0,12,0
1746569689360,BENG 196,001,957946,Engler; Adam J.,9996,0,9999,3
1746569690385,BISP 197,001,959851,Wilhelm; James E.,9998,0,9999,1
1746569691413,CAT 124RS,A01,956906,Staff,6,0,25,19
1746569692439,CAT 125RS,A01,922013,Staff,6,0,25,19
1746569693467,CLRE 250,A00,891860,Morris; Sheldon,9995,0,9999,4
1746569695517,CLRE 251R,A00,907817,Mehta; Ravindra L.,9994,0,9999,5
1746569696542,CLRE 252,A00,891864,Cuomo; Raphael Eduardo,9993,0,9999,6
1746569697566,CLRE 253,A00,891867,Vaida; Florin,9994,0,9999,5
1746569697566,CLRE 253,B00,907819,Staff,9999,0,9999,0
1746569698591,CLRE 259,A00,891868,Patel; Hemal,9998,0,9999,1
1746569699616,CLRE 260,A00,891872,Cuomo; Raphael Eduardo,9999,0,9999,0
1746569700640,CLRE 297,001,891888,Cuomo; Raphael Eduardo,9999,0,9999,0
1746569701666,CSE 191,A00,958773,Minnes Kemp; Mor Mia,9995,0,9999,4
1746569702690,CSE 197,001,959846,Minnes Kemp; Mor Mia,9990,0,9999,9
1746569703720,CSS 201S,A01,892054,Mignozzetti; Umberto,25,0,30,5
1746569704750,CSS 202S,A01,892056,Mignozzetti; Umberto,25,0,30,5
1746569705787,DSC 197,001,956898,Eldridge; Justin Matthew,9996,0,9999,3
1746569706818,DSC 297,001,958000,Mazumdar; Arya,9998,0,9999,1
1746569706818,DSC 297,002,959862,Wang; Yusu,9998,0,9999,1
1746569707845,EAP 100,A00,905686,Staff,9778,0,9999,221
1746569708874,ECE 45,A01,892618,Staff,0,0,65,65
1746569710930,ECE 111,A01,892719,Staff,5,0,65,60
1746569711960,ECE 197,001,957920,Mercier; Patrick Philip,9991,0,9999,8
1746569713004,ECON 178,A01,907814,Zhu; Ying,26,0,35,9
1746569714032,EDS 115,A00,895312,Staff,35,0,45,10
1746569715062,EDS 117,A01,895337,Staff,23,0,30,7
1746569716086,EDS 125,A00,895341,Jones; Gabrielle Anastasia,36,0,45,9
1746569717109,EDS 128A,A01,895459,Fargason; Sharon Gayle,44,0,45,1
1746569718134,EDS 128B,A01,895543,Pappas; Elizabeth,44,0,45,1
1746569719159,EDS 139,A00,897203,Pappas; Elizabeth,44,0,45,1
1746569719159,EDS 139,B00,897209,Fargason; Sharon Gayle,41,0,45,4
1746569720184,EDS 201,A00,895545,Staff,22,0,45,23
1746569721212,EDS 203,A01,895581,Halter; Christopher P.,22,0,45,23
1746569722236,EDS 204R,A01,895625,Heinzman; Erica M.,39,0,45,6
1746569722236,EDS 204R,B01,895693,Halter; Christopher P.,10,0,45,35
1746569723270,EDS 206R,A00,895694,Fargason; Sharon Gayle,1,0,30,29
1746569723270,EDS 206R,B00,895695,Choi; Bailey Miyeon,16,0,30,14
1746569724299,EDS 250,A00,895697,Hemans; Patricia Ann Benitez,22,0,45,23
1746569725323,EDS 281,A00,895701,Meyerott; Theresa Ann,1,0,15,14
1746569726349,EDS 284,A00,895736,Meyerott; Theresa Ann,1,0,15,14
1746569727375,EDS 286,A00,897210,Fine; Sarah,0,0,15,15
1746569728400,EDS 289C,A01,895770,Daly; Alan J.,1,0,15,14
1746569729424,EDS 290,A00,897211,Hofstetter; Carolyn,0,0,15,15
1746569730457,LIGM 5A,A00,896162,Fischer-Grunski; Eva K,12,0,20,8
1746569731486,LIGM 5B,A00,896260,Fischer-Grunski; Eva K,17,0,20,3
1746569732513,LIGM 5C,A00,896308,Fischer-Grunski; Eva K,18,0,20,2
1746569733538,LIIT 5AS,A00,896313,Carnelos; Chiara,18,0,20,2
1746569734566,LIIT 5BS,A00,896416,Carnelos; Chiara,20,0,20,0
1746569735594,LIIT 5CS,A00,896564,Carnelos; Chiara,20,0,20,0
1746569736622,LISP 5A,A00,896588,Munoz Sanchez; Alicia,2,0,20,18
1746569737650,LISP 5B,A00,896653,Munoz Sanchez; Alicia,7,0,20,13
1746569738676,LISP 5C,A00,896655,Munoz Sanchez; Alicia,0,1,20,20
1746569739700,MAE 197,001,957918,Kleissl; Jan,9996,0,9999,3
1746569739700,MAE 197,002,959806,Boechler; Nicholas Sebastia,9998,0,9999,1
1746569739700,MAE 197,003,959852,Mullin; Jennifer S,9998,0,9999,1
1746569740726,MATH 2,A01,957937,Staff,33,0,35,2
1746569741754,MATH 197,001,957876,Kedlaya; Kiran S.,9993,0,9999,6
1746569742782,MCWP 40,A00,892729,Duru; Nur,10,0,20,10
1746569742782,MCWP 40,B00,893304,Montejo; Carolina,14,0,20,6
1746569743806,MCWP 40R,A00,893757,Redela; Pamela Morgan,0,5,20,20
1746569744834,MCWP 50,A00,893758,Morshed; Michael James,0,0,20,20
1746569744834,MCWP 50,B00,893761,Bartulis; Jason Michael,17,0,20,3
1746569745858,MCWP 50R,A00,893766,Compas; Sean Matthew,0,1,20,20
1746569745858,MCWP 50R,B00,893769,Carter; Jennifer A,0,1,20,20
1746569745858,MCWP 50R,C00,893771,Krone; Jarret,0,3,20,20
1746569745858,MCWP 50R,D00,893772,Miller; Elizabeth Deen,0,0,20,20
1746569745858,MCWP 50R,E00,893775,Carter; Andrea L,0,1,20,20
1746569746887,MMW 11R,A01,892721,Herbst; Matthew,11,0,27,16
1746569746887,MMW 11R,A02,892722,Herbst; Matthew,0,0,0,3
1746569747914,MMW 12R,A01,892724,Herbst; Matthew,0,11,16,16
1746569747914,MMW 12R,A02,892725,Herbst; Matthew,0,10,16,16
1746569748941,MMW 13R,A01,892727,Staff,0,4,16,16
1746569748941,MMW 13R,A02,892728,Staff,0,4,16,16
1746569748941,MMW 13R,A03,958032,Staff,0,4,16,16
1746569748941,MMW 13R,A04,958033,Staff,0,4,16,16
1746569748941,MMW 13R,A05,958034,Staff,0,4,16,16
1746569749971,SIO 295LS,A00,894015,Staff,5,0,25,20
1746569751000,SIO 295S,A00,894020,Staff,5,0,25,20
1746569752030,SIOC 290S,B01,958918,Merrifield; Mark A,14,0,30,16
1746569753056,SIOC 291S,B01,958922,Gabriel; Corey John,14,0,30,16
1746569754083,SOCI 117,A01,895339,Staff,3,0,5,2
1746569755106,WES 237B,A00,894149,Staff,11,0,20,9
1746569757174,AESE 279B,A00,891859,Staff,13,0,35,22
1746569758201,AIP 197,001,891854,Vespa; Emanuel Ignacio,9999,0,9999,0
1746569759225,ANTH 289S,A00,891856,Gagneux; Pascal,12,0,12,0
1746569760251,BENG 196,001,957946,Engler; Adam J.,9996,0,9999,3
1746569761276,BISP 197,001,959851,Wilhelm; James E.,9998,0,9999,1
1746569762307,CAT 124RS,A01,956906,Staff,6,0,25,19
1746569763335,CAT 125RS,A01,922013,Staff,6,0,25,19
1746569764358,CLRE 250,A00,891860,Morris; Sheldon,9995,0,9999,4
1746569766415,CLRE 251R,A00,907817,Mehta; Ravindra L.,9994,0,9999,5
1746569767440,CLRE 252,A00,891864,Cuomo; Raphael Eduardo,9993,0,9999,6
1746569768465,CLRE 253,A00,891867,Vaida; Florin,9994,0,9999,5
1746569768465,CLRE 253,B00,907819,Staff,9999,0,9999,0
1746569769493,CLRE 259,A00,891868,Patel; Hemal,9998,0,9999,1
1746569770517,CLRE 260,A00,891872,Cuomo; Raphael Eduardo,9999,0,9999,0
1746569771543,CLRE 297,001,891888,Cuomo; Raphael Eduardo,9999,0,9999,0
1746569772568,CSE 191,A00,958773,Minnes Kemp; Mor Mia,9995,0,9999,4
1746569773592,CSE 197,001,959846,Minnes Kemp; Mor Mia,9990,0,9999,9
1746569774617,CSS 201S,A01,892054,Mignozzetti; Umberto,25,0,30,5
1746569775644,CSS 202S,A01,892056,Mignozzetti; Umberto,25,0,30,5
1746569776672,DSC 197,001,956898,Eldridge; Justin Matthew,9996,0,9999,3
1746569777702,DSC 297,001,958000,Mazumdar; Arya,9998,0,9999,1
1746569777702,DSC 297,002,959862,Wang; Yusu,9998,0,9999,1
1746569778726,EAP 100,A00,905686,Staff,9778,0,9999,221
1746569779757,ECE 45,A01,892618,Staff,0,0,65,65
1746569781809,ECE 111,A01,892719,Staff,5,0,65,60
1746569782838,ECE 197,001,957920,Mercier; Patrick Philip,9991,0,9999,8
1746569783867,ECON 178,A01,907814,Zhu; Ying,26,0,35,9
1746569784891,EDS 115,A00,895312,Staff,35,0,45,10
1746569785914,EDS 117,A01,895337,Staff,23,0,30,7
1746569786944,EDS 125,A00,895341,Jones; Gabrielle Anastasia,36,0,45,9
1746569787969,EDS 128A,A01,895459,Fargason; Sharon Gayle,44,0,45,1
1746569788995,EDS 128B,A01,895543,Pappas; Elizabeth,44,0,45,1
1746569790022,EDS 139,A00,897203,Pappas; Elizabeth,44,0,45,1
1746569790022,EDS 139,B00,897209,Fargason; Sharon Gayle,41,0,45,4
1746569791046,EDS 201,A00,895545,Staff,22,0,45,23
1746569792074,EDS 203,A01,895581,Halter; Christopher P.,22,0,45,23
1746569793098,EDS 204R,A01,895625,Heinzman; Erica M.,39,0,45,6
1746569793098,EDS 204R,B01,895693,Halter; Christopher P.,10,0,45,35
1746569794123,EDS 206R,A00,895694,Fargason; Sharon Gayle,1,0,30,29
1746569794123,EDS 206R,B00,895695,Choi; Bailey Miyeon,16,0,30,14
1746569795152,EDS 250,A00,895697,Hemans; Patricia Ann Benitez,22,0,45,23
1746569796179,EDS 281,A00,895701,Meyerott; Theresa Ann,1,0,15,14
1746569797204,EDS 284,A00,895736,Meyerott; Theresa Ann,1,0,15,14
1746569798233,EDS 286,A00,897210,Fine; Sarah,0,0,15,15
1746569799258,EDS 289C,A01,895770,Daly; Alan J.,1,0,15,14
1746569800284,EDS 290,A00,897211,Hofstetter; Carolyn,0,0,15,15
1746569801309,LIGM 5A,A00,896162,Fischer-Grunski; Eva K,12,0,20,8
1746569802334,LIGM 5B,A00,896260,Fischer-Grunski; Eva K,17,0,20,3
1746569803359,LIGM 5C,A00,896308,Fischer-Grunski; Eva K,18,0,20,2
1746569804382,LIIT 5AS,A00,896313,Carnelos; Chiara,18,0,20,2
1746569805411,LIIT 5BS,A00,896416,Carnelos; Chiara,20,0,20,0
1746569806438,LIIT 5CS,A00,896564,Carnelos; Chiara,20,0,20,0
1746569807465,LISP 5A,A00,896588,Munoz Sanchez; Alicia,2,0,20,18
1746569808498,LISP 5B,A00,896653,Munoz Sanchez; Alicia,7,0,20,13
1746569809523,LISP 5C,A00,896655,Munoz Sanchez; Alicia,0,1,20,20
1746569810547,MAE 197,001,957918,Kleissl; Jan,9996,0,9999,3
1746569810547,MAE 197,002,959806,Boechler; Nicholas Sebastia,9998,0,9999,1
1746569810547,MAE 197,003,959852,Mullin; Jennifer S,9998,0,9999,1
1746569811573,MATH 2,A01,957937,Staff,33,0,35,2
1746569812598,MATH 197,001,957876,Kedlaya; Kiran S.,9993,0,9999,6
1746569813627,MCWP 40,A00,892729,Duru; Nur,10,0,20,10
1746569813627,MCWP 40,B00,893304,Montejo; Carolina,14,0,20,6
1746569814650,MCWP 40R,A00,893757,Redela; Pamela Morgan,0,5,20,20
1746569815680,MCWP 50,A00,893758,Morshed; Michael James,0,0,20,20
1746569815680,MCWP 50,B00,893761,Bartulis; Jason Michael,17,0,20,3
1746569816710,MCWP 50R,A00,893766,Compas; Sean Matthew,0,1,20,20
1746569816710,MCWP 50R,B00,893769,Carter; Jennifer A,0,1,20,20
1746569816710,MCWP 50R,C00,893771,Krone; Jarret,0,3,20,20
1746569816710,MCWP 50R,D00,893772,Miller; Elizabeth Deen,0,0,20,20
1746569816710,MCWP 50R,E00,893775,Carter; Andrea L,0,1,20,20
1746569817736,MMW 11R,A01,892721,Herbst; Matthew,11,0,27,16
1746569817736,MMW 11R,A02,892722,Herbst; Matthew,0,0,0,3
1746569818766,MMW 12R,A01,892724,Herbst; Matthew,0,11,16,16
1746569818766,MMW 12R,A02,892725,Herbst; Matthew,0,10,16,16
1746569819792,MMW 13R,A01,892727,Staff,0,4,16,16
1746569819792,MMW 13R,A02,892728,Staff,0,4,16,16
1746569819792,MMW 13R,A03,958032,Staff,0,4,16,16
1746569819792,MMW 13R,A04,958033,Staff,0,4,16,16
1746569819792,MMW 13R,A05,958034,Staff,0,4,16,16
1746569820820,SIO 295LS,A00,894015,Staff,5,0,25,20
1746569821845,SIO 295S,A00,894020,Staff,5,0,25,20
1746569822870,SIOC 290S,B01,958918,Merrifield; Mark A,14,0,30,16
1746569823900,SIOC 291S,B01,958922,Gabriel; Corey John,14,0,30,16
1746569824930,SOCI 117,A01,895339,Staff,3,0,5,2
1746569825965,WES 237B,A00,894149,Staff,11,0,20,9
1746569828029,AESE 279B,A00,891859,Staff,13,0,35,22
1746569829054,AIP 197,001,891854,Vespa; Emanuel Ignacio,9999,0,9999,0
1746569830081,ANTH 289S,A00,891856,Gagneux; Pascal,12,0,12,0
1746569831112,BENG 196,001,957946,Engler; Adam J.,9996,0,9999,3
1746569832136,BISP 197,001,959851,Wilhelm; James E.,9998,0,9999,1
1746569833176,CAT 124RS,A01,956906,Staff,6,0,25,19
1746569834201,CAT 125RS,A01,922013,Staff,6,0,25,19
1746569835230,CLRE 250,A00,891860,Morris; Sheldon,9995,0,9999,4
1746569837282,CLRE 251R,A00,907817,Mehta; Ravindra L.,9994,0,9999,5
1746569838308,CLRE 252,A00,891864,Cuomo; Raphael Eduardo,9993,0,9999,6
1746569839332,CLRE 253,A00,891867,Vaida; Florin,9994,0,9999,5
1746569839332,CLRE 253,B00,907819,Staff,9999,0,9999,0
1746569840356,CLRE 259,A00,891868,Patel; Hemal,9998,0,9999,1
1746569841380,CLRE 260,A00,891872,Cuomo; Raphael Eduardo,9999,0,9999,0
1746569842418,CLRE 297,001,891888,Cuomo; Raphael Eduardo,9999,0,9999,0
1746569843440,CSE 191,A00,958773,Minnes Kemp; Mor Mia,9995,0,9999,4
1746569844464,CSE 197,001,959846,Minnes Kemp; Mor Mia,9990,0,9999,9
1746569845497,CSS 201S,A01,892054,Mignozzetti; Umberto,25,0,30,5
1746569846522,CSS 202S,A01,892056,Mignozzetti; Umberto,25,0,30,5
1746569847546,DSC 197,001,956898,Eldridge; Justin Matthew,9996,0,9999,3
1746569848575,DSC 297,001,958000,Mazumdar; Arya,9998,0,9999,1
1746569848575,DSC 297,002,959862,Wang; Yusu,9998,0,9999,1
1746569849601,EAP 100,A00,905686,Staff,9778,0,9999,221
1746569850628,ECE 45,A01,892618,Staff,0,0,65,65
1746569852681,ECE 111,A01,892719,Staff,5,0,65,60
1746569853710,ECE 197,001,957920,Mercier; Patrick Philip,9991,0,9999,8
1746569854736,ECON 178,A01,907814,Zhu; Ying,26,0,35,9
1746569855761,EDS 115,A00,895312,Staff,35,0,45,10
1746569856787,EDS 117,A01,895337,Staff,23,0,30,7
1746569857813,EDS 125,A00,895341,Jones; Gabrielle Anastasia,36,0,45,9
1746569858838,EDS 128A,A01,895459,Fargason; Sharon Gayle,44,0,45,1
1746569859863,EDS 128B,A01,895543,Pappas; Elizabeth,44,0,45,1
1746569860894,EDS 139,A00,897203,Pappas; Elizabeth,44,0,45,1
1746569860894,EDS 139,B00,897209,Fargason; Sharon Gayle,41,0,45,4
1746569861920,EDS 201,A00,895545,Staff,22,0,45,23
1746569862945,EDS 203,A01,895581,Halter; Christopher P.,22,0,45,23
1746569863973,EDS 204R,A01,895625,Heinzman; Erica M.,39,0,45,6
1746569863973,EDS 204R,B01,895693,Halter; Christopher P.,10,0,45,35
1746569865000,EDS 206R,A00,895694,Fargason; Sharon Gayle,1,0,30,29
1746569865000,EDS 206R,B00,895695,Choi; Bailey Miyeon,16,0,30,14
1746569866027,EDS 250,A00,895697,Hemans; Patricia Ann Benitez,22,0,45,23
1746569867057,EDS 281,A00,895701,Meyerott; Theresa Ann,1,0,15,14
1746569868083,EDS 284,A00,895736,Meyerott; Theresa Ann,1,0,15,14
1746569869111,EDS 286,A00,897210,Fine; Sarah,0,0,15,15
1746569870141,EDS 289C,A01,895770,Daly; Alan J.,1,0,15,14
1746569871165,EDS 290,A00,897211,Hofstetter; Carolyn,0,0,15,15
1746569872194,LIGM 5A,A00,896162,Fischer-Grunski; Eva K,12,0,20,8
1746569873226,LIGM 5B,A00,896260,Fischer-Grunski; Eva K,17,0,20,3
1746569874252,LIGM 5C,A00,896308,Fischer-Grunski; Eva K,18,0,20,2
1746569875281,LIIT 5AS,A00,896313,Carnelos; Chiara,18,0,20,2
1746569876309,LIIT 5BS,A00,896416,Carnelos; Chiara,20,0,20,0
1746569877339,LIIT 5CS,A00,896564,Carnelos; Chiara,20,0,20,0
1746569878367,LISP 5A,A00,896588,Munoz Sanchez; Alicia,2,0,20,18
1746569879396,LISP 5B,A00,896653,Munoz Sanchez; Alicia,7,0,20,13
1746569880419,LISP 5C,A00,896655,Munoz Sanchez; Alicia,0,1,20,20
1746569881444,MAE 197,001,957918,Kleissl; Jan,9996,0,9999,3
1746569881444,MAE 197,002,959806,Boechler; Nicholas Sebastia,9998,0,9999,1
1746569881444,MAE 197,003,959852,Mullin; Jennifer S,9998,0,9999,1
1746569882470,MATH 2,A01,957937,Staff,33,0,35,2
1746569883498,MATH 197,001,957876,Kedlaya; Kiran S.,9993,0,9999,6
1746569884524,MCWP 40,A00,892729,Duru; Nur,10,0,20,10
1746569884524,MCWP 40,B00,893304,Montejo; Carolina,14,0,20,6
1746569885557,MCWP 40R,A00,893757,Redela; Pamela Morgan,0,5,20,20
1746569886584,MCWP 50,A00,893758,Morshed; Michael James,0,0,20,20
1746569886584,MCWP 50,B00,893761,Bartulis; Jason Michael,17,0,20,3
1746569887611,MCWP 50R,A00,893766,Compas; Sean Matthew,0,1,20,20
1746569887611,MCWP 50R,B00,893769,Carter; Jennifer A,0,1,20,20
1746569887611,MCWP 50R,C00,893771,Krone; Jarret,0,3,20,20
1746569887611,MCWP 50R,D00,893772,Miller; Elizabeth Deen,0,0,20,20
1746569887611,MCWP 50R,E00,893775,Carter; Andrea L,0,1,20,20
1746569888637,MMW 11R,A01,892721,Herbst; Matthew,11,0,27,16
1746569888637,MMW 11R,A02,892722,Herbst; Matthew,0,0,0,3
1746569889668,MMW 12R,A01,892724,Herbst; Matthew,0,11,16,16
1746569889668,MMW 12R,A02,892725,Herbst; Matthew,0,10,16,16
1746569890710,MMW 13R,A01,892727,Staff,0,4,16,16
1746569890710,MMW 13R,A02,892728,Staff,0,4,16,16
1746569890710,MMW 13R,A03,958032,Staff,0,4,16,16
1746569890710,MMW 13R,A04,958033,Staff,0,4,16,16
1746569890710,MMW 13R,A05,958034,Staff,0,4,16,16
1746569891735,SIO 295LS,A00,894015,Staff,5,0,25,20
1746569892762,SIO 295S,A00,894020,Staff,5,0,25,20
1746569893788,SIOC 290S,B01,958918,Merrifield; Mark A,14,0,30,16
1746569894818,SIOC 291S,B01,958922,Gabriel; Corey John,14,0,30,16
1746569895845,SOCI 117,A01,895339,Staff,3,0,5,2
1746569896870,WES 237B,A00,894149,Staff,11,0,20,9
1746569898943,AESE 279B,A00,891859,Staff,13,0,35,22
1746569899969,AIP 197,001,891854,Vespa; Emanuel Ignacio,9999,0,9999,0
1746569900994,ANTH 289S,A00,891856,Gagneux; Pascal,12,0,12,0
1746569902023,BENG 196,001,957946,Engler; Adam J.,9996,0,9999,3
1746569903051,BISP 197,001,959851,Wilhelm; James E.,9998,0,9999,1
1746569904104,CAT 124RS,A01,956906,Staff,6,0,25,19
1746569905132,CAT 125RS,A01,922013,Staff,6,0,25,19
1746569906160,CLRE 250,A00,891860,Morris; Sheldon,9995,0,9999,4
1746569908210,CLRE 251R,A00,907817,Mehta; Ravindra L.,9994,0,9999,5
1746569909237,CLRE 252,A00,891864,Cuomo; Raphael Eduardo,9993,0,9999,6
1746569910261,CLRE 253,A00,891867,Vaida; Florin,9994,0,9999,5
1746569910261,CLRE 253,B00,907819,Staff,9999,0,9999,0
1746569911285,CLRE 259,A00,891868,Patel; Hemal,9998,0,9999,1
1746569912312,CLRE 260,A00,891872,Cuomo; Raphael Eduardo,9999,0,9999,0
1746569913339,CLRE 297,001,891888,Cuomo; Raphael Eduardo,9999,0,9999,0
1746569914363,CSE 191,A00,958773,Minnes Kemp; Mor Mia,9995,0,9999,4
1746569915387,CSE 197,001,959846,Minnes Kemp; Mor Mia,9990,0,9999,9
1746569916413,CSS 201S,A01,892054,Mignozzetti; Umberto,25,0,30,5
1746569917442,CSS 202S,A01,892056,Mignozzetti; Umberto,25,0,30,5
1746569918468,DSC 197,001,956898,Eldridge; Justin Matthew,9996,0,9999,3
1746569919496,DSC 297,001,958000,Mazumdar; Arya,9998,0,9999,1
1746569919496,DSC 297,002,959862,Wang; Yusu,9998,0,9999,1
1746569920520,EAP 100,A00,905686,Staff,9778,0,9999,221
1746569921549,ECE 45,A01,892618,Staff,0,0,65,65
1746569923602,ECE 111,A01,892719,Staff,5,0,65,60
1746569924627,ECE 197,001,957920,Mercier; Patrick Philip,9991,0,9999,8
1746569925652,ECON 178,A01,907814,Zhu; Ying,26,0,35,9
1746569926680,EDS 115,A00,895312,Staff,35,0,45,10
1746569927703,EDS 117,A01,895337,Staff,23,0,30,7
1746569928732,EDS 125,A00,895341,Jones; Gabrielle Anastasia,36,0,45,9
1746569929762,EDS 128A,A01,895459,Fargason; Sharon Gayle,44,0,45,1
1746569930785,EDS 128B,A01,895543,Pappas; Elizabeth,44,0,45,1
1746569931809,EDS 139,A00,897203,Pappas; Elizabeth,44,0,45,1
1746569931809,EDS 139,B00,897209,Fargason; Sharon Gayle,41,0,45,4
1746569932833,EDS 201,A00,895545,Staff,22,0,45,23
1746569933863,EDS 203,A01,895581,Halter; Christopher P.,22,0,45,23
1746569934893,EDS 204R,A01,895625,Heinzman; Erica M.,39,0,45,6
1746569934893,EDS 204R,B01,895693,Halter; Christopher P.,10,0,45,35
1746569935919,EDS 206R,A00,895694,Fargason; Sharon Gayle,1,0,30,29
1746569935919,EDS 206R,B00,895695,Choi; Bailey Miyeon,16,0,30,14
1746569936947,EDS 250,A00,895697,Hemans; Patricia Ann Benitez,22,0,45,23
1746569937974,EDS 281,A00,895701,Meyerott; Theresa Ann,1,0,15,14
1746569938998,EDS 284,A00,895736,Meyerott; Theresa Ann,1,0,15,14
1746569940027,EDS 286,A00,897210,Fine; Sarah,0,0,15,15
1746569941055,EDS 289C,A01,895770,Daly; Alan J.,1,0,15,14
1746569942087,EDS 290,A00,897211,Hofstetter; Carolyn,0,0,15,15
1746569943112,LIGM 5A,A00,896162,Fischer-Grunski; Eva K,12,0,20,8
1746569944144,LIGM 5B,A00,896260,Fischer-Grunski; Eva K,17,0,20,3
1746569945173,LIGM 5C,A00,896308,Fischer-Grunski; Eva K,18,0,20,2
1746569946198,LIIT 5AS,A00,896313,Carnelos; Chiara,18,0,20,2
1746569947223,LIIT 5BS,A00,896416,Carnelos; Chiara,20,0,20,0
1746569948251,LIIT 5CS,A00,896564,Carnelos; Chiara,20,0,20,0
1746569949276,LISP 5A,A00,896588,Munoz Sanchez; Alicia,2,0,20,18
1746569950300,LISP 5B,A00,896653,Munoz Sanchez; Alicia,7,0,20,13
1746569951327,LISP 5C,A00,896655,Munoz Sanchez; Alicia,0,1,20,20
1746569952352,MAE 197,001,957918,Kleissl; Jan,9996,0,9999,3
1746569952352,MAE 197,002,959806,Boechler; Nicholas Sebastia,9998,0,9999,1
1746569952352,MAE 197,003,959852,Mullin; Jennifer S,9998,0,9999,1
1746569953378,MATH 2,A01,957937,Staff,33,0,35,2
1746569954406,MATH 197,001,957876,Kedlaya; Kiran S.,9993,0,9999,6
1746569955436,MCWP 40,A00,892729,Duru; Nur,10,0,20,10
1746569955436,MCWP 40,B00,893304,Montejo; Carolina,14,0,20,6
1746569956467,MCWP 40R,A00,893757,Redela; Pamela Morgan,0,5,20,20
1746569957492,MCWP 50,A00,893758,Morshed; Michael James,0,0,20,20
1746569957492,MCWP 50,B00,893761,Bartulis; Jason Michael,17,0,20,3
1746569958518,MCWP 50R,A00,893766,Compas; Sean Matthew,0,1,20,20
1746569958518,MCWP 50R,B00,893769,Carter; Jennifer A,0,1,20,20
1746569958518,MCWP 50R,C00,893771,Krone; Jarret,0,3,20,20
1746569958518,MCWP 50R,D00,893772,Miller; Elizabeth Deen,0,0,20,20
1746569958518,MCWP 50R,E00,893775,Carter; Andrea L,0,1,20,20
1746569959548,MMW 11R,A01,892721,Herbst; Matthew,11,0,27,16
1746569959548,MMW 11R,A02,892722,Herbst; Matthew,0,0,0,3
1746569960577,MMW 12R,A01,892724,Herbst; Matthew,0,11,16,16
1746569960577,MMW 12R,A02,892725,Herbst; Matthew,0,10,16,16
1746569961603,MMW 13R,A01,892727,Staff,0,4,16,16
1746569961603,MMW 13R,A02,892728,Staff,0,4,16,16
1746569961603,MMW 13R,A03,958032,Staff,0,4,16,16
1746569961603,MMW 13R,A04,958033,Staff,0,4,16,16
1746569961603,MMW 13R,A05,958034,Staff,0,4,16,16
1746569962632,SIO 295LS,A00,894015,Staff,5,0,25,20
1746569963670,SIO 295S,A00,894020,Staff,5,0,25,20
1746569964696,SIOC 290S,B01,958918,Merrifield; Mark A,14,0,30,16
1746569965723,SIOC 291S,B01,958922,Gabriel; Corey John,14,0,30,16
1746569966751,SOCI 117,A01,895339,Staff,3,0,5,2
1746569967778,WES 237B,A00,894149,Staff,11,0,20,9
1746569969837,AESE 279B,A00,891859,Staff,13,0,35,22
1746569970862,AIP 197,001,891854,Vespa; Emanuel Ignacio,9999,0,9999,0
1746569971890,ANTH 289S,A00,891856,Gagneux; Pascal,12,0,12,0
1746569972914,BENG 196,001,957946,Engler; Adam J.,9996,0,9999,3
1746569973941,BISP 197,001,959851,Wilhelm; James E.,9998,0,9999,1
1746569974969,CAT 124RS,A01,956906,Staff,6,0,25,19
1746569975995,CAT 125RS,A01,922013,Staff,6,0,25,19
1746569977026,CLRE 250,A00,891860,Morris; Sheldon,9995,0,9999,4
1746569979075,CLRE 251R,A00,907817,Mehta; Ravindra L.,9994,0,9999,5
1746569980104,CLRE 252,A00,891864,Cuomo; Raphael Eduardo,9993,0,9999,6
1746569981132,CLRE 253,A00,891867,Vaida; Florin,9994,0,9999,5
1746569981132,CLRE 253,B00,907819,Staff,9999,0,9999,0
1746569982164,CLRE 259,A00,891868,Patel; Hemal,9998,0,9999,1
1746569983189,CLRE 260,A00,891872,Cuomo; Raphael Eduardo,9999,0,9999,0
1746569984219,CLRE 297,001,891888,Cuomo; Raphael Eduardo,9999,0,9999,0
1746569985246,CSE 191,A00,958773,Minnes Kemp; Mor Mia,9995,0,9999,4
1746569986278,CSE 197,001,959846,Minnes Kemp; Mor Mia,9990,0,9999,9
1746569987308,CSS 201S,A01,892054,Mignozzetti; Umberto,25,0,30,5
1746569988334,CSS 202S,A01,892056,Mignozzetti; Umberto,25,0,30,5
1746569989360,DSC 197,001,956898,Eldridge; Justin Matthew,9996,0,9999,3
1746569990390,DSC 297,001,958000,Mazumdar; Arya,9998,0,9999,1
1746569990390,DSC 297,002,959862,Wang; Yusu,9998,0,9999,1
1746569991417,EAP 100,A00,905686,Staff,9778,0,9999,221
1746569992442,ECE 45,A01,892618,Staff,0,0,65,65
1746569994500,ECE 111,A01,892719,Staff,5,0,65,60
1746569995526,ECE 197,001,957920,Mercier; Patrick Philip,9991,0,9999,8
1746569996556,ECON 178,A01,907814,Zhu; Ying,26,0,35,9
1746569997579,EDS 115,A00,895312,Staff,35,0,45,10
1746569998608,EDS 117,A01,895337,Staff,23,0,30,7
1746569999637,EDS 125,A00,895341,Jones; Gabrielle Anastasia,36,0,45,9
1746570000661,EDS 128A,A01,895459,Fargason; Sharon Gayle,44,0,45,1
1746570001685,EDS 128B,A01,895543,Pappas; Elizabeth,44,0,45,1
1746570002712,EDS 139,A00,897203,Pappas; Elizabeth,44,0,45,1
1746570002712,EDS 139,B00,897209,Fargason; Sharon Gayle,41,0,45,4
1746570003740,EDS 201,A00,895545,Staff,22,0,45,23
1746570004767,EDS 203,A01,895581,Halter; Christopher P.,22,0,45,23
1746570005793,EDS 204R,A01,895625,Heinzman; Erica M.,39,0,45,6
1746570005793,EDS 204R,B01,895693,Halter; Christopher P.,10,0,45,35
1746570006822,EDS 206R,A00,895694,Fargason; Sharon Gayle,1,0,30,29
1746570006822,EDS 206R,B00,895695,Choi; Bailey Miyeon,16,0,30,14
1746570007850,EDS 250,A00,895697,Hemans; Patricia Ann Benitez,22,0,45,23
1746570008878,EDS 281,A00,895701,Meyerott; Theresa Ann,1,0,15,14
1746570009905,EDS 284,A00,895736,Meyerott; Theresa Ann,1,0,15,14
1746570010933,EDS 286,A00,897210,Fine; Sarah,0,0,15,15
1746570011958,EDS 289C,A01,895770,Daly; Alan J.,1,0,15,14
1746570012983,EDS 290,A00,897211,Hofstetter; Carolyn,0,0,15,15
1746570014013,LIGM 5A,A00,896162,Fischer-Grunski; Eva K,12,0,20,8
1746570015043,LIGM 5B,A00,896260,Fischer-Grunski; Eva K,17,0,20,3
1746570016073,LIGM 5C,A00,896308,Fischer-Grunski; Eva K,18,0,20,2
1746570017102,LIIT 5AS,A00,896313,Carnelos; Chiara,18,0,20,2
1746570018130,LIIT 5BS,A00,896416,Carnelos; Chiara,20,0,20,0
1746570019156,LIIT 5CS,A00,896564,Carnelos; Chiara,20,0,20,0
1746570020185,LISP 5A,A00,896588,Munoz Sanchez; Alicia,2,0,20,18
1746570021217,LISP 5B,A00,896653,Munoz Sanchez; Alicia,7,0,20,13
1746570022247,LISP 5C,A00,896655,Munoz Sanchez; Alicia,0,1,20,20
1746570023273,MAE 197,001,957918,Kleissl; Jan,9996,0,9999,3
1746570023273,MAE 197,002,959806,Boechler; Nicholas Sebastia,9998,0,9999,1
1746570023273,MAE 197,003,959852,Mullin; Jennifer S,9998,0,9999,1
1746570024303,MATH 2,A01,957937,Staff,33,0,35,2
1746570025330,MATH 197,001,957876,Kedlaya; Kiran S.,9993,0,9999,6
1746570026355,MCWP 40,A00,892729,Duru; Nur,10,0,20,10
1746570026355,MCWP 40,B00,893304,Montejo; Carolina,14,0,20,6
1746570027381,MCWP 40R,A00,893757,Redela; Pamela Morgan,0,5,20,20
1746570028407,MCWP 50,A00,893758,Morshed; Michael James,0,0,20,20
1746570028407,MCWP 50,B00,893761,Bartulis; Jason Michael,17,0,20,3
1746570029432,MCWP 50R,A00,893766,Compas; Sean Matthew,0,1,20,20
1746570029432,MCWP 50R,B00,893769,Carter; Jennifer A,0,1,20,20
1746570029432,MCWP 50R,C00,893771,Krone; Jarret,0,3,20,20
1746570029432,MCWP 50R,D00,893772,Miller; Elizabeth Deen,0,0,20,20
1746570029432,MCWP 50R,E00,893775,Carter; Andrea L,0,1,20,20
1746570030459,MMW 11R,A01,892721,Herbst; Matthew,11,0,27,16
1746570030459,MMW 11R,A02,892722,Herbst; Matthew,0,0,0,3
1746570031697,MMW 12R,A01,892724,Herbst; Matthew,0,11,16,16
1746570031697,MMW 12R,A02,892725,Herbst; Matthew,0,10,16,16
1746570032726,MMW 13R,A01,892727,Staff,0,4,16,16
1746570032726,MMW 13R,A02,892728,Staff,0,4,16,16
1746570032726,MMW 13R,A03,958032,Staff,0,4,16,16
1746570032726,MMW 13R,A04,958033,Staff,0,4,16,16
1746570032726,MMW 13R,A05,958034,Staff,0,4,16,16
1746570033753,SIO 295LS,A00,894015,Staff,5,0,25,20
1746570034780,SIO 295S,A00,894020,Staff,5,0,25,20
1746570035809,SIOC 290S,B01,958918,Merrifield; Mark A,14,0,30,16
1746570036852,SIOC 291S,B01,958922,Gabriel; Corey John,14,0,30,16
1746570037876,SOCI 117,A01,895339,Staff,3,0,5,2
1746570038904,WES 237B,A00,894149,Staff,11,0,20,9
1746570040971,AESE 279B,A00,891859,Staff,13,0,35,22
1746570041995,AIP 197,001,891854,Vespa; Emanuel Ignacio,9999,0,9999,0
1746570043022,ANTH 289S,A00,891856,Gagneux; Pascal,12,0,12,0
1746570044050,BENG 196,001,957946,Engler; Adam J.,9996,0,9999,3
1746570045074,BISP 197,001,959851,Wilhelm; James E.,9998,0,9999,1
1746570046100,CAT 124RS,A01,956906,Staff,6,0,25,19
1746570047127,CAT 125RS,A01,922013,Staff,6,0,25,19
1746570048153,CLRE 250,A00,891860,Morris; Sheldon,9995,0,9999,4
1746570050201,CLRE 251R,A00,907817,Mehta; Ravindra L.,9994,0,9999,5
1746570051226,CLRE 252,A00,891864,Cuomo; Raphael Eduardo,9993,0,9999,6
1746570052251,CLRE 253,A00,891867,Vaida; Florin,9994,0,9999,5
1746570052251,CLRE 253,B00,907819,Staff,9999,0,9999,0
1746570053275,CLRE 259,A00,891868,Patel; Hemal,9998,0,9999,1
1746570054321,CLRE 260,A00,891872,Cuomo; Raphael Eduardo,9999,0,9999,0
1746570055344,CLRE 297,001,891888,Cuomo; Raphael Eduardo,9999,0,9999,0
1746570056374,CSE 191,A00,958773,Minnes Kemp; Mor Mia,9995,0,9999,4
1746570057401,CSE 197,001,959846,Minnes Kemp; Mor Mia,9990,0,9999,9
1746570058426,CSS 201S,A01,892054,Mignozzetti; Umberto,25,0,30,5
1746570059454,CSS 202S,A01,892056,Mignozzetti; Umberto,25,0,30,5
1746570060479,DSC 197,001,956898,Eldridge; Justin Matthew,9996,0,9999,3
1746570061509,DSC 297,001,958000,Mazumdar; Arya,9998,0,9999,1
1746570061509,DSC 297,002,959862,Wang; Yusu,9998,0,9999,1
1746570062534,EAP 100,A00,905686,Staff,9778,0,9999,221
1746570063559,ECE 45,A01,892618,Staff,0,0,65,65
1746570065612,ECE 111,A01,892719,Staff,5,0,65,60
1746570066641,ECE 197,001,957920,Mercier; Patrick Philip,9991,0,9999,8
1746570067665,ECON 178,A01,907814,Zhu; Ying,26,0,35,9
1746570069296,EDS 115,A00,895312,Staff,35,0,45,10
1746570070322,EDS 117,A01,895337,Staff,23,0,30,7
1746570071350,EDS 125,A00,895341,Jones; Gabrielle Anastasia,36,0,45,9
1746570072377,EDS 128A,A01,895459,Fargason; Sharon Gayle,44,0,45,1
1746570073404,EDS 128B,A01,895543,Pappas; Elizabeth,44,0,45,1
1746570074430,EDS 139,A00,897203,Pappas; Elizabeth,44,0,45,1
1746570074430,EDS 139,B00,897209,Fargason; Sharon Gayle,41,0,45,4
1746570075457,EDS 201,A00,895545,Staff,22,0,45,23
1746570076481,EDS 203,A01,895581,Halter; Christopher P.,22,0,45,23
1746570077505,EDS 204R,A01,895625,Heinzman; Erica M.,39,0,45,6
1746570077505,EDS 204R,B01,895693,Halter; Christopher P.,10,0,45,35
1746570078534,EDS 206R,A00,895694,Fargason; Sharon Gayle,1,0,30,29
1746570078534,EDS 206R,B00,895695,Choi; Bailey Miyeon,16,0,30,14
1746570079557,EDS 250,A00,895697,Hemans; Patricia Ann Benitez,22,0,45,23
1746570080583,EDS 281,A00,895701,Meyerott; Theresa Ann,1,0,15,14
1746570081614,EDS 284,A00,895736,Meyerott; Theresa Ann,1,0,15,14
1746570082641,EDS 286,A00,897210,Fine; Sarah,0,0,15,15
1746570083666,EDS 289C,A01,895770,Daly; Alan J.,1,0,15,14
1746570084692,EDS 290,A00,897211,Hofstetter; Carolyn,0,0,15,15
1746570085720,LIGM 5A,A00,896162,Fischer-Grunski; Eva K,12,0,20,8
1746570086746,LIGM 5B,A00,896260,Fischer-Grunski; Eva K,17,0,20,3
1746570087775,LIGM 5C,A00,896308,Fischer-Grunski; Eva K,18,0,20,2
1746570088804,LIIT 5AS,A00,896313,Carnelos; Chiara,18,0,20,2
1746570089832,LIIT 5BS,A00,896416,Carnelos; Chiara,20,0,20,0
1746570090860,LIIT 5CS,A00,896564,Carnelos; Chiara,20,0,20,0
1746570091888,LISP 5A,A00,896588,Munoz Sanchez; Alicia,2,0,20,18
1746570092913,LISP 5B,A00,896653,Munoz Sanchez; Alicia,7,0,20,13
1746570093937,LISP 5C,A00,896655,Munoz Sanchez; Alicia,0,1,20,20
1746570094966,MAE 197,001,957918,Kleissl; Jan,9996,0,9999,3
1746570094966,MAE 197,002,959806,Boechler; Nicholas Sebastia,9998,0,9999,1
1746570094966,MAE 197,003,959852,Mullin; Jennifer S,9998,0,9999,1
1746570095992,MATH 2,A01,957937,Staff,33,0,35,2
1746570097057,MATH 197,001,957876,Kedlaya; Kiran S.,9993,0,9999,6
1746570098081,MCWP 40,A00,892729,Duru; Nur,10,0,20,10
1746570098081,MCWP 40,B00,893304,Montejo; Carolina,14,0,20,6
1746570099110,MCWP 40R,A00,893757,Redela; Pamela Morgan,0,5,20,20
1746570100134,MCWP 50,A00,893758,Morshed; Michael James,0,0,20,20
1746570100134,MCWP 50,B00,893761,Bartulis; Jason Michael,17,0,20,3
1746570101163,MCWP 50R,A00,893766,Compas; Sean Matthew,0,1,20,20
1746570101163,MCWP 50R,B00,893769,Carter; Jennifer A,0,1,20,20
1746570101163,MCWP 50R,C00,893771,Krone; Jarret,0,3,20,20
1746570101163,MCWP 50R,D00,893772,Miller; Elizabeth Deen,0,0,20,20
1746570101163,MCWP 50R,E00,893775,Carter; Andrea L,0,1,20,20
1746570102191,MMW 11R,A01,892721,Herbst; Matthew,11,0,27,16
1746570102191,MMW 11R,A02,892722,Herbst; Matthew,0,0,0,3
1746570103220,MMW 12R,A01,892724,Herbst; Matthew,0,11,16,16
1746570103220,MMW 12R,A02,892725,Herbst; Matthew,0,10,16,16
1746570104244,MMW 13R,A01,892727,Staff,0,4,16,16
1746570104244,MMW 13R,A02,892728,Staff,0,4,16,16
1746570104244,MMW 13R,A03,958032,Staff,0,4,16,16
1746570104244,MMW 13R,A04,958033,Staff,0,4,16,16
1746570104244,MMW 13R,A05,958034,Staff,0,4,16,16
1746570105270,SIO 295LS,A00,894015,Staff,5,0,25,20
1746570106297,SIO 295S,A00,894020,Staff,5,0,25,20
1746570107323,SIOC 290S,B01,958918,Merrifield; Mark A,14,0,30,16
1746570108350,SIOC 291S,B01,958922,Gabriel; Corey John,14,0,30,16
1746570109375,SOCI 117,A01,895339,Staff,3,0,5,2
1746570110401,WES 237B,A00,894149,Staff,11,0,20,9
1746570112471,AESE 279B,A00,891859,Staff,13,0,35,22
1746570113496,AIP 197,001,891854,Vespa; Emanuel Ignacio,9999,0,9999,0
1746570114526,ANTH 289S,A00,891856,Gagneux; Pascal,12,0,12,0
1746570115552,BENG 196,001,957946,Engler; Adam J.,9996,0,9999,3
1746570116579,BISP 197,001,959851,Wilhelm; James E.,9998,0,9999,1
1746570117605,CAT 124RS,A01,956906,Staff,6,0,25,19
1746570118633,CAT 125RS,A01,922013,Staff,6,0,25,19
1746570119662,CLRE 250,A00,891860,Morris; Sheldon,9995,0,9999,4
1746570121718,CLRE 251R,A00,907817,Mehta; Ravindra L.,9994,0,9999,5
1746570122744,CLRE 252,A00,891864,Cuomo; Raphael Eduardo,9993,0,9999,6
1746570123770,CLRE 253,A00,891867,Vaida; Florin,9994,0,9999,5
1746570123770,CLRE 253,B00,907819,Staff,9999,0,9999,0
1746570124796,CLRE 259,A00,891868,Patel; Hemal,9998,0,9999,1
1746570125822,CLRE 260,A00,891872,Cuomo; Raphael Eduardo,9999,0,9999,0
1746570126852,CLRE 297,001,891888,Cuomo; Raphael Eduardo,9999,0,9999,0
1746570127878,CSE 191,A00,958773,Minnes Kemp; Mor Mia,9995,0,9999,4
1746570128906,CSE 197,001,959846,Minnes Kemp; Mor Mia,9990,0,9999,9
1746570129936,CSS 201S,A01,892054,Mignozzetti; Umberto,25,0,30,5
1746570130960,CSS 202S,A01,892056,Mignozzetti; Umberto,25,0,30,5
1746570131992,DSC 197,001,956898,Eldridge; Justin Matthew,9996,0,9999,3
1746570133017,DSC 297,001,958000,Mazumdar; Arya,9998,0,9999,1
1746570133017,DSC 297,002,959862,Wang; Yusu,9998,0,9999,1
1746570134042,EAP 100,A00,905686,Staff,9778,0,9999,221
1746570135068,ECE 45,A01,892618,Staff,0,0,65,65
1746570137119,ECE 111,A01,892719,Staff,5,0,65,60
1746570138147,ECE 197,001,957920,Mercier; Patrick Philip,9991,0,9999,8
1746570139175,ECON 178,A01,907814,Zhu; Ying,26,0,35,9
1746570140200,EDS 115,A00,895312,Staff,35,0,45,10
1746570141225,EDS 117,A01,895337,Staff,23,0,30,7
1746570142254,EDS 125,A00,895341,Jones; Gabrielle Anastasia,36,0,45,9
1746570143280,EDS 128A,A01,895459,Fargason; Sharon Gayle,44,0,45,1
1746570144307,EDS 128B,A01,895543,Pappas; Elizabeth,44,0,45,1
1746570145336,EDS 139,A00,897203,Pappas; Elizabeth,44,0,45,1
1746570145336,EDS 139,B00,897209,Fargason; Sharon Gayle,41,0,45,4
1746570146361,EDS 201,A00,895545,Staff,22,0,45,23
1746570147391,EDS 203,A01,895581,Halter; Christopher P.,22,0,45,23
1746570148417,EDS 204R,A01,895625,Heinzman; Erica M.,39,0,45,6
1746570148417,EDS 204R,B01,895693,Halter; Christopher P.,10,0,45,35
1746570149442,EDS 206R,A00,895694,Fargason; Sharon Gayle,1,0,30,29
1746570149442,EDS 206R,B00,895695,Choi; Bailey Miyeon,16,0,30,14
1746570150468,EDS 250,A00,895697,Hemans; Patricia Ann Benitez,22,0,45,23
1746570151496,EDS 281,A00,895701,Meyerott; Theresa Ann,1,0,15,14
1746570152521,EDS 284,A00,895736,Meyerott; Theresa Ann,1,0,15,14
1746570153545,EDS 286,A00,897210,Fine; Sarah,0,0,15,15
1746570154573,EDS 289C,A01,895770,Daly; Alan J.,1,0,15,14
1746570155599,EDS 290,A00,897211,Hofstetter; Carolyn,0,0,15,15
1746570156628,LIGM 5A,A00,896162,Fischer-Grunski; Eva K,12,0,20,8
1746570157653,LIGM 5B,A00,896260,Fischer-Grunski; Eva K,17,0,20,3
1746570158678,LIGM 5C,A00,896308,Fischer-Grunski; Eva K,18,0,20,2
1746570159702,LIIT 5AS,A00,896313,Carnelos; Chiara,18,0,20,2
1746570160728,LIIT 5BS,A00,896416,Carnelos; Chiara,20,0,20,0
1746570161753,LIIT 5CS,A00,896564,Carnelos; Chiara,20,0,20,0
1746570162779,LISP 5A,A00,896588,Munoz Sanchez; Alicia,2,0,20,18
1746570163805,LISP 5B,A00,896653,Munoz Sanchez; Alicia,7,0,20,13
1746570164831,LISP 5C,A00,896655,Munoz Sanchez; Alicia,0,1,20,20
1746570165856,MAE 197,001,957918,Kleissl; Jan,9996,0,9999,3
1746570165856,MAE 197,002,959806,Boechler; Nicholas Sebastia,9998,0,9999,1
1746570165856,MAE 197,003,959852,Mullin; Jennifer S,9998,0,9999,1
1746570166882,MATH 2,A01,957937,Staff,33,0,35,2
1746570167905,MATH 197,001,957876,Kedlaya; Kiran S.,9993,0,9999,6
1746570168932,MCWP 40,A00,892729,Duru; Nur,10,0,20,10
1746570168932,MCWP 40,B00,893304,Montejo; Carolina,14,0,20,6
1746570169961,MCWP 40R,A00,893757,Redela; Pamela Morgan,0,5,20,20
1746570170989,MCWP 50,A00,893758,Morshed; Michael James,0,0,20,20
1746570170989,MCWP 50,B00,893761,Bartulis; Jason Michael,17,0,20,3
1746570172015,MCWP 50R,A00,893766,Compas; Sean Matthew,0,1,20,20
1746570172015,MCWP 50R,B00,893769,Carter; Jennifer A,0,1,20,20
1746570172015,MCWP 50R,C00,893771,Krone; Jarret,0,3,20,20
1746570172015,MCWP 50R,D00,893772,Miller; Elizabeth Deen,0,0,20,20
1746570172015,MCWP 50R,E00,893775,Carter; Andrea L,0,1,20,20
1746570173041,MMW 11R,A01,892721,Herbst; Matthew,11,0,27,16
1746570173041,MMW 11R,A02,892722,Herbst; Matthew,0,0,0,3
1746570174066,MMW 12R,A01,892724,Herbst; Matthew,0,11,16,16
1746570174066,MMW 12R,A02,892725,Herbst; Matthew,0,10,16,16
1746570175094,MMW 13R,A01,892727,Staff,0,4,16,16
1746570175094,MMW 13R,A02,892728,Staff,0,4,16,16
1746570175094,MMW 13R,A03,958032,Staff,0,4,16,16
1746570175094,MMW 13R,A04,958033,Staff,0,4,16,16
1746570175094,MMW 13R,A05,958034,Staff,0,4,16,16
1746570176119,SIO 295LS,A00,894015,Staff,5,0,25,20
1746570177149,SIO 295S,A00,894020,Staff,5,0,25,20
1746570178178,SIOC 290S,B01,958918,Merrifield; Mark A,14,0,30,16
1746570179204,SIOC 291S,B01,958922,Gabriel; Corey John,14,0,30,16
1746570180247,SOCI 117,A01,895339,Staff,3,0,5,2
1746570181272,WES 237B,A00,894149,Staff,11,0,20,9
1746570183338,AESE 279B,A00,891859,Staff,13,0,35,22
1746570184363,AIP 197,001,891854,Vespa; Emanuel Ignacio,9999,0,9999,0
1746570185391,ANTH 289S,A00,891856,Gagneux; Pascal,12,0,12,0
1746570186420,BENG 196,001,957946,Engler; Adam J.,9996,0,9999,3
1746570187448,BISP 197,001,959851,Wilhelm; James E.,9998,0,9999,1
1746570188472,CAT 124RS,A01,956906,Staff,6,0,25,19
1746570189499,CAT 125RS,A01,922013,Staff,6,0,25,19
1746570190526,CLRE 250,A00,891860,Morris; Sheldon,9995,0,9999,4
1746570192592,CLRE 251R,A00,907817,Mehta; Ravindra L.,9994,0,9999,5
1746570193619,CLRE 252,A00,891864,Cuomo; Raphael Eduardo,9993,0,9999,6
1746570194645,CLRE 253,A00,891867,Vaida; Florin,9994,0,9999,5
1746570194645,CLRE 253,B00,907819,Staff,9999,0,9999,0
1746570195673,CLRE 259,A00,891868,Patel; Hemal,9998,0,9999,1
1746570196700,CLRE 260,A00,891872,Cuomo; Raphael Eduardo,9999,0,9999,0
1746570197731,CLRE 297,001,891888,Cuomo; Raphael Eduardo,9999,0,9999,0
1746570198757,CSE 191,A00,958773,Minnes Kemp; Mor Mia,9995,0,9999,4
1746570199787,CSE 197,001,959846,Minnes Kemp; Mor Mia,9990,0,9999,9
1746570200856,CSS 201S,A01,892054,Mignozzetti; Umberto,25,0,30,5
1746570201883,CSS 202S,A01,892056,Mignozzetti; Umberto,25,0,30,5
1746570202909,DSC 197,001,956898,Eldridge; Justin Matthew,9996,0,9999,3
1746570203934,DSC 297,001,958000,Mazumdar; Arya,9998,0,9999,1
1746570203934,DSC 297,002,959862,Wang; Yusu,9998,0,9999,1
1746570204958,EAP 100,A00,905686,Staff,9778,0,9999,221
1746570205988,ECE 45,A01,892618,Staff,0,0,65,65
1746570208037,ECE 111,A01,892719,Staff,5,0,65,60
1746570209062,ECE 197,001,957920,Mercier; Patrick Philip,9991,0,9999,8
1746570210088,ECON 178,A01,907814,Zhu; Ying,26,0,35,9
1746570211112,EDS 115,A00,895312,Staff,35,0,45,10
1746570212136,EDS 117,A01,895337,Staff,23,0,30,7
1746570213163,EDS 125,A00,895341,Jones; Gabrielle Anastasia,36,0,45,9
1746570214187,EDS 128A,A01,895459,Fargason; Sharon Gayle,44,0,45,1
1746570215211,EDS 128B,A01,895543,Pappas; Elizabeth,44,0,45,1
1746570216236,EDS 139,A00,897203,Pappas; Elizabeth,44,0,45,1
1746570216236,EDS 139,B00,897209,Fargason; Sharon Gayle,41,0,45,4
1746570217260,EDS 201,A00,895545,Staff,22,0,45,23
1746570218289,EDS 203,A01,895581,Halter; Christopher P.,22,0,45,23
1746570219317,EDS 204R,A01,895625,Heinzman; Erica M.,39,0,45,6
1746570219317,EDS 204R,B01,895693,Halter; Christopher P.,10,0,45,35
1746570220341,EDS 206R,A00,895694,Fargason; Sharon Gayle,1,0,30,29
1746570220341,EDS 206R,B00,895695,Choi; Bailey Miyeon,16,0,30,14
1746570221369,EDS 250,A00,895697,Hemans; Patricia Ann Benitez,22,0,45,23
1746570222407,EDS 281,A00,895701,Meyerott; Theresa Ann,1,0,15,14
1746570223433,EDS 284,A00,895736,Meyerott; Theresa Ann,1,0,15,14
1746570224460,EDS 286,A00,897210,Fine; Sarah,0,0,15,15
1746570225488,EDS 289C,A01,895770,Daly; Alan J.,1,0,15,14
1746570226516,EDS 290,A00,897211,Hofstetter; Carolyn,0,0,15,15
1746570227542,LIGM 5A,A00,896162,Fischer-Grunski; Eva K,12,0,20,8
1746570228568,LIGM 5B,A00,896260,Fischer-Grunski; Eva K,17,0,20,3
1746570229595,LIGM 5C,A00,896308,Fischer-Grunski; Eva K,18,0,20,2
1746570230643,LIIT 5AS,A00,896313,Carnelos; Chiara,18,0,20,2
1746570231668,LIIT 5BS,A00,896416,Carnelos; Chiara,20,0,20,0
1746570232694,LIIT 5CS,A00,896564,Carnelos; Chiara,20,0,20,0
1746570233726,LISP 5A,A00,896588,Munoz Sanchez; Alicia,2,0,20,18
1746570234752,LISP 5B,A00,896653,Munoz Sanchez; Alicia,7,0,20,13
1746570235778,LISP 5C,A00,896655,Munoz Sanchez; Alicia,0,1,20,20
1746570236807,MAE 197,001,957918,Kleissl; Jan,9996,0,9999,3
1746570236807,MAE 197,002,959806,Boechler; Nicholas Sebastia,9998,0,9999,1
1746570236807,MAE 197,003,959852,Mullin; Jennifer S,9998,0,9999,1
1746570237834,MATH 2,A01,957937,Staff,33,0,35,2
1746570238857,MATH 197,001,957876,Kedlaya; Kiran S.,9993,0,9999,6
1746570239888,MCWP 40,A00,892729,Duru; Nur,10,0,20,10
1746570239888,MCWP 40,B00,893304,Montejo; Carolina,14,0,20,6
1746570240912,MCWP 40R,A00,893757,Redela; Pamela Morgan,0,5,20,20
1746570241939,MCWP 50,A00,893758,Morshed; Michael James,0,0,20,20
1746570241939,MCWP 50,B00,893761,Bartulis; Jason Michael,17,0,20,3
1746570242967,MCWP 50R,A00,893766,Compas; Sean Matthew,0,1,20,20
1746570242967,MCWP 50R,B00,893769,Carter; Jennifer A,0,1,20,20
1746570242967,MCWP 50R,C00,893771,Krone; Jarret,0,3,20,20
1746570242967,MCWP 50R,D00,893772,Miller; Elizabeth Deen,0,0,20,20
1746570242967,MCWP 50R,E00,893775,Carter; Andrea L,0,1,20,20
1746570243996,MMW 11R,A01,892721,Herbst; Matthew,11,0,27,16
1746570243996,MMW 11R,A02,892722,Herbst; Matthew,0,0,0,3
1746570245032,MMW 12R,A01,892724,Herbst; Matthew,0,11,16,16
1746570245032,MMW 12R,A02,892725,Herbst; Matthew,0,10,16,16
1746570246059,MMW 13R,A01,892727,Staff,0,4,16,16
1746570246059,MMW 13R,A02,892728,Staff,0,4,16,16
1746570246059,MMW 13R,A03,958032,Staff,0,4,16,16
1746570246059,MMW 13R,A04,958033,Staff,0,4,16,16
1746570246059,MMW 13R,A05,958034,Staff,0,4,16,16
1746570247088,SIO 295LS,A00,894015,Staff,5,0,25,20
1746570248118,SIO 295S,A00,894020,Staff,5,0,25,20
1746570249147,SIOC 290S,B01,958918,Merrifield; Mark A,14,0,30,16
1746570250178,SIOC 291S,B01,958922,Gabriel; Corey John,14,0,30,16
1746570251206,SOCI 117,A01,895339,Staff,3,0,5,2
1746570252234,WES 237B,A00,894149,Staff,11,0,20,9
1746570254310,AESE 279B,A00,891859,Staff,13,0,35,22
1746570255334,AIP 197,001,891854,Vespa; Emanuel Ignacio,9999,0,9999,0
1746570256363,ANTH 289S,A00,891856,Gagneux; Pascal,12,0,12,0
1746570257389,BENG 196,001,957946,Engler; Adam J.,9996,0,9999,3
1746570258413,BISP 197,001,959851,Wilhelm; James E.,9998,0,9999,1
1746570259441,CAT 124RS,A01,956906,Staff,6,0,25,19
1746570260466,CAT 125RS,A01,922013,Staff,6,0,25,19
1746570261497,CLRE 250,A00,891860,Morris; Sheldon,9995,0,9999,4
1746570263550,CLRE 251R,A00,907817,Mehta; Ravindra L.,9994,0,9999,5
1746570264579,CLRE 252,A00,891864,Cuomo; Raphael Eduardo,9993,0,9999,6
1746570265608,CLRE 253,A00,891867,Vaida; Florin,9994,0,9999,5
1746570265608,CLRE 253,B00,907819,Staff,9999,0,9999,0
1746570266635,CLRE 259,A00,891868,Patel; Hemal,9998,0,9999,1
1746570267660,CLRE 260,A00,891872,Cuomo; Raphael Eduardo,9999,0,9999,0
1746570268684,CLRE 297,001,891888,Cuomo; Raphael Eduardo,9999,0,9999,0
1746570269710,CSE 191,A00,958773,Minnes Kemp; Mor Mia,9995,0,9999,4
1746570270738,CSE 197,001,959846,Minnes Kemp; Mor Mia,9990,0,9999,9
1746570271779,CSS 201S,A01,892054,Mignozzetti; Umberto,25,0,30,5
1746570272811,CSS 202S,A01,892056,Mignozzetti; Umberto,25,0,30,5
1746570273840,DSC 197,001,956898,Eldridge; Justin Matthew,9996,0,9999,3
1746570274870,DSC 297,001,958000,Mazumdar; Arya,9998,0,9999,1
1746570274870,DSC 297,002,959862,Wang; Yusu,9998,0,9999,1
1746570275898,EAP 100,A00,905686,Staff,9778,0,9999,221
1746570276929,ECE 45,A01,892618,Staff,0,0,65,65
1746570278977,ECE 111,A01,892719,Staff,5,0,65,60
1746570280002,ECE 197,001,957920,Mercier; Patrick Philip,9991,0,9999,8
1746570281026,ECON 178,A01,907814,Zhu; Ying,26,0,35,9
1746570282050,EDS 115,A00,895312,Staff,35,0,45,10
1746570283079,EDS 117,A01,895337,Staff,23,0,30,7
1746570284103,EDS 125,A00,895341,Jones; Gabrielle Anastasia,36,0,45,9
1746570285135,EDS 128A,A01,895459,Fargason; Sharon Gayle,44,0,45,1
1746570286164,EDS 128B,A01,895543,Pappas; Elizabeth,44,0,45,1
1746570287192,EDS 139,A00,897203,Pappas; Elizabeth,44,0,45,1
1746570287192,EDS 139,B00,897209,Fargason; Sharon Gayle,41,0,45,4
1746570288217,EDS 201,A00,895545,Staff,22,0,45,23
1746570289241,EDS 203,A01,895581,Halter; Christopher P.,22,0,45,23
1746570290270,EDS 204R,A01,895625,Heinzman; Erica M.,39,0,45,6
1746570290270,EDS 204R,B01,895693,Halter; Christopher P.,10,0,45,35
1746570291298,EDS 206R,A00,895694,Fargason; Sharon Gayle,1,0,30,29
1746570291298,EDS 206R,B00,895695,Choi; Bailey Miyeon,16,0,30,14
1746570292328,EDS 250,A00,895697,Hemans; Patricia Ann Benitez,22,0,45,23
1746570293374,EDS 281,A00,895701,Meyerott; Theresa Ann,1,0,15,14
1746570294401,EDS 284,A00,895736,Meyerott; Theresa Ann,1,0,15,14
1746570295426,EDS 286,A00,897210,Fine; Sarah,0,0,15,15
1746570296450,EDS 289C,A01,895770,Daly; Alan J.,1,0,15,14
1746570297474,EDS 290,A00,897211,Hofstetter; Carolyn,0,0,15,15
1746570298505,LIGM 5A,A00,896162,Fischer-Grunski; Eva K,12,0,20,8
1746570299540,LIGM 5B,A00,896260,Fischer-Grunski; Eva K,17,0,20,3
1746570300566,LIGM 5C,A00,896308,Fischer-Grunski; Eva K,18,0,20,2
1746570301597,LIIT 5AS,A00,896313,Carnelos; Chiara,18,0,20,2
1746570302623,LIIT 5BS,A00,896416,Carnelos; Chiara,20,0,20,0
1746570303711,LIIT 5CS,A00,896564,Carnelos; Chiara,20,0,20,0
1746570304737,LISP 5A,A00,896588,Munoz Sanchez; Alicia,2,0,20,18
1746570305772,LISP 5B,A00,896653,Munoz Sanchez; Alicia,7,0,20,13
1746570306943,LISP 5C,A00,896655,Munoz Sanchez; Alicia,0,1,20,20
1746570307969,MAE 197,001,957918,Kleissl; Jan,9996,0,9999,3
1746570307969,MAE 197,002,959806,Boechler; Nicholas Sebastia,9998,0,9999,1
1746570307969,MAE 197,003,959852,Mullin; Jennifer S,9998,0,9999,1
1746570309028,MATH 2,A01,957937,Staff,33,0,35,2
1746570310059,MATH 197,001,957876,Kedlaya; Kiran S.,9993,0,9999,6
1746570311097,MCWP 40,A00,892729,Duru; Nur,10,0,20,10
1746570311097,MCWP 40,B00,893304,Montejo; Carolina,14,0,20,6
1746570312141,MCWP 40R,A00,893757,Redela; Pamela Morgan,0,5,20,20
1746570313173,MCWP 50,A00,893758,Morshed; Michael James,0,0,20,20
1746570313173,MCWP 50,B00,893761,Bartulis; Jason Michael,17,0,20,3
1746570314204,MCWP 50R,A00,893766,Compas; Sean Matthew,0,1,20,20
1746570314204,MCWP 50R,B00,893769,Carter; Jennifer A,0,1,20,20
1746570314204,MCWP 50R,C00,893771,Krone; Jarret,0,3,20,20
1746570314204,MCWP 50R,D00,893772,Miller; Elizabeth Deen,0,0,20,20
1746570314204,MCWP 50R,E00,893775,Carter; Andrea L,0,1,20,20
1746570315229,MMW 11R,A01,892721,Herbst; Matthew,11,0,27,16
1746570315229,MMW 11R,A02,892722,Herbst; Matthew,0,0,0,3
1746570316257,MMW 12R,A01,892724,Herbst; Matthew,0,11,16,16
1746570316257,MMW 12R,A02,892725,Herbst; Matthew,0,10,16,16
1746570317284,MMW 13R,A01,892727,Staff,0,4,16,16
1746570317284,MMW 13R,A02,892728,Staff,0,4,16,16
1746570317284,MMW 13R,A03,958032,Staff,0,4,16,16
1746570317284,MMW 13R,A04,958033,Staff,0,4,16,16
1746570317284,MMW 13R,A05,958034,Staff,0,4,16,16
1746570318313,SIO 295LS,A00,894015,Staff,5,0,25,20
1746570319340,SIO 295S,A00,894020,Staff,5,0,25,20
1746570320366,SIOC 290S,B01,958918,Merrifield; Mark A,14,0,30,16
1746570321398,SIOC 291S,B01,958922,Gabriel; Corey John,14,0,30,16
1746570322423,SOCI 117,A01,895339,Staff,3,0,5,2
1746570323448,WES 237B,A00,894149,Staff,11,0,20,9
1746570325511,AESE 279B,A00,891859,Staff,13,0,35,22
1746570326534,AIP 197,001,891854,Vespa; Emanuel Ignacio,9999,0,9999,0
1746570327560,ANTH 289S,A00,891856,Gagneux; Pascal,12,0,12,0
1746570328796,BENG 196,001,957946,Engler; Adam J.,9996,0,9999,3
1746570329824,BISP 197,001,959851,Wilhelm; James E.,9998,0,9999,1
1746570330850,CAT 124RS,A01,956906,Staff,6,0,25,19
1746570331886,CAT 125RS,A01,922013,Staff,6,0,25,19
1746570332916,CLRE 250,A00,891860,Morris; Sheldon,9995,0,9999,4
1746570334990,CLRE 251R,A00,907817,Mehta; Ravindra L.,9994,0,9999,5
1746570336020,CLRE 252,A00,891864,Cuomo; Raphael Eduardo,9993,0,9999,6
1746570337048,CLRE 253,A00,891867,Vaida; Florin,9994,0,9999,5
1746570337048,CLRE 253,B00,907819,Staff,9999,0,9999,0
1746570338072,CLRE 259,A00,891868,Patel; Hemal,9998,0,9999,1
1746570339101,CLRE 260,A00,891872,Cuomo; Raphael Eduardo,9999,0,9999,0
1746570340126,CLRE 297,001,891888,Cuomo; Raphael Eduardo,9999,0,9999,0
1746570341149,CSE 191,A00,958773,Minnes Kemp; Mor Mia,9995,0,9999,4
1746570342177,CSE 197,001,959846,Minnes Kemp; Mor Mia,9990,0,9999,9
1746570343206,CSS 201S,A01,892054,Mignozzetti; Umberto,25,0,30,5
1746570344237,CSS 202S,A01,892056,Mignozzetti; Umberto,25,0,30,5
1746570345265,DSC 197,001,956898,Eldridge; Justin Matthew,9996,0,9999,3
1746570346295,DSC 297,001,958000,Mazumdar; Arya,9998,0,9999,1
1746570346295,DSC 297,002,959862,Wang; Yusu,9998,0,9999,1
1746570347320,EAP 100,A00,905686,Staff,9778,0,9999,221
1746570348344,ECE 45,A01,892618,Staff,0,0,65,65
1746570350398,ECE 111,A01,892719,Staff,5,0,65,60
1746570351424,ECE 197,001,957920,Mercier; Patrick Philip,9991,0,9999,8
1746570352448,ECON 178,A01,907814,Zhu; Ying,26,0,35,9
1746570353477,EDS 115,A00,895312,Staff,35,0,45,10
1746570354507,EDS 117,A01,895337,Staff,23,0,30,7
1746570355532,EDS 125,A00,895341,Jones; Gabrielle Anastasia,36,0,45,9
1746570356561,EDS 128A,A01,895459,Fargason; Sharon Gayle,44,0,45,1
1746570357588,EDS 128B,A01,895543,Pappas; Elizabeth,44,0,45,1
1746570358671,EDS 139,A00,897203,Pappas; Elizabeth,44,0,45,1
1746570358671,EDS 139,B00,897209,Fargason; Sharon Gayle,41,0,45,4
1746570359696,EDS 201,A00,895545,Staff,22,0,45,23
1746570360725,EDS 203,A01,895581,Halter; Christopher P.,22,0,45,23
1746570361756,EDS 204R,A01,895625,Heinzman; Erica M.,39,0,45,6
1746570361756,EDS 204R,B01,895693,Halter; Christopher P.,10,0,45,35
1746570362780,EDS 206R,A00,895694,Fargason; Sharon Gayle,1,0,30,29
1746570362780,EDS 206R,B00,895695,Choi; Bailey Miyeon,16,0,30,14
1746570363809,EDS 250,A00,895697,Hemans; Patricia Ann Benitez,22,0,45,23
1746570364840,EDS 281,A00,895701,Meyerott; Theresa Ann,1,0,15,14
1746570365867,EDS 284,A00,895736,Meyerott; Theresa Ann,1,0,15,14
1746570366932,EDS 286,A00,897210,Fine; Sarah,0,0,15,15
1746570367956,EDS 289C,A01,895770,Daly; Alan J.,1,0,15,14
1746570368985,EDS 290,A00,897211,Hofstetter; Carolyn,0,0,15,15
1746570370013,LIGM 5A,A00,896162,Fischer-Grunski; Eva K,12,0,20,8
1746570371038,LIGM 5B,A00,896260,Fischer-Grunski; Eva K,17,0,20,3
1746570372067,LIGM 5C,A00,896308,Fischer-Grunski; Eva K,18,0,20,2
1746570373093,LIIT 5AS,A00,896313,Carnelos; Chiara,18,0,20,2
1746570374119,LIIT 5BS,A00,896416,Carnelos; Chiara,20,0,20,0
1746570375148,LIIT 5CS,A00,896564,Carnelos; Chiara,20,0,20,0
1746570376171,LISP 5A,A00,896588,Munoz Sanchez; Alicia,2,0,20,18
1746570377196,LISP 5B,A00,896653,Munoz Sanchez; Alicia,7,0,20,13
1746570378229,LISP 5C,A00,896655,Munoz Sanchez; Alicia,0,1,20,20
1746570379256,MAE 197,001,957918,Kleissl; Jan,9996,0,9999,3
1746570379256,MAE 197,002,959806,Boechler; Nicholas Sebastia,9998,0,9999,1
1746570379256,MAE 197,003,959852,Mullin; Jennifer S,9998,0,9999,1
1746570380285,MATH 2,A01,957937,Staff,33,0,35,2
1746570381314,MATH 197,001,957876,Kedlaya; Kiran S.,9993,0,9999,6
1746570382342,MCWP 40,A00,892729,Duru; Nur,10,0,20,10
1746570382342,MCWP 40,B00,893304,Montejo; Carolina,14,0,20,6
1746570383370,MCWP 40R,A00,893757,Redela; Pamela Morgan,0,5,20,20
1746570384396,MCWP 50,A00,893758,Morshed; Michael James,0,0,20,20
1746570384396,MCWP 50,B00,893761,Bartulis; Jason Michael,17,0,20,3
1746570385423,MCWP 50R,A00,893766,Compas; Sean Matthew,0,1,20,20
1746570385423,MCWP 50R,B00,893769,Carter; Jennifer A,0,1,20,20
1746570385423,MCWP 50R,C00,893771,Krone; Jarret,0,3,20,20
1746570385423,MCWP 50R,D00,893772,Miller; Elizabeth Deen,0,0,20,20
1746570385423,MCWP 50R,E00,893775,Carter; Andrea L,0,1,20,20
1746570386451,MMW 11R,A01,892721,Herbst; Matthew,11,0,27,16
1746570386451,MMW 11R,A02,892722,Herbst; Matthew,0,0,0,3
1746570387478,MMW 12R,A01,892724,Herbst; Matthew,0,11,16,16
1746570387478,MMW 12R,A02,892725,Herbst; Matthew,0,10,16,16
1746570388502,MMW 13R,A01,892727,Staff,0,4,16,16
1746570388502,MMW 13R,A02,892728,Staff,0,4,16,16
1746570388502,MMW 13R,A03,958032,Staff,0,4,16,16
1746570388502,MMW 13R,A04,958033,Staff,0,4,16,16
1746570388502,MMW 13R,A05,958034,Staff,0,4,16,16
1746570389530,SIO 295LS,A00,894015,Staff,5,0,25,20
1746570390557,SIO 295S,A00,894020,Staff,5,0,25,20
1746570391583,SIOC 290S,B01,958918,Merrifield; Mark A,14,0,30,16
1746570392610,SIOC 291S,B01,958922,Gabriel; Corey John,14,0,30,16
1746570393635,SOCI 117,A01,895339,Staff,3,0,5,2
1746570394659,WES 237B,A00,894149,Staff,11,0,20,9
1746570396727,AESE 279B,A00,891859,Staff,13,0,35,22
1746570397751,AIP 197,001,891854,Vespa; Emanuel Ignacio,9999,0,9999,0
1746570398779,ANTH 289S,A00,891856,Gagneux; Pascal,12,0,12,0
1746570399807,BENG 196,001,957946,Engler; Adam J.,9996,0,9999,3
1746570400834,BISP 197,001,959851,Wilhelm; James E.,9998,0,9999,1
1746570401862,CAT 124RS,A01,956906,Staff,6,0,25,19
1746570402890,CAT 125RS,A01,922013,Staff,6,0,25,19
1746570403917,CLRE 250,A00,891860,Morris; Sheldon,9995,0,9999,4
1746570405970,CLRE 251R,A00,907817,Mehta; Ravindra L.,9994,0,9999,5
1746570406995,CLRE 252,A00,891864,Cuomo; Raphael Eduardo,9993,0,9999,6
1746570408024,CLRE 253,A00,891867,Vaida; Florin,9994,0,9999,5
1746570408024,CLRE 253,B00,907819,Staff,9999,0,9999,0
1746570409055,CLRE 259,A00,891868,Patel; Hemal,9998,0,9999,1
1746570410082,CLRE 260,A00,891872,Cuomo; Raphael Eduardo,9999,0,9999,0
1746570411105,CLRE 297,001,891888,Cuomo; Raphael Eduardo,9999,0,9999,0
1746570412131,CSE 191,A00,958773,Minnes Kemp; Mor Mia,9995,0,9999,4
1746570413157,CSE 197,001,959846,Minnes Kemp; Mor Mia,9990,0,9999,9
1746570414187,CSS 201S,A01,892054,Mignozzetti; Umberto,25,0,30,5
1746570415211,CSS 202S,A01,892056,Mignozzetti; Umberto,25,0,30,5
1746570416236,DSC 197,001,956898,Eldridge; Justin Matthew,9996,0,9999,3
1746570417286,DSC 297,001,958000,Mazumdar; Arya,9998,0,9999,1
1746570417286,DSC 297,002,959862,Wang; Yusu,9998,0,9999,1
1746570418311,EAP 100,A00,905686,Staff,9778,0,9999,221
1746570419337,ECE 45,A01,892618,Staff,0,0,65,65
1746570421390,ECE 111,A01,892719,Staff,5,0,65,60
1746570422420,ECE 197,001,957920,Mercier; Patrick Philip,9991,0,9999,8
1746570423446,ECON 178,A01,907814,Zhu; Ying,26,0,35,9
1746570424474,EDS 115,A00,895312,Staff,35,0,45,10
1746570425500,EDS 117,A01,895337,Staff,23,0,30,7
1746570426529,EDS 125,A00,895341,Jones; Gabrielle Anastasia,36,0,45,9
1746570427557,EDS 128A,A01,895459,Fargason; Sharon Gayle,44,0,45,1
1746570428585,EDS 128B,A01,895543,Pappas; Elizabeth,44,0,45,1
1746570429610,EDS 139,A00,897203,Pappas; Elizabeth,44,0,45,1
1746570429610,EDS 139,B00,897209,Fargason; Sharon Gayle,41,0,45,4
1746570430634,EDS 201,A00,895545,Staff,22,0,45,23
1746570431660,EDS 203,A01,895581,Halter; Christopher P.,22,0,45,23
1746570432685,EDS 204R,A01,895625,Heinzman; Erica M.,39,0,45,6
1746570432685,EDS 204R,B01,895693,Halter; Christopher P.,10,0,45,35
1746570433711,EDS 206R,A00,895694,Fargason; Sharon Gayle,1,0,30,29
1746570433711,EDS 206R,B00,895695,Choi; Bailey Miyeon,16,0,30,14
1746570434734,EDS 250,A00,895697,Hemans; Patricia Ann Benitez,22,0,45,23
1746570435759,EDS 281,A00,895701,Meyerott; Theresa Ann,1,0,15,14
1746570436790,EDS 284,A00,895736,Meyerott; Theresa Ann,1,0,15,14
1746570437816,EDS 286,A00,897210,Fine; Sarah,0,0,15,15
1746570438845,EDS 289C,A01,895770,Daly; Alan J.,1,0,15,14
1746570439872,EDS 290,A00,897211,Hofstetter; Carolyn,0,0,15,15
1746570440899,LIGM 5A,A00,896162,Fischer-Grunski; Eva K,12,0,20,8
1746570441937,LIGM 5B,A00,896260,Fischer-Grunski; Eva K,17,0,20,3
1746570442962,LIGM 5C,A00,896308,Fischer-Grunski; Eva K,18,0,20,2
1746570443991,LIIT 5AS,A00,896313,Carnelos; Chiara,18,0,20,2
1746570445018,LIIT 5BS,A00,896416,Carnelos; Chiara,20,0,20,0
1746570446048,LIIT 5CS,A00,896564,Carnelos; Chiara,20,0,20,0
1746570447079,LISP 5A,A00,896588,Munoz Sanchez; Alicia,2,0,20,18
1746570448104,LISP 5B,A00,896653,Munoz Sanchez; Alicia,7,0,20,13
1746570449136,LISP 5C,A00,896655,Munoz Sanchez; Alicia,0,1,20,20
1746570450166,MAE 197,001,957918,Kleissl; Jan,9996,0,9999,3
1746570450166,MAE 197,002,959806,Boechler; Nicholas Sebastia,9998,0,9999,1
1746570450166,MAE 197,003,959852,Mullin; Jennifer S,9998,0,9999,1
1746570451191,MATH 2,A01,957937,Staff,33,0,35,2
1746570452218,MATH 197,001,957876,Kedlaya; Kiran S.,9993,0,9999,6
1746570453246,MCWP 40,A00,892729,Duru; Nur,10,0,20,10
1746570453246,MCWP 40,B00,893304,Montejo; Carolina,14,0,20,6
1746570454276,MCWP 40R,A00,893757,Redela; Pamela Morgan,0,5,20,20
1746570455307,MCWP 50,A00,893758,Morshed; Michael James,0,0,20,20
1746570455307,MCWP 50,B00,893761,Bartulis; Jason Michael,17,0,20,3
1746570456335,MCWP 50R,A00,893766,Compas; Sean Matthew,0,1,20,20
1746570456335,MCWP 50R,B00,893769,Carter; Jennifer A,0,1,20,20
1746570456335,MCWP 50R,C00,893771,Krone; Jarret,0,3,20,20
1746570456335,MCWP 50R,D00,893772,Miller; Elizabeth Deen,0,0,20,20
1746570456335,MCWP 50R,E00,893775,Carter; Andrea L,0,1,20,20
1746570457362,MMW 11R,A01,892721,Herbst; Matthew,11,0,27,16
1746570457362,MMW 11R,A02,892722,Herbst; Matthew,0,0,0,3
1746570458387,MMW 12R,A01,892724,Herbst; Matthew,0,11,16,16
1746570458387,MMW 12R,A02,892725,Herbst; Matthew,0,10,16,16
1746570459415,MMW 13R,A01,892727,Staff,0,4,16,16
1746570459415,MMW 13R,A02,892728,Staff,0,4,16,16
1746570459415,MMW 13R,A03,958032,Staff,0,4,16,16
1746570459415,MMW 13R,A04,958033,Staff,0,4,16,16
1746570459415,MMW 13R,A05,958034,Staff,0,4,16,16
1746570460442,SIO 295LS,A00,894015,Staff,5,0,25,20
1746570461470,SIO 295S,A00,894020,Staff,5,0,25,20
1746570462498,SIOC 290S,B01,958918,Merrifield; Mark A,14,0,30,16
1746570463526,SIOC 291S,B01,958922,Gabriel; Corey John,14,0,30,16
1746570464553,SOCI 117,A01,895339,Staff,3,0,5,2
1746570465580,WES 237B,A00,894149,Staff,11,0,20,9
1746570467657,AESE 279B,A00,891859,Staff,13,0,35,22
1746570468688,AIP 197,001,891854,Vespa; Emanuel Ignacio,9999,0,9999,0
1746570469719,ANTH 289S,A00,891856,Gagneux; Pascal,12,0,12,0
1746570470811,BENG 196,001,957946,Engler; Adam J.,9996,0,9999,3
1746570471837,BISP 197,001,959851,Wilhelm; James E.,9998,0,9999,1
1746570472866,CAT 124RS,A01,956906,Staff,6,0,25,19
1746570473894,CAT 125RS,A01,922013,Staff,6,0,25,19
1746570474921,CLRE 250,A00,891860,Morris; Sheldon,9995,0,9999,4
1746570476984,CLRE 251R,A00,907817,Mehta; Ravindra L.,9994,0,9999,5
1746570478011,CLRE 252,A00,891864,Cuomo; Raphael Eduardo,9993,0,9999,6
1746570479040,CLRE 253,A00,891867,Vaida; Florin,9994,0,9999,5
1746570479040,CLRE 253,B00,907819,Staff,9999,0,9999,0
1746570480065,CLRE 259,A00,891868,Patel; Hemal,9998,0,9999,1
1746570481094,CLRE 260,A00,891872,Cuomo; Raphael Eduardo,9999,0,9999,0
1746570482120,CLRE 297,001,891888,Cuomo; Raphael Eduardo,9999,0,9999,0
1746570483148,CSE 191,A00,958773,Minnes Kemp; Mor Mia,9995,0,9999,4
1746570484178,CSE 197,001,959846,Minnes Kemp; Mor Mia,9990,0,9999,9
1746570485205,CSS 201S,A01,892054,Mignozzetti; Umberto,25,0,30,5
1746570486233,CSS 202S,A01,892056,Mignozzetti; Umberto,25,0,30,5
1746570487260,DSC 197,001,956898,Eldridge; Justin Matthew,9996,0,9999,3
1746570488289,DSC 297,001,958000,Mazumdar; Arya,9998,0,9999,1
1746570488289,DSC 297,002,959862,Wang; Yusu,9998,0,9999,1
1746570489316,EAP 100,A00,905686,Staff,9778,0,9999,221
1746570490348,ECE 45,A01,892618,Staff,0,0,65,65
1746570492406,ECE 111,A01,892719,Staff,5,0,65,60
1746570493435,ECE 197,001,957920,Mercier; Patrick Philip,9991,0,9999,8
1746570494466,ECON 178,A01,907814,Zhu; Ying,26,0,35,9
1746570495496,EDS 115,A00,895312,Staff,35,0,45,10
1746570496526,EDS 117,A01,895337,Staff,23,0,30,7
1746570497558,EDS 125,A00,895341,Jones; Gabrielle Anastasia,36,0,45,9
1746570498588,EDS 128A,A01,895459,Fargason; Sharon Gayle,44,0,45,1
1746570499614,EDS 128B,A01,895543,Pappas; Elizabeth,44,0,45,1
1746570500643,EDS 139,A00,897203,Pappas; Elizabeth,44,0,45,1
1746570500643,EDS 139,B00,897209,Fargason; Sharon Gayle,41,0,45,4
1746570501671,EDS 201,A00,895545,Staff,22,0,45,23
1746570502702,EDS 203,A01,895581,Halter; Christopher P.,22,0,45,23
1746570503732,EDS 204R,A01,895625,Heinzman; Erica M.,39,0,45,6
1746570503732,EDS 204R,B01,895693,Halter; Christopher P.,10,0,45,35
1746570504762,EDS 206R,A00,895694,Fargason; Sharon Gayle,1,0,30,29
1746570504762,EDS 206R,B00,895695,Choi; Bailey Miyeon,16,0,30,14
1746570505788,EDS 250,A00,895697,Hemans; Patricia Ann Benitez,22,0,45,23
1746570506817,EDS 281,A00,895701,Meyerott; Theresa Ann,1,0,15,14
1746570507844,EDS 284,A00,895736,Meyerott; Theresa Ann,1,0,15,14
1746570508871,EDS 286,A00,897210,Fine; Sarah,0,0,15,15
1746570509899,EDS 289C,A01,895770,Daly; Alan J.,1,0,15,14
1746570510926,EDS 290,A00,897211,Hofstetter; Carolyn,0,0,15,15
1746570511953,LIGM 5A,A00,896162,Fischer-Grunski; Eva K,12,0,20,8
1746570512984,LIGM 5B,A00,896260,Fischer-Grunski; Eva K,17,0,20,3
1746570514010,LIGM 5C,A00,896308,Fischer-Grunski; Eva K,18,0,20,2
1746570515042,LIIT 5AS,A00,896313,Carnelos; Chiara,18,0,20,2
1746570516074,LIIT 5BS,A00,896416,Carnelos; Chiara,20,0,20,0
1746570517103,LIIT 5CS,A00,896564,Carnelos; Chiara,20,0,20,0
1746570518130,LISP 5A,A00,896588,Munoz Sanchez; Alicia,2,0,20,18
1746570519162,LISP 5B,A00,896653,Munoz Sanchez; Alicia,7,0,20,13
1746570520192,LISP 5C,A00,896655,Munoz Sanchez; Alicia,0,1,20,20
1746570521218,MAE 197,001,957918,Kleissl; Jan,9996,0,9999,3
1746570521218,MAE 197,002,959806,Boechler; Nicholas Sebastia,9998,0,9999,1
1746570521218,MAE 197,003,959852,Mullin; Jennifer S,9998,0,9999,1
1746570522245,MATH 2,A01,957937,Staff,33,0,35,2
1746570523275,MATH 197,001,957876,Kedlaya; Kiran S.,9993,0,9999,6
1746570524301,MCWP 40,A00,892729,Duru; Nur,10,0,20,10
1746570524301,MCWP 40,B00,893304,Montejo; Carolina,14,0,20,6
1746570525326,MCWP 40R,A00,893757,Redela; Pamela Morgan,0,5,20,20
1746570526354,MCWP 50,A00,893758,Morshed; Michael James,0,0,20,20
1746570526354,MCWP 50,B00,893761,Bartulis; Jason Michael,17,0,20,3
1746570527386,MCWP 50R,A00,893766,Compas; Sean Matthew,0,1,20,20
1746570527386,MCWP 50R,B00,893769,Carter; Jennifer A,0,1,20,20
1746570527386,MCWP 50R,C00,893771,Krone; Jarret,0,3,20,20
1746570527386,MCWP 50R,D00,893772,Miller; Elizabeth Deen,0,0,20,20
1746570527386,MCWP 50R,E00,893775,Carter; Andrea L,0,1,20,20
1746570528416,MMW 11R,A01,892721,Herbst; Matthew,11,0,27,16
1746570528416,MMW 11R,A02,892722,Herbst; Matthew,0,0,0,3
1746570529442,MMW 12R,A01,892724,Herbst; Matthew,0,11,16,16
1746570529442,MMW 12R,A02,892725,Herbst; Matthew,0,10,16,16
1746570530468,MMW 13R,A01,892727,Staff,0,4,16,16
1746570530468,MMW 13R,A02,892728,Staff,0,4,16,16
1746570530468,MMW 13R,A03,958032,Staff,0,4,16,16
1746570530468,MMW 13R,A04,958033,Staff,0,4,16,16
1746570530468,MMW 13R,A05,958034,Staff,0,4,16,16
1746570531492,SIO 295LS,A00,894015,Staff,5,0,25,20
1746570532519,SIO 295S,A00,894020,Staff,5,0,25,20
1746570533548,SIOC 290S,B01,958918,Merrifield; Mark A,14,0,30,16
1746570534578,SIOC 291S,B01,958922,Gabriel; Corey John,14,0,30,16
1746570535605,SOCI 117,A01,895339,Staff,3,0,5,2
1746570536630,WES 237B,A00,894149,Staff,11,0,20,9
1746570538696,AESE 279B,A00,891859,Staff,13,0,35,22
1746570539723,AIP 197,001,891854,Vespa; Emanuel Ignacio,9999,0,9999,0
1746570540751,ANTH 289S,A00,891856,Gagneux; Pascal,12,0,12,0
1746570541777,BENG 196,001,957946,Engler; Adam J.,9996,0,9999,3
1746570542804,BISP 197,001,959851,Wilhelm; James E.,9998,0,9999,1
1746570543831,CAT 124RS,A01,956906,Staff,6,0,25,19
1746570544859,CAT 125RS,A01,922013,Staff,6,0,25,19
1746570545888,CLRE 250,A00,891860,Morris; Sheldon,9995,0,9999,4
1746570547940,CLRE 251R,A00,907817,Mehta; Ravindra L.,9994,0,9999,5
1746570548966,CLRE 252,A00,891864,Cuomo; Raphael Eduardo,9993,0,9999,6
1746570549996,CLRE 253,A00,891867,Vaida; Florin,9994,0,9999,5
1746570549996,CLRE 253,B00,907819,Staff,9999,0,9999,0
1746570551024,CLRE 259,A00,891868,Patel; Hemal,9998,0,9999,1
1746570552051,CLRE 260,A00,891872,Cuomo; Raphael Eduardo,9999,0,9999,0
1746570553077,CLRE 297,001,891888,Cuomo; Raphael Eduardo,9999,0,9999,0
1746570554106,CSE 191,A00,958773,Minnes Kemp; Mor Mia,9995,0,9999,4
1746570555130,CSE 197,001,959846,Minnes Kemp; Mor Mia,9990,0,9999,9
1746570556155,CSS 201S,A01,892054,Mignozzetti; Umberto,25,0,30,5
1746570557184,CSS 202S,A01,892056,Mignozzetti; Umberto,25,0,30,5
1746570558209,DSC 197,001,956898,Eldridge; Justin Matthew,9996,0,9999,3
1746570559239,DSC 297,001,958000,Mazumdar; Arya,9998,0,9999,1
1746570559239,DSC 297,002,959862,Wang; Yusu,9998,0,9999,1
1746570560264,EAP 100,A00,905686,Staff,9778,0,9999,221
1746570561289,ECE 45,A01,892618,Staff,0,0,65,65
1746570563342,ECE 111,A01,892719,Staff,5,0,65,60
1746570564370,ECE 197,001,957920,Mercier; Patrick Philip,9991,0,9999,8
1746570565398,ECON 178,A01,907814,Zhu; Ying,26,0,35,9
1746570566423,EDS 115,A00,895312,Staff,35,0,45,10
1746570567448,EDS 117,A01,895337,Staff,23,0,30,7
1746570568473,EDS 125,A00,895341,Jones; Gabrielle Anastasia,36,0,45,9
1746570569497,EDS 128A,A01,895459,Fargason; Sharon Gayle,44,0,45,1
1746570570523,EDS 128B,A01,895543,Pappas; Elizabeth,44,0,45,1
1746570571549,EDS 139,A00,897203,Pappas; Elizabeth,44,0,45,1
1746570571549,EDS 139,B00,897209,Fargason; Sharon Gayle,41,0,45,4
1746570572575,EDS 201,A00,895545,Staff,22,0,45,23
1746570573599,EDS 203,A01,895581,Halter; Christopher P.,22,0,45,23
1746570574665,EDS 204R,A01,895625,Heinzman; Erica M.,39,0,45,6
1746570574665,EDS 204R,B01,895693,Halter; Christopher P.,10,0,45,35
1746570575690,EDS 206R,A00,895694,Fargason; Sharon Gayle,1,0,30,29
1746570575690,EDS 206R,B00,895695,Choi; Bailey Miyeon,16,0,30,14
1746570576716,EDS 250,A00,895697,Hemans; Patricia Ann Benitez,22,0,45,23
1746570577740,EDS 281,A00,895701,Meyerott; Theresa Ann,1,0,15,14
1746570578765,EDS 284,A00,895736,Meyerott; Theresa Ann,1,0,15,14
1746570579792,EDS 286,A00,897210,Fine; Sarah,0,0,15,15
1746570580818,EDS 289C,A01,895770,Daly; Alan J.,1,0,15,14
1746570581847,EDS 290,A00,897211,Hofstetter; Carolyn,0,0,15,15
1746570582871,LIGM 5A,A00,896162,Fischer-Grunski; Eva K,12,0,20,8
1746570583898,LIGM 5B,A00,896260,Fischer-Grunski; Eva K,17,0,20,3
1746570584924,LIGM 5C,A00,896308,Fischer-Grunski; Eva K,18,0,20,2
1746570585954,LIIT 5AS,A00,896313,Carnelos; Chiara,18,0,20,2
1746570586983,LIIT 5BS,A00,896416,Carnelos; Chiara,20,0,20,0
1746570588009,LIIT 5CS,A00,896564,Carnelos; Chiara,20,0,20,0
1746570589037,LISP 5A,A00,896588,Munoz Sanchez; Alicia,2,0,20,18
1746570590062,LISP 5B,A00,896653,Munoz Sanchez; Alicia,7,0,20,13
1746570591088,LISP 5C,A00,896655,Munoz Sanchez; Alicia,0,1,20,20
1746570592115,MAE 197,001,957918,Kleissl; Jan,9996,0,9999,3
1746570592115,MAE 197,002,959806,Boechler; Nicholas Sebastia,9998,0,9999,1
1746570592115,MAE 197,003,959852,Mullin; Jennifer S,9998,0,9999,1
1746570593140,MATH 2,A01,957937,Staff,33,0,35,2
1746570594163,MATH 197,001,957876,Kedlaya; Kiran S.,9993,0,9999,6
1746570595189,MCWP 40,A00,892729,Duru; Nur,10,0,20,10
1746570595189,MCWP 40,B00,893304,Montejo; Carolina,14,0,20,6
1746570596216,MCWP 40R,A00,893757,Redela; Pamela Morgan,0,5,20,20
1746570597245,MCWP 50,A00,893758,Morshed; Michael James,0,0,20,20
1746570597245,MCWP 50,B00,893761,Bartulis; Jason Michael,17,0,20,3
1746570598272,MCWP 50R,A00,893766,Compas; Sean Matthew,0,1,20,20
1746570598272,MCWP 50R,B00,893769,Carter; Jennifer A,0,1,20,20
1746570598272,MCWP 50R,C00,893771,Krone; Jarret,0,3,20,20
1746570598272,MCWP 50R,D00,893772,Miller; Elizabeth Deen,0,0,20,20
1746570598272,MCWP 50R,E00,893775,Carter; Andrea L,0,1,20,20
1746570599298,MMW 11R,A01,892721,Herbst; Matthew,11,0,27,16
1746570599298,MMW 11R,A02,892722,Herbst; Matthew,0,0,0,3
1746570600323,MMW 12R,A01,892724,Herbst; Matthew,0,11,16,16
1746570600323,MMW 12R,A02,892725,Herbst; Matthew,0,10,16,16
1746570601351,MMW 13R,A01,892727,Staff,0,4,16,16
1746570601351,MMW 13R,A02,892728,Staff,0,4,16,16
1746570601351,MMW 13R,A03,958032,Staff,0,4,16,16
1746570601351,MMW 13R,A04,958033,Staff,0,4,16,16
1746570601351,MMW 13R,A05,958034,Staff,0,4,16,16
1746570602376,SIO 295LS,A00,894015,Staff,5,0,25,20
1746570603401,SIO 295S,A00,894020,Staff,5,0,25,20
1746570604431,SIOC 290S,B01,958918,Merrifield; Mark A,14,0,30,16
1746570605457,SIOC 291S,B01,958922,Gabriel; Corey John,14,0,30,16
1746570606482,SOCI 117,A01,895339,Staff,3,0,5,2
1746570607510,WES 237B,A00,894149,Staff,11,0,20,9
1746570609580,AESE 279B,A00,891859,Staff,13,0,35,22
1746570610607,AIP 197,001,891854,Vespa; Emanuel Ignacio,9999,0,9999,0
1746570611635,ANTH 289S,A00,891856,Gagneux; Pascal,12,0,12,0
1746570612659,BENG 196,001,957946,Engler; Adam J.,9996,0,9999,3
1746570613684,BISP 197,001,959851,Wilhelm; James E.,9998,0,9999,1
1746570614712,CAT 124RS,A01,956906,Staff,6,0,25,19
1746570615737,CAT 125RS,A01,922013,Staff,6,0,25,19
1746570616767,CLRE 250,A00,891860,Morris; Sheldon,9995,0,9999,4
1746570618819,CLRE 251R,A00,907817,Mehta; Ravindra L.,9994,0,9999,5
1746570619849,CLRE 252,A00,891864,Cuomo; Raphael Eduardo,9993,0,9999,6
1746570620873,CLRE 253,A00,891867,Vaida; Florin,9994,0,9999,5
1746570620873,CLRE 253,B00,907819,Staff,9999,0,9999,0
1746570621898,CLRE 259,A00,891868,Patel; Hemal,9998,0,9999,1
1746570622923,CLRE 260,A00,891872,Cuomo; Raphael Eduardo,9999,0,9999,0
1746570623948,CLRE 297,001,891888,Cuomo; Raphael Eduardo,9999,0,9999,0
1746570624976,CSE 191,A00,958773,Minnes Kemp; Mor Mia,9995,0,9999,4
1746570626004,CSE 197,001,959846,Minnes Kemp; Mor Mia,9990,0,9999,9
1746570627036,CSS 201S,A01,892054,Mignozzetti; Umberto,25,0,30,5
1746570628060,CSS 202S,A01,892056,Mignozzetti; Umberto,25,0,30,5
1746570629088,DSC 197,001,956898,Eldridge; Justin Matthew,9996,0,9999,3
1746570630113,DSC 297,001,958000,Mazumdar; Arya,9998,0,9999,1
1746570630113,DSC 297,002,959862,Wang; Yusu,9998,0,9999,1
1746570631139,EAP 100,A00,905686,Staff,9778,0,9999,221
1746570632165,ECE 45,A01,892618,Staff,0,0,65,65
1746570634217,ECE 111,A01,892719,Staff,5,0,65,60
1746570635245,ECE 197,001,957920,Mercier; Patrick Philip,9991,0,9999,8
1746570636272,ECON 178,A01,907814,Zhu; Ying,26,0,35,9
1746570637298,EDS 115,A00,895312,Staff,35,0,45,10
1746570638326,EDS 117,A01,895337,Staff,23,0,30,7
1746570639351,EDS 125,A00,895341,Jones; Gabrielle Anastasia,36,0,45,9
1746570640377,EDS 128A,A01,895459,Fargason; Sharon Gayle,44,0,45,1
1746570641401,EDS 128B,A01,895543,Pappas; Elizabeth,44,0,45,1
1746570642426,EDS 139,A00,897203,Pappas; Elizabeth,44,0,45,1
1746570642426,EDS 139,B00,897209,Fargason; Sharon Gayle,41,0,45,4
1746570643450,EDS 201,A00,895545,Staff,22,0,45,23
1746570644474,EDS 203,A01,895581,Halter; Christopher P.,22,0,45,23
1746570645501,EDS 204R,A01,895625,Heinzman; Erica M.,39,0,45,6
1746570645501,EDS 204R,B01,895693,Halter; Christopher P.,10,0,45,35
1746570646524,EDS 206R,A00,895694,Fargason; Sharon Gayle,1,0,30,29
1746570646524,EDS 206R,B00,895695,Choi; Bailey Miyeon,16,0,30,14
1746570647550,EDS 250,A00,895697,Hemans; Patricia Ann Benitez,22,0,45,23
1746570648574,EDS 281,A00,895701,Meyerott; Theresa Ann,1,0,15,14
1746570649606,EDS 284,A00,895736,Meyerott; Theresa Ann,1,0,15,14
1746570650633,EDS 286,A00,897210,Fine; Sarah,0,0,15,15
1746570651658,EDS 289C,A01,895770,Daly; Alan J.,1,0,15,14
1746570652686,EDS 290,A00,897211,Hofstetter; Carolyn,0,0,15,15
1746570653715,LIGM 5A,A00,896162,Fischer-Grunski; Eva K,12,0,20,8
1746570654743,LIGM 5B,A00,896260,Fischer-Grunski; Eva K,17,0,20,3
1746570655773,LIGM 5C,A00,896308,Fischer-Grunski; Eva K,18,0,20,2
1746570656797,LIIT 5AS,A00,896313,Carnelos; Chiara,18,0,20,2
1746570657823,LIIT 5BS,A00,896416,Carnelos; Chiara,20,0,20,0
1746570658849,LIIT 5CS,A00,896564,Carnelos; Chiara,20,0,20,0
1746570659880,LISP 5A,A00,896588,Munoz Sanchez; Alicia,2,0,20,18
1746570660904,LISP 5B,A00,896653,Munoz Sanchez; Alicia,7,0,20,13
1746570661934,LISP 5C,A00,896655,Munoz Sanchez; Alicia,0,1,20,20
1746570662963,MAE 197,001,957918,Kleissl; Jan,9996,0,9999,3
1746570662963,MAE 197,002,959806,Boechler; Nicholas Sebastia,9998,0,9999,1
1746570662963,MAE 197,003,959852,Mullin; Jennifer S,9998,0,9999,1
1746570664073,MATH 2,A01,957937,Staff,33,0,35,2
1746570665101,MATH 197,001,957876,Kedlaya; Kiran S.,9993,0,9999,6
1746570666129,MCWP 40,A00,892729,Duru; Nur,10,0,20,10
1746570666129,MCWP 40,B00,893304,Montejo; Carolina,14,0,20,6
1746570667153,MCWP 40R,A00,893757,Redela; Pamela Morgan,0,5,20,20
1746570668182,MCWP 50,A00,893758,Morshed; Michael James,0,0,20,20
1746570668182,MCWP 50,B00,893761,Bartulis; Jason Michael,17,0,20,3
1746570669214,MCWP 50R,A00,893766,Compas; Sean Matthew,0,1,20,20
1746570669214,MCWP 50R,B00,893769,Carter; Jennifer A,0,1,20,20
1746570669214,MCWP 50R,C00,893771,Krone; Jarret,0,3,20,20
1746570669214,MCWP 50R,D00,893772,Miller; Elizabeth Deen,0,0,20,20
1746570669214,MCWP 50R,E00,893775,Carter; Andrea L,0,1,20,20
1746570670242,MMW 11R,A01,892721,Herbst; Matthew,11,0,27,16
1746570670242,MMW 11R,A02,892722,Herbst; Matthew,0,0,0,3
1746570671269,MMW 12R,A01,892724,Herbst; Matthew,0,11,16,16
1746570671269,MMW 12R,A02,892725,Herbst; Matthew,0,10,16,16
1746570672297,MMW 13R,A01,892727,Staff,0,4,16,16
1746570672297,MMW 13R,A02,892728,Staff,0,4,16,16
1746570672297,MMW 13R,A03,958032,Staff,0,4,16,16
1746570672297,MMW 13R,A04,958033,Staff,0,4,16,16
1746570672297,MMW 13R,A05,958034,Staff,0,4,16,16
1746570673324,SIO 295LS,A00,894015,Staff,5,0,25,20
1746570674350,SIO 295S,A00,894020,Staff,5,0,25,20
1746570675378,SIOC 290S,B01,958918,Merrifield; Mark A,14,0,30,16
1746570676408,SIOC 291S,B01,958922,Gabriel; Corey John,14,0,30,16
1746570677433,SOCI 117,A01,895339,Staff,3,0,5,2
1746570678460,WES 237B,A00,894149,Staff,11,0,20,9
1746570680531,AESE 279B,A00,891859,Staff,13,0,35,22
1746570681555,AIP 197,001,891854,Vespa; Emanuel Ignacio,9999,0,9999,0
1746570682580,ANTH 289S,A00,891856,Gagneux; Pascal,12,0,12,0
1746570683606,BENG 196,001,957946,Engler; Adam J.,9996,0,9999,3
1746570684632,BISP 197,001,959851,Wilhelm; James E.,9998,0,9999,1
1746570685660,CAT 124RS,A01,956906,Staff,6,0,25,19
1746570686689,CAT 125RS,A01,922013,Staff,6,0,25,19
1746570687716,CLRE 250,A00,891860,Morris; Sheldon,9995,0,9999,4
1746570689770,CLRE 251R,A00,907817,Mehta; Ravindra L.,9994,0,9999,5
1746570690796,CLRE 252,A00,891864,Cuomo; Raphael Eduardo,9993,0,9999,6
1746570691824,CLRE 253,A00,891867,Vaida; Florin,9994,0,9999,5
1746570691824,CLRE 253,B00,907819,Staff,9999,0,9999,0
1746570692851,CLRE 259,A00,891868,Patel; Hemal,9998,0,9999,1
1746570693876,CLRE 260,A00,891872,Cuomo; Raphael Eduardo,9999,0,9999,0
1746570694904,CLRE 297,001,891888,Cuomo; Raphael Eduardo,9999,0,9999,0
1746570695932,CSE 191,A00,958773,Minnes Kemp; Mor Mia,9995,0,9999,4
1746570696957,CSE 197,001,959846,Minnes Kemp; Mor Mia,9990,0,9999,9
1746570697983,CSS 201S,A01,892054,Mignozzetti; Umberto,25,0,30,5
1746570699009,CSS 202S,A01,892056,Mignozzetti; Umberto,25,0,30,5
1746570700034,DSC 197,001,956898,Eldridge; Justin Matthew,9996,0,9999,3
1746570701059,DSC 297,001,958000,Mazumdar; Arya,9998,0,9999,1
1746570701059,DSC 297,002,959862,Wang; Yusu,9998,0,9999,1
1746570702084,EAP 100,A00,905686,Staff,9778,0,9999,221
1746570703109,ECE 45,A01,892618,Staff,0,0,65,65
1746570705161,ECE 111,A01,892719,Staff,5,0,65,60
1746570706185,ECE 197,001,957920,Mercier; Patrick Philip,9991,0,9999,8
1746570707215,ECON 178,A01,907814,Zhu; Ying,26,0,35,9
1746570708281,EDS 115,A00,895312,Staff,35,0,45,10
1746570709310,EDS 117,A01,895337,Staff,23,0,30,7
1746570710337,EDS 125,A00,895341,Jones; Gabrielle Anastasia,36,0,45,9
1746570711365,EDS 128A,A01,895459,Fargason; Sharon Gayle,44,0,45,1
1746570712406,EDS 128B,A01,895543,Pappas; Elizabeth,44,0,45,1
1746570713431,EDS 139,A00,897203,Pappas; Elizabeth,44,0,45,1
1746570713431,EDS 139,B00,897209,Fargason; Sharon Gayle,41,0,45,4
1746570714457,EDS 201,A00,895545,Staff,22,0,45,23
1746570715482,EDS 203,A01,895581,Halter; Christopher P.,22,0,45,23
1746570716510,EDS 204R,A01,895625,Heinzman; Erica M.,39,0,45,6
1746570716510,EDS 204R,B01,895693,Halter; Christopher P.,10,0,45,35
1746570717534,EDS 206R,A00,895694,Fargason; Sharon Gayle,1,0,30,29
1746570717534,EDS 206R,B00,895695,Choi; Bailey Miyeon,16,0,30,14
1746570718563,EDS 250,A00,895697,Hemans; Patricia Ann Benitez,22,0,45,23
1746570719593,EDS 281,A00,895701,Meyerott; Theresa Ann,1,0,15,14
1746570720618,EDS 284,A00,895736,Meyerott; Theresa Ann,1,0,15,14
1746570721644,EDS 286,A00,897210,Fine; Sarah,0,0,15,15
1746570722669,EDS 289C,A01,895770,Daly; Alan J.,1,0,15,14
1746570723696,EDS 290,A00,897211,Hofstetter; Carolyn,0,0,15,15
1746570724721,LIGM 5A,A00,896162,Fischer-Grunski; Eva K,12,0,20,8
1746570725748,LIGM 5B,A00,896260,Fischer-Grunski; Eva K,17,0,20,3
1746570726772,LIGM 5C,A00,896308,Fischer-Grunski; Eva K,18,0,20,2
1746570727797,LIIT 5AS,A00,896313,Carnelos; Chiara,18,0,20,2
1746570728825,LIIT 5BS,A00,896416,Carnelos; Chiara,20,0,20,0
1746570729851,LIIT 5CS,A00,896564,Carnelos; Chiara,20,0,20,0
1746570730877,LISP 5A,A00,896588,Munoz Sanchez; Alicia,2,0,20,18
1746570731907,LISP 5B,A00,896653,Munoz Sanchez; Alicia,7,0,20,13
1746570732934,LISP 5C,A00,896655,Munoz Sanchez; Alicia,0,1,20,20
1746570733959,MAE 197,001,957918,Kleissl; Jan,9996,0,9999,3
1746570733959,MAE 197,002,959806,Boechler; Nicholas Sebastia,9998,0,9999,1
1746570733959,MAE 197,003,959852,Mullin; Jennifer S,9998,0,9999,1
1746570734984,MATH 2,A01,957937,Staff,33,0,35,2
1746570736010,MATH 197,001,957876,Kedlaya; Kiran S.,9993,0,9999,6
1746570737037,MCWP 40,A00,892729,Duru; Nur,10,0,20,10
1746570737037,MCWP 40,B00,893304,Montejo; Carolina,14,0,20,6
1746570738061,MCWP 40R,A00,893757,Redela; Pamela Morgan,0,5,20,20
1746570739090,MCWP 50,A00,893758,Morshed; Michael James,0,0,20,20
1746570739090,MCWP 50,B00,893761,Bartulis; Jason Michael,17,0,20,3
1746570740123,MCWP 50R,A00,893766,Compas; Sean Matthew,0,1,20,20
1746570740123,MCWP 50R,B00,893769,Carter; Jennifer A,0,1,20,20
1746570740123,MCWP 50R,C00,893771,Krone; Jarret,0,3,20,20
1746570740123,MCWP 50R,D00,893772,Miller; Elizabeth Deen,0,0,20,20
1746570740123,MCWP 50R,E00,893775,Carter; Andrea L,0,1,20,20
1746570741151,MMW 11R,A01,892721,Herbst; Matthew,11,0,27,16
1746570741151,MMW 11R,A02,892722,Herbst; Matthew,0,0,0,3
1746570742179,MMW 12R,A01,892724,Herbst; Matthew,0,11,16,16
1746570742179,MMW 12R,A02,892725,Herbst; Matthew,0,10,16,16
1746570743209,MMW 13R,A01,892727,Staff,0,4,16,16
1746570743209,MMW 13R,A02,892728,Staff,0,4,16,16
1746570743209,MMW 13R,A03,958032,Staff,0,4,16,16
1746570743209,MMW 13R,A04,958033,Staff,0,4,16,16
1746570743209,MMW 13R,A05,958034,Staff,0,4,16,16
1746570744234,SIO 295LS,A00,894015,Staff,5,0,25,20
1746570745259,SIO 295S,A00,894020,Staff,5,0,25,20
1746570746284,SIOC 290S,B01,958918,Merrifield; Mark A,14,0,30,16
1746570747313,SIOC 291S,B01,958922,Gabriel; Corey John,14,0,30,16
1746570748337,SOCI 117,A01,895339,Staff,3,0,5,2
1746570749362,WES 237B,A00,894149,Staff,11,0,20,9
1746570751427,AESE 279B,A00,891859,Staff,13,0,35,22
1746570752455,AIP 197,001,891854,Vespa; Emanuel Ignacio,9999,0,9999,0
1746570753482,ANTH 289S,A00,891856,Gagneux; Pascal,12,0,12,0
1746570754509,BENG 196,001,957946,Engler; Adam J.,9996,0,9999,3
1746570755534,BISP 197,001,959851,Wilhelm; James E.,9998,0,9999,1
1746570756558,CAT 124RS,A01,956906,Staff,6,0,25,19
1746570757587,CAT 125RS,A01,922013,Staff,6,0,25,19
1746570758613,CLRE 250,A00,891860,Morris; Sheldon,9995,0,9999,4
1746570760664,CLRE 251R,A00,907817,Mehta; Ravindra L.,9994,0,9999,5
1746570761689,CLRE 252,A00,891864,Cuomo; Raphael Eduardo,9993,0,9999,6
1746570762720,CLRE 253,A00,891867,Vaida; Florin,9994,0,9999,5
1746570762720,CLRE 253,B00,907819,Staff,9999,0,9999,0
1746570763745,CLRE 259,A00,891868,Patel; Hemal,9998,0,9999,1
1746570764770,CLRE 260,A00,891872,Cuomo; Raphael Eduardo,9999,0,9999,0
1746570765795,CLRE 297,001,891888,Cuomo; Raphael Eduardo,9999,0,9999,0
1746570766825,CSE 191,A00,958773,Minnes Kemp; Mor Mia,9995,0,9999,4
1746570767850,CSE 197,001,959846,Minnes Kemp; Mor Mia,9990,0,9999,9
1746570768877,CSS 201S,A01,892054,Mignozzetti; Umberto,25,0,30,5
1746570769906,CSS 202S,A01,892056,Mignozzetti; Umberto,25,0,30,5
1746570770931,DSC 197,001,956898,Eldridge; Justin Matthew,9996,0,9999,3
1746570771959,DSC 297,001,958000,Mazumdar; Arya,9998,0,9999,1
1746570771959,DSC 297,002,959862,Wang; Yusu,9998,0,9999,1
1746570772985,EAP 100,A00,905686,Staff,9778,0,9999,221
1746570774011,ECE 45,A01,892618,Staff,0,0,65,65
1746570776065,ECE 111,A01,892719,Staff,5,0,65,60
1746570777091,ECE 197,001,957920,Mercier; Patrick Philip,9991,0,9999,8
1746570778121,ECON 178,A01,907814,Zhu; Ying,26,0,35,9
1746570779147,EDS 115,A00,895312,Staff,35,0,45,10
1746570780172,EDS 117,A01,895337,Staff,23,0,30,7
1746570781197,EDS 125,A00,895341,Jones; Gabrielle Anastasia,36,0,45,9
1746570782223,EDS 128A,A01,895459,Fargason; Sharon Gayle,44,0,45,1
1746570783252,EDS 128B,A01,895543,Pappas; Elizabeth,44,0,45,1
1746570784277,EDS 139,A00,897203,Pappas; Elizabeth,44,0,45,1
1746570784277,EDS 139,B00,897209,Fargason; Sharon Gayle,41,0,45,4
1746570785306,EDS 201,A00,895545,Staff,22,0,45,23
1746570786335,EDS 203,A01,895581,Halter; Christopher P.,22,0,45,23
1746570787360,EDS 204R,A01,895625,Heinzman; Erica M.,39,0,45,6
1746570787360,EDS 204R,B01,895693,Halter; Christopher P.,10,0,45,35
1746570788385,EDS 206R,A00,895694,Fargason; Sharon Gayle,1,0,30,29
1746570788385,EDS 206R,B00,895695,Choi; Bailey Miyeon,16,0,30,14
1746570789414,EDS 250,A00,895697,Hemans; Patricia Ann Benitez,22,0,45,23
1746570790439,EDS 281,A00,895701,Meyerott; Theresa Ann,1,0,15,14
1746570791469,EDS 284,A00,895736,Meyerott; Theresa Ann,1,0,15,14
1746570792498,EDS 286,A00,897210,Fine; Sarah,0,0,15,15
1746570793527,EDS 289C,A01,895770,Daly; Alan J.,1,0,15,14
1746570794552,EDS 290,A00,897211,Hofstetter; Carolyn,0,0,15,15
1746570795578,LIGM 5A,A00,896162,Fischer-Grunski; Eva K,12,0,20,8
1746570796603,LIGM 5B,A00,896260,Fischer-Grunski; Eva K,17,0,20,3
1746570797630,LIGM 5C,A00,896308,Fischer-Grunski; Eva K,18,0,20,2
1746570798655,LIIT 5AS,A00,896313,Carnelos; Chiara,18,0,20,2
1746570799684,LIIT 5BS,A00,896416,Carnelos; Chiara,20,0,20,0
1746570800710,LIIT 5CS,A00,896564,Carnelos; Chiara,20,0,20,0
1746570801739,LISP 5A,A00,896588,Munoz Sanchez; Alicia,2,0,20,18
1746570802770,LISP 5B,A00,896653,Munoz Sanchez; Alicia,7,0,20,13
1746570803795,LISP 5C,A00,896655,Munoz Sanchez; Alicia,0,1,20,20
1746570804819,MAE 197,001,957918,Kleissl; Jan,9996,0,9999,3
1746570804819,MAE 197,002,959806,Boechler; Nicholas Sebastia,9998,0,9999,1
1746570804819,MAE 197,003,959852,Mullin; Jennifer S,9998,0,9999,1
1746570805846,MATH 2,A01,957937,Staff,33,0,35,2
1746570806873,MATH 197,001,957876,Kedlaya; Kiran S.,9993,0,9999,6
1746570807899,MCWP 40,A00,892729,Duru; Nur,10,0,20,10
1746570807899,MCWP 40,B00,893304,Montejo; Carolina,14,0,20,6
1746570808926,MCWP 40R,A00,893757,Redela; Pamela Morgan,0,5,20,20
1746570809952,MCWP 50,A00,893758,Morshed; Michael James,0,0,20,20
1746570809952,MCWP 50,B00,893761,Bartulis; Jason Michael,17,0,20,3
1746570810977,MCWP 50R,A00,893766,Compas; Sean Matthew,0,1,20,20
1746570810977,MCWP 50R,B00,893769,Carter; Jennifer A,0,1,20,20
1746570810977,MCWP 50R,C00,893771,Krone; Jarret,0,3,20,20
1746570810977,MCWP 50R,D00,893772,Miller; Elizabeth Deen,0,0,20,20
1746570810977,MCWP 50R,E00,893775,Carter; Andrea L,0,1,20,20
1746570812003,MMW 11R,A01,892721,Herbst; Matthew,11,0,27,16
1746570812003,MMW 11R,A02,892722,Herbst; Matthew,0,0,0,3
1746570813032,MMW 12R,A01,892724,Herbst; Matthew,0,11,16,16
1746570813032,MMW 12R,A02,892725,Herbst; Matthew,0,10,16,16
1746570814057,MMW 13R,A01,892727,Staff,0,4,16,16
1746570814057,MMW 13R,A02,892728,Staff,0,4,16,16
1746570814057,MMW 13R,A03,958032,Staff,0,4,16,16
1746570814057,MMW 13R,A04,958033,Staff,0,4,16,16
1746570814057,MMW 13R,A05,958034,Staff,0,4,16,16
1746570815086,SIO 295LS,A00,894015,Staff,5,0,25,20
1746570816111,SIO 295S,A00,894020,Staff,5,0,25,20
1746570817137,SIOC 290S,B01,958918,Merrifield; Mark A,14,0,30,16
1746570818167,SIOC 291S,B01,958922,Gabriel; Corey John,14,0,30,16
1746570819197,SOCI 117,A01,895339,Staff,3,0,5,2
1746570820221,WES 237B,A00,894149,Staff,11,0,20,9
1746570822280,AESE 279B,A00,891859,Staff,13,0,35,22
1746570823304,AIP 197,001,891854,Vespa; Emanuel Ignacio,9999,0,9999,0
1746570824330,ANTH 289S,A00,891856,Gagneux; Pascal,12,0,12,0
1746570825358,BENG 196,001,957946,Engler; Adam J.,9996,0,9999,3
1746570826382,BISP 197,001,959851,Wilhelm; James E.,9998,0,9999,1
1746570827406,CAT 124RS,A01,956906,Staff,6,0,25,19
1746570828433,CAT 125RS,A01,922013,Staff,6,0,25,19
1746570829461,CLRE 250,A00,891860,Morris; Sheldon,9995,0,9999,4
1746570831513,CLRE 251R,A00,907817,Mehta; Ravindra L.,9994,0,9999,5
1746570832538,CLRE 252,A00,891864,Cuomo; Raphael Eduardo,9993,0,9999,6
1746570833568,CLRE 253,A00,891867,Vaida; Florin,9994,0,9999,5
1746570833568,CLRE 253,B00,907819,Staff,9999,0,9999,0
1746570834597,CLRE 259,A00,891868,Patel; Hemal,9998,0,9999,1
1746570835623,CLRE 260,A00,891872,Cuomo; Raphael Eduardo,9999,0,9999,0
1746570836652,CLRE 297,001,891888,Cuomo; Raphael Eduardo,9999,0,9999,0
1746570837683,CSE 191,A00,958773,Minnes Kemp; Mor Mia,9995,0,9999,4
1746570838712,CSE 197,001,959846,Minnes Kemp; Mor Mia,9990,0,9999,9
1746570839739,CSS 201S,A01,892054,Mignozzetti; Umberto,25,0,30,5
1746570840768,CSS 202S,A01,892056,Mignozzetti; Umberto,25,0,30,5
1746570841797,DSC 197,001,956898,Eldridge; Justin Matthew,9996,0,9999,3
1746570842821,DSC 297,001,958000,Mazumdar; Arya,9998,0,9999,1
1746570842821,DSC 297,002,959862,Wang; Yusu,9998,0,9999,1
1746570843846,EAP 100,A00,905686,Staff,9778,0,9999,221
1746570844871,ECE 45,A01,892618,Staff,0,0,65,65
1746570846930,ECE 111,A01,892719,Staff,5,0,65,60
1746570847954,ECE 197,001,957920,Mercier; Patrick Philip,9991,0,9999,8
1746570848979,ECON 178,A01,907814,Zhu; Ying,26,0,35,9
1746570850012,EDS 115,A00,895312,Staff,35,0,45,10
1746570851038,EDS 117,A01,895337,Staff,23,0,30,7
1746570852062,EDS 125,A00,895341,Jones; Gabrielle Anastasia,36,0,45,9
1746570853087,EDS 128A,A01,895459,Fargason; Sharon Gayle,44,0,45,1
1746570854115,EDS 128B,A01,895543,Pappas; Elizabeth,44,0,45,1
1746570855140,EDS 139,A00,897203,Pappas; Elizabeth,44,0,45,1
1746570855140,EDS 139,B00,897209,Fargason; Sharon Gayle,41,0,45,4
1746570856168,EDS 201,A00,895545,Staff,22,0,45,23
1746570857195,EDS 203,A01,895581,Halter; Christopher P.,22,0,45,23
1746570858220,EDS 204R,A01,895625,Heinzman; Erica M.,39,0,45,6
1746570858220,EDS 204R,B01,895693,Halter; Christopher P.,10,0,45,35
1746570859246,EDS 206R,A00,895694,Fargason; Sharon Gayle,1,0,30,29
1746570859246,EDS 206R,B00,895695,Choi; Bailey Miyeon,16,0,30,14
1746570860270,EDS 250,A00,895697,Hemans; Patricia Ann Benitez,22,0,45,23
1746570861297,EDS 281,A00,895701,Meyerott; Theresa Ann,1,0,15,14
1746570862334,EDS 284,A00,895736,Meyerott; Theresa Ann,1,0,15,14
1746570863361,EDS 286,A00,897210,Fine; Sarah,0,0,15,15
1746570864387,EDS 289C,A01,895770,Daly; Alan J.,1,0,15,14
1746570865414,EDS 290,A00,897211,Hofstetter; Carolyn,0,0,15,15
1746570866443,LIGM 5A,A00,896162,Fischer-Grunski; Eva K,12,0,20,8
1746570867472,LIGM 5B,A00,896260,Fischer-Grunski; Eva K,17,0,20,3
1746570868496,LIGM 5C,A00,896308,Fischer-Grunski; Eva K,18,0,20,2
1746570869523,LIIT 5AS,A00,896313,Carnelos; Chiara,18,0,20,2
1746570870553,LIIT 5BS,A00,896416,Carnelos; Chiara,20,0,20,0
1746570871580,LIIT 5CS,A00,896564,Carnelos; Chiara,20,0,20,0
1746570872605,LISP 5A,A00,896588,Munoz Sanchez; Alicia,2,0,20,18
1746570873629,LISP 5B,A00,896653,Munoz Sanchez; Alicia,7,0,20,13
1746570874655,LISP 5C,A00,896655,Munoz Sanchez; Alicia,0,1,20,20
1746570875685,MAE 197,001,957918,Kleissl; Jan,9996,0,9999,3
1746570875685,MAE 197,002,959806,Boechler; Nicholas Sebastia,9998,0,9999,1
1746570875685,MAE 197,003,959852,Mullin; Jennifer S,9998,0,9999,1
1746570876710,MATH 2,A01,957937,Staff,33,0,35,2
1746570877741,MATH 197,001,957876,Kedlaya; Kiran S.,9993,0,9999,6
1746570878769,MCWP 40,A00,892729,Duru; Nur,10,0,20,10
1746570878769,MCWP 40,B00,893304,Montejo; Carolina,14,0,20,6
1746570879795,MCWP 40R,A00,893757,Redela; Pamela Morgan,0,5,20,20
1746570880825,MCWP 50,A00,893758,Morshed; Michael James,0,0,20,20
1746570880825,MCWP 50,B00,893761,Bartulis; Jason Michael,17,0,20,3
1746570881854,MCWP 50R,A00,893766,Compas; Sean Matthew,0,1,20,20
1746570881854,MCWP 50R,B00,893769,Carter; Jennifer A,0,1,20,20
1746570881854,MCWP 50R,C00,893771,Krone; Jarret,0,3,20,20
1746570881854,MCWP 50R,D00,893772,Miller; Elizabeth Deen,0,0,20,20
1746570881854,MCWP 50R,E00,893775,Carter; Andrea L,0,1,20,20
1746570882878,MMW 11R,A01,892721,Herbst; Matthew,11,0,27,16
1746570882878,MMW 11R,A02,892722,Herbst; Matthew,0,0,0,3
1746570883904,MMW 12R,A01,892724,Herbst; Matthew,0,11,16,16
1746570883904,MMW 12R,A02,892725,Herbst; Matthew,0,10,16,16
1746570884928,MMW 13R,A01,892727,Staff,0,4,16,16
1746570884928,MMW 13R,A02,892728,Staff,0,4,16,16
1746570884928,MMW 13R,A03,958032,Staff,0,4,16,16
1746570884928,MMW 13R,A04,958033,Staff,0,4,16,16
1746570884928,MMW 13R,A05,958034,Staff,0,4,16,16
1746570885957,SIO 295LS,A00,894015,Staff,5,0,25,20
1746570886982,SIO 295S,A00,894020,Staff,5,0,25,20
1746570888011,SIOC 290S,B01,958918,Merrifield; Mark A,14,0,30,16
1746570889039,SIOC 291S,B01,958922,Gabriel; Corey John,14,0,30,16
1746570890065,SOCI 117,A01,895339,Staff,3,0,5,2
1746570891092,WES 237B,A00,894149,Staff,11,0,20,9
1746570893150,AESE 279B,A00,891859,Staff,13,0,35,22
1746570894178,AIP 197,001,891854,Vespa; Emanuel Ignacio,9999,0,9999,0
1746570895202,ANTH 289S,A00,891856,Gagneux; Pascal,12,0,12,0
1746570896230,BENG 196,001,957946,Engler; Adam J.,9996,0,9999,3
1746570897254,BISP 197,001,959851,Wilhelm; James E.,9998,0,9999,1
1746570898278,CAT 124RS,A01,956906,Staff,6,0,25,19
1746570899304,CAT 125RS,A01,922013,Staff,6,0,25,19
1746570900333,CLRE 250,A00,891860,Morris; Sheldon,9995,0,9999,4
1746570902397,CLRE 251R,A00,907817,Mehta; Ravindra L.,9994,0,9999,5
1746570903421,CLRE 252,A00,891864,Cuomo; Raphael Eduardo,9993,0,9999,6
1746570904446,CLRE 253,A00,891867,Vaida; Florin,9994,0,9999,5
1746570904446,CLRE 253,B00,907819,Staff,9999,0,9999,0
1746570905473,CLRE 259,A00,891868,Patel; Hemal,9998,0,9999,1
1746570906501,CLRE 260,A00,891872,Cuomo; Raphael Eduardo,9999,0,9999,0
1746570907529,CLRE 297,001,891888,Cuomo; Raphael Eduardo,9999,0,9999,0
1746570908557,CSE 191,A00,958773,Minnes Kemp; Mor Mia,9995,0,9999,4
1746570909583,CSE 197,001,959846,Minnes Kemp; Mor Mia,9990,0,9999,9
1746570910613,CSS 201S,A01,892054,Mignozzetti; Umberto,25,0,30,5
1746570911644,CSS 202S,A01,892056,Mignozzetti; Umberto,25,0,30,5
1746570912670,DSC 197,001,956898,Eldridge; Justin Matthew,9996,0,9999,3
1746570913698,DSC 297,001,958000,Mazumdar; Arya,9998,0,9999,1
1746570913698,DSC 297,002,959862,Wang; Yusu,9998,0,9999,1
1746570914726,EAP 100,A00,905686,Staff,9778,0,9999,221
1746570915756,ECE 45,A01,892618,Staff,0,0,65,65
1746570917810,ECE 111,A01,892719,Staff,5,0,65,60
1746570918839,ECE 197,001,957920,Mercier; Patrick Philip,9991,0,9999,8
1746570919867,ECON 178,A01,907814,Zhu; Ying,26,0,35,9
1746570920895,EDS 115,A00,895312,Staff,35,0,45,10
1746570921922,EDS 117,A01,895337,Staff,23,0,30,7
1746570922947,EDS 125,A00,895341,Jones; Gabrielle Anastasia,36,0,45,9
1746570923971,EDS 128A,A01,895459,Fargason; Sharon Gayle,44,0,45,1
1746570925000,EDS 128B,A01,895543,Pappas; Elizabeth,44,0,45,1
1746570926028,EDS 139,A00,897203,Pappas; Elizabeth,44,0,45,1
1746570926028,EDS 139,B00,897209,Fargason; Sharon Gayle,41,0,45,4
1746570927057,EDS 201,A00,895545,Staff,22,0,45,23
1746570928081,EDS 203,A01,895581,Halter; Christopher P.,22,0,45,23
1746570929106,EDS 204R,A01,895625,Heinzman; Erica M.,39,0,45,6
1746570929106,EDS 204R,B01,895693,Halter; Christopher P.,10,0,45,35
1746570930131,EDS 206R,A00,895694,Fargason; Sharon Gayle,1,0,30,29
1746570930131,EDS 206R,B00,895695,Choi; Bailey Miyeon,16,0,30,14
1746570931158,EDS 250,A00,895697,Hemans; Patricia Ann Benitez,22,0,45,23
1746570932182,EDS 281,A00,895701,Meyerott; Theresa Ann,1,0,15,14
1746570933208,EDS 284,A00,895736,Meyerott; Theresa Ann,1,0,15,14
1746570934235,EDS 286,A00,897210,Fine; Sarah,0,0,15,15
1746570935260,EDS 289C,A01,895770,Daly; Alan J.,1,0,15,14
1746570936287,EDS 290,A00,897211,Hofstetter; Carolyn,0,0,15,15
1746570937316,LIGM 5A,A00,896162,Fischer-Grunski; Eva K,12,0,20,8
1746570938340,LIGM 5B,A00,896260,Fischer-Grunski; Eva K,17,0,20,3
1746570939369,LIGM 5C,A00,896308,Fischer-Grunski; Eva K,18,0,20,2
1746570940397,LIIT 5AS,A00,896313,Carnelos; Chiara,18,0,20,2
1746570941422,LIIT 5BS,A00,896416,Carnelos; Chiara,20,0,20,0
1746570942455,LIIT 5CS,A00,896564,Carnelos; Chiara,20,0,20,0
1746570943479,LISP 5A,A00,896588,Munoz Sanchez; Alicia,2,0,20,18
1746570944504,LISP 5B,A00,896653,Munoz Sanchez; Alicia,7,0,20,13
1746570945534,LISP 5C,A00,896655,Munoz Sanchez; Alicia,0,1,20,20
1746570946559,MAE 197,001,957918,Kleissl; Jan,9996,0,9999,3
1746570946559,MAE 197,002,959806,Boechler; Nicholas Sebastia,9998,0,9999,1
1746570946559,MAE 197,003,959852,Mullin; Jennifer S,9998,0,9999,1
1746570947586,MATH 2,A01,957937,Staff,33,0,35,2
1746570948611,MATH 197,001,957876,Kedlaya; Kiran S.,9993,0,9999,6
1746570949636,MCWP 40,A00,892729,Duru; Nur,10,0,20,10
1746570949636,MCWP 40,B00,893304,Montejo; Carolina,14,0,20,6
1746570950662,MCWP 40R,A00,893757,Redela; Pamela Morgan,0,5,20,20
1746570951686,MCWP 50,A00,893758,Morshed; Michael James,0,0,20,20
1746570951686,MCWP 50,B00,893761,Bartulis; Jason Michael,17,0,20,3
1746570952710,MCWP 50R,A00,893766,Compas; Sean Matthew,0,1,20,20
1746570952710,MCWP 50R,B00,893769,Carter; Jennifer A,0,1,20,20
1746570952710,MCWP 50R,C00,893771,Krone; Jarret,0,3,20,20
1746570952710,MCWP 50R,D00,893772,Miller; Elizabeth Deen,0,0,20,20
1746570952710,MCWP 50R,E00,893775,Carter; Andrea L,0,1,20,20
1746570953737,MMW 11R,A01,892721,Herbst; Matthew,11,0,27,16
1746570953737,MMW 11R,A02,892722,Herbst; Matthew,0,0,0,3
1746570954766,MMW 12R,A01,892724,Herbst; Matthew,0,11,16,16
1746570954766,MMW 12R,A02,892725,Herbst; Matthew,0,10,16,16
1746570955795,MMW 13R,A01,892727,Staff,0,4,16,16
1746570955795,MMW 13R,A02,892728,Staff,0,4,16,16
1746570955795,MMW 13R,A03,958032,Staff,0,4,16,16
1746570955795,MMW 13R,A04,958033,Staff,0,4,16,16
1746570955795,MMW 13R,A05,958034,Staff,0,4,16,16
1746570956823,SIO 295LS,A00,894015,Staff,5,0,25,20
1746570957851,SIO 295S,A00,894020,Staff,5,0,25,20
1746570958882,SIOC 290S,B01,958918,Merrifield; Mark A,14,0,30,16
1746570959908,SIOC 291S,B01,958922,Gabriel; Corey John,14,0,30,16
1746570960934,SOCI 117,A01,895339,Staff,3,0,5,2
1746570961958,WES 237B,A00,894149,Staff,11,0,20,9
1746570964017,AESE 279B,A00,891859,Staff,13,0,35,22
1746570965043,AIP 197,001,891854,Vespa; Emanuel Ignacio,9999,0,9999,0
1746570966068,ANTH 289S,A00,891856,Gagneux; Pascal,12,0,12,0
1746570967092,BENG 196,001,957946,Engler; Adam J.,9996,0,9999,3
1746570968123,BISP 197,001,959851,Wilhelm; James E.,9998,0,9999,1
1746570969152,CAT 124RS,A01,956906,Staff,6,0,25,19
1746570970176,CAT 125RS,A01,922013,Staff,6,0,25,19
1746570971202,CLRE 250,A00,891860,Morris; Sheldon,9995,0,9999,4
1746570973253,CLRE 251R,A00,907817,Mehta; Ravindra L.,9994,0,9999,5
1746570974278,CLRE 252,A00,891864,Cuomo; Raphael Eduardo,9993,0,9999,6
1746570975303,CLRE 253,A00,891867,Vaida; Florin,9994,0,9999,5
1746570975303,CLRE 253,B00,907819,Staff,9999,0,9999,0
1746570976328,CLRE 259,A00,891868,Patel; Hemal,9998,0,9999,1
1746570977354,CLRE 260,A00,891872,Cuomo; Raphael Eduardo,9999,0,9999,0
1746570978383,CLRE 297,001,891888,Cuomo; Raphael Eduardo,9999,0,9999,0
1746570979410,CSE 191,A00,958773,Minnes Kemp; Mor Mia,9995,0,9999,4
1746570980438,CSE 197,001,959846,Minnes Kemp; Mor Mia,9990,0,9999,9
1746570981467,CSS 201S,A01,892054,Mignozzetti; Umberto,25,0,30,5
1746570982498,CSS 202S,A01,892056,Mignozzetti; Umberto,25,0,30,5
1746570983525,DSC 197,001,956898,Eldridge; Justin Matthew,9996,0,9999,3
1746570984555,DSC 297,001,958000,Mazumdar; Arya,9998,0,9999,1
1746570984555,DSC 297,002,959862,Wang; Yusu,9998,0,9999,1
1746570985584,EAP 100,A00,905686,Staff,9778,0,9999,221
1746570986614,ECE 45,A01,892618,Staff,0,0,65,65
1746570988665,ECE 111,A01,892719,Staff,5,0,65,60
1746570989689,ECE 197,001,957920,Mercier; Patrick Philip,9991,0,9999,8
1746570990716,ECON 178,A01,907814,Zhu; Ying,26,0,35,9
1746570991744,EDS 115,A00,895312,Staff,35,0,45,10
1746570992769,EDS 117,A01,895337,Staff,23,0,30,7
1746570993798,EDS 125,A00,895341,Jones; Gabrielle Anastasia,36,0,45,9
1746570994826,EDS 128A,A01,895459,Fargason; Sharon Gayle,44,0,45,1
1746570995853,EDS 128B,A01,895543,Pappas; Elizabeth,44,0,45,1
1746570996879,EDS 139,A00,897203,Pappas; Elizabeth,44,0,45,1
1746570996879,EDS 139,B00,897209,Fargason; Sharon Gayle,41,0,45,4
1746570997907,EDS 201,A00,895545,Staff,22,0,45,23
1746570998932,EDS 203,A01,895581,Halter; Christopher P.,22,0,45,23
1746570999957,EDS 204R,A01,895625,Heinzman; Erica M.,39,0,45,6
1746570999957,EDS 204R,B01,895693,Halter; Christopher P.,10,0,45,35
1746571000986,EDS 206R,A00,895694,Fargason; Sharon Gayle,1,0,30,29
1746571000986,EDS 206R,B00,895695,Choi; Bailey Miyeon,16,0,30,14
1746571002014,EDS 250,A00,895697,Hemans; Patricia Ann Benitez,22,0,45,23
1746571003040,EDS 281,A00,895701,Meyerott; Theresa Ann,1,0,15,14
1746571004066,EDS 284,A00,895736,Meyerott; Theresa Ann,1,0,15,14
1746571005091,EDS 286,A00,897210,Fine; Sarah,0,0,15,15
1746571006117,EDS 289C,A01,895770,Daly; Alan J.,1,0,15,14
1746571007144,EDS 290,A00,897211,Hofstetter; Carolyn,0,0,15,15
1746571008174,LIGM 5A,A00,896162,Fischer-Grunski; Eva K,12,0,20,8
1746571009202,LIGM 5B,A00,896260,Fischer-Grunski; Eva K,17,0,20,3
1746571010225,LIGM 5C,A00,896308,Fischer-Grunski; Eva K,18,0,20,2
1746571011253,LIIT 5AS,A00,896313,Carnelos; Chiara,18,0,20,2
1746571012278,LIIT 5BS,A00,896416,Carnelos; Chiara,20,0,20,0
1746571013302,LIIT 5CS,A00,896564,Carnelos; Chiara,20,0,20,0
1746571014327,LISP 5A,A00,896588,Munoz Sanchez; Alicia,2,0,20,18
1746571015353,LISP 5B,A00,896653,Munoz Sanchez; Alicia,7,0,20,13
1746571016378,LISP 5C,A00,896655,Munoz Sanchez; Alicia,0,1,20,20
1746571017404,MAE 197,001,957918,Kleissl; Jan,9996,0,9999,3
1746571017404,MAE 197,002,959806,Boechler; Nicholas Sebastia,9998,0,9999,1
1746571017404,MAE 197,003,959852,Mullin; Jennifer S,9998,0,9999,1
1746571018427,MATH 2,A01,957937,Staff,33,0,35,2
1746571019452,MATH 197,001,957876,Kedlaya; Kiran S.,9993,0,9999,6
1746571020480,MCWP 40,A00,892729,Duru; Nur,10,0,20,10
1746571020480,MCWP 40,B00,893304,Montejo; Carolina,14,0,20,6
1746571021505,MCWP 40R,A00,893757,Redela; Pamela Morgan,0,5,20,20
1746571022535,MCWP 50,A00,893758,Morshed; Michael James,0,0,20,20
1746571022535,MCWP 50,B00,893761,Bartulis; Jason Michael,17,0,20,3
1746571023563,MCWP 50R,A00,893766,Compas; Sean Matthew,0,1,20,20
1746571023563,MCWP 50R,B00,893769,Carter; Jennifer A,0,1,20,20
1746571023563,MCWP 50R,C00,893771,Krone; Jarret,0,3,20,20
1746571023563,MCWP 50R,D00,893772,Miller; Elizabeth Deen,0,0,20,20
1746571023563,MCWP 50R,E00,893775,Carter; Andrea L,0,1,20,20
1746571024591,MMW 11R,A01,892721,Herbst; Matthew,11,0,27,16
1746571024591,MMW 11R,A02,892722,Herbst; Matthew,0,0,0,3
1746571025620,MMW 12R,A01,892724,Herbst; Matthew,0,11,16,16
1746571025620,MMW 12R,A02,892725,Herbst; Matthew,0,10,16,16
1746571026646,MMW 13R,A01,892727,Staff,0,4,16,16
1746571026646,MMW 13R,A02,892728,Staff,0,4,16,16
1746571026646,MMW 13R,A03,958032,Staff,0,4,16,16
1746571026646,MMW 13R,A04,958033,Staff,0,4,16,16
1746571026646,MMW 13R,A05,958034,Staff,0,4,16,16
1746571027670,SIO 295LS,A00,894015,Staff,5,0,25,20
1746571028699,SIO 295S,A00,894020,Staff,5,0,25,20
1746571029725,SIOC 290S,B01,958918,Merrifield; Mark A,14,0,30,16
1746571030750,SIOC 291S,B01,958922,Gabriel; Corey John,14,0,30,16
1746571031775,SOCI 117,A01,895339,Staff,3,0,5,2
1746571032800,WES 237B,A00,894149,Staff,11,0,20,9
1746571034861,AESE 279B,A00,891859,Staff,13,0,35,22
1746571035886,AIP 197,001,891854,Vespa; Emanuel Ignacio,9999,0,9999,0
1746571036911,ANTH 289S,A00,891856,Gagneux; Pascal,12,0,12,0
1746571037940,BENG 196,001,957946,Engler; Adam J.,9996,0,9999,3
1746571038967,BISP 197,001,959851,Wilhelm; James E.,9998,0,9999,1
1746571039993,CAT 124RS,A01,956906,Staff,6,0,25,19
1746571041019,CAT 125RS,A01,922013,Staff,6,0,25,19
1746571042044,CLRE 250,A00,891860,Morris; Sheldon,9995,0,9999,4
1746571044100,CLRE 251R,A00,907817,Mehta; Ravindra L.,9994,0,9999,5
1746571045128,CLRE 252,A00,891864,Cuomo; Raphael Eduardo,9993,0,9999,6
1746571046158,CLRE 253,A00,891867,Vaida; Florin,9994,0,9999,5
1746571046158,CLRE 253,B00,907819,Staff,9999,0,9999,0
1746571047184,CLRE 259,A00,891868,Patel; Hemal,9998,0,9999,1
1746571048209,CLRE 260,A00,891872,Cuomo; Raphael Eduardo,9999,0,9999,0
1746571049275,CLRE 297,001,891888,Cuomo; Raphael Eduardo,9999,0,9999,0
1746571050299,CSE 191,A00,958773,Minnes Kemp; Mor Mia,9995,0,9999,4
1746571051324,CSE 197,001,959846,Minnes Kemp; Mor Mia,9990,0,9999,9
1746571052349,CSS 201S,A01,892054,Mignozzetti; Umberto,25,0,30,5
1746571053379,CSS 202S,A01,892056,Mignozzetti; Umberto,25,0,30,5
1746571054405,DSC 197,001,956898,Eldridge; Justin Matthew,9996,0,9999,3
1746571055432,DSC 297,001,958000,Mazumdar; Arya,9998,0,9999,1
1746571055432,DSC 297,002,959862,Wang; Yusu,9998,0,9999,1
1746571056456,EAP 100,A00,905686,Staff,9778,0,9999,221
1746571057486,ECE 45,A01,892618,Staff,0,0,65,65
1746571059538,ECE 111,A01,892719,Staff,5,0,65,60
1746571060566,ECE 197,001,957920,Mercier; Patrick Philip,9991,0,9999,8
1746571061592,ECON 178,A01,907814,Zhu; Ying,26,0,35,9
1746571062621,EDS 115,A00,895312,Staff,35,0,45,10
1746571063646,EDS 117,A01,895337,Staff,23,0,30,7
1746571064675,EDS 125,A00,895341,Jones; Gabrielle Anastasia,36,0,45,9
1746571065699,EDS 128A,A01,895459,Fargason; Sharon Gayle,44,0,45,1
1746571066724,EDS 128B,A01,895543,Pappas; Elizabeth,44,0,45,1
1746571067752,EDS 139,A00,897203,Pappas; Elizabeth,44,0,45,1
1746571067752,EDS 139,B00,897209,Fargason; Sharon Gayle,41,0,45,4
1746571068779,EDS 201,A00,895545,Staff,22,0,45,23
1746571069812,EDS 203,A01,895581,Halter; Christopher P.,22,0,45,23
1746571070839,EDS 204R,A01,895625,Heinzman; Erica M.,39,0,45,6
1746571070839,EDS 204R,B01,895693,Halter; Christopher P.,10,0,45,35
1746571071865,EDS 206R,A00,895694,Fargason; Sharon Gayle,1,0,30,29
1746571071865,EDS 206R,B00,895695,Choi; Bailey Miyeon,16,0,30,14
1746571072894,EDS 250,A00,895697,Hemans; Patricia Ann Benitez,22,0,45,23
1746571073922,EDS 281,A00,895701,Meyerott; Theresa Ann,1,0,15,14
1746571074948,EDS 284,A00,895736,Meyerott; Theresa Ann,1,0,15,14
1746571075976,EDS 286,A00,897210,Fine; Sarah,0,0,15,15
1746571077002,EDS 289C,A01,895770,Daly; Alan J.,1,0,15,14
1746571078029,EDS 290,A00,897211,Hofstetter; Carolyn,0,0,15,15
1746571079055,LIGM 5A,A00,896162,Fischer-Grunski; Eva K,12,0,20,8
1746571080083,LIGM 5B,A00,896260,Fischer-Grunski; Eva K,17,0,20,3
1746571081112,LIGM 5C,A00,896308,Fischer-Grunski; Eva K,18,0,20,2
1746571082139,LIIT 5AS,A00,896313,Carnelos; Chiara,18,0,20,2
1746571083166,LIIT 5BS,A00,896416,Carnelos; Chiara,20,0,20,0
1746571084192,LIIT 5CS,A00,896564,Carnelos; Chiara,20,0,20,0
1746571085216,LISP 5A,A00,896588,Munoz Sanchez; Alicia,2,0,20,18
1746571086246,LISP 5B,A00,896653,Munoz Sanchez; Alicia,7,0,20,13
1746571087276,LISP 5C,A00,896655,Munoz Sanchez; Alicia,0,1,20,20
1746571088302,MAE 197,001,957918,Kleissl; Jan,9996,0,9999,3
1746571088302,MAE 197,002,959806,Boechler; Nicholas Sebastia,9998,0,9999,1
1746571088302,MAE 197,003,959852,Mullin; Jennifer S,9998,0,9999,1
1746571089330,MATH 2,A01,957937,Staff,33,0,35,2
1746571090356,MATH 197,001,957876,Kedlaya; Kiran S.,9993,0,9999,6
1746571091382,MCWP 40,A00,892729,Duru; Nur,10,0,20,10
1746571091382,MCWP 40,B00,893304,Montejo; Carolina,14,0,20,6
1746571092420,MCWP 40R,A00,893757,Redela; Pamela Morgan,0,5,20,20
1746571093460,MCWP 50,A00,893758,Morshed; Michael James,0,0,20,20
1746571093460,MCWP 50,B00,893761,Bartulis; Jason Michael,17,0,20,3
1746571094489,MCWP 50R,A00,893766,Compas; Sean Matthew,0,1,20,20
1746571094489,MCWP 50R,B00,893769,Carter; Jennifer A,0,1,20,20
1746571094489,MCWP 50R,C00,893771,Krone; Jarret,0,3,20,20
1746571094489,MCWP 50R,D00,893772,Miller; Elizabeth Deen,0,0,20,20
1746571094489,MCWP 50R,E00,893775,Carter; Andrea L,0,1,20,20
1746571095513,MMW 11R,A01,892721,Herbst; Matthew,11,0,27,16
1746571095513,MMW 11R,A02,892722,Herbst; Matthew,0,0,0,3
1746571096541,MMW 12R,A01,892724,Herbst; Matthew,0,11,16,16
1746571096541,MMW 12R,A02,892725,Herbst; Matthew,0,10,16,16
1746571097568,MMW 13R,A01,892727,Staff,0,4,16,16
1746571097568,MMW 13R,A02,892728,Staff,0,4,16,16
1746571097568,MMW 13R,A03,958032,Staff,0,4,16,16
1746571097568,MMW 13R,A04,958033,Staff,0,4,16,16
1746571097568,MMW 13R,A05,958034,Staff,0,4,16,16
1746571098597,SIO 295LS,A00,894015,Staff,5,0,25,20
1746571099622,SIO 295S,A00,894020,Staff,5,0,25,20
1746571100652,SIOC 290S,B01,958918,Merrifield; Mark A,14,0,30,16
1746571101677,SIOC 291S,B01,958922,Gabriel; Corey John,14,0,30,16
1746571102703,SOCI 117,A01,895339,Staff,3,0,5,2
1746571103730,WES 237B,A00,894149,Staff,11,0,20,9
1746571105793,AESE 279B,A00,891859,Staff,13,0,35,22
1746571106817,AIP 197,001,891854,Vespa; Emanuel Ignacio,9999,0,9999,0
1746571107845,ANTH 289S,A00,891856,Gagneux; Pascal,12,0,12,0
1746571108871,BENG 196,001,957946,Engler; Adam J.,9996,0,9999,3
1746571109896,BISP 197,001,959851,Wilhelm; James E.,9998,0,9999,1
1746571110923,CAT 124RS,A01,956906,Staff,6,0,25,19
1746571111947,CAT 125RS,A01,922013,Staff,6,0,25,19
1746571112971,CLRE 250,A00,891860,Morris; Sheldon,9995,0,9999,4
1746571115025,CLRE 251R,A00,907817,Mehta; Ravindra L.,9994,0,9999,5
1746571116051,CLRE 252,A00,891864,Cuomo; Raphael Eduardo,9993,0,9999,6
1746571117079,CLRE 253,A00,891867,Vaida; Florin,9994,0,9999,5
1746571117079,CLRE 253,B00,907819,Staff,9999,0,9999,0
1746571118105,CLRE 259,A00,891868,Patel; Hemal,9998,0,9999,1
1746571119130,CLRE 260,A00,891872,Cuomo; Raphael Eduardo,9999,0,9999,0
1746571120159,CLRE 297,001,891888,Cuomo; Raphael Eduardo,9999,0,9999,0
1746571121186,CSE 191,A00,958773,Minnes Kemp; Mor Mia,9995,0,9999,4
1746571122227,CSE 197,001,959846,Minnes Kemp; Mor Mia,9990,0,9999,9
1746571123252,CSS 201S,A01,892054,Mignozzetti; Umberto,25,0,30,5
1746571124281,CSS 202S,A01,892056,Mignozzetti; Umberto,25,0,30,5
1746571125309,DSC 197,001,956898,Eldridge; Justin Matthew,9996,0,9999,3
1746571126334,DSC 297,001,958000,Mazumdar; Arya,9998,0,9999,1
1746571126334,DSC 297,002,959862,Wang; Yusu,9998,0,9999,1
1746571127361,EAP 100,A00,905686,Staff,9778,0,9999,221
1746571128385,ECE 45,A01,892618,Staff,0,0,65,65
1746571130440,ECE 111,A01,892719,Staff,5,0,65,60
1746571131471,ECE 197,001,957920,Mercier; Patrick Philip,9991,0,9999,8
1746571132496,ECON 178,A01,907814,Zhu; Ying,26,0,35,9
1746571133520,EDS 115,A00,895312,Staff,35,0,45,10
1746571134544,EDS 117,A01,895337,Staff,23,0,30,7
1746571135573,EDS 125,A00,895341,Jones; Gabrielle Anastasia,36,0,45,9
1746571136599,EDS 128A,A01,895459,Fargason; Sharon Gayle,44,0,45,1
1746571137627,EDS 128B,A01,895543,Pappas; Elizabeth,44,0,45,1
1746571138656,EDS 139,A00,897203,Pappas; Elizabeth,44,0,45,1
1746571138656,EDS 139,B00,897209,Fargason; Sharon Gayle,41,0,45,4
1746571139680,EDS 201,A00,895545,Staff,22,0,45,23
1746571140708,EDS 203,A01,895581,Halter; Christopher P.,22,0,45,23
1746571141740,EDS 204R,A01,895625,Heinzman; Erica M.,39,0,45,6
1746571141740,EDS 204R,B01,895693,Halter; Christopher P.,10,0,45,35
1746571142772,EDS 206R,A00,895694,Fargason; Sharon Gayle,1,0,30,29
1746571142772,EDS 206R,B00,895695,Choi; Bailey Miyeon,16,0,30,14
1746571143798,EDS 250,A00,895697,Hemans; Patricia Ann Benitez,22,0,45,23
1746571144823,EDS 281,A00,895701,Meyerott; Theresa Ann,1,0,15,14
1746571145849,EDS 284,A00,895736,Meyerott; Theresa Ann,1,0,15,14
1746571146874,EDS 286,A00,897210,Fine; Sarah,0,0,15,15
1746571147899,EDS 289C,A01,895770,Daly; Alan J.,1,0,15,14
1746571148928,EDS 290,A00,897211,Hofstetter; Carolyn,0,0,15,15
1746571149958,LIGM 5A,A00,896162,Fischer-Grunski; Eva K,12,0,20,8
1746571150983,LIGM 5B,A00,896260,Fischer-Grunski; Eva K,17,0,20,3
1746571152008,LIGM 5C,A00,896308,Fischer-Grunski; Eva K,18,0,20,2
1746571153072,LIIT 5AS,A00,896313,Carnelos; Chiara,18,0,20,2
1746571154101,LIIT 5BS,A00,896416,Carnelos; Chiara,20,0,20,0
1746571155127,LIIT 5CS,A00,896564,Carnelos; Chiara,20,0,20,0
1746571156152,LISP 5A,A00,896588,Munoz Sanchez; Alicia,2,0,20,18
1746571157178,LISP 5B,A00,896653,Munoz Sanchez; Alicia,7,0,20,13
1746571158208,LISP 5C,A00,896655,Munoz Sanchez; Alicia,0,1,20,20
1746571159237,MAE 197,001,957918,Kleissl; Jan,9996,0,9999,3
1746571159237,MAE 197,002,959806,Boechler; Nicholas Sebastia,9998,0,9999,1
1746571159237,MAE 197,003,959852,Mullin; Jennifer S,9998,0,9999,1
1746571160261,MATH 2,A01,957937,Staff,33,0,35,2
1746571161286,MATH 197,001,957876,Kedlaya; Kiran S.,9993,0,9999,6
1746571162314,MCWP 40,A00,892729,Duru; Nur,10,0,20,10
1746571162314,MCWP 40,B00,893304,Montejo; Carolina,14,0,20,6
1746571163341,MCWP 40R,A00,893757,Redela; Pamela Morgan,0,5,20,20
1746571164366,MCWP 50,A00,893758,Morshed; Michael James,0,0,20,20
1746571164366,MCWP 50,B00,893761,Bartulis; Jason Michael,17,0,20,3
1746571165395,MCWP 50R,A00,893766,Compas; Sean Matthew,0,1,20,20
1746571165395,MCWP 50R,B00,893769,Carter; Jennifer A,0,1,20,20
1746571165395,MCWP 50R,C00,893771,Krone; Jarret,0,3,20,20
1746571165395,MCWP 50R,D00,893772,Miller; Elizabeth Deen,0,0,20,20
1746571165395,MCWP 50R,E00,893775,Carter; Andrea L,0,1,20,20
1746571166419,MMW 11R,A01,892721,Herbst; Matthew,11,0,27,16
1746571166419,MMW 11R,A02,892722,Herbst; Matthew,0,0,0,3
1746571167447,MMW 12R,A01,892724,Herbst; Matthew,0,11,16,16
1746571167447,MMW 12R,A02,892725,Herbst; Matthew,0,10,16,16
1746571168478,MMW 13R,A01,892727,Staff,0,4,16,16
1746571168478,MMW 13R,A02,892728,Staff,0,4,16,16
1746571168478,MMW 13R,A03,958032,Staff,0,4,16,16
1746571168478,MMW 13R,A04,958033,Staff,0,4,16,16
1746571168478,MMW 13R,A05,958034,Staff,0,4,16,16
1746571169507,SIO 295LS,A00,894015,Staff,5,0,25,20
1746571170535,SIO 295S,A00,894020,Staff,5,0,25,20
1746571171561,SIOC 290S,B01,958918,Merrifield; Mark A,14,0,30,16
1746571172588,SIOC 291S,B01,958922,Gabriel; Corey John,14,0,30,16
1746571173612,SOCI 117,A01,895339,Staff,3,0,5,2
1746571174638,WES 237B,A00,894149,Staff,11,0,20,9
1746571176698,AESE 279B,A00,891859,Staff,13,0,35,22
1746571177727,AIP 197,001,891854,Vespa; Emanuel Ignacio,9999,0,9999,0
1746571178755,ANTH 289S,A00,891856,Gagneux; Pascal,12,0,12,0
1746571179784,BENG 196,001,957946,Engler; Adam J.,9996,0,9999,3
1746571180808,BISP 197,001,959851,Wilhelm; James E.,9998,0,9999,1
1746571181835,CAT 124RS,A01,956906,Staff,6,0,25,19
1746571182862,CAT 125RS,A01,922013,Staff,6,0,25,19
1746571183889,CLRE 250,A00,891860,Morris; Sheldon,9995,0,9999,4
1746571185940,CLRE 251R,A00,907817,Mehta; Ravindra L.,9994,0,9999,5
1746571186967,CLRE 252,A00,891864,Cuomo; Raphael Eduardo,9993,0,9999,6
1746571187994,CLRE 253,A00,891867,Vaida; Florin,9994,0,9999,5
1746571187994,CLRE 253,B00,907819,Staff,9999,0,9999,0
1746571189018,CLRE 259,A00,891868,Patel; Hemal,9998,0,9999,1
1746571190042,CLRE 260,A00,891872,Cuomo; Raphael Eduardo,9999,0,9999,0
1746571191068,CLRE 297,001,891888,Cuomo; Raphael Eduardo,9999,0,9999,0
1746571192092,CSE 191,A00,958773,Minnes Kemp; Mor Mia,9995,0,9999,4
1746571193121,CSE 197,001,959846,Minnes Kemp; Mor Mia,9990,0,9999,9
1746571194147,CSS 201S,A01,892054,Mignozzetti; Umberto,25,0,30,5
1746571195177,CSS 202S,A01,892056,Mignozzetti; Umberto,25,0,30,5
1746571196203,DSC 197,001,956898,Eldridge; Justin Matthew,9996,0,9999,3
1746571197231,DSC 297,001,958000,Mazumdar; Arya,9998,0,9999,1
1746571197231,DSC 297,002,959862,Wang; Yusu,9998,0,9999,1
1746571198256,EAP 100,A00,905686,Staff,9778,0,9999,221
1746571199287,ECE 45,A01,892618,Staff,0,0,65,65
1746571201340,ECE 111,A01,892719,Staff,5,0,65,60
1746571202369,ECE 197,001,957920,Mercier; Patrick Philip,9991,0,9999,8
1746571203399,ECON 178,A01,907814,Zhu; Ying,26,0,35,9
1746571204422,EDS 115,A00,895312,Staff,35,0,45,10
1746571205450,EDS 117,A01,895337,Staff,23,0,30,7
1746571206478,EDS 125,A00,895341,Jones; Gabrielle Anastasia,36,0,45,9
1746571207503,EDS 128A,A01,895459,Fargason; Sharon Gayle,44,0,45,1
1746571208532,EDS 128B,A01,895543,Pappas; Elizabeth,44,0,45,1
1746571209559,EDS 139,A00,897203,Pappas; Elizabeth,44,0,45,1
1746571209559,EDS 139,B00,897209,Fargason; Sharon Gayle,41,0,45,4
1746571210583,EDS 201,A00,895545,Staff,22,0,45,23
1746571211609,EDS 203,A01,895581,Halter; Christopher P.,22,0,45,23
1746571212639,EDS 204R,A01,895625,Heinzman; Erica M.,39,0,45,6
1746571212639,EDS 204R,B01,895693,Halter; Christopher P.,10,0,45,35
1746571213668,EDS 206R,A00,895694,Fargason; Sharon Gayle,1,0,30,29
1746571213668,EDS 206R,B00,895695,Choi; Bailey Miyeon,16,0,30,14
1746571214696,EDS 250,A00,895697,Hemans; Patricia Ann Benitez,22,0,45,23
1746571215722,EDS 281,A00,895701,Meyerott; Theresa Ann,1,0,15,14
1746571216750,EDS 284,A00,895736,Meyerott; Theresa Ann,1,0,15,14
1746571217775,EDS 286,A00,897210,Fine; Sarah,0,0,15,15
1746571218800,EDS 289C,A01,895770,Daly; Alan J.,1,0,15,14
1746571219825,EDS 290,A00,897211,Hofstetter; Carolyn,0,0,15,15
1746571220850,LIGM 5A,A00,896162,Fischer-Grunski; Eva K,12,0,20,8
1746571221881,LIGM 5B,A00,896260,Fischer-Grunski; Eva K,17,0,20,3
1746571222908,LIGM 5C,A00,896308,Fischer-Grunski; Eva K,18,0,20,2
1746571223934,LIIT 5AS,A00,896313,Carnelos; Chiara,18,0,20,2
1746571224959,LIIT 5BS,A00,896416,Carnelos; Chiara,20,0,20,0
1746571225988,LIIT 5CS,A00,896564,Carnelos; Chiara,20,0,20,0
1746571227017,LISP 5A,A00,896588,Munoz Sanchez; Alicia,2,0,20,18
1746571228042,LISP 5B,A00,896653,Munoz Sanchez; Alicia,7,0,20,13
1746571229068,LISP 5C,A00,896655,Munoz Sanchez; Alicia,0,1,20,20
1746571230095,MAE 197,001,957918,Kleissl; Jan,9996,0,9999,3
1746571230095,MAE 197,002,959806,Boechler; Nicholas Sebastia,9998,0,9999,1
1746571230095,MAE 197,003,959852,Mullin; Jennifer S,9998,0,9999,1
1746571231119,MATH 2,A01,957937,Staff,33,0,35,2
1746571232143,MATH 197,001,957876,Kedlaya; Kiran S.,9993,0,9999,6
1746571233174,MCWP 40,A00,892729,Duru; Nur,10,0,20,10
1746571233174,MCWP 40,B00,893304,Montejo; Carolina,14,0,20,6
1746571234198,MCWP 40R,A00,893757,Redela; Pamela Morgan,0,5,20,20
1746571235223,MCWP 50,A00,893758,Morshed; Michael James,0,0,20,20
1746571235223,MCWP 50,B00,893761,Bartulis; Jason Michael,17,0,20,3
1746571236252,MCWP 50R,A00,893766,Compas; Sean Matthew,0,1,20,20
1746571236252,MCWP 50R,B00,893769,Carter; Jennifer A,0,1,20,20
1746571236252,MCWP 50R,C00,893771,Krone; Jarret,0,3,20,20
1746571236252,MCWP 50R,D00,893772,Miller; Elizabeth Deen,0,0,20,20
1746571236252,MCWP 50R,E00,893775,Carter; Andrea L,0,1,20,20
1746571237276,MMW 11R,A01,892721,Herbst; Matthew,11,0,27,16
1746571237276,MMW 11R,A02,892722,Herbst; Matthew,0,0,0,3
1746571238304,MMW 12R,A01,892724,Herbst; Matthew,0,11,16,16
1746571238304,MMW 12R,A02,892725,Herbst; Matthew,0,10,16,16
1746571239334,MMW 13R,A01,892727,Staff,0,4,16,16
1746571239334,MMW 13R,A02,892728,Staff,0,4,16,16
1746571239334,MMW 13R,A03,958032,Staff,0,4,16,16
1746571239334,MMW 13R,A04,958033,Staff,0,4,16,16
1746571239334,MMW 13R,A05,958034,Staff,0,4,16,16
1746571240363,SIO 295LS,A00,894015,Staff,5,0,25,20
1746571241387,SIO 295S,A00,894020,Staff,5,0,25,20
1746571242417,SIOC 290S,B01,958918,Merrifield; Mark A,14,0,30,16
1746571243447,SIOC 291S,B01,958922,Gabriel; Corey John,14,0,30,16
1746571244472,SOCI 117,A01,895339,Staff,3,0,5,2
1746571245504,WES 237B,A00,894149,Staff,11,0,20,9
1746571247578,AESE 279B,A00,891859,Staff,13,0,35,22
1746571248602,AIP 197,001,891854,Vespa; Emanuel Ignacio,9999,0,9999,0
1746571249630,ANTH 289S,A00,891856,Gagneux; Pascal,12,0,12,0
1746571250659,BENG 196,001,957946,Engler; Adam J.,9996,0,9999,3
1746571251684,BISP 197,001,959851,Wilhelm; James E.,9998,0,9999,1
1746571252711,CAT 124RS,A01,956906,Staff,6,0,25,19
1746571253737,CAT 125RS,A01,922013,Staff,6,0,25,19
1746571254761,CLRE 250,A00,891860,Morris; Sheldon,9995,0,9999,4
1746571256865,CLRE 251R,A00,907817,Mehta; Ravindra L.,9994,0,9999,5
1746571257895,CLRE 252,A00,891864,Cuomo; Raphael Eduardo,9993,0,9999,6
1746571258923,CLRE 253,A00,891867,Vaida; Florin,9994,0,9999,5
1746571258923,CLRE 253,B00,907819,Staff,9999,0,9999,0
1746571259949,CLRE 259,A00,891868,Patel; Hemal,9998,0,9999,1
1746571260974,CLRE 260,A00,891872,Cuomo; Raphael Eduardo,9999,0,9999,0
1746571262001,CLRE 297,001,891888,Cuomo; Raphael Eduardo,9999,0,9999,0
1746571263029,CSE 191,A00,958773,Minnes Kemp; Mor Mia,9995,0,9999,4
1746571264054,CSE 197,001,959846,Minnes Kemp; Mor Mia,9990,0,9999,9
1746571265079,CSS 201S,A01,892054,Mignozzetti; Umberto,25,0,30,5
1746571266103,CSS 202S,A01,892056,Mignozzetti; Umberto,25,0,30,5
1746571267128,DSC 197,001,956898,Eldridge; Justin Matthew,9996,0,9999,3
1746571268154,DSC 297,001,958000,Mazumdar; Arya,9998,0,9999,1
1746571268154,DSC 297,002,959862,Wang; Yusu,9998,0,9999,1
1746571269179,EAP 100,A00,905686,Staff,9778,0,9999,221
1746571270206,ECE 45,A01,892618,Staff,0,0,65,65
1746571272256,ECE 111,A01,892719,Staff,5,0,65,60
1746571273285,ECE 197,001,957920,Mercier; Patrick Philip,9991,0,9999,8
1746571274311,ECON 178,A01,907814,Zhu; Ying,26,0,35,9
1746571275337,EDS 115,A00,895312,Staff,35,0,45,10
1746571276366,EDS 117,A01,895337,Staff,23,0,30,7
1746571277390,EDS 125,A00,895341,Jones; Gabrielle Anastasia,36,0,45,9
1746571278418,EDS 128A,A01,895459,Fargason; Sharon Gayle,44,0,45,1
1746571279448,EDS 128B,A01,895543,Pappas; Elizabeth,44,0,45,1
1746571280473,EDS 139,A00,897203,Pappas; Elizabeth,44,0,45,1
1746571280473,EDS 139,B00,897209,Fargason; Sharon Gayle,41,0,45,4
1746571281498,EDS 201,A00,895545,Staff,22,0,45,23
1746571282530,EDS 203,A01,895581,Halter; Christopher P.,22,0,45,23
1746571283554,EDS 204R,A01,895625,Heinzman; Erica M.,39,0,45,6
1746571283554,EDS 204R,B01,895693,Halter; Christopher P.,10,0,45,35
1746571284580,EDS 206R,A00,895694,Fargason; Sharon Gayle,1,0,30,29
1746571284580,EDS 206R,B00,895695,Choi; Bailey Miyeon,16,0,30,14
1746571285604,EDS 250,A00,895697,Hemans; Patricia Ann Benitez,22,0,45,23
1746571286630,EDS 281,A00,895701,Meyerott; Theresa Ann,1,0,15,14
1746571287658,EDS 284,A00,895736,Meyerott; Theresa Ann,1,0,15,14
1746571288683,EDS 286,A00,897210,Fine; Sarah,0,0,15,15
1746571289714,EDS 289C,A01,895770,Daly; Alan J.,1,0,15,14
1746571290739,EDS 290,A00,897211,Hofstetter; Carolyn,0,0,15,15
1746571291764,LIGM 5A,A00,896162,Fischer-Grunski; Eva K,12,0,20,8
1746571292793,LIGM 5B,A00,896260,Fischer-Grunski; Eva K,17,0,20,3
1746571293819,LIGM 5C,A00,896308,Fischer-Grunski; Eva K,18,0,20,2
1746571294846,LIIT 5AS,A00,896313,Carnelos; Chiara,18,0,20,2
1746571295872,LIIT 5BS,A00,896416,Carnelos; Chiara,20,0,20,0
1746571296901,LIIT 5CS,A00,896564,Carnelos; Chiara,20,0,20,0
1746571297926,LISP 5A,A00,896588,Munoz Sanchez; Alicia,2,0,20,18
1746571298956,LISP 5B,A00,896653,Munoz Sanchez; Alicia,7,0,20,13
1746571299986,LISP 5C,A00,896655,Munoz Sanchez; Alicia,0,1,20,20
1746571301011,MAE 197,001,957918,Kleissl; Jan,9996,0,9999,3
1746571301011,MAE 197,002,959806,Boechler; Nicholas Sebastia,9998,0,9999,1
1746571301011,MAE 197,003,959852,Mullin; Jennifer S,9998,0,9999,1
1746571302036,MATH 2,A01,957937,Staff,33,0,35,2
1746571303061,MATH 197,001,957876,Kedlaya; Kiran S.,9993,0,9999,6
1746571304086,MCWP 40,A00,892729,Duru; Nur,10,0,20,10
1746571304086,MCWP 40,B00,893304,Montejo; Carolina,14,0,20,6
1746571305115,MCWP 40R,A00,893757,Redela; Pamela Morgan,0,5,20,20
1746571306143,MCWP 50,A00,893758,Morshed; Michael James,0,0,20,20
1746571306143,MCWP 50,B00,893761,Bartulis; Jason Michael,17,0,20,3
1746571307168,MCWP 50R,A00,893766,Compas; Sean Matthew,0,1,20,20
1746571307168,MCWP 50R,B00,893769,Carter; Jennifer A,0,1,20,20
1746571307168,MCWP 50R,C00,893771,Krone; Jarret,0,3,20,20
1746571307168,MCWP 50R,D00,893772,Miller; Elizabeth Deen,0,0,20,20
1746571307168,MCWP 50R,E00,893775,Carter; Andrea L,0,1,20,20
1746571308209,MMW 11R,A01,892721,Herbst; Matthew,11,0,27,16
1746571308209,MMW 11R,A02,892722,Herbst; Matthew,0,0,0,3
1746571309232,MMW 12R,A01,892724,Herbst; Matthew,0,11,16,16
1746571309232,MMW 12R,A02,892725,Herbst; Matthew,0,10,16,16
1746571310257,MMW 13R,A01,892727,Staff,0,4,16,16
1746571310257,MMW 13R,A02,892728,Staff,0,4,16,16
1746571310257,MMW 13R,A03,958032,Staff,0,4,16,16
1746571310257,MMW 13R,A04,958033,Staff,0,4,16,16
1746571310257,MMW 13R,A05,958034,Staff,0,4,16,16
1746571311283,SIO 295LS,A00,894015,Staff,5,0,25,20
1746571312309,SIO 295S,A00,894020,Staff,5,0,25,20
1746571313336,SIOC 290S,B01,958918,Merrifield; Mark A,14,0,30,16
1746571314362,SIOC 291S,B01,958922,Gabriel; Corey John,14,0,30,16
1746571315404,SOCI 117,A01,895339,Staff,3,0,5,2
1746571316431,WES 237B,A00,894149,Staff,11,0,20,9
1746571318491,AESE 279B,A00,891859,Staff,13,0,35,22
1746571319519,AIP 197,001,891854,Vespa; Emanuel Ignacio,9999,0,9999,0
1746571320543,ANTH 289S,A00,891856,Gagneux; Pascal,12,0,12,0
1746571321568,BENG 196,001,957946,Engler; Adam J.,9996,0,9999,3
1746571322592,BISP 197,001,959851,Wilhelm; James E.,9998,0,9999,1
1746571323618,CAT 124RS,A01,956906,Staff,6,0,25,19
1746571324644,CAT 125RS,A01,922013,Staff,6,0,25,19
1746571325673,CLRE 250,A00,891860,Morris; Sheldon,9995,0,9999,4
1746571327727,CLRE 251R,A00,907817,Mehta; Ravindra L.,9994,0,9999,5
1746571328755,CLRE 252,A00,891864,Cuomo; Raphael Eduardo,9993,0,9999,6
1746571329779,CLRE 253,A00,891867,Vaida; Florin,9994,0,9999,5
1746571329779,CLRE 253,B00,907819,Staff,9999,0,9999,0
1746571330805,CLRE 259,A00,891868,Patel; Hemal,9998,0,9999,1
1746571331845,CLRE 260,A00,891872,Cuomo; Raphael Eduardo,9999,0,9999,0
1746571332869,CLRE 297,001,891888,Cuomo; Raphael Eduardo,9999,0,9999,0
1746571333896,CSE 191,A00,958773,Minnes Kemp; Mor Mia,9995,0,9999,4
1746571334922,CSE 197,001,959846,Minnes Kemp; Mor Mia,9990,0,9999,9
1746571335949,CSS 201S,A01,892054,Mignozzetti; Umberto,25,0,30,5
1746571336974,CSS 202S,A01,892056,Mignozzetti; Umberto,25,0,30,5
1746571337999,DSC 197,001,956898,Eldridge; Justin Matthew,9996,0,9999,3
1746571339026,DSC 297,001,958000,Mazumdar; Arya,9998,0,9999,1
1746571339026,DSC 297,002,959862,Wang; Yusu,9998,0,9999,1
1746571340053,EAP 100,A00,905686,Staff,9778,0,9999,221
1746571341080,ECE 45,A01,892618,Staff,0,0,65,65
1746571343131,ECE 111,A01,892719,Staff,5,0,65,60
1746571344155,ECE 197,001,957920,Mercier; Patrick Philip,9991,0,9999,8
1746571345182,ECON 178,A01,907814,Zhu; Ying,26,0,35,9
1746571346206,EDS 115,A00,895312,Staff,35,0,45,10
1746571347235,EDS 117,A01,895337,Staff,23,0,30,7
1746571348264,EDS 125,A00,895341,Jones; Gabrielle Anastasia,36,0,45,9
1746571349293,EDS 128A,A01,895459,Fargason; Sharon Gayle,44,0,45,1
1746571350318,EDS 128B,A01,895543,Pappas; Elizabeth,44,0,45,1
1746571351345,EDS 139,A00,897203,Pappas; Elizabeth,44,0,45,1
1746571351345,EDS 139,B00,897209,Fargason; Sharon Gayle,41,0,45,4
1746571352396,EDS 201,A00,895545,Staff,22,0,45,23
1746571353423,EDS 203,A01,895581,Halter; Christopher P.,22,0,45,23
1746571354449,EDS 204R,A01,895625,Heinzman; Erica M.,39,0,45,6
1746571354449,EDS 204R,B01,895693,Halter; Christopher P.,10,0,45,35
1746571355478,EDS 206R,A00,895694,Fargason; Sharon Gayle,1,0,30,29
1746571355478,EDS 206R,B00,895695,Choi; Bailey Miyeon,16,0,30,14
1746571356507,EDS 250,A00,895697,Hemans; Patricia Ann Benitez,22,0,45,23
1746571357534,EDS 281,A00,895701,Meyerott; Theresa Ann,1,0,15,14
1746571358561,EDS 284,A00,895736,Meyerott; Theresa Ann,1,0,15,14
1746571359587,EDS 286,A00,897210,Fine; Sarah,0,0,15,15
1746571360612,EDS 289C,A01,895770,Daly; Alan J.,1,0,15,14
1746571361637,EDS 290,A00,897211,Hofstetter; Carolyn,0,0,15,15
1746571362666,LIGM 5A,A00,896162,Fischer-Grunski; Eva K,12,0,20,8
1746571363691,LIGM 5B,A00,896260,Fischer-Grunski; Eva K,17,0,20,3
1746571364720,LIGM 5C,A00,896308,Fischer-Grunski; Eva K,18,0,20,2
1746571365745,LIIT 5AS,A00,896313,Carnelos; Chiara,18,0,20,2
1746571366770,LIIT 5BS,A00,896416,Carnelos; Chiara,20,0,20,0
1746571367795,LIIT 5CS,A00,896564,Carnelos; Chiara,20,0,20,0
1746571368820,LISP 5A,A00,896588,Munoz Sanchez; Alicia,2,0,20,18
1746571369846,LISP 5B,A00,896653,Munoz Sanchez; Alicia,7,0,20,13
1746571370871,LISP 5C,A00,896655,Munoz Sanchez; Alicia,0,1,20,20
1746571371895,MAE 197,001,957918,Kleissl; Jan,9996,0,9999,3
1746571371895,MAE 197,002,959806,Boechler; Nicholas Sebastia,9998,0,9999,1
1746571371895,MAE 197,003,959852,Mullin; Jennifer S,9998,0,9999,1
1746571372919,MATH 2,A01,957937,Staff,33,0,35,2
1746571373943,MATH 197,001,957876,Kedlaya; Kiran S.,9993,0,9999,6
1746571374971,MCWP 40,A00,892729,Duru; Nur,10,0,20,10
1746571374971,MCWP 40,B00,893304,Montejo; Carolina,14,0,20,6
1746571375994,MCWP 40R,A00,893757,Redela; Pamela Morgan,0,5,20,20
1746571377022,MCWP 50,A00,893758,Morshed; Michael James,0,0,20,20
1746571377022,MCWP 50,B00,893761,Bartulis; Jason Michael,17,0,20,3
1746571378051,MCWP 50R,A00,893766,Compas; Sean Matthew,0,1,20,20
1746571378051,MCWP 50R,B00,893769,Carter; Jennifer A,0,1,20,20
1746571378051,MCWP 50R,C00,893771,Krone; Jarret,0,3,20,20
1746571378051,MCWP 50R,D00,893772,Miller; Elizabeth Deen,0,0,20,20
1746571378051,MCWP 50R,E00,893775,Carter; Andrea L,0,1,20,20
1746571379076,MMW 11R,A01,892721,Herbst; Matthew,11,0,27,16
1746571379076,MMW 11R,A02,892722,Herbst; Matthew,0,0,0,3
1746571380128,MMW 12R,A01,892724,Herbst; Matthew,0,11,16,16
1746571380128,MMW 12R,A02,892725,Herbst; Matthew,0,10,16,16
1746571381155,MMW 13R,A01,892727,Staff,0,4,16,16
1746571381155,MMW 13R,A02,892728,Staff,0,4,16,16
1746571381155,MMW 13R,A03,958032,Staff,0,4,16,16
1746571381155,MMW 13R,A04,958033,Staff,0,4,16,16
1746571381155,MMW 13R,A05,958034,Staff,0,4,16,16
1746571382180,SIO 295LS,A00,894015,Staff,5,0,25,20
1746571383205,SIO 295S,A00,894020,Staff,5,0,25,20
1746571384230,SIOC 290S,B01,958918,Merrifield; Mark A,14,0,30,16
1746571385256,SIOC 291S,B01,958922,Gabriel; Corey John,14,0,30,16
1746571386281,SOCI 117,A01,895339,Staff,3,0,5,2
1746571387304,WES 237B,A00,894149,Staff,11,0,20,9
1746571389358,AESE 279B,A00,891859,Staff,13,0,35,22
1746571390384,AIP 197,001,891854,Vespa; Emanuel Ignacio,9999,0,9999,0
1746571391408,ANTH 289S,A00,891856,Gagneux; Pascal,12,0,12,0
1746571392436,BENG 196,001,957946,Engler; Adam J.,9996,0,9999,3
1746571393463,BISP 197,001,959851,Wilhelm; James E.,9998,0,9999,1
1746571394490,CAT 124RS,A01,956906,Staff,6,0,25,19
1746571395515,CAT 125RS,A01,922013,Staff,6,0,25,19
1746571396544,CLRE 250,A00,891860,Morris; Sheldon,9995,0,9999,4
1746571398600,CLRE 251R,A00,907817,Mehta; Ravindra L.,9994,0,9999,5
1746571399627,CLRE 252,A00,891864,Cuomo; Raphael Eduardo,9993,0,9999,6
1746571400653,CLRE 253,A00,891867,Vaida; Florin,9994,0,9999,5
1746571400653,CLRE 253,B00,907819,Staff,9999,0,9999,0
1746571401682,CLRE 259,A00,891868,Patel; Hemal,9998,0,9999,1
1746571402709,CLRE 260,A00,891872,Cuomo; Raphael Eduardo,9999,0,9999,0
1746571403734,CLRE 297,001,891888,Cuomo; Raphael Eduardo,9999,0,9999,0
1746571404759,CSE 191,A00,958773,Minnes Kemp; Mor Mia,9995,0,9999,4
1746571405785,CSE 197,001,959846,Minnes Kemp; Mor Mia,9990,0,9999,9
1746571406809,CSS 201S,A01,892054,Mignozzetti; Umberto,25,0,30,5
1746571407839,CSS 202S,A01,892056,Mignozzetti; Umberto,25,0,30,5
1746571408863,DSC 197,001,956898,Eldridge; Justin Matthew,9996,0,9999,3
1746571409887,DSC 297,001,958000,Mazumdar; Arya,9998,0,9999,1
1746571409887,DSC 297,002,959862,Wang; Yusu,9998,0,9999,1
1746571410911,EAP 100,A00,905686,Staff,9778,0,9999,221
1746571411940,ECE 45,A01,892618,Staff,0,0,65,65
1746571413989,ECE 111,A01,892719,Staff,5,0,65,60
1746571415014,ECE 197,001,957920,Mercier; Patrick Philip,9991,0,9999,8
1746571416040,ECON 178,A01,907814,Zhu; Ying,26,0,35,9
1746571417065,EDS 115,A00,895312,Staff,35,0,45,10
1746571418095,EDS 117,A01,895337,Staff,23,0,30,7
1746571419123,EDS 125,A00,895341,Jones; Gabrielle Anastasia,36,0,45,9
1746571420152,EDS 128A,A01,895459,Fargason; Sharon Gayle,44,0,45,1
1746571421177,EDS 128B,A01,895543,Pappas; Elizabeth,44,0,45,1
1746571422202,EDS 139,A00,897203,Pappas; Elizabeth,44,0,45,1
1746571422202,EDS 139,B00,897209,Fargason; Sharon Gayle,41,0,45,4
1746571423230,EDS 201,A00,895545,Staff,22,0,45,23
1746571424255,EDS 203,A01,895581,Halter; Christopher P.,22,0,45,23
1746571425282,EDS 204R,A01,895625,Heinzman; Erica M.,39,0,45,6
1746571425282,EDS 204R,B01,895693,Halter; Christopher P.,10,0,45,35
1746571426310,EDS 206R,A00,895694,Fargason; Sharon Gayle,1,0,30,29
1746571426310,EDS 206R,B00,895695,Choi; Bailey Miyeon,16,0,30,14
1746571427336,EDS 250,A00,895697,Hemans; Patricia Ann Benitez,22,0,45,23
1746571428362,EDS 281,A00,895701,Meyerott; Theresa Ann,1,0,15,14
1746571429389,EDS 284,A00,895736,Meyerott; Theresa Ann,1,0,15,14
1746571430472,EDS 286,A00,897210,Fine; Sarah,0,0,15,15
1746571431496,EDS 289C,A01,895770,Daly; Alan J.,1,0,15,14
1746571432524,EDS 290,A00,897211,Hofstetter; Carolyn,0,0,15,15
1746571433550,LIGM 5A,A00,896162,Fischer-Grunski; Eva K,12,0,20,8
1746571434579,LIGM 5B,A00,896260,Fischer-Grunski; Eva K,17,0,20,3
1746571435607,LIGM 5C,A00,896308,Fischer-Grunski; Eva K,18,0,20,2
1746571436634,LIIT 5AS,A00,896313,Carnelos; Chiara,18,0,20,2
1746571437660,LIIT 5BS,A00,896416,Carnelos; Chiara,20,0,20,0
1746571438684,LIIT 5CS,A00,896564,Carnelos; Chiara,20,0,20,0
1746571439711,LISP 5A,A00,896588,Munoz Sanchez; Alicia,2,0,20,18
1746571440740,LISP 5B,A00,896653,Munoz Sanchez; Alicia,7,0,20,13
1746571441766,LISP 5C,A00,896655,Munoz Sanchez; Alicia,0,1,20,20
1746571442795,MAE 197,001,957918,Kleissl; Jan,9996,0,9999,3
1746571442795,MAE 197,002,959806,Boechler; Nicholas Sebastia,9998,0,9999,1
1746571442795,MAE 197,003,959852,Mullin; Jennifer S,9998,0,9999,1
1746571443819,MATH 2,A01,957937,Staff,33,0,35,2
1746571444844,MATH 197,001,957876,Kedlaya; Kiran S.,9993,0,9999,6
1746571445873,MCWP 40,A00,892729,Duru; Nur,10,0,20,10
1746571445873,MCWP 40,B00,893304,Montejo; Carolina,14,0,20,6
1746571446900,MCWP 40R,A00,893757,Redela; Pamela Morgan,0,5,20,20
1746571447926,MCWP 50,A00,893758,Morshed; Michael James,0,0,20,20
1746571447926,MCWP 50,B00,893761,Bartulis; Jason Michael,17,0,20,3
1746571448955,MCWP 50R,A00,893766,Compas; Sean Matthew,0,1,20,20
1746571448955,MCWP 50R,B00,893769,Carter; Jennifer A,0,1,20,20
1746571448955,MCWP 50R,C00,893771,Krone; Jarret,0,3,20,20
1746571448955,MCWP 50R,D00,893772,Miller; Elizabeth Deen,0,0,20,20
1746571448955,MCWP 50R,E00,893775,Carter; Andrea L,0,1,20,20
1746571449981,MMW 11R,A01,892721,Herbst; Matthew,11,0,27,16
1746571449981,MMW 11R,A02,892722,Herbst; Matthew,0,0,0,3
1746571451009,MMW 12R,A01,892724,Herbst; Matthew,0,11,16,16
1746571451009,MMW 12R,A02,892725,Herbst; Matthew,0,10,16,16
1746571452034,MMW 13R,A01,892727,Staff,0,4,16,16
1746571452034,MMW 13R,A02,892728,Staff,0,4,16,16
1746571452034,MMW 13R,A03,958032,Staff,0,4,16,16
1746571452034,MMW 13R,A04,958033,Staff,0,4,16,16
1746571452034,MMW 13R,A05,958034,Staff,0,4,16,16
1746571453061,SIO 295LS,A00,894015,Staff,5,0,25,20
1746571454089,SIO 295S,A00,894020,Staff,5,0,25,20
1746571455119,SIOC 290S,B01,958918,Merrifield; Mark A,14,0,30,16
1746571456145,SIOC 291S,B01,958922,Gabriel; Corey John,14,0,30,16
1746571457174,SOCI 117,A01,895339,Staff,3,0,5,2
1746571458200,WES 237B,A00,894149,Staff,11,0,20,9
1746571460260,AESE 279B,A00,891859,Staff,13,0,35,22
1746571461285,AIP 197,001,891854,Vespa; Emanuel Ignacio,9999,0,9999,0
1746571462311,ANTH 289S,A00,891856,Gagneux; Pascal,12,0,12,0
1746571463337,BENG 196,001,957946,Engler; Adam J.,9996,0,9999,3
1746571464362,BISP 197,001,959851,Wilhelm; James E.,9998,0,9999,1
1746571465390,CAT 124RS,A01,956906,Staff,6,0,25,19
1746571466413,CAT 125RS,A01,922013,Staff,6,0,25,19
1746571467438,CLRE 250,A00,891860,Morris; Sheldon,9995,0,9999,4
1746571469492,CLRE 251R,A00,907817,Mehta; Ravindra L.,9994,0,9999,5
1746571470519,CLRE 252,A00,891864,Cuomo; Raphael Eduardo,9993,0,9999,6
1746571471545,CLRE 253,A00,891867,Vaida; Florin,9994,0,9999,5
1746571471545,CLRE 253,B00,907819,Staff,9999,0,9999,0
1746571472575,CLRE 259,A00,891868,Patel; Hemal,9998,0,9999,1
1746571473600,CLRE 260,A00,891872,Cuomo; Raphael Eduardo,9999,0,9999,0
1746571474625,CLRE 297,001,891888,Cuomo; Raphael Eduardo,9999,0,9999,0
1746571475654,CSE 191,A00,958773,Minnes Kemp; Mor Mia,9995,0,9999,4
1746571476680,CSE 197,001,959846,Minnes Kemp; Mor Mia,9990,0,9999,9
1746571477706,CSS 201S,A01,892054,Mignozzetti; Umberto,25,0,30,5
1746571478736,CSS 202S,A01,892056,Mignozzetti; Umberto,25,0,30,5
1746571479763,DSC 197,001,956898,Eldridge; Justin Matthew,9996,0,9999,3
1746571480788,DSC 297,001,958000,Mazumdar; Arya,9998,0,9999,1
1746571480788,DSC 297,002,959862,Wang; Yusu,9998,0,9999,1
1746571481817,EAP 100,A00,905686,Staff,9778,0,9999,221
1746571482843,ECE 45,A01,892618,Staff,0,0,65,65
1746571484895,ECE 111,A01,892719,Staff,5,0,65,60
1746571485920,ECE 197,001,957920,Mercier; Patrick Philip,9991,0,9999,8
1746571486947,ECON 178,A01,907814,Zhu; Ying,26,0,35,9
1746571487975,EDS 115,A00,895312,Staff,35,0,45,10
1746571489001,EDS 117,A01,895337,Staff,23,0,30,7
1746571490025,EDS 125,A00,895341,Jones; Gabrielle Anastasia,36,0,45,9
1746571491055,EDS 128A,A01,895459,Fargason; Sharon Gayle,44,0,45,1
1746571492080,EDS 128B,A01,895543,Pappas; Elizabeth,44,0,45,1
1746571493108,EDS 139,A00,897203,Pappas; Elizabeth,44,0,45,1
1746571493108,EDS 139,B00,897209,Fargason; Sharon Gayle,41,0,45,4
1746571494133,EDS 201,A00,895545,Staff,22,0,45,23
1746571495158,EDS 203,A01,895581,Halter; Christopher P.,22,0,45,23
1746571496182,EDS 204R,A01,895625,Heinzman; Erica M.,39,0,45,6
1746571496182,EDS 204R,B01,895693,Halter; Christopher P.,10,0,45,35
1746571497208,EDS 206R,A00,895694,Fargason; Sharon Gayle,1,0,30,29
1746571497208,EDS 206R,B00,895695,Choi; Bailey Miyeon,16,0,30,14
1746571498233,EDS 250,A00,895697,Hemans; Patricia Ann Benitez,22,0,45,23
1746571499261,EDS 281,A00,895701,Meyerott; Theresa Ann,1,0,15,14
1746571500289,EDS 284,A00,895736,Meyerott; Theresa Ann,1,0,15,14
1746571501317,EDS 286,A00,897210,Fine; Sarah,0,0,15,15
1746571502349,EDS 289C,A01,895770,Daly; Alan J.,1,0,15,14
1746571503377,EDS 290,A00,897211,Hofstetter; Carolyn,0,0,15,15
1746571504404,LIGM 5A,A00,896162,Fischer-Grunski; Eva K,12,0,20,8
1746571505429,LIGM 5B,A00,896260,Fischer-Grunski; Eva K,17,0,20,3
1746571506454,LIGM 5C,A00,896308,Fischer-Grunski; Eva K,18,0,20,2
1746571507479,LIIT 5AS,A00,896313,Carnelos; Chiara,18,0,20,2
1746571508506,LIIT 5BS,A00,896416,Carnelos; Chiara,20,0,20,0
1746571509534,LIIT 5CS,A00,896564,Carnelos; Chiara,20,0,20,0
1746571510561,LISP 5A,A00,896588,Munoz Sanchez; Alicia,2,0,20,18
1746571511588,LISP 5B,A00,896653,Munoz Sanchez; Alicia,7,0,20,13
1746571512613,LISP 5C,A00,896655,Munoz Sanchez; Alicia,0,1,20,20
1746571513638,MAE 197,001,957918,Kleissl; Jan,9996,0,9999,3
1746571513638,MAE 197,002,959806,Boechler; Nicholas Sebastia,9998,0,9999,1
1746571513638,MAE 197,003,959852,Mullin; Jennifer S,9998,0,9999,1
1746571514663,MATH 2,A01,957937,Staff,33,0,35,2
1746571515689,MATH 197,001,957876,Kedlaya; Kiran S.,9993,0,9999,6
1746571516714,MCWP 40,A00,892729,Duru; Nur,10,0,20,10
1746571516714,MCWP 40,B00,893304,Montejo; Carolina,14,0,20,6
1746571517741,MCWP 40R,A00,893757,Redela; Pamela Morgan,0,5,20,20
1746571518767,MCWP 50,A00,893758,Morshed; Michael James,0,0,20,20
1746571518767,MCWP 50,B00,893761,Bartulis; Jason Michael,17,0,20,3
1746571519791,MCWP 50R,A00,893766,Compas; Sean Matthew,0,1,20,20
1746571519791,MCWP 50R,B00,893769,Carter; Jennifer A,0,1,20,20
1746571519791,MCWP 50R,C00,893771,Krone; Jarret,0,3,20,20
1746571519791,MCWP 50R,D00,893772,Miller; Elizabeth Deen,0,0,20,20
1746571519791,MCWP 50R,E00,893775,Carter; Andrea L,0,1,20,20
1746571520818,MMW 11R,A01,892721,Herbst; Matthew,11,0,27,16
1746571520818,MMW 11R,A02,892722,Herbst; Matthew,0,0,0,3
1746571521844,MMW 12R,A01,892724,Herbst; Matthew,0,11,16,16
1746571521844,MMW 12R,A02,892725,Herbst; Matthew,0,10,16,16
1746571522870,MMW 13R,A01,892727,Staff,0,4,16,16
1746571522870,MMW 13R,A02,892728,Staff,0,4,16,16
1746571522870,MMW 13R,A03,958032,Staff,0,4,16,16
1746571522870,MMW 13R,A04,958033,Staff,0,4,16,16
1746571522870,MMW 13R,A05,958034,Staff,0,4,16,16
1746571523897,SIO 295LS,A00,894015,Staff,5,0,25,20
1746571524924,SIO 295S,A00,894020,Staff,5,0,25,20
1746571525948,SIOC 290S,B01,958918,Merrifield; Mark A,14,0,30,16
1746571526978,SIOC 291S,B01,958922,Gabriel; Corey John,14,0,30,16
1746571528002,SOCI 117,A01,895339,Staff,3,0,5,2
1746571529028,WES 237B,A00,894149,Staff,11,0,20,9
1746571531096,AESE 279B,A00,891859,Staff,13,0,35,22
1746571532124,AIP 197,001,891854,Vespa; Emanuel Ignacio,9999,0,9999,0
1746571533149,ANTH 289S,A00,891856,Gagneux; Pascal,12,0,12,0
1746571534176,BENG 196,001,957946,Engler; Adam J.,9996,0,9999,3
1746571535203,BISP 197,001,959851,Wilhelm; James E.,9998,0,9999,1
1746571536228,CAT 124RS,A01,956906,Staff,6,0,25,19
1746571537252,CAT 125RS,A01,922013,Staff,6,0,25,19
1746571538278,CLRE 250,A00,891860,Morris; Sheldon,9995,0,9999,4
1746571540330,CLRE 251R,A00,907817,Mehta; Ravindra L.,9994,0,9999,5
1746571541429,CLRE 252,A00,891864,Cuomo; Raphael Eduardo,9993,0,9999,6
1746571542458,CLRE 253,A00,891867,Vaida; Florin,9994,0,9999,5
1746571542458,CLRE 253,B00,907819,Staff,9999,0,9999,0
1746571543483,CLRE 259,A00,891868,Patel; Hemal,9998,0,9999,1
1746571544510,CLRE 260,A00,891872,Cuomo; Raphael Eduardo,9999,0,9999,0
1746571545534,CLRE 297,001,891888,Cuomo; Raphael Eduardo,9999,0,9999,0
1746571546559,CSE 191,A00,958773,Minnes Kemp; Mor Mia,9995,0,9999,4
1746571547586,CSE 197,001,959846,Minnes Kemp; Mor Mia,9990,0,9999,9
1746571548611,CSS 201S,A01,892054,Mignozzetti; Umberto,25,0,30,5
1746571549636,CSS 202S,A01,892056,Mignozzetti; Umberto,25,0,30,5
1746571550662,DSC 197,001,956898,Eldridge; Justin Matthew,9996,0,9999,3
1746571551686,DSC 297,001,958000,Mazumdar; Arya,9998,0,9999,1
1746571551686,DSC 297,002,959862,Wang; Yusu,9998,0,9999,1
1746571552711,EAP 100,A00,905686,Staff,9778,0,9999,221
1746571553741,ECE 45,A01,892618,Staff,0,0,65,65
1746571555791,ECE 111,A01,892719,Staff,5,0,65,60
1746571556819,ECE 197,001,957920,Mercier; Patrick Philip,9991,0,9999,8
1746571557847,ECON 178,A01,907814,Zhu; Ying,26,0,35,9
1746571558872,EDS 115,A00,895312,Staff,35,0,45,10
1746571559900,EDS 117,A01,895337,Staff,23,0,30,7
1746571560926,EDS 125,A00,895341,Jones; Gabrielle Anastasia,36,0,45,9
1746571561950,EDS 128A,A01,895459,Fargason; Sharon Gayle,44,0,45,1
1746571562975,EDS 128B,A01,895543,Pappas; Elizabeth,44,0,45,1
1746571564002,EDS 139,A00,897203,Pappas; Elizabeth,44,0,45,1
1746571564002,EDS 139,B00,897209,Fargason; Sharon Gayle,41,0,45,4
1746571565031,EDS 201,A00,895545,Staff,22,0,45,23
1746571566057,EDS 203,A01,895581,Halter; Christopher P.,22,0,45,23
1746571567085,EDS 204R,A01,895625,Heinzman; Erica M.,39,0,45,6
1746571567085,EDS 204R,B01,895693,Halter; Christopher P.,10,0,45,35
1746571568110,EDS 206R,A00,895694,Fargason; Sharon Gayle,1,0,30,29
1746571568110,EDS 206R,B00,895695,Choi; Bailey Miyeon,16,0,30,14
1746571569139,EDS 250,A00,895697,Hemans; Patricia Ann Benitez,22,0,45,23
1746571570168,EDS 281,A00,895701,Meyerott; Theresa Ann,1,0,15,14
1746571571192,EDS 284,A00,895736,Meyerott; Theresa Ann,1,0,15,14
1746571572218,EDS 286,A00,897210,Fine; Sarah,0,0,15,15
1746571573244,EDS 289C,A01,895770,Daly; Alan J.,1,0,15,14
1746571574268,EDS 290,A00,897211,Hofstetter; Carolyn,0,0,15,15
1746571575297,LIGM 5A,A00,896162,Fischer-Grunski; Eva K,12,0,20,8
1746571576322,LIGM 5B,A00,896260,Fischer-Grunski; Eva K,17,0,20,3
1746571577347,LIGM 5C,A00,896308,Fischer-Grunski; Eva K,18,0,20,2
1746571578372,LIIT 5AS,A00,896313,Carnelos; Chiara,18,0,20,2
1746571579401,LIIT 5BS,A00,896416,Carnelos; Chiara,20,0,20,0
1746571580425,LIIT 5CS,A00,896564,Carnelos; Chiara,20,0,20,0
1746571581452,LISP 5A,A00,896588,Munoz Sanchez; Alicia,2,0,20,18
1746571582478,LISP 5B,A00,896653,Munoz Sanchez; Alicia,7,0,20,13
1746571583507,LISP 5C,A00,896655,Munoz Sanchez; Alicia,0,1,20,20
1746571584536,MAE 197,001,957918,Kleissl; Jan,9996,0,9999,3
1746571584536,MAE 197,002,959806,Boechler; Nicholas Sebastia,9998,0,9999,1
1746571584536,MAE 197,003,959852,Mullin; Jennifer S,9998,0,9999,1
1746571585561,MATH 2,A01,957937,Staff,33,0,35,2
1746571586589,MATH 197,001,957876,Kedlaya; Kiran S.,9993,0,9999,6
1746571587615,MCWP 40,A00,892729,Duru; Nur,10,0,20,10
1746571587615,MCWP 40,B00,893304,Montejo; Carolina,14,0,20,6
1746571588641,MCWP 40R,A00,893757,Redela; Pamela Morgan,0,5,20,20
1746571589667,MCWP 50,A00,893758,Morshed; Michael James,0,0,20,20
1746571589667,MCWP 50,B00,893761,Bartulis; Jason Michael,17,0,20,3
1746571590693,MCWP 50R,A00,893766,Compas; Sean Matthew,0,1,20,20
1746571590693,MCWP 50R,B00,893769,Carter; Jennifer A,0,1,20,20
1746571590693,MCWP 50R,C00,893771,Krone; Jarret,0,3,20,20
1746571590693,MCWP 50R,D00,893772,Miller; Elizabeth Deen,0,0,20,20
1746571590693,MCWP 50R,E00,893775,Carter; Andrea L,0,1,20,20
1746571591720,MMW 11R,A01,892721,Herbst; Matthew,11,0,27,16
1746571591720,MMW 11R,A02,892722,Herbst; Matthew,0,0,0,3
1746571592745,MMW 12R,A01,892724,Herbst; Matthew,0,11,16,16
1746571592745,MMW 12R,A02,892725,Herbst; Matthew,0,10,16,16
1746571593773,MMW 13R,A01,892727,Staff,0,4,16,16
1746571593773,MMW 13R,A02,892728,Staff,0,4,16,16
1746571593773,MMW 13R,A03,958032,Staff,0,4,16,16
1746571593773,MMW 13R,A04,958033,Staff,0,4,16,16
1746571593773,MMW 13R,A05,958034,Staff,0,4,16,16
1746571594799,SIO 295LS,A00,894015,Staff,5,0,25,20
1746571595825,SIO 295S,A00,894020,Staff,5,0,25,20
1746571596850,SIOC 290S,B01,958918,Merrifield; Mark A,14,0,30,16
1746571597880,SIOC 291S,B01,958922,Gabriel; Corey John,14,0,30,16
1746571598909,SOCI 117,A01,895339,Staff,3,0,5,2
1746571599935,WES 237B,A00,894149,Staff,11,0,20,9
1746571601999,AESE 279B,A00,891859,Staff,13,0,35,22
1746571603037,AIP 197,001,891854,Vespa; Emanuel Ignacio,9999,0,9999,0
1746571604063,ANTH 289S,A00,891856,Gagneux; Pascal,12,0,12,0
1746571605089,BENG 196,001,957946,Engler; Adam J.,9996,0,9999,3
1746571606117,BISP 197,001,959851,Wilhelm; James E.,9998,0,9999,1
1746571607146,CAT 124RS,A01,956906,Staff,6,0,25,19
1746571608172,CAT 125RS,A01,922013,Staff,6,0,25,19
1746571609197,CLRE 250,A00,891860,Morris; Sheldon,9995,0,9999,4
1746571611250,CLRE 251R,A00,907817,Mehta; Ravindra L.,9994,0,9999,5
1746571612274,CLRE 252,A00,891864,Cuomo; Raphael Eduardo,9993,0,9999,6
1746571613300,CLRE 253,A00,891867,Vaida; Florin,9994,0,9999,5
1746571613300,CLRE 253,B00,907819,Staff,9999,0,9999,0
1746571614325,CLRE 259,A00,891868,Patel; Hemal,9998,0,9999,1
1746571615348,CLRE 260,A00,891872,Cuomo; Raphael Eduardo,9999,0,9999,0
1746571616373,CLRE 297,001,891888,Cuomo; Raphael Eduardo,9999,0,9999,0
1746571617400,CSE 191,A00,958773,Minnes Kemp; Mor Mia,9995,0,9999,4
1746571618427,CSE 197,001,959846,Minnes Kemp; Mor Mia,9990,0,9999,9
1746571619453,CSS 201S,A01,892054,Mignozzetti; Umberto,25,0,30,5
1746571620483,CSS 202S,A01,892056,Mignozzetti; Umberto,25,0,30,5
1746571621507,DSC 197,001,956898,Eldridge; Justin Matthew,9996,0,9999,3
1746571622535,DSC 297,001,958000,Mazumdar; Arya,9998,0,9999,1
1746571622535,DSC 297,002,959862,Wang; Yusu,9998,0,9999,1
1746571623562,EAP 100,A00,905686,Staff,9778,0,9999,221
1746571624589,ECE 45,A01,892618,Staff,0,0,65,65
1746571626640,ECE 111,A01,892719,Staff,5,0,65,60
1746571627666,ECE 197,001,957920,Mercier; Patrick Philip,9991,0,9999,8
1746571628695,ECON 178,A01,907814,Zhu; Ying,26,0,35,9
1746571629719,EDS 115,A00,895312,Staff,35,0,45,10
1746571630748,EDS 117,A01,895337,Staff,23,0,30,7
1746571631777,EDS 125,A00,895341,Jones; Gabrielle Anastasia,36,0,45,9
1746571632801,EDS 128A,A01,895459,Fargason; Sharon Gayle,44,0,45,1
1746571633827,EDS 128B,A01,895543,Pappas; Elizabeth,44,0,45,1
1746571634857,EDS 139,A00,897203,Pappas; Elizabeth,44,0,45,1
1746571634857,EDS 139,B00,897209,Fargason; Sharon Gayle,41,0,45,4
1746571635883,EDS 201,A00,895545,Staff,22,0,45,23
1746571636913,EDS 203,A01,895581,Halter; Christopher P.,22,0,45,23
1746571637938,EDS 204R,A01,895625,Heinzman; Erica M.,39,0,45,6
1746571637938,EDS 204R,B01,895693,Halter; Christopher P.,10,0,45,35
1746571638964,EDS 206R,A00,895694,Fargason; Sharon Gayle,1,0,30,29
1746571638964,EDS 206R,B00,895695,Choi; Bailey Miyeon,16,0,30,14
1746571639991,EDS 250,A00,895697,Hemans; Patricia Ann Benitez,22,0,45,23
1746571641020,EDS 281,A00,895701,Meyerott; Theresa Ann,1,0,15,14
1746571642044,EDS 284,A00,895736,Meyerott; Theresa Ann,1,0,15,14
1746571643069,EDS 286,A00,897210,Fine; Sarah,0,0,15,15
1746571644096,EDS 289C,A01,895770,Daly; Alan J.,1,0,15,14
1746571645123,EDS 290,A00,897211,Hofstetter; Carolyn,0,0,15,15
1746571646151,LIGM 5A,A00,896162,Fischer-Grunski; Eva K,12,0,20,8
1746571647176,LIGM 5B,A00,896260,Fischer-Grunski; Eva K,17,0,20,3
1746571648201,LIGM 5C,A00,896308,Fischer-Grunski; Eva K,18,0,20,2
1746571649229,LIIT 5AS,A00,896313,Carnelos; Chiara,18,0,20,2
1746571650258,LIIT 5BS,A00,896416,Carnelos; Chiara,20,0,20,0
1746571651288,LIIT 5CS,A00,896564,Carnelos; Chiara,20,0,20,0
1746571652311,LISP 5A,A00,896588,Munoz Sanchez; Alicia,2,0,20,18
1746571653339,LISP 5B,A00,896653,Munoz Sanchez; Alicia,7,0,20,13
1746571654363,LISP 5C,A00,896655,Munoz Sanchez; Alicia,0,1,20,20
1746571655389,MAE 197,001,957918,Kleissl; Jan,9996,0,9999,3
1746571655389,MAE 197,002,959806,Boechler; Nicholas Sebastia,9998,0,9999,1
1746571655389,MAE 197,003,959852,Mullin; Jennifer S,9998,0,9999,1
1746571656417,MATH 2,A01,957937,Staff,33,0,35,2
1746571657442,MATH 197,001,957876,Kedlaya; Kiran S.,9993,0,9999,6
1746571658467,MCWP 40,A00,892729,Duru; Nur,10,0,20,10
1746571658467,MCWP 40,B00,893304,Montejo; Carolina,14,0,20,6
1746571659492,MCWP 40R,A00,893757,Redela; Pamela Morgan,0,5,20,20
1746571660517,MCWP 50,A00,893758,Morshed; Michael James,0,0,20,20
1746571660517,MCWP 50,B00,893761,Bartulis; Jason Michael,17,0,20,3
1746571661543,MCWP 50R,A00,893766,Compas; Sean Matthew,0,1,20,20
1746571661543,MCWP 50R,B00,893769,Carter; Jennifer A,0,1,20,20
1746571661543,MCWP 50R,C00,893771,Krone; Jarret,0,3,20,20
1746571661543,MCWP 50R,D00,893772,Miller; Elizabeth Deen,0,0,20,20
1746571661543,MCWP 50R,E00,893775,Carter; Andrea L,0,1,20,20
1746571662568,MMW 11R,A01,892721,Herbst; Matthew,11,0,27,16
1746571662568,MMW 11R,A02,892722,Herbst; Matthew,0,0,0,3
1746571663593,MMW 12R,A01,892724,Herbst; Matthew,0,11,16,16
1746571663593,MMW 12R,A02,892725,Herbst; Matthew,0,10,16,16
1746571664621,MMW 13R,A01,892727,Staff,0,4,16,16
1746571664621,MMW 13R,A02,892728,Staff,0,4,16,16
1746571664621,MMW 13R,A03,958032,Staff,0,4,16,16
1746571664621,MMW 13R,A04,958033,Staff,0,4,16,16
1746571664621,MMW 13R,A05,958034,Staff,0,4,16,16
1746571665647,SIO 295LS,A00,894015,Staff,5,0,25,20
1746571666673,SIO 295S,A00,894020,Staff,5,0,25,20
1746571667699,SIOC 290S,B01,958918,Merrifield; Mark A,14,0,30,16
1746571668723,SIOC 291S,B01,958922,Gabriel; Corey John,14,0,30,16
1746571669752,SOCI 117,A01,895339,Staff,3,0,5,2
1746571670779,WES 237B,A00,894149,Staff,11,0,20,9
1746571672846,AESE 279B,A00,891859,Staff,13,0,35,22
1746571673870,AIP 197,001,891854,Vespa; Emanuel Ignacio,9999,0,9999,0
1746571674897,ANTH 289S,A00,891856,Gagneux; Pascal,12,0,12,0
1746571675926,BENG 196,001,957946,Engler; Adam J.,9996,0,9999,3
1746571676955,BISP 197,001,959851,Wilhelm; James E.,9998,0,9999,1
1746571677981,CAT 124RS,A01,956906,Staff,6,0,25,19
1746571679008,CAT 125RS,A01,922013,Staff,6,0,25,19
1746571680035,CLRE 250,A00,891860,Morris; Sheldon,9995,0,9999,4
1746571682088,CLRE 251R,A00,907817,Mehta; Ravindra L.,9994,0,9999,5
1746571683114,CLRE 252,A00,891864,Cuomo; Raphael Eduardo,9993,0,9999,6
1746571684139,CLRE 253,A00,891867,Vaida; Florin,9994,0,9999,5
1746571684139,CLRE 253,B00,907819,Staff,9999,0,9999,0
1746571685169,CLRE 259,A00,891868,Patel; Hemal,9998,0,9999,1
1746571686195,CLRE 260,A00,891872,Cuomo; Raphael Eduardo,9999,0,9999,0
1746571687223,CLRE 297,001,891888,Cuomo; Raphael Eduardo,9999,0,9999,0
1746571688251,CSE 191,A00,958773,Minnes Kemp; Mor Mia,9995,0,9999,4
1746571689283,CSE 197,001,959846,Minnes Kemp; Mor Mia,9990,0,9999,9
1746571690307,CSS 201S,A01,892054,Mignozzetti; Umberto,25,0,30,5
1746571691335,CSS 202S,A01,892056,Mignozzetti; Umberto,25,0,30,5
1746571692360,DSC 197,001,956898,Eldridge; Justin Matthew,9996,0,9999,3
1746571693387,DSC 297,001,958000,Mazumdar; Arya,9998,0,9999,1
1746571693387,DSC 297,002,959862,Wang; Yusu,9998,0,9999,1
1746571694412,EAP 100,A00,905686,Staff,9778,0,9999,221
1746571695437,ECE 45,A01,892618,Staff,0,0,65,65
1746571697488,ECE 111,A01,892719,Staff,5,0,65,60
1746571698516,ECE 197,001,957920,Mercier; Patrick Philip,9991,0,9999,8
1746571699545,ECON 178,A01,907814,Zhu; Ying,26,0,35,9
1746571700569,EDS 115,A00,895312,Staff,35,0,45,10
1746571701594,EDS 117,A01,895337,Staff,23,0,30,7
1746571702619,EDS 125,A00,895341,Jones; Gabrielle Anastasia,36,0,45,9
1746571703646,EDS 128A,A01,895459,Fargason; Sharon Gayle,44,0,45,1
1746571704672,EDS 128B,A01,895543,Pappas; Elizabeth,44,0,45,1
1746571705698,EDS 139,A00,897203,Pappas; Elizabeth,44,0,45,1
1746571705698,EDS 139,B00,897209,Fargason; Sharon Gayle,41,0,45,4
1746571706724,EDS 201,A00,895545,Staff,22,0,45,23
1746571707750,EDS 203,A01,895581,Halter; Christopher P.,22,0,45,23
1746571708777,EDS 204R,A01,895625,Heinzman; Erica M.,39,0,45,6
1746571708777,EDS 204R,B01,895693,Halter; Christopher P.,10,0,45,35
1746571709802,EDS 206R,A00,895694,Fargason; Sharon Gayle,1,0,30,29
1746571709802,EDS 206R,B00,895695,Choi; Bailey Miyeon,16,0,30,14
1746571710826,EDS 250,A00,895697,Hemans; Patricia Ann Benitez,22,0,45,23
1746571711849,EDS 281,A00,895701,Meyerott; Theresa Ann,1,0,15,14
1746571712874,EDS 284,A00,895736,Meyerott; Theresa Ann,1,0,15,14
1746571713899,EDS 286,A00,897210,Fine; Sarah,0,0,15,15
1746571714926,EDS 289C,A01,895770,Daly; Alan J.,1,0,15,14
1746571715953,EDS 290,A00,897211,Hofstetter; Carolyn,0,0,15,15
1746571716975,LIGM 5A,A00,896162,Fischer-Grunski; Eva K,12,0,20,8
1746571718004,LIGM 5B,A00,896260,Fischer-Grunski; Eva K,17,0,20,3
1746571719028,LIGM 5C,A00,896308,Fischer-Grunski; Eva K,18,0,20,2
1746571720057,LIIT 5AS,A00,896313,Carnelos; Chiara,18,0,20,2
1746571721081,LIIT 5BS,A00,896416,Carnelos; Chiara,20,0,20,0
1746571722109,LIIT 5CS,A00,896564,Carnelos; Chiara,20,0,20,0
1746571723144,LISP 5A,A00,896588,Munoz Sanchez; Alicia,2,0,20,18
1746571724178,LISP 5B,A00,896653,Munoz Sanchez; Alicia,7,0,20,13
1746571725204,LISP 5C,A00,896655,Munoz Sanchez; Alicia,0,1,20,20
1746571726231,MAE 197,001,957918,Kleissl; Jan,9996,0,9999,3
1746571726231,MAE 197,002,959806,Boechler; Nicholas Sebastia,9998,0,9999,1
1746571726231,MAE 197,003,959852,Mullin; Jennifer S,9998,0,9999,1
1746571727255,MATH 2,A01,957937,Staff,33,0,35,2
1746571728280,MATH 197,001,957876,Kedlaya; Kiran S.,9993,0,9999,6
1746571729304,MCWP 40,A00,892729,Duru; Nur,10,0,20,10
1746571729304,MCWP 40,B00,893304,Montejo; Carolina,14,0,20,6
1746571730333,MCWP 40R,A00,893757,Redela; Pamela Morgan,0,5,20,20
1746571731358,MCWP 50,A00,893758,Morshed; Michael James,0,0,20,20
1746571731358,MCWP 50,B00,893761,Bartulis; Jason Michael,17,0,20,3
1746571732382,MCWP 50R,A00,893766,Compas; Sean Matthew,0,1,20,20
1746571732382,MCWP 50R,B00,893769,Carter; Jennifer A,0,1,20,20
1746571732382,MCWP 50R,C00,893771,Krone; Jarret,0,3,20,20
1746571732382,MCWP 50R,D00,893772,Miller; Elizabeth Deen,0,0,20,20
1746571732382,MCWP 50R,E00,893775,Carter; Andrea L,0,1,20,20
1746571733410,MMW 11R,A01,892721,Herbst; Matthew,11,0,27,16
1746571733410,MMW 11R,A02,892722,Herbst; Matthew,0,0,0,3
1746571734436,MMW 12R,A01,892724,Herbst; Matthew,0,11,16,16
1746571734436,MMW 12R,A02,892725,Herbst; Matthew,0,10,16,16
1746571735461,MMW 13R,A01,892727,Staff,0,4,16,16
1746571735461,MMW 13R,A02,892728,Staff,0,4,16,16
1746571735461,MMW 13R,A03,958032,Staff,0,4,16,16
1746571735461,MMW 13R,A04,958033,Staff,0,4,16,16
1746571735461,MMW 13R,A05,958034,Staff,0,4,16,16
1746571736487,SIO 295LS,A00,894015,Staff,5,0,25,20
1746571737512,SIO 295S,A00,894020,Staff,5,0,25,20
1746571738537,SIOC 290S,B01,958918,Merrifield; Mark A,14,0,30,16
1746571739566,SIOC 291S,B01,958922,Gabriel; Corey John,14,0,30,16
1746571740593,SOCI 117,A01,895339,Staff,3,0,5,2
1746571741620,WES 237B,A00,894149,Staff,11,0,20,9
1746571743679,AESE 279B,A00,891859,Staff,13,0,35,22
1746571744708,AIP 197,001,891854,Vespa; Emanuel Ignacio,9999,0,9999,0
1746571745732,ANTH 289S,A00,891856,Gagneux; Pascal,12,0,12,0
1746571746757,BENG 196,001,957946,Engler; Adam J.,9996,0,9999,3
1746571747782,BISP 197,001,959851,Wilhelm; James E.,9998,0,9999,1
1746571748810,CAT 124RS,A01,956906,Staff,6,0,25,19
1746571749837,CAT 125RS,A01,922013,Staff,6,0,25,19
1746571750869,CLRE 250,A00,891860,Morris; Sheldon,9995,0,9999,4
1746571752922,CLRE 251R,A00,907817,Mehta; Ravindra L.,9994,0,9999,5
1746571753948,CLRE 252,A00,891864,Cuomo; Raphael Eduardo,9993,0,9999,6
1746571754975,CLRE 253,A00,891867,Vaida; Florin,9994,0,9999,5
1746571754975,CLRE 253,B00,907819,Staff,9999,0,9999,0
1746571756000,CLRE 259,A00,891868,Patel; Hemal,9998,0,9999,1
1746571757026,CLRE 260,A00,891872,Cuomo; Raphael Eduardo,9999,0,9999,0
1746571758053,CLRE 297,001,891888,Cuomo; Raphael Eduardo,9999,0,9999,0
1746571759082,CSE 191,A00,958773,Minnes Kemp; Mor Mia,9995,0,9999,4
1746571760110,CSE 197,001,959846,Minnes Kemp; Mor Mia,9990,0,9999,9
1746571761136,CSS 201S,A01,892054,Mignozzetti; Umberto,25,0,30,5
1746571762161,CSS 202S,A01,892056,Mignozzetti; Umberto,25,0,30,5
1746571763185,DSC 197,001,956898,Eldridge; Justin Matthew,9996,0,9999,3
1746571764213,DSC 297,001,958000,Mazumdar; Arya,9998,0,9999,1
1746571764213,DSC 297,002,959862,Wang; Yusu,9998,0,9999,1
1746571765238,EAP 100,A00,905686,Staff,9778,0,9999,221
1746571766268,ECE 45,A01,892618,Staff,0,0,65,65
1746571768319,ECE 111,A01,892719,Staff,5,0,65,60
1746571769345,ECE 197,001,957920,Mercier; Patrick Philip,9991,0,9999,8
1746571770374,ECON 178,A01,907814,Zhu; Ying,26,0,35,9
1746571771401,EDS 115,A00,895312,Staff,35,0,45,10
1746571772427,EDS 117,A01,895337,Staff,23,0,30,7
1746571773456,EDS 125,A00,895341,Jones; Gabrielle Anastasia,36,0,45,9
1746571774480,EDS 128A,A01,895459,Fargason; Sharon Gayle,44,0,45,1
1746571775507,EDS 128B,A01,895543,Pappas; Elizabeth,44,0,45,1
1746571776538,EDS 139,A00,897203,Pappas; Elizabeth,44,0,45,1
1746571776538,EDS 139,B00,897209,Fargason; Sharon Gayle,41,0,45,4
1746571777566,EDS 201,A00,895545,Staff,22,0,45,23
1746571778595,EDS 203,A01,895581,Halter; Christopher P.,22,0,45,23
1746571779621,EDS 204R,A01,895625,Heinzman; Erica M.,39,0,45,6
1746571779621,EDS 204R,B01,895693,Halter; Christopher P.,10,0,45,35
1746571780645,EDS 206R,A00,895694,Fargason; Sharon Gayle,1,0,30,29
1746571780645,EDS 206R,B00,895695,Choi; Bailey Miyeon,16,0,30,14
1746571781668,EDS 250,A00,895697,Hemans; Patricia Ann Benitez,22,0,45,23
1746571782693,EDS 281,A00,895701,Meyerott; Theresa Ann,1,0,15,14
1746571783716,EDS 284,A00,895736,Meyerott; Theresa Ann,1,0,15,14
1746571784744,EDS 286,A00,897210,Fine; Sarah,0,0,15,15
1746571785771,EDS 289C,A01,895770,Daly; Alan J.,1,0,15,14
1746571786798,EDS 290,A00,897211,Hofstetter; Carolyn,0,0,15,15
1746571787823,LIGM 5A,A00,896162,Fischer-Grunski; Eva K,12,0,20,8
1746571788848,LIGM 5B,A00,896260,Fischer-Grunski; Eva K,17,0,20,3
1746571789886,LIGM 5C,A00,896308,Fischer-Grunski; Eva K,18,0,20,2
1746571790911,LIIT 5AS,A00,896313,Carnelos; Chiara,18,0,20,2
1746571791935,LIIT 5BS,A00,896416,Carnelos; Chiara,20,0,20,0
1746571792962,LIIT 5CS,A00,896564,Carnelos; Chiara,20,0,20,0
1746571793990,LISP 5A,A00,896588,Munoz Sanchez; Alicia,2,0,20,18
1746571795019,LISP 5B,A00,896653,Munoz Sanchez; Alicia,7,0,20,13
1746571796046,LISP 5C,A00,896655,Munoz Sanchez; Alicia,0,1,20,20
1746571797074,MAE 197,001,957918,Kleissl; Jan,9996,0,9999,3
1746571797074,MAE 197,002,959806,Boechler; Nicholas Sebastia,9998,0,9999,1
1746571797074,MAE 197,003,959852,Mullin; Jennifer S,9998,0,9999,1
1746571798098,MATH 2,A01,957937,Staff,33,0,35,2
1746571799125,MATH 197,001,957876,Kedlaya; Kiran S.,9993,0,9999,6
1746571800149,MCWP 40,A00,892729,Duru; Nur,10,0,20,10
1746571800149,MCWP 40,B00,893304,Montejo; Carolina,14,0,20,6
1746571801176,MCWP 40R,A00,893757,Redela; Pamela Morgan,0,5,20,20
1746571802203,MCWP 50,A00,893758,Morshed; Michael James,0,0,20,20
1746571802203,MCWP 50,B00,893761,Bartulis; Jason Michael,17,0,20,3
1746571803233,MCWP 50R,A00,893766,Compas; Sean Matthew,0,1,20,20
1746571803233,MCWP 50R,B00,893769,Carter; Jennifer A,0,1,20,20
1746571803233,MCWP 50R,C00,893771,Krone; Jarret,0,3,20,20
1746571803233,MCWP 50R,D00,893772,Miller; Elizabeth Deen,0,0,20,20
1746571803233,MCWP 50R,E00,893775,Carter; Andrea L,0,1,20,20
1746571804256,MMW 11R,A01,892721,Herbst; Matthew,11,0,27,16
1746571804256,MMW 11R,A02,892722,Herbst; Matthew,0,0,0,3
1746571805283,MMW 12R,A01,892724,Herbst; Matthew,0,11,16,16
1746571805283,MMW 12R,A02,892725,Herbst; Matthew,0,10,16,16
1746571806310,MMW 13R,A01,892727,Staff,0,4,16,16
1746571806310,MMW 13R,A02,892728,Staff,0,4,16,16
1746571806310,MMW 13R,A03,958032,Staff,0,4,16,16
1746571806310,MMW 13R,A04,958033,Staff,0,4,16,16
1746571806310,MMW 13R,A05,958034,Staff,0,4,16,16
1746571807333,SIO 295LS,A00,894015,Staff,5,0,25,20
1746571808361,SIO 295S,A00,894020,Staff,5,0,25,20
1746571809385,SIOC 290S,B01,958918,Merrifield; Mark A,14,0,30,16
1746571810412,SIOC 291S,B01,958922,Gabriel; Corey John,14,0,30,16
1746571811436,SOCI 117,A01,895339,Staff,3,0,5,2
1746571812460,WES 237B,A00,894149,Staff,11,0,20,9
1746571814529,AESE 279B,A00,891859,Staff,13,0,35,22
1746571815557,AIP 197,001,891854,Vespa; Emanuel Ignacio,9999,0,9999,0
1746571816583,ANTH 289S,A00,891856,Gagneux; Pascal,12,0,12,0
1746571817608,BENG 196,001,957946,Engler; Adam J.,9996,0,9999,3
1746571818632,BISP 197,001,959851,Wilhelm; James E.,9998,0,9999,1
1746571819659,CAT 124RS,A01,956906,Staff,6,0,25,19
1746571820686,CAT 125RS,A01,922013,Staff,6,0,25,19
1746571821714,CLRE 250,A00,891860,Morris; Sheldon,9995,0,9999,4
1746571823767,CLRE 251R,A00,907817,Mehta; Ravindra L.,9994,0,9999,5
1746571824790,CLRE 252,A00,891864,Cuomo; Raphael Eduardo,9993,0,9999,6
1746571825818,CLRE 253,A00,891867,Vaida; Florin,9994,0,9999,5
1746571825818,CLRE 253,B00,907819,Staff,9999,0,9999,0
1746571826842,CLRE 259,A00,891868,Patel; Hemal,9998,0,9999,1
1746571837779,CLRE 260,A00,891872,Cuomo; Raphael Eduardo,9999,0,9999,0
1746571838812,CLRE 297,001,891888,Cuomo; Raphael Eduardo,9999,0,9999,0
1746571839836,CSE 191,A00,958773,Minnes Kemp; Mor Mia,9995,0,9999,4
1746571840861,CSE 197,001,959846,Minnes Kemp; Mor Mia,9990,0,9999,9
1746571841895,CSS 201S,A01,892054,Mignozzetti; Umberto,25,0,30,5
1746571842922,CSS 202S,A01,892056,Mignozzetti; Umberto,25,0,30,5
1746571843946,DSC 197,001,956898,Eldridge; Justin Matthew,9996,0,9999,3
1746571844970,DSC 297,001,958000,Mazumdar; Arya,9998,0,9999,1
1746571844970,DSC 297,002,959862,Wang; Yusu,9998,0,9999,1
1746571845998,EAP 100,A00,905686,Staff,9778,0,9999,221
1746571847030,ECE 45,A01,892618,Staff,0,0,65,65
1746571849083,ECE 111,A01,892719,Staff,5,0,65,60
1746571850107,ECE 197,001,957920,Mercier; Patrick Philip,9991,0,9999,8
1746571851135,ECON 178,A01,907814,Zhu; Ying,26,0,35,9
1746571852161,EDS 115,A00,895312,Staff,35,0,45,10
1746571853206,EDS 117,A01,895337,Staff,23,0,30,7
1746571854231,EDS 125,A00,895341,Jones; Gabrielle Anastasia,36,0,45,9
1746571855255,EDS 128A,A01,895459,Fargason; Sharon Gayle,44,0,45,1
1746571856280,EDS 128B,A01,895543,Pappas; Elizabeth,44,0,45,1
1746571857306,EDS 139,A00,897203,Pappas; Elizabeth,44,0,45,1
1746571857306,EDS 139,B00,897209,Fargason; Sharon Gayle,41,0,45,4
1746571858334,EDS 201,A00,895545,Staff,22,0,45,23
1746571859359,EDS 203,A01,895581,Halter; Christopher P.,22,0,45,23
1746571860383,EDS 204R,A01,895625,Heinzman; Erica M.,39,0,45,6
1746571860383,EDS 204R,B01,895693,Halter; Christopher P.,10,0,45,35
1746571861409,EDS 206R,A00,895694,Fargason; Sharon Gayle,1,0,30,29
1746571861409,EDS 206R,B00,895695,Choi; Bailey Miyeon,16,0,30,14
1746571862436,EDS 250,A00,895697,Hemans; Patricia Ann Benitez,22,0,45,23
1746571863461,EDS 281,A00,895701,Meyerott; Theresa Ann,1,0,15,14
1746571864486,EDS 284,A00,895736,Meyerott; Theresa Ann,1,0,15,14
1746571865512,EDS 286,A00,897210,Fine; Sarah,0,0,15,15
1746571866538,EDS 289C,A01,895770,Daly; Alan J.,1,0,15,14
1746571867563,EDS 290,A00,897211,Hofstetter; Carolyn,0,0,15,15
1746571868588,LIGM 5A,A00,896162,Fischer-Grunski; Eva K,12,0,20,8
1746571869617,LIGM 5B,A00,896260,Fischer-Grunski; Eva K,17,0,20,3
1746571870643,LIGM 5C,A00,896308,Fischer-Grunski; Eva K,18,0,20,2
1746571871668,LIIT 5AS,A00,896313,Carnelos; Chiara,18,0,20,2
1746571872694,LIIT 5BS,A00,896416,Carnelos; Chiara,20,0,20,0
1746571873721,LIIT 5CS,A00,896564,Carnelos; Chiara,20,0,20,0
1746571874747,LISP 5A,A00,896588,Munoz Sanchez; Alicia,2,0,20,18
1746571875790,LISP 5B,A00,896653,Munoz Sanchez; Alicia,7,0,20,13
1746571876821,LISP 5C,A00,896655,Munoz Sanchez; Alicia,0,1,20,20
1746571877846,MAE 197,001,957918,Kleissl; Jan,9996,0,9999,3
1746571877846,MAE 197,002,959806,Boechler; Nicholas Sebastia,9998,0,9999,1
1746571877846,MAE 197,003,959852,Mullin; Jennifer S,9998,0,9999,1
1746571878871,MATH 2,A01,957937,Staff,33,0,35,2
1746571879898,MATH 197,001,957876,Kedlaya; Kiran S.,9993,0,9999,6
1746571880922,MCWP 40,A00,892729,Duru; Nur,10,0,20,10
1746571880922,MCWP 40,B00,893304,Montejo; Carolina,14,0,20,6
1746571881948,MCWP 40R,A00,893757,Redela; Pamela Morgan,0,5,20,20
1746571882976,MCWP 50,A00,893758,Morshed; Michael James,0,0,20,20
1746571882976,MCWP 50,B00,893761,Bartulis; Jason Michael,17,0,20,3
1746571884001,MCWP 50R,A00,893766,Compas; Sean Matthew,0,1,20,20
1746571884001,MCWP 50R,B00,893769,Carter; Jennifer A,0,1,20,20
1746571884001,MCWP 50R,C00,893771,Krone; Jarret,0,3,20,20
1746571884001,MCWP 50R,D00,893772,Miller; Elizabeth Deen,0,0,20,20
1746571884001,MCWP 50R,E00,893775,Carter; Andrea L,0,1,20,20
1746571885028,MMW 11R,A01,892721,Herbst; Matthew,11,0,27,16
1746571885028,MMW 11R,A02,892722,Herbst; Matthew,0,0,0,3
1746571886052,MMW 12R,A01,892724,Herbst; Matthew,0,11,16,16
1746571886052,MMW 12R,A02,892725,Herbst; Matthew,0,10,16,16
1746571887079,MMW 13R,A01,892727,Staff,0,4,16,16
1746571887079,MMW 13R,A02,892728,Staff,0,4,16,16
1746571887079,MMW 13R,A03,958032,Staff,0,4,16,16
1746571887079,MMW 13R,A04,958033,Staff,0,4,16,16
1746571887079,MMW 13R,A05,958034,Staff,0,4,16,16
1746571888105,SIO 295LS,A00,894015,Staff,5,0,25,20
1746571889130,SIO 295S,A00,894020,Staff,5,0,25,20
1746571890154,SIOC 290S,B01,958918,Merrifield; Mark A,14,0,30,16
1746571891181,SIOC 291S,B01,958922,Gabriel; Corey John,14,0,30,16
1746571892207,SOCI 117,A01,895339,Staff,3,0,5,2
1746571893232,WES 237B,A00,894149,Staff,11,0,20,9
1746571895296,AESE 279B,A00,891859,Staff,13,0,35,22
1746571896321,AIP 197,001,891854,Vespa; Emanuel Ignacio,9999,0,9999,0
1746571897346,ANTH 289S,A00,891856,Gagneux; Pascal,12,0,12,0
1746571898375,BENG 196,001,957946,Engler; Adam J.,9996,0,9999,3
1746571899398,BISP 197,001,959851,Wilhelm; James E.,9998,0,9999,1
1746571900423,CAT 124RS,A01,956906,Staff,6,0,25,19
1746571901449,CAT 125RS,A01,922013,Staff,6,0,25,19
1746571902479,CLRE 250,A00,891860,Morris; Sheldon,9995,0,9999,4
1746571904530,CLRE 251R,A00,907817,Mehta; Ravindra L.,9994,0,9999,5
1746571905554,CLRE 252,A00,891864,Cuomo; Raphael Eduardo,9993,0,9999,6
1746571906580,CLRE 253,A00,891867,Vaida; Florin,9994,0,9999,5
1746571906580,CLRE 253,B00,907819,Staff,9999,0,9999,0
1746571907607,CLRE 259,A00,891868,Patel; Hemal,9998,0,9999,1
1746571908634,CLRE 260,A00,891872,Cuomo; Raphael Eduardo,9999,0,9999,0
1746571909657,CLRE 297,001,891888,Cuomo; Raphael Eduardo,9999,0,9999,0
1746571910684,CSE 191,A00,958773,Minnes Kemp; Mor Mia,9995,0,9999,4
1746571911712,CSE 197,001,959846,Minnes Kemp; Mor Mia,9990,0,9999,9
1746571912736,CSS 201S,A01,892054,Mignozzetti; Umberto,25,0,30,5
1746571914029,CSS 202S,A01,892056,Mignozzetti; Umberto,25,0,30,5
1746571915056,DSC 197,001,956898,Eldridge; Justin Matthew,9996,0,9999,3
1746571916086,DSC 297,001,958000,Mazumdar; Arya,9998,0,9999,1
1746571916086,DSC 297,002,959862,Wang; Yusu,9998,0,9999,1
1746571917111,EAP 100,A00,905686,Staff,9778,0,9999,221
1746571918136,ECE 45,A01,892618,Staff,0,0,65,65
1746571920190,ECE 111,A01,892719,Staff,5,0,65,60
1746571921215,ECE 197,001,957920,Mercier; Patrick Philip,9991,0,9999,8
1746571922241,ECON 178,A01,907814,Zhu; Ying,26,0,35,9
1746571923267,EDS 115,A00,895312,Staff,35,0,45,10
1746571924291,EDS 117,A01,895337,Staff,23,0,30,7
1746571925319,EDS 125,A00,895341,Jones; Gabrielle Anastasia,36,0,45,9
1746571926349,EDS 128A,A01,895459,Fargason; Sharon Gayle,44,0,45,1
1746571927381,EDS 128B,A01,895543,Pappas; Elizabeth,44,0,45,1
1746571928404,EDS 139,A00,897203,Pappas; Elizabeth,44,0,45,1
1746571928404,EDS 139,B00,897209,Fargason; Sharon Gayle,41,0,45,4
1746571929429,EDS 201,A00,895545,Staff,22,0,45,23
1746571930454,EDS 203,A01,895581,Halter; Christopher P.,22,0,45,23
1746571931480,EDS 204R,A01,895625,Heinzman; Erica M.,39,0,45,6
1746571931480,EDS 204R,B01,895693,Halter; Christopher P.,10,0,45,35
1746571932509,EDS 206R,A00,895694,Fargason; Sharon Gayle,1,0,30,29
1746571932509,EDS 206R,B00,895695,Choi; Bailey Miyeon,16,0,30,14
1746571933533,EDS 250,A00,895697,Hemans; Patricia Ann Benitez,22,0,45,23
1746571934561,EDS 281,A00,895701,Meyerott; Theresa Ann,1,0,15,14
1746571935585,EDS 284,A00,895736,Meyerott; Theresa Ann,1,0,15,14
1746571936609,EDS 286,A00,897210,Fine; Sarah,0,0,15,15
1746571937633,EDS 289C,A01,895770,Daly; Alan J.,1,0,15,14
1746571938659,EDS 290,A00,897211,Hofstetter; Carolyn,0,0,15,15
1746571939685,LIGM 5A,A00,896162,Fischer-Grunski; Eva K,12,0,20,8
1746571940710,LIGM 5B,A00,896260,Fischer-Grunski; Eva K,17,0,20,3
1746571941743,LIGM 5C,A00,896308,Fischer-Grunski; Eva K,18,0,20,2
1746571942773,LIIT 5AS,A00,896313,Carnelos; Chiara,18,0,20,2
1746571943798,LIIT 5BS,A00,896416,Carnelos; Chiara,20,0,20,0
1746571944824,LIIT 5CS,A00,896564,Carnelos; Chiara,20,0,20,0
1746571945849,LISP 5A,A00,896588,Munoz Sanchez; Alicia,2,0,20,18
1746571946873,LISP 5B,A00,896653,Munoz Sanchez; Alicia,7,0,20,13
1746571947901,LISP 5C,A00,896655,Munoz Sanchez; Alicia,0,1,20,20
1746571948926,MAE 197,001,957918,Kleissl; Jan,9996,0,9999,3
1746571948926,MAE 197,002,959806,Boechler; Nicholas Sebastia,9998,0,9999,1
1746571948926,MAE 197,003,959852,Mullin; Jennifer S,9998,0,9999,1
1746571949950,MATH 2,A01,957937,Staff,33,0,35,2
1746571950976,MATH 197,001,957876,Kedlaya; Kiran S.,9993,0,9999,6
1746571952002,MCWP 40,A00,892729,Duru; Nur,10,0,20,10
1746571952002,MCWP 40,B00,893304,Montejo; Carolina,14,0,20,6
1746571953028,MCWP 40R,A00,893757,Redela; Pamela Morgan,0,5,20,20
1746571954052,MCWP 50,A00,893758,Morshed; Michael James,0,0,20,20
1746571954052,MCWP 50,B00,893761,Bartulis; Jason Michael,17,0,20,3
1746571955077,MCWP 50R,A00,893766,Compas; Sean Matthew,0,1,20,20
1746571955077,MCWP 50R,B00,893769,Carter; Jennifer A,0,1,20,20
1746571955077,MCWP 50R,C00,893771,Krone; Jarret,0,3,20,20
1746571955077,MCWP 50R,D00,893772,Miller; Elizabeth Deen,0,0,20,20
1746571955077,MCWP 50R,E00,893775,Carter; Andrea L,0,1,20,20
1746571956101,MMW 11R,A01,892721,Herbst; Matthew,11,0,27,16
1746571956101,MMW 11R,A02,892722,Herbst; Matthew,0,0,0,3
1746571957127,MMW 12R,A01,892724,Herbst; Matthew,0,11,16,16
1746571957127,MMW 12R,A02,892725,Herbst; Matthew,0,10,16,16
1746571958151,MMW 13R,A01,892727,Staff,0,4,16,16
1746571958151,MMW 13R,A02,892728,Staff,0,4,16,16
1746571958151,MMW 13R,A03,958032,Staff,0,4,16,16
1746571958151,MMW 13R,A04,958033,Staff,0,4,16,16
1746571958151,MMW 13R,A05,958034,Staff,0,4,16,16
1746571959178,SIO 295LS,A00,894015,Staff,5,0,25,20
1746571960207,SIO 295S,A00,894020,Staff,5,0,25,20
1746571961237,SIOC 290S,B01,958918,Merrifield; Mark A,14,0,30,16
1746571962268,SIOC 291S,B01,958922,Gabriel; Corey John,14,0,30,16
1746571963291,SOCI 117,A01,895339,Staff,3,0,5,2
1746571964316,WES 237B,A00,894149,Staff,11,0,20,9
1746571966378,AESE 279B,A00,891859,Staff,13,0,35,22
1746571967406,AIP 197,001,891854,Vespa; Emanuel Ignacio,9999,0,9999,0
1746571968433,ANTH 289S,A00,891856,Gagneux; Pascal,12,0,12,0
1746571969456,BENG 196,001,957946,Engler; Adam J.,9996,0,9999,3
1746571970486,BISP 197,001,959851,Wilhelm; James E.,9998,0,9999,1
1746571971514,CAT 124RS,A01,956906,Staff,6,0,25,19
1746571972538,CAT 125RS,A01,922013,Staff,6,0,25,19
1746571973564,CLRE 250,A00,891860,Morris; Sheldon,9995,0,9999,4
1746571975674,CLRE 251R,A00,907817,Mehta; Ravindra L.,9994,0,9999,5
1746571976701,CLRE 252,A00,891864,Cuomo; Raphael Eduardo,9993,0,9999,6
1746571977729,CLRE 253,A00,891867,Vaida; Florin,9994,0,9999,5
1746571977729,CLRE 253,B00,907819,Staff,9999,0,9999,0
1746571978754,CLRE 259,A00,891868,Patel; Hemal,9998,0,9999,1
1746571979780,CLRE 260,A00,891872,Cuomo; Raphael Eduardo,9999,0,9999,0
1746571980807,CLRE 297,001,891888,Cuomo; Raphael Eduardo,9999,0,9999,0
1746571981831,CSE 191,A00,958773,Minnes Kemp; Mor Mia,9995,0,9999,4
1746571982860,CSE 197,001,959846,Minnes Kemp; Mor Mia,9990,0,9999,9
1746571983884,CSS 201S,A01,892054,Mignozzetti; Umberto,25,0,30,5
1746571984909,CSS 202S,A01,892056,Mignozzetti; Umberto,25,0,30,5
1746571985934,DSC 197,001,956898,Eldridge; Justin Matthew,9996,0,9999,3
1746571986960,DSC 297,001,958000,Mazumdar; Arya,9998,0,9999,1
1746571986960,DSC 297,002,959862,Wang; Yusu,9998,0,9999,1
1746571987987,EAP 100,A00,905686,Staff,9778,0,9999,221
1746571989013,ECE 45,A01,892618,Staff,0,0,65,65
1746571991063,ECE 111,A01,892719,Staff,5,0,65,60
1746571992091,ECE 197,001,957920,Mercier; Patrick Philip,9991,0,9999,8
1746571993121,ECON 178,A01,907814,Zhu; Ying,26,0,35,9
1746571994145,EDS 115,A00,895312,Staff,35,0,45,10
1746571995170,EDS 117,A01,895337,Staff,23,0,30,7
1746571996197,EDS 125,A00,895341,Jones; Gabrielle Anastasia,36,0,45,9
1746571997221,EDS 128A,A01,895459,Fargason; Sharon Gayle,44,0,45,1
1746571998246,EDS 128B,A01,895543,Pappas; Elizabeth,44,0,45,1
1746571999275,EDS 139,A00,897203,Pappas; Elizabeth,44,0,45,1
1746571999275,EDS 139,B00,897209,Fargason; Sharon Gayle,41,0,45,4
1746572000302,EDS 201,A00,895545,Staff,22,0,45,23
1746572001328,EDS 203,A01,895581,Halter; Christopher P.,22,0,45,23
1746572002357,EDS 204R,A01,895625,Heinzman; Erica M.,39,0,45,6
1746572002357,EDS 204R,B01,895693,Halter; Christopher P.,10,0,45,35
1746572003387,EDS 206R,A00,895694,Fargason; Sharon Gayle,1,0,30,29
1746572003387,EDS 206R,B00,895695,Choi; Bailey Miyeon,16,0,30,14
1746572004413,EDS 250,A00,895697,Hemans; Patricia Ann Benitez,22,0,45,23
1746572005440,EDS 281,A00,895701,Meyerott; Theresa Ann,1,0,15,14
1746572006468,EDS 284,A00,895736,Meyerott; Theresa Ann,1,0,15,14
1746572007494,EDS 286,A00,897210,Fine; Sarah,0,0,15,15
1746572008519,EDS 289C,A01,895770,Daly; Alan J.,1,0,15,14
1746572009545,EDS 290,A00,897211,Hofstetter; Carolyn,0,0,15,15
1746572010569,LIGM 5A,A00,896162,Fischer-Grunski; Eva K,12,0,20,8
1746572011598,LIGM 5B,A00,896260,Fischer-Grunski; Eva K,17,0,20,3
1746572012627,LIGM 5C,A00,896308,Fischer-Grunski; Eva K,18,0,20,2
1746572013655,LIIT 5AS,A00,896313,Carnelos; Chiara,18,0,20,2
1746572014685,LIIT 5BS,A00,896416,Carnelos; Chiara,20,0,20,0
1746572015715,LIIT 5CS,A00,896564,Carnelos; Chiara,20,0,20,0
1746572016746,LISP 5A,A00,896588,Munoz Sanchez; Alicia,2,0,20,18
1746572017772,LISP 5B,A00,896653,Munoz Sanchez; Alicia,7,0,20,13
1746572018797,LISP 5C,A00,896655,Munoz Sanchez; Alicia,0,1,20,20
1746572019821,MAE 197,001,957918,Kleissl; Jan,9996,0,9999,3
1746572019821,MAE 197,002,959806,Boechler; Nicholas Sebastia,9998,0,9999,1
1746572019821,MAE 197,003,959852,Mullin; Jennifer S,9998,0,9999,1
1746572020847,MATH 2,A01,957937,Staff,33,0,35,2
1746572021872,MATH 197,001,957876,Kedlaya; Kiran S.,9993,0,9999,6
1746572022897,MCWP 40,A00,892729,Duru; Nur,10,0,20,10
1746572022897,MCWP 40,B00,893304,Montejo; Carolina,14,0,20,6
1746572023926,MCWP 40R,A00,893757,Redela; Pamela Morgan,0,5,20,20
1746572024951,MCWP 50,A00,893758,Morshed; Michael James,0,0,20,20
1746572024951,MCWP 50,B00,893761,Bartulis; Jason Michael,17,0,20,3
1746572025976,MCWP 50R,A00,893766,Compas; Sean Matthew,0,1,20,20
1746572025976,MCWP 50R,B00,893769,Carter; Jennifer A,0,1,20,20
1746572025976,MCWP 50R,C00,893771,Krone; Jarret,0,3,20,20
1746572025976,MCWP 50R,D00,893772,Miller; Elizabeth Deen,0,0,20,20
1746572025976,MCWP 50R,E00,893775,Carter; Andrea L,0,1,20,20
1746572027002,MMW 11R,A01,892721,Herbst; Matthew,11,0,27,16
1746572027002,MMW 11R,A02,892722,Herbst; Matthew,0,0,0,3
1746572028028,MMW 12R,A01,892724,Herbst; Matthew,0,11,16,16
1746572028028,MMW 12R,A02,892725,Herbst; Matthew,0,10,16,16
1746572029052,MMW 13R,A01,892727,Staff,0,4,16,16
1746572029052,MMW 13R,A02,892728,Staff,0,4,16,16
1746572029052,MMW 13R,A03,958032,Staff,0,4,16,16
1746572029052,MMW 13R,A04,958033,Staff,0,4,16,16
1746572029052,MMW 13R,A05,958034,Staff,0,4,16,16
1746572030076,SIO 295LS,A00,894015,Staff,5,0,25,20
1746572031102,SIO 295S,A00,894020,Staff,5,0,25,20
1746572032128,SIOC 290S,B01,958918,Merrifield; Mark A,14,0,30,16
1746572033155,SIOC 291S,B01,958922,Gabriel; Corey John,14,0,30,16
1746572034182,SOCI 117,A01,895339,Staff,3,0,5,2
1746572035206,WES 237B,A00,894149,Staff,11,0,20,9
1746572037271,AESE 279B,A00,891859,Staff,13,0,35,22
1746572038295,AIP 197,001,891854,Vespa; Emanuel Ignacio,9999,0,9999,0
1746572039320,ANTH 289S,A00,891856,Gagneux; Pascal,12,0,12,0
1746572040347,BENG 196,001,957946,Engler; Adam J.,9996,0,9999,3
1746572041371,BISP 197,001,959851,Wilhelm; James E.,9998,0,9999,1
1746572042397,CAT 124RS,A01,956906,Staff,6,0,25,19
1746572043424,CAT 125RS,A01,922013,Staff,6,0,25,19
1746572044448,CLRE 250,A00,891860,Morris; Sheldon,9995,0,9999,4
1746572046501,CLRE 251R,A00,907817,Mehta; Ravindra L.,9994,0,9999,5
1746572047527,CLRE 252,A00,891864,Cuomo; Raphael Eduardo,9993,0,9999,6
1746572048554,CLRE 253,A00,891867,Vaida; Florin,9994,0,9999,5
1746572048554,CLRE 253,B00,907819,Staff,9999,0,9999,0
1746572049581,CLRE 259,A00,891868,Patel; Hemal,9998,0,9999,1
1746572050608,CLRE 260,A00,891872,Cuomo; Raphael Eduardo,9999,0,9999,0
1746572051634,CLRE 297,001,891888,Cuomo; Raphael Eduardo,9999,0,9999,0
1746572052658,CSE 191,A00,958773,Minnes Kemp; Mor Mia,9995,0,9999,4
1746572053684,CSE 197,001,959846,Minnes Kemp; Mor Mia,9990,0,9999,9
1746572054712,CSS 201S,A01,892054,Mignozzetti; Umberto,25,0,30,5
1746572055739,CSS 202S,A01,892056,Mignozzetti; Umberto,25,0,30,5
1746572056765,DSC 197,001,956898,Eldridge; Justin Matthew,9996,0,9999,3
1746572057792,DSC 297,001,958000,Mazumdar; Arya,9998,0,9999,1
1746572057792,DSC 297,002,959862,Wang; Yusu,9998,0,9999,1
1746572058817,EAP 100,A00,905686,Staff,9778,0,9999,221
1746572059841,ECE 45,A01,892618,Staff,0,0,65,65
1746572061892,ECE 111,A01,892719,Staff,5,0,65,60
1746572062919,ECE 197,001,957920,Mercier; Patrick Philip,9991,0,9999,8
1746572063947,ECON 178,A01,907814,Zhu; Ying,26,0,35,9
1746572064976,EDS 115,A00,895312,Staff,35,0,45,10
1746572066000,EDS 117,A01,895337,Staff,23,0,30,7
1746572067028,EDS 125,A00,895341,Jones; Gabrielle Anastasia,36,0,45,9
1746572068054,EDS 128A,A01,895459,Fargason; Sharon Gayle,44,0,45,1
1746572069086,EDS 128B,A01,895543,Pappas; Elizabeth,44,0,45,1
1746572070115,EDS 139,A00,897203,Pappas; Elizabeth,44,0,45,1
1746572070115,EDS 139,B00,897209,Fargason; Sharon Gayle,41,0,45,4
1746572071140,EDS 201,A00,895545,Staff,22,0,45,23
1746572072166,EDS 203,A01,895581,Halter; Christopher P.,22,0,45,23
1746572073189,EDS 204R,A01,895625,Heinzman; Erica M.,39,0,45,6
1746572073189,EDS 204R,B01,895693,Halter; Christopher P.,10,0,45,35
1746572074214,EDS 206R,A00,895694,Fargason; Sharon Gayle,1,0,30,29
1746572074214,EDS 206R,B00,895695,Choi; Bailey Miyeon,16,0,30,14
1746572075238,EDS 250,A00,895697,Hemans; Patricia Ann Benitez,22,0,45,23
1746572076263,EDS 281,A00,895701,Meyerott; Theresa Ann,1,0,15,14
1746572077288,EDS 284,A00,895736,Meyerott; Theresa Ann,1,0,15,14
1746572078354,EDS 286,A00,897210,Fine; Sarah,0,0,15,15
1746572079380,EDS 289C,A01,895770,Daly; Alan J.,1,0,15,14
1746572080404,EDS 290,A00,897211,Hofstetter; Carolyn,0,0,15,15
1746572081430,LIGM 5A,A00,896162,Fischer-Grunski; Eva K,12,0,20,8
1746572082459,LIGM 5B,A00,896260,Fischer-Grunski; Eva K,17,0,20,3
1746572083483,LIGM 5C,A00,896308,Fischer-Grunski; Eva K,18,0,20,2
1746572084508,LIIT 5AS,A00,896313,Carnelos; Chiara,18,0,20,2
1746572085533,LIIT 5BS,A00,896416,Carnelos; Chiara,20,0,20,0
1746572086559,LIIT 5CS,A00,896564,Carnelos; Chiara,20,0,20,0
1746572087586,LISP 5A,A00,896588,Munoz Sanchez; Alicia,2,0,20,18
1746572088611,LISP 5B,A00,896653,Munoz Sanchez; Alicia,7,0,20,13
1746572089635,LISP 5C,A00,896655,Munoz Sanchez; Alicia,0,1,20,20
1746572090659,MAE 197,001,957918,Kleissl; Jan,9996,0,9999,3
1746572090659,MAE 197,002,959806,Boechler; Nicholas Sebastia,9998,0,9999,1
1746572090659,MAE 197,003,959852,Mullin; Jennifer S,9998,0,9999,1
1746572091684,MATH 2,A01,957937,Staff,33,0,35,2
1746572092712,MATH 197,001,957876,Kedlaya; Kiran S.,9993,0,9999,6
1746572093741,MCWP 40,A00,892729,Duru; Nur,10,0,20,10
1746572093741,MCWP 40,B00,893304,Montejo; Carolina,14,0,20,6
1746572094765,MCWP 40R,A00,893757,Redela; Pamela Morgan,0,5,20,20
1746572095790,MCWP 50,A00,893758,Morshed; Michael James,0,0,20,20
1746572095790,MCWP 50,B00,893761,Bartulis; Jason Michael,17,0,20,3
1746572096819,MCWP 50R,A00,893766,Compas; Sean Matthew,0,1,20,20
1746572096819,MCWP 50R,B00,893769,Carter; Jennifer A,0,1,20,20
1746572096819,MCWP 50R,C00,893771,Krone; Jarret,0,3,20,20
1746572096819,MCWP 50R,D00,893772,Miller; Elizabeth Deen,0,0,20,20
1746572096819,MCWP 50R,E00,893775,Carter; Andrea L,0,1,20,20
1746572097849,MMW 11R,A01,892721,Herbst; Matthew,11,0,27,16
1746572097849,MMW 11R,A02,892722,Herbst; Matthew,0,0,0,3
1746572098879,MMW 12R,A01,892724,Herbst; Matthew,0,11,16,16
1746572098879,MMW 12R,A02,892725,Herbst; Matthew,0,10,16,16
1746572099908,MMW 13R,A01,892727,Staff,0,4,16,16
1746572099908,MMW 13R,A02,892728,Staff,0,4,16,16
1746572099908,MMW 13R,A03,958032,Staff,0,4,16,16
1746572099908,MMW 13R,A04,958033,Staff,0,4,16,16
1746572099908,MMW 13R,A05,958034,Staff,0,4,16,16
1746572100935,SIO 295LS,A00,894015,Staff,5,0,25,20
1746572101960,SIO 295S,A00,894020,Staff,5,0,25,20
1746572102984,SIOC 290S,B01,958918,Merrifield; Mark A,14,0,30,16
1746572104015,SIOC 291S,B01,958922,Gabriel; Corey John,14,0,30,16
1746572105042,SOCI 117,A01,895339,Staff,3,0,5,2
1746572106068,WES 237B,A00,894149,Staff,11,0,20,9
1746572108132,AESE 279B,A00,891859,Staff,13,0,35,22
1746572109161,AIP 197,001,891854,Vespa; Emanuel Ignacio,9999,0,9999,0
1746572110187,ANTH 289S,A00,891856,Gagneux; Pascal,12,0,12,0
1746572111214,BENG 196,001,957946,Engler; Adam J.,9996,0,9999,3
1746572112238,BISP 197,001,959851,Wilhelm; James E.,9998,0,9999,1
1746572113271,CAT 124RS,A01,956906,Staff,6,0,25,19
1746572114294,CAT 125RS,A01,922013,Staff,6,0,25,19
1746572115325,CLRE 250,A00,891860,Morris; Sheldon,9995,0,9999,4
1746572117377,CLRE 251R,A00,907817,Mehta; Ravindra L.,9994,0,9999,5
1746572118405,CLRE 252,A00,891864,Cuomo; Raphael Eduardo,9993,0,9999,6
1746572119429,CLRE 253,A00,891867,Vaida; Florin,9994,0,9999,5
1746572119429,CLRE 253,B00,907819,Staff,9999,0,9999,0
1746572120458,CLRE 259,A00,891868,Patel; Hemal,9998,0,9999,1
1746572121482,CLRE 260,A00,891872,Cuomo; Raphael Eduardo,9999,0,9999,0
1746572122509,CLRE 297,001,891888,Cuomo; Raphael Eduardo,9999,0,9999,0
1746572123534,CSE 191,A00,958773,Minnes Kemp; Mor Mia,9995,0,9999,4
1746572124558,CSE 197,001,959846,Minnes Kemp; Mor Mia,9990,0,9999,9
1746572125584,CSS 201S,A01,892054,Mignozzetti; Umberto,25,0,30,5
1746572126608,CSS 202S,A01,892056,Mignozzetti; Umberto,25,0,30,5
1746572127632,DSC 197,001,956898,Eldridge; Justin Matthew,9996,0,9999,3
1746572128656,DSC 297,001,958000,Mazumdar; Arya,9998,0,9999,1
1746572128656,DSC 297,002,959862,Wang; Yusu,9998,0,9999,1
1746572129684,EAP 100,A00,905686,Staff,9778,0,9999,221
1746572130919,ECE 45,A01,892618,Staff,0,0,65,65
1746572132975,ECE 111,A01,892719,Staff,5,0,65,60
1746572134003,ECE 197,001,957920,Mercier; Patrick Philip,9991,0,9999,8
1746572135035,ECON 178,A01,907814,Zhu; Ying,26,0,35,9
1746572136062,EDS 115,A00,895312,Staff,35,0,45,10
1746572137108,EDS 117,A01,895337,Staff,23,0,30,7
1746572138136,EDS 125,A00,895341,Jones; Gabrielle Anastasia,36,0,45,9
1746572139161,EDS 128A,A01,895459,Fargason; Sharon Gayle,44,0,45,1
1746572140185,EDS 128B,A01,895543,Pappas; Elizabeth,44,0,45,1
1746572141210,EDS 139,A00,897203,Pappas; Elizabeth,44,0,45,1
1746572141210,EDS 139,B00,897209,Fargason; Sharon Gayle,41,0,45,4
1746572142235,EDS 201,A00,895545,Staff,22,0,45,23
1746572143261,EDS 203,A01,895581,Halter; Christopher P.,22,0,45,23
1746572144285,EDS 204R,A01,895625,Heinzman; Erica M.,39,0,45,6
1746572144285,EDS 204R,B01,895693,Halter; Christopher P.,10,0,45,35
1746572145311,EDS 206R,A00,895694,Fargason; Sharon Gayle,1,0,30,29
1746572145311,EDS 206R,B00,895695,Choi; Bailey Miyeon,16,0,30,14
1746572146338,EDS 250,A00,895697,Hemans; Patricia Ann Benitez,22,0,45,23
1746572147362,EDS 281,A00,895701,Meyerott; Theresa Ann,1,0,15,14
1746572148386,EDS 284,A00,895736,Meyerott; Theresa Ann,1,0,15,14
1746572149411,EDS 286,A00,897210,Fine; Sarah,0,0,15,15
1746572150436,EDS 289C,A01,895770,Daly; Alan J.,1,0,15,14
1746572151462,EDS 290,A00,897211,Hofstetter; Carolyn,0,0,15,15
1746572152490,LIGM 5A,A00,896162,Fischer-Grunski; Eva K,12,0,20,8
1746572153516,LIGM 5B,A00,896260,Fischer-Grunski; Eva K,17,0,20,3
1746572154540,LIGM 5C,A00,896308,Fischer-Grunski; Eva K,18,0,20,2
1746572155569,LIIT 5AS,A00,896313,Carnelos; Chiara,18,0,20,2
1746572156633,LIIT 5BS,A00,896416,Carnelos; Chiara,20,0,20,0
1746572157659,LIIT 5CS,A00,896564,Carnelos; Chiara,20,0,20,0
1746572158689,LISP 5A,A00,896588,Munoz Sanchez; Alicia,2,0,20,18
1746572159716,LISP 5B,A00,896653,Munoz Sanchez; Alicia,7,0,20,13
1746572160740,LISP 5C,A00,896655,Munoz Sanchez; Alicia,0,1,20,20
1746572161769,MAE 197,001,957918,Kleissl; Jan,9996,0,9999,3
1746572161769,MAE 197,002,959806,Boechler; Nicholas Sebastia,9998,0,9999,1
1746572161769,MAE 197,003,959852,Mullin; Jennifer S,9998,0,9999,1
1746572162795,MATH 2,A01,957937,Staff,33,0,35,2
1746572163824,MATH 197,001,957876,Kedlaya; Kiran S.,9993,0,9999,6
1746572164851,MCWP 40,A00,892729,Duru; Nur,10,0,20,10
1746572164851,MCWP 40,B00,893304,Montejo; Carolina,14,0,20,6
1746572165878,MCWP 40R,A00,893757,Redela; Pamela Morgan,0,5,20,20
1746572166912,MCWP 50,A00,893758,Morshed; Michael James,0,0,20,20
1746572166912,MCWP 50,B00,893761,Bartulis; Jason Michael,17,0,20,3
1746572167944,MCWP 50R,A00,893766,Compas; Sean Matthew,0,1,20,20
1746572167944,MCWP 50R,B00,893769,Carter; Jennifer A,0,1,20,20
1746572167944,MCWP 50R,C00,893771,Krone; Jarret,0,3,20,20
1746572167944,MCWP 50R,D00,893772,Miller; Elizabeth Deen,0,0,20,20
1746572167944,MCWP 50R,E00,893775,Carter; Andrea L,0,1,20,20
1746572168968,MMW 11R,A01,892721,Herbst; Matthew,11,0,27,16
1746572168968,MMW 11R,A02,892722,Herbst; Matthew,0,0,0,3
1746572170007,MMW 12R,A01,892724,Herbst; Matthew,0,11,16,16
1746572170007,MMW 12R,A02,892725,Herbst; Matthew,0,10,16,16
1746572171035,MMW 13R,A01,892727,Staff,0,4,16,16
1746572171035,MMW 13R,A02,892728,Staff,0,4,16,16
1746572171035,MMW 13R,A03,958032,Staff,0,4,16,16
1746572171035,MMW 13R,A04,958033,Staff,0,4,16,16
1746572171035,MMW 13R,A05,958034,Staff,0,4,16,16
1746572172063,SIO 295LS,A00,894015,Staff,5,0,25,20
1746572173089,SIO 295S,A00,894020,Staff,5,0,25,20
1746572174119,SIOC 290S,B01,958918,Merrifield; Mark A,14,0,30,16
1746572175149,SIOC 291S,B01,958922,Gabriel; Corey John,14,0,30,16
1746572176175,SOCI 117,A01,895339,Staff,3,0,5,2
1746572177198,WES 237B,A00,894149,Staff,11,0,20,9
1746572179261,AESE 279B,A00,891859,Staff,13,0,35,22
1746572180289,AIP 197,001,891854,Vespa; Emanuel Ignacio,9999,0,9999,0
1746572181317,ANTH 289S,A00,891856,Gagneux; Pascal,12,0,12,0
1746572182341,BENG 196,001,957946,Engler; Adam J.,9996,0,9999,3
1746572183367,BISP 197,001,959851,Wilhelm; James E.,9998,0,9999,1
1746572184395,CAT 124RS,A01,956906,Staff,6,0,25,19
1746572185418,CAT 125RS,A01,922013,Staff,6,0,25,19
1746572186443,CLRE 250,A00,891860,Morris; Sheldon,9995,0,9999,4
1746572188497,CLRE 251R,A00,907817,Mehta; Ravindra L.,9994,0,9999,5
1746572189520,CLRE 252,A00,891864,Cuomo; Raphael Eduardo,9993,0,9999,6
1746572190545,CLRE 253,A00,891867,Vaida; Florin,9994,0,9999,5
1746572190545,CLRE 253,B00,907819,Staff,9999,0,9999,0
1746572191573,CLRE 259,A00,891868,Patel; Hemal,9998,0,9999,1
1746572192597,CLRE 260,A00,891872,Cuomo; Raphael Eduardo,9999,0,9999,0
1746572193621,CLRE 297,001,891888,Cuomo; Raphael Eduardo,9999,0,9999,0
1746572194647,CSE 191,A00,958773,Minnes Kemp; Mor Mia,9995,0,9999,4
1746572195671,CSE 197,001,959846,Minnes Kemp; Mor Mia,9990,0,9999,9
1746572196701,CSS 201S,A01,892054,Mignozzetti; Umberto,25,0,30,5
1746572197726,CSS 202S,A01,892056,Mignozzetti; Umberto,25,0,30,5
1746572198751,DSC 197,001,956898,Eldridge; Justin Matthew,9996,0,9999,3
1746572199778,DSC 297,001,958000,Mazumdar; Arya,9998,0,9999,1
1746572199778,DSC 297,002,959862,Wang; Yusu,9998,0,9999,1
1746572200802,EAP 100,A00,905686,Staff,9778,0,9999,221
1746572201828,ECE 45,A01,892618,Staff,0,0,65,65
1746572203880,ECE 111,A01,892719,Staff,5,0,65,60
1746572204905,ECE 197,001,957920,Mercier; Patrick Philip,9991,0,9999,8
1746572205935,ECON 178,A01,907814,Zhu; Ying,26,0,35,9
1746572206960,EDS 115,A00,895312,Staff,35,0,45,10
1746572207986,EDS 117,A01,895337,Staff,23,0,30,7
1746572209012,EDS 125,A00,895341,Jones; Gabrielle Anastasia,36,0,45,9
1746572210041,EDS 128A,A01,895459,Fargason; Sharon Gayle,44,0,45,1
1746572211067,EDS 128B,A01,895543,Pappas; Elizabeth,44,0,45,1
1746572212091,EDS 139,A00,897203,Pappas; Elizabeth,44,0,45,1
1746572212091,EDS 139,B00,897209,Fargason; Sharon Gayle,41,0,45,4
1746572213116,EDS 201,A00,895545,Staff,22,0,45,23
1746572214144,EDS 203,A01,895581,Halter; Christopher P.,22,0,45,23
1746572215168,EDS 204R,A01,895625,Heinzman; Erica M.,39,0,45,6
1746572215168,EDS 204R,B01,895693,Halter; Christopher P.,10,0,45,35
1746572216197,EDS 206R,A00,895694,Fargason; Sharon Gayle,1,0,30,29
1746572216197,EDS 206R,B00,895695,Choi; Bailey Miyeon,16,0,30,14
1746572217223,EDS 250,A00,895697,Hemans; Patricia Ann Benitez,22,0,45,23
1746572218252,EDS 281,A00,895701,Meyerott; Theresa Ann,1,0,15,14
1746572219278,EDS 284,A00,895736,Meyerott; Theresa Ann,1,0,15,14
1746572220305,EDS 286,A00,897210,Fine; Sarah,0,0,15,15
1746572221330,EDS 289C,A01,895770,Daly; Alan J.,1,0,15,14
1746572222356,EDS 290,A00,897211,Hofstetter; Carolyn,0,0,15,15
1746572223385,LIGM 5A,A00,896162,Fischer-Grunski; Eva K,12,0,20,8
1746572224411,LIGM 5B,A00,896260,Fischer-Grunski; Eva K,17,0,20,3
1746572225439,LIGM 5C,A00,896308,Fischer-Grunski; Eva K,18,0,20,2
1746572226464,LIIT 5AS,A00,896313,Carnelos; Chiara,18,0,20,2
1746572227489,LIIT 5BS,A00,896416,Carnelos; Chiara,20,0,20,0
1746572228518,LIIT 5CS,A00,896564,Carnelos; Chiara,20,0,20,0
1746572229542,LISP 5A,A00,896588,Munoz Sanchez; Alicia,2,0,20,18
1746572230567,LISP 5B,A00,896653,Munoz Sanchez; Alicia,7,0,20,13
1746572231593,LISP 5C,A00,896655,Munoz Sanchez; Alicia,0,1,20,20
1746572232617,MAE 197,001,957918,Kleissl; Jan,9996,0,9999,3
1746572232617,MAE 197,002,959806,Boechler; Nicholas Sebastia,9998,0,9999,1
1746572232617,MAE 197,003,959852,Mullin; Jennifer S,9998,0,9999,1
1746572233643,MATH 2,A01,957937,Staff,33,0,35,2
1746572234670,MATH 197,001,957876,Kedlaya; Kiran S.,9993,0,9999,6
1746572235696,MCWP 40,A00,892729,Duru; Nur,10,0,20,10
1746572235696,MCWP 40,B00,893304,Montejo; Carolina,14,0,20,6
1746572236721,MCWP 40R,A00,893757,Redela; Pamela Morgan,0,5,20,20
1746572237748,MCWP 50,A00,893758,Morshed; Michael James,0,0,20,20
1746572237748,MCWP 50,B00,893761,Bartulis; Jason Michael,17,0,20,3
1746572238774,MCWP 50R,A00,893766,Compas; Sean Matthew,0,1,20,20
1746572238774,MCWP 50R,B00,893769,Carter; Jennifer A,0,1,20,20
1746572238774,MCWP 50R,C00,893771,Krone; Jarret,0,3,20,20
1746572238774,MCWP 50R,D00,893772,Miller; Elizabeth Deen,0,0,20,20
1746572238774,MCWP 50R,E00,893775,Carter; Andrea L,0,1,20,20
1746572239801,MMW 11R,A01,892721,Herbst; Matthew,11,0,27,16
1746572239801,MMW 11R,A02,892722,Herbst; Matthew,0,0,0,3
1746572240827,MMW 12R,A01,892724,Herbst; Matthew,0,11,16,16
1746572240827,MMW 12R,A02,892725,Herbst; Matthew,0,10,16,16
1746572241852,MMW 13R,A01,892727,Staff,0,4,16,16
1746572241852,MMW 13R,A02,892728,Staff,0,4,16,16
1746572241852,MMW 13R,A03,958032,Staff,0,4,16,16
1746572241852,MMW 13R,A04,958033,Staff,0,4,16,16
1746572241852,MMW 13R,A05,958034,Staff,0,4,16,16
1746572242877,SIO 295LS,A00,894015,Staff,5,0,25,20
1746572243904,SIO 295S,A00,894020,Staff,5,0,25,20
1746572244931,SIOC 290S,B01,958918,Merrifield; Mark A,14,0,30,16
1746572245956,SIOC 291S,B01,958922,Gabriel; Corey John,14,0,30,16
1746572246982,SOCI 117,A01,895339,Staff,3,0,5,2
1746572248007,WES 237B,A00,894149,Staff,11,0,20,9
1746572250069,AESE 279B,A00,891859,Staff,13,0,35,22
1746572251093,AIP 197,001,891854,Vespa; Emanuel Ignacio,9999,0,9999,0
1746572252121,ANTH 289S,A00,891856,Gagneux; Pascal,12,0,12,0
1746572253146,BENG 196,001,957946,Engler; Adam J.,9996,0,9999,3
1746572254171,BISP 197,001,959851,Wilhelm; James E.,9998,0,9999,1
1746572255197,CAT 124RS,A01,956906,Staff,6,0,25,19
1746572256225,CAT 125RS,A01,922013,Staff,6,0,25,19
1746572257252,CLRE 250,A00,891860,Morris; Sheldon,9995,0,9999,4
1746572259304,CLRE 251R,A00,907817,Mehta; Ravindra L.,9994,0,9999,5
1746572260329,CLRE 252,A00,891864,Cuomo; Raphael Eduardo,9993,0,9999,6
1746572261356,CLRE 253,A00,891867,Vaida; Florin,9994,0,9999,5
1746572261356,CLRE 253,B00,907819,Staff,9999,0,9999,0
1746572262380,CLRE 259,A00,891868,Patel; Hemal,9998,0,9999,1
1746572263405,CLRE 260,A00,891872,Cuomo; Raphael Eduardo,9999,0,9999,0
1746572264434,CLRE 297,001,891888,Cuomo; Raphael Eduardo,9999,0,9999,0
1746572265460,CSE 191,A00,958773,Minnes Kemp; Mor Mia,9995,0,9999,4
1746572266487,CSE 197,001,959846,Minnes Kemp; Mor Mia,9990,0,9999,9
1746572267513,CSS 201S,A01,892054,Mignozzetti; Umberto,25,0,30,5
1746572268539,CSS 202S,A01,892056,Mignozzetti; Umberto,25,0,30,5
1746572269564,DSC 197,001,956898,Eldridge; Justin Matthew,9996,0,9999,3
1746572270589,DSC 297,001,958000,Mazumdar; Arya,9998,0,9999,1
1746572270589,DSC 297,002,959862,Wang; Yusu,9998,0,9999,1
1746572271615,EAP 100,A00,905686,Staff,9778,0,9999,221
1746572272643,ECE 45,A01,892618,Staff,0,0,65,65
1746572274691,ECE 111,A01,892719,Staff,5,0,65,60
1746572275718,ECE 197,001,957920,Mercier; Patrick Philip,9991,0,9999,8
1746572276743,ECON 178,A01,907814,Zhu; Ying,26,0,35,9
1746572277767,EDS 115,A00,895312,Staff,35,0,45,10
1746572278794,EDS 117,A01,895337,Staff,23,0,30,7
1746572279820,EDS 125,A00,895341,Jones; Gabrielle Anastasia,36,0,45,9
1746572280846,EDS 128A,A01,895459,Fargason; Sharon Gayle,44,0,45,1
1746572281872,EDS 128B,A01,895543,Pappas; Elizabeth,44,0,45,1
1746572282897,EDS 139,A00,897203,Pappas; Elizabeth,44,0,45,1
1746572282897,EDS 139,B00,897209,Fargason; Sharon Gayle,41,0,45,4
1746572283923,EDS 201,A00,895545,Staff,22,0,45,23
1746572284951,EDS 203,A01,895581,Halter; Christopher P.,22,0,45,23
1746572285974,EDS 204R,A01,895625,Heinzman; Erica M.,39,0,45,6
1746572285974,EDS 204R,B01,895693,Halter; Christopher P.,10,0,45,35
1746572287004,EDS 206R,A00,895694,Fargason; Sharon Gayle,1,0,30,29
1746572287004,EDS 206R,B00,895695,Choi; Bailey Miyeon,16,0,30,14
1746572288027,EDS 250,A00,895697,Hemans; Patricia Ann Benitez,22,0,45,23
1746572289053,EDS 281,A00,895701,Meyerott; Theresa Ann,1,0,15,14
1746572290078,EDS 284,A00,895736,Meyerott; Theresa Ann,1,0,15,14
1746572291106,EDS 286,A00,897210,Fine; Sarah,0,0,15,15
1746572292133,EDS 289C,A01,895770,Daly; Alan J.,1,0,15,14
1746572293160,EDS 290,A00,897211,Hofstetter; Carolyn,0,0,15,15
1746572294184,LIGM 5A,A00,896162,Fischer-Grunski; Eva K,12,0,20,8
1746572295215,LIGM 5B,A00,896260,Fischer-Grunski; Eva K,17,0,20,3
1746572296242,LIGM 5C,A00,896308,Fischer-Grunski; Eva K,18,0,20,2
1746572297268,LIIT 5AS,A00,896313,Carnelos; Chiara,18,0,20,2
1746572298292,LIIT 5BS,A00,896416,Carnelos; Chiara,20,0,20,0
1746572299319,LIIT 5CS,A00,896564,Carnelos; Chiara,20,0,20,0
1746572300348,LISP 5A,A00,896588,Munoz Sanchez; Alicia,2,0,20,18
1746572301373,LISP 5B,A00,896653,Munoz Sanchez; Alicia,7,0,20,13
1746572302398,LISP 5C,A00,896655,Munoz Sanchez; Alicia,0,1,20,20
1746572303424,MAE 197,001,957918,Kleissl; Jan,9996,0,9999,3
1746572303424,MAE 197,002,959806,Boechler; Nicholas Sebastia,9998,0,9999,1
1746572303424,MAE 197,003,959852,Mullin; Jennifer S,9998,0,9999,1
1746572304452,MATH 2,A01,957937,Staff,33,0,35,2
1746572305479,MATH 197,001,957876,Kedlaya; Kiran S.,9993,0,9999,6
1746572306505,MCWP 40,A00,892729,Duru; Nur,10,0,20,10
1746572306505,MCWP 40,B00,893304,Montejo; Carolina,14,0,20,6
1746572307533,MCWP 40R,A00,893757,Redela; Pamela Morgan,0,5,20,20
1746572308557,MCWP 50,A00,893758,Morshed; Michael James,0,0,20,20
1746572308557,MCWP 50,B00,893761,Bartulis; Jason Michael,17,0,20,3
1746572309582,MCWP 50R,A00,893766,Compas; Sean Matthew,0,1,20,20
1746572309582,MCWP 50R,B00,893769,Carter; Jennifer A,0,1,20,20
1746572309582,MCWP 50R,C00,893771,Krone; Jarret,0,3,20,20
1746572309582,MCWP 50R,D00,893772,Miller; Elizabeth Deen,0,0,20,20
1746572309582,MCWP 50R,E00,893775,Carter; Andrea L,0,1,20,20
1746572310609,MMW 11R,A01,892721,Herbst; Matthew,11,0,27,16
1746572310609,MMW 11R,A02,892722,Herbst; Matthew,0,0,0,3
1746572311634,MMW 12R,A01,892724,Herbst; Matthew,0,11,16,16
1746572311634,MMW 12R,A02,892725,Herbst; Matthew,0,10,16,16
1746572312659,MMW 13R,A01,892727,Staff,0,4,16,16
1746572312659,MMW 13R,A02,892728,Staff,0,4,16,16
1746572312659,MMW 13R,A03,958032,Staff,0,4,16,16
1746572312659,MMW 13R,A04,958033,Staff,0,4,16,16
1746572312659,MMW 13R,A05,958034,Staff,0,4,16,16
1746572313685,SIO 295LS,A00,894015,Staff,5,0,25,20
1746572314709,SIO 295S,A00,894020,Staff,5,0,25,20
1746572315735,SIOC 290S,B01,958918,Merrifield; Mark A,14,0,30,16
1746572316767,SIOC 291S,B01,958922,Gabriel; Corey John,14,0,30,16
1746572317793,SOCI 117,A01,895339,Staff,3,0,5,2
1746572318818,WES 237B,A00,894149,Staff,11,0,20,9
1746572320882,AESE 279B,A00,891859,Staff,13,0,35,22
1746572321910,AIP 197,001,891854,Vespa; Emanuel Ignacio,9999,0,9999,0
1746572322935,ANTH 289S,A00,891856,Gagneux; Pascal,12,0,12,0
1746572323962,BENG 196,001,957946,Engler; Adam J.,9996,0,9999,3
1746572324991,BISP 197,001,959851,Wilhelm; James E.,9998,0,9999,1
1746572326018,CAT 124RS,A01,956906,Staff,6,0,25,19
1746572327055,CAT 125RS,A01,922013,Staff,6,0,25,19
1746572328082,CLRE 250,A00,891860,Morris; Sheldon,9995,0,9999,4
1746572330134,CLRE 251R,A00,907817,Mehta; Ravindra L.,9994,0,9999,5
1746572331159,CLRE 252,A00,891864,Cuomo; Raphael Eduardo,9993,0,9999,6
1746572332184,CLRE 253,A00,891867,Vaida; Florin,9994,0,9999,5
1746572332184,CLRE 253,B00,907819,Staff,9999,0,9999,0
1746572333210,CLRE 259,A00,891868,Patel; Hemal,9998,0,9999,1
1746572334239,CLRE 260,A00,891872,Cuomo; Raphael Eduardo,9999,0,9999,0
1746572335263,CLRE 297,001,891888,Cuomo; Raphael Eduardo,9999,0,9999,0
1746572336291,CSE 191,A00,958773,Minnes Kemp; Mor Mia,9995,0,9999,4
1746572337317,CSE 197,001,959846,Minnes Kemp; Mor Mia,9990,0,9999,9
1746572338342,CSS 201S,A01,892054,Mignozzetti; Umberto,25,0,30,5
1746572339372,CSS 202S,A01,892056,Mignozzetti; Umberto,25,0,30,5
1746572340399,DSC 197,001,956898,Eldridge; Justin Matthew,9996,0,9999,3
1746572341427,DSC 297,001,958000,Mazumdar; Arya,9998,0,9999,1
1746572341427,DSC 297,002,959862,Wang; Yusu,9998,0,9999,1
1746572342453,EAP 100,A00,905686,Staff,9778,0,9999,221
1746572343480,ECE 45,A01,892618,Staff,0,0,65,65
1746572345534,ECE 111,A01,892719,Staff,5,0,65,60
1746572346560,ECE 197,001,957920,Mercier; Patrick Philip,9991,0,9999,8
1746572347588,ECON 178,A01,907814,Zhu; Ying,26,0,35,9
1746572348614,EDS 115,A00,895312,Staff,35,0,45,10
1746572349641,EDS 117,A01,895337,Staff,23,0,30,7
1746572350665,EDS 125,A00,895341,Jones; Gabrielle Anastasia,36,0,45,9
1746572351693,EDS 128A,A01,895459,Fargason; Sharon Gayle,44,0,45,1
1746572352720,EDS 128B,A01,895543,Pappas; Elizabeth,44,0,45,1
1746572353745,EDS 139,A00,897203,Pappas; Elizabeth,44,0,45,1
1746572353745,EDS 139,B00,897209,Fargason; Sharon Gayle,41,0,45,4
1746572354773,EDS 201,A00,895545,Staff,22,0,45,23
1746572355802,EDS 203,A01,895581,Halter; Christopher P.,22,0,45,23
1746572356830,EDS 204R,A01,895625,Heinzman; Erica M.,39,0,45,6
1746572356830,EDS 204R,B01,895693,Halter; Christopher P.,10,0,45,35
1746572357858,EDS 206R,A00,895694,Fargason; Sharon Gayle,1,0,30,29
1746572357858,EDS 206R,B00,895695,Choi; Bailey Miyeon,16,0,30,14
1746572358883,EDS 250,A00,895697,Hemans; Patricia Ann Benitez,22,0,45,23
1746572359908,EDS 281,A00,895701,Meyerott; Theresa Ann,1,0,15,14
1746572360933,EDS 284,A00,895736,Meyerott; Theresa Ann,1,0,15,14
1746572361958,EDS 286,A00,897210,Fine; Sarah,0,0,15,15
1746572362984,EDS 289C,A01,895770,Daly; Alan J.,1,0,15,14
1746572364013,EDS 290,A00,897211,Hofstetter; Carolyn,0,0,15,15
1746572365038,LIGM 5A,A00,896162,Fischer-Grunski; Eva K,12,0,20,8
1746572366065,LIGM 5B,A00,896260,Fischer-Grunski; Eva K,17,0,20,3
1746572367095,LIGM 5C,A00,896308,Fischer-Grunski; Eva K,18,0,20,2
1746572368120,LIIT 5AS,A00,896313,Carnelos; Chiara,18,0,20,2
1746572369147,LIIT 5BS,A00,896416,Carnelos; Chiara,20,0,20,0
1746572370175,LIIT 5CS,A00,896564,Carnelos; Chiara,20,0,20,0
1746572371202,LISP 5A,A00,896588,Munoz Sanchez; Alicia,2,0,20,18
1746572372231,LISP 5B,A00,896653,Munoz Sanchez; Alicia,7,0,20,13
1746572373255,LISP 5C,A00,896655,Munoz Sanchez; Alicia,0,1,20,20
1746572374283,MAE 197,001,957918,Kleissl; Jan,9996,0,9999,3
1746572374283,MAE 197,002,959806,Boechler; Nicholas Sebastia,9998,0,9999,1
1746572374283,MAE 197,003,959852,Mullin; Jennifer S,9998,0,9999,1
1746572375327,MATH 2,A01,957937,Staff,33,0,35,2
1746572376355,MATH 197,001,957876,Kedlaya; Kiran S.,9993,0,9999,6
1746572377382,MCWP 40,A00,892729,Duru; Nur,10,0,20,10
1746572377382,MCWP 40,B00,893304,Montejo; Carolina,14,0,20,6
1746572378407,MCWP 40R,A00,893757,Redela; Pamela Morgan,0,5,20,20
1746572379435,MCWP 50,A00,893758,Morshed; Michael James,0,0,20,20
1746572379435,MCWP 50,B00,893761,Bartulis; Jason Michael,17,0,20,3
1746572380459,MCWP 50R,A00,893766,Compas; Sean Matthew,0,1,20,20
1746572380459,MCWP 50R,B00,893769,Carter; Jennifer A,0,1,20,20
1746572380459,MCWP 50R,C00,893771,Krone; Jarret,0,3,20,20
1746572380459,MCWP 50R,D00,893772,Miller; Elizabeth Deen,0,0,20,20
1746572380459,MCWP 50R,E00,893775,Carter; Andrea L,0,1,20,20
1746572381483,MMW 11R,A01,892721,Herbst; Matthew,11,0,27,16
1746572381483,MMW 11R,A02,892722,Herbst; Matthew,0,0,0,3
1746572382509,MMW 12R,A01,892724,Herbst; Matthew,0,11,16,16
1746572382509,MMW 12R,A02,892725,Herbst; Matthew,0,10,16,16
1746572383535,MMW 13R,A01,892727,Staff,0,4,16,16
1746572383535,MMW 13R,A02,892728,Staff,0,4,16,16
1746572383535,MMW 13R,A03,958032,Staff,0,4,16,16
1746572383535,MMW 13R,A04,958033,Staff,0,4,16,16
1746572383535,MMW 13R,A05,958034,Staff,0,4,16,16
1746572384560,SIO 295LS,A00,894015,Staff,5,0,25,20
1746572385584,SIO 295S,A00,894020,Staff,5,0,25,20
1746572386613,SIOC 290S,B01,958918,Merrifield; Mark A,14,0,30,16
1746572387639,SIOC 291S,B01,958922,Gabriel; Corey John,14,0,30,16
1746572388667,SOCI 117,A01,895339,Staff,3,0,5,2
1746572389692,WES 237B,A00,894149,Staff,11,0,20,9
1746572391759,AESE 279B,A00,891859,Staff,13,0,35,22
1746572392786,AIP 197,001,891854,Vespa; Emanuel Ignacio,9999,0,9999,0
1746572393810,ANTH 289S,A00,891856,Gagneux; Pascal,12,0,12,0
1746572394835,BENG 196,001,957946,Engler; Adam J.,9996,0,9999,3
1746572395860,BISP 197,001,959851,Wilhelm; James E.,9998,0,9999,1
1746572396888,CAT 124RS,A01,956906,Staff,6,0,25,19
1746572397915,CAT 125RS,A01,922013,Staff,6,0,25,19
1746572398943,CLRE 250,A00,891860,Morris; Sheldon,9995,0,9999,4
1746572400992,CLRE 251R,A00,907817,Mehta; Ravindra L.,9994,0,9999,5
1746572402019,CLRE 252,A00,891864,Cuomo; Raphael Eduardo,9993,0,9999,6
1746572403044,CLRE 253,A00,891867,Vaida; Florin,9994,0,9999,5
1746572403044,CLRE 253,B00,907819,Staff,9999,0,9999,0
1746572404069,CLRE 259,A00,891868,Patel; Hemal,9998,0,9999,1
1746572405095,CLRE 260,A00,891872,Cuomo; Raphael Eduardo,9999,0,9999,0
1746572406119,CLRE 297,001,891888,Cuomo; Raphael Eduardo,9999,0,9999,0
1746572407182,CSE 191,A00,958773,Minnes Kemp; Mor Mia,9995,0,9999,4
1746572408208,CSE 197,001,959846,Minnes Kemp; Mor Mia,9990,0,9999,9
1746572409233,CSS 201S,A01,892054,Mignozzetti; Umberto,25,0,30,5
1746572410261,CSS 202S,A01,892056,Mignozzetti; Umberto,25,0,30,5
1746572411289,DSC 197,001,956898,Eldridge; Justin Matthew,9996,0,9999,3
1746572412317,DSC 297,001,958000,Mazumdar; Arya,9998,0,9999,1
1746572412317,DSC 297,002,959862,Wang; Yusu,9998,0,9999,1
1746572413343,EAP 100,A00,905686,Staff,9778,0,9999,221
1746572414373,ECE 45,A01,892618,Staff,0,0,65,65
1746572416422,ECE 111,A01,892719,Staff,5,0,65,60
1746572417450,ECE 197,001,957920,Mercier; Patrick Philip,9991,0,9999,8
1746572418476,ECON 178,A01,907814,Zhu; Ying,26,0,35,9
1746572419502,EDS 115,A00,895312,Staff,35,0,45,10
1746572420527,EDS 117,A01,895337,Staff,23,0,30,7
1746572421552,EDS 125,A00,895341,Jones; Gabrielle Anastasia,36,0,45,9
1746572422577,EDS 128A,A01,895459,Fargason; Sharon Gayle,44,0,45,1
1746572423603,EDS 128B,A01,895543,Pappas; Elizabeth,44,0,45,1
1746572424629,EDS 139,A00,897203,Pappas; Elizabeth,44,0,45,1
1746572424629,EDS 139,B00,897209,Fargason; Sharon Gayle,41,0,45,4
1746572425654,EDS 201,A00,895545,Staff,22,0,45,23
1746572426678,EDS 203,A01,895581,Halter; Christopher P.,22,0,45,23
1746572427704,EDS 204R,A01,895625,Heinzman; Erica M.,39,0,45,6
1746572427704,EDS 204R,B01,895693,Halter; Christopher P.,10,0,45,35
1746572428732,EDS 206R,A00,895694,Fargason; Sharon Gayle,1,0,30,29
1746572428732,EDS 206R,B00,895695,Choi; Bailey Miyeon,16,0,30,14
1746572429762,EDS 250,A00,895697,Hemans; Patricia Ann Benitez,22,0,45,23
1746572430789,EDS 281,A00,895701,Meyerott; Theresa Ann,1,0,15,14
1746572431813,EDS 284,A00,895736,Meyerott; Theresa Ann,1,0,15,14
1746572432839,EDS 286,A00,897210,Fine; Sarah,0,0,15,15
1746572433865,EDS 289C,A01,895770,Daly; Alan J.,1,0,15,14
1746572434891,EDS 290,A00,897211,Hofstetter; Carolyn,0,0,15,15
1746572435917,LIGM 5A,A00,896162,Fischer-Grunski; Eva K,12,0,20,8
1746572436942,LIGM 5B,A00,896260,Fischer-Grunski; Eva K,17,0,20,3
1746572437971,LIGM 5C,A00,896308,Fischer-Grunski; Eva K,18,0,20,2
1746572438997,LIIT 5AS,A00,896313,Carnelos; Chiara,18,0,20,2
1746572440024,LIIT 5BS,A00,896416,Carnelos; Chiara,20,0,20,0
1746572441050,LIIT 5CS,A00,896564,Carnelos; Chiara,20,0,20,0
1746572442078,LISP 5A,A00,896588,Munoz Sanchez; Alicia,2,0,20,18
1746572443104,LISP 5B,A00,896653,Munoz Sanchez; Alicia,7,0,20,13
1746572444131,LISP 5C,A00,896655,Munoz Sanchez; Alicia,0,1,20,20
1746572445157,MAE 197,001,957918,Kleissl; Jan,9996,0,9999,3
1746572445157,MAE 197,002,959806,Boechler; Nicholas Sebastia,9998,0,9999,1
1746572445157,MAE 197,003,959852,Mullin; Jennifer S,9998,0,9999,1
1746572446181,MATH 2,A01,957937,Staff,33,0,35,2
1746572447206,MATH 197,001,957876,Kedlaya; Kiran S.,9993,0,9999,6
1746572448230,MCWP 40,A00,892729,Duru; Nur,10,0,20,10
1746572448230,MCWP 40,B00,893304,Montejo; Carolina,14,0,20,6
1746572449254,MCWP 40R,A00,893757,Redela; Pamela Morgan,0,5,20,20
1746572450279,MCWP 50,A00,893758,Morshed; Michael James,0,0,20,20
1746572450279,MCWP 50,B00,893761,Bartulis; Jason Michael,17,0,20,3
1746572451305,MCWP 50R,A00,893766,Compas; Sean Matthew,0,1,20,20
1746572451305,MCWP 50R,B00,893769,Carter; Jennifer A,0,1,20,20
1746572451305,MCWP 50R,C00,893771,Krone; Jarret,0,3,20,20
1746572451305,MCWP 50R,D00,893772,Miller; Elizabeth Deen,0,0,20,20
1746572451305,MCWP 50R,E00,893775,Carter; Andrea L,0,1,20,20
1746572452330,MMW 11R,A01,892721,Herbst; Matthew,11,0,27,16
1746572452330,MMW 11R,A02,892722,Herbst; Matthew,0,0,0,3
1746572453354,MMW 12R,A01,892724,Herbst; Matthew,0,11,16,16
1746572453354,MMW 12R,A02,892725,Herbst; Matthew,0,10,16,16
1746572454379,MMW 13R,A01,892727,Staff,0,4,16,16
1746572454379,MMW 13R,A02,892728,Staff,0,4,16,16
1746572454379,MMW 13R,A03,958032,Staff,0,4,16,16
1746572454379,MMW 13R,A04,958033,Staff,0,4,16,16
1746572454379,MMW 13R,A05,958034,Staff,0,4,16,16
1746572455405,SIO 295LS,A00,894015,Staff,5,0,25,20
1746572456429,SIO 295S,A00,894020,Staff,5,0,25,20
1746572457456,SIOC 290S,B01,958918,Merrifield; Mark A,14,0,30,16
1746572458485,SIOC 291S,B01,958922,Gabriel; Corey John,14,0,30,16
1746572459510,SOCI 117,A01,895339,Staff,3,0,5,2
1746572460533,WES 237B,A00,894149,Staff,11,0,20,9
1746572462602,AESE 279B,A00,891859,Staff,13,0,35,22
1746572463627,AIP 197,001,891854,Vespa; Emanuel Ignacio,9999,0,9999,0
1746572464654,ANTH 289S,A00,891856,Gagneux; Pascal,12,0,12,0
1746572465679,BENG 196,001,957946,Engler; Adam J.,9996,0,9999,3
1746572466705,BISP 197,001,959851,Wilhelm; James E.,9998,0,9999,1
1746572467731,CAT 124RS,A01,956906,Staff,6,0,25,19
1746572468759,CAT 125RS,A01,922013,Staff,6,0,25,19
1746572469784,CLRE 250,A00,891860,Morris; Sheldon,9995,0,9999,4
1746572471843,CLRE 251R,A00,907817,Mehta; Ravindra L.,9994,0,9999,5
1746572472870,CLRE 252,A00,891864,Cuomo; Raphael Eduardo,9993,0,9999,6
1746572473901,CLRE 253,A00,891867,Vaida; Florin,9994,0,9999,5
1746572473901,CLRE 253,B00,907819,Staff,9999,0,9999,0
1746572474929,CLRE 259,A00,891868,Patel; Hemal,9998,0,9999,1
1746572475956,CLRE 260,A00,891872,Cuomo; Raphael Eduardo,9999,0,9999,0
1746572476985,CLRE 297,001,891888,Cuomo; Raphael Eduardo,9999,0,9999,0
1746572478016,CSE 191,A00,958773,Minnes Kemp; Mor Mia,9995,0,9999,4
1746572479040,CSE 197,001,959846,Minnes Kemp; Mor Mia,9990,0,9999,9
1746572480070,CSS 201S,A01,892054,Mignozzetti; Umberto,25,0,30,5
1746572481098,CSS 202S,A01,892056,Mignozzetti; Umberto,25,0,30,5
1746572482125,DSC 197,001,956898,Eldridge; Justin Matthew,9996,0,9999,3
1746572483151,DSC 297,001,958000,Mazumdar; Arya,9998,0,9999,1
1746572483151,DSC 297,002,959862,Wang; Yusu,9998,0,9999,1
1746572484177,EAP 100,A00,905686,Staff,9778,0,9999,221
1746572485202,ECE 45,A01,892618,Staff,0,0,65,65
1746572487254,ECE 111,A01,892719,Staff,5,0,65,60
1746572488282,ECE 197,001,957920,Mercier; Patrick Philip,9991,0,9999,8
1746572489308,ECON 178,A01,907814,Zhu; Ying,26,0,35,9
1746572490335,EDS 115,A00,895312,Staff,35,0,45,10
1746572491361,EDS 117,A01,895337,Staff,23,0,30,7
1746572492387,EDS 125,A00,895341,Jones; Gabrielle Anastasia,36,0,45,9
1746572493411,EDS 128A,A01,895459,Fargason; Sharon Gayle,44,0,45,1
1746572494435,EDS 128B,A01,895543,Pappas; Elizabeth,44,0,45,1
1746572495458,EDS 139,A00,897203,Pappas; Elizabeth,44,0,45,1
1746572495458,EDS 139,B00,897209,Fargason; Sharon Gayle,41,0,45,4
1746572496484,EDS 201,A00,895545,Staff,22,0,45,23
1746572497511,EDS 203,A01,895581,Halter; Christopher P.,22,0,45,23
1746572498537,EDS 204R,A01,895625,Heinzman; Erica M.,39,0,45,6
1746572498537,EDS 204R,B01,895693,Halter; Christopher P.,10,0,45,35
1746572499566,EDS 206R,A00,895694,Fargason; Sharon Gayle,1,0,30,29
1746572499566,EDS 206R,B00,895695,Choi; Bailey Miyeon,16,0,30,14
1746572500594,EDS 250,A00,895697,Hemans; Patricia Ann Benitez,22,0,45,23
1746572501622,EDS 281,A00,895701,Meyerott; Theresa Ann,1,0,15,14
1746572502647,EDS 284,A00,895736,Meyerott; Theresa Ann,1,0,15,14
1746572503674,EDS 286,A00,897210,Fine; Sarah,0,0,15,15
1746572504702,EDS 289C,A01,895770,Daly; Alan J.,1,0,15,14
1746572505728,EDS 290,A00,897211,Hofstetter; Carolyn,0,0,15,15
1746572506755,LIGM 5A,A00,896162,Fischer-Grunski; Eva K,12,0,20,8
1746572507781,LIGM 5B,A00,896260,Fischer-Grunski; Eva K,17,0,20,3
1746572508810,LIGM 5C,A00,896308,Fischer-Grunski; Eva K,18,0,20,2
1746572509839,LIIT 5AS,A00,896313,Carnelos; Chiara,18,0,20,2
1746572510866,LIIT 5BS,A00,896416,Carnelos; Chiara,20,0,20,0
1746572511892,LIIT 5CS,A00,896564,Carnelos; Chiara,20,0,20,0
1746572512918,LISP 5A,A00,896588,Munoz Sanchez; Alicia,2,0,20,18
1746572513943,LISP 5B,A00,896653,Munoz Sanchez; Alicia,7,0,20,13
1746572514967,LISP 5C,A00,896655,Munoz Sanchez; Alicia,0,1,20,20
1746572515992,MAE 197,001,957918,Kleissl; Jan,9996,0,9999,3
1746572515992,MAE 197,002,959806,Boechler; Nicholas Sebastia,9998,0,9999,1
1746572515992,MAE 197,003,959852,Mullin; Jennifer S,9998,0,9999,1
1746572517017,MATH 2,A01,957937,Staff,33,0,35,2
1746572518044,MATH 197,001,957876,Kedlaya; Kiran S.,9993,0,9999,6
1746572519068,MCWP 40,A00,892729,Duru; Nur,10,0,20,10
1746572519068,MCWP 40,B00,893304,Montejo; Carolina,14,0,20,6
1746572520096,MCWP 40R,A00,893757,Redela; Pamela Morgan,0,5,20,20
1746572521123,MCWP 50,A00,893758,Morshed; Michael James,0,0,20,20
1746572521123,MCWP 50,B00,893761,Bartulis; Jason Michael,17,0,20,3
1746572522149,MCWP 50R,A00,893766,Compas; Sean Matthew,0,1,20,20
1746572522149,MCWP 50R,B00,893769,Carter; Jennifer A,0,1,20,20
1746572522149,MCWP 50R,C00,893771,Krone; Jarret,0,3,20,20
1746572522149,MCWP 50R,D00,893772,Miller; Elizabeth Deen,0,0,20,20
1746572522149,MCWP 50R,E00,893775,Carter; Andrea L,0,1,20,20
1746572523176,MMW 11R,A01,892721,Herbst; Matthew,11,0,27,16
1746572523176,MMW 11R,A02,892722,Herbst; Matthew,0,0,0,3
1746572524203,MMW 12R,A01,892724,Herbst; Matthew,0,11,16,16
1746572524203,MMW 12R,A02,892725,Herbst; Matthew,0,10,16,16
1746572525235,MMW 13R,A01,892727,Staff,0,4,16,16
1746572525235,MMW 13R,A02,892728,Staff,0,4,16,16
1746572525235,MMW 13R,A03,958032,Staff,0,4,16,16
1746572525235,MMW 13R,A04,958033,Staff,0,4,16,16
1746572525235,MMW 13R,A05,958034,Staff,0,4,16,16
1746572526263,SIO 295LS,A00,894015,Staff,5,0,25,20
1746572527292,SIO 295S,A00,894020,Staff,5,0,25,20
1746572528318,SIOC 290S,B01,958918,Merrifield; Mark A,14,0,30,16
1746572529344,SIOC 291S,B01,958922,Gabriel; Corey John,14,0,30,16
1746572530369,SOCI 117,A01,895339,Staff,3,0,5,2
1746572531397,WES 237B,A00,894149,Staff,11,0,20,9
1746572533460,AESE 279B,A00,891859,Staff,13,0,35,22
1746572534484,AIP 197,001,891854,Vespa; Emanuel Ignacio,9999,0,9999,0
1746572535509,ANTH 289S,A00,891856,Gagneux; Pascal,12,0,12,0
1746572536536,BENG 196,001,957946,Engler; Adam J.,9996,0,9999,3
1746572537561,BISP 197,001,959851,Wilhelm; James E.,9998,0,9999,1
1746572538589,CAT 124RS,A01,956906,Staff,6,0,25,19
1746572539614,CAT 125RS,A01,922013,Staff,6,0,25,19
1746572540642,CLRE 250,A00,891860,Morris; Sheldon,9995,0,9999,4
1746572542693,CLRE 251R,A00,907817,Mehta; Ravindra L.,9994,0,9999,5
1746572543717,CLRE 252,A00,891864,Cuomo; Raphael Eduardo,9993,0,9999,6
1746572544747,CLRE 253,A00,891867,Vaida; Florin,9994,0,9999,5
1746572544747,CLRE 253,B00,907819,Staff,9999,0,9999,0
1746572545773,CLRE 259,A00,891868,Patel; Hemal,9998,0,9999,1
1746572546803,CLRE 260,A00,891872,Cuomo; Raphael Eduardo,9999,0,9999,0
1746572547827,CLRE 297,001,891888,Cuomo; Raphael Eduardo,9999,0,9999,0
1746572548855,CSE 191,A00,958773,Minnes Kemp; Mor Mia,9995,0,9999,4
1746572549880,CSE 197,001,959846,Minnes Kemp; Mor Mia,9990,0,9999,9
1746572550905,CSS 201S,A01,892054,Mignozzetti; Umberto,25,0,30,5
1746572551932,CSS 202S,A01,892056,Mignozzetti; Umberto,25,0,30,5
1746572552961,DSC 197,001,956898,Eldridge; Justin Matthew,9996,0,9999,3
1746572553985,DSC 297,001,958000,Mazumdar; Arya,9998,0,9999,1
1746572553985,DSC 297,002,959862,Wang; Yusu,9998,0,9999,1
1746572555017,EAP 100,A00,905686,Staff,9778,0,9999,221
1746572556046,ECE 45,A01,892618,Staff,0,0,65,65
1746572558096,ECE 111,A01,892719,Staff,5,0,65,60
1746572559123,ECE 197,001,957920,Mercier; Patrick Philip,9991,0,9999,8
1746572560151,ECON 178,A01,907814,Zhu; Ying,26,0,35,9
1746572561181,EDS 115,A00,895312,Staff,35,0,45,10
1746572562209,EDS 117,A01,895337,Staff,23,0,30,7
1746572563238,EDS 125,A00,895341,Jones; Gabrielle Anastasia,36,0,45,9
1746572564263,EDS 128A,A01,895459,Fargason; Sharon Gayle,44,0,45,1
1746572565288,EDS 128B,A01,895543,Pappas; Elizabeth,44,0,45,1
1746572566317,EDS 139,A00,897203,Pappas; Elizabeth,44,0,45,1
1746572566317,EDS 139,B00,897209,Fargason; Sharon Gayle,41,0,45,4
1746572567343,EDS 201,A00,895545,Staff,22,0,45,23
1746572568367,EDS 203,A01,895581,Halter; Christopher P.,22,0,45,23
1746572569396,EDS 204R,A01,895625,Heinzman; Erica M.,39,0,45,6
1746572569396,EDS 204R,B01,895693,Halter; Christopher P.,10,0,45,35
1746572570424,EDS 206R,A00,895694,Fargason; Sharon Gayle,1,0,30,29
1746572570424,EDS 206R,B00,895695,Choi; Bailey Miyeon,16,0,30,14
1746572571451,EDS 250,A00,895697,Hemans; Patricia Ann Benitez,22,0,45,23
1746572572478,EDS 281,A00,895701,Meyerott; Theresa Ann,1,0,15,14
1746572573504,EDS 284,A00,895736,Meyerott; Theresa Ann,1,0,15,14
1746572574532,EDS 286,A00,897210,Fine; Sarah,0,0,15,15
1746572575561,EDS 289C,A01,895770,Daly; Alan J.,1,0,15,14
1746572576589,EDS 290,A00,897211,Hofstetter; Carolyn,0,0,15,15
1746572577611,LIGM 5A,A00,896162,Fischer-Grunski; Eva K,12,0,20,8
1746572578640,LIGM 5B,A00,896260,Fischer-Grunski; Eva K,17,0,20,3
1746572579664,LIGM 5C,A00,896308,Fischer-Grunski; Eva K,18,0,20,2
1746572580693,LIIT 5AS,A00,896313,Carnelos; Chiara,18,0,20,2
1746572581724,LIIT 5BS,A00,896416,Carnelos; Chiara,20,0,20,0
1746572582753,LIIT 5CS,A00,896564,Carnelos; Chiara,20,0,20,0
1746572583778,LISP 5A,A00,896588,Munoz Sanchez; Alicia,2,0,20,18
1746572584802,LISP 5B,A00,896653,Munoz Sanchez; Alicia,7,0,20,13
1746572585826,LISP 5C,A00,896655,Munoz Sanchez; Alicia,0,1,20,20
1746572586851,MAE 197,001,957918,Kleissl; Jan,9996,0,9999,3
1746572586851,MAE 197,002,959806,Boechler; Nicholas Sebastia,9998,0,9999,1
1746572586851,MAE 197,003,959852,Mullin; Jennifer S,9998,0,9999,1
1746572587880,MATH 2,A01,957937,Staff,33,0,35,2
1746572588905,MATH 197,001,957876,Kedlaya; Kiran S.,9993,0,9999,6
1746572589933,MCWP 40,A00,892729,Duru; Nur,10,0,20,10
1746572589933,MCWP 40,B00,893304,Montejo; Carolina,14,0,20,6
1746572590958,MCWP 40R,A00,893757,Redela; Pamela Morgan,0,5,20,20
1746572591984,MCWP 50,A00,893758,Morshed; Michael James,0,0,20,20
1746572591984,MCWP 50,B00,893761,Bartulis; Jason Michael,17,0,20,3
1746572593010,MCWP 50R,A00,893766,Compas; Sean Matthew,0,1,20,20
1746572593010,MCWP 50R,B00,893769,Carter; Jennifer A,0,1,20,20
1746572593010,MCWP 50R,C00,893771,Krone; Jarret,0,3,20,20
1746572593010,MCWP 50R,D00,893772,Miller; Elizabeth Deen,0,0,20,20
1746572593010,MCWP 50R,E00,893775,Carter; Andrea L,0,1,20,20
1746572594033,MMW 11R,A01,892721,Herbst; Matthew,11,0,27,16
1746572594033,MMW 11R,A02,892722,Herbst; Matthew,0,0,0,3
1746572595060,MMW 12R,A01,892724,Herbst; Matthew,0,11,16,16
1746572595060,MMW 12R,A02,892725,Herbst; Matthew,0,10,16,16
1746572596085,MMW 13R,A01,892727,Staff,0,4,16,16
1746572596085,MMW 13R,A02,892728,Staff,0,4,16,16
1746572596085,MMW 13R,A03,958032,Staff,0,4,16,16
1746572596085,MMW 13R,A04,958033,Staff,0,4,16,16
1746572596085,MMW 13R,A05,958034,Staff,0,4,16,16
1746572597109,SIO 295LS,A00,894015,Staff,5,0,25,20
1746572598135,SIO 295S,A00,894020,Staff,5,0,25,20
1746572599166,SIOC 290S,B01,958918,Merrifield; Mark A,14,0,30,16
1746572600195,SIOC 291S,B01,958922,Gabriel; Corey John,14,0,30,16
1746572601220,SOCI 117,A01,895339,Staff,3,0,5,2
1746572602247,WES 237B,A00,894149,Staff,11,0,20,9
1746572604309,AESE 279B,A00,891859,Staff,13,0,35,22
1746572605346,AIP 197,001,891854,Vespa; Emanuel Ignacio,9999,0,9999,0
1746572606372,ANTH 289S,A00,891856,Gagneux; Pascal,12,0,12,0
1746572607397,BENG 196,001,957946,Engler; Adam J.,9996,0,9999,3
1746572608424,BISP 197,001,959851,Wilhelm; James E.,9998,0,9999,1
1746572609447,CAT 124RS,A01,956906,Staff,6,0,25,19
1746572610475,CAT 125RS,A01,922013,Staff,6,0,25,19
1746572611501,CLRE 250,A00,891860,Morris; Sheldon,9995,0,9999,4
1746572613549,CLRE 251R,A00,907817,Mehta; Ravindra L.,9994,0,9999,5
1746572614577,CLRE 252,A00,891864,Cuomo; Raphael Eduardo,9993,0,9999,6
1746572615604,CLRE 253,A00,891867,Vaida; Florin,9994,0,9999,5
1746572615604,CLRE 253,B00,907819,Staff,9999,0,9999,0
1746572616630,CLRE 259,A00,891868,Patel; Hemal,9998,0,9999,1
1746572617656,CLRE 260,A00,891872,Cuomo; Raphael Eduardo,9999,0,9999,0
1746572618682,CLRE 297,001,891888,Cuomo; Raphael Eduardo,9999,0,9999,0
1746572619708,CSE 191,A00,958773,Minnes Kemp; Mor Mia,9995,0,9999,4
1746572620731,CSE 197,001,959846,Minnes Kemp; Mor Mia,9990,0,9999,9
1746572621757,CSS 201S,A01,892054,Mignozzetti; Umberto,25,0,30,5
1746572622783,CSS 202S,A01,892056,Mignozzetti; Umberto,25,0,30,5
1746572623810,DSC 197,001,956898,Eldridge; Justin Matthew,9996,0,9999,3
1746572624837,DSC 297,001,958000,Mazumdar; Arya,9998,0,9999,1
1746572624837,DSC 297,002,959862,Wang; Yusu,9998,0,9999,1
1746572625861,EAP 100,A00,905686,Staff,9778,0,9999,221
1746572626888,ECE 45,A01,892618,Staff,0,0,65,65
1746572628941,ECE 111,A01,892719,Staff,5,0,65,60
1746572629965,ECE 197,001,957920,Mercier; Patrick Philip,9991,0,9999,8
1746572630991,ECON 178,A01,907814,Zhu; Ying,26,0,35,9
1746572632017,EDS 115,A00,895312,Staff,35,0,45,10
1746572633042,EDS 117,A01,895337,Staff,23,0,30,7
1746572634068,EDS 125,A00,895341,Jones; Gabrielle Anastasia,36,0,45,9
1746572635094,EDS 128A,A01,895459,Fargason; Sharon Gayle,44,0,45,1
1746572636120,EDS 128B,A01,895543,Pappas; Elizabeth,44,0,45,1
1746572637148,EDS 139,A00,897203,Pappas; Elizabeth,44,0,45,1
1746572637148,EDS 139,B00,897209,Fargason; Sharon Gayle,41,0,45,4
1746572638173,EDS 201,A00,895545,Staff,22,0,45,23
1746572639199,EDS 203,A01,895581,Halter; Christopher P.,22,0,45,23
1746572640228,EDS 204R,A01,895625,Heinzman; Erica M.,39,0,45,6
1746572640228,EDS 204R,B01,895693,Halter; Christopher P.,10,0,45,35
1746572641256,EDS 206R,A00,895694,Fargason; Sharon Gayle,1,0,30,29
1746572641256,EDS 206R,B00,895695,Choi; Bailey Miyeon,16,0,30,14
1746572642281,EDS 250,A00,895697,Hemans; Patricia Ann Benitez,22,0,45,23
1746572643306,EDS 281,A00,895701,Meyerott; Theresa Ann,1,0,15,14
1746572644333,EDS 284,A00,895736,Meyerott; Theresa Ann,1,0,15,14
1746572645363,EDS 286,A00,897210,Fine; Sarah,0,0,15,15
1746572646391,EDS 289C,A01,895770,Daly; Alan J.,1,0,15,14
1746572647418,EDS 290,A00,897211,Hofstetter; Carolyn,0,0,15,15
1746572648447,LIGM 5A,A00,896162,Fischer-Grunski; Eva K,12,0,20,8
1746572649479,LIGM 5B,A00,896260,Fischer-Grunski; Eva K,17,0,20,3
1746572650523,LIGM 5C,A00,896308,Fischer-Grunski; Eva K,18,0,20,2
1746572651549,LIIT 5AS,A00,896313,Carnelos; Chiara,18,0,20,2
1746572652573,LIIT 5BS,A00,896416,Carnelos; Chiara,20,0,20,0
1746572653599,LIIT 5CS,A00,896564,Carnelos; Chiara,20,0,20,0
1746572654623,LISP 5A,A00,896588,Munoz Sanchez; Alicia,2,0,20,18
1746572655653,LISP 5B,A00,896653,Munoz Sanchez; Alicia,7,0,20,13
1746572656683,LISP 5C,A00,896655,Munoz Sanchez; Alicia,0,1,20,20
1746572657706,MAE 197,001,957918,Kleissl; Jan,9996,0,9999,3
1746572657706,MAE 197,002,959806,Boechler; Nicholas Sebastia,9998,0,9999,1
1746572657706,MAE 197,003,959852,Mullin; Jennifer S,9998,0,9999,1
1746572658735,MATH 2,A01,957937,Staff,33,0,35,2
1746572659758,MATH 197,001,957876,Kedlaya; Kiran S.,9993,0,9999,6
1746572660785,MCWP 40,A00,892729,Duru; Nur,10,0,20,10
1746572660785,MCWP 40,B00,893304,Montejo; Carolina,14,0,20,6
1746572661810,MCWP 40R,A00,893757,Redela; Pamela Morgan,0,5,20,20
1746572662843,MCWP 50,A00,893758,Morshed; Michael James,0,0,20,20
1746572662843,MCWP 50,B00,893761,Bartulis; Jason Michael,17,0,20,3
1746572663869,MCWP 50R,A00,893766,Compas; Sean Matthew,0,1,20,20
1746572663869,MCWP 50R,B00,893769,Carter; Jennifer A,0,1,20,20
1746572663869,MCWP 50R,C00,893771,Krone; Jarret,0,3,20,20
1746572663869,MCWP 50R,D00,893772,Miller; Elizabeth Deen,0,0,20,20
1746572663869,MCWP 50R,E00,893775,Carter; Andrea L,0,1,20,20
1746572664894,MMW 11R,A01,892721,Herbst; Matthew,11,0,27,16
1746572664894,MMW 11R,A02,892722,Herbst; Matthew,0,0,0,3
1746572665921,MMW 12R,A01,892724,Herbst; Matthew,0,11,16,16
1746572665921,MMW 12R,A02,892725,Herbst; Matthew,0,10,16,16
1746572666948,MMW 13R,A01,892727,Staff,0,4,16,16
1746572666948,MMW 13R,A02,892728,Staff,0,4,16,16
1746572666948,MMW 13R,A03,958032,Staff,0,4,16,16
1746572666948,MMW 13R,A04,958033,Staff,0,4,16,16
1746572666948,MMW 13R,A05,958034,Staff,0,4,16,16
1746572667977,SIO 295LS,A00,894015,Staff,5,0,25,20
1746572669001,SIO 295S,A00,894020,Staff,5,0,25,20
1746572670025,SIOC 290S,B01,958918,Merrifield; Mark A,14,0,30,16
1746572671052,SIOC 291S,B01,958922,Gabriel; Corey John,14,0,30,16
1746572672075,SOCI 117,A01,895339,Staff,3,0,5,2
1746572673099,WES 237B,A00,894149,Staff,11,0,20,9
1746572675154,AESE 279B,A00,891859,Staff,13,0,35,22
1746572676179,AIP 197,001,891854,Vespa; Emanuel Ignacio,9999,0,9999,0
1746572677202,ANTH 289S,A00,891856,Gagneux; Pascal,12,0,12,0
1746572678231,BENG 196,001,957946,Engler; Adam J.,9996,0,9999,3
1746572679255,BISP 197,001,959851,Wilhelm; James E.,9998,0,9999,1
1746572680281,CAT 124RS,A01,956906,Staff,6,0,25,19
1746572681305,CAT 125RS,A01,922013,Staff,6,0,25,19
1746572682335,CLRE 250,A00,891860,Morris; Sheldon,9995,0,9999,4
1746572684383,CLRE 251R,A00,907817,Mehta; Ravindra L.,9994,0,9999,5
1746572685413,CLRE 252,A00,891864,Cuomo; Raphael Eduardo,9993,0,9999,6
1746572686440,CLRE 253,A00,891867,Vaida; Florin,9994,0,9999,5
1746572686440,CLRE 253,B00,907819,Staff,9999,0,9999,0
1746572687471,CLRE 259,A00,891868,Patel; Hemal,9998,0,9999,1
1746572688496,CLRE 260,A00,891872,Cuomo; Raphael Eduardo,9999,0,9999,0
1746572689522,CLRE 297,001,891888,Cuomo; Raphael Eduardo,9999,0,9999,0
1746572690547,CSE 191,A00,958773,Minnes Kemp; Mor Mia,9995,0,9999,4
1746572691571,CSE 197,001,959846,Minnes Kemp; Mor Mia,9990,0,9999,9
1746572692598,CSS 201S,A01,892054,Mignozzetti; Umberto,25,0,30,5
1746572693626,CSS 202S,A01,892056,Mignozzetti; Umberto,25,0,30,5
1746572694654,DSC 197,001,956898,Eldridge; Justin Matthew,9996,0,9999,3
1746572695682,DSC 297,001,958000,Mazumdar; Arya,9998,0,9999,1
1746572695682,DSC 297,002,959862,Wang; Yusu,9998,0,9999,1
1746572696708,EAP 100,A00,905686,Staff,9778,0,9999,221
1746572697734,ECE 45,A01,892618,Staff,0,0,65,65
1746572699788,ECE 111,A01,892719,Staff,5,0,65,60
1746572700825,ECE 197,001,957920,Mercier; Patrick Philip,9991,0,9999,8
1746572701853,ECON 178,A01,907814,Zhu; Ying,26,0,35,9
1746572702879,EDS 115,A00,895312,Staff,35,0,45,10
1746572703911,EDS 117,A01,895337,Staff,23,0,30,7
1746572704938,EDS 125,A00,895341,Jones; Gabrielle Anastasia,36,0,45,9
1746572705966,EDS 128A,A01,895459,Fargason; Sharon Gayle,44,0,45,1
1746572706995,EDS 128B,A01,895543,Pappas; Elizabeth,44,0,45,1
1746572708019,EDS 139,A00,897203,Pappas; Elizabeth,44,0,45,1
1746572708019,EDS 139,B00,897209,Fargason; Sharon Gayle,41,0,45,4
1746572709047,EDS 201,A00,895545,Staff,22,0,45,23
1746572710073,EDS 203,A01,895581,Halter; Christopher P.,22,0,45,23
1746572711103,EDS 204R,A01,895625,Heinzman; Erica M.,39,0,45,6
1746572711103,EDS 204R,B01,895693,Halter; Christopher P.,10,0,45,35
1746572712128,EDS 206R,A00,895694,Fargason; Sharon Gayle,1,0,30,29
1746572712128,EDS 206R,B00,895695,Choi; Bailey Miyeon,16,0,30,14
1746572713157,EDS 250,A00,895697,Hemans; Patricia Ann Benitez,22,0,45,23
1746572714183,EDS 281,A00,895701,Meyerott; Theresa Ann,1,0,15,14
1746572715207,EDS 284,A00,895736,Meyerott; Theresa Ann,1,0,15,14
1746572716233,EDS 286,A00,897210,Fine; Sarah,0,0,15,15
1746572717258,EDS 289C,A01,895770,Daly; Alan J.,1,0,15,14
1746572718282,EDS 290,A00,897211,Hofstetter; Carolyn,0,0,15,15
1746572719311,LIGM 5A,A00,896162,Fischer-Grunski; Eva K,12,0,20,8
1746572720337,LIGM 5B,A00,896260,Fischer-Grunski; Eva K,17,0,20,3
1746572721362,LIGM 5C,A00,896308,Fischer-Grunski; Eva K,18,0,20,2
1746572722401,LIIT 5AS,A00,896313,Carnelos; Chiara,18,0,20,2
1746572723425,LIIT 5BS,A00,896416,Carnelos; Chiara,20,0,20,0
1746572724449,LIIT 5CS,A00,896564,Carnelos; Chiara,20,0,20,0
1746572725479,LISP 5A,A00,896588,Munoz Sanchez; Alicia,2,0,20,18
1746572726503,LISP 5B,A00,896653,Munoz Sanchez; Alicia,7,0,20,13
1746572727530,LISP 5C,A00,896655,Munoz Sanchez; Alicia,0,1,20,20
1746572728556,MAE 197,001,957918,Kleissl; Jan,9996,0,9999,3
1746572728556,MAE 197,002,959806,Boechler; Nicholas Sebastia,9998,0,9999,1
1746572728556,MAE 197,003,959852,Mullin; Jennifer S,9998,0,9999,1
1746572729580,MATH 2,A01,957937,Staff,33,0,35,2
1746572730606,MATH 197,001,957876,Kedlaya; Kiran S.,9993,0,9999,6
1746572731633,MCWP 40,A00,892729,Duru; Nur,10,0,20,10
1746572731633,MCWP 40,B00,893304,Montejo; Carolina,14,0,20,6
1746572732660,MCWP 40R,A00,893757,Redela; Pamela Morgan,0,5,20,20
1746572733688,MCWP 50,A00,893758,Morshed; Michael James,0,0,20,20
1746572733688,MCWP 50,B00,893761,Bartulis; Jason Michael,17,0,20,3
1746572734714,MCWP 50R,A00,893766,Compas; Sean Matthew,0,1,20,20
1746572734714,MCWP 50R,B00,893769,Carter; Jennifer A,0,1,20,20
1746572734714,MCWP 50R,C00,893771,Krone; Jarret,0,3,20,20
1746572734714,MCWP 50R,D00,893772,Miller; Elizabeth Deen,0,0,20,20
1746572734714,MCWP 50R,E00,893775,Carter; Andrea L,0,1,20,20
1746572735741,MMW 11R,A01,892721,Herbst; Matthew,11,0,27,16
1746572735741,MMW 11R,A02,892722,Herbst; Matthew,0,0,0,3
1746572736766,MMW 12R,A01,892724,Herbst; Matthew,0,11,16,16
1746572736766,MMW 12R,A02,892725,Herbst; Matthew,0,10,16,16
1746572737794,MMW 13R,A01,892727,Staff,0,4,16,16
1746572737794,MMW 13R,A02,892728,Staff,0,4,16,16
1746572737794,MMW 13R,A03,958032,Staff,0,4,16,16
1746572737794,MMW 13R,A04,958033,Staff,0,4,16,16
1746572737794,MMW 13R,A05,958034,Staff,0,4,16,16
1746572738819,SIO 295LS,A00,894015,Staff,5,0,25,20
1746572739849,SIO 295S,A00,894020,Staff,5,0,25,20
1746572740875,SIOC 290S,B01,958918,Merrifield; Mark A,14,0,30,16
1746572741905,SIOC 291S,B01,958922,Gabriel; Corey John,14,0,30,16
1746572742931,SOCI 117,A01,895339,Staff,3,0,5,2
1746572743958,WES 237B,A00,894149,Staff,11,0,20,9
1746572746034,AESE 279B,A00,891859,Staff,13,0,35,22
1746572747067,AIP 197,001,891854,Vespa; Emanuel Ignacio,9999,0,9999,0
1746572748098,ANTH 289S,A00,891856,Gagneux; Pascal,12,0,12,0
1746572749124,BENG 196,001,957946,Engler; Adam J.,9996,0,9999,3
1746572750152,BISP 197,001,959851,Wilhelm; James E.,9998,0,9999,1
1746572751176,CAT 124RS,A01,956906,Staff,6,0,25,19
1746572752201,CAT 125RS,A01,922013,Staff,6,0,25,19
1746572753226,CLRE 250,A00,891860,Morris; Sheldon,9995,0,9999,4
1746572755278,CLRE 251R,A00,907817,Mehta; Ravindra L.,9994,0,9999,5
1746572756302,CLRE 252,A00,891864,Cuomo; Raphael Eduardo,9993,0,9999,6
1746572757327,CLRE 253,A00,891867,Vaida; Florin,9994,0,9999,5
1746572757327,CLRE 253,B00,907819,Staff,9999,0,9999,0
1746572758352,CLRE 259,A00,891868,Patel; Hemal,9998,0,9999,1
1746572759379,CLRE 260,A00,891872,Cuomo; Raphael Eduardo,9999,0,9999,0
1746572760406,CLRE 297,001,891888,Cuomo; Raphael Eduardo,9999,0,9999,0
1746572761435,CSE 191,A00,958773,Minnes Kemp; Mor Mia,9995,0,9999,4
1746572762464,CSE 197,001,959846,Minnes Kemp; Mor Mia,9990,0,9999,9
1746572763491,CSS 201S,A01,892054,Mignozzetti; Umberto,25,0,30,5
1746572764523,CSS 202S,A01,892056,Mignozzetti; Umberto,25,0,30,5
1746572765551,DSC 197,001,956898,Eldridge; Justin Matthew,9996,0,9999,3
1746572766607,DSC 297,001,958000,Mazumdar; Arya,9998,0,9999,1
1746572766607,DSC 297,002,959862,Wang; Yusu,9998,0,9999,1
1746572767633,EAP 100,A00,905686,Staff,9778,0,9999,221
1746572768659,ECE 45,A01,892618,Staff,0,0,65,65
1746572770712,ECE 111,A01,892719,Staff,5,0,65,60
1746572771738,ECE 197,001,957920,Mercier; Patrick Philip,9991,0,9999,8
1746572772767,ECON 178,A01,907814,Zhu; Ying,26,0,35,9
1746572773793,EDS 115,A00,895312,Staff,35,0,45,10
1746572774823,EDS 117,A01,895337,Staff,23,0,30,7
1746572775849,EDS 125,A00,895341,Jones; Gabrielle Anastasia,36,0,45,9
1746572776879,EDS 128A,A01,895459,Fargason; Sharon Gayle,44,0,45,1
1746572777904,EDS 128B,A01,895543,Pappas; Elizabeth,44,0,45,1
1746572778932,EDS 139,A00,897203,Pappas; Elizabeth,44,0,45,1
1746572778932,EDS 139,B00,897209,Fargason; Sharon Gayle,41,0,45,4
1746572779958,EDS 201,A00,895545,Staff,22,0,45,23
1746572780983,EDS 203,A01,895581,Halter; Christopher P.,22,0,45,23
1746572782012,EDS 204R,A01,895625,Heinzman; Erica M.,39,0,45,6
1746572782012,EDS 204R,B01,895693,Halter; Christopher P.,10,0,45,35
1746572783037,EDS 206R,A00,895694,Fargason; Sharon Gayle,1,0,30,29
1746572783037,EDS 206R,B00,895695,Choi; Bailey Miyeon,16,0,30,14
1746572784067,EDS 250,A00,895697,Hemans; Patricia Ann Benitez,22,0,45,23
1746572785094,EDS 281,A00,895701,Meyerott; Theresa Ann,1,0,15,14
1746572786120,EDS 284,A00,895736,Meyerott; Theresa Ann,1,0,15,14
1746572787149,EDS 286,A00,897210,Fine; Sarah,0,0,15,15
1746572788173,EDS 289C,A01,895770,Daly; Alan J.,1,0,15,14
1746572789199,EDS 290,A00,897211,Hofstetter; Carolyn,0,0,15,15
1746572790260,LIGM 5A,A00,896162,Fischer-Grunski; Eva K,12,0,20,8
1746572791285,LIGM 5B,A00,896260,Fischer-Grunski; Eva K,17,0,20,3
1746572792315,LIGM 5C,A00,896308,Fischer-Grunski; Eva K,18,0,20,2
1746572793340,LIIT 5AS,A00,896313,Carnelos; Chiara,18,0,20,2
1746572794363,LIIT 5BS,A00,896416,Carnelos; Chiara,20,0,20,0
1746572795393,LIIT 5CS,A00,896564,Carnelos; Chiara,20,0,20,0
1746572796418,LISP 5A,A00,896588,Munoz Sanchez; Alicia,2,0,20,18
1746572797443,LISP 5B,A00,896653,Munoz Sanchez; Alicia,7,0,20,13
1746572798469,LISP 5C,A00,896655,Munoz Sanchez; Alicia,0,1,20,20
1746572799495,MAE 197,001,957918,Kleissl; Jan,9996,0,9999,3
1746572799495,MAE 197,002,959806,Boechler; Nicholas Sebastia,9998,0,9999,1
1746572799495,MAE 197,003,959852,Mullin; Jennifer S,9998,0,9999,1
1746572800524,MATH 2,A01,957937,Staff,33,0,35,2
1746572801553,MATH 197,001,957876,Kedlaya; Kiran S.,9993,0,9999,6
1746572802582,MCWP 40,A00,892729,Duru; Nur,10,0,20,10
1746572802582,MCWP 40,B00,893304,Montejo; Carolina,14,0,20,6
1746572803606,MCWP 40R,A00,893757,Redela; Pamela Morgan,0,5,20,20
1746572804634,MCWP 50,A00,893758,Morshed; Michael James,0,0,20,20
1746572804634,MCWP 50,B00,893761,Bartulis; Jason Michael,17,0,20,3
1746572805659,MCWP 50R,A00,893766,Compas; Sean Matthew,0,1,20,20
1746572805659,MCWP 50R,B00,893769,Carter; Jennifer A,0,1,20,20
1746572805659,MCWP 50R,C00,893771,Krone; Jarret,0,3,20,20
1746572805659,MCWP 50R,D00,893772,Miller; Elizabeth Deen,0,0,20,20
1746572805659,MCWP 50R,E00,893775,Carter; Andrea L,0,1,20,20
1746572806685,MMW 11R,A01,892721,Herbst; Matthew,11,0,27,16
1746572806685,MMW 11R,A02,892722,Herbst; Matthew,0,0,0,3
1746572807712,MMW 12R,A01,892724,Herbst; Matthew,0,11,16,16
1746572807712,MMW 12R,A02,892725,Herbst; Matthew,0,10,16,16
1746572808737,MMW 13R,A01,892727,Staff,0,4,16,16
1746572808737,MMW 13R,A02,892728,Staff,0,4,16,16
1746572808737,MMW 13R,A03,958032,Staff,0,4,16,16
1746572808737,MMW 13R,A04,958033,Staff,0,4,16,16
1746572808737,MMW 13R,A05,958034,Staff,0,4,16,16
1746572809763,SIO 295LS,A00,894015,Staff,5,0,25,20
1746572810788,SIO 295S,A00,894020,Staff,5,0,25,20
1746572811818,SIOC 290S,B01,958918,Merrifield; Mark A,14,0,30,16
1746572812848,SIOC 291S,B01,958922,Gabriel; Corey John,14,0,30,16
1746572813878,SOCI 117,A01,895339,Staff,3,0,5,2
1746572814905,WES 237B,A00,894149,Staff,11,0,20,9
1746572816960,AESE 279B,A00,891859,Staff,13,0,35,22
1746572818009,AIP 197,001,891854,Vespa; Emanuel Ignacio,9999,0,9999,0
1746572819034,ANTH 289S,A00,891856,Gagneux; Pascal,12,0,12,0
1746572820059,BENG 196,001,957946,Engler; Adam J.,9996,0,9999,3
1746572821087,BISP 197,001,959851,Wilhelm; James E.,9998,0,9999,1
1746572822110,CAT 124RS,A01,956906,Staff,6,0,25,19
1746572823139,CAT 125RS,A01,922013,Staff,6,0,25,19
1746572824168,CLRE 250,A00,891860,Morris; Sheldon,9995,0,9999,4
1746572826222,CLRE 251R,A00,907817,Mehta; Ravindra L.,9994,0,9999,5
1746572827245,CLRE 252,A00,891864,Cuomo; Raphael Eduardo,9993,0,9999,6
1746572828272,CLRE 253,A00,891867,Vaida; Florin,9994,0,9999,5
1746572828272,CLRE 253,B00,907819,Staff,9999,0,9999,0
1746572829297,CLRE 259,A00,891868,Patel; Hemal,9998,0,9999,1
1746572830322,CLRE 260,A00,891872,Cuomo; Raphael Eduardo,9999,0,9999,0
1746572831349,CLRE 297,001,891888,Cuomo; Raphael Eduardo,9999,0,9999,0
1746572832374,CSE 191,A00,958773,Minnes Kemp; Mor Mia,9995,0,9999,4
1746572833400,CSE 197,001,959846,Minnes Kemp; Mor Mia,9990,0,9999,9
1746572834430,CSS 201S,A01,892054,Mignozzetti; Umberto,25,0,30,5
1746572835463,CSS 202S,A01,892056,Mignozzetti; Umberto,25,0,30,5
1746572836492,DSC 197,001,956898,Eldridge; Justin Matthew,9996,0,9999,3
1746572837517,DSC 297,001,958000,Mazumdar; Arya,9998,0,9999,1
1746572837517,DSC 297,002,959862,Wang; Yusu,9998,0,9999,1
1746572838559,EAP 100,A00,905686,Staff,9778,0,9999,221
1746572839590,ECE 45,A01,892618,Staff,0,0,65,65
1746572841645,ECE 111,A01,892719,Staff,5,0,65,60
1746572842669,ECE 197,001,957920,Mercier; Patrick Philip,9991,0,9999,8
1746572843693,ECON 178,A01,907814,Zhu; Ying,26,0,35,9
1746572844724,EDS 115,A00,895312,Staff,35,0,45,10
1746572845752,EDS 117,A01,895337,Staff,23,0,30,7
1746572846777,EDS 125,A00,895341,Jones; Gabrielle Anastasia,36,0,45,9
1746572847802,EDS 128A,A01,895459,Fargason; Sharon Gayle,44,0,45,1
1746572848832,EDS 128B,A01,895543,Pappas; Elizabeth,44,0,45,1
1746572849861,EDS 139,A00,897203,Pappas; Elizabeth,44,0,45,1
1746572849861,EDS 139,B00,897209,Fargason; Sharon Gayle,41,0,45,4
1746572850887,EDS 201,A00,895545,Staff,22,0,45,23
1746572851913,EDS 203,A01,895581,Halter; Christopher P.,22,0,45,23
1746572852940,EDS 204R,A01,895625,Heinzman; Erica M.,39,0,45,6
1746572852940,EDS 204R,B01,895693,Halter; Christopher P.,10,0,45,35
1746572853965,EDS 206R,A00,895694,Fargason; Sharon Gayle,1,0,30,29
1746572853965,EDS 206R,B00,895695,Choi; Bailey Miyeon,16,0,30,14
1746572854992,EDS 250,A00,895697,Hemans; Patricia Ann Benitez,22,0,45,23
1746572856019,EDS 281,A00,895701,Meyerott; Theresa Ann,1,0,15,14
1746572857048,EDS 284,A00,895736,Meyerott; Theresa Ann,1,0,15,14
1746572858077,EDS 286,A00,897210,Fine; Sarah,0,0,15,15
1746572859105,EDS 289C,A01,895770,Daly; Alan J.,1,0,15,14
1746572860134,EDS 290,A00,897211,Hofstetter; Carolyn,0,0,15,15
1746572861160,LIGM 5A,A00,896162,Fischer-Grunski; Eva K,12,0,20,8
1746572862187,LIGM 5B,A00,896260,Fischer-Grunski; Eva K,17,0,20,3
1746572863217,LIGM 5C,A00,896308,Fischer-Grunski; Eva K,18,0,20,2
1746572864242,LIIT 5AS,A00,896313,Carnelos; Chiara,18,0,20,2
1746572865273,LIIT 5BS,A00,896416,Carnelos; Chiara,20,0,20,0
1746572866302,LIIT 5CS,A00,896564,Carnelos; Chiara,20,0,20,0
1746572867329,LISP 5A,A00,896588,Munoz Sanchez; Alicia,2,0,20,18
1746572868354,LISP 5B,A00,896653,Munoz Sanchez; Alicia,7,0,20,13
1746572869379,LISP 5C,A00,896655,Munoz Sanchez; Alicia,0,1,20,20
1746572870409,MAE 197,001,957918,Kleissl; Jan,9996,0,9999,3
1746572870409,MAE 197,002,959806,Boechler; Nicholas Sebastia,9998,0,9999,1
1746572870409,MAE 197,003,959852,Mullin; Jennifer S,9998,0,9999,1
1746572871435,MATH 2,A01,957937,Staff,33,0,35,2
1746572872460,MATH 197,001,957876,Kedlaya; Kiran S.,9993,0,9999,6
1746572873487,MCWP 40,A00,892729,Duru; Nur,10,0,20,10
1746572873487,MCWP 40,B00,893304,Montejo; Carolina,14,0,20,6
1746572874512,MCWP 40R,A00,893757,Redela; Pamela Morgan,0,5,20,20
1746572875540,MCWP 50,A00,893758,Morshed; Michael James,0,0,20,20
1746572875540,MCWP 50,B00,893761,Bartulis; Jason Michael,17,0,20,3
1746572876565,MCWP 50R,A00,893766,Compas; Sean Matthew,0,1,20,20
1746572876565,MCWP 50R,B00,893769,Carter; Jennifer A,0,1,20,20
1746572876565,MCWP 50R,C00,893771,Krone; Jarret,0,3,20,20
1746572876565,MCWP 50R,D00,893772,Miller; Elizabeth Deen,0,0,20,20
1746572876565,MCWP 50R,E00,893775,Carter; Andrea L,0,1,20,20
1746572877590,MMW 11R,A01,892721,Herbst; Matthew,11,0,27,16
1746572877590,MMW 11R,A02,892722,Herbst; Matthew,0,0,0,3
1746572878620,MMW 12R,A01,892724,Herbst; Matthew,0,11,16,16
1746572878620,MMW 12R,A02,892725,Herbst; Matthew,0,10,16,16
1746572879649,MMW 13R,A01,892727,Staff,0,4,16,16
1746572879649,MMW 13R,A02,892728,Staff,0,4,16,16
1746572879649,MMW 13R,A03,958032,Staff,0,4,16,16
1746572879649,MMW 13R,A04,958033,Staff,0,4,16,16
1746572879649,MMW 13R,A05,958034,Staff,0,4,16,16
1746572880675,SIO 295LS,A00,894015,Staff,5,0,25,20
1746572881708,SIO 295S,A00,894020,Staff,5,0,25,20
1746572882737,SIOC 290S,B01,958918,Merrifield; Mark A,14,0,30,16
1746572883768,SIOC 291S,B01,958922,Gabriel; Corey John,14,0,30,16
1746572884799,SOCI 117,A01,895339,Staff,3,0,5,2
1746572885824,WES 237B,A00,894149,Staff,11,0,20,9
1746572887890,AESE 279B,A00,891859,Staff,13,0,35,22
1746572888914,AIP 197,001,891854,Vespa; Emanuel Ignacio,9999,0,9999,0
1746572889942,ANTH 289S,A00,891856,Gagneux; Pascal,12,0,12,0
1746572890967,BENG 196,001,957946,Engler; Adam J.,9996,0,9999,3
1746572891995,BISP 197,001,959851,Wilhelm; James E.,9998,0,9999,1
1746572893023,CAT 124RS,A01,956906,Staff,6,0,25,19
1746572894053,CAT 125RS,A01,922013,Staff,6,0,25,19
1746572895078,CLRE 250,A00,891860,Morris; Sheldon,9995,0,9999,4
1746572897135,CLRE 251R,A00,907817,Mehta; Ravindra L.,9994,0,9999,5
1746572898161,CLRE 252,A00,891864,Cuomo; Raphael Eduardo,9993,0,9999,6
1746572899189,CLRE 253,A00,891867,Vaida; Florin,9994,0,9999,5
1746572899189,CLRE 253,B00,907819,Staff,9999,0,9999,0
1746572900214,CLRE 259,A00,891868,Patel; Hemal,9998,0,9999,1
1746572901245,CLRE 260,A00,891872,Cuomo; Raphael Eduardo,9999,0,9999,0
1746572902274,CLRE 297,001,891888,Cuomo; Raphael Eduardo,9999,0,9999,0
1746572903298,CSE 191,A00,958773,Minnes Kemp; Mor Mia,9995,0,9999,4
1746572904325,CSE 197,001,959846,Minnes Kemp; Mor Mia,9990,0,9999,9
1746572905351,CSS 201S,A01,892054,Mignozzetti; Umberto,25,0,30,5
1746572906379,CSS 202S,A01,892056,Mignozzetti; Umberto,25,0,30,5
1746572907405,DSC 197,001,956898,Eldridge; Justin Matthew,9996,0,9999,3
1746572908429,DSC 297,001,958000,Mazumdar; Arya,9998,0,9999,1
1746572908429,DSC 297,002,959862,Wang; Yusu,9998,0,9999,1
1746572909455,EAP 100,A00,905686,Staff,9778,0,9999,221
1746572910480,ECE 45,A01,892618,Staff,0,0,65,65
1746572912535,ECE 111,A01,892719,Staff,5,0,65,60
1746572913562,ECE 197,001,957920,Mercier; Patrick Philip,9991,0,9999,8
1746572914594,ECON 178,A01,907814,Zhu; Ying,26,0,35,9
1746572915620,EDS 115,A00,895312,Staff,35,0,45,10
1746572916644,EDS 117,A01,895337,Staff,23,0,30,7
1746572917670,EDS 125,A00,895341,Jones; Gabrielle Anastasia,36,0,45,9
1746572918698,EDS 128A,A01,895459,Fargason; Sharon Gayle,44,0,45,1
1746572919727,EDS 128B,A01,895543,Pappas; Elizabeth,44,0,45,1
1746572920758,EDS 139,A00,897203,Pappas; Elizabeth,44,0,45,1
1746572920758,EDS 139,B00,897209,Fargason; Sharon Gayle,41,0,45,4
1746572921787,EDS 201,A00,895545,Staff,22,0,45,23
1746572922813,EDS 203,A01,895581,Halter; Christopher P.,22,0,45,23
1746572923837,EDS 204R,A01,895625,Heinzman; Erica M.,39,0,45,6
1746572923837,EDS 204R,B01,895693,Halter; Christopher P.,10,0,45,35
1746572924862,EDS 206R,A00,895694,Fargason; Sharon Gayle,1,0,30,29
1746572924862,EDS 206R,B00,895695,Choi; Bailey Miyeon,16,0,30,14
1746572925887,EDS 250,A00,895697,Hemans; Patricia Ann Benitez,22,0,45,23
1746572926915,EDS 281,A00,895701,Meyerott; Theresa Ann,1,0,15,14
1746572927940,EDS 284,A00,895736,Meyerott; Theresa Ann,1,0,15,14
1746572928966,EDS 286,A00,897210,Fine; Sarah,0,0,15,15
1746572929998,EDS 289C,A01,895770,Daly; Alan J.,1,0,15,14
1746572931024,EDS 290,A00,897211,Hofstetter; Carolyn,0,0,15,15
1746572932050,LIGM 5A,A00,896162,Fischer-Grunski; Eva K,12,0,20,8
1746572933075,LIGM 5B,A00,896260,Fischer-Grunski; Eva K,17,0,20,3
1746572934100,LIGM 5C,A00,896308,Fischer-Grunski; Eva K,18,0,20,2
1746572935129,LIIT 5AS,A00,896313,Carnelos; Chiara,18,0,20,2
1746572936154,LIIT 5BS,A00,896416,Carnelos; Chiara,20,0,20,0
1746572937184,LIIT 5CS,A00,896564,Carnelos; Chiara,20,0,20,0
1746572938214,LISP 5A,A00,896588,Munoz Sanchez; Alicia,2,0,20,18
1746572939239,LISP 5B,A00,896653,Munoz Sanchez; Alicia,7,0,20,13
1746572940264,LISP 5C,A00,896655,Munoz Sanchez; Alicia,0,1,20,20
1746572941293,MAE 197,001,957918,Kleissl; Jan,9996,0,9999,3
1746572941293,MAE 197,002,959806,Boechler; Nicholas Sebastia,9998,0,9999,1
1746572941293,MAE 197,003,959852,Mullin; Jennifer S,9998,0,9999,1
1746572942319,MATH 2,A01,957937,Staff,33,0,35,2
1746572943347,MATH 197,001,957876,Kedlaya; Kiran S.,9993,0,9999,6
1746572944373,MCWP 40,A00,892729,Duru; Nur,10,0,20,10
1746572944373,MCWP 40,B00,893304,Montejo; Carolina,14,0,20,6
1746572945398,MCWP 40R,A00,893757,Redela; Pamela Morgan,0,5,20,20
1746572946427,MCWP 50,A00,893758,Morshed; Michael James,0,0,20,20
1746572946427,MCWP 50,B00,893761,Bartulis; Jason Michael,17,0,20,3
1746572947452,MCWP 50R,A00,893766,Compas; Sean Matthew,0,1,20,20
1746572947452,MCWP 50R,B00,893769,Carter; Jennifer A,0,1,20,20
1746572947452,MCWP 50R,C00,893771,Krone; Jarret,0,3,20,20
1746572947452,MCWP 50R,D00,893772,Miller; Elizabeth Deen,0,0,20,20
1746572947452,MCWP 50R,E00,893775,Carter; Andrea L,0,1,20,20
1746572948479,MMW 11R,A01,892721,Herbst; Matthew,11,0,27,16
1746572948479,MMW 11R,A02,892722,Herbst; Matthew,0,0,0,3
1746572949503,MMW 12R,A01,892724,Herbst; Matthew,0,11,16,16
1746572949503,MMW 12R,A02,892725,Herbst; Matthew,0,10,16,16
1746572950531,MMW 13R,A01,892727,Staff,0,4,16,16
1746572950531,MMW 13R,A02,892728,Staff,0,4,16,16
1746572950531,MMW 13R,A03,958032,Staff,0,4,16,16
1746572950531,MMW 13R,A04,958033,Staff,0,4,16,16
1746572950531,MMW 13R,A05,958034,Staff,0,4,16,16
1746572951560,SIO 295LS,A00,894015,Staff,5,0,25,20
1746572952588,SIO 295S,A00,894020,Staff,5,0,25,20
1746572953613,SIOC 290S,B01,958918,Merrifield; Mark A,14,0,30,16
1746572954644,SIOC 291S,B01,958922,Gabriel; Corey John,14,0,30,16
1746572955669,SOCI 117,A01,895339,Staff,3,0,5,2
1746572956697,WES 237B,A00,894149,Staff,11,0,20,9
1746572958765,AESE 279B,A00,891859,Staff,13,0,35,22
1746572959791,AIP 197,001,891854,Vespa; Emanuel Ignacio,9999,0,9999,0
1746572960815,ANTH 289S,A00,891856,Gagneux; Pascal,12,0,12,0
1746572961840,BENG 196,001,957946,Engler; Adam J.,9996,0,9999,3
1746572962868,BISP 197,001,959851,Wilhelm; James E.,9998,0,9999,1
1746572963893,CAT 124RS,A01,956906,Staff,6,0,25,19
1746572964922,CAT 125RS,A01,922013,Staff,6,0,25,19
1746572965948,CLRE 250,A00,891860,Morris; Sheldon,9995,0,9999,4
1746572968009,CLRE 251R,A00,907817,Mehta; Ravindra L.,9994,0,9999,5
1746572969036,CLRE 252,A00,891864,Cuomo; Raphael Eduardo,9993,0,9999,6
1746572970062,CLRE 253,A00,891867,Vaida; Florin,9994,0,9999,5
1746572970062,CLRE 253,B00,907819,Staff,9999,0,9999,0
1746572971091,CLRE 259,A00,891868,Patel; Hemal,9998,0,9999,1
1746572972116,CLRE 260,A00,891872,Cuomo; Raphael Eduardo,9999,0,9999,0
1746572973143,CLRE 297,001,891888,Cuomo; Raphael Eduardo,9999,0,9999,0
1746572974175,CSE 191,A00,958773,Minnes Kemp; Mor Mia,9995,0,9999,4
1746572975204,CSE 197,001,959846,Minnes Kemp; Mor Mia,9990,0,9999,9
1746572976230,CSS 201S,A01,892054,Mignozzetti; Umberto,25,0,30,5
1746572977255,CSS 202S,A01,892056,Mignozzetti; Umberto,25,0,30,5
1746572978283,DSC 197,001,956898,Eldridge; Justin Matthew,9996,0,9999,3
1746572979311,DSC 297,001,958000,Mazumdar; Arya,9998,0,9999,1
1746572979311,DSC 297,002,959862,Wang; Yusu,9998,0,9999,1
1746572980337,EAP 100,A00,905686,Staff,9778,0,9999,221
1746572981365,ECE 45,A01,892618,Staff,0,0,65,65
1746572983432,ECE 111,A01,892719,Staff,5,0,65,60
1746572984456,ECE 197,001,957920,Mercier; Patrick Philip,9991,0,9999,8
1746572985483,ECON 178,A01,907814,Zhu; Ying,26,0,35,9
1746572986508,EDS 115,A00,895312,Staff,35,0,45,10
1746572987533,EDS 117,A01,895337,Staff,23,0,30,7
1746572988562,EDS 125,A00,895341,Jones; Gabrielle Anastasia,36,0,45,9
1746572989587,EDS 128A,A01,895459,Fargason; Sharon Gayle,44,0,45,1
1746572990616,EDS 128B,A01,895543,Pappas; Elizabeth,44,0,45,1
1746572991642,EDS 139,A00,897203,Pappas; Elizabeth,44,0,45,1
1746572991642,EDS 139,B00,897209,Fargason; Sharon Gayle,41,0,45,4
1746572992669,EDS 201,A00,895545,Staff,22,0,45,23
1746572993694,EDS 203,A01,895581,Halter; Christopher P.,22,0,45,23
1746572994722,EDS 204R,A01,895625,Heinzman; Erica M.,39,0,45,6
1746572994722,EDS 204R,B01,895693,Halter; Christopher P.,10,0,45,35
1746572995753,EDS 206R,A00,895694,Fargason; Sharon Gayle,1,0,30,29
1746572995753,EDS 206R,B00,895695,Choi; Bailey Miyeon,16,0,30,14
1746572996779,EDS 250,A00,895697,Hemans; Patricia Ann Benitez,22,0,45,23
1746572997806,EDS 281,A00,895701,Meyerott; Theresa Ann,1,0,15,14
1746572998831,EDS 284,A00,895736,Meyerott; Theresa Ann,1,0,15,14
1746572999861,EDS 286,A00,897210,Fine; Sarah,0,0,15,15
1746573000888,EDS 289C,A01,895770,Daly; Alan J.,1,0,15,14
1746573001919,EDS 290,A00,897211,Hofstetter; Carolyn,0,0,15,15
1746573002947,LIGM 5A,A00,896162,Fischer-Grunski; Eva K,12,0,20,8
1746573003973,LIGM 5B,A00,896260,Fischer-Grunski; Eva K,17,0,20,3
1746573005002,LIGM 5C,A00,896308,Fischer-Grunski; Eva K,18,0,20,2
1746573006031,LIIT 5AS,A00,896313,Carnelos; Chiara,18,0,20,2
1746573007058,LIIT 5BS,A00,896416,Carnelos; Chiara,20,0,20,0
1746573008087,LIIT 5CS,A00,896564,Carnelos; Chiara,20,0,20,0
1746573009115,LISP 5A,A00,896588,Munoz Sanchez; Alicia,2,0,20,18
1746573010144,LISP 5B,A00,896653,Munoz Sanchez; Alicia,7,0,20,13
1746573011170,LISP 5C,A00,896655,Munoz Sanchez; Alicia,0,1,20,20
1746573012197,MAE 197,001,957918,Kleissl; Jan,9996,0,9999,3
1746573012197,MAE 197,002,959806,Boechler; Nicholas Sebastia,9998,0,9999,1
1746573012197,MAE 197,003,959852,Mullin; Jennifer S,9998,0,9999,1
1746573013222,MATH 2,A01,957937,Staff,33,0,35,2
1746573014248,MATH 197,001,957876,Kedlaya; Kiran S.,9993,0,9999,6
1746573015275,MCWP 40,A00,892729,Duru; Nur,10,0,20,10
1746573015275,MCWP 40,B00,893304,Montejo; Carolina,14,0,20,6
1746573016304,MCWP 40R,A00,893757,Redela; Pamela Morgan,0,5,20,20
1746573017330,MCWP 50,A00,893758,Morshed; Michael James,0,0,20,20
1746573017330,MCWP 50,B00,893761,Bartulis; Jason Michael,17,0,20,3
1746573018360,MCWP 50R,A00,893766,Compas; Sean Matthew,0,1,20,20
1746573018360,MCWP 50R,B00,893769,Carter; Jennifer A,0,1,20,20
1746573018360,MCWP 50R,C00,893771,Krone; Jarret,0,3,20,20
1746573018360,MCWP 50R,D00,893772,Miller; Elizabeth Deen,0,0,20,20
1746573018360,MCWP 50R,E00,893775,Carter; Andrea L,0,1,20,20
1746573019386,MMW 11R,A01,892721,Herbst; Matthew,11,0,27,16
1746573019386,MMW 11R,A02,892722,Herbst; Matthew,0,0,0,3
1746573020411,MMW 12R,A01,892724,Herbst; Matthew,0,11,16,16
1746573020411,MMW 12R,A02,892725,Herbst; Matthew,0,10,16,16
1746573021436,MMW 13R,A01,892727,Staff,0,4,16,16
1746573021436,MMW 13R,A02,892728,Staff,0,4,16,16
1746573021436,MMW 13R,A03,958032,Staff,0,4,16,16
1746573021436,MMW 13R,A04,958033,Staff,0,4,16,16
1746573021436,MMW 13R,A05,958034,Staff,0,4,16,16
1746573022462,SIO 295LS,A00,894015,Staff,5,0,25,20
1746573023488,SIO 295S,A00,894020,Staff,5,0,25,20
1746573024515,SIOC 290S,B01,958918,Merrifield; Mark A,14,0,30,16
1746573025550,SIOC 291S,B01,958922,Gabriel; Corey John,14,0,30,16
1746573026576,SOCI 117,A01,895339,Staff,3,0,5,2
1746573027603,WES 237B,A00,894149,Staff,11,0,20,9
1746573029662,AESE 279B,A00,891859,Staff,13,0,35,22
1746573030692,AIP 197,001,891854,Vespa; Emanuel Ignacio,9999,0,9999,0
1746573031720,ANTH 289S,A00,891856,Gagneux; Pascal,12,0,12,0
1746573032751,BENG 196,001,957946,Engler; Adam J.,9996,0,9999,3
1746573033780,BISP 197,001,959851,Wilhelm; James E.,9998,0,9999,1
1746573034811,CAT 124RS,A01,956906,Staff,6,0,25,19
1746573035836,CAT 125RS,A01,922013,Staff,6,0,25,19
1746573036866,CLRE 250,A00,891860,Morris; Sheldon,9995,0,9999,4
1746573038920,CLRE 251R,A00,907817,Mehta; Ravindra L.,9994,0,9999,5
1746573039948,CLRE 252,A00,891864,Cuomo; Raphael Eduardo,9993,0,9999,6
1746573040976,CLRE 253,A00,891867,Vaida; Florin,9994,0,9999,5
1746573040976,CLRE 253,B00,907819,Staff,9999,0,9999,0
1746573042002,CLRE 259,A00,891868,Patel; Hemal,9998,0,9999,1
1746573043028,CLRE 260,A00,891872,Cuomo; Raphael Eduardo,9999,0,9999,0
1746573044056,CLRE 297,001,891888,Cuomo; Raphael Eduardo,9999,0,9999,0
1746573045085,CSE 191,A00,958773,Minnes Kemp; Mor Mia,9995,0,9999,4
1746573046115,CSE 197,001,959846,Minnes Kemp; Mor Mia,9990,0,9999,9
1746573047140,CSS 201S,A01,892054,Mignozzetti; Umberto,25,0,30,5
1746573048166,CSS 202S,A01,892056,Mignozzetti; Umberto,25,0,30,5
1746573049194,DSC 197,001,956898,Eldridge; Justin Matthew,9996,0,9999,3
1746573050221,DSC 297,001,958000,Mazumdar; Arya,9998,0,9999,1
1746573050221,DSC 297,002,959862,Wang; Yusu,9998,0,9999,1
1746573051250,EAP 100,A00,905686,Staff,9778,0,9999,221
1746573052279,ECE 45,A01,892618,Staff,0,0,65,65
1746573054335,ECE 111,A01,892719,Staff,5,0,65,60
1746573055361,ECE 197,001,957920,Mercier; Patrick Philip,9991,0,9999,8
1746573056387,ECON 178,A01,907814,Zhu; Ying,26,0,35,9
1746573057415,EDS 115,A00,895312,Staff,35,0,45,10
1746573058442,EDS 117,A01,895337,Staff,23,0,30,7
1746573059474,EDS 125,A00,895341,Jones; Gabrielle Anastasia,36,0,45,9
1746573060502,EDS 128A,A01,895459,Fargason; Sharon Gayle,44,0,45,1
1746573061532,EDS 128B,A01,895543,Pappas; Elizabeth,44,0,45,1
1746573062561,EDS 139,A00,897203,Pappas; Elizabeth,44,0,45,1
1746573062561,EDS 139,B00,897209,Fargason; Sharon Gayle,41,0,45,4
1746573063586,EDS 201,A00,895545,Staff,22,0,45,23
1746573064611,EDS 203,A01,895581,Halter; Christopher P.,22,0,45,23
1746573065648,EDS 204R,A01,895625,Heinzman; Erica M.,39,0,45,6
1746573065648,EDS 204R,B01,895693,Halter; Christopher P.,10,0,45,35
1746573066674,EDS 206R,A00,895694,Fargason; Sharon Gayle,1,0,30,29
1746573066674,EDS 206R,B00,895695,Choi; Bailey Miyeon,16,0,30,14
1746573067702,EDS 250,A00,895697,Hemans; Patricia Ann Benitez,22,0,45,23
1746573068730,EDS 281,A00,895701,Meyerott; Theresa Ann,1,0,15,14
1746573069756,EDS 284,A00,895736,Meyerott; Theresa Ann,1,0,15,14
1746573070786,EDS 286,A00,897210,Fine; Sarah,0,0,15,15
1746573071812,EDS 289C,A01,895770,Daly; Alan J.,1,0,15,14
1746573072842,EDS 290,A00,897211,Hofstetter; Carolyn,0,0,15,15
1746573073872,LIGM 5A,A00,896162,Fischer-Grunski; Eva K,12,0,20,8
1746573074899,LIGM 5B,A00,896260,Fischer-Grunski; Eva K,17,0,20,3
1746573075925,LIGM 5C,A00,896308,Fischer-Grunski; Eva K,18,0,20,2
1746573076955,LIIT 5AS,A00,896313,Carnelos; Chiara,18,0,20,2
1746573077985,LIIT 5BS,A00,896416,Carnelos; Chiara,20,0,20,0
1746573079015,LIIT 5CS,A00,896564,Carnelos; Chiara,20,0,20,0
1746573080044,LISP 5A,A00,896588,Munoz Sanchez; Alicia,2,0,20,18
1746573081075,LISP 5B,A00,896653,Munoz Sanchez; Alicia,7,0,20,13
1746573082101,LISP 5C,A00,896655,Munoz Sanchez; Alicia,0,1,20,20
1746573083128,MAE 197,001,957918,Kleissl; Jan,9996,0,9999,3
1746573083128,MAE 197,002,959806,Boechler; Nicholas Sebastia,9998,0,9999,1
1746573083128,MAE 197,003,959852,Mullin; Jennifer S,9998,0,9999,1
1746573084159,MATH 2,A01,957937,Staff,33,0,35,2
1746573085188,MATH 197,001,957876,Kedlaya; Kiran S.,9993,0,9999,6
1746573086215,MCWP 40,A00,892729,Duru; Nur,10,0,20,10
1746573086215,MCWP 40,B00,893304,Montejo; Carolina,14,0,20,6
1746573087244,MCWP 40R,A00,893757,Redela; Pamela Morgan,0,5,20,20
1746573088269,MCWP 50,A00,893758,Morshed; Michael James,0,0,20,20
1746573088269,MCWP 50,B00,893761,Bartulis; Jason Michael,17,0,20,3
1746573089299,MCWP 50R,A00,893766,Compas; Sean Matthew,0,1,20,20
1746573089299,MCWP 50R,B00,893769,Carter; Jennifer A,0,1,20,20
1746573089299,MCWP 50R,C00,893771,Krone; Jarret,0,3,20,20
1746573089299,MCWP 50R,D00,893772,Miller; Elizabeth Deen,0,0,20,20
1746573089299,MCWP 50R,E00,893775,Carter; Andrea L,0,1,20,20
1746573090326,MMW 11R,A01,892721,Herbst; Matthew,11,0,27,16
1746573090326,MMW 11R,A02,892722,Herbst; Matthew,0,0,0,3
1746573091352,MMW 12R,A01,892724,Herbst; Matthew,0,11,16,16
1746573091352,MMW 12R,A02,892725,Herbst; Matthew,0,10,16,16
1746573092382,MMW 13R,A01,892727,Staff,0,4,16,16
1746573092382,MMW 13R,A02,892728,Staff,0,4,16,16
1746573092382,MMW 13R,A03,958032,Staff,0,4,16,16
1746573092382,MMW 13R,A04,958033,Staff,0,4,16,16
1746573092382,MMW 13R,A05,958034,Staff,0,4,16,16
1746573093411,SIO 295LS,A00,894015,Staff,5,0,25,20
1746573094436,SIO 295S,A00,894020,Staff,5,0,25,20
1746573095463,SIOC 290S,B01,958918,Merrifield; Mark A,14,0,30,16
1746573096491,SIOC 291S,B01,958922,Gabriel; Corey John,14,0,30,16
1746573097517,SOCI 117,A01,895339,Staff,3,0,5,2
1746573098543,WES 237B,A00,894149,Staff,11,0,20,9
1746573100606,AESE 279B,A00,891859,Staff,13,0,35,22
1746573101637,AIP 197,001,891854,Vespa; Emanuel Ignacio,9999,0,9999,0
1746573102664,ANTH 289S,A00,891856,Gagneux; Pascal,12,0,12,0
1746573103690,BENG 196,001,957946,Engler; Adam J.,9996,0,9999,3
1746573104717,BISP 197,001,959851,Wilhelm; James E.,9998,0,9999,1
1746573105743,CAT 124RS,A01,956906,Staff,6,0,25,19
1746573106773,CAT 125RS,A01,922013,Staff,6,0,25,19
1746573107798,CLRE 250,A00,891860,Morris; Sheldon,9995,0,9999,4
1746573109857,CLRE 251R,A00,907817,Mehta; Ravindra L.,9994,0,9999,5
1746573110890,CLRE 252,A00,891864,Cuomo; Raphael Eduardo,9993,0,9999,6
1746573111921,CLRE 253,A00,891867,Vaida; Florin,9994,0,9999,5
1746573111921,CLRE 253,B00,907819,Staff,9999,0,9999,0
1746573112950,CLRE 259,A00,891868,Patel; Hemal,9998,0,9999,1
1746573113979,CLRE 260,A00,891872,Cuomo; Raphael Eduardo,9999,0,9999,0
1746573115006,CLRE 297,001,891888,Cuomo; Raphael Eduardo,9999,0,9999,0
1746573116034,CSE 191,A00,958773,Minnes Kemp; Mor Mia,9995,0,9999,4
1746573117063,CSE 197,001,959846,Minnes Kemp; Mor Mia,9990,0,9999,9
1746573118091,CSS 201S,A01,892054,Mignozzetti; Umberto,25,0,30,5
1746573119119,CSS 202S,A01,892056,Mignozzetti; Umberto,25,0,30,5
1746573120146,DSC 197,001,956898,Eldridge; Justin Matthew,9996,0,9999,3
1746573121177,DSC 297,001,958000,Mazumdar; Arya,9998,0,9999,1
1746573121177,DSC 297,002,959862,Wang; Yusu,9998,0,9999,1
1746573122207,EAP 100,A00,905686,Staff,9778,0,9999,221
1746573123236,ECE 45,A01,892618,Staff,0,0,65,65
1746573125298,ECE 111,A01,892719,Staff,5,0,65,60
1746573126328,ECE 197,001,957920,Mercier; Patrick Philip,9991,0,9999,8
1746573127356,ECON 178,A01,907814,Zhu; Ying,26,0,35,9
1746573128385,EDS 115,A00,895312,Staff,35,0,45,10
1746573129416,EDS 117,A01,895337,Staff,23,0,30,7
1746573130443,EDS 125,A00,895341,Jones; Gabrielle Anastasia,36,0,45,9
1746573131471,EDS 128A,A01,895459,Fargason; Sharon Gayle,44,0,45,1
1746573132499,EDS 128B,A01,895543,Pappas; Elizabeth,44,0,45,1
1746573133526,EDS 139,A00,897203,Pappas; Elizabeth,44,0,45,1
1746573133526,EDS 139,B00,897209,Fargason; Sharon Gayle,41,0,45,4
1746573134553,EDS 201,A00,895545,Staff,22,0,45,23
1746573135581,EDS 203,A01,895581,Halter; Christopher P.,22,0,45,23
1746573136612,EDS 204R,A01,895625,Heinzman; Erica M.,39,0,45,6
1746573136612,EDS 204R,B01,895693,Halter; Christopher P.,10,0,45,35
1746573137640,EDS 206R,A00,895694,Fargason; Sharon Gayle,1,0,30,29
1746573137640,EDS 206R,B00,895695,Choi; Bailey Miyeon,16,0,30,14
1746573138668,EDS 250,A00,895697,Hemans; Patricia Ann Benitez,22,0,45,23
1746573139695,EDS 281,A00,895701,Meyerott; Theresa Ann,1,0,15,14
1746573140726,EDS 284,A00,895736,Meyerott; Theresa Ann,1,0,15,14
1746573141761,EDS 286,A00,897210,Fine; Sarah,0,0,15,15
1746573142794,EDS 289C,A01,895770,Daly; Alan J.,1,0,15,14
1746573143821,EDS 290,A00,897211,Hofstetter; Carolyn,0,0,15,15
1746573144850,LIGM 5A,A00,896162,Fischer-Grunski; Eva K,12,0,20,8
1746573145883,LIGM 5B,A00,896260,Fischer-Grunski; Eva K,17,0,20,3
1746573146911,LIGM 5C,A00,896308,Fischer-Grunski; Eva K,18,0,20,2
1746573147939,LIIT 5AS,A00,896313,Carnelos; Chiara,18,0,20,2
1746573148970,LIIT 5BS,A00,896416,Carnelos; Chiara,20,0,20,0
1746573149997,LIIT 5CS,A00,896564,Carnelos; Chiara,20,0,20,0
1746573151024,LISP 5A,A00,896588,Munoz Sanchez; Alicia,2,0,20,18
1746573152053,LISP 5B,A00,896653,Munoz Sanchez; Alicia,7,0,20,13
1746573153081,LISP 5C,A00,896655,Munoz Sanchez; Alicia,0,1,20,20
1746573154107,MAE 197,001,957918,Kleissl; Jan,9996,0,9999,3
1746573154107,MAE 197,002,959806,Boechler; Nicholas Sebastia,9998,0,9999,1
1746573154107,MAE 197,003,959852,Mullin; Jennifer S,9998,0,9999,1
1746573155134,MATH 2,A01,957937,Staff,33,0,35,2
1746573156168,MATH 197,001,957876,Kedlaya; Kiran S.,9993,0,9999,6
1746573157196,MCWP 40,A00,892729,Duru; Nur,10,0,20,10
1746573157196,MCWP 40,B00,893304,Montejo; Carolina,14,0,20,6
1746573158224,MCWP 40R,A00,893757,Redela; Pamela Morgan,0,5,20,20
1746573159253,MCWP 50,A00,893758,Morshed; Michael James,0,0,20,20
1746573159253,MCWP 50,B00,893761,Bartulis; Jason Michael,17,0,20,3
1746573160281,MCWP 50R,A00,893766,Compas; Sean Matthew,0,1,20,20
1746573160281,MCWP 50R,B00,893769,Carter; Jennifer A,0,1,20,20
1746573160281,MCWP 50R,C00,893771,Krone; Jarret,0,3,20,20
1746573160281,MCWP 50R,D00,893772,Miller; Elizabeth Deen,0,0,20,20
1746573160281,MCWP 50R,E00,893775,Carter; Andrea L,0,1,20,20
1746573161311,MMW 11R,A01,892721,Herbst; Matthew,11,0,27,16
1746573161311,MMW 11R,A02,892722,Herbst; Matthew,0,0,0,3
1746573162343,MMW 12R,A01,892724,Herbst; Matthew,0,11,16,16
1746573162343,MMW 12R,A02,892725,Herbst; Matthew,0,10,16,16
1746573163373,MMW 13R,A01,892727,Staff,0,4,16,16
1746573163373,MMW 13R,A02,892728,Staff,0,4,16,16
1746573163373,MMW 13R,A03,958032,Staff,0,4,16,16
1746573163373,MMW 13R,A04,958033,Staff,0,4,16,16
1746573163373,MMW 13R,A05,958034,Staff,0,4,16,16
1746573164408,SIO 295LS,A00,894015,Staff,5,0,25,20
1746573165440,SIO 295S,A00,894020,Staff,5,0,25,20
1746573166471,SIOC 290S,B01,958918,Merrifield; Mark A,14,0,30,16
1746573167499,SIOC 291S,B01,958922,Gabriel; Corey John,14,0,30,16
1746573168526,SOCI 117,A01,895339,Staff,3,0,5,2
1746573169558,WES 237B,A00,894149,Staff,11,0,20,9
1746573171636,AESE 279B,A00,891859,Staff,13,0,35,22
1746573172664,AIP 197,001,891854,Vespa; Emanuel Ignacio,9999,0,9999,0
1746573173695,ANTH 289S,A00,891856,Gagneux; Pascal,12,0,12,0
1746573174722,BENG 196,001,957946,Engler; Adam J.,9996,0,9999,3
1746573175751,BISP 197,001,959851,Wilhelm; James E.,9998,0,9999,1
1746573176783,CAT 124RS,A01,956906,Staff,6,0,25,19
1746573177809,CAT 125RS,A01,922013,Staff,6,0,25,19
1746573178835,CLRE 250,A00,891860,Morris; Sheldon,9995,0,9999,4
1746573180891,CLRE 251R,A00,907817,Mehta; Ravindra L.,9994,0,9999,5
1746573181919,CLRE 252,A00,891864,Cuomo; Raphael Eduardo,9993,0,9999,6
1746573182948,CLRE 253,A00,891867,Vaida; Florin,9994,0,9999,5
1746573182948,CLRE 253,B00,907819,Staff,9999,0,9999,0
1746573183975,CLRE 259,A00,891868,Patel; Hemal,9998,0,9999,1
1746573185003,CLRE 260,A00,891872,Cuomo; Raphael Eduardo,9999,0,9999,0
1746573186030,CLRE 297,001,891888,Cuomo; Raphael Eduardo,9999,0,9999,0
1746573187061,CSE 191,A00,958773,Minnes Kemp; Mor Mia,9995,0,9999,4
1746573188088,CSE 197,001,959846,Minnes Kemp; Mor Mia,9990,0,9999,9
1746573189118,CSS 201S,A01,892054,Mignozzetti; Umberto,25,0,30,5
1746573190150,CSS 202S,A01,892056,Mignozzetti; Umberto,25,0,30,5
1746573191184,DSC 197,001,956898,Eldridge; Justin Matthew,9996,0,9999,3
1746573192214,DSC 297,001,958000,Mazumdar; Arya,9998,0,9999,1
1746573192214,DSC 297,002,959862,Wang; Yusu,9998,0,9999,1
1746573193240,EAP 100,A00,905686,Staff,9778,0,9999,221
1746573194269,ECE 45,A01,892618,Staff,0,0,65,65
1746573196326,ECE 111,A01,892719,Staff,5,0,65,60
1746573197355,ECE 197,001,957920,Mercier; Patrick Philip,9991,0,9999,8
1746573198388,ECON 178,A01,907814,Zhu; Ying,26,0,35,9
1746573199420,EDS 115,A00,895312,Staff,35,0,45,10
1746573200451,EDS 117,A01,895337,Staff,23,0,30,7
1746573201484,EDS 125,A00,895341,Jones; Gabrielle Anastasia,36,0,45,9
1746573202512,EDS 128A,A01,895459,Fargason; Sharon Gayle,44,0,45,1
1746573203544,EDS 128B,A01,895543,Pappas; Elizabeth,44,0,45,1
1746573204573,EDS 139,A00,897203,Pappas; Elizabeth,44,0,45,1
1746573204573,EDS 139,B00,897209,Fargason; Sharon Gayle,41,0,45,4
1746573205602,EDS 201,A00,895545,Staff,22,0,45,23
1746573206629,EDS 203,A01,895581,Halter; Christopher P.,22,0,45,23
1746573207661,EDS 204R,A01,895625,Heinzman; Erica M.,39,0,45,6
1746573207661,EDS 204R,B01,895693,Halter; Christopher P.,10,0,45,35
1746573208690,EDS 206R,A00,895694,Fargason; Sharon Gayle,1,0,30,29
1746573208690,EDS 206R,B00,895695,Choi; Bailey Miyeon,16,0,30,14
1746573209722,EDS 250,A00,895697,Hemans; Patricia Ann Benitez,22,0,45,23
1746573210753,EDS 281,A00,895701,Meyerott; Theresa Ann,1,0,15,14
1746573211780,EDS 284,A00,895736,Meyerott; Theresa Ann,1,0,15,14
1746573212809,EDS 286,A00,897210,Fine; Sarah,0,0,15,15
1746573213839,EDS 289C,A01,895770,Daly; Alan J.,1,0,15,14
1746573214868,EDS 290,A00,897211,Hofstetter; Carolyn,0,0,15,15
1746573215900,LIGM 5A,A00,896162,Fischer-Grunski; Eva K,12,0,20,8
1746573216939,LIGM 5B,A00,896260,Fischer-Grunski; Eva K,17,0,20,3
1746573217971,LIGM 5C,A00,896308,Fischer-Grunski; Eva K,18,0,20,2
1746573218998,LIIT 5AS,A00,896313,Carnelos; Chiara,18,0,20,2
1746573220027,LIIT 5BS,A00,896416,Carnelos; Chiara,20,0,20,0
1746573221059,LIIT 5CS,A00,896564,Carnelos; Chiara,20,0,20,0
1746573222092,LISP 5A,A00,896588,Munoz Sanchez; Alicia,2,0,20,18
1746573223121,LISP 5B,A00,896653,Munoz Sanchez; Alicia,7,0,20,13
1746573224149,LISP 5C,A00,896655,Munoz Sanchez; Alicia,0,1,20,20
1746573225183,MAE 197,001,957918,Kleissl; Jan,9996,0,9999,3
1746573225183,MAE 197,002,959806,Boechler; Nicholas Sebastia,9998,0,9999,1
1746573225183,MAE 197,003,959852,Mullin; Jennifer S,9998,0,9999,1
1746573226210,MATH 2,A01,957937,Staff,33,0,35,2
1746573227242,MATH 197,001,957876,Kedlaya; Kiran S.,9993,0,9999,6
1746573228274,MCWP 40,A00,892729,Duru; Nur,10,0,20,10
1746573228274,MCWP 40,B00,893304,Montejo; Carolina,14,0,20,6
1746573229306,MCWP 40R,A00,893757,Redela; Pamela Morgan,0,5,20,20
1746573230340,MCWP 50,A00,893758,Morshed; Michael James,0,0,20,20
1746573230340,MCWP 50,B00,893761,Bartulis; Jason Michael,17,0,20,3
1746573231373,MCWP 50R,A00,893766,Compas; Sean Matthew,0,1,20,20
1746573231373,MCWP 50R,B00,893769,Carter; Jennifer A,0,1,20,20
1746573231373,MCWP 50R,C00,893771,Krone; Jarret,0,3,20,20
1746573231373,MCWP 50R,D00,893772,Miller; Elizabeth Deen,0,0,20,20
1746573231373,MCWP 50R,E00,893775,Carter; Andrea L,0,1,20,20
1746573232411,MMW 11R,A01,892721,Herbst; Matthew,11,0,27,16
1746573232411,MMW 11R,A02,892722,Herbst; Matthew,0,0,0,3
1746573233443,MMW 12R,A01,892724,Herbst; Matthew,0,11,16,16
1746573233443,MMW 12R,A02,892725,Herbst; Matthew,0,10,16,16
1746573234473,MMW 13R,A01,892727,Staff,0,4,16,16
1746573234473,MMW 13R,A02,892728,Staff,0,4,16,16
1746573234473,MMW 13R,A03,958032,Staff,0,4,16,16
1746573234473,MMW 13R,A04,958033,Staff,0,4,16,16
1746573234473,MMW 13R,A05,958034,Staff,0,4,16,16
1746573235501,SIO 295LS,A00,894015,Staff,5,0,25,20
1746573236527,SIO 295S,A00,894020,Staff,5,0,25,20
1746573237561,SIOC 290S,B01,958918,Merrifield; Mark A,14,0,30,16
1746573238588,SIOC 291S,B01,958922,Gabriel; Corey John,14,0,30,16
1746573239616,SOCI 117,A01,895339,Staff,3,0,5,2
1746573240645,WES 237B,A00,894149,Staff,11,0,20,9
1746573242710,AESE 279B,A00,891859,Staff,13,0,35,22
1746573243736,AIP 197,001,891854,Vespa; Emanuel Ignacio,9999,0,9999,0
1746573244764,ANTH 289S,A00,891856,Gagneux; Pascal,12,0,12,0
1746573245791,BENG 196,001,957946,Engler; Adam J.,9996,0,9999,3
1746573246824,BISP 197,001,959851,Wilhelm; James E.,9998,0,9999,1
1746573247853,CAT 124RS,A01,956906,Staff,6,0,25,19
1746573248879,CAT 125RS,A01,922013,Staff,6,0,25,19
1746573249906,CLRE 250,A00,891860,Morris; Sheldon,9995,0,9999,4
1746573251966,CLRE 251R,A00,907817,Mehta; Ravindra L.,9994,0,9999,5
1746573252997,CLRE 252,A00,891864,Cuomo; Raphael Eduardo,9993,0,9999,6
1746573254024,CLRE 253,A00,891867,Vaida; Florin,9994,0,9999,5
1746573254024,CLRE 253,B00,907819,Staff,9999,0,9999,0
1746573255057,CLRE 259,A00,891868,Patel; Hemal,9998,0,9999,1
1746573256083,CLRE 260,A00,891872,Cuomo; Raphael Eduardo,9999,0,9999,0
1746573257111,CLRE 297,001,891888,Cuomo; Raphael Eduardo,9999,0,9999,0
1746573258138,CSE 191,A00,958773,Minnes Kemp; Mor Mia,9995,0,9999,4
1746573259165,CSE 197,001,959846,Minnes Kemp; Mor Mia,9990,0,9999,9
1746573260198,CSS 201S,A01,892054,Mignozzetti; Umberto,25,0,30,5
1746573261226,CSS 202S,A01,892056,Mignozzetti; Umberto,25,0,30,5
1746573262253,DSC 197,001,956898,Eldridge; Justin Matthew,9996,0,9999,3
1746573263284,DSC 297,001,958000,Mazumdar; Arya,9998,0,9999,1
1746573263284,DSC 297,002,959862,Wang; Yusu,9998,0,9999,1
1746573264313,EAP 100,A00,905686,Staff,9778,0,9999,221
1746573265347,ECE 45,A01,892618,Staff,0,0,65,65
1746573267402,ECE 111,A01,892719,Staff,5,0,65,60
1746573268430,ECE 197,001,957920,Mercier; Patrick Philip,9991,0,9999,8
1746573269460,ECON 178,A01,907814,Zhu; Ying,26,0,35,9
1746573270487,EDS 115,A00,895312,Staff,35,0,45,10
1746573271515,EDS 117,A01,895337,Staff,23,0,30,7
1746573272546,EDS 125,A00,895341,Jones; Gabrielle Anastasia,36,0,45,9
1746573273574,EDS 128A,A01,895459,Fargason; Sharon Gayle,44,0,45,1
1746573274603,EDS 128B,A01,895543,Pappas; Elizabeth,44,0,45,1
1746573275630,EDS 139,A00,897203,Pappas; Elizabeth,44,0,45,1
1746573275630,EDS 139,B00,897209,Fargason; Sharon Gayle,41,0,45,4
1746573276657,EDS 201,A00,895545,Staff,22,0,45,23
1746573277682,EDS 203,A01,895581,Halter; Christopher P.,22,0,45,23
1746573278710,EDS 204R,A01,895625,Heinzman; Erica M.,39,0,45,6
1746573278710,EDS 204R,B01,895693,Halter; Christopher P.,10,0,45,35
1746573279736,EDS 206R,A00,895694,Fargason; Sharon Gayle,1,0,30,29
1746573279736,EDS 206R,B00,895695,Choi; Bailey Miyeon,16,0,30,14
1746573280764,EDS 250,A00,895697,Hemans; Patricia Ann Benitez,22,0,45,23
1746573281794,EDS 281,A00,895701,Meyerott; Theresa Ann,1,0,15,14
1746573282824,EDS 284,A00,895736,Meyerott; Theresa Ann,1,0,15,14
1746573283853,EDS 286,A00,897210,Fine; Sarah,0,0,15,15
1746573284882,EDS 289C,A01,895770,Daly; Alan J.,1,0,15,14
1746573285908,EDS 290,A00,897211,Hofstetter; Carolyn,0,0,15,15
1746573286935,LIGM 5A,A00,896162,Fischer-Grunski; Eva K,12,0,20,8
1746573287964,LIGM 5B,A00,896260,Fischer-Grunski; Eva K,17,0,20,3
1746573288995,LIGM 5C,A00,896308,Fischer-Grunski; Eva K,18,0,20,2
1746573290022,LIIT 5AS,A00,896313,Carnelos; Chiara,18,0,20,2
1746573291048,LIIT 5BS,A00,896416,Carnelos; Chiara,20,0,20,0
1746573292074,LIIT 5CS,A00,896564,Carnelos; Chiara,20,0,20,0
1746573293100,LISP 5A,A00,896588,Munoz Sanchez; Alicia,2,0,20,18
1746573294130,LISP 5B,A00,896653,Munoz Sanchez; Alicia,7,0,20,13
1746573295157,LISP 5C,A00,896655,Munoz Sanchez; Alicia,0,1,20,20
1746573296187,MAE 197,001,957918,Kleissl; Jan,9996,0,9999,3
1746573296187,MAE 197,002,959806,Boechler; Nicholas Sebastia,9998,0,9999,1
1746573296187,MAE 197,003,959852,Mullin; Jennifer S,9998,0,9999,1
1746573297213,MATH 2,A01,957937,Staff,33,0,35,2
1746573298238,MATH 197,001,957876,Kedlaya; Kiran S.,9993,0,9999,6
1746573299270,MCWP 40,A00,892729,Duru; Nur,10,0,20,10
1746573299270,MCWP 40,B00,893304,Montejo; Carolina,14,0,20,6
1746573300299,MCWP 40R,A00,893757,Redela; Pamela Morgan,0,5,20,20
1746573301326,MCWP 50,A00,893758,Morshed; Michael James,0,0,20,20
1746573301326,MCWP 50,B00,893761,Bartulis; Jason Michael,17,0,20,3
1746573302359,MCWP 50R,A00,893766,Compas; Sean Matthew,0,1,20,20
1746573302359,MCWP 50R,B00,893769,Carter; Jennifer A,0,1,20,20
1746573302359,MCWP 50R,C00,893771,Krone; Jarret,0,3,20,20
1746573302359,MCWP 50R,D00,893772,Miller; Elizabeth Deen,0,0,20,20
1746573302359,MCWP 50R,E00,893775,Carter; Andrea L,0,1,20,20
1746573303389,MMW 11R,A01,892721,Herbst; Matthew,11,0,27,16
1746573303389,MMW 11R,A02,892722,Herbst; Matthew,0,0,0,3
1746573304415,MMW 12R,A01,892724,Herbst; Matthew,0,11,16,16
1746573304415,MMW 12R,A02,892725,Herbst; Matthew,0,10,16,16
1746573305446,MMW 13R,A01,892727,Staff,0,4,16,16
1746573305446,MMW 13R,A02,892728,Staff,0,4,16,16
1746573305446,MMW 13R,A03,958032,Staff,0,4,16,16
1746573305446,MMW 13R,A04,958033,Staff,0,4,16,16
1746573305446,MMW 13R,A05,958034,Staff,0,4,16,16
1746573306476,SIO 295LS,A00,894015,Staff,5,0,25,20
1746573307504,SIO 295S,A00,894020,Staff,5,0,25,20
1746573308531,SIOC 290S,B01,958918,Merrifield; Mark A,14,0,30,16
1746573309559,SIOC 291S,B01,958922,Gabriel; Corey John,14,0,30,16
1746573310586,SOCI 117,A01,895339,Staff,3,0,5,2
1746573311624,WES 237B,A00,894149,Staff,11,0,20,9
1746573313684,AESE 279B,A00,891859,Staff,13,0,35,22
1746573314712,AIP 197,001,891854,Vespa; Emanuel Ignacio,9999,0,9999,0
1746573315743,ANTH 289S,A00,891856,Gagneux; Pascal,12,0,12,0
1746573316767,BENG 196,001,957946,Engler; Adam J.,9996,0,9999,3
1746573317794,BISP 197,001,959851,Wilhelm; James E.,9998,0,9999,1
1746573318822,CAT 124RS,A01,956906,Staff,6,0,25,19
1746573319850,CAT 125RS,A01,922013,Staff,6,0,25,19
1746573320881,CLRE 250,A00,891860,Morris; Sheldon,9995,0,9999,4
1746573322935,CLRE 251R,A00,907817,Mehta; Ravindra L.,9994,0,9999,5
1746573323962,CLRE 252,A00,891864,Cuomo; Raphael Eduardo,9993,0,9999,6
1746573324990,CLRE 253,A00,891867,Vaida; Florin,9994,0,9999,5
1746573324990,CLRE 253,B00,907819,Staff,9999,0,9999,0
1746573326020,CLRE 259,A00,891868,Patel; Hemal,9998,0,9999,1
1746573327046,CLRE 260,A00,891872,Cuomo; Raphael Eduardo,9999,0,9999,0
1746573328073,CLRE 297,001,891888,Cuomo; Raphael Eduardo,9999,0,9999,0
1746573329102,CSE 191,A00,958773,Minnes Kemp; Mor Mia,9995,0,9999,4
1746573330133,CSE 197,001,959846,Minnes Kemp; Mor Mia,9990,0,9999,9
1746573331159,CSS 201S,A01,892054,Mignozzetti; Umberto,25,0,30,5
1746573332186,CSS 202S,A01,892056,Mignozzetti; Umberto,25,0,30,5
1746573333213,DSC 197,001,956898,Eldridge; Justin Matthew,9996,0,9999,3
1746573334241,DSC 297,001,958000,Mazumdar; Arya,9998,0,9999,1
1746573334241,DSC 297,002,959862,Wang; Yusu,9998,0,9999,1
1746573335267,EAP 100,A00,905686,Staff,9778,0,9999,221
1746573336295,ECE 45,A01,892618,Staff,0,0,65,65
1746573338348,ECE 111,A01,892719,Staff,5,0,65,60
1746573339374,ECE 197,001,957920,Mercier; Patrick Philip,9991,0,9999,8
1746573340405,ECON 178,A01,907814,Zhu; Ying,26,0,35,9
1746573341432,EDS 115,A00,895312,Staff,35,0,45,10
1746573342461,EDS 117,A01,895337,Staff,23,0,30,7
1746573343488,EDS 125,A00,895341,Jones; Gabrielle Anastasia,36,0,45,9
1746573344513,EDS 128A,A01,895459,Fargason; Sharon Gayle,44,0,45,1
1746573345540,EDS 128B,A01,895543,Pappas; Elizabeth,44,0,45,1
1746573346569,EDS 139,A00,897203,Pappas; Elizabeth,44,0,45,1
1746573346569,EDS 139,B00,897209,Fargason; Sharon Gayle,41,0,45,4
1746573347596,EDS 201,A00,895545,Staff,22,0,45,23
1746573348622,EDS 203,A01,895581,Halter; Christopher P.,22,0,45,23
1746573349652,EDS 204R,A01,895625,Heinzman; Erica M.,39,0,45,6
1746573349652,EDS 204R,B01,895693,Halter; Christopher P.,10,0,45,35
1746573350679,EDS 206R,A00,895694,Fargason; Sharon Gayle,1,0,30,29
1746573350679,EDS 206R,B00,895695,Choi; Bailey Miyeon,16,0,30,14
1746573351705,EDS 250,A00,895697,Hemans; Patricia Ann Benitez,22,0,45,23
1746573352736,EDS 281,A00,895701,Meyerott; Theresa Ann,1,0,15,14
1746573353762,EDS 284,A00,895736,Meyerott; Theresa Ann,1,0,15,14
1746573354788,EDS 286,A00,897210,Fine; Sarah,0,0,15,15
1746573355815,EDS 289C,A01,895770,Daly; Alan J.,1,0,15,14
1746573356847,EDS 290,A00,897211,Hofstetter; Carolyn,0,0,15,15
1746573357873,LIGM 5A,A00,896162,Fischer-Grunski; Eva K,12,0,20,8
1746573358905,LIGM 5B,A00,896260,Fischer-Grunski; Eva K,17,0,20,3
1746573359932,LIGM 5C,A00,896308,Fischer-Grunski; Eva K,18,0,20,2
1746573360963,LIIT 5AS,A00,896313,Carnelos; Chiara,18,0,20,2
1746573361994,LIIT 5BS,A00,896416,Carnelos; Chiara,20,0,20,0
1746573363021,LIIT 5CS,A00,896564,Carnelos; Chiara,20,0,20,0
1746573364048,LISP 5A,A00,896588,Munoz Sanchez; Alicia,2,0,20,18
1746573365074,LISP 5B,A00,896653,Munoz Sanchez; Alicia,7,0,20,13
1746573366101,LISP 5C,A00,896655,Munoz Sanchez; Alicia,0,1,20,20
1746573367129,MAE 197,001,957918,Kleissl; Jan,9996,0,9999,3
1746573367129,MAE 197,002,959806,Boechler; Nicholas Sebastia,9998,0,9999,1
1746573367129,MAE 197,003,959852,Mullin; Jennifer S,9998,0,9999,1
1746573368158,MATH 2,A01,957937,Staff,33,0,35,2
1746573369185,MATH 197,001,957876,Kedlaya; Kiran S.,9993,0,9999,6
1746573370214,MCWP 40,A00,892729,Duru; Nur,10,0,20,10
1746573370214,MCWP 40,B00,893304,Montejo; Carolina,14,0,20,6
1746573371241,MCWP 40R,A00,893757,Redela; Pamela Morgan,0,5,20,20
1746573372270,MCWP 50,A00,893758,Morshed; Michael James,0,0,20,20
1746573372270,MCWP 50,B00,893761,Bartulis; Jason Michael,17,0,20,3
1746573373297,MCWP 50R,A00,893766,Compas; Sean Matthew,0,1,20,20
1746573373297,MCWP 50R,B00,893769,Carter; Jennifer A,0,1,20,20
1746573373297,MCWP 50R,C00,893771,Krone; Jarret,0,3,20,20
1746573373297,MCWP 50R,D00,893772,Miller; Elizabeth Deen,0,0,20,20
1746573373297,MCWP 50R,E00,893775,Carter; Andrea L,0,1,20,20
1746573374411,MMW 11R,A01,892721,Herbst; Matthew,11,0,27,16
1746573374411,MMW 11R,A02,892722,Herbst; Matthew,0,0,0,3
1746573375443,MMW 12R,A01,892724,Herbst; Matthew,0,11,16,16
1746573375443,MMW 12R,A02,892725,Herbst; Matthew,0,10,16,16
1746573376468,MMW 13R,A01,892727,Staff,0,4,16,16
1746573376468,MMW 13R,A02,892728,Staff,0,4,16,16
1746573376468,MMW 13R,A03,958032,Staff,0,4,16,16
1746573376468,MMW 13R,A04,958033,Staff,0,4,16,16
1746573376468,MMW 13R,A05,958034,Staff,0,4,16,16
1746573377499,SIO 295LS,A00,894015,Staff,5,0,25,20
1746573378527,SIO 295S,A00,894020,Staff,5,0,25,20
1746573379554,SIOC 290S,B01,958918,Merrifield; Mark A,14,0,30,16
1746573380582,SIOC 291S,B01,958922,Gabriel; Corey John,14,0,30,16
1746573381608,SOCI 117,A01,895339,Staff,3,0,5,2
1746573382639,WES 237B,A00,894149,Staff,11,0,20,9
1746573384704,AESE 279B,A00,891859,Staff,13,0,35,22
1746573385729,AIP 197,001,891854,Vespa; Emanuel Ignacio,9999,0,9999,0
1746573386754,ANTH 289S,A00,891856,Gagneux; Pascal,12,0,12,0
1746573387779,BENG 196,001,957946,Engler; Adam J.,9996,0,9999,3
1746573388809,BISP 197,001,959851,Wilhelm; James E.,9998,0,9999,1
1746573389835,CAT 124RS,A01,956906,Staff,6,0,25,19
1746573390862,CAT 125RS,A01,922013,Staff,6,0,25,19
1746573391891,CLRE 250,A00,891860,Morris; Sheldon,9995,0,9999,4
1746573393944,CLRE 251R,A00,907817,Mehta; Ravindra L.,9994,0,9999,5
1746573394975,CLRE 252,A00,891864,Cuomo; Raphael Eduardo,9993,0,9999,6
1746573396002,CLRE 253,A00,891867,Vaida; Florin,9994,0,9999,5
1746573396002,CLRE 253,B00,907819,Staff,9999,0,9999,0
1746573397033,CLRE 259,A00,891868,Patel; Hemal,9998,0,9999,1
1746573398062,CLRE 260,A00,891872,Cuomo; Raphael Eduardo,9999,0,9999,0
1746573399092,CLRE 297,001,891888,Cuomo; Raphael Eduardo,9999,0,9999,0
1746573400117,CSE 191,A00,958773,Minnes Kemp; Mor Mia,9995,0,9999,4
1746573401147,CSE 197,001,959846,Minnes Kemp; Mor Mia,9990,0,9999,9
1746573402178,CSS 201S,A01,892054,Mignozzetti; Umberto,25,0,30,5
1746573403208,CSS 202S,A01,892056,Mignozzetti; Umberto,25,0,30,5
1746573404233,DSC 197,001,956898,Eldridge; Justin Matthew,9996,0,9999,3
1746573405258,DSC 297,001,958000,Mazumdar; Arya,9998,0,9999,1
1746573405258,DSC 297,002,959862,Wang; Yusu,9998,0,9999,1
1746573406284,EAP 100,A00,905686,Staff,9778,0,9999,221
1746573407313,ECE 45,A01,892618,Staff,0,0,65,65
1746573409369,ECE 111,A01,892719,Staff,5,0,65,60
1746573410398,ECE 197,001,957920,Mercier; Patrick Philip,9991,0,9999,8
1746573411423,ECON 178,A01,907814,Zhu; Ying,26,0,35,9
1746573412453,EDS 115,A00,895312,Staff,35,0,45,10
1746573413478,EDS 117,A01,895337,Staff,23,0,30,7
1746573414504,EDS 125,A00,895341,Jones; Gabrielle Anastasia,36,0,45,9
1746573415537,EDS 128A,A01,895459,Fargason; Sharon Gayle,44,0,45,1
1746573416562,EDS 128B,A01,895543,Pappas; Elizabeth,44,0,45,1
1746573417587,EDS 139,A00,897203,Pappas; Elizabeth,44,0,45,1
1746573417587,EDS 139,B00,897209,Fargason; Sharon Gayle,41,0,45,4
1746573418614,EDS 201,A00,895545,Staff,22,0,45,23
1746573419640,EDS 203,A01,895581,Halter; Christopher P.,22,0,45,23
1746573420669,EDS 204R,A01,895625,Heinzman; Erica M.,39,0,45,6
1746573420669,EDS 204R,B01,895693,Halter; Christopher P.,10,0,45,35
1746573421698,EDS 206R,A00,895694,Fargason; Sharon Gayle,1,0,30,29
1746573421698,EDS 206R,B00,895695,Choi; Bailey Miyeon,16,0,30,14
1746573422727,EDS 250,A00,895697,Hemans; Patricia Ann Benitez,22,0,45,23
1746573423756,EDS 281,A00,895701,Meyerott; Theresa Ann,1,0,15,14
1746573424785,EDS 284,A00,895736,Meyerott; Theresa Ann,1,0,15,14
1746573425811,EDS 286,A00,897210,Fine; Sarah,0,0,15,15
1746573426837,EDS 289C,A01,895770,Daly; Alan J.,1,0,15,14
1746573427863,EDS 290,A00,897211,Hofstetter; Carolyn,0,0,15,15
1746573428889,LIGM 5A,A00,896162,Fischer-Grunski; Eva K,12,0,20,8
1746573429915,LIGM 5B,A00,896260,Fischer-Grunski; Eva K,17,0,20,3
1746573430940,LIGM 5C,A00,896308,Fischer-Grunski; Eva K,18,0,20,2
1746573431967,LIIT 5AS,A00,896313,Carnelos; Chiara,18,0,20,2
1746573432993,LIIT 5BS,A00,896416,Carnelos; Chiara,20,0,20,0
1746573434021,LIIT 5CS,A00,896564,Carnelos; Chiara,20,0,20,0
1746573435046,LISP 5A,A00,896588,Munoz Sanchez; Alicia,2,0,20,18
1746573436074,LISP 5B,A00,896653,Munoz Sanchez; Alicia,7,0,20,13
1746573437101,LISP 5C,A00,896655,Munoz Sanchez; Alicia,0,1,20,20
1746573438126,MAE 197,001,957918,Kleissl; Jan,9996,0,9999,3
1746573438126,MAE 197,002,959806,Boechler; Nicholas Sebastia,9998,0,9999,1
1746573438126,MAE 197,003,959852,Mullin; Jennifer S,9998,0,9999,1
1746573439154,MATH 2,A01,957937,Staff,33,0,35,2
1746573440180,MATH 197,001,957876,Kedlaya; Kiran S.,9993,0,9999,6
1746573441206,MCWP 40,A00,892729,Duru; Nur,10,0,20,10
1746573441206,MCWP 40,B00,893304,Montejo; Carolina,14,0,20,6
1746573442232,MCWP 40R,A00,893757,Redela; Pamela Morgan,0,5,20,20
1746573443259,MCWP 50,A00,893758,Morshed; Michael James,0,0,20,20
1746573443259,MCWP 50,B00,893761,Bartulis; Jason Michael,17,0,20,3
1746573444286,MCWP 50R,A00,893766,Compas; Sean Matthew,0,1,20,20
1746573444286,MCWP 50R,B00,893769,Carter; Jennifer A,0,1,20,20
1746573444286,MCWP 50R,C00,893771,Krone; Jarret,0,3,20,20
1746573444286,MCWP 50R,D00,893772,Miller; Elizabeth Deen,0,0,20,20
1746573444286,MCWP 50R,E00,893775,Carter; Andrea L,0,1,20,20
1746573445313,MMW 11R,A01,892721,Herbst; Matthew,11,0,27,16
1746573445313,MMW 11R,A02,892722,Herbst; Matthew,0,0,0,3
1746573446341,MMW 12R,A01,892724,Herbst; Matthew,0,11,16,16
1746573446341,MMW 12R,A02,892725,Herbst; Matthew,0,10,16,16
1746573447371,MMW 13R,A01,892727,Staff,0,4,16,16
1746573447371,MMW 13R,A02,892728,Staff,0,4,16,16
1746573447371,MMW 13R,A03,958032,Staff,0,4,16,16
1746573447371,MMW 13R,A04,958033,Staff,0,4,16,16
1746573447371,MMW 13R,A05,958034,Staff,0,4,16,16
1746573448396,SIO 295LS,A00,894015,Staff,5,0,25,20
1746573449420,SIO 295S,A00,894020,Staff,5,0,25,20
1746573450448,SIOC 290S,B01,958918,Merrifield; Mark A,14,0,30,16
1746573451473,SIOC 291S,B01,958922,Gabriel; Corey John,14,0,30,16
1746573452504,SOCI 117,A01,895339,Staff,3,0,5,2
1746573453529,WES 237B,A00,894149,Staff,11,0,20,9
1746573455591,AESE 279B,A00,891859,Staff,13,0,35,22
1746573456616,AIP 197,001,891854,Vespa; Emanuel Ignacio,9999,0,9999,0
1746573457640,ANTH 289S,A00,891856,Gagneux; Pascal,12,0,12,0
1746573458666,BENG 196,001,957946,Engler; Adam J.,9996,0,9999,3
1746573459691,BISP 197,001,959851,Wilhelm; James E.,9998,0,9999,1
1746573460721,CAT 124RS,A01,956906,Staff,6,0,25,19
1746573461745,CAT 125RS,A01,922013,Staff,6,0,25,19
1746573462770,CLRE 250,A00,891860,Morris; Sheldon,9995,0,9999,4
1746573464828,CLRE 251R,A00,907817,Mehta; Ravindra L.,9994,0,9999,5
1746573465855,CLRE 252,A00,891864,Cuomo; Raphael Eduardo,9993,0,9999,6
1746573466885,CLRE 253,A00,891867,Vaida; Florin,9994,0,9999,5
1746573466885,CLRE 253,B00,907819,Staff,9999,0,9999,0
1746573467914,CLRE 259,A00,891868,Patel; Hemal,9998,0,9999,1
1746573468938,CLRE 260,A00,891872,Cuomo; Raphael Eduardo,9999,0,9999,0
1746573469966,CLRE 297,001,891888,Cuomo; Raphael Eduardo,9999,0,9999,0
1746573470991,CSE 191,A00,958773,Minnes Kemp; Mor Mia,9995,0,9999,4
1746573472016,CSE 197,001,959846,Minnes Kemp; Mor Mia,9990,0,9999,9
1746573473040,CSS 201S,A01,892054,Mignozzetti; Umberto,25,0,30,5
1746573474066,CSS 202S,A01,892056,Mignozzetti; Umberto,25,0,30,5
1746573475091,DSC 197,001,956898,Eldridge; Justin Matthew,9996,0,9999,3
1746573476116,DSC 297,001,958000,Mazumdar; Arya,9998,0,9999,1
1746573476116,DSC 297,002,959862,Wang; Yusu,9998,0,9999,1
1746573477141,EAP 100,A00,905686,Staff,9778,0,9999,221
1746573478171,ECE 45,A01,892618,Staff,0,0,65,65
1746573480224,ECE 111,A01,892719,Staff,5,0,65,60
1746573481254,ECE 197,001,957920,Mercier; Patrick Philip,9991,0,9999,8
1746573482281,ECON 178,A01,907814,Zhu; Ying,26,0,35,9
1746573483308,EDS 115,A00,895312,Staff,35,0,45,10
1746573484334,EDS 117,A01,895337,Staff,23,0,30,7
1746573485360,EDS 125,A00,895341,Jones; Gabrielle Anastasia,36,0,45,9
1746573486391,EDS 128A,A01,895459,Fargason; Sharon Gayle,44,0,45,1
1746573487421,EDS 128B,A01,895543,Pappas; Elizabeth,44,0,45,1
1746573488451,EDS 139,A00,897203,Pappas; Elizabeth,44,0,45,1
1746573488451,EDS 139,B00,897209,Fargason; Sharon Gayle,41,0,45,4
1746573489481,EDS 201,A00,895545,Staff,22,0,45,23
1746573490509,EDS 203,A01,895581,Halter; Christopher P.,22,0,45,23
1746573491535,EDS 204R,A01,895625,Heinzman; Erica M.,39,0,45,6
1746573491535,EDS 204R,B01,895693,Halter; Christopher P.,10,0,45,35
1746573492562,EDS 206R,A00,895694,Fargason; Sharon Gayle,1,0,30,29
1746573492562,EDS 206R,B00,895695,Choi; Bailey Miyeon,16,0,30,14
1746573493587,EDS 250,A00,895697,Hemans; Patricia Ann Benitez,22,0,45,23
1746573494613,EDS 281,A00,895701,Meyerott; Theresa Ann,1,0,15,14
1746573495637,EDS 284,A00,895736,Meyerott; Theresa Ann,1,0,15,14
1746573496662,EDS 286,A00,897210,Fine; Sarah,0,0,15,15
1746573497693,EDS 289C,A01,895770,Daly; Alan J.,1,0,15,14
1746573498720,EDS 290,A00,897211,Hofstetter; Carolyn,0,0,15,15
1746573499756,LIGM 5A,A00,896162,Fischer-Grunski; Eva K,12,0,20,8
1746573500783,LIGM 5B,A00,896260,Fischer-Grunski; Eva K,17,0,20,3
1746573501808,LIGM 5C,A00,896308,Fischer-Grunski; Eva K,18,0,20,2
1746573502837,LIIT 5AS,A00,896313,Carnelos; Chiara,18,0,20,2
1746573503865,LIIT 5BS,A00,896416,Carnelos; Chiara,20,0,20,0
1746573504891,LIIT 5CS,A00,896564,Carnelos; Chiara,20,0,20,0
1746573505915,LISP 5A,A00,896588,Munoz Sanchez; Alicia,2,0,20,18
1746573506979,LISP 5B,A00,896653,Munoz Sanchez; Alicia,7,0,20,13
1746573508009,LISP 5C,A00,896655,Munoz Sanchez; Alicia,0,1,20,20
1746573509034,MAE 197,001,957918,Kleissl; Jan,9996,0,9999,3
1746573509034,MAE 197,002,959806,Boechler; Nicholas Sebastia,9998,0,9999,1
1746573509034,MAE 197,003,959852,Mullin; Jennifer S,9998,0,9999,1
1746573510058,MATH 2,A01,957937,Staff,33,0,35,2
1746573511087,MATH 197,001,957876,Kedlaya; Kiran S.,9993,0,9999,6
1746573512112,MCWP 40,A00,892729,Duru; Nur,10,0,20,10
1746573512112,MCWP 40,B00,893304,Montejo; Carolina,14,0,20,6
1746573513137,MCWP 40R,A00,893757,Redela; Pamela Morgan,0,5,20,20
1746573514162,MCWP 50,A00,893758,Morshed; Michael James,0,0,20,20
1746573514162,MCWP 50,B00,893761,Bartulis; Jason Michael,17,0,20,3
1746573515193,MCWP 50R,A00,893766,Compas; Sean Matthew,0,1,20,20
1746573515193,MCWP 50R,B00,893769,Carter; Jennifer A,0,1,20,20
1746573515193,MCWP 50R,C00,893771,Krone; Jarret,0,3,20,20
1746573515193,MCWP 50R,D00,893772,Miller; Elizabeth Deen,0,0,20,20
1746573515193,MCWP 50R,E00,893775,Carter; Andrea L,0,1,20,20
1746573516219,MMW 11R,A01,892721,Herbst; Matthew,11,0,27,16
1746573516219,MMW 11R,A02,892722,Herbst; Matthew,0,0,0,3
1746573517243,MMW 12R,A01,892724,Herbst; Matthew,0,11,16,16
1746573517243,MMW 12R,A02,892725,Herbst; Matthew,0,10,16,16
1746573518269,MMW 13R,A01,892727,Staff,0,4,16,16
1746573518269,MMW 13R,A02,892728,Staff,0,4,16,16
1746573518269,MMW 13R,A03,958032,Staff,0,4,16,16
1746573518269,MMW 13R,A04,958033,Staff,0,4,16,16
1746573518269,MMW 13R,A05,958034,Staff,0,4,16,16
1746573519294,SIO 295LS,A00,894015,Staff,5,0,25,20
1746573520323,SIO 295S,A00,894020,Staff,5,0,25,20
1746573521351,SIOC 290S,B01,958918,Merrifield; Mark A,14,0,30,16
1746573522378,SIOC 291S,B01,958922,Gabriel; Corey John,14,0,30,16
1746573523406,SOCI 117,A01,895339,Staff,3,0,5,2
1746573524433,WES 237B,A00,894149,Staff,11,0,20,9
1746573526496,AESE 279B,A00,891859,Staff,13,0,35,22
1746573527524,AIP 197,001,891854,Vespa; Emanuel Ignacio,9999,0,9999,0
1746573528552,ANTH 289S,A00,891856,Gagneux; Pascal,12,0,12,0
1746573529578,BENG 196,001,957946,Engler; Adam J.,9996,0,9999,3
1746573530605,BISP 197,001,959851,Wilhelm; James E.,9998,0,9999,1
1746573531629,CAT 124RS,A01,956906,Staff,6,0,25,19
1746573532655,CAT 125RS,A01,922013,Staff,6,0,25,19
1746573533683,CLRE 250,A00,891860,Morris; Sheldon,9995,0,9999,4
1746573535739,CLRE 251R,A00,907817,Mehta; Ravindra L.,9994,0,9999,5
1746573536765,CLRE 252,A00,891864,Cuomo; Raphael Eduardo,9993,0,9999,6
1746573537797,CLRE 253,A00,891867,Vaida; Florin,9994,0,9999,5
1746573537797,CLRE 253,B00,907819,Staff,9999,0,9999,0
1746573538827,CLRE 259,A00,891868,Patel; Hemal,9998,0,9999,1
1746573539851,CLRE 260,A00,891872,Cuomo; Raphael Eduardo,9999,0,9999,0
1746573540876,CLRE 297,001,891888,Cuomo; Raphael Eduardo,9999,0,9999,0
1746573541901,CSE 191,A00,958773,Minnes Kemp; Mor Mia,9995,0,9999,4
1746573542927,CSE 197,001,959846,Minnes Kemp; Mor Mia,9990,0,9999,9
1746573543957,CSS 201S,A01,892054,Mignozzetti; Umberto,25,0,30,5
1746573544990,CSS 202S,A01,892056,Mignozzetti; Umberto,25,0,30,5
1746573546018,DSC 197,001,956898,Eldridge; Justin Matthew,9996,0,9999,3
1746573547044,DSC 297,001,958000,Mazumdar; Arya,9998,0,9999,1
1746573547044,DSC 297,002,959862,Wang; Yusu,9998,0,9999,1
1746573548072,EAP 100,A00,905686,Staff,9778,0,9999,221
1746573549103,ECE 45,A01,892618,Staff,0,0,65,65
1746573551153,ECE 111,A01,892719,Staff,5,0,65,60
1746573552181,ECE 197,001,957920,Mercier; Patrick Philip,9991,0,9999,8
1746573553208,ECON 178,A01,907814,Zhu; Ying,26,0,35,9
1746573554234,EDS 115,A00,895312,Staff,35,0,45,10
1746573555263,EDS 117,A01,895337,Staff,23,0,30,7
1746573556290,EDS 125,A00,895341,Jones; Gabrielle Anastasia,36,0,45,9
1746573557319,EDS 128A,A01,895459,Fargason; Sharon Gayle,44,0,45,1
1746573558345,EDS 128B,A01,895543,Pappas; Elizabeth,44,0,45,1
1746573559370,EDS 139,A00,897203,Pappas; Elizabeth,44,0,45,1
1746573559370,EDS 139,B00,897209,Fargason; Sharon Gayle,41,0,45,4
1746573560397,EDS 201,A00,895545,Staff,22,0,45,23
1746573561426,EDS 203,A01,895581,Halter; Christopher P.,22,0,45,23
1746573562451,EDS 204R,A01,895625,Heinzman; Erica M.,39,0,45,6
1746573562451,EDS 204R,B01,895693,Halter; Christopher P.,10,0,45,35
1746573563478,EDS 206R,A00,895694,Fargason; Sharon Gayle,1,0,30,29
1746573563478,EDS 206R,B00,895695,Choi; Bailey Miyeon,16,0,30,14
1746573564504,EDS 250,A00,895697,Hemans; Patricia Ann Benitez,22,0,45,23
1746573565532,EDS 281,A00,895701,Meyerott; Theresa Ann,1,0,15,14
1746573566558,EDS 284,A00,895736,Meyerott; Theresa Ann,1,0,15,14
1746573567585,EDS 286,A00,897210,Fine; Sarah,0,0,15,15
1746573568611,EDS 289C,A01,895770,Daly; Alan J.,1,0,15,14
1746573569639,EDS 290,A00,897211,Hofstetter; Carolyn,0,0,15,15
1746573570665,LIGM 5A,A00,896162,Fischer-Grunski; Eva K,12,0,20,8
1746573571690,LIGM 5B,A00,896260,Fischer-Grunski; Eva K,17,0,20,3
1746573572716,LIGM 5C,A00,896308,Fischer-Grunski; Eva K,18,0,20,2
1746573573748,LIIT 5AS,A00,896313,Carnelos; Chiara,18,0,20,2
1746573574772,LIIT 5BS,A00,896416,Carnelos; Chiara,20,0,20,0
1746573575798,LIIT 5CS,A00,896564,Carnelos; Chiara,20,0,20,0
1746573576825,LISP 5A,A00,896588,Munoz Sanchez; Alicia,2,0,20,18
1746573577852,LISP 5B,A00,896653,Munoz Sanchez; Alicia,7,0,20,13
1746573578876,LISP 5C,A00,896655,Munoz Sanchez; Alicia,0,1,20,20
1746573579901,MAE 197,001,957918,Kleissl; Jan,9996,0,9999,3
1746573579901,MAE 197,002,959806,Boechler; Nicholas Sebastia,9998,0,9999,1
1746573579901,MAE 197,003,959852,Mullin; Jennifer S,9998,0,9999,1
1746573580925,MATH 2,A01,957937,Staff,33,0,35,2
1746573581950,MATH 197,001,957876,Kedlaya; Kiran S.,9993,0,9999,6
1746573582978,MCWP 40,A00,892729,Duru; Nur,10,0,20,10
1746573582978,MCWP 40,B00,893304,Montejo; Carolina,14,0,20,6
1746573584003,MCWP 40R,A00,893757,Redela; Pamela Morgan,0,5,20,20
1746573585032,MCWP 50,A00,893758,Morshed; Michael James,0,0,20,20
1746573585032,MCWP 50,B00,893761,Bartulis; Jason Michael,17,0,20,3
1746573586069,MCWP 50R,A00,893766,Compas; Sean Matthew,0,1,20,20
1746573586069,MCWP 50R,B00,893769,Carter; Jennifer A,0,1,20,20
1746573586069,MCWP 50R,C00,893771,Krone; Jarret,0,3,20,20
1746573586069,MCWP 50R,D00,893772,Miller; Elizabeth Deen,0,0,20,20
1746573586069,MCWP 50R,E00,893775,Carter; Andrea L,0,1,20,20
1746573587099,MMW 11R,A01,892721,Herbst; Matthew,11,0,27,16
1746573587099,MMW 11R,A02,892722,Herbst; Matthew,0,0,0,3
1746573588125,MMW 12R,A01,892724,Herbst; Matthew,0,11,16,16
1746573588125,MMW 12R,A02,892725,Herbst; Matthew,0,10,16,16
1746573589149,MMW 13R,A01,892727,Staff,0,4,16,16
1746573589149,MMW 13R,A02,892728,Staff,0,4,16,16
1746573589149,MMW 13R,A03,958032,Staff,0,4,16,16
1746573589149,MMW 13R,A04,958033,Staff,0,4,16,16
1746573589149,MMW 13R,A05,958034,Staff,0,4,16,16
1746573590181,SIO 295LS,A00,894015,Staff,5,0,25,20
1746573591206,SIO 295S,A00,894020,Staff,5,0,25,20
1746573592231,SIOC 290S,B01,958918,Merrifield; Mark A,14,0,30,16
1746573593257,SIOC 291S,B01,958922,Gabriel; Corey John,14,0,30,16
1746573594286,SOCI 117,A01,895339,Staff,3,0,5,2
1746573595318,WES 237B,A00,894149,Staff,11,0,20,9
1746573597448,AESE 279B,A00,891859,Staff,13,0,35,22
1746573598475,AIP 197,001,891854,Vespa; Emanuel Ignacio,9999,0,9999,0
1746573599502,ANTH 289S,A00,891856,Gagneux; Pascal,12,0,12,0
1746573600526,BENG 196,001,957946,Engler; Adam J.,9996,0,9999,3
1746573601551,BISP 197,001,959851,Wilhelm; James E.,9998,0,9999,1
1746573602577,CAT 124RS,A01,956906,Staff,6,0,25,19
1746573603604,CAT 125RS,A01,922013,Staff,6,0,25,19
1746573604630,CLRE 250,A00,891860,Morris; Sheldon,9995,0,9999,4
1746573606688,CLRE 251R,A00,907817,Mehta; Ravindra L.,9994,0,9999,5
1746573607728,CLRE 252,A00,891864,Cuomo; Raphael Eduardo,9993,0,9999,6
1746573608754,CLRE 253,A00,891867,Vaida; Florin,9994,0,9999,5
1746573608754,CLRE 253,B00,907819,Staff,9999,0,9999,0
1746573609792,CLRE 259,A00,891868,Patel; Hemal,9998,0,9999,1
1746573610821,CLRE 260,A00,891872,Cuomo; Raphael Eduardo,9999,0,9999,0
1746573611848,CLRE 297,001,891888,Cuomo; Raphael Eduardo,9999,0,9999,0
1746573612879,CSE 191,A00,958773,Minnes Kemp; Mor Mia,9995,0,9999,4
1746573613908,CSE 197,001,959846,Minnes Kemp; Mor Mia,9990,0,9999,9
1746573614938,CSS 201S,A01,892054,Mignozzetti; Umberto,25,0,30,5
1746573615970,CSS 202S,A01,892056,Mignozzetti; Umberto,25,0,30,5
1746573617022,DSC 197,001,956898,Eldridge; Justin Matthew,9996,0,9999,3
1746573618048,DSC 297,001,958000,Mazumdar; Arya,9998,0,9999,1
1746573618048,DSC 297,002,959862,Wang; Yusu,9998,0,9999,1
1746573619077,EAP 100,A00,905686,Staff,9778,0,9999,221
1746573620102,ECE 45,A01,892618,Staff,0,0,65,65
1746573622157,ECE 111,A01,892719,Staff,5,0,65,60
1746573623185,ECE 197,001,957920,Mercier; Patrick Philip,9991,0,9999,8
1746573624213,ECON 178,A01,907814,Zhu; Ying,26,0,35,9
1746573625242,EDS 115,A00,895312,Staff,35,0,45,10
1746573626267,EDS 117,A01,895337,Staff,23,0,30,7
1746573627290,EDS 125,A00,895341,Jones; Gabrielle Anastasia,36,0,45,9
1746573628318,EDS 128A,A01,895459,Fargason; Sharon Gayle,44,0,45,1
1746573629348,EDS 128B,A01,895543,Pappas; Elizabeth,44,0,45,1
1746573630372,EDS 139,A00,897203,Pappas; Elizabeth,44,0,45,1
1746573630372,EDS 139,B00,897209,Fargason; Sharon Gayle,41,0,45,4
1746573631399,EDS 201,A00,895545,Staff,22,0,45,23
1746573632424,EDS 203,A01,895581,Halter; Christopher P.,22,0,45,23
1746573633453,EDS 204R,A01,895625,Heinzman; Erica M.,39,0,45,6
1746573633453,EDS 204R,B01,895693,Halter; Christopher P.,10,0,45,35
1746573634477,EDS 206R,A00,895694,Fargason; Sharon Gayle,1,0,30,29
1746573634477,EDS 206R,B00,895695,Choi; Bailey Miyeon,16,0,30,14
1746573635502,EDS 250,A00,895697,Hemans; Patricia Ann Benitez,22,0,45,23
1746573636530,EDS 281,A00,895701,Meyerott; Theresa Ann,1,0,15,14
1746573637557,EDS 284,A00,895736,Meyerott; Theresa Ann,1,0,15,14
1746573638584,EDS 286,A00,897210,Fine; Sarah,0,0,15,15
1746573639608,EDS 289C,A01,895770,Daly; Alan J.,1,0,15,14
1746573640632,EDS 290,A00,897211,Hofstetter; Carolyn,0,0,15,15
1746573641658,LIGM 5A,A00,896162,Fischer-Grunski; Eva K,12,0,20,8
1746573642687,LIGM 5B,A00,896260,Fischer-Grunski; Eva K,17,0,20,3
1746573643713,LIGM 5C,A00,896308,Fischer-Grunski; Eva K,18,0,20,2
1746573644739,LIIT 5AS,A00,896313,Carnelos; Chiara,18,0,20,2
1746573645767,LIIT 5BS,A00,896416,Carnelos; Chiara,20,0,20,0
1746573646797,LIIT 5CS,A00,896564,Carnelos; Chiara,20,0,20,0
1746573647821,LISP 5A,A00,896588,Munoz Sanchez; Alicia,2,0,20,18
1746573648848,LISP 5B,A00,896653,Munoz Sanchez; Alicia,7,0,20,13
1746573649877,LISP 5C,A00,896655,Munoz Sanchez; Alicia,0,1,20,20
1746573650905,MAE 197,001,957918,Kleissl; Jan,9996,0,9999,3
1746573650905,MAE 197,002,959806,Boechler; Nicholas Sebastia,9998,0,9999,1
1746573650905,MAE 197,003,959852,Mullin; Jennifer S,9998,0,9999,1
1746573651932,MATH 2,A01,957937,Staff,33,0,35,2
1746573652957,MATH 197,001,957876,Kedlaya; Kiran S.,9993,0,9999,6
1746573653986,MCWP 40,A00,892729,Duru; Nur,10,0,20,10
1746573653986,MCWP 40,B00,893304,Montejo; Carolina,14,0,20,6
1746573655011,MCWP 40R,A00,893757,Redela; Pamela Morgan,0,5,20,20
1746573656037,MCWP 50,A00,893758,Morshed; Michael James,0,0,20,20
1746573656037,MCWP 50,B00,893761,Bartulis; Jason Michael,17,0,20,3
1746573657063,MCWP 50R,A00,893766,Compas; Sean Matthew,0,1,20,20
1746573657063,MCWP 50R,B00,893769,Carter; Jennifer A,0,1,20,20
1746573657063,MCWP 50R,C00,893771,Krone; Jarret,0,3,20,20
1746573657063,MCWP 50R,D00,893772,Miller; Elizabeth Deen,0,0,20,20
1746573657063,MCWP 50R,E00,893775,Carter; Andrea L,0,1,20,20
1746573658093,MMW 11R,A01,892721,Herbst; Matthew,11,0,27,16
1746573658093,MMW 11R,A02,892722,Herbst; Matthew,0,0,0,3
1746573659120,MMW 12R,A01,892724,Herbst; Matthew,0,11,16,16
1746573659120,MMW 12R,A02,892725,Herbst; Matthew,0,10,16,16
1746573660144,MMW 13R,A01,892727,Staff,0,4,16,16
1746573660144,MMW 13R,A02,892728,Staff,0,4,16,16
1746573660144,MMW 13R,A03,958032,Staff,0,4,16,16
1746573660144,MMW 13R,A04,958033,Staff,0,4,16,16
1746573660144,MMW 13R,A05,958034,Staff,0,4,16,16
1746573661169,SIO 295LS,A00,894015,Staff,5,0,25,20
1746573662194,SIO 295S,A00,894020,Staff,5,0,25,20
1746573663219,SIOC 290S,B01,958918,Merrifield; Mark A,14,0,30,16
1746573664243,SIOC 291S,B01,958922,Gabriel; Corey John,14,0,30,16
1746573665271,SOCI 117,A01,895339,Staff,3,0,5,2
1746573666296,WES 237B,A00,894149,Staff,11,0,20,9
1746573668356,AESE 279B,A00,891859,Staff,13,0,35,22
1746573669382,AIP 197,001,891854,Vespa; Emanuel Ignacio,9999,0,9999,0
1746573670407,ANTH 289S,A00,891856,Gagneux; Pascal,12,0,12,0
1746573671436,BENG 196,001,957946,Engler; Adam J.,9996,0,9999,3
1746573672460,BISP 197,001,959851,Wilhelm; James E.,9998,0,9999,1
1746573673488,CAT 124RS,A01,956906,Staff,6,0,25,19
1746573674514,CAT 125RS,A01,922013,Staff,6,0,25,19
1746573675545,CLRE 250,A00,891860,Morris; Sheldon,9995,0,9999,4
1746573677596,CLRE 251R,A00,907817,Mehta; Ravindra L.,9994,0,9999,5
1746573678621,CLRE 252,A00,891864,Cuomo; Raphael Eduardo,9993,0,9999,6
1746573679648,CLRE 253,A00,891867,Vaida; Florin,9994,0,9999,5
1746573679648,CLRE 253,B00,907819,Staff,9999,0,9999,0
1746573680674,CLRE 259,A00,891868,Patel; Hemal,9998,0,9999,1
1746573681699,CLRE 260,A00,891872,Cuomo; Raphael Eduardo,9999,0,9999,0
1746573682729,CLRE 297,001,891888,Cuomo; Raphael Eduardo,9999,0,9999,0
1746573683755,CSE 191,A00,958773,Minnes Kemp; Mor Mia,9995,0,9999,4
1746573684784,CSE 197,001,959846,Minnes Kemp; Mor Mia,9990,0,9999,9
1746573685817,CSS 201S,A01,892054,Mignozzetti; Umberto,25,0,30,5
1746573686845,CSS 202S,A01,892056,Mignozzetti; Umberto,25,0,30,5
1746573687873,DSC 197,001,956898,Eldridge; Justin Matthew,9996,0,9999,3
1746573688898,DSC 297,001,958000,Mazumdar; Arya,9998,0,9999,1
1746573688898,DSC 297,002,959862,Wang; Yusu,9998,0,9999,1
1746573689924,EAP 100,A00,905686,Staff,9778,0,9999,221
1746573690951,ECE 45,A01,892618,Staff,0,0,65,65
1746573693004,ECE 111,A01,892719,Staff,5,0,65,60
1746573694030,ECE 197,001,957920,Mercier; Patrick Philip,9991,0,9999,8
1746573695060,ECON 178,A01,907814,Zhu; Ying,26,0,35,9
1746573696084,EDS 115,A00,895312,Staff,35,0,45,10
1746573697108,EDS 117,A01,895337,Staff,23,0,30,7
1746573698133,EDS 125,A00,895341,Jones; Gabrielle Anastasia,36,0,45,9
1746573699160,EDS 128A,A01,895459,Fargason; Sharon Gayle,44,0,45,1
1746573700189,EDS 128B,A01,895543,Pappas; Elizabeth,44,0,45,1
1746573701213,EDS 139,A00,897203,Pappas; Elizabeth,44,0,45,1
1746573701213,EDS 139,B00,897209,Fargason; Sharon Gayle,41,0,45,4
1746573702240,EDS 201,A00,895545,Staff,22,0,45,23
1746573703269,EDS 203,A01,895581,Halter; Christopher P.,22,0,45,23
1746573704296,EDS 204R,A01,895625,Heinzman; Erica M.,39,0,45,6
1746573704296,EDS 204R,B01,895693,Halter; Christopher P.,10,0,45,35
1746573705320,EDS 206R,A00,895694,Fargason; Sharon Gayle,1,0,30,29
1746573705320,EDS 206R,B00,895695,Choi; Bailey Miyeon,16,0,30,14
1746573706343,EDS 250,A00,895697,Hemans; Patricia Ann Benitez,22,0,45,23
1746573707368,EDS 281,A00,895701,Meyerott; Theresa Ann,1,0,15,14
1746573708395,EDS 284,A00,895736,Meyerott; Theresa Ann,1,0,15,14
1746573709423,EDS 286,A00,897210,Fine; Sarah,0,0,15,15
1746573710452,EDS 289C,A01,895770,Daly; Alan J.,1,0,15,14
1746573711483,EDS 290,A00,897211,Hofstetter; Carolyn,0,0,15,15
1746573712510,LIGM 5A,A00,896162,Fischer-Grunski; Eva K,12,0,20,8
1746573713541,LIGM 5B,A00,896260,Fischer-Grunski; Eva K,17,0,20,3
1746573714570,LIGM 5C,A00,896308,Fischer-Grunski; Eva K,18,0,20,2
1746573715598,LIIT 5AS,A00,896313,Carnelos; Chiara,18,0,20,2
1746573716624,LIIT 5BS,A00,896416,Carnelos; Chiara,20,0,20,0
1746573717649,LIIT 5CS,A00,896564,Carnelos; Chiara,20,0,20,0
1746573718675,LISP 5A,A00,896588,Munoz Sanchez; Alicia,2,0,20,18
1746573719700,LISP 5B,A00,896653,Munoz Sanchez; Alicia,7,0,20,13
1746573720724,LISP 5C,A00,896655,Munoz Sanchez; Alicia,0,1,20,20
1746573721749,MAE 197,001,957918,Kleissl; Jan,9996,0,9999,3
1746573721749,MAE 197,002,959806,Boechler; Nicholas Sebastia,9998,0,9999,1
1746573721749,MAE 197,003,959852,Mullin; Jennifer S,9998,0,9999,1
1746573722774,MATH 2,A01,957937,Staff,33,0,35,2
1746573723800,MATH 197,001,957876,Kedlaya; Kiran S.,9993,0,9999,6
1746573724827,MCWP 40,A00,892729,Duru; Nur,10,0,20,10
1746573724827,MCWP 40,B00,893304,Montejo; Carolina,14,0,20,6
1746573725855,MCWP 40R,A00,893757,Redela; Pamela Morgan,0,5,20,20
1746573726881,MCWP 50,A00,893758,Morshed; Michael James,0,0,20,20
1746573726881,MCWP 50,B00,893761,Bartulis; Jason Michael,17,0,20,3
1746573727910,MCWP 50R,A00,893766,Compas; Sean Matthew,0,1,20,20
1746573727910,MCWP 50R,B00,893769,Carter; Jennifer A,0,1,20,20
1746573727910,MCWP 50R,C00,893771,Krone; Jarret,0,3,20,20
1746573727910,MCWP 50R,D00,893772,Miller; Elizabeth Deen,0,0,20,20
1746573727910,MCWP 50R,E00,893775,Carter; Andrea L,0,1,20,20
1746573728935,MMW 11R,A01,892721,Herbst; Matthew,11,0,27,16
1746573728935,MMW 11R,A02,892722,Herbst; Matthew,0,0,0,3
1746573729962,MMW 12R,A01,892724,Herbst; Matthew,0,11,16,16
1746573729962,MMW 12R,A02,892725,Herbst; Matthew,0,10,16,16
1746573730994,MMW 13R,A01,892727,Staff,0,4,16,16
1746573730994,MMW 13R,A02,892728,Staff,0,4,16,16
1746573730994,MMW 13R,A03,958032,Staff,0,4,16,16
1746573730994,MMW 13R,A04,958033,Staff,0,4,16,16
1746573730994,MMW 13R,A05,958034,Staff,0,4,16,16
1746573732020,SIO 295LS,A00,894015,Staff,5,0,25,20
1746573733046,SIO 295S,A00,894020,Staff,5,0,25,20
1746573734070,SIOC 290S,B01,958918,Merrifield; Mark A,14,0,30,16
1746573735099,SIOC 291S,B01,958922,Gabriel; Corey John,14,0,30,16
1746573736123,SOCI 117,A01,895339,Staff,3,0,5,2
1746573737152,WES 237B,A00,894149,Staff,11,0,20,9
1746573739207,AESE 279B,A00,891859,Staff,13,0,35,22
1746573740236,AIP 197,001,891854,Vespa; Emanuel Ignacio,9999,0,9999,0
1746573741268,ANTH 289S,A00,891856,Gagneux; Pascal,12,0,12,0
1746573742294,BENG 196,001,957946,Engler; Adam J.,9996,0,9999,3
1746573743325,BISP 197,001,959851,Wilhelm; James E.,9998,0,9999,1
1746573744351,CAT 124RS,A01,956906,Staff,6,0,25,19
1746573745379,CAT 125RS,A01,922013,Staff,6,0,25,19
1746573746404,CLRE 250,A00,891860,Morris; Sheldon,9995,0,9999,4
1746573748458,CLRE 251R,A00,907817,Mehta; Ravindra L.,9994,0,9999,5
1746573749485,CLRE 252,A00,891864,Cuomo; Raphael Eduardo,9993,0,9999,6
1746573750513,CLRE 253,A00,891867,Vaida; Florin,9994,0,9999,5
1746573750513,CLRE 253,B00,907819,Staff,9999,0,9999,0
1746573751542,CLRE 259,A00,891868,Patel; Hemal,9998,0,9999,1
1746573752571,CLRE 260,A00,891872,Cuomo; Raphael Eduardo,9999,0,9999,0
1746573753594,CLRE 297,001,891888,Cuomo; Raphael Eduardo,9999,0,9999,0
1746573754624,CSE 191,A00,958773,Minnes Kemp; Mor Mia,9995,0,9999,4
1746573755649,CSE 197,001,959846,Minnes Kemp; Mor Mia,9990,0,9999,9
1746573756674,CSS 201S,A01,892054,Mignozzetti; Umberto,25,0,30,5
1746573757705,CSS 202S,A01,892056,Mignozzetti; Umberto,25,0,30,5
1746573758730,DSC 197,001,956898,Eldridge; Justin Matthew,9996,0,9999,3
1746573759755,DSC 297,001,958000,Mazumdar; Arya,9998,0,9999,1
1746573759755,DSC 297,002,959862,Wang; Yusu,9998,0,9999,1
1746573760783,EAP 100,A00,905686,Staff,9778,0,9999,221
1746573761813,ECE 45,A01,892618,Staff,0,0,65,65
1746573763868,ECE 111,A01,892719,Staff,5,0,65,60
1746573764897,ECE 197,001,957920,Mercier; Patrick Philip,9991,0,9999,8
1746573765927,ECON 178,A01,907814,Zhu; Ying,26,0,35,9
1746573766953,EDS 115,A00,895312,Staff,35,0,45,10
1746573767981,EDS 117,A01,895337,Staff,23,0,30,7
1746573769006,EDS 125,A00,895341,Jones; Gabrielle Anastasia,36,0,45,9
1746573770031,EDS 128A,A01,895459,Fargason; Sharon Gayle,44,0,45,1
1746573771059,EDS 128B,A01,895543,Pappas; Elizabeth,44,0,45,1
1746573772082,EDS 139,A00,897203,Pappas; Elizabeth,44,0,45,1
1746573772082,EDS 139,B00,897209,Fargason; Sharon Gayle,41,0,45,4
1746573773111,EDS 201,A00,895545,Staff,22,0,45,23
1746573774138,EDS 203,A01,895581,Halter; Christopher P.,22,0,45,23
1746573775163,EDS 204R,A01,895625,Heinzman; Erica M.,39,0,45,6
1746573775163,EDS 204R,B01,895693,Halter; Christopher P.,10,0,45,35
1746573776189,EDS 206R,A00,895694,Fargason; Sharon Gayle,1,0,30,29
1746573776189,EDS 206R,B00,895695,Choi; Bailey Miyeon,16,0,30,14
1746573777214,EDS 250,A00,895697,Hemans; Patricia Ann Benitez,22,0,45,23
1746573778242,EDS 281,A00,895701,Meyerott; Theresa Ann,1,0,15,14
1746573779267,EDS 284,A00,895736,Meyerott; Theresa Ann,1,0,15,14
1746573780292,EDS 286,A00,897210,Fine; Sarah,0,0,15,15
1746573781317,EDS 289C,A01,895770,Daly; Alan J.,1,0,15,14
1746573782342,EDS 290,A00,897211,Hofstetter; Carolyn,0,0,15,15
1746573783369,LIGM 5A,A00,896162,Fischer-Grunski; Eva K,12,0,20,8
1746573784394,LIGM 5B,A00,896260,Fischer-Grunski; Eva K,17,0,20,3
1746573785419,LIGM 5C,A00,896308,Fischer-Grunski; Eva K,18,0,20,2
1746573786445,LIIT 5AS,A00,896313,Carnelos; Chiara,18,0,20,2
1746573787471,LIIT 5BS,A00,896416,Carnelos; Chiara,20,0,20,0
1746573788500,LIIT 5CS,A00,896564,Carnelos; Chiara,20,0,20,0
1746573789525,LISP 5A,A00,896588,Munoz Sanchez; Alicia,2,0,20,18
1746573790550,LISP 5B,A00,896653,Munoz Sanchez; Alicia,7,0,20,13
1746573791574,LISP 5C,A00,896655,Munoz Sanchez; Alicia,0,1,20,20
1746573792599,MAE 197,001,957918,Kleissl; Jan,9996,0,9999,3
1746573792599,MAE 197,002,959806,Boechler; Nicholas Sebastia,9998,0,9999,1
1746573792599,MAE 197,003,959852,Mullin; Jennifer S,9998,0,9999,1
1746573793624,MATH 2,A01,957937,Staff,33,0,35,2
1746573794652,MATH 197,001,957876,Kedlaya; Kiran S.,9993,0,9999,6
1746573795676,MCWP 40,A00,892729,Duru; Nur,10,0,20,10
1746573795676,MCWP 40,B00,893304,Montejo; Carolina,14,0,20,6
1746573796705,MCWP 40R,A00,893757,Redela; Pamela Morgan,0,5,20,20
1746573797730,MCWP 50,A00,893758,Morshed; Michael James,0,0,20,20
1746573797730,MCWP 50,B00,893761,Bartulis; Jason Michael,17,0,20,3
1746573798759,MCWP 50R,A00,893766,Compas; Sean Matthew,0,1,20,20
1746573798759,MCWP 50R,B00,893769,Carter; Jennifer A,0,1,20,20
1746573798759,MCWP 50R,C00,893771,Krone; Jarret,0,3,20,20
1746573798759,MCWP 50R,D00,893772,Miller; Elizabeth Deen,0,0,20,20
1746573798759,MCWP 50R,E00,893775,Carter; Andrea L,0,1,20,20
1746573799787,MMW 11R,A01,892721,Herbst; Matthew,11,0,27,16
1746573799787,MMW 11R,A02,892722,Herbst; Matthew,0,0,0,3
1746573800813,MMW 12R,A01,892724,Herbst; Matthew,0,11,16,16
1746573800813,MMW 12R,A02,892725,Herbst; Matthew,0,10,16,16
1746573801838,MMW 13R,A01,892727,Staff,0,4,16,16
1746573801838,MMW 13R,A02,892728,Staff,0,4,16,16
1746573801838,MMW 13R,A03,958032,Staff,0,4,16,16
1746573801838,MMW 13R,A04,958033,Staff,0,4,16,16
1746573801838,MMW 13R,A05,958034,Staff,0,4,16,16
1746573802863,SIO 295LS,A00,894015,Staff,5,0,25,20
1746573803889,SIO 295S,A00,894020,Staff,5,0,25,20
1746573804919,SIOC 290S,B01,958918,Merrifield; Mark A,14,0,30,16
1746573805947,SIOC 291S,B01,958922,Gabriel; Corey John,14,0,30,16
1746573806974,SOCI 117,A01,895339,Staff,3,0,5,2
1746573808002,WES 237B,A00,894149,Staff,11,0,20,9
1746573810057,AESE 279B,A00,891859,Staff,13,0,35,22
1746573811081,AIP 197,001,891854,Vespa; Emanuel Ignacio,9999,0,9999,0
1746573812107,ANTH 289S,A00,891856,Gagneux; Pascal,12,0,12,0
1746573813133,BENG 196,001,957946,Engler; Adam J.,9996,0,9999,3
1746573814160,BISP 197,001,959851,Wilhelm; James E.,9998,0,9999,1
1746573815191,CAT 124RS,A01,956906,Staff,6,0,25,19
1746573816217,CAT 125RS,A01,922013,Staff,6,0,25,19
1746573817245,CLRE 250,A00,891860,Morris; Sheldon,9995,0,9999,4
1746573819297,CLRE 251R,A00,907817,Mehta; Ravindra L.,9994,0,9999,5
1746573820322,CLRE 252,A00,891864,Cuomo; Raphael Eduardo,9993,0,9999,6
1746573821348,CLRE 253,A00,891867,Vaida; Florin,9994,0,9999,5
1746573821348,CLRE 253,B00,907819,Staff,9999,0,9999,0
1746573822373,CLRE 259,A00,891868,Patel; Hemal,9998,0,9999,1
1746573823401,CLRE 260,A00,891872,Cuomo; Raphael Eduardo,9999,0,9999,0
1746573824428,CLRE 297,001,891888,Cuomo; Raphael Eduardo,9999,0,9999,0
1746573825457,CSE 191,A00,958773,Minnes Kemp; Mor Mia,9995,0,9999,4
1746573826481,CSE 197,001,959846,Minnes Kemp; Mor Mia,9990,0,9999,9
1746573827508,CSS 201S,A01,892054,Mignozzetti; Umberto,25,0,30,5
1746573828534,CSS 202S,A01,892056,Mignozzetti; Umberto,25,0,30,5
1746573829565,DSC 197,001,956898,Eldridge; Justin Matthew,9996,0,9999,3
1746573830594,DSC 297,001,958000,Mazumdar; Arya,9998,0,9999,1
1746573830594,DSC 297,002,959862,Wang; Yusu,9998,0,9999,1
1746573831622,EAP 100,A00,905686,Staff,9778,0,9999,221
1746573832653,ECE 45,A01,892618,Staff,0,0,65,65
1746573834706,ECE 111,A01,892719,Staff,5,0,65,60
1746573835735,ECE 197,001,957920,Mercier; Patrick Philip,9991,0,9999,8
1746573836761,ECON 178,A01,907814,Zhu; Ying,26,0,35,9
1746573837786,EDS 115,A00,895312,Staff,35,0,45,10
1746573838811,EDS 117,A01,895337,Staff,23,0,30,7
1746573839838,EDS 125,A00,895341,Jones; Gabrielle Anastasia,36,0,45,9
1746573840862,EDS 128A,A01,895459,Fargason; Sharon Gayle,44,0,45,1
1746573841890,EDS 128B,A01,895543,Pappas; Elizabeth,44,0,45,1
1746573842917,EDS 139,A00,897203,Pappas; Elizabeth,44,0,45,1
1746573842917,EDS 139,B00,897209,Fargason; Sharon Gayle,41,0,45,4
1746573843943,EDS 201,A00,895545,Staff,22,0,45,23
1746573844970,EDS 203,A01,895581,Halter; Christopher P.,22,0,45,23
1746573845994,EDS 204R,A01,895625,Heinzman; Erica M.,39,0,45,6
1746573845994,EDS 204R,B01,895693,Halter; Christopher P.,10,0,45,35
1746573847024,EDS 206R,A00,895694,Fargason; Sharon Gayle,1,0,30,29
1746573847024,EDS 206R,B00,895695,Choi; Bailey Miyeon,16,0,30,14
1746573848051,EDS 250,A00,895697,Hemans; Patricia Ann Benitez,22,0,45,23
1746573849077,EDS 281,A00,895701,Meyerott; Theresa Ann,1,0,15,14
1746573850104,EDS 284,A00,895736,Meyerott; Theresa Ann,1,0,15,14
1746573851129,EDS 286,A00,897210,Fine; Sarah,0,0,15,15
1746573852154,EDS 289C,A01,895770,Daly; Alan J.,1,0,15,14
1746573853182,EDS 290,A00,897211,Hofstetter; Carolyn,0,0,15,15
1746573854207,LIGM 5A,A00,896162,Fischer-Grunski; Eva K,12,0,20,8
1746573855232,LIGM 5B,A00,896260,Fischer-Grunski; Eva K,17,0,20,3
1746573856258,LIGM 5C,A00,896308,Fischer-Grunski; Eva K,18,0,20,2
1746573857290,LIIT 5AS,A00,896313,Carnelos; Chiara,18,0,20,2
1746573858314,LIIT 5BS,A00,896416,Carnelos; Chiara,20,0,20,0
1746573859342,LIIT 5CS,A00,896564,Carnelos; Chiara,20,0,20,0
1746573860374,LISP 5A,A00,896588,Munoz Sanchez; Alicia,2,0,20,18
1746573861405,LISP 5B,A00,896653,Munoz Sanchez; Alicia,7,0,20,13
1746573862431,LISP 5C,A00,896655,Munoz Sanchez; Alicia,0,1,20,20
1746573863457,MAE 197,001,957918,Kleissl; Jan,9996,0,9999,3
1746573863457,MAE 197,002,959806,Boechler; Nicholas Sebastia,9998,0,9999,1
1746573863457,MAE 197,003,959852,Mullin; Jennifer S,9998,0,9999,1
1746573864484,MATH 2,A01,957937,Staff,33,0,35,2
1746573865513,MATH 197,001,957876,Kedlaya; Kiran S.,9993,0,9999,6
1746573866538,MCWP 40,A00,892729,Duru; Nur,10,0,20,10
1746573866538,MCWP 40,B00,893304,Montejo; Carolina,14,0,20,6
1746573867565,MCWP 40R,A00,893757,Redela; Pamela Morgan,0,5,20,20
1746573868594,MCWP 50,A00,893758,Morshed; Michael James,0,0,20,20
1746573868594,MCWP 50,B00,893761,Bartulis; Jason Michael,17,0,20,3
1746573869625,MCWP 50R,A00,893766,Compas; Sean Matthew,0,1,20,20
1746573869625,MCWP 50R,B00,893769,Carter; Jennifer A,0,1,20,20
1746573869625,MCWP 50R,C00,893771,Krone; Jarret,0,3,20,20
1746573869625,MCWP 50R,D00,893772,Miller; Elizabeth Deen,0,0,20,20
1746573869625,MCWP 50R,E00,893775,Carter; Andrea L,0,1,20,20
1746573870656,MMW 11R,A01,892721,Herbst; Matthew,11,0,27,16
1746573870656,MMW 11R,A02,892722,Herbst; Matthew,0,0,0,3
1746573871684,MMW 12R,A01,892724,Herbst; Matthew,0,11,16,16
1746573871684,MMW 12R,A02,892725,Herbst; Matthew,0,10,16,16
1746573872713,MMW 13R,A01,892727,Staff,0,4,16,16
1746573872713,MMW 13R,A02,892728,Staff,0,4,16,16
1746573872713,MMW 13R,A03,958032,Staff,0,4,16,16
1746573872713,MMW 13R,A04,958033,Staff,0,4,16,16
1746573872713,MMW 13R,A05,958034,Staff,0,4,16,16
1746573873738,SIO 295LS,A00,894015,Staff,5,0,25,20
1746573874763,SIO 295S,A00,894020,Staff,5,0,25,20
1746573875791,SIOC 290S,B01,958918,Merrifield; Mark A,14,0,30,16
1746573876815,SIOC 291S,B01,958922,Gabriel; Corey John,14,0,30,16
1746573877840,SOCI 117,A01,895339,Staff,3,0,5,2
1746573878868,WES 237B,A00,894149,Staff,11,0,20,9
1746573880924,AESE 279B,A00,891859,Staff,13,0,35,22
1746573881955,AIP 197,001,891854,Vespa; Emanuel Ignacio,9999,0,9999,0
1746573882981,ANTH 289S,A00,891856,Gagneux; Pascal,12,0,12,0
1746573884006,BENG 196,001,957946,Engler; Adam J.,9996,0,9999,3
1746573885034,BISP 197,001,959851,Wilhelm; James E.,9998,0,9999,1
1746573886063,CAT 124RS,A01,956906,Staff,6,0,25,19
1746573887090,CAT 125RS,A01,922013,Staff,6,0,25,19
1746573888114,CLRE 250,A00,891860,Morris; Sheldon,9995,0,9999,4
1746573890166,CLRE 251R,A00,907817,Mehta; Ravindra L.,9994,0,9999,5
1746573891191,CLRE 252,A00,891864,Cuomo; Raphael Eduardo,9993,0,9999,6
1746573892216,CLRE 253,A00,891867,Vaida; Florin,9994,0,9999,5
1746573892216,CLRE 253,B00,907819,Staff,9999,0,9999,0
1746573893280,CLRE 259,A00,891868,Patel; Hemal,9998,0,9999,1
1746573894306,CLRE 260,A00,891872,Cuomo; Raphael Eduardo,9999,0,9999,0
1746573895334,CLRE 297,001,891888,Cuomo; Raphael Eduardo,9999,0,9999,0
1746573896361,CSE 191,A00,958773,Minnes Kemp; Mor Mia,9995,0,9999,4
1746573897389,CSE 197,001,959846,Minnes Kemp; Mor Mia,9990,0,9999,9
1746573898416,CSS 201S,A01,892054,Mignozzetti; Umberto,25,0,30,5
1746573899443,CSS 202S,A01,892056,Mignozzetti; Umberto,25,0,30,5
1746573900469,DSC 197,001,956898,Eldridge; Justin Matthew,9996,0,9999,3
1746573901499,DSC 297,001,958000,Mazumdar; Arya,9998,0,9999,1
1746573901499,DSC 297,002,959862,Wang; Yusu,9998,0,9999,1
1746573902527,EAP 100,A00,905686,Staff,9778,0,9999,221
1746573903553,ECE 45,A01,892618,Staff,0,0,65,65
1746573905610,ECE 111,A01,892719,Staff,5,0,65,60
1746573906638,ECE 197,001,957920,Mercier; Patrick Philip,9991,0,9999,8
1746573907664,ECON 178,A01,907814,Zhu; Ying,26,0,35,9
1746573908692,EDS 115,A00,895312,Staff,35,0,45,10
1746573909717,EDS 117,A01,895337,Staff,23,0,30,7
1746573910743,EDS 125,A00,895341,Jones; Gabrielle Anastasia,36,0,45,9
1746573911768,EDS 128A,A01,895459,Fargason; Sharon Gayle,44,0,45,1
1746573912804,EDS 128B,A01,895543,Pappas; Elizabeth,44,0,45,1
1746573913834,EDS 139,A00,897203,Pappas; Elizabeth,44,0,45,1
1746573913834,EDS 139,B00,897209,Fargason; Sharon Gayle,41,0,45,4
1746573914862,EDS 201,A00,895545,Staff,22,0,45,23
1746573915890,EDS 203,A01,895581,Halter; Christopher P.,22,0,45,23
1746573916915,EDS 204R,A01,895625,Heinzman; Erica M.,39,0,45,6
1746573916915,EDS 204R,B01,895693,Halter; Christopher P.,10,0,45,35
1746573917943,EDS 206R,A00,895694,Fargason; Sharon Gayle,1,0,30,29
1746573917943,EDS 206R,B00,895695,Choi; Bailey Miyeon,16,0,30,14
1746573918969,EDS 250,A00,895697,Hemans; Patricia Ann Benitez,22,0,45,23
1746573919996,EDS 281,A00,895701,Meyerott; Theresa Ann,1,0,15,14
1746573921029,EDS 284,A00,895736,Meyerott; Theresa Ann,1,0,15,14
1746573922053,EDS 286,A00,897210,Fine; Sarah,0,0,15,15
1746573923079,EDS 289C,A01,895770,Daly; Alan J.,1,0,15,14
1746573924103,EDS 290,A00,897211,Hofstetter; Carolyn,0,0,15,15
1746573925126,LIGM 5A,A00,896162,Fischer-Grunski; Eva K,12,0,20,8
1746573926153,LIGM 5B,A00,896260,Fischer-Grunski; Eva K,17,0,20,3
1746573927179,LIGM 5C,A00,896308,Fischer-Grunski; Eva K,18,0,20,2
1746573928203,LIIT 5AS,A00,896313,Carnelos; Chiara,18,0,20,2
1746573929231,LIIT 5BS,A00,896416,Carnelos; Chiara,20,0,20,0
1746573930260,LIIT 5CS,A00,896564,Carnelos; Chiara,20,0,20,0
1746573931289,LISP 5A,A00,896588,Munoz Sanchez; Alicia,2,0,20,18
1746573932317,LISP 5B,A00,896653,Munoz Sanchez; Alicia,7,0,20,13
1746573933342,LISP 5C,A00,896655,Munoz Sanchez; Alicia,0,1,20,20
1746573934373,MAE 197,001,957918,Kleissl; Jan,9996,0,9999,3
1746573934373,MAE 197,002,959806,Boechler; Nicholas Sebastia,9998,0,9999,1
1746573934373,MAE 197,003,959852,Mullin; Jennifer S,9998,0,9999,1
1746573935398,MATH 2,A01,957937,Staff,33,0,35,2
1746573936426,MATH 197,001,957876,Kedlaya; Kiran S.,9993,0,9999,6
1746573937453,MCWP 40,A00,892729,Duru; Nur,10,0,20,10
1746573937453,MCWP 40,B00,893304,Montejo; Carolina,14,0,20,6
1746573938478,MCWP 40R,A00,893757,Redela; Pamela Morgan,0,5,20,20
1746573939506,MCWP 50,A00,893758,Morshed; Michael James,0,0,20,20
1746573939506,MCWP 50,B00,893761,Bartulis; Jason Michael,17,0,20,3
1746573940536,MCWP 50R,A00,893766,Compas; Sean Matthew,0,1,20,20
1746573940536,MCWP 50R,B00,893769,Carter; Jennifer A,0,1,20,20
1746573940536,MCWP 50R,C00,893771,Krone; Jarret,0,3,20,20
1746573940536,MCWP 50R,D00,893772,Miller; Elizabeth Deen,0,0,20,20
1746573940536,MCWP 50R,E00,893775,Carter; Andrea L,0,1,20,20
1746573941560,MMW 11R,A01,892721,Herbst; Matthew,14,0,30,16
1746573941560,MMW 11R,A02,892722,Herbst; Matthew,0,0,0,3
1746573942587,MMW 12R,A01,892724,Herbst; Matthew,0,11,16,16
1746573942587,MMW 12R,A02,892725,Herbst; Matthew,0,10,16,16
1746573943615,MMW 13R,A01,892727,Staff,0,4,16,16
1746573943615,MMW 13R,A02,892728,Staff,0,4,16,16
1746573943615,MMW 13R,A03,958032,Staff,0,4,16,16
1746573943615,MMW 13R,A04,958033,Staff,0,4,16,16
1746573943615,MMW 13R,A05,958034,Staff,0,4,16,16
1746573944643,SIO 295LS,A00,894015,Staff,5,0,25,20
1746573945671,SIO 295S,A00,894020,Staff,5,0,25,20
1746573946696,SIOC 290S,B01,958918,Merrifield; Mark A,14,0,30,16
1746573947723,SIOC 291S,B01,958922,Gabriel; Corey John,14,0,30,16
1746573948750,SOCI 117,A01,895339,Staff,3,0,5,2
1746573949775,WES 237B,A00,894149,Staff,11,0,20,9
1746573951836,AESE 279B,A00,891859,Staff,13,0,35,22
1746573952864,AIP 197,001,891854,Vespa; Emanuel Ignacio,9999,0,9999,0
1746573953892,ANTH 289S,A00,891856,Gagneux; Pascal,12,0,12,0
1746573954920,BENG 196,001,957946,Engler; Adam J.,9996,0,9999,3
1746573955944,BISP 197,001,959851,Wilhelm; James E.,9998,0,9999,1
1746573956973,CAT 124RS,A01,956906,Staff,6,0,25,19
1746573957998,CAT 125RS,A01,922013,Staff,6,0,25,19
1746573959022,CLRE 250,A00,891860,Morris; Sheldon,9995,0,9999,4
1746573961083,CLRE 251R,A00,907817,Mehta; Ravindra L.,9994,0,9999,5
1746573962114,CLRE 252,A00,891864,Cuomo; Raphael Eduardo,9993,0,9999,6
1746573963145,CLRE 253,A00,891867,Vaida; Florin,9994,0,9999,5
1746573963145,CLRE 253,B00,907819,Staff,9999,0,9999,0
1746573964171,CLRE 259,A00,891868,Patel; Hemal,9998,0,9999,1
1746573965200,CLRE 260,A00,891872,Cuomo; Raphael Eduardo,9999,0,9999,0
1746573966226,CLRE 297,001,891888,Cuomo; Raphael Eduardo,9999,0,9999,0
1746573967251,CSE 191,A00,958773,Minnes Kemp; Mor Mia,9995,0,9999,4
1746573968278,CSE 197,001,959846,Minnes Kemp; Mor Mia,9990,0,9999,9
1746573969304,CSS 201S,A01,892054,Mignozzetti; Umberto,25,0,30,5
1746573970335,CSS 202S,A01,892056,Mignozzetti; Umberto,25,0,30,5
1746573971363,DSC 197,001,956898,Eldridge; Justin Matthew,9996,0,9999,3
1746573972405,DSC 297,001,958000,Mazumdar; Arya,9998,0,9999,1
1746573972405,DSC 297,002,959862,Wang; Yusu,9998,0,9999,1
1746573973430,EAP 100,A00,905686,Staff,9778,0,9999,221
1746573974457,ECE 45,A01,892618,Staff,0,0,65,65
1746573976508,ECE 111,A01,892719,Staff,5,0,65,60
1746573977534,ECE 197,001,957920,Mercier; Patrick Philip,9991,0,9999,8
1746573978566,ECON 178,A01,907814,Zhu; Ying,26,0,35,9
1746573979591,EDS 115,A00,895312,Staff,35,0,45,10
1746573980617,EDS 117,A01,895337,Staff,23,0,30,7
1746573981644,EDS 125,A00,895341,Jones; Gabrielle Anastasia,36,0,45,9
1746573982672,EDS 128A,A01,895459,Fargason; Sharon Gayle,44,0,45,1
1746573983701,EDS 128B,A01,895543,Pappas; Elizabeth,44,0,45,1
1746573984726,EDS 139,A00,897203,Pappas; Elizabeth,44,0,45,1
1746573984726,EDS 139,B00,897209,Fargason; Sharon Gayle,41,0,45,4
1746573985751,EDS 201,A00,895545,Staff,22,0,45,23
1746573986776,EDS 203,A01,895581,Halter; Christopher P.,22,0,45,23
1746573987802,EDS 204R,A01,895625,Heinzman; Erica M.,39,0,45,6
1746573987802,EDS 204R,B01,895693,Halter; Christopher P.,10,0,45,35
1746573988827,EDS 206R,A00,895694,Fargason; Sharon Gayle,1,0,30,29
1746573988827,EDS 206R,B00,895695,Choi; Bailey Miyeon,16,0,30,14
1746573989856,EDS 250,A00,895697,Hemans; Patricia Ann Benitez,22,0,45,23
1746573990882,EDS 281,A00,895701,Meyerott; Theresa Ann,1,0,15,14
1746573991907,EDS 284,A00,895736,Meyerott; Theresa Ann,1,0,15,14
1746573992935,EDS 286,A00,897210,Fine; Sarah,0,0,15,15
1746573993961,EDS 289C,A01,895770,Daly; Alan J.,1,0,15,14
1746573994989,EDS 290,A00,897211,Hofstetter; Carolyn,0,0,15,15
1746573996019,LIGM 5A,A00,896162,Fischer-Grunski; Eva K,12,0,20,8
1746573997045,LIGM 5B,A00,896260,Fischer-Grunski; Eva K,17,0,20,3
1746573998073,LIGM 5C,A00,896308,Fischer-Grunski; Eva K,18,0,20,2
1746573999100,LIIT 5AS,A00,896313,Carnelos; Chiara,18,0,20,2
1746574000130,LIIT 5BS,A00,896416,Carnelos; Chiara,20,0,20,0
1746574001160,LIIT 5CS,A00,896564,Carnelos; Chiara,20,0,20,0
1746574002187,LISP 5A,A00,896588,Munoz Sanchez; Alicia,2,0,20,18
1746574003212,LISP 5B,A00,896653,Munoz Sanchez; Alicia,7,0,20,13
1746574004238,LISP 5C,A00,896655,Munoz Sanchez; Alicia,0,1,20,20
1746574005269,MAE 197,001,957918,Kleissl; Jan,9996,0,9999,3
1746574005269,MAE 197,002,959806,Boechler; Nicholas Sebastia,9998,0,9999,1
1746574005269,MAE 197,003,959852,Mullin; Jennifer S,9998,0,9999,1
1746574006297,MATH 2,A01,957937,Staff,33,0,35,2
1746574007363,MATH 197,001,957876,Kedlaya; Kiran S.,9993,0,9999,6
1746574008390,MCWP 40,A00,892729,Duru; Nur,10,0,20,10
1746574008390,MCWP 40,B00,893304,Montejo; Carolina,14,0,20,6
1746574009416,MCWP 40R,A00,893757,Redela; Pamela Morgan,0,5,20,20
1746574010443,MCWP 50,A00,893758,Morshed; Michael James,0,0,20,20
1746574010443,MCWP 50,B00,893761,Bartulis; Jason Michael,17,0,20,3
1746574011470,MCWP 50R,A00,893766,Compas; Sean Matthew,0,1,20,20
1746574011470,MCWP 50R,B00,893769,Carter; Jennifer A,0,1,20,20
1746574011470,MCWP 50R,C00,893771,Krone; Jarret,0,3,20,20
1746574011470,MCWP 50R,D00,893772,Miller; Elizabeth Deen,0,0,20,20
1746574011470,MCWP 50R,E00,893775,Carter; Andrea L,0,1,20,20
1746574012497,MMW 11R,A01,892721,Herbst; Matthew,14,0,30,16
1746574012497,MMW 11R,A02,892722,Herbst; Matthew,0,0,0,3
1746574013524,MMW 12R,A01,892724,Herbst; Matthew,0,11,16,16
1746574013524,MMW 12R,A02,892725,Herbst; Matthew,0,10,16,16
1746574014548,MMW 13R,A01,892727,Staff,0,4,16,16
1746574014548,MMW 13R,A02,892728,Staff,0,4,16,16
1746574014548,MMW 13R,A03,958032,Staff,0,4,16,16
1746574014548,MMW 13R,A04,958033,Staff,0,4,16,16
1746574014548,MMW 13R,A05,958034,Staff,0,4,16,16
1746574015573,SIO 295LS,A00,894015,Staff,5,0,25,20
1746574016599,SIO 295S,A00,894020,Staff,5,0,25,20
1746574017624,SIOC 290S,B01,958918,Merrifield; Mark A,14,0,30,16
1746574018655,SIOC 291S,B01,958922,Gabriel; Corey John,14,0,30,16
1746574019682,SOCI 117,A01,895339,Staff,3,0,5,2
1746574020707,WES 237B,A00,894149,Staff,11,0,20,9
1746574022768,AESE 279B,A00,891859,Staff,13,0,35,22
1746574023792,AIP 197,001,891854,Vespa; Emanuel Ignacio,9999,0,9999,0
1746574024818,ANTH 289S,A00,891856,Gagneux; Pascal,12,0,12,0
1746574025847,BENG 196,001,957946,Engler; Adam J.,9996,0,9999,3
1746574026871,BISP 197,001,959851,Wilhelm; James E.,9998,0,9999,1
1746574027898,CAT 124RS,A01,956906,Staff,6,0,25,19
1746574028923,CAT 125RS,A01,922013,Staff,6,0,25,19
1746574029949,CLRE 250,A00,891860,Morris; Sheldon,9995,0,9999,4
1746574032007,CLRE 251R,A00,907817,Mehta; Ravindra L.,9994,0,9999,5
1746574033035,CLRE 252,A00,891864,Cuomo; Raphael Eduardo,9993,0,9999,6
1746574034059,CLRE 253,A00,891867,Vaida; Florin,9994,0,9999,5
1746574034059,CLRE 253,B00,907819,Staff,9999,0,9999,0
1746574035084,CLRE 259,A00,891868,Patel; Hemal,9998,0,9999,1
1746574036108,CLRE 260,A00,891872,Cuomo; Raphael Eduardo,9999,0,9999,0
1746574037135,CLRE 297,001,891888,Cuomo; Raphael Eduardo,9999,0,9999,0
1746574038161,CSE 191,A00,958773,Minnes Kemp; Mor Mia,9995,0,9999,4
1746574039185,CSE 197,001,959846,Minnes Kemp; Mor Mia,9990,0,9999,9
1746574040210,CSS 201S,A01,892054,Mignozzetti; Umberto,25,0,30,5
1746574041240,CSS 202S,A01,892056,Mignozzetti; Umberto,25,0,30,5
1746574042264,DSC 197,001,956898,Eldridge; Justin Matthew,9996,0,9999,3
1746574043292,DSC 297,001,958000,Mazumdar; Arya,9998,0,9999,1
1746574043292,DSC 297,002,959862,Wang; Yusu,9998,0,9999,1
1746574044318,EAP 100,A00,905686,Staff,9778,0,9999,221
1746574045349,ECE 45,A01,892618,Staff,0,0,65,65
1746574047404,ECE 111,A01,892719,Staff,5,0,65,60
1746574048430,ECE 197,001,957920,Mercier; Patrick Philip,9991,0,9999,8
1746574049456,ECON 178,A01,907814,Zhu; Ying,26,0,35,9
1746574050485,EDS 115,A00,895312,Staff,35,0,45,10
1746574051508,EDS 117,A01,895337,Staff,23,0,30,7
1746574052538,EDS 125,A00,895341,Jones; Gabrielle Anastasia,36,0,45,9
1746574053562,EDS 128A,A01,895459,Fargason; Sharon Gayle,44,0,45,1
1746574054588,EDS 128B,A01,895543,Pappas; Elizabeth,44,0,45,1
1746574055618,EDS 139,A00,897203,Pappas; Elizabeth,44,0,45,1
1746574055618,EDS 139,B00,897209,Fargason; Sharon Gayle,41,0,45,4
1746574056645,EDS 201,A00,895545,Staff,22,0,45,23
1746574057671,EDS 203,A01,895581,Halter; Christopher P.,22,0,45,23
1746574058700,EDS 204R,A01,895625,Heinzman; Erica M.,39,0,45,6
1746574058700,EDS 204R,B01,895693,Halter; Christopher P.,10,0,45,35
1746574059727,EDS 206R,A00,895694,Fargason; Sharon Gayle,1,0,30,29
1746574059727,EDS 206R,B00,895695,Choi; Bailey Miyeon,16,0,30,14
1746574060755,EDS 250,A00,895697,Hemans; Patricia Ann Benitez,22,0,45,23
1746574061781,EDS 281,A00,895701,Meyerott; Theresa Ann,1,0,15,14
1746574062809,EDS 284,A00,895736,Meyerott; Theresa Ann,1,0,15,14
1746574063834,EDS 286,A00,897210,Fine; Sarah,0,0,15,15
1746574064860,EDS 289C,A01,895770,Daly; Alan J.,1,0,15,14
1746574065886,EDS 290,A00,897211,Hofstetter; Carolyn,0,0,15,15
1746574066912,LIGM 5A,A00,896162,Fischer-Grunski; Eva K,12,0,20,8
1746574067937,LIGM 5B,A00,896260,Fischer-Grunski; Eva K,17,0,20,3
1746574068965,LIGM 5C,A00,896308,Fischer-Grunski; Eva K,18,0,20,2
1746574069993,LIIT 5AS,A00,896313,Carnelos; Chiara,18,0,20,2
1746574071021,LIIT 5BS,A00,896416,Carnelos; Chiara,20,0,20,0
1746574072047,LIIT 5CS,A00,896564,Carnelos; Chiara,20,0,20,0
1746574073072,LISP 5A,A00,896588,Munoz Sanchez; Alicia,2,0,20,18
1746574074098,LISP 5B,A00,896653,Munoz Sanchez; Alicia,7,0,20,13
1746574075126,LISP 5C,A00,896655,Munoz Sanchez; Alicia,0,1,20,20
1746574076155,MAE 197,001,957918,Kleissl; Jan,9996,0,9999,3
1746574076155,MAE 197,002,959806,Boechler; Nicholas Sebastia,9998,0,9999,1
1746574076155,MAE 197,003,959852,Mullin; Jennifer S,9998,0,9999,1
1746574077181,MATH 2,A01,957937,Staff,33,0,35,2
1746574078208,MATH 197,001,957876,Kedlaya; Kiran S.,9993,0,9999,6
1746574079236,MCWP 40,A00,892729,Duru; Nur,10,0,20,10
1746574079236,MCWP 40,B00,893304,Montejo; Carolina,14,0,20,6
1746574080262,MCWP 40R,A00,893757,Redela; Pamela Morgan,0,5,20,20
1746574081287,MCWP 50,A00,893758,Morshed; Michael James,0,0,20,20
1746574081287,MCWP 50,B00,893761,Bartulis; Jason Michael,17,0,20,3
1746574082312,MCWP 50R,A00,893766,Compas; Sean Matthew,0,1,20,20
1746574082312,MCWP 50R,B00,893769,Carter; Jennifer A,0,1,20,20
1746574082312,MCWP 50R,C00,893771,Krone; Jarret,0,3,20,20
1746574082312,MCWP 50R,D00,893772,Miller; Elizabeth Deen,0,0,20,20
1746574082312,MCWP 50R,E00,893775,Carter; Andrea L,0,1,20,20
1746574083339,MMW 11R,A01,892721,Herbst; Matthew,14,0,30,16
1746574083339,MMW 11R,A02,892722,Herbst; Matthew,0,0,0,3
1746574084366,MMW 12R,A01,892724,Herbst; Matthew,0,11,16,16
1746574084366,MMW 12R,A02,892725,Herbst; Matthew,0,10,16,16
1746574085391,MMW 13R,A01,892727,Staff,0,4,16,16
1746574085391,MMW 13R,A02,892728,Staff,0,4,16,16
1746574085391,MMW 13R,A03,958032,Staff,0,4,16,16
1746574085391,MMW 13R,A04,958033,Staff,0,4,16,16
1746574085391,MMW 13R,A05,958034,Staff,0,4,16,16
1746574086418,SIO 295LS,A00,894015,Staff,5,0,25,20
1746574087444,SIO 295S,A00,894020,Staff,5,0,25,20
1746574088473,SIOC 290S,B01,958918,Merrifield; Mark A,14,0,30,16
1746574089502,SIOC 291S,B01,958922,Gabriel; Corey John,14,0,30,16
1746574090530,SOCI 117,A01,895339,Staff,3,0,5,2
1746574091559,WES 237B,A00,894149,Staff,11,0,20,9
1746574093618,AESE 279B,A00,891859,Staff,13,0,35,22
1746574094642,AIP 197,001,891854,Vespa; Emanuel Ignacio,9999,0,9999,0
1746574095666,ANTH 289S,A00,891856,Gagneux; Pascal,12,0,12,0
1746574096690,BENG 196,001,957946,Engler; Adam J.,9996,0,9999,3
1746574097717,BISP 197,001,959851,Wilhelm; James E.,9998,0,9999,1
1746574098745,CAT 124RS,A01,956906,Staff,6,0,25,19
1746574099771,CAT 125RS,A01,922013,Staff,6,0,25,19
1746574100798,CLRE 250,A00,891860,Morris; Sheldon,9995,0,9999,4
1746574102852,CLRE 251R,A00,907817,Mehta; Ravindra L.,9994,0,9999,5
1746574103878,CLRE 252,A00,891864,Cuomo; Raphael Eduardo,9993,0,9999,6
1746574104907,CLRE 253,A00,891867,Vaida; Florin,9994,0,9999,5
1746574104907,CLRE 253,B00,907819,Staff,9999,0,9999,0
1746574105933,CLRE 259,A00,891868,Patel; Hemal,9998,0,9999,1
1746574106957,CLRE 260,A00,891872,Cuomo; Raphael Eduardo,9999,0,9999,0
1746574107983,CLRE 297,001,891888,Cuomo; Raphael Eduardo,9999,0,9999,0
1746574109012,CSE 191,A00,958773,Minnes Kemp; Mor Mia,9995,0,9999,4
1746574110039,CSE 197,001,959846,Minnes Kemp; Mor Mia,9990,0,9999,9
1746574111066,CSS 201S,A01,892054,Mignozzetti; Umberto,25,0,30,5
1746574112091,CSS 202S,A01,892056,Mignozzetti; Umberto,25,0,30,5
1746574113115,DSC 197,001,956898,Eldridge; Justin Matthew,9996,0,9999,3
1746574114144,DSC 297,001,958000,Mazumdar; Arya,9998,0,9999,1
1746574114144,DSC 297,002,959862,Wang; Yusu,9998,0,9999,1
1746574115167,EAP 100,A00,905686,Staff,9778,0,9999,221
1746574116192,ECE 45,A01,892618,Staff,0,0,65,65
1746574118250,ECE 111,A01,892719,Staff,5,0,65,60
1746574119273,ECE 197,001,957920,Mercier; Patrick Philip,9991,0,9999,8
1746574120299,ECON 178,A01,907814,Zhu; Ying,26,0,35,9
1746574121324,EDS 115,A00,895312,Staff,35,0,45,10
1746574122352,EDS 117,A01,895337,Staff,23,0,30,7
1746574123380,EDS 125,A00,895341,Jones; Gabrielle Anastasia,36,0,45,9
1746574124407,EDS 128A,A01,895459,Fargason; Sharon Gayle,44,0,45,1
1746574125439,EDS 128B,A01,895543,Pappas; Elizabeth,44,0,45,1
1746574126468,EDS 139,A00,897203,Pappas; Elizabeth,44,0,45,1
1746574126468,EDS 139,B00,897209,Fargason; Sharon Gayle,41,0,45,4
1746574127495,EDS 201,A00,895545,Staff,22,0,45,23
1746574128519,EDS 203,A01,895581,Halter; Christopher P.,22,0,45,23
1746574129543,EDS 204R,A01,895625,Heinzman; Erica M.,39,0,45,6
1746574129543,EDS 204R,B01,895693,Halter; Christopher P.,10,0,45,35
1746574130569,EDS 206R,A00,895694,Fargason; Sharon Gayle,1,0,30,29
1746574130569,EDS 206R,B00,895695,Choi; Bailey Miyeon,16,0,30,14
1746574131599,EDS 250,A00,895697,Hemans; Patricia Ann Benitez,22,0,45,23
1746574132624,EDS 281,A00,895701,Meyerott; Theresa Ann,1,0,15,14
1746574133652,EDS 284,A00,895736,Meyerott; Theresa Ann,1,0,15,14
1746574134677,EDS 286,A00,897210,Fine; Sarah,0,0,15,15
1746574135705,EDS 289C,A01,895770,Daly; Alan J.,1,0,15,14
1746574136734,EDS 290,A00,897211,Hofstetter; Carolyn,0,0,15,15
1746574137760,LIGM 5A,A00,896162,Fischer-Grunski; Eva K,12,0,20,8
1746574138784,LIGM 5B,A00,896260,Fischer-Grunski; Eva K,17,0,20,3
1746574139808,LIGM 5C,A00,896308,Fischer-Grunski; Eva K,18,0,20,2
1746574140839,LIIT 5AS,A00,896313,Carnelos; Chiara,18,0,20,2
1746574141865,LIIT 5BS,A00,896416,Carnelos; Chiara,20,0,20,0
1746574142893,LIIT 5CS,A00,896564,Carnelos; Chiara,20,0,20,0
1746574143920,LISP 5A,A00,896588,Munoz Sanchez; Alicia,2,0,20,18
1746574144950,LISP 5B,A00,896653,Munoz Sanchez; Alicia,7,0,20,13
1746574145976,LISP 5C,A00,896655,Munoz Sanchez; Alicia,0,1,20,20
1746574147004,MAE 197,001,957918,Kleissl; Jan,9996,0,9999,3
1746574147004,MAE 197,002,959806,Boechler; Nicholas Sebastia,9998,0,9999,1
1746574147004,MAE 197,003,959852,Mullin; Jennifer S,9998,0,9999,1
1746574148030,MATH 2,A01,957937,Staff,33,0,35,2
1746574149061,MATH 197,001,957876,Kedlaya; Kiran S.,9993,0,9999,6
1746574150118,MCWP 40,A00,892729,Duru; Nur,10,0,20,10
1746574150118,MCWP 40,B00,893304,Montejo; Carolina,14,0,20,6
1746574151146,MCWP 40R,A00,893757,Redela; Pamela Morgan,0,5,20,20
1746574152173,MCWP 50,A00,893758,Morshed; Michael James,0,0,20,20
1746574152173,MCWP 50,B00,893761,Bartulis; Jason Michael,17,0,20,3
1746574153198,MCWP 50R,A00,893766,Compas; Sean Matthew,0,1,20,20
1746574153198,MCWP 50R,B00,893769,Carter; Jennifer A,0,1,20,20
1746574153198,MCWP 50R,C00,893771,Krone; Jarret,0,3,20,20
1746574153198,MCWP 50R,D00,893772,Miller; Elizabeth Deen,0,0,20,20
1746574153198,MCWP 50R,E00,893775,Carter; Andrea L,0,1,20,20
1746574154226,MMW 11R,A01,892721,Herbst; Matthew,14,0,30,16
1746574154226,MMW 11R,A02,892722,Herbst; Matthew,0,0,0,3
1746574155253,MMW 12R,A01,892724,Herbst; Matthew,0,11,16,16
1746574155253,MMW 12R,A02,892725,Herbst; Matthew,0,10,16,16
1746574156278,MMW 13R,A01,892727,Staff,0,4,16,16
1746574156278,MMW 13R,A02,892728,Staff,0,4,16,16
1746574156278,MMW 13R,A03,958032,Staff,0,4,16,16
1746574156278,MMW 13R,A04,958033,Staff,0,4,16,16
1746574156278,MMW 13R,A05,958034,Staff,0,4,16,16
1746574157306,SIO 295LS,A00,894015,Staff,5,0,25,20
1746574158335,SIO 295S,A00,894020,Staff,5,0,25,20
1746574159360,SIOC 290S,B01,958918,Merrifield; Mark A,14,0,30,16
1746574160389,SIOC 291S,B01,958922,Gabriel; Corey John,14,0,30,16
1746574161418,SOCI 117,A01,895339,Staff,3,0,5,2
1746574162447,WES 237B,A00,894149,Staff,11,0,20,9
1746574164506,AESE 279B,A00,891859,Staff,13,0,35,22
1746574165530,AIP 197,001,891854,Vespa; Emanuel Ignacio,9999,0,9999,0
1746574166558,ANTH 289S,A00,891856,Gagneux; Pascal,12,0,12,0
1746574167586,BENG 196,001,957946,Engler; Adam J.,9996,0,9999,3
1746574168611,BISP 197,001,959851,Wilhelm; James E.,9998,0,9999,1
1746574169638,CAT 124RS,A01,956906,Staff,6,0,25,19
1746574170663,CAT 125RS,A01,922013,Staff,6,0,25,19
1746574171689,CLRE 250,A00,891860,Morris; Sheldon,9995,0,9999,4
1746574173739,CLRE 251R,A00,907817,Mehta; Ravindra L.,9994,0,9999,5
1746574174766,CLRE 252,A00,891864,Cuomo; Raphael Eduardo,9993,0,9999,6
1746574175790,CLRE 253,A00,891867,Vaida; Florin,9994,0,9999,5
1746574175790,CLRE 253,B00,907819,Staff,9999,0,9999,0
1746574176815,CLRE 259,A00,891868,Patel; Hemal,9998,0,9999,1
1746574177846,CLRE 260,A00,891872,Cuomo; Raphael Eduardo,9999,0,9999,0
1746574178872,CLRE 297,001,891888,Cuomo; Raphael Eduardo,9999,0,9999,0
1746574179895,CSE 191,A00,958773,Minnes Kemp; Mor Mia,9995,0,9999,4
1746574180919,CSE 197,001,959846,Minnes Kemp; Mor Mia,9990,0,9999,9
1746574181944,CSS 201S,A01,892054,Mignozzetti; Umberto,25,0,30,5
1746574182968,CSS 202S,A01,892056,Mignozzetti; Umberto,25,0,30,5
1746574183993,DSC 197,001,956898,Eldridge; Justin Matthew,9996,0,9999,3
1746574185024,DSC 297,001,958000,Mazumdar; Arya,9998,0,9999,1
1746574185024,DSC 297,002,959862,Wang; Yusu,9998,0,9999,1
1746574186049,EAP 100,A00,905686,Staff,9778,0,9999,221
1746574187079,ECE 45,A01,892618,Staff,0,0,65,65
1746574189126,ECE 111,A01,892719,Staff,5,0,65,60
1746574190153,ECE 197,001,957920,Mercier; Patrick Philip,9991,0,9999,8
1746574191178,ECON 178,A01,907814,Zhu; Ying,26,0,35,9
1746574192204,EDS 115,A00,895312,Staff,35,0,45,10
1746574193229,EDS 117,A01,895337,Staff,23,0,30,7
1746574194255,EDS 125,A00,895341,Jones; Gabrielle Anastasia,36,0,45,9
1746574195284,EDS 128A,A01,895459,Fargason; Sharon Gayle,44,0,45,1
1746574196307,EDS 128B,A01,895543,Pappas; Elizabeth,44,0,45,1
1746574197335,EDS 139,A00,897203,Pappas; Elizabeth,44,0,45,1
1746574197335,EDS 139,B00,897209,Fargason; Sharon Gayle,41,0,45,4
1746574198359,EDS 201,A00,895545,Staff,22,0,45,23
1746574199386,EDS 203,A01,895581,Halter; Christopher P.,22,0,45,23
1746574200414,EDS 204R,A01,895625,Heinzman; Erica M.,39,0,45,6
1746574200414,EDS 204R,B01,895693,Halter; Christopher P.,10,0,45,35
1746574201440,EDS 206R,A00,895694,Fargason; Sharon Gayle,1,0,30,29
1746574201440,EDS 206R,B00,895695,Choi; Bailey Miyeon,16,0,30,14
1746574202492,EDS 250,A00,895697,Hemans; Patricia Ann Benitez,22,0,45,23
1746574203519,EDS 281,A00,895701,Meyerott; Theresa Ann,1,0,15,14
1746574204546,EDS 284,A00,895736,Meyerott; Theresa Ann,1,0,15,14
1746574205570,EDS 286,A00,897210,Fine; Sarah,0,0,15,15
1746574206596,EDS 289C,A01,895770,Daly; Alan J.,1,0,15,14
1746574207621,EDS 290,A00,897211,Hofstetter; Carolyn,0,0,15,15
1746574208646,LIGM 5A,A00,896162,Fischer-Grunski; Eva K,12,0,20,8
1746574209675,LIGM 5B,A00,896260,Fischer-Grunski; Eva K,17,0,20,3
1746574210699,LIGM 5C,A00,896308,Fischer-Grunski; Eva K,18,0,20,2
1746574211726,LIIT 5AS,A00,896313,Carnelos; Chiara,18,0,20,2
1746574212749,LIIT 5BS,A00,896416,Carnelos; Chiara,20,0,20,0
1746574213776,LIIT 5CS,A00,896564,Carnelos; Chiara,20,0,20,0
1746574214800,LISP 5A,A00,896588,Munoz Sanchez; Alicia,2,0,20,18
1746574215825,LISP 5B,A00,896653,Munoz Sanchez; Alicia,7,0,20,13
1746574216857,LISP 5C,A00,896655,Munoz Sanchez; Alicia,0,1,20,20
1746574217882,MAE 197,001,957918,Kleissl; Jan,9996,0,9999,3
1746574217882,MAE 197,002,959806,Boechler; Nicholas Sebastia,9998,0,9999,1
1746574217882,MAE 197,003,959852,Mullin; Jennifer S,9998,0,9999,1
1746574218907,MATH 2,A01,957937,Staff,33,0,35,2
1746574219935,MATH 197,001,957876,Kedlaya; Kiran S.,9993,0,9999,6
1746574220960,MCWP 40,A00,892729,Duru; Nur,10,0,20,10
1746574220960,MCWP 40,B00,893304,Montejo; Carolina,14,0,20,6
1746574221988,MCWP 40R,A00,893757,Redela; Pamela Morgan,0,5,20,20
1746574223012,MCWP 50,A00,893758,Morshed; Michael James,0,0,20,20
1746574223012,MCWP 50,B00,893761,Bartulis; Jason Michael,17,0,20,3
1746574224037,MCWP 50R,A00,893766,Compas; Sean Matthew,0,1,20,20
1746574224037,MCWP 50R,B00,893769,Carter; Jennifer A,0,1,20,20
1746574224037,MCWP 50R,C00,893771,Krone; Jarret,0,3,20,20
1746574224037,MCWP 50R,D00,893772,Miller; Elizabeth Deen,0,0,20,20
1746574224037,MCWP 50R,E00,893775,Carter; Andrea L,0,1,20,20
1746574225067,MMW 11R,A01,892721,Herbst; Matthew,14,0,30,16
1746574225067,MMW 11R,A02,892722,Herbst; Matthew,0,0,0,3
1746574226092,MMW 12R,A01,892724,Herbst; Matthew,0,11,16,16
1746574226092,MMW 12R,A02,892725,Herbst; Matthew,0,10,16,16
1746574227118,MMW 13R,A01,892727,Staff,0,4,16,16
1746574227118,MMW 13R,A02,892728,Staff,0,4,16,16
1746574227118,MMW 13R,A03,958032,Staff,0,4,16,16
1746574227118,MMW 13R,A04,958033,Staff,0,4,16,16
1746574227118,MMW 13R,A05,958034,Staff,0,4,16,16
1746574228143,SIO 295LS,A00,894015,Staff,5,0,25,20
1746574229171,SIO 295S,A00,894020,Staff,5,0,25,20
1746574230198,SIOC 290S,B01,958918,Merrifield; Mark A,14,0,30,16
1746574231222,SIOC 291S,B01,958922,Gabriel; Corey John,14,0,30,16
1746574232248,SOCI 117,A01,895339,Staff,3,0,5,2
1746574233275,WES 237B,A00,894149,Staff,11,0,20,9
1746574235331,AESE 279B,A00,891859,Staff,13,0,35,22
1746574236359,AIP 197,001,891854,Vespa; Emanuel Ignacio,9999,0,9999,0
1746574237385,ANTH 289S,A00,891856,Gagneux; Pascal,12,0,12,0
1746574238414,BENG 196,001,957946,Engler; Adam J.,9996,0,9999,3
1746574239445,BISP 197,001,959851,Wilhelm; James E.,9998,0,9999,1
1746574240470,CAT 124RS,A01,956906,Staff,6,0,25,19
1746574241496,CAT 125RS,A01,922013,Staff,6,0,25,19
1746574242520,CLRE 250,A00,891860,Morris; Sheldon,9995,0,9999,4
1746574244576,CLRE 251R,A00,907817,Mehta; Ravindra L.,9994,0,9999,5
1746574245601,CLRE 252,A00,891864,Cuomo; Raphael Eduardo,9993,0,9999,6
1746574246627,CLRE 253,A00,891867,Vaida; Florin,9994,0,9999,5
1746574246627,CLRE 253,B00,907819,Staff,9999,0,9999,0
1746574247657,CLRE 259,A00,891868,Patel; Hemal,9998,0,9999,1
1746574248688,CLRE 260,A00,891872,Cuomo; Raphael Eduardo,9999,0,9999,0
1746574249713,CLRE 297,001,891888,Cuomo; Raphael Eduardo,9999,0,9999,0
1746574250739,CSE 191,A00,958773,Minnes Kemp; Mor Mia,9995,0,9999,4
1746574251764,CSE 197,001,959846,Minnes Kemp; Mor Mia,9990,0,9999,9
1746574252794,CSS 201S,A01,892054,Mignozzetti; Umberto,25,0,30,5
1746574253821,CSS 202S,A01,892056,Mignozzetti; Umberto,25,0,30,5
1746574254846,DSC 197,001,956898,Eldridge; Justin Matthew,9996,0,9999,3
1746574255871,DSC 297,001,958000,Mazumdar; Arya,9998,0,9999,1
1746574255871,DSC 297,002,959862,Wang; Yusu,9998,0,9999,1
1746574256900,EAP 100,A00,905686,Staff,9778,0,9999,221
1746574257926,ECE 45,A01,892618,Staff,0,0,65,65
1746574259981,ECE 111,A01,892719,Staff,5,0,65,60
1746574261011,ECE 197,001,957920,Mercier; Patrick Philip,9991,0,9999,8
1746574262042,ECON 178,A01,907814,Zhu; Ying,26,0,35,9
1746574263069,EDS 115,A00,895312,Staff,35,0,45,10
1746574264100,EDS 117,A01,895337,Staff,23,0,30,7
1746574265125,EDS 125,A00,895341,Jones; Gabrielle Anastasia,36,0,45,9
1746574266151,EDS 128A,A01,895459,Fargason; Sharon Gayle,44,0,45,1
1746574267177,EDS 128B,A01,895543,Pappas; Elizabeth,44,0,45,1
1746574268207,EDS 139,A00,897203,Pappas; Elizabeth,44,0,45,1
1746574268207,EDS 139,B00,897209,Fargason; Sharon Gayle,41,0,45,4
1746574269233,EDS 201,A00,895545,Staff,22,0,45,23
1746574270258,EDS 203,A01,895581,Halter; Christopher P.,22,0,45,23
1746574271284,EDS 204R,A01,895625,Heinzman; Erica M.,39,0,45,6
1746574271284,EDS 204R,B01,895693,Halter; Christopher P.,10,0,45,35
1746574272316,EDS 206R,A00,895694,Fargason; Sharon Gayle,1,0,30,29
1746574272316,EDS 206R,B00,895695,Choi; Bailey Miyeon,16,0,30,14
1746574273345,EDS 250,A00,895697,Hemans; Patricia Ann Benitez,22,0,45,23
1746574274370,EDS 281,A00,895701,Meyerott; Theresa Ann,1,0,15,14
1746574275394,EDS 284,A00,895736,Meyerott; Theresa Ann,1,0,15,14
1746574276418,EDS 286,A00,897210,Fine; Sarah,0,0,15,15
1746574277448,EDS 289C,A01,895770,Daly; Alan J.,1,0,15,14
1746574278475,EDS 290,A00,897211,Hofstetter; Carolyn,0,0,15,15
1746574279505,LIGM 5A,A00,896162,Fischer-Grunski; Eva K,12,0,20,8
1746574280533,LIGM 5B,A00,896260,Fischer-Grunski; Eva K,17,0,20,3
1746574281557,LIGM 5C,A00,896308,Fischer-Grunski; Eva K,18,0,20,2
1746574282583,LIIT 5AS,A00,896313,Carnelos; Chiara,18,0,20,2
1746574283608,LIIT 5BS,A00,896416,Carnelos; Chiara,20,0,20,0
1746574284634,LIIT 5CS,A00,896564,Carnelos; Chiara,20,0,20,0
1746574285663,LISP 5A,A00,896588,Munoz Sanchez; Alicia,2,0,20,18
1746574286691,LISP 5B,A00,896653,Munoz Sanchez; Alicia,7,0,20,13
1746574287717,LISP 5C,A00,896655,Munoz Sanchez; Alicia,0,1,20,20
1746574288743,MAE 197,001,957918,Kleissl; Jan,9996,0,9999,3
1746574288743,MAE 197,002,959806,Boechler; Nicholas Sebastia,9998,0,9999,1
1746574288743,MAE 197,003,959852,Mullin; Jennifer S,9998,0,9999,1
1746574289769,MATH 2,A01,957937,Staff,33,0,35,2
1746574290797,MATH 197,001,957876,Kedlaya; Kiran S.,9993,0,9999,6
1746574291826,MCWP 40,A00,892729,Duru; Nur,10,0,20,10
1746574291826,MCWP 40,B00,893304,Montejo; Carolina,14,0,20,6
1746574292854,MCWP 40R,A00,893757,Redela; Pamela Morgan,0,5,20,20
1746574293879,MCWP 50,A00,893758,Morshed; Michael James,0,0,20,20
1746574293879,MCWP 50,B00,893761,Bartulis; Jason Michael,17,0,20,3
1746574294908,MCWP 50R,A00,893766,Compas; Sean Matthew,0,1,20,20
1746574294908,MCWP 50R,B00,893769,Carter; Jennifer A,0,1,20,20
1746574294908,MCWP 50R,C00,893771,Krone; Jarret,0,3,20,20
1746574294908,MCWP 50R,D00,893772,Miller; Elizabeth Deen,0,0,20,20
1746574294908,MCWP 50R,E00,893775,Carter; Andrea L,0,1,20,20
1746574295937,MMW 11R,A01,892721,Herbst; Matthew,14,0,30,16
1746574295937,MMW 11R,A02,892722,Herbst; Matthew,0,0,0,3
1746574296967,MMW 12R,A01,892724,Herbst; Matthew,0,11,16,16
1746574296967,MMW 12R,A02,892725,Herbst; Matthew,0,10,16,16
1746574297994,MMW 13R,A01,892727,Staff,0,4,16,16
1746574297994,MMW 13R,A02,892728,Staff,0,4,16,16
1746574297994,MMW 13R,A03,958032,Staff,0,4,16,16
1746574297994,MMW 13R,A04,958033,Staff,0,4,16,16
1746574297994,MMW 13R,A05,958034,Staff,0,4,16,16
1746574299019,SIO 295LS,A00,894015,Staff,5,0,25,20
1746574300049,SIO 295S,A00,894020,Staff,5,0,25,20
1746574301077,SIOC 290S,B01,958918,Merrifield; Mark A,14,0,30,16
1746574302102,SIOC 291S,B01,958922,Gabriel; Corey John,14,0,30,16
1746574303127,SOCI 117,A01,895339,Staff,3,0,5,2
1746574304152,WES 237B,A00,894149,Staff,11,0,20,9
1746574306219,AESE 279B,A00,891859,Staff,13,0,35,22
1746574307246,AIP 197,001,891854,Vespa; Emanuel Ignacio,9999,0,9999,0
1746574308275,ANTH 289S,A00,891856,Gagneux; Pascal,12,0,12,0
1746574309300,BENG 196,001,957946,Engler; Adam J.,9996,0,9999,3
1746574310333,BISP 197,001,959851,Wilhelm; James E.,9998,0,9999,1
1746574311388,CAT 124RS,A01,956906,Staff,6,0,25,19
1746574312418,CAT 125RS,A01,922013,Staff,6,0,25,19
1746574313443,CLRE 250,A00,891860,Morris; Sheldon,9995,0,9999,4
1746574315498,CLRE 251R,A00,907817,Mehta; Ravindra L.,9994,0,9999,5
1746574316523,CLRE 252,A00,891864,Cuomo; Raphael Eduardo,9993,0,9999,6
1746574317553,CLRE 253,A00,891867,Vaida; Florin,9994,0,9999,5
1746574317553,CLRE 253,B00,907819,Staff,9999,0,9999,0
1746574318578,CLRE 259,A00,891868,Patel; Hemal,9998,0,9999,1
1746574319604,CLRE 260,A00,891872,Cuomo; Raphael Eduardo,9999,0,9999,0
1746574320630,CLRE 297,001,891888,Cuomo; Raphael Eduardo,9999,0,9999,0
1746574321657,CSE 191,A00,958773,Minnes Kemp; Mor Mia,9995,0,9999,4
1746574322692,CSE 197,001,959846,Minnes Kemp; Mor Mia,9990,0,9999,9
1746574323722,CSS 201S,A01,892054,Mignozzetti; Umberto,25,0,30,5
1746574324753,CSS 202S,A01,892056,Mignozzetti; Umberto,25,0,30,5
1746574325783,DSC 197,001,956898,Eldridge; Justin Matthew,9996,0,9999,3
1746574326812,DSC 297,001,958000,Mazumdar; Arya,9998,0,9999,1
1746574326812,DSC 297,002,959862,Wang; Yusu,9998,0,9999,1
1746574327838,EAP 100,A00,905686,Staff,9778,0,9999,221
1746574328862,ECE 45,A01,892618,Staff,0,0,65,65
1746574330914,ECE 111,A01,892719,Staff,5,0,65,60
1746574331943,ECE 197,001,957920,Mercier; Patrick Philip,9991,0,9999,8
1746574332971,ECON 178,A01,907814,Zhu; Ying,26,0,35,9
1746574333996,EDS 115,A00,895312,Staff,35,0,45,10
1746574335022,EDS 117,A01,895337,Staff,23,0,30,7
1746574336049,EDS 125,A00,895341,Jones; Gabrielle Anastasia,36,0,45,9
1746574337073,EDS 128A,A01,895459,Fargason; Sharon Gayle,44,0,45,1
1746574338099,EDS 128B,A01,895543,Pappas; Elizabeth,44,0,45,1
1746574339123,EDS 139,A00,897203,Pappas; Elizabeth,44,0,45,1
1746574339123,EDS 139,B00,897209,Fargason; Sharon Gayle,41,0,45,4
1746574340148,EDS 201,A00,895545,Staff,22,0,45,23
1746574341174,EDS 203,A01,895581,Halter; Christopher P.,22,0,45,23
1746574342199,EDS 204R,A01,895625,Heinzman; Erica M.,39,0,45,6
1746574342199,EDS 204R,B01,895693,Halter; Christopher P.,10,0,45,35
1746574343225,EDS 206R,A00,895694,Fargason; Sharon Gayle,1,0,30,29
1746574343225,EDS 206R,B00,895695,Choi; Bailey Miyeon,16,0,30,14
1746574344253,EDS 250,A00,895697,Hemans; Patricia Ann Benitez,22,0,45,23
1746574345276,EDS 281,A00,895701,Meyerott; Theresa Ann,1,0,15,14
1746574346300,EDS 284,A00,895736,Meyerott; Theresa Ann,1,0,15,14
1746574347325,EDS 286,A00,897210,Fine; Sarah,0,0,15,15
1746574348350,EDS 289C,A01,895770,Daly; Alan J.,1,0,15,14
1746574349587,EDS 290,A00,897211,Hofstetter; Carolyn,0,0,15,15
1746574350616,LIGM 5A,A00,896162,Fischer-Grunski; Eva K,12,0,20,8
1746574351641,LIGM 5B,A00,896260,Fischer-Grunski; Eva K,17,0,20,3
1746574352670,LIGM 5C,A00,896308,Fischer-Grunski; Eva K,18,0,20,2
1746574353696,LIIT 5AS,A00,896313,Carnelos; Chiara,18,0,20,2
1746574354721,LIIT 5BS,A00,896416,Carnelos; Chiara,20,0,20,0
1746574355750,LIIT 5CS,A00,896564,Carnelos; Chiara,20,0,20,0
1746574356778,LISP 5A,A00,896588,Munoz Sanchez; Alicia,2,0,20,18
1746574357806,LISP 5B,A00,896653,Munoz Sanchez; Alicia,7,0,20,13
1746574358833,LISP 5C,A00,896655,Munoz Sanchez; Alicia,0,1,20,20
1746574359863,MAE 197,001,957918,Kleissl; Jan,9996,0,9999,3
1746574359863,MAE 197,002,959806,Boechler; Nicholas Sebastia,9998,0,9999,1
1746574359863,MAE 197,003,959852,Mullin; Jennifer S,9998,0,9999,1
1746574360888,MATH 2,A01,957937,Staff,33,0,35,2
1746574361913,MATH 197,001,957876,Kedlaya; Kiran S.,9993,0,9999,6
1746574362942,MCWP 40,A00,892729,Duru; Nur,10,0,20,10
1746574362942,MCWP 40,B00,893304,Montejo; Carolina,14,0,20,6
1746574363966,MCWP 40R,A00,893757,Redela; Pamela Morgan,0,5,20,20
1746574364994,MCWP 50,A00,893758,Morshed; Michael James,0,0,20,20
1746574364994,MCWP 50,B00,893761,Bartulis; Jason Michael,17,0,20,3
1746574366024,MCWP 50R,A00,893766,Compas; Sean Matthew,0,1,20,20
1746574366024,MCWP 50R,B00,893769,Carter; Jennifer A,0,1,20,20
1746574366024,MCWP 50R,C00,893771,Krone; Jarret,0,3,20,20
1746574366024,MCWP 50R,D00,893772,Miller; Elizabeth Deen,0,0,20,20
1746574366024,MCWP 50R,E00,893775,Carter; Andrea L,0,1,20,20
1746574367049,MMW 11R,A01,892721,Herbst; Matthew,14,0,30,16
1746574367049,MMW 11R,A02,892722,Herbst; Matthew,0,0,0,3
1746574368075,MMW 12R,A01,892724,Herbst; Matthew,0,11,16,16
1746574368075,MMW 12R,A02,892725,Herbst; Matthew,0,10,16,16
1746574369100,MMW 13R,A01,892727,Staff,0,4,16,16
1746574369100,MMW 13R,A02,892728,Staff,0,4,16,16
1746574369100,MMW 13R,A03,958032,Staff,0,4,16,16
1746574369100,MMW 13R,A04,958033,Staff,0,4,16,16
1746574369100,MMW 13R,A05,958034,Staff,0,4,16,16
1746574370133,SIO 295LS,A00,894015,Staff,5,0,25,20
1746574371160,SIO 295S,A00,894020,Staff,5,0,25,20
1746574372186,SIOC 290S,B01,958918,Merrifield; Mark A,14,0,30,16
1746574373215,SIOC 291S,B01,958922,Gabriel; Corey John,14,0,30,16
1746574374244,SOCI 117,A01,895339,Staff,3,0,5,2
1746574375270,WES 237B,A00,894149,Staff,11,0,20,9
1746574377328,AESE 279B,A00,891859,Staff,13,0,35,22
1746574378353,AIP 197,001,891854,Vespa; Emanuel Ignacio,9999,0,9999,0
1746574379379,ANTH 289S,A00,891856,Gagneux; Pascal,12,0,12,0
1746574380403,BENG 196,001,957946,Engler; Adam J.,9996,0,9999,3
1746574381427,BISP 197,001,959851,Wilhelm; James E.,9998,0,9999,1
1746574382452,CAT 124RS,A01,956906,Staff,6,0,25,19
1746574383481,CAT 125RS,A01,922013,Staff,6,0,25,19
1746574384505,CLRE 250,A00,891860,Morris; Sheldon,9995,0,9999,4
1746574386561,CLRE 251R,A00,907817,Mehta; Ravindra L.,9994,0,9999,5
1746574387587,CLRE 252,A00,891864,Cuomo; Raphael Eduardo,9993,0,9999,6
1746574388618,CLRE 253,A00,891867,Vaida; Florin,9994,0,9999,5
1746574388618,CLRE 253,B00,907819,Staff,9999,0,9999,0
1746574389648,CLRE 259,A00,891868,Patel; Hemal,9998,0,9999,1
1746574390674,CLRE 260,A00,891872,Cuomo; Raphael Eduardo,9999,0,9999,0
1746574391698,CLRE 297,001,891888,Cuomo; Raphael Eduardo,9999,0,9999,0
1746574392724,CSE 191,A00,958773,Minnes Kemp; Mor Mia,9995,0,9999,4
1746574393750,CSE 197,001,959846,Minnes Kemp; Mor Mia,9990,0,9999,9
1746574394781,CSS 201S,A01,892054,Mignozzetti; Umberto,25,0,30,5
1746574395811,CSS 202S,A01,892056,Mignozzetti; Umberto,25,0,30,5
1746574396837,DSC 197,001,956898,Eldridge; Justin Matthew,9996,0,9999,3
1746574397866,DSC 297,001,958000,Mazumdar; Arya,9998,0,9999,1
1746574397866,DSC 297,002,959862,Wang; Yusu,9998,0,9999,1
1746574398890,EAP 100,A00,905686,Staff,9778,0,9999,221
1746574399915,ECE 45,A01,892618,Staff,0,0,65,65
1746574401974,ECE 111,A01,892719,Staff,5,0,65,60
1746574403001,ECE 197,001,957920,Mercier; Patrick Philip,9991,0,9999,8
1746574404030,ECON 178,A01,907814,Zhu; Ying,26,0,35,9
1746574405056,EDS 115,A00,895312,Staff,35,0,45,10
1746574406080,EDS 117,A01,895337,Staff,23,0,30,7
1746574407106,EDS 125,A00,895341,Jones; Gabrielle Anastasia,36,0,45,9
1746574408132,EDS 128A,A01,895459,Fargason; Sharon Gayle,44,0,45,1
1746574409157,EDS 128B,A01,895543,Pappas; Elizabeth,44,0,45,1
1746574410183,EDS 139,A00,897203,Pappas; Elizabeth,44,0,45,1
1746574410183,EDS 139,B00,897209,Fargason; Sharon Gayle,41,0,45,4
1746574411212,EDS 201,A00,895545,Staff,22,0,45,23
1746574412240,EDS 203,A01,895581,Halter; Christopher P.,22,0,45,23
1746574413264,EDS 204R,A01,895625,Heinzman; Erica M.,39,0,45,6
1746574413264,EDS 204R,B01,895693,Halter; Christopher P.,10,0,45,35
1746574414291,EDS 206R,A00,895694,Fargason; Sharon Gayle,1,0,30,29
1746574414291,EDS 206R,B00,895695,Choi; Bailey Miyeon,16,0,30,14
1746574415319,EDS 250,A00,895697,Hemans; Patricia Ann Benitez,22,0,45,23
1746574416345,EDS 281,A00,895701,Meyerott; Theresa Ann,1,0,15,14
1746574417391,EDS 284,A00,895736,Meyerott; Theresa Ann,1,0,15,14
1746574418416,EDS 286,A00,897210,Fine; Sarah,0,0,15,15
1746574419444,EDS 289C,A01,895770,Daly; Alan J.,1,0,15,14
1746574420475,EDS 290,A00,897211,Hofstetter; Carolyn,0,0,15,15
1746574421503,LIGM 5A,A00,896162,Fischer-Grunski; Eva K,12,0,20,8
1746574422530,LIGM 5B,A00,896260,Fischer-Grunski; Eva K,17,0,20,3
1746574423555,LIGM 5C,A00,896308,Fischer-Grunski; Eva K,18,0,20,2
1746574424581,LIIT 5AS,A00,896313,Carnelos; Chiara,18,0,20,2
1746574425606,LIIT 5BS,A00,896416,Carnelos; Chiara,20,0,20,0
1746574426633,LIIT 5CS,A00,896564,Carnelos; Chiara,20,0,20,0
1746574427661,LISP 5A,A00,896588,Munoz Sanchez; Alicia,2,0,20,18
1746574428689,LISP 5B,A00,896653,Munoz Sanchez; Alicia,7,0,20,13
1746574429716,LISP 5C,A00,896655,Munoz Sanchez; Alicia,0,1,20,20
1746574430740,MAE 197,001,957918,Kleissl; Jan,9996,0,9999,3
1746574430740,MAE 197,002,959806,Boechler; Nicholas Sebastia,9998,0,9999,1
1746574430740,MAE 197,003,959852,Mullin; Jennifer S,9998,0,9999,1
1746574431766,MATH 2,A01,957937,Staff,33,0,35,2
1746574432793,MATH 197,001,957876,Kedlaya; Kiran S.,9993,0,9999,6
1746574433818,MCWP 40,A00,892729,Duru; Nur,10,0,20,10
1746574433818,MCWP 40,B00,893304,Montejo; Carolina,14,0,20,6
1746574434843,MCWP 40R,A00,893757,Redela; Pamela Morgan,0,5,20,20
1746574435868,MCWP 50,A00,893758,Morshed; Michael James,0,0,20,20
1746574435868,MCWP 50,B00,893761,Bartulis; Jason Michael,17,0,20,3
1746574436897,MCWP 50R,A00,893766,Compas; Sean Matthew,0,1,20,20
1746574436897,MCWP 50R,B00,893769,Carter; Jennifer A,0,1,20,20
1746574436897,MCWP 50R,C00,893771,Krone; Jarret,0,3,20,20
1746574436897,MCWP 50R,D00,893772,Miller; Elizabeth Deen,0,0,20,20
1746574436897,MCWP 50R,E00,893775,Carter; Andrea L,0,1,20,20
1746574437923,MMW 11R,A01,892721,Herbst; Matthew,14,0,30,16
1746574437923,MMW 11R,A02,892722,Herbst; Matthew,0,0,0,3
1746574438948,MMW 12R,A01,892724,Herbst; Matthew,0,11,16,16
1746574438948,MMW 12R,A02,892725,Herbst; Matthew,0,10,16,16
1746574439973,MMW 13R,A01,892727,Staff,0,4,16,16
1746574439973,MMW 13R,A02,892728,Staff,0,4,16,16
1746574439973,MMW 13R,A03,958032,Staff,0,4,16,16
1746574439973,MMW 13R,A04,958033,Staff,0,4,16,16
1746574439973,MMW 13R,A05,958034,Staff,0,4,16,16
1746574441001,SIO 295LS,A00,894015,Staff,5,0,25,20
1746574442027,SIO 295S,A00,894020,Staff,5,0,25,20
1746574443052,SIOC 290S,B01,958918,Merrifield; Mark A,14,0,30,16
1746574444077,SIOC 291S,B01,958922,Gabriel; Corey John,14,0,30,16
1746574445102,SOCI 117,A01,895339,Staff,3,0,5,2
1746574446127,WES 237B,A00,894149,Staff,11,0,20,9
1746574448187,AESE 279B,A00,891859,Staff,13,0,35,22
1746574449212,AIP 197,001,891854,Vespa; Emanuel Ignacio,9999,0,9999,0
1746574450241,ANTH 289S,A00,891856,Gagneux; Pascal,12,0,12,0
1746574451267,BENG 196,001,957946,Engler; Adam J.,9996,0,9999,3
1746574452292,BISP 197,001,959851,Wilhelm; James E.,9998,0,9999,1
1746574453316,CAT 124RS,A01,956906,Staff,6,0,25,19
1746574454341,CAT 125RS,A01,922013,Staff,6,0,25,19
1746574455365,CLRE 250,A00,891860,Morris; Sheldon,9995,0,9999,4
1746574457415,CLRE 251R,A00,907817,Mehta; Ravindra L.,9994,0,9999,5
1746574458439,CLRE 252,A00,891864,Cuomo; Raphael Eduardo,9993,0,9999,6
1746574459467,CLRE 253,A00,891867,Vaida; Florin,9994,0,9999,5
1746574459467,CLRE 253,B00,907819,Staff,9999,0,9999,0
1746574460491,CLRE 259,A00,891868,Patel; Hemal,9998,0,9999,1
1746574461516,CLRE 260,A00,891872,Cuomo; Raphael Eduardo,9999,0,9999,0
1746574462546,CLRE 297,001,891888,Cuomo; Raphael Eduardo,9999,0,9999,0
1746574463570,CSE 191,A00,958773,Minnes Kemp; Mor Mia,9995,0,9999,4
1746574464596,CSE 197,001,959846,Minnes Kemp; Mor Mia,9990,0,9999,9
1746574465622,CSS 201S,A01,892054,Mignozzetti; Umberto,25,0,30,5
1746574466647,CSS 202S,A01,892056,Mignozzetti; Umberto,25,0,30,5
1746574467675,DSC 197,001,956898,Eldridge; Justin Matthew,9996,0,9999,3
1746574468702,DSC 297,001,958000,Mazumdar; Arya,9998,0,9999,1
1746574468702,DSC 297,002,959862,Wang; Yusu,9998,0,9999,1
1746574469729,EAP 100,A00,905686,Staff,9778,0,9999,221
1746574470755,ECE 45,A01,892618,Staff,0,0,65,65
1746574472808,ECE 111,A01,892719,Staff,5,0,65,60
1746574473835,ECE 197,001,957920,Mercier; Patrick Philip,9991,0,9999,8
1746574474861,ECON 178,A01,907814,Zhu; Ying,26,0,35,9
1746574475887,EDS 115,A00,895312,Staff,35,0,45,10
1746574476916,EDS 117,A01,895337,Staff,23,0,30,7
1746574477940,EDS 125,A00,895341,Jones; Gabrielle Anastasia,36,0,45,9
1746574478967,EDS 128A,A01,895459,Fargason; Sharon Gayle,44,0,45,1
1746574479996,EDS 128B,A01,895543,Pappas; Elizabeth,44,0,45,1
1746574481023,EDS 139,A00,897203,Pappas; Elizabeth,44,0,45,1
1746574481023,EDS 139,B00,897209,Fargason; Sharon Gayle,41,0,45,4
1746574482051,EDS 201,A00,895545,Staff,22,0,45,23
1746574483078,EDS 203,A01,895581,Halter; Christopher P.,22,0,45,23
1746574484107,EDS 204R,A01,895625,Heinzman; Erica M.,39,0,45,6
1746574484107,EDS 204R,B01,895693,Halter; Christopher P.,10,0,45,35
1746574485132,EDS 206R,A00,895694,Fargason; Sharon Gayle,1,0,30,29
1746574485132,EDS 206R,B00,895695,Choi; Bailey Miyeon,16,0,30,14
1746574486160,EDS 250,A00,895697,Hemans; Patricia Ann Benitez,22,0,45,23
1746574487187,EDS 281,A00,895701,Meyerott; Theresa Ann,1,0,15,14
1746574488212,EDS 284,A00,895736,Meyerott; Theresa Ann,1,0,15,14
1746574489239,EDS 286,A00,897210,Fine; Sarah,0,0,15,15
1746574490263,EDS 289C,A01,895770,Daly; Alan J.,1,0,15,14
1746574491290,EDS 290,A00,897211,Hofstetter; Carolyn,0,0,15,15
1746574492319,LIGM 5A,A00,896162,Fischer-Grunski; Eva K,12,0,20,8
1746574493344,LIGM 5B,A00,896260,Fischer-Grunski; Eva K,17,0,20,3
1746574494368,LIGM 5C,A00,896308,Fischer-Grunski; Eva K,18,0,20,2
1746574495395,LIIT 5AS,A00,896313,Carnelos; Chiara,18,0,20,2
1746574496423,LIIT 5BS,A00,896416,Carnelos; Chiara,20,0,20,0
1746574497448,LIIT 5CS,A00,896564,Carnelos; Chiara,20,0,20,0
1746574498475,LISP 5A,A00,896588,Munoz Sanchez; Alicia,2,0,20,18
1746574499501,LISP 5B,A00,896653,Munoz Sanchez; Alicia,7,0,20,13
1746574500531,LISP 5C,A00,896655,Munoz Sanchez; Alicia,0,1,20,20
1746574501560,MAE 197,001,957918,Kleissl; Jan,9996,0,9999,3
1746574501560,MAE 197,002,959806,Boechler; Nicholas Sebastia,9998,0,9999,1
1746574501560,MAE 197,003,959852,Mullin; Jennifer S,9998,0,9999,1
1746574502587,MATH 2,A01,957937,Staff,33,0,35,2
1746574503615,MATH 197,001,957876,Kedlaya; Kiran S.,9993,0,9999,6
1746574504642,MCWP 40,A00,892729,Duru; Nur,10,0,20,10
1746574504642,MCWP 40,B00,893304,Montejo; Carolina,14,0,20,6
1746574505671,MCWP 40R,A00,893757,Redela; Pamela Morgan,0,5,20,20
1746574506698,MCWP 50,A00,893758,Morshed; Michael James,0,0,20,20
1746574506698,MCWP 50,B00,893761,Bartulis; Jason Michael,17,0,20,3
1746574507724,MCWP 50R,A00,893766,Compas; Sean Matthew,0,1,20,20
1746574507724,MCWP 50R,B00,893769,Carter; Jennifer A,0,1,20,20
1746574507724,MCWP 50R,C00,893771,Krone; Jarret,0,3,20,20
1746574507724,MCWP 50R,D00,893772,Miller; Elizabeth Deen,0,0,20,20
1746574507724,MCWP 50R,E00,893775,Carter; Andrea L,0,1,20,20
1746574508748,MMW 11R,A01,892721,Herbst; Matthew,14,0,30,16
1746574508748,MMW 11R,A02,892722,Herbst; Matthew,0,0,0,3
1746574509774,MMW 12R,A01,892724,Herbst; Matthew,0,11,16,16
1746574509774,MMW 12R,A02,892725,Herbst; Matthew,0,10,16,16
1746574510799,MMW 13R,A01,892727,Staff,0,4,16,16
1746574510799,MMW 13R,A02,892728,Staff,0,4,16,16
1746574510799,MMW 13R,A03,958032,Staff,0,4,16,16
1746574510799,MMW 13R,A04,958033,Staff,0,4,16,16
1746574510799,MMW 13R,A05,958034,Staff,0,4,16,16
1746574511825,SIO 295LS,A00,894015,Staff,5,0,25,20
1746574512888,SIO 295S,A00,894020,Staff,5,0,25,20
1746574513917,SIOC 290S,B01,958918,Merrifield; Mark A,14,0,30,16
1746574514947,SIOC 291S,B01,958922,Gabriel; Corey John,14,0,30,16
1746574515975,SOCI 117,A01,895339,Staff,3,0,5,2
1746574517003,WES 237B,A00,894149,Staff,11,0,20,9
1746574519066,AESE 279B,A00,891859,Staff,13,0,35,22
1746574520094,AIP 197,001,891854,Vespa; Emanuel Ignacio,9999,0,9999,0
1746574521120,ANTH 289S,A00,891856,Gagneux; Pascal,12,0,12,0
1746574522149,BENG 196,001,957946,Engler; Adam J.,9996,0,9999,3
1746574523176,BISP 197,001,959851,Wilhelm; James E.,9998,0,9999,1
1746574524200,CAT 124RS,A01,956906,Staff,6,0,25,19
1746574525224,CAT 125RS,A01,922013,Staff,6,0,25,19
1746574526252,CLRE 250,A00,891860,Morris; Sheldon,9995,0,9999,4
1746574528306,CLRE 251R,A00,907817,Mehta; Ravindra L.,9994,0,9999,5
1746574529331,CLRE 252,A00,891864,Cuomo; Raphael Eduardo,9993,0,9999,6
1746574530356,CLRE 253,A00,891867,Vaida; Florin,9994,0,9999,5
1746574530356,CLRE 253,B00,907819,Staff,9999,0,9999,0
1746574531385,CLRE 259,A00,891868,Patel; Hemal,9998,0,9999,1
1746574532420,CLRE 260,A00,891872,Cuomo; Raphael Eduardo,9999,0,9999,0
1746574533444,CLRE 297,001,891888,Cuomo; Raphael Eduardo,9999,0,9999,0
1746574534472,CSE 191,A00,958773,Minnes Kemp; Mor Mia,9995,0,9999,4
1746574535498,CSE 197,001,959846,Minnes Kemp; Mor Mia,9990,0,9999,9
1746574536524,CSS 201S,A01,892054,Mignozzetti; Umberto,25,0,30,5
1746574537551,CSS 202S,A01,892056,Mignozzetti; Umberto,25,0,30,5
1746574538579,DSC 197,001,956898,Eldridge; Justin Matthew,9996,0,9999,3
1746574539606,DSC 297,001,958000,Mazumdar; Arya,9998,0,9999,1
1746574539606,DSC 297,002,959862,Wang; Yusu,9998,0,9999,1
1746574540634,EAP 100,A00,905686,Staff,9778,0,9999,221
1746574541663,ECE 45,A01,892618,Staff,0,0,65,65
1746574543718,ECE 111,A01,892719,Staff,5,0,65,60
1746574544747,ECE 197,001,957920,Mercier; Patrick Philip,9991,0,9999,8
1746574545772,ECON 178,A01,907814,Zhu; Ying,26,0,35,9
1746574546797,EDS 115,A00,895312,Staff,35,0,45,10
1746574547823,EDS 117,A01,895337,Staff,23,0,30,7
1746574548853,EDS 125,A00,895341,Jones; Gabrielle Anastasia,36,0,45,9
1746574549877,EDS 128A,A01,895459,Fargason; Sharon Gayle,44,0,45,1
1746574550903,EDS 128B,A01,895543,Pappas; Elizabeth,44,0,45,1
1746574551926,EDS 139,A00,897203,Pappas; Elizabeth,44,0,45,1
1746574551926,EDS 139,B00,897209,Fargason; Sharon Gayle,41,0,45,4
1746574552958,EDS 201,A00,895545,Staff,22,0,45,23
1746574553981,EDS 203,A01,895581,Halter; Christopher P.,22,0,45,23
1746574555009,EDS 204R,A01,895625,Heinzman; Erica M.,39,0,45,6
1746574555009,EDS 204R,B01,895693,Halter; Christopher P.,10,0,45,35
1746574556036,EDS 206R,A00,895694,Fargason; Sharon Gayle,1,0,30,29
1746574556036,EDS 206R,B00,895695,Choi; Bailey Miyeon,16,0,30,14
1746574557064,EDS 250,A00,895697,Hemans; Patricia Ann Benitez,22,0,45,23
1746574558089,EDS 281,A00,895701,Meyerott; Theresa Ann,1,0,15,14
1746574559119,EDS 284,A00,895736,Meyerott; Theresa Ann,1,0,15,14
1746574560145,EDS 286,A00,897210,Fine; Sarah,0,0,15,15
1746574561173,EDS 289C,A01,895770,Daly; Alan J.,1,0,15,14
1746574562203,EDS 290,A00,897211,Hofstetter; Carolyn,0,0,15,15
1746574563232,LIGM 5A,A00,896162,Fischer-Grunski; Eva K,12,0,20,8
1746574564259,LIGM 5B,A00,896260,Fischer-Grunski; Eva K,17,0,20,3
1746574565285,LIGM 5C,A00,896308,Fischer-Grunski; Eva K,18,0,20,2
1746574566314,LIIT 5AS,A00,896313,Carnelos; Chiara,18,0,20,2
1746574567337,LIIT 5BS,A00,896416,Carnelos; Chiara,20,0,20,0
1746574568361,LIIT 5CS,A00,896564,Carnelos; Chiara,20,0,20,0
1746574569391,LISP 5A,A00,896588,Munoz Sanchez; Alicia,2,0,20,18
1746574570415,LISP 5B,A00,896653,Munoz Sanchez; Alicia,7,0,20,13
1746574571445,LISP 5C,A00,896655,Munoz Sanchez; Alicia,0,1,20,20
1746574572474,MAE 197,001,957918,Kleissl; Jan,9996,0,9999,3
1746574572474,MAE 197,002,959806,Boechler; Nicholas Sebastia,9998,0,9999,1
1746574572474,MAE 197,003,959852,Mullin; Jennifer S,9998,0,9999,1
1746574573497,MATH 2,A01,957937,Staff,33,0,35,2
1746574574523,MATH 197,001,957876,Kedlaya; Kiran S.,9993,0,9999,6
1746574575552,MCWP 40,A00,892729,Duru; Nur,10,0,20,10
1746574575552,MCWP 40,B00,893304,Montejo; Carolina,14,0,20,6
1746574576580,MCWP 40R,A00,893757,Redela; Pamela Morgan,0,5,20,20
1746574577608,MCWP 50,A00,893758,Morshed; Michael James,0,0,20,20
1746574577608,MCWP 50,B00,893761,Bartulis; Jason Michael,17,0,20,3
1746574578660,MCWP 50R,A00,893766,Compas; Sean Matthew,0,1,20,20
1746574578660,MCWP 50R,B00,893769,Carter; Jennifer A,0,1,20,20
1746574578660,MCWP 50R,C00,893771,Krone; Jarret,0,3,20,20
1746574578660,MCWP 50R,D00,893772,Miller; Elizabeth Deen,0,0,20,20
1746574578660,MCWP 50R,E00,893775,Carter; Andrea L,0,1,20,20
1746574579685,MMW 11R,A01,892721,Herbst; Matthew,14,0,30,16
1746574579685,MMW 11R,A02,892722,Herbst; Matthew,0,0,0,3
1746574580711,MMW 12R,A01,892724,Herbst; Matthew,0,11,16,16
1746574580711,MMW 12R,A02,892725,Herbst; Matthew,0,10,16,16
1746574581739,MMW 13R,A01,892727,Staff,0,4,16,16
1746574581739,MMW 13R,A02,892728,Staff,0,4,16,16
1746574581739,MMW 13R,A03,958032,Staff,0,4,16,16
1746574581739,MMW 13R,A04,958033,Staff,0,4,16,16
1746574581739,MMW 13R,A05,958034,Staff,0,4,16,16
1746574582764,SIO 295LS,A00,894015,Staff,5,0,25,20
1746574583788,SIO 295S,A00,894020,Staff,5,0,25,20
1746574584823,SIOC 290S,B01,958918,Merrifield; Mark A,14,0,30,16
1746574585848,SIOC 291S,B01,958922,Gabriel; Corey John,14,0,30,16
1746574586874,SOCI 117,A01,895339,Staff,3,0,5,2
1746574587898,WES 237B,A00,894149,Staff,11,0,20,9
1746574589963,AESE 279B,A00,891859,Staff,13,0,35,22
1746574590990,AIP 197,001,891854,Vespa; Emanuel Ignacio,9999,0,9999,0
1746574592014,ANTH 289S,A00,891856,Gagneux; Pascal,12,0,12,0
1746574593038,BENG 196,001,957946,Engler; Adam J.,9996,0,9999,3
1746574594064,BISP 197,001,959851,Wilhelm; James E.,9998,0,9999,1
1746574595087,CAT 124RS,A01,956906,Staff,6,0,25,19
1746574596113,CAT 125RS,A01,922013,Staff,6,0,25,19
1746574597139,CLRE 250,A00,891860,Morris; Sheldon,9995,0,9999,4
1746574599190,CLRE 251R,A00,907817,Mehta; Ravindra L.,9994,0,9999,5
1746574600213,CLRE 252,A00,891864,Cuomo; Raphael Eduardo,9993,0,9999,6
1746574601240,CLRE 253,A00,891867,Vaida; Florin,9994,0,9999,5
1746574601240,CLRE 253,B00,907819,Staff,9999,0,9999,0
1746574602263,CLRE 259,A00,891868,Patel; Hemal,9998,0,9999,1
1746574603290,CLRE 260,A00,891872,Cuomo; Raphael Eduardo,9999,0,9999,0
1746574604314,CLRE 297,001,891888,Cuomo; Raphael Eduardo,9999,0,9999,0
1746574605339,CSE 191,A00,958773,Minnes Kemp; Mor Mia,9995,0,9999,4
1746574606363,CSE 197,001,959846,Minnes Kemp; Mor Mia,9990,0,9999,9
1746574607388,CSS 201S,A01,892054,Mignozzetti; Umberto,25,0,30,5
1746574608417,CSS 202S,A01,892056,Mignozzetti; Umberto,25,0,30,5
1746574609441,DSC 197,001,956898,Eldridge; Justin Matthew,9996,0,9999,3
1746574610467,DSC 297,001,958000,Mazumdar; Arya,9998,0,9999,1
1746574610467,DSC 297,002,959862,Wang; Yusu,9998,0,9999,1
1746574611495,EAP 100,A00,905686,Staff,9778,0,9999,221
1746574612521,ECE 45,A01,892618,Staff,0,0,65,65
1746574614573,ECE 111,A01,892719,Staff,5,0,65,60
1746574615600,ECE 197,001,957920,Mercier; Patrick Philip,9991,0,9999,8
1746574616626,ECON 178,A01,907814,Zhu; Ying,26,0,35,9
1746574617651,EDS 115,A00,895312,Staff,35,0,45,10
1746574618677,EDS 117,A01,895337,Staff,23,0,30,7
1746574619702,EDS 125,A00,895341,Jones; Gabrielle Anastasia,36,0,45,9
1746574620726,EDS 128A,A01,895459,Fargason; Sharon Gayle,44,0,45,1
1746574621752,EDS 128B,A01,895543,Pappas; Elizabeth,44,0,45,1
1746574622776,EDS 139,A00,897203,Pappas; Elizabeth,44,0,45,1
1746574622776,EDS 139,B00,897209,Fargason; Sharon Gayle,41,0,45,4
1746574623804,EDS 201,A00,895545,Staff,22,0,45,23
1746574624831,EDS 203,A01,895581,Halter; Christopher P.,22,0,45,23
1746574625861,EDS 204R,A01,895625,Heinzman; Erica M.,39,0,45,6
1746574625861,EDS 204R,B01,895693,Halter; Christopher P.,10,0,45,35
1746574626886,EDS 206R,A00,895694,Fargason; Sharon Gayle,1,0,30,29
1746574626886,EDS 206R,B00,895695,Choi; Bailey Miyeon,16,0,30,14
1746574627916,EDS 250,A00,895697,Hemans; Patricia Ann Benitez,22,0,45,23
1746574628959,EDS 281,A00,895701,Meyerott; Theresa Ann,1,0,15,14
1746574629986,EDS 284,A00,895736,Meyerott; Theresa Ann,1,0,15,14
1746574631014,EDS 286,A00,897210,Fine; Sarah,0,0,15,15
1746574632040,EDS 289C,A01,895770,Daly; Alan J.,1,0,15,14
1746574633067,EDS 290,A00,897211,Hofstetter; Carolyn,0,0,15,15
1746574634096,LIGM 5A,A00,896162,Fischer-Grunski; Eva K,12,0,20,8
1746574635124,LIGM 5B,A00,896260,Fischer-Grunski; Eva K,17,0,20,3
1746574636149,LIGM 5C,A00,896308,Fischer-Grunski; Eva K,18,0,20,2
1746574637180,LIIT 5AS,A00,896313,Carnelos; Chiara,18,0,20,2
1746574638211,LIIT 5BS,A00,896416,Carnelos; Chiara,20,0,20,0
1746574639239,LIIT 5CS,A00,896564,Carnelos; Chiara,20,0,20,0
1746574640265,LISP 5A,A00,896588,Munoz Sanchez; Alicia,2,0,20,18
1746574641295,LISP 5B,A00,896653,Munoz Sanchez; Alicia,7,0,20,13
1746574642321,LISP 5C,A00,896655,Munoz Sanchez; Alicia,0,1,20,20
1746574643349,MAE 197,001,957918,Kleissl; Jan,9996,0,9999,3
1746574643349,MAE 197,002,959806,Boechler; Nicholas Sebastia,9998,0,9999,1
1746574643349,MAE 197,003,959852,Mullin; Jennifer S,9998,0,9999,1
1746574644374,MATH 2,A01,957937,Staff,33,0,35,2
1746574645402,MATH 197,001,957876,Kedlaya; Kiran S.,9993,0,9999,6
1746574646431,MCWP 40,A00,892729,Duru; Nur,10,0,20,10
1746574646431,MCWP 40,B00,893304,Montejo; Carolina,14,0,20,6
1746574647456,MCWP 40R,A00,893757,Redela; Pamela Morgan,0,5,20,20
1746574648483,MCWP 50,A00,893758,Morshed; Michael James,0,0,20,20
1746574648483,MCWP 50,B00,893761,Bartulis; Jason Michael,17,0,20,3
1746574649507,MCWP 50R,A00,893766,Compas; Sean Matthew,0,1,20,20
1746574649507,MCWP 50R,B00,893769,Carter; Jennifer A,0,1,20,20
1746574649507,MCWP 50R,C00,893771,Krone; Jarret,0,3,20,20
1746574649507,MCWP 50R,D00,893772,Miller; Elizabeth Deen,0,0,20,20
1746574649507,MCWP 50R,E00,893775,Carter; Andrea L,0,1,20,20
1746574650533,MMW 11R,A01,892721,Herbst; Matthew,14,0,30,16
1746574650533,MMW 11R,A02,892722,Herbst; Matthew,0,0,0,3
1746574651561,MMW 12R,A01,892724,Herbst; Matthew,0,11,16,16
1746574651561,MMW 12R,A02,892725,Herbst; Matthew,0,10,16,16
1746574652587,MMW 13R,A01,892727,Staff,0,4,16,16
1746574652587,MMW 13R,A02,892728,Staff,0,4,16,16
1746574652587,MMW 13R,A03,958032,Staff,0,4,16,16
1746574652587,MMW 13R,A04,958033,Staff,0,4,16,16
1746574652587,MMW 13R,A05,958034,Staff,0,4,16,16
1746574653613,SIO 295LS,A00,894015,Staff,5,0,25,20
1746574654647,SIO 295S,A00,894020,Staff,5,0,25,20
1746574655673,SIOC 290S,B01,958918,Merrifield; Mark A,14,0,30,16
1746574656697,SIOC 291S,B01,958922,Gabriel; Corey John,14,0,30,16
1746574657722,SOCI 117,A01,895339,Staff,3,0,5,2
1746574658749,WES 237B,A00,894149,Staff,11,0,20,9
1746574660807,AESE 279B,A00,891859,Staff,13,0,35,22
1746574661835,AIP 197,001,891854,Vespa; Emanuel Ignacio,9999,0,9999,0
1746574662864,ANTH 289S,A00,891856,Gagneux; Pascal,12,0,12,0
1746574663888,BENG 196,001,957946,Engler; Adam J.,9996,0,9999,3
1746574664914,BISP 197,001,959851,Wilhelm; James E.,9998,0,9999,1
1746574665940,CAT 124RS,A01,956906,Staff,6,0,25,19
1746574666967,CAT 125RS,A01,922013,Staff,6,0,25,19
1746574667996,CLRE 250,A00,891860,Morris; Sheldon,9995,0,9999,4
1746574670056,CLRE 251R,A00,907817,Mehta; Ravindra L.,9994,0,9999,5
1746574671080,CLRE 252,A00,891864,Cuomo; Raphael Eduardo,9993,0,9999,6
1746574672105,CLRE 253,A00,891867,Vaida; Florin,9994,0,9999,5
1746574672105,CLRE 253,B00,907819,Staff,9999,0,9999,0
1746574673133,CLRE 259,A00,891868,Patel; Hemal,9998,0,9999,1
1746574674162,CLRE 260,A00,891872,Cuomo; Raphael Eduardo,9999,0,9999,0
1746574675191,CLRE 297,001,891888,Cuomo; Raphael Eduardo,9999,0,9999,0
1746574676219,CSE 191,A00,958773,Minnes Kemp; Mor Mia,9995,0,9999,4
1746574677245,CSE 197,001,959846,Minnes Kemp; Mor Mia,9990,0,9999,9
1746574678270,CSS 201S,A01,892054,Mignozzetti; Umberto,25,0,30,5
1746574679299,CSS 202S,A01,892056,Mignozzetti; Umberto,25,0,30,5
1746574680325,DSC 197,001,956898,Eldridge; Justin Matthew,9996,0,9999,3
1746574681348,DSC 297,001,958000,Mazumdar; Arya,9998,0,9999,1
1746574681348,DSC 297,002,959862,Wang; Yusu,9998,0,9999,1
1746574682377,EAP 100,A00,905686,Staff,9778,0,9999,221
1746574683403,ECE 45,A01,892618,Staff,0,0,65,65
1746574685470,ECE 111,A01,892719,Staff,5,0,65,60
1746574686496,ECE 197,001,957920,Mercier; Patrick Philip,9991,0,9999,8
1746574687528,ECON 178,A01,907814,Zhu; Ying,26,0,35,9
1746574688551,EDS 115,A00,895312,Staff,35,0,45,10
1746574689579,EDS 117,A01,895337,Staff,23,0,30,7
1746574690610,EDS 125,A00,895341,Jones; Gabrielle Anastasia,36,0,45,9
1746574691638,EDS 128A,A01,895459,Fargason; Sharon Gayle,44,0,45,1
1746574692663,EDS 128B,A01,895543,Pappas; Elizabeth,44,0,45,1
1746574693690,EDS 139,A00,897203,Pappas; Elizabeth,44,0,45,1
1746574693690,EDS 139,B00,897209,Fargason; Sharon Gayle,41,0,45,4
1746574694715,EDS 201,A00,895545,Staff,22,0,45,23
1746574695738,EDS 203,A01,895581,Halter; Christopher P.,22,0,45,23
1746574696764,EDS 204R,A01,895625,Heinzman; Erica M.,39,0,45,6
1746574696764,EDS 204R,B01,895693,Halter; Christopher P.,10,0,45,35
1746574697792,EDS 206R,A00,895694,Fargason; Sharon Gayle,1,0,30,29
1746574697792,EDS 206R,B00,895695,Choi; Bailey Miyeon,16,0,30,14
1746574698833,EDS 250,A00,895697,Hemans; Patricia Ann Benitez,22,0,45,23
1746574699858,EDS 281,A00,895701,Meyerott; Theresa Ann,1,0,15,14
1746574700882,EDS 284,A00,895736,Meyerott; Theresa Ann,1,0,15,14
1746574701909,EDS 286,A00,897210,Fine; Sarah,0,0,15,15
1746574702936,EDS 289C,A01,895770,Daly; Alan J.,1,0,15,14
1746574703962,EDS 290,A00,897211,Hofstetter; Carolyn,0,0,15,15
1746574704988,LIGM 5A,A00,896162,Fischer-Grunski; Eva K,12,0,20,8
1746574706013,LIGM 5B,A00,896260,Fischer-Grunski; Eva K,17,0,20,3
1746574707039,LIGM 5C,A00,896308,Fischer-Grunski; Eva K,18,0,20,2
1746574708064,LIIT 5AS,A00,896313,Carnelos; Chiara,18,0,20,2
1746574709092,LIIT 5BS,A00,896416,Carnelos; Chiara,20,0,20,0
1746574710119,LIIT 5CS,A00,896564,Carnelos; Chiara,20,0,20,0
1746574711148,LISP 5A,A00,896588,Munoz Sanchez; Alicia,2,0,20,18
1746574712173,LISP 5B,A00,896653,Munoz Sanchez; Alicia,7,0,20,13
1746574713198,LISP 5C,A00,896655,Munoz Sanchez; Alicia,0,1,20,20
1746574714222,MAE 197,001,957918,Kleissl; Jan,9996,0,9999,3
1746574714222,MAE 197,002,959806,Boechler; Nicholas Sebastia,9998,0,9999,1
1746574714222,MAE 197,003,959852,Mullin; Jennifer S,9998,0,9999,1
1746574715249,MATH 2,A01,957937,Staff,33,0,35,2
1746574716274,MATH 197,001,957876,Kedlaya; Kiran S.,9993,0,9999,6
1746574717298,MCWP 40,A00,892729,Duru; Nur,10,0,20,10
1746574717298,MCWP 40,B00,893304,Montejo; Carolina,14,0,20,6
1746574718326,MCWP 40R,A00,893757,Redela; Pamela Morgan,0,5,20,20
1746574719350,MCWP 50,A00,893758,Morshed; Michael James,0,0,20,20
1746574719350,MCWP 50,B00,893761,Bartulis; Jason Michael,17,0,20,3
1746574720378,MCWP 50R,A00,893766,Compas; Sean Matthew,0,1,20,20
1746574720378,MCWP 50R,B00,893769,Carter; Jennifer A,0,1,20,20
1746574720378,MCWP 50R,C00,893771,Krone; Jarret,0,3,20,20
1746574720378,MCWP 50R,D00,893772,Miller; Elizabeth Deen,0,0,20,20
1746574720378,MCWP 50R,E00,893775,Carter; Andrea L,0,1,20,20
1746574721409,MMW 11R,A01,892721,Herbst; Matthew,14,0,30,16
1746574721409,MMW 11R,A02,892722,Herbst; Matthew,0,0,0,3
1746574722433,MMW 12R,A01,892724,Herbst; Matthew,0,11,16,16
1746574722433,MMW 12R,A02,892725,Herbst; Matthew,0,10,16,16
1746574723457,MMW 13R,A01,892727,Staff,0,4,16,16
1746574723457,MMW 13R,A02,892728,Staff,0,4,16,16
1746574723457,MMW 13R,A03,958032,Staff,0,4,16,16
1746574723457,MMW 13R,A04,958033,Staff,0,4,16,16
1746574723457,MMW 13R,A05,958034,Staff,0,4,16,16
1746574724482,SIO 295LS,A00,894015,Staff,5,0,25,20
1746574725506,SIO 295S,A00,894020,Staff,5,0,25,20
1746574726536,SIOC 290S,B01,958918,Merrifield; Mark A,14,0,30,16
1746574727565,SIOC 291S,B01,958922,Gabriel; Corey John,14,0,30,16
1746574728588,SOCI 117,A01,895339,Staff,3,0,5,2
1746574729614,WES 237B,A00,894149,Staff,11,0,20,9
1746574731672,AESE 279B,A00,891859,Staff,13,0,35,22
1746574732698,AIP 197,001,891854,Vespa; Emanuel Ignacio,9999,0,9999,0
1746574733724,ANTH 289S,A00,891856,Gagneux; Pascal,12,0,12,0
1746574734754,BENG 196,001,957946,Engler; Adam J.,9996,0,9999,3
1746574735781,BISP 197,001,959851,Wilhelm; James E.,9998,0,9999,1
1746574736809,CAT 124RS,A01,956906,Staff,6,0,25,19
1746574737835,CAT 125RS,A01,922013,Staff,6,0,25,19
1746574738863,CLRE 250,A00,891860,Morris; Sheldon,9995,0,9999,4
1746574740915,CLRE 251R,A00,907817,Mehta; Ravindra L.,9994,0,9999,5
1746574741946,CLRE 252,A00,891864,Cuomo; Raphael Eduardo,9993,0,9999,6
1746574742970,CLRE 253,A00,891867,Vaida; Florin,9994,0,9999,5
1746574742970,CLRE 253,B00,907819,Staff,9999,0,9999,0
1746574743995,CLRE 259,A00,891868,Patel; Hemal,9998,0,9999,1
1746574745020,CLRE 260,A00,891872,Cuomo; Raphael Eduardo,9999,0,9999,0
1746574746047,CLRE 297,001,891888,Cuomo; Raphael Eduardo,9999,0,9999,0
1746574747071,CSE 191,A00,958773,Minnes Kemp; Mor Mia,9995,0,9999,4
1746574748100,CSE 197,001,959846,Minnes Kemp; Mor Mia,9990,0,9999,9
1746574749125,CSS 201S,A01,892054,Mignozzetti; Umberto,25,0,30,5
1746574750153,CSS 202S,A01,892056,Mignozzetti; Umberto,25,0,30,5
1746574751177,DSC 197,001,956898,Eldridge; Justin Matthew,9996,0,9999,3
1746574752202,DSC 297,001,958000,Mazumdar; Arya,9998,0,9999,1
1746574752202,DSC 297,002,959862,Wang; Yusu,9998,0,9999,1
1746574753226,EAP 100,A00,905686,Staff,9778,0,9999,221
1746574754253,ECE 45,A01,892618,Staff,0,0,65,65
1746574756305,ECE 111,A01,892719,Staff,5,0,65,60
1746574757330,ECE 197,001,957920,Mercier; Patrick Philip,9991,0,9999,8
1746574758354,ECON 178,A01,907814,Zhu; Ying,26,0,35,9
1746574759381,EDS 115,A00,895312,Staff,35,0,45,10
1746574760405,EDS 117,A01,895337,Staff,23,0,30,7
1746574761435,EDS 125,A00,895341,Jones; Gabrielle Anastasia,36,0,45,9
1746574762464,EDS 128A,A01,895459,Fargason; Sharon Gayle,44,0,45,1
1746574763494,EDS 128B,A01,895543,Pappas; Elizabeth,44,0,45,1
1746574764521,EDS 139,A00,897203,Pappas; Elizabeth,44,0,45,1
1746574764521,EDS 139,B00,897209,Fargason; Sharon Gayle,41,0,45,4
1746574765547,EDS 201,A00,895545,Staff,22,0,45,23
1746574766578,EDS 203,A01,895581,Halter; Christopher P.,22,0,45,23
1746574767602,EDS 204R,A01,895625,Heinzman; Erica M.,39,0,45,6
1746574767602,EDS 204R,B01,895693,Halter; Christopher P.,10,0,45,35
1746574768630,EDS 206R,A00,895694,Fargason; Sharon Gayle,1,0,30,29
1746574768630,EDS 206R,B00,895695,Choi; Bailey Miyeon,16,0,30,14
1746574769660,EDS 250,A00,895697,Hemans; Patricia Ann Benitez,22,0,45,23
1746574770688,EDS 281,A00,895701,Meyerott; Theresa Ann,1,0,15,14
1746574771714,EDS 284,A00,895736,Meyerott; Theresa Ann,1,0,15,14
1746574772738,EDS 286,A00,897210,Fine; Sarah,0,0,15,15
1746574773763,EDS 289C,A01,895770,Daly; Alan J.,1,0,15,14
1746574774789,EDS 290,A00,897211,Hofstetter; Carolyn,0,0,15,15
1746574775818,LIGM 5A,A00,896162,Fischer-Grunski; Eva K,12,0,20,8
1746574776848,LIGM 5B,A00,896260,Fischer-Grunski; Eva K,17,0,20,3
1746574777874,LIGM 5C,A00,896308,Fischer-Grunski; Eva K,18,0,20,2
1746574778902,LIIT 5AS,A00,896313,Carnelos; Chiara,18,0,20,2
1746574779928,LIIT 5BS,A00,896416,Carnelos; Chiara,20,0,20,0
1746574780953,LIIT 5CS,A00,896564,Carnelos; Chiara,20,0,20,0
1746574781979,LISP 5A,A00,896588,Munoz Sanchez; Alicia,2,0,20,18
1746574783004,LISP 5B,A00,896653,Munoz Sanchez; Alicia,7,0,20,13
1746574784033,LISP 5C,A00,896655,Munoz Sanchez; Alicia,0,1,20,20
1746574785059,MAE 197,001,957918,Kleissl; Jan,9996,0,9999,3
1746574785059,MAE 197,002,959806,Boechler; Nicholas Sebastia,9998,0,9999,1
1746574785059,MAE 197,003,959852,Mullin; Jennifer S,9998,0,9999,1
1746574786085,MATH 2,A01,957937,Staff,33,0,35,2
1746574787110,MATH 197,001,957876,Kedlaya; Kiran S.,9993,0,9999,6
1746574788135,MCWP 40,A00,892729,Duru; Nur,10,0,20,10
1746574788135,MCWP 40,B00,893304,Montejo; Carolina,14,0,20,6
1746574789163,MCWP 40R,A00,893757,Redela; Pamela Morgan,0,5,20,20
1746574790189,MCWP 50,A00,893758,Morshed; Michael James,0,0,20,20
1746574790189,MCWP 50,B00,893761,Bartulis; Jason Michael,17,0,20,3
1746574791218,MCWP 50R,A00,893766,Compas; Sean Matthew,0,1,20,20
1746574791218,MCWP 50R,B00,893769,Carter; Jennifer A,0,1,20,20
1746574791218,MCWP 50R,C00,893771,Krone; Jarret,0,3,20,20
1746574791218,MCWP 50R,D00,893772,Miller; Elizabeth Deen,0,0,20,20
1746574791218,MCWP 50R,E00,893775,Carter; Andrea L,0,1,20,20
1746574792246,MMW 11R,A01,892721,Herbst; Matthew,14,0,30,16
1746574792246,MMW 11R,A02,892722,Herbst; Matthew,0,0,0,3
1746574793274,MMW 12R,A01,892724,Herbst; Matthew,0,11,16,16
1746574793274,MMW 12R,A02,892725,Herbst; Matthew,0,10,16,16
1746574794302,MMW 13R,A01,892727,Staff,0,4,16,16
1746574794302,MMW 13R,A02,892728,Staff,0,4,16,16
1746574794302,MMW 13R,A03,958032,Staff,0,4,16,16
1746574794302,MMW 13R,A04,958033,Staff,0,4,16,16
1746574794302,MMW 13R,A05,958034,Staff,0,4,16,16
1746574795328,SIO 295LS,A00,894015,Staff,5,0,25,20
1746574796355,SIO 295S,A00,894020,Staff,5,0,25,20
1746574797384,SIOC 290S,B01,958918,Merrifield; Mark A,14,0,30,16
1746574798415,SIOC 291S,B01,958922,Gabriel; Corey John,14,0,30,16
1746574799442,SOCI 117,A01,895339,Staff,3,0,5,2
1746574800467,WES 237B,A00,894149,Staff,11,0,20,9
1746574802530,AESE 279B,A00,891859,Staff,13,0,35,22
1746574803558,AIP 197,001,891854,Vespa; Emanuel Ignacio,9999,0,9999,0
1746574804595,ANTH 289S,A00,891856,Gagneux; Pascal,12,0,12,0
1746574805624,BENG 196,001,957946,Engler; Adam J.,9996,0,9999,3
1746574806653,BISP 197,001,959851,Wilhelm; James E.,9998,0,9999,1
1746574807681,CAT 124RS,A01,956906,Staff,6,0,25,19
1746574808705,CAT 125RS,A01,922013,Staff,6,0,25,19
1746574809732,CLRE 250,A00,891860,Morris; Sheldon,9995,0,9999,4
1746574811787,CLRE 251R,A00,907817,Mehta; Ravindra L.,9994,0,9999,5
1746574812811,CLRE 252,A00,891864,Cuomo; Raphael Eduardo,9993,0,9999,6
1746574813836,CLRE 253,A00,891867,Vaida; Florin,9994,0,9999,5
1746574813836,CLRE 253,B00,907819,Staff,9999,0,9999,0
1746574814862,CLRE 259,A00,891868,Patel; Hemal,9998,0,9999,1
1746574815890,CLRE 260,A00,891872,Cuomo; Raphael Eduardo,9999,0,9999,0
1746574816921,CLRE 297,001,891888,Cuomo; Raphael Eduardo,9999,0,9999,0
1746574817950,CSE 191,A00,958773,Minnes Kemp; Mor Mia,9995,0,9999,4
1746574818974,CSE 197,001,959846,Minnes Kemp; Mor Mia,9990,0,9999,9
1746574820002,CSS 201S,A01,892054,Mignozzetti; Umberto,25,0,30,5
1746574821030,CSS 202S,A01,892056,Mignozzetti; Umberto,25,0,30,5
1746574822057,DSC 197,001,956898,Eldridge; Justin Matthew,9996,0,9999,3
1746574823088,DSC 297,001,958000,Mazumdar; Arya,9998,0,9999,1
1746574823088,DSC 297,002,959862,Wang; Yusu,9998,0,9999,1
1746574824115,EAP 100,A00,905686,Staff,9778,0,9999,221
1746574825139,ECE 45,A01,892618,Staff,0,0,65,65
1746574827196,ECE 111,A01,892719,Staff,5,0,65,60
1746574828227,ECE 197,001,957920,Mercier; Patrick Philip,9991,0,9999,8
1746574829251,ECON 178,A01,907814,Zhu; Ying,26,0,35,9
1746574830279,EDS 115,A00,895312,Staff,35,0,45,10
1746574831308,EDS 117,A01,895337,Staff,23,0,30,7
1746574832337,EDS 125,A00,895341,Jones; Gabrielle Anastasia,36,0,45,9
1746574833362,EDS 128A,A01,895459,Fargason; Sharon Gayle,44,0,45,1
1746574834387,EDS 128B,A01,895543,Pappas; Elizabeth,44,0,45,1
1746574835412,EDS 139,A00,897203,Pappas; Elizabeth,44,0,45,1
1746574835412,EDS 139,B00,897209,Fargason; Sharon Gayle,41,0,45,4
1746574836440,EDS 201,A00,895545,Staff,22,0,45,23
1746574837464,EDS 203,A01,895581,Halter; Christopher P.,22,0,45,23
1746574838492,EDS 204R,A01,895625,Heinzman; Erica M.,39,0,45,6
1746574838492,EDS 204R,B01,895693,Halter; Christopher P.,10,0,45,35
1746574839516,EDS 206R,A00,895694,Fargason; Sharon Gayle,1,0,30,29
1746574839516,EDS 206R,B00,895695,Choi; Bailey Miyeon,16,0,30,14
1746574840541,EDS 250,A00,895697,Hemans; Patricia Ann Benitez,22,0,45,23
1746574841566,EDS 281,A00,895701,Meyerott; Theresa Ann,1,0,15,14
1746574842590,EDS 284,A00,895736,Meyerott; Theresa Ann,1,0,15,14
1746574843615,EDS 286,A00,897210,Fine; Sarah,0,0,15,15
1746574844642,EDS 289C,A01,895770,Daly; Alan J.,1,0,15,14
1746574845669,EDS 290,A00,897211,Hofstetter; Carolyn,0,0,15,15
1746574846697,LIGM 5A,A00,896162,Fischer-Grunski; Eva K,12,0,20,8
1746574847725,LIGM 5B,A00,896260,Fischer-Grunski; Eva K,17,0,20,3
1746574848750,LIGM 5C,A00,896308,Fischer-Grunski; Eva K,18,0,20,2
1746574849779,LIIT 5AS,A00,896313,Carnelos; Chiara,18,0,20,2
1746574850805,LIIT 5BS,A00,896416,Carnelos; Chiara,20,0,20,0
1746574851831,LIIT 5CS,A00,896564,Carnelos; Chiara,20,0,20,0
1746574852862,LISP 5A,A00,896588,Munoz Sanchez; Alicia,2,0,20,18
1746574853891,LISP 5B,A00,896653,Munoz Sanchez; Alicia,7,0,20,13
1746574854915,LISP 5C,A00,896655,Munoz Sanchez; Alicia,0,1,20,20
1746574855941,MAE 197,001,957918,Kleissl; Jan,9996,0,9999,3
1746574855941,MAE 197,002,959806,Boechler; Nicholas Sebastia,9998,0,9999,1
1746574855941,MAE 197,003,959852,Mullin; Jennifer S,9998,0,9999,1
1746574856969,MATH 2,A01,957937,Staff,33,0,35,2
1746574857998,MATH 197,001,957876,Kedlaya; Kiran S.,9993,0,9999,6
1746574859024,MCWP 40,A00,892729,Duru; Nur,10,0,20,10
1746574859024,MCWP 40,B00,893304,Montejo; Carolina,14,0,20,6
1746574860053,MCWP 40R,A00,893757,Redela; Pamela Morgan,0,5,20,20
1746574861079,MCWP 50,A00,893758,Morshed; Michael James,0,0,20,20
1746574861079,MCWP 50,B00,893761,Bartulis; Jason Michael,17,0,20,3
1746574862119,MCWP 50R,A00,893766,Compas; Sean Matthew,0,1,20,20
1746574862119,MCWP 50R,B00,893769,Carter; Jennifer A,0,1,20,20
1746574862119,MCWP 50R,C00,893771,Krone; Jarret,0,3,20,20
1746574862119,MCWP 50R,D00,893772,Miller; Elizabeth Deen,0,0,20,20
1746574862119,MCWP 50R,E00,893775,Carter; Andrea L,0,1,20,20
1746574863144,MMW 11R,A01,892721,Herbst; Matthew,14,0,30,16
1746574863144,MMW 11R,A02,892722,Herbst; Matthew,0,0,0,3
1746574864173,MMW 12R,A01,892724,Herbst; Matthew,0,11,16,16
1746574864173,MMW 12R,A02,892725,Herbst; Matthew,0,10,16,16
1746574865203,MMW 13R,A01,892727,Staff,0,4,16,16
1746574865203,MMW 13R,A02,892728,Staff,0,4,16,16
1746574865203,MMW 13R,A03,958032,Staff,0,4,16,16
1746574865203,MMW 13R,A04,958033,Staff,0,4,16,16
1746574865203,MMW 13R,A05,958034,Staff,0,4,16,16
1746574866232,SIO 295LS,A00,894015,Staff,5,0,25,20
1746574867259,SIO 295S,A00,894020,Staff,5,0,25,20
1746574868283,SIOC 290S,B01,958918,Merrifield; Mark A,14,0,30,16
1746574869310,SIOC 291S,B01,958922,Gabriel; Corey John,14,0,30,16
1746574870334,SOCI 117,A01,895339,Staff,3,0,5,2
1746574871360,WES 237B,A00,894149,Staff,11,0,20,9
1746574873414,AESE 279B,A00,891859,Staff,13,0,35,22
1746574874439,AIP 197,001,891854,Vespa; Emanuel Ignacio,9999,0,9999,0
1746574875466,ANTH 289S,A00,891856,Gagneux; Pascal,12,0,12,0
1746574876493,BENG 196,001,957946,Engler; Adam J.,9996,0,9999,3
1746574877519,BISP 197,001,959851,Wilhelm; James E.,9998,0,9999,1
1746574878545,CAT 124RS,A01,956906,Staff,6,0,25,19
1746574879572,CAT 125RS,A01,922013,Staff,6,0,25,19
1746574880599,CLRE 250,A00,891860,Morris; Sheldon,9995,0,9999,4
1746574882651,CLRE 251R,A00,907817,Mehta; Ravindra L.,9994,0,9999,5
1746574883677,CLRE 252,A00,891864,Cuomo; Raphael Eduardo,9993,0,9999,6
1746574884702,CLRE 253,A00,891867,Vaida; Florin,9994,0,9999,5
1746574884702,CLRE 253,B00,907819,Staff,9999,0,9999,0
1746574885759,CLRE 259,A00,891868,Patel; Hemal,9998,0,9999,1
1746574886785,CLRE 260,A00,891872,Cuomo; Raphael Eduardo,9999,0,9999,0
1746574887814,CLRE 297,001,891888,Cuomo; Raphael Eduardo,9999,0,9999,0
1746574888840,CSE 191,A00,958773,Minnes Kemp; Mor Mia,9995,0,9999,4
1746574889867,CSE 197,001,959846,Minnes Kemp; Mor Mia,9990,0,9999,9
1746574890897,CSS 201S,A01,892054,Mignozzetti; Umberto,25,0,30,5
1746574891936,CSS 202S,A01,892056,Mignozzetti; Umberto,25,0,30,5
1746574892960,DSC 197,001,956898,Eldridge; Justin Matthew,9996,0,9999,3
1746574893985,DSC 297,001,958000,Mazumdar; Arya,9998,0,9999,1
1746574893985,DSC 297,002,959862,Wang; Yusu,9998,0,9999,1
1746574895028,EAP 100,A00,905686,Staff,9778,0,9999,221
1746574896121,ECE 45,A01,892618,Staff,0,0,65,65
1746574898177,ECE 111,A01,892719,Staff,5,0,65,60
1746574899202,ECE 197,001,957920,Mercier; Patrick Philip,9991,0,9999,8
1746574900233,ECON 178,A01,907814,Zhu; Ying,26,0,35,9
1746574901260,EDS 115,A00,895312,Staff,35,0,45,10
1746574902289,EDS 117,A01,895337,Staff,23,0,30,7
1746574903318,EDS 125,A00,895341,Jones; Gabrielle Anastasia,36,0,45,9
1746574904346,EDS 128A,A01,895459,Fargason; Sharon Gayle,44,0,45,1
1746574905375,EDS 128B,A01,895543,Pappas; Elizabeth,44,0,45,1
1746574906401,EDS 139,A00,897203,Pappas; Elizabeth,44,0,45,1
1746574906401,EDS 139,B00,897209,Fargason; Sharon Gayle,41,0,45,4
1746574907427,EDS 201,A00,895545,Staff,22,0,45,23
1746574908454,EDS 203,A01,895581,Halter; Christopher P.,22,0,45,23
1746574909478,EDS 204R,A01,895625,Heinzman; Erica M.,39,0,45,6
1746574909478,EDS 204R,B01,895693,Halter; Christopher P.,10,0,45,35
1746574910505,EDS 206R,A00,895694,Fargason; Sharon Gayle,1,0,30,29
1746574910505,EDS 206R,B00,895695,Choi; Bailey Miyeon,16,0,30,14
1746574911531,EDS 250,A00,895697,Hemans; Patricia Ann Benitez,22,0,45,23
1746574912556,EDS 281,A00,895701,Meyerott; Theresa Ann,1,0,15,14
1746574913583,EDS 284,A00,895736,Meyerott; Theresa Ann,1,0,15,14
1746574914608,EDS 286,A00,897210,Fine; Sarah,0,0,15,15
1746574915635,EDS 289C,A01,895770,Daly; Alan J.,1,0,15,14
1746574916664,EDS 290,A00,897211,Hofstetter; Carolyn,0,0,15,15
1746574917693,LIGM 5A,A00,896162,Fischer-Grunski; Eva K,12,0,20,8
1746574918723,LIGM 5B,A00,896260,Fischer-Grunski; Eva K,17,0,20,3
1746574919747,LIGM 5C,A00,896308,Fischer-Grunski; Eva K,18,0,20,2
1746574920774,LIIT 5AS,A00,896313,Carnelos; Chiara,18,0,20,2
1746574921798,LIIT 5BS,A00,896416,Carnelos; Chiara,20,0,20,0
1746574922823,LIIT 5CS,A00,896564,Carnelos; Chiara,20,0,20,0
1746574923856,LISP 5A,A00,896588,Munoz Sanchez; Alicia,2,0,20,18
1746574924884,LISP 5B,A00,896653,Munoz Sanchez; Alicia,7,0,20,13
1746574925909,LISP 5C,A00,896655,Munoz Sanchez; Alicia,0,1,20,20
1746574926935,MAE 197,001,957918,Kleissl; Jan,9996,0,9999,3
1746574926935,MAE 197,002,959806,Boechler; Nicholas Sebastia,9998,0,9999,1
1746574926935,MAE 197,003,959852,Mullin; Jennifer S,9998,0,9999,1
1746574927960,MATH 2,A01,957937,Staff,33,0,35,2
1746574928989,MATH 197,001,957876,Kedlaya; Kiran S.,9993,0,9999,6
1746574930016,MCWP 40,A00,892729,Duru; Nur,10,0,20,10
1746574930016,MCWP 40,B00,893304,Montejo; Carolina,14,0,20,6
1746574931045,MCWP 40R,A00,893757,Redela; Pamela Morgan,0,5,20,20
1746574932073,MCWP 50,A00,893758,Morshed; Michael James,0,0,20,20
1746574932073,MCWP 50,B00,893761,Bartulis; Jason Michael,17,0,20,3
1746574933102,MCWP 50R,A00,893766,Compas; Sean Matthew,0,1,20,20
1746574933102,MCWP 50R,B00,893769,Carter; Jennifer A,0,1,20,20
1746574933102,MCWP 50R,C00,893771,Krone; Jarret,0,3,20,20
1746574933102,MCWP 50R,D00,893772,Miller; Elizabeth Deen,0,0,20,20
1746574933102,MCWP 50R,E00,893775,Carter; Andrea L,0,1,20,20
1746574934128,MMW 11R,A01,892721,Herbst; Matthew,14,0,30,16
1746574934128,MMW 11R,A02,892722,Herbst; Matthew,0,0,0,3
1746574935151,MMW 12R,A01,892724,Herbst; Matthew,0,11,16,16
1746574935151,MMW 12R,A02,892725,Herbst; Matthew,0,10,16,16
1746574936178,MMW 13R,A01,892727,Staff,0,4,16,16
1746574936178,MMW 13R,A02,892728,Staff,0,4,16,16
1746574936178,MMW 13R,A03,958032,Staff,0,4,16,16
1746574936178,MMW 13R,A04,958033,Staff,0,4,16,16
1746574936178,MMW 13R,A05,958034,Staff,0,4,16,16
1746574937203,SIO 295LS,A00,894015,Staff,5,0,25,20
1746574938228,SIO 295S,A00,894020,Staff,5,0,25,20
1746574939256,SIOC 290S,B01,958918,Merrifield; Mark A,14,0,30,16
1746574940282,SIOC 291S,B01,958922,Gabriel; Corey John,14,0,30,16
1746574941306,SOCI 117,A01,895339,Staff,3,0,5,2
1746574942333,WES 237B,A00,894149,Staff,11,0,20,9
1746574944401,AESE 279B,A00,891859,Staff,13,0,35,22
1746574945425,AIP 197,001,891854,Vespa; Emanuel Ignacio,9999,0,9999,0
1746574946453,ANTH 289S,A00,891856,Gagneux; Pascal,12,0,12,0
1746574947478,BENG 196,001,957946,Engler; Adam J.,9996,0,9999,3
1746574948501,BISP 197,001,959851,Wilhelm; James E.,9998,0,9999,1
1746574949525,CAT 124RS,A01,956906,Staff,6,0,25,19
1746574950550,CAT 125RS,A01,922013,Staff,6,0,25,19
1746574951577,CLRE 250,A00,891860,Morris; Sheldon,9995,0,9999,4
1746574953626,CLRE 251R,A00,907817,Mehta; Ravindra L.,9994,0,9999,5
1746574954653,CLRE 252,A00,891864,Cuomo; Raphael Eduardo,9993,0,9999,6
1746574955676,CLRE 253,A00,891867,Vaida; Florin,9994,0,9999,5
1746574955676,CLRE 253,B00,907819,Staff,9999,0,9999,0
1746574956700,CLRE 259,A00,891868,Patel; Hemal,9998,0,9999,1
1746574957724,CLRE 260,A00,891872,Cuomo; Raphael Eduardo,9999,0,9999,0
1746574958747,CLRE 297,001,891888,Cuomo; Raphael Eduardo,9999,0,9999,0
1746574959773,CSE 191,A00,958773,Minnes Kemp; Mor Mia,9995,0,9999,4
1746574960798,CSE 197,001,959846,Minnes Kemp; Mor Mia,9990,0,9999,9
1746574961823,CSS 201S,A01,892054,Mignozzetti; Umberto,25,0,30,5
1746574962857,CSS 202S,A01,892056,Mignozzetti; Umberto,25,0,30,5
1746574963880,DSC 197,001,956898,Eldridge; Justin Matthew,9996,0,9999,3
1746574964906,DSC 297,001,958000,Mazumdar; Arya,9998,0,9999,1
1746574964906,DSC 297,002,959862,Wang; Yusu,9998,0,9999,1
1746574965933,EAP 100,A00,905686,Staff,9778,0,9999,221
1746574966959,ECE 45,A01,892618,Staff,0,0,65,65
1746574969009,ECE 111,A01,892719,Staff,5,0,65,60
1746574970041,ECE 197,001,957920,Mercier; Patrick Philip,9991,0,9999,8
1746574971067,ECON 178,A01,907814,Zhu; Ying,26,0,35,9
1746574972092,EDS 115,A00,895312,Staff,35,0,45,10
1746574973121,EDS 117,A01,895337,Staff,23,0,30,7
1746574974147,EDS 125,A00,895341,Jones; Gabrielle Anastasia,36,0,45,9
1746574975170,EDS 128A,A01,895459,Fargason; Sharon Gayle,44,0,45,1
1746574976195,EDS 128B,A01,895543,Pappas; Elizabeth,44,0,45,1
1746574977221,EDS 139,A00,897203,Pappas; Elizabeth,44,0,45,1
1746574977221,EDS 139,B00,897209,Fargason; Sharon Gayle,41,0,45,4
1746574978245,EDS 201,A00,895545,Staff,22,0,45,23
1746574979270,EDS 203,A01,895581,Halter; Christopher P.,22,0,45,23
1746574980294,EDS 204R,A01,895625,Heinzman; Erica M.,39,0,45,6
1746574980294,EDS 204R,B01,895693,Halter; Christopher P.,10,0,45,35
1746574981318,EDS 206R,A00,895694,Fargason; Sharon Gayle,1,0,30,29
1746574981318,EDS 206R,B00,895695,Choi; Bailey Miyeon,16,0,30,14
1746574982342,EDS 250,A00,895697,Hemans; Patricia Ann Benitez,22,0,45,23
1746574983368,EDS 281,A00,895701,Meyerott; Theresa Ann,1,0,15,14
1746574984392,EDS 284,A00,895736,Meyerott; Theresa Ann,1,0,15,14
1746574985419,EDS 286,A00,897210,Fine; Sarah,0,0,15,15
1746574986443,EDS 289C,A01,895770,Daly; Alan J.,1,0,15,14
1746574987470,EDS 290,A00,897211,Hofstetter; Carolyn,0,0,15,15
1746574988497,LIGM 5A,A00,896162,Fischer-Grunski; Eva K,12,0,20,8
1746574989522,LIGM 5B,A00,896260,Fischer-Grunski; Eva K,17,0,20,3
1746574990548,LIGM 5C,A00,896308,Fischer-Grunski; Eva K,18,0,20,2
1746574991577,LIIT 5AS,A00,896313,Carnelos; Chiara,18,0,20,2
1746574992601,LIIT 5BS,A00,896416,Carnelos; Chiara,20,0,20,0
1746574993627,LIIT 5CS,A00,896564,Carnelos; Chiara,20,0,20,0
1746574994652,LISP 5A,A00,896588,Munoz Sanchez; Alicia,2,0,20,18
1746574995675,LISP 5B,A00,896653,Munoz Sanchez; Alicia,7,0,20,13
1746574996700,LISP 5C,A00,896655,Munoz Sanchez; Alicia,0,1,20,20
1746574997726,MAE 197,001,957918,Kleissl; Jan,9996,0,9999,3
1746574997726,MAE 197,002,959806,Boechler; Nicholas Sebastia,9998,0,9999,1
1746574997726,MAE 197,003,959852,Mullin; Jennifer S,9998,0,9999,1
1746574998752,MATH 2,A01,957937,Staff,33,0,35,2
1746574999776,MATH 197,001,957876,Kedlaya; Kiran S.,9993,0,9999,6
1746575000802,MCWP 40,A00,892729,Duru; Nur,10,0,20,10
1746575000802,MCWP 40,B00,893304,Montejo; Carolina,14,0,20,6
1746575001829,MCWP 40R,A00,893757,Redela; Pamela Morgan,0,5,20,20
1746575002857,MCWP 50,A00,893758,Morshed; Michael James,0,0,20,20
1746575002857,MCWP 50,B00,893761,Bartulis; Jason Michael,17,0,20,3
1746575003883,MCWP 50R,A00,893766,Compas; Sean Matthew,0,1,20,20
1746575003883,MCWP 50R,B00,893769,Carter; Jennifer A,0,1,20,20
1746575003883,MCWP 50R,C00,893771,Krone; Jarret,0,3,20,20
1746575003883,MCWP 50R,D00,893772,Miller; Elizabeth Deen,0,0,20,20
1746575003883,MCWP 50R,E00,893775,Carter; Andrea L,0,1,20,20
1746575004911,MMW 11R,A01,892721,Herbst; Matthew,14,0,30,16
1746575004911,MMW 11R,A02,892722,Herbst; Matthew,0,0,0,3
1746575005940,MMW 12R,A01,892724,Herbst; Matthew,0,11,16,16
1746575005940,MMW 12R,A02,892725,Herbst; Matthew,0,10,16,16
1746575006966,MMW 13R,A01,892727,Staff,0,4,16,16
1746575006966,MMW 13R,A02,892728,Staff,0,4,16,16
1746575006966,MMW 13R,A03,958032,Staff,0,4,16,16
1746575006966,MMW 13R,A04,958033,Staff,0,4,16,16
1746575006966,MMW 13R,A05,958034,Staff,0,4,16,16
1746575007992,SIO 295LS,A00,894015,Staff,5,0,25,20
1746575009023,SIO 295S,A00,894020,Staff,5,0,25,20
1746575010053,SIOC 290S,B01,958918,Merrifield; Mark A,14,0,30,16
1746575011084,SIOC 291S,B01,958922,Gabriel; Corey John,14,0,30,16
1746575012109,SOCI 117,A01,895339,Staff,3,0,5,2
1746575013133,WES 237B,A00,894149,Staff,11,0,20,9
1746575015199,AESE 279B,A00,891859,Staff,13,0,35,22
1746575016226,AIP 197,001,891854,Vespa; Emanuel Ignacio,9999,0,9999,0
1746575017251,ANTH 289S,A00,891856,Gagneux; Pascal,12,0,12,0
1746575018280,BENG 196,001,957946,Engler; Adam J.,9996,0,9999,3
1746575019304,BISP 197,001,959851,Wilhelm; James E.,9998,0,9999,1
1746575020331,CAT 124RS,A01,956906,Staff,6,0,25,19
1746575021356,CAT 125RS,A01,922013,Staff,6,0,25,19
1746575022381,CLRE 250,A00,891860,Morris; Sheldon,9995,0,9999,4
1746575024433,CLRE 251R,A00,907817,Mehta; Ravindra L.,9994,0,9999,5
1746575025458,CLRE 252,A00,891864,Cuomo; Raphael Eduardo,9993,0,9999,6
1746575026483,CLRE 253,A00,891867,Vaida; Florin,9994,0,9999,5
1746575026483,CLRE 253,B00,907819,Staff,9999,0,9999,0
1746575027509,CLRE 259,A00,891868,Patel; Hemal,9998,0,9999,1
1746575028537,CLRE 260,A00,891872,Cuomo; Raphael Eduardo,9999,0,9999,0
1746575029561,CLRE 297,001,891888,Cuomo; Raphael Eduardo,9999,0,9999,0
1746575030588,CSE 191,A00,958773,Minnes Kemp; Mor Mia,9995,0,9999,4
1746575031614,CSE 197,001,959846,Minnes Kemp; Mor Mia,9990,0,9999,9
1746575032640,CSS 201S,A01,892054,Mignozzetti; Umberto,25,0,30,5
1746575033665,CSS 202S,A01,892056,Mignozzetti; Umberto,25,0,30,5
1746575034691,DSC 197,001,956898,Eldridge; Justin Matthew,9996,0,9999,3
1746575035720,DSC 297,001,958000,Mazumdar; Arya,9998,0,9999,1
1746575035720,DSC 297,002,959862,Wang; Yusu,9998,0,9999,1
1746575036745,EAP 100,A00,905686,Staff,9778,0,9999,221
1746575037775,ECE 45,A01,892618,Staff,0,0,65,65
1746575039823,ECE 111,A01,892719,Staff,5,0,65,60
1746575040848,ECE 197,001,957920,Mercier; Patrick Philip,9991,0,9999,8
1746575041877,ECON 178,A01,907814,Zhu; Ying,26,0,35,9
1746575042903,EDS 115,A00,895312,Staff,35,0,45,10
1746575043931,EDS 117,A01,895337,Staff,23,0,30,7
1746575044974,EDS 125,A00,895341,Jones; Gabrielle Anastasia,36,0,45,9
1746575045998,EDS 128A,A01,895459,Fargason; Sharon Gayle,44,0,45,1
1746575047022,EDS 128B,A01,895543,Pappas; Elizabeth,44,0,45,1
1746575048050,EDS 139,A00,897203,Pappas; Elizabeth,44,0,45,1
1746575048050,EDS 139,B00,897209,Fargason; Sharon Gayle,41,0,45,4
1746575049074,EDS 201,A00,895545,Staff,22,0,45,23
1746575050099,EDS 203,A01,895581,Halter; Christopher P.,22,0,45,23
1746575051128,EDS 204R,A01,895625,Heinzman; Erica M.,39,0,45,6
1746575051128,EDS 204R,B01,895693,Halter; Christopher P.,10,0,45,35
1746575052153,EDS 206R,A00,895694,Fargason; Sharon Gayle,1,0,30,29
1746575052153,EDS 206R,B00,895695,Choi; Bailey Miyeon,16,0,30,14
1746575053180,EDS 250,A00,895697,Hemans; Patricia Ann Benitez,22,0,45,23
1746575054204,EDS 281,A00,895701,Meyerott; Theresa Ann,1,0,15,14
1746575055228,EDS 284,A00,895736,Meyerott; Theresa Ann,1,0,15,14
1746575056253,EDS 286,A00,897210,Fine; Sarah,0,0,15,15
1746575057278,EDS 289C,A01,895770,Daly; Alan J.,1,0,15,14
1746575058302,EDS 290,A00,897211,Hofstetter; Carolyn,0,0,15,15
1746575059327,LIGM 5A,A00,896162,Fischer-Grunski; Eva K,12,0,20,8
1746575060354,LIGM 5B,A00,896260,Fischer-Grunski; Eva K,17,0,20,3
1746575061382,LIGM 5C,A00,896308,Fischer-Grunski; Eva K,18,0,20,2
1746575062410,LIIT 5AS,A00,896313,Carnelos; Chiara,18,0,20,2
1746575063434,LIIT 5BS,A00,896416,Carnelos; Chiara,20,0,20,0
1746575064463,LIIT 5CS,A00,896564,Carnelos; Chiara,20,0,20,0
1746575065488,LISP 5A,A00,896588,Munoz Sanchez; Alicia,2,0,20,18
1746575066513,LISP 5B,A00,896653,Munoz Sanchez; Alicia,7,0,20,13
1746575067537,LISP 5C,A00,896655,Munoz Sanchez; Alicia,0,1,20,20
1746575068564,MAE 197,001,957918,Kleissl; Jan,9996,0,9999,3
1746575068564,MAE 197,002,959806,Boechler; Nicholas Sebastia,9998,0,9999,1
1746575068564,MAE 197,003,959852,Mullin; Jennifer S,9998,0,9999,1
1746575069591,MATH 2,A01,957937,Staff,33,0,35,2
1746575070617,MATH 197,001,957876,Kedlaya; Kiran S.,9993,0,9999,6
1746575071645,MCWP 40,A00,892729,Duru; Nur,10,0,20,10
1746575071645,MCWP 40,B00,893304,Montejo; Carolina,14,0,20,6
1746575072674,MCWP 40R,A00,893757,Redela; Pamela Morgan,0,5,20,20
1746575073703,MCWP 50,A00,893758,Morshed; Michael James,0,0,20,20
1746575073703,MCWP 50,B00,893761,Bartulis; Jason Michael,17,0,20,3
1746575074729,MCWP 50R,A00,893766,Compas; Sean Matthew,0,1,20,20
1746575074729,MCWP 50R,B00,893769,Carter; Jennifer A,0,1,20,20
1746575074729,MCWP 50R,C00,893771,Krone; Jarret,0,3,20,20
1746575074729,MCWP 50R,D00,893772,Miller; Elizabeth Deen,0,0,20,20
1746575074729,MCWP 50R,E00,893775,Carter; Andrea L,0,1,20,20
1746575075754,MMW 11R,A01,892721,Herbst; Matthew,14,0,30,16
1746575075754,MMW 11R,A02,892722,Herbst; Matthew,0,0,0,3
1746575076782,MMW 12R,A01,892724,Herbst; Matthew,0,11,16,16
1746575076782,MMW 12R,A02,892725,Herbst; Matthew,0,10,16,16
1746575077808,MMW 13R,A01,892727,Staff,0,4,16,16
1746575077808,MMW 13R,A02,892728,Staff,0,4,16,16
1746575077808,MMW 13R,A03,958032,Staff,0,4,16,16
1746575077808,MMW 13R,A04,958033,Staff,0,4,16,16
1746575077808,MMW 13R,A05,958034,Staff,0,4,16,16
1746575078836,SIO 295LS,A00,894015,Staff,5,0,25,20
1746575079861,SIO 295S,A00,894020,Staff,5,0,25,20
1746575080892,SIOC 290S,B01,958918,Merrifield; Mark A,14,0,30,16
1746575081922,SIOC 291S,B01,958922,Gabriel; Corey John,14,0,30,16
1746575082950,SOCI 117,A01,895339,Staff,3,0,5,2
1746575083976,WES 237B,A00,894149,Staff,11,0,20,9
1746575086056,AESE 279B,A00,891859,Staff,13,0,35,22
1746575087080,AIP 197,001,891854,Vespa; Emanuel Ignacio,9999,0,9999,0
1746575088105,ANTH 289S,A00,891856,Gagneux; Pascal,12,0,12,0
1746575089132,BENG 196,001,957946,Engler; Adam J.,9996,0,9999,3
1746575090157,BISP 197,001,959851,Wilhelm; James E.,9998,0,9999,1
1746575091205,CAT 124RS,A01,956906,Staff,6,0,25,19
1746575092230,CAT 125RS,A01,922013,Staff,6,0,25,19
1746575093256,CLRE 250,A00,891860,Morris; Sheldon,9995,0,9999,4
1746575095307,CLRE 251R,A00,907817,Mehta; Ravindra L.,9994,0,9999,5
1746575096332,CLRE 252,A00,891864,Cuomo; Raphael Eduardo,9993,0,9999,6
1746575097358,CLRE 253,A00,891867,Vaida; Florin,9994,0,9999,5
1746575097358,CLRE 253,B00,907819,Staff,9999,0,9999,0
1746575098382,CLRE 259,A00,891868,Patel; Hemal,9998,0,9999,1
1746575099409,CLRE 260,A00,891872,Cuomo; Raphael Eduardo,9999,0,9999,0
1746575100432,CLRE 297,001,891888,Cuomo; Raphael Eduardo,9999,0,9999,0
1746575101460,CSE 191,A00,958773,Minnes Kemp; Mor Mia,9995,0,9999,4
1746575102485,CSE 197,001,959846,Minnes Kemp; Mor Mia,9990,0,9999,9
1746575103520,CSS 201S,A01,892054,Mignozzetti; Umberto,25,0,30,5
1746575104548,CSS 202S,A01,892056,Mignozzetti; Umberto,25,0,30,5
1746575105574,DSC 197,001,956898,Eldridge; Justin Matthew,9996,0,9999,3
1746575106602,DSC 297,001,958000,Mazumdar; Arya,9998,0,9999,1
1746575106602,DSC 297,002,959862,Wang; Yusu,9998,0,9999,1
1746575107628,EAP 100,A00,905686,Staff,9778,0,9999,221
1746575108655,ECE 45,A01,892618,Staff,0,0,65,65
1746575110705,ECE 111,A01,892719,Staff,5,0,65,60
1746575111730,ECE 197,001,957920,Mercier; Patrick Philip,9991,0,9999,8
1746575112754,ECON 178,A01,907814,Zhu; Ying,26,0,35,9
1746575113780,EDS 115,A00,895312,Staff,35,0,45,10
1746575114809,EDS 117,A01,895337,Staff,23,0,30,7
1746575115846,EDS 125,A00,895341,Jones; Gabrielle Anastasia,36,0,45,9
1746575116875,EDS 128A,A01,895459,Fargason; Sharon Gayle,44,0,45,1
1746575117902,EDS 128B,A01,895543,Pappas; Elizabeth,44,0,45,1
1746575118927,EDS 139,A00,897203,Pappas; Elizabeth,44,0,45,1
1746575118927,EDS 139,B00,897209,Fargason; Sharon Gayle,41,0,45,4
1746575119955,EDS 201,A00,895545,Staff,22,0,45,23
1746575120979,EDS 203,A01,895581,Halter; Christopher P.,22,0,45,23
1746575122008,EDS 204R,A01,895625,Heinzman; Erica M.,39,0,45,6
1746575122008,EDS 204R,B01,895693,Halter; Christopher P.,10,0,45,35
1746575123034,EDS 206R,A00,895694,Fargason; Sharon Gayle,1,0,30,29
1746575123034,EDS 206R,B00,895695,Choi; Bailey Miyeon,16,0,30,14
1746575124058,EDS 250,A00,895697,Hemans; Patricia Ann Benitez,22,0,45,23
1746575125084,EDS 281,A00,895701,Meyerott; Theresa Ann,1,0,15,14
1746575126110,EDS 284,A00,895736,Meyerott; Theresa Ann,1,0,15,14
1746575127135,EDS 286,A00,897210,Fine; Sarah,0,0,15,15
1746575128161,EDS 289C,A01,895770,Daly; Alan J.,1,0,15,14
1746575129186,EDS 290,A00,897211,Hofstetter; Carolyn,0,0,15,15
1746575130211,LIGM 5A,A00,896162,Fischer-Grunski; Eva K,12,0,20,8
1746575131235,LIGM 5B,A00,896260,Fischer-Grunski; Eva K,17,0,20,3
1746575132263,LIGM 5C,A00,896308,Fischer-Grunski; Eva K,18,0,20,2
1746575133291,LIIT 5AS,A00,896313,Carnelos; Chiara,18,0,20,2
1746575134318,LIIT 5BS,A00,896416,Carnelos; Chiara,20,0,20,0
1746575135346,LIIT 5CS,A00,896564,Carnelos; Chiara,20,0,20,0
1746575136371,LISP 5A,A00,896588,Munoz Sanchez; Alicia,2,0,20,18
1746575137399,LISP 5B,A00,896653,Munoz Sanchez; Alicia,7,0,20,13
1746575138423,LISP 5C,A00,896655,Munoz Sanchez; Alicia,0,1,20,20
1746575139451,MAE 197,001,957918,Kleissl; Jan,9996,0,9999,3
1746575139451,MAE 197,002,959806,Boechler; Nicholas Sebastia,9998,0,9999,1
1746575139451,MAE 197,003,959852,Mullin; Jennifer S,9998,0,9999,1
1746575140481,MATH 2,A01,957937,Staff,33,0,35,2
1746575141506,MATH 197,001,957876,Kedlaya; Kiran S.,9993,0,9999,6
1746575142530,MCWP 40,A00,892729,Duru; Nur,10,0,20,10
1746575142530,MCWP 40,B00,893304,Montejo; Carolina,14,0,20,6
1746575143553,MCWP 40R,A00,893757,Redela; Pamela Morgan,0,5,20,20
1746575144582,MCWP 50,A00,893758,Morshed; Michael James,0,0,20,20
1746575144582,MCWP 50,B00,893761,Bartulis; Jason Michael,17,0,20,3
1746575145609,MCWP 50R,A00,893766,Compas; Sean Matthew,0,1,20,20
1746575145609,MCWP 50R,B00,893769,Carter; Jennifer A,0,1,20,20
1746575145609,MCWP 50R,C00,893771,Krone; Jarret,0,3,20,20
1746575145609,MCWP 50R,D00,893772,Miller; Elizabeth Deen,0,0,20,20
1746575145609,MCWP 50R,E00,893775,Carter; Andrea L,0,1,20,20
1746575146639,MMW 11R,A01,892721,Herbst; Matthew,14,0,30,16
1746575146639,MMW 11R,A02,892722,Herbst; Matthew,0,0,0,3
1746575147665,MMW 12R,A01,892724,Herbst; Matthew,0,11,16,16
1746575147665,MMW 12R,A02,892725,Herbst; Matthew,0,10,16,16
1746575148689,MMW 13R,A01,892727,Staff,0,4,16,16
1746575148689,MMW 13R,A02,892728,Staff,0,4,16,16
1746575148689,MMW 13R,A03,958032,Staff,0,4,16,16
1746575148689,MMW 13R,A04,958033,Staff,0,4,16,16
1746575148689,MMW 13R,A05,958034,Staff,0,4,16,16
1746575149716,SIO 295LS,A00,894015,Staff,5,0,25,20
1746575150743,SIO 295S,A00,894020,Staff,5,0,25,20
1746575151770,SIOC 290S,B01,958918,Merrifield; Mark A,14,0,30,16
1746575152795,SIOC 291S,B01,958922,Gabriel; Corey John,14,0,30,16
1746575153821,SOCI 117,A01,895339,Staff,3,0,5,2
1746575154846,WES 237B,A00,894149,Staff,11,0,20,9
1746575156951,AESE 279B,A00,891859,Staff,13,0,35,22
1746575157976,AIP 197,001,891854,Vespa; Emanuel Ignacio,9999,0,9999,0
1746575159000,ANTH 289S,A00,891856,Gagneux; Pascal,12,0,12,0
1746575160024,BENG 196,001,957946,Engler; Adam J.,9996,0,9999,3
1746575161054,BISP 197,001,959851,Wilhelm; James E.,9998,0,9999,1
1746575162081,CAT 124RS,A01,956906,Staff,6,0,25,19
1746575163105,CAT 125RS,A01,922013,Staff,6,0,25,19
1746575164144,CLRE 250,A00,891860,Morris; Sheldon,9995,0,9999,4
1746575166198,CLRE 251R,A00,907817,Mehta; Ravindra L.,9994,0,9999,5
1746575167223,CLRE 252,A00,891864,Cuomo; Raphael Eduardo,9993,0,9999,6
1746575168252,CLRE 253,A00,891867,Vaida; Florin,9994,0,9999,5
1746575168252,CLRE 253,B00,907819,Staff,9999,0,9999,0
1746575169280,CLRE 259,A00,891868,Patel; Hemal,9998,0,9999,1
1746575170307,CLRE 260,A00,891872,Cuomo; Raphael Eduardo,9999,0,9999,0
1746575171332,CLRE 297,001,891888,Cuomo; Raphael Eduardo,9999,0,9999,0
1746575172357,CSE 191,A00,958773,Minnes Kemp; Mor Mia,9995,0,9999,4
1746575173384,CSE 197,001,959846,Minnes Kemp; Mor Mia,9990,0,9999,9
1746575174415,CSS 201S,A01,892054,Mignozzetti; Umberto,25,0,30,5
1746575175441,CSS 202S,A01,892056,Mignozzetti; Umberto,25,0,30,5
1746575176467,DSC 197,001,956898,Eldridge; Justin Matthew,9996,0,9999,3
1746575177491,DSC 297,001,958000,Mazumdar; Arya,9998,0,9999,1
1746575177491,DSC 297,002,959862,Wang; Yusu,9998,0,9999,1
1746575178517,EAP 100,A00,905686,Staff,9778,0,9999,221
1746575179542,ECE 45,A01,892618,Staff,0,0,65,65
1746575181596,ECE 111,A01,892719,Staff,5,0,65,60
1746575182624,ECE 197,001,957920,Mercier; Patrick Philip,9991,0,9999,8
1746575183654,ECON 178,A01,907814,Zhu; Ying,26,0,35,9
1746575184681,EDS 115,A00,895312,Staff,35,0,45,10
1746575185707,EDS 117,A01,895337,Staff,23,0,30,7
1746575186734,EDS 125,A00,895341,Jones; Gabrielle Anastasia,36,0,45,9
1746575187759,EDS 128A,A01,895459,Fargason; Sharon Gayle,44,0,45,1
1746575188785,EDS 128B,A01,895543,Pappas; Elizabeth,44,0,45,1
1746575189809,EDS 139,A00,897203,Pappas; Elizabeth,44,0,45,1
1746575189809,EDS 139,B00,897209,Fargason; Sharon Gayle,41,0,45,4
1746575190834,EDS 201,A00,895545,Staff,22,0,45,23
1746575191862,EDS 203,A01,895581,Halter; Christopher P.,22,0,45,23
1746575192887,EDS 204R,A01,895625,Heinzman; Erica M.,39,0,45,6
1746575192887,EDS 204R,B01,895693,Halter; Christopher P.,10,0,45,35
1746575193913,EDS 206R,A00,895694,Fargason; Sharon Gayle,1,0,30,29
1746575193913,EDS 206R,B00,895695,Choi; Bailey Miyeon,16,0,30,14
1746575194938,EDS 250,A00,895697,Hemans; Patricia Ann Benitez,22,0,45,23
1746575195965,EDS 281,A00,895701,Meyerott; Theresa Ann,1,0,15,14
1746575196990,EDS 284,A00,895736,Meyerott; Theresa Ann,1,0,15,14
1746575198016,EDS 286,A00,897210,Fine; Sarah,0,0,15,15
1746575199042,EDS 289C,A01,895770,Daly; Alan J.,1,0,15,14
1746575200067,EDS 290,A00,897211,Hofstetter; Carolyn,0,0,15,15
1746575201097,LIGM 5A,A00,896162,Fischer-Grunski; Eva K,12,0,20,8
1746575202123,LIGM 5B,A00,896260,Fischer-Grunski; Eva K,17,0,20,3
1746575203149,LIGM 5C,A00,896308,Fischer-Grunski; Eva K,18,0,20,2
1746575204175,LIIT 5AS,A00,896313,Carnelos; Chiara,18,0,20,2
1746575205202,LIIT 5BS,A00,896416,Carnelos; Chiara,20,0,20,0
1746575206230,LIIT 5CS,A00,896564,Carnelos; Chiara,20,0,20,0
1746575207256,LISP 5A,A00,896588,Munoz Sanchez; Alicia,2,0,20,18
1746575208281,LISP 5B,A00,896653,Munoz Sanchez; Alicia,7,0,20,13
1746575209311,LISP 5C,A00,896655,Munoz Sanchez; Alicia,0,1,20,20
1746575210338,MAE 197,001,957918,Kleissl; Jan,9996,0,9999,3
1746575210338,MAE 197,002,959806,Boechler; Nicholas Sebastia,9998,0,9999,1
1746575210338,MAE 197,003,959852,Mullin; Jennifer S,9998,0,9999,1
1746575211365,MATH 2,A01,957937,Staff,33,0,35,2
1746575212404,MATH 197,001,957876,Kedlaya; Kiran S.,9993,0,9999,6
1746575213432,MCWP 40,A00,892729,Duru; Nur,10,0,20,10
1746575213432,MCWP 40,B00,893304,Montejo; Carolina,14,0,20,6
1746575214455,MCWP 40R,A00,893757,Redela; Pamela Morgan,0,5,20,20
1746575215479,MCWP 50,A00,893758,Morshed; Michael James,0,0,20,20
1746575215479,MCWP 50,B00,893761,Bartulis; Jason Michael,17,0,20,3
1746575216502,MCWP 50R,A00,893766,Compas; Sean Matthew,0,1,20,20
1746575216502,MCWP 50R,B00,893769,Carter; Jennifer A,0,1,20,20
1746575216502,MCWP 50R,C00,893771,Krone; Jarret,0,3,20,20
1746575216502,MCWP 50R,D00,893772,Miller; Elizabeth Deen,0,0,20,20
1746575216502,MCWP 50R,E00,893775,Carter; Andrea L,0,1,20,20
1746575217530,MMW 11R,A01,892721,Herbst; Matthew,14,0,30,16
1746575217530,MMW 11R,A02,892722,Herbst; Matthew,0,0,0,3
1746575218553,MMW 12R,A01,892724,Herbst; Matthew,0,11,16,16
1746575218553,MMW 12R,A02,892725,Herbst; Matthew,0,10,16,16
1746575219582,MMW 13R,A01,892727,Staff,0,4,16,16
1746575219582,MMW 13R,A02,892728,Staff,0,4,16,16
1746575219582,MMW 13R,A03,958032,Staff,0,4,16,16
1746575219582,MMW 13R,A04,958033,Staff,0,4,16,16
1746575219582,MMW 13R,A05,958034,Staff,0,4,16,16
1746575220609,SIO 295LS,A00,894015,Staff,5,0,25,20
1746575221635,SIO 295S,A00,894020,Staff,5,0,25,20
1746575222661,SIOC 290S,B01,958918,Merrifield; Mark A,14,0,30,16
1746575223688,SIOC 291S,B01,958922,Gabriel; Corey John,14,0,30,16
1746575224713,SOCI 117,A01,895339,Staff,3,0,5,2
1746575225738,WES 237B,A00,894149,Staff,11,0,20,9
1746575227795,AESE 279B,A00,891859,Staff,13,0,35,22
1746575228823,AIP 197,001,891854,Vespa; Emanuel Ignacio,9999,0,9999,0
1746575229849,ANTH 289S,A00,891856,Gagneux; Pascal,12,0,12,0
1746575230874,BENG 196,001,957946,Engler; Adam J.,9996,0,9999,3
1746575231900,BISP 197,001,959851,Wilhelm; James E.,9998,0,9999,1
1746575232925,CAT 124RS,A01,956906,Staff,6,0,25,19
1746575233955,CAT 125RS,A01,922013,Staff,6,0,25,19
1746575234982,CLRE 250,A00,891860,Morris; Sheldon,9995,0,9999,4
1746575237037,CLRE 251R,A00,907817,Mehta; Ravindra L.,9994,0,9999,5
1746575238062,CLRE 252,A00,891864,Cuomo; Raphael Eduardo,9993,0,9999,6
1746575239087,CLRE 253,A00,891867,Vaida; Florin,9994,0,9999,5
1746575239087,CLRE 253,B00,907819,Staff,9999,0,9999,0
1746575240114,CLRE 259,A00,891868,Patel; Hemal,9998,0,9999,1
1746575241138,CLRE 260,A00,891872,Cuomo; Raphael Eduardo,9999,0,9999,0
1746575242164,CLRE 297,001,891888,Cuomo; Raphael Eduardo,9999,0,9999,0
1746575243192,CSE 191,A00,958773,Minnes Kemp; Mor Mia,9995,0,9999,4
1746575244219,CSE 197,001,959846,Minnes Kemp; Mor Mia,9990,0,9999,9
1746575245249,CSS 201S,A01,892054,Mignozzetti; Umberto,25,0,30,5
1746575246273,CSS 202S,A01,892056,Mignozzetti; Umberto,25,0,30,5
1746575247298,DSC 197,001,956898,Eldridge; Justin Matthew,9996,0,9999,3
1746575248325,DSC 297,001,958000,Mazumdar; Arya,9998,0,9999,1
1746575248325,DSC 297,002,959862,Wang; Yusu,9998,0,9999,1
1746575249353,EAP 100,A00,905686,Staff,9778,0,9999,221
1746575250378,ECE 45,A01,892618,Staff,0,0,65,65
1746575252426,ECE 111,A01,892719,Staff,5,0,65,60
1746575253450,ECE 197,001,957920,Mercier; Patrick Philip,9991,0,9999,8
1746575254475,ECON 178,A01,907814,Zhu; Ying,26,0,35,9
1746575255502,EDS 115,A00,895312,Staff,35,0,45,10
1746575256530,EDS 117,A01,895337,Staff,23,0,30,7
1746575257555,EDS 125,A00,895341,Jones; Gabrielle Anastasia,36,0,45,9
1746575258584,EDS 128A,A01,895459,Fargason; Sharon Gayle,44,0,45,1
1746575259610,EDS 128B,A01,895543,Pappas; Elizabeth,44,0,45,1
1746575260639,EDS 139,A00,897203,Pappas; Elizabeth,44,0,45,1
1746575260639,EDS 139,B00,897209,Fargason; Sharon Gayle,41,0,45,4
1746575261663,EDS 201,A00,895545,Staff,22,0,45,23
1746575262689,EDS 203,A01,895581,Halter; Christopher P.,22,0,45,23
1746575263718,EDS 204R,A01,895625,Heinzman; Erica M.,39,0,45,6
1746575263718,EDS 204R,B01,895693,Halter; Christopher P.,10,0,45,35
1746575264748,EDS 206R,A00,895694,Fargason; Sharon Gayle,1,0,30,29
1746575264748,EDS 206R,B00,895695,Choi; Bailey Miyeon,16,0,30,14
1746575265777,EDS 250,A00,895697,Hemans; Patricia Ann Benitez,22,0,45,23
1746575266803,EDS 281,A00,895701,Meyerott; Theresa Ann,1,0,15,14
1746575267831,EDS 284,A00,895736,Meyerott; Theresa Ann,1,0,15,14
1746575268856,EDS 286,A00,897210,Fine; Sarah,0,0,15,15
1746575269885,EDS 289C,A01,895770,Daly; Alan J.,1,0,15,14
1746575270915,EDS 290,A00,897211,Hofstetter; Carolyn,0,0,15,15
1746575271946,LIGM 5A,A00,896162,Fischer-Grunski; Eva K,12,0,20,8
1746575272971,LIGM 5B,A00,896260,Fischer-Grunski; Eva K,17,0,20,3
1746575273997,LIGM 5C,A00,896308,Fischer-Grunski; Eva K,18,0,20,2
1746575275027,LIIT 5AS,A00,896313,Carnelos; Chiara,18,0,20,2
1746575276057,LIIT 5BS,A00,896416,Carnelos; Chiara,20,0,20,0
1746575277082,LIIT 5CS,A00,896564,Carnelos; Chiara,20,0,20,0
1746575278106,LISP 5A,A00,896588,Munoz Sanchez; Alicia,2,0,20,18
1746575279132,LISP 5B,A00,896653,Munoz Sanchez; Alicia,7,0,20,13
1746575280158,LISP 5C,A00,896655,Munoz Sanchez; Alicia,0,1,20,20
1746575281182,MAE 197,001,957918,Kleissl; Jan,9996,0,9999,3
1746575281182,MAE 197,002,959806,Boechler; Nicholas Sebastia,9998,0,9999,1
1746575281182,MAE 197,003,959852,Mullin; Jennifer S,9998,0,9999,1
1746575282209,MATH 2,A01,957937,Staff,33,0,35,2
1746575283240,MATH 197,001,957876,Kedlaya; Kiran S.,9993,0,9999,6
1746575284265,MCWP 40,A00,892729,Duru; Nur,10,0,20,10
1746575284265,MCWP 40,B00,893304,Montejo; Carolina,14,0,20,6
1746575285294,MCWP 40R,A00,893757,Redela; Pamela Morgan,0,5,20,20
1746575286318,MCWP 50,A00,893758,Morshed; Michael James,0,0,20,20
1746575286318,MCWP 50,B00,893761,Bartulis; Jason Michael,17,0,20,3
1746575287342,MCWP 50R,A00,893766,Compas; Sean Matthew,0,1,20,20
1746575287342,MCWP 50R,B00,893769,Carter; Jennifer A,0,1,20,20
1746575287342,MCWP 50R,C00,893771,Krone; Jarret,0,3,20,20
1746575287342,MCWP 50R,D00,893772,Miller; Elizabeth Deen,0,0,20,20
1746575287342,MCWP 50R,E00,893775,Carter; Andrea L,0,1,20,20
1746575288370,MMW 11R,A01,892721,Herbst; Matthew,14,0,30,16
1746575288370,MMW 11R,A02,892722,Herbst; Matthew,0,0,0,3
1746575289396,MMW 12R,A01,892724,Herbst; Matthew,0,11,16,16
1746575289396,MMW 12R,A02,892725,Herbst; Matthew,0,10,16,16
1746575290420,MMW 13R,A01,892727,Staff,0,4,16,16
1746575290420,MMW 13R,A02,892728,Staff,0,4,16,16
1746575290420,MMW 13R,A03,958032,Staff,0,4,16,16
1746575290420,MMW 13R,A04,958033,Staff,0,4,16,16
1746575290420,MMW 13R,A05,958034,Staff,0,4,16,16
1746575291445,SIO 295LS,A00,894015,Staff,5,0,25,20
1746575292470,SIO 295S,A00,894020,Staff,5,0,25,20
1746575293499,SIOC 290S,B01,958918,Merrifield; Mark A,14,0,30,16
1746575294528,SIOC 291S,B01,958922,Gabriel; Corey John,14,0,30,16
1746575295553,SOCI 117,A01,895339,Staff,3,0,5,2
1746575296580,WES 237B,A00,894149,Staff,11,0,20,9
1746575298640,AESE 279B,A00,891859,Staff,13,0,35,22
1746575299669,AIP 197,001,891854,Vespa; Emanuel Ignacio,9999,0,9999,0
1746575300698,ANTH 289S,A00,891856,Gagneux; Pascal,12,0,12,0
1746575301724,BENG 196,001,957946,Engler; Adam J.,9996,0,9999,3
1746575302749,BISP 197,001,959851,Wilhelm; James E.,9998,0,9999,1
1746575303773,CAT 124RS,A01,956906,Staff,6,0,25,19
1746575304799,CAT 125RS,A01,922013,Staff,6,0,25,19
1746575305828,CLRE 250,A00,891860,Morris; Sheldon,9995,0,9999,4
1746575307884,CLRE 251R,A00,907817,Mehta; Ravindra L.,9994,0,9999,5
1746575308913,CLRE 252,A00,891864,Cuomo; Raphael Eduardo,9993,0,9999,6
1746575309937,CLRE 253,A00,891867,Vaida; Florin,9994,0,9999,5
1746575309937,CLRE 253,B00,907819,Staff,9999,0,9999,0
1746575310961,CLRE 259,A00,891868,Patel; Hemal,9998,0,9999,1
1746575311986,CLRE 260,A00,891872,Cuomo; Raphael Eduardo,9999,0,9999,0
1746575313014,CLRE 297,001,891888,Cuomo; Raphael Eduardo,9999,0,9999,0
1746575314039,CSE 191,A00,958773,Minnes Kemp; Mor Mia,9995,0,9999,4
1746575315067,CSE 197,001,959846,Minnes Kemp; Mor Mia,9990,0,9999,9
1746575316097,CSS 201S,A01,892054,Mignozzetti; Umberto,25,0,30,5
1746575317123,CSS 202S,A01,892056,Mignozzetti; Umberto,25,0,30,5
1746575318151,DSC 197,001,956898,Eldridge; Justin Matthew,9996,0,9999,3
1746575319177,DSC 297,001,958000,Mazumdar; Arya,9998,0,9999,1
1746575319177,DSC 297,002,959862,Wang; Yusu,9998,0,9999,1
1746575320206,EAP 100,A00,905686,Staff,9778,0,9999,221
1746575321230,ECE 45,A01,892618,Staff,0,0,65,65
1746575323280,ECE 111,A01,892719,Staff,5,0,65,60
1746575324306,ECE 197,001,957920,Mercier; Patrick Philip,9991,0,9999,8
1746575325332,ECON 178,A01,907814,Zhu; Ying,26,0,35,9
1746575326355,EDS 115,A00,895312,Staff,35,0,45,10
1746575327383,EDS 117,A01,895337,Staff,23,0,30,7
1746575328412,EDS 125,A00,895341,Jones; Gabrielle Anastasia,36,0,45,9
1746575329437,EDS 128A,A01,895459,Fargason; Sharon Gayle,44,0,45,1
1746575330464,EDS 128B,A01,895543,Pappas; Elizabeth,44,0,45,1
1746575331489,EDS 139,A00,897203,Pappas; Elizabeth,44,0,45,1
1746575331489,EDS 139,B00,897209,Fargason; Sharon Gayle,41,0,45,4
1746575332516,EDS 201,A00,895545,Staff,22,0,45,23
1746575333540,EDS 203,A01,895581,Halter; Christopher P.,22,0,45,23
1746575334567,EDS 204R,A01,895625,Heinzman; Erica M.,39,0,45,6
1746575334567,EDS 204R,B01,895693,Halter; Christopher P.,10,0,45,35
1746575335593,EDS 206R,A00,895694,Fargason; Sharon Gayle,1,0,30,29
1746575335593,EDS 206R,B00,895695,Choi; Bailey Miyeon,16,0,30,14
1746575336620,EDS 250,A00,895697,Hemans; Patricia Ann Benitez,22,0,45,23
1746575337649,EDS 281,A00,895701,Meyerott; Theresa Ann,1,0,15,14
1746575338673,EDS 284,A00,895736,Meyerott; Theresa Ann,1,0,15,14
1746575339699,EDS 286,A00,897210,Fine; Sarah,0,0,15,15
1746575340724,EDS 289C,A01,895770,Daly; Alan J.,1,0,15,14
1746575341748,EDS 290,A00,897211,Hofstetter; Carolyn,0,0,15,15
1746575342772,LIGM 5A,A00,896162,Fischer-Grunski; Eva K,12,0,20,8
1746575343798,LIGM 5B,A00,896260,Fischer-Grunski; Eva K,17,0,20,3
1746575344823,LIGM 5C,A00,896308,Fischer-Grunski; Eva K,18,0,20,2
1746575345851,LIIT 5AS,A00,896313,Carnelos; Chiara,18,0,20,2
1746575346877,LIIT 5BS,A00,896416,Carnelos; Chiara,20,0,20,0
1746575347902,LIIT 5CS,A00,896564,Carnelos; Chiara,20,0,20,0
1746575348930,LISP 5A,A00,896588,Munoz Sanchez; Alicia,2,0,20,18
1746575349961,LISP 5B,A00,896653,Munoz Sanchez; Alicia,7,0,20,13
1746575350986,LISP 5C,A00,896655,Munoz Sanchez; Alicia,0,1,20,20
1746575352009,MAE 197,001,957918,Kleissl; Jan,9996,0,9999,3
1746575352009,MAE 197,002,959806,Boechler; Nicholas Sebastia,9998,0,9999,1
1746575352009,MAE 197,003,959852,Mullin; Jennifer S,9998,0,9999,1
1746575353035,MATH 2,A01,957937,Staff,33,0,35,2
1746575354058,MATH 197,001,957876,Kedlaya; Kiran S.,9993,0,9999,6
1746575355086,MCWP 40,A00,892729,Duru; Nur,10,0,20,10
1746575355086,MCWP 40,B00,893304,Montejo; Carolina,14,0,20,6
1746575356112,MCWP 40R,A00,893757,Redela; Pamela Morgan,0,5,20,20
1746575357138,MCWP 50,A00,893758,Morshed; Michael James,0,0,20,20
1746575357138,MCWP 50,B00,893761,Bartulis; Jason Michael,17,0,20,3
1746575358163,MCWP 50R,A00,893766,Compas; Sean Matthew,0,1,20,20
1746575358163,MCWP 50R,B00,893769,Carter; Jennifer A,0,1,20,20
1746575358163,MCWP 50R,C00,893771,Krone; Jarret,0,3,20,20
1746575358163,MCWP 50R,D00,893772,Miller; Elizabeth Deen,0,0,20,20
1746575358163,MCWP 50R,E00,893775,Carter; Andrea L,0,1,20,20
1746575359188,MMW 11R,A01,892721,Herbst; Matthew,14,0,30,16
1746575359188,MMW 11R,A02,892722,Herbst; Matthew,0,0,0,3
1746575360213,MMW 12R,A01,892724,Herbst; Matthew,0,11,16,16
1746575360213,MMW 12R,A02,892725,Herbst; Matthew,0,10,16,16
1746575361242,MMW 13R,A01,892727,Staff,0,4,16,16
1746575361242,MMW 13R,A02,892728,Staff,0,4,16,16
1746575361242,MMW 13R,A03,958032,Staff,0,4,16,16
1746575361242,MMW 13R,A04,958033,Staff,0,4,16,16
1746575361242,MMW 13R,A05,958034,Staff,0,4,16,16
1746575362267,SIO 295LS,A00,894015,Staff,5,0,25,20
1746575363294,SIO 295S,A00,894020,Staff,5,0,25,20
1746575364321,SIOC 290S,B01,958918,Merrifield; Mark A,14,0,30,16
1746575365347,SIOC 291S,B01,958922,Gabriel; Corey John,14,0,30,16
1746575366371,SOCI 117,A01,895339,Staff,3,0,5,2
1746575367398,WES 237B,A00,894149,Staff,11,0,20,9
1746575369462,AESE 279B,A00,891859,Staff,13,0,35,22
1746575370490,AIP 197,001,891854,Vespa; Emanuel Ignacio,9999,0,9999,0
1746575371514,ANTH 289S,A00,891856,Gagneux; Pascal,12,0,12,0
1746575372540,BENG 196,001,957946,Engler; Adam J.,9996,0,9999,3
1746575373565,BISP 197,001,959851,Wilhelm; James E.,9998,0,9999,1
1746575374590,CAT 124RS,A01,956906,Staff,6,0,25,19
1746575375615,CAT 125RS,A01,922013,Staff,6,0,25,19
1746575376642,CLRE 250,A00,891860,Morris; Sheldon,9995,0,9999,4
1746575378691,CLRE 251R,A00,907817,Mehta; Ravindra L.,9994,0,9999,5
1746575379718,CLRE 252,A00,891864,Cuomo; Raphael Eduardo,9993,0,9999,6
1746575380743,CLRE 253,A00,891867,Vaida; Florin,9994,0,9999,5
1746575380743,CLRE 253,B00,907819,Staff,9999,0,9999,0
1746575381769,CLRE 259,A00,891868,Patel; Hemal,9998,0,9999,1
1746575382796,CLRE 260,A00,891872,Cuomo; Raphael Eduardo,9999,0,9999,0
1746575383824,CLRE 297,001,891888,Cuomo; Raphael Eduardo,9999,0,9999,0
1746575384848,CSE 191,A00,958773,Minnes Kemp; Mor Mia,9995,0,9999,4
1746575385871,CSE 197,001,959846,Minnes Kemp; Mor Mia,9990,0,9999,9
1746575386898,CSS 201S,A01,892054,Mignozzetti; Umberto,25,0,30,5
1746575387928,CSS 202S,A01,892056,Mignozzetti; Umberto,25,0,30,5
1746575388952,DSC 197,001,956898,Eldridge; Justin Matthew,9996,0,9999,3
1746575389979,DSC 297,001,958000,Mazumdar; Arya,9998,0,9999,1
1746575389979,DSC 297,002,959862,Wang; Yusu,9998,0,9999,1
1746575391005,EAP 100,A00,905686,Staff,9778,0,9999,221
1746575392033,ECE 45,A01,892618,Staff,0,0,65,65
1746575394082,ECE 111,A01,892719,Staff,5,0,65,60
1746575395106,ECE 197,001,957920,Mercier; Patrick Philip,9991,0,9999,8
1746575396130,ECON 178,A01,907814,Zhu; Ying,26,0,35,9
1746575397159,EDS 115,A00,895312,Staff,35,0,45,10
1746575398184,EDS 117,A01,895337,Staff,23,0,30,7
1746575399212,EDS 125,A00,895341,Jones; Gabrielle Anastasia,36,0,45,9
1746575400240,EDS 128A,A01,895459,Fargason; Sharon Gayle,44,0,45,1
1746575401265,EDS 128B,A01,895543,Pappas; Elizabeth,44,0,45,1
1746575402293,EDS 139,A00,897203,Pappas; Elizabeth,44,0,45,1
1746575402293,EDS 139,B00,897209,Fargason; Sharon Gayle,41,0,45,4
1746575403320,EDS 201,A00,895545,Staff,22,0,45,23
1746575404346,EDS 203,A01,895581,Halter; Christopher P.,22,0,45,23
1746575405370,EDS 204R,A01,895625,Heinzman; Erica M.,39,0,45,6
1746575405370,EDS 204R,B01,895693,Halter; Christopher P.,10,0,45,35
1746575406394,EDS 206R,A00,895694,Fargason; Sharon Gayle,1,0,30,29
1746575406394,EDS 206R,B00,895695,Choi; Bailey Miyeon,16,0,30,14
1746575407419,EDS 250,A00,895697,Hemans; Patricia Ann Benitez,22,0,45,23
1746575408446,EDS 281,A00,895701,Meyerott; Theresa Ann,1,0,15,14
1746575409471,EDS 284,A00,895736,Meyerott; Theresa Ann,1,0,15,14
1746575410496,EDS 286,A00,897210,Fine; Sarah,0,0,15,15
1746575411529,EDS 289C,A01,895770,Daly; Alan J.,1,0,15,14
1746575412556,EDS 290,A00,897211,Hofstetter; Carolyn,0,0,15,15
1746575413582,LIGM 5A,A00,896162,Fischer-Grunski; Eva K,12,0,20,8
1746575414609,LIGM 5B,A00,896260,Fischer-Grunski; Eva K,17,0,20,3
1746575415640,LIGM 5C,A00,896308,Fischer-Grunski; Eva K,18,0,20,2
1746575416664,LIIT 5AS,A00,896313,Carnelos; Chiara,18,0,20,2
1746575417692,LIIT 5BS,A00,896416,Carnelos; Chiara,20,0,20,0
1746575418719,LIIT 5CS,A00,896564,Carnelos; Chiara,20,0,20,0
1746575419745,LISP 5A,A00,896588,Munoz Sanchez; Alicia,2,0,20,18
1746575420772,LISP 5B,A00,896653,Munoz Sanchez; Alicia,7,0,20,13
1746575421798,LISP 5C,A00,896655,Munoz Sanchez; Alicia,0,1,20,20
1746575422825,MAE 197,001,957918,Kleissl; Jan,9996,0,9999,3
1746575422825,MAE 197,002,959806,Boechler; Nicholas Sebastia,9998,0,9999,1
1746575422825,MAE 197,003,959852,Mullin; Jennifer S,9998,0,9999,1
1746575423851,MATH 2,A01,957937,Staff,33,0,35,2
1746575424876,MATH 197,001,957876,Kedlaya; Kiran S.,9993,0,9999,6
1746575425905,MCWP 40,A00,892729,Duru; Nur,10,0,20,10
1746575425905,MCWP 40,B00,893304,Montejo; Carolina,14,0,20,6
1746575426936,MCWP 40R,A00,893757,Redela; Pamela Morgan,0,5,20,20
1746575427963,MCWP 50,A00,893758,Morshed; Michael James,0,0,20,20
1746575427963,MCWP 50,B00,893761,Bartulis; Jason Michael,17,0,20,3
1746575428993,MCWP 50R,A00,893766,Compas; Sean Matthew,0,1,20,20
1746575428993,MCWP 50R,B00,893769,Carter; Jennifer A,0,1,20,20
1746575428993,MCWP 50R,C00,893771,Krone; Jarret,0,3,20,20
1746575428993,MCWP 50R,D00,893772,Miller; Elizabeth Deen,0,0,20,20
1746575428993,MCWP 50R,E00,893775,Carter; Andrea L,0,1,20,20
1746575430019,MMW 11R,A01,892721,Herbst; Matthew,14,0,30,16
1746575430019,MMW 11R,A02,892722,Herbst; Matthew,0,0,0,3
1746575431047,MMW 12R,A01,892724,Herbst; Matthew,0,11,16,16
1746575431047,MMW 12R,A02,892725,Herbst; Matthew,0,10,16,16
1746575432070,MMW 13R,A01,892727,Staff,0,4,16,16
1746575432070,MMW 13R,A02,892728,Staff,0,4,16,16
1746575432070,MMW 13R,A03,958032,Staff,0,4,16,16
1746575432070,MMW 13R,A04,958033,Staff,0,4,16,16
1746575432070,MMW 13R,A05,958034,Staff,0,4,16,16
1746575433096,SIO 295LS,A00,894015,Staff,5,0,25,20
1746575434122,SIO 295S,A00,894020,Staff,5,0,25,20
1746575435149,SIOC 290S,B01,958918,Merrifield; Mark A,14,0,30,16
1746575436178,SIOC 291S,B01,958922,Gabriel; Corey John,14,0,30,16
1746575437205,SOCI 117,A01,895339,Staff,3,0,5,2
1746575438233,WES 237B,A00,894149,Staff,11,0,20,9
1746575440299,AESE 279B,A00,891859,Staff,13,0,35,22
1746575441326,AIP 197,001,891854,Vespa; Emanuel Ignacio,9999,0,9999,0
1746575442351,ANTH 289S,A00,891856,Gagneux; Pascal,12,0,12,0
1746575443375,BENG 196,001,957946,Engler; Adam J.,9996,0,9999,3
1746575444398,BISP 197,001,959851,Wilhelm; James E.,9998,0,9999,1
1746575445427,CAT 124RS,A01,956906,Staff,6,0,25,19
1746575446454,CAT 125RS,A01,922013,Staff,6,0,25,19
1746575447479,CLRE 250,A00,891860,Morris; Sheldon,9995,0,9999,4
1746575449534,CLRE 251R,A00,907817,Mehta; Ravindra L.,9994,0,9999,5
1746575450558,CLRE 252,A00,891864,Cuomo; Raphael Eduardo,9993,0,9999,6
1746575451587,CLRE 253,A00,891867,Vaida; Florin,9994,0,9999,5
1746575451587,CLRE 253,B00,907819,Staff,9999,0,9999,0
1746575452615,CLRE 259,A00,891868,Patel; Hemal,9998,0,9999,1
1746575453640,CLRE 260,A00,891872,Cuomo; Raphael Eduardo,9999,0,9999,0
1746575454666,CLRE 297,001,891888,Cuomo; Raphael Eduardo,9999,0,9999,0
1746575455692,CSE 191,A00,958773,Minnes Kemp; Mor Mia,9995,0,9999,4
1746575456718,CSE 197,001,959846,Minnes Kemp; Mor Mia,9990,0,9999,9
1746575457746,CSS 201S,A01,892054,Mignozzetti; Umberto,25,0,30,5
1746575458772,CSS 202S,A01,892056,Mignozzetti; Umberto,25,0,30,5
1746575459802,DSC 197,001,956898,Eldridge; Justin Matthew,9996,0,9999,3
1746575460829,DSC 297,001,958000,Mazumdar; Arya,9998,0,9999,1
1746575460829,DSC 297,002,959862,Wang; Yusu,9998,0,9999,1
1746575461855,EAP 100,A00,905686,Staff,9778,0,9999,221
1746575462884,ECE 45,A01,892618,Staff,0,0,65,65
1746575464937,ECE 111,A01,892719,Staff,5,0,65,60
1746575465964,ECE 197,001,957920,Mercier; Patrick Philip,9991,0,9999,8
1746575466995,ECON 178,A01,907814,Zhu; Ying,26,0,35,9
1746575468019,EDS 115,A00,895312,Staff,35,0,45,10
1746575469047,EDS 117,A01,895337,Staff,23,0,30,7
1746575470070,EDS 125,A00,895341,Jones; Gabrielle Anastasia,36,0,45,9
1746575471098,EDS 128A,A01,895459,Fargason; Sharon Gayle,44,0,45,1
1746575472127,EDS 128B,A01,895543,Pappas; Elizabeth,44,0,45,1
1746575473151,EDS 139,A00,897203,Pappas; Elizabeth,44,0,45,1
1746575473151,EDS 139,B00,897209,Fargason; Sharon Gayle,41,0,45,4
1746575474192,EDS 201,A00,895545,Staff,22,0,45,23
1746575475218,EDS 203,A01,895581,Halter; Christopher P.,22,0,45,23
1746575476246,EDS 204R,A01,895625,Heinzman; Erica M.,39,0,45,6
1746575476246,EDS 204R,B01,895693,Halter; Christopher P.,10,0,45,35
1746575477272,EDS 206R,A00,895694,Fargason; Sharon Gayle,1,0,30,29
1746575477272,EDS 206R,B00,895695,Choi; Bailey Miyeon,16,0,30,14
1746575478303,EDS 250,A00,895697,Hemans; Patricia Ann Benitez,22,0,45,23
1746575479327,EDS 281,A00,895701,Meyerott; Theresa Ann,1,0,15,14
1746575480352,EDS 284,A00,895736,Meyerott; Theresa Ann,1,0,15,14
1746575481377,EDS 286,A00,897210,Fine; Sarah,0,0,15,15
1746575482415,EDS 289C,A01,895770,Daly; Alan J.,1,0,15,14
1746575483441,EDS 290,A00,897211,Hofstetter; Carolyn,0,0,15,15
1746575484466,LIGM 5A,A00,896162,Fischer-Grunski; Eva K,12,0,20,8
1746575485491,LIGM 5B,A00,896260,Fischer-Grunski; Eva K,17,0,20,3
1746575486520,LIGM 5C,A00,896308,Fischer-Grunski; Eva K,18,0,20,2
1746575487548,LIIT 5AS,A00,896313,Carnelos; Chiara,18,0,20,2
1746575488573,LIIT 5BS,A00,896416,Carnelos; Chiara,20,0,20,0
1746575489598,LIIT 5CS,A00,896564,Carnelos; Chiara,20,0,20,0
1746575490624,LISP 5A,A00,896588,Munoz Sanchez; Alicia,2,0,20,18
1746575491654,LISP 5B,A00,896653,Munoz Sanchez; Alicia,7,0,20,13
1746575492678,LISP 5C,A00,896655,Munoz Sanchez; Alicia,0,1,20,20
1746575493703,MAE 197,001,957918,Kleissl; Jan,9996,0,9999,3
1746575493703,MAE 197,002,959806,Boechler; Nicholas Sebastia,9998,0,9999,1
1746575493703,MAE 197,003,959852,Mullin; Jennifer S,9998,0,9999,1
1746575494730,MATH 2,A01,957937,Staff,33,0,35,2
1746575495757,MATH 197,001,957876,Kedlaya; Kiran S.,9993,0,9999,6
1746575496787,MCWP 40,A00,892729,Duru; Nur,10,0,20,10
1746575496787,MCWP 40,B00,893304,Montejo; Carolina,14,0,20,6
1746575497813,MCWP 40R,A00,893757,Redela; Pamela Morgan,0,5,20,20
1746575498839,MCWP 50,A00,893758,Morshed; Michael James,0,0,20,20
1746575498839,MCWP 50,B00,893761,Bartulis; Jason Michael,17,0,20,3
1746575499866,MCWP 50R,A00,893766,Compas; Sean Matthew,0,1,20,20
1746575499866,MCWP 50R,B00,893769,Carter; Jennifer A,0,1,20,20
1746575499866,MCWP 50R,C00,893771,Krone; Jarret,0,3,20,20
1746575499866,MCWP 50R,D00,893772,Miller; Elizabeth Deen,0,0,20,20
1746575499866,MCWP 50R,E00,893775,Carter; Andrea L,0,1,20,20
1746575500892,MMW 11R,A01,892721,Herbst; Matthew,14,0,30,16
1746575500892,MMW 11R,A02,892722,Herbst; Matthew,0,0,0,3
1746575501920,MMW 12R,A01,892724,Herbst; Matthew,0,11,16,16
1746575501920,MMW 12R,A02,892725,Herbst; Matthew,0,10,16,16
1746575502947,MMW 13R,A01,892727,Staff,0,4,16,16
1746575502947,MMW 13R,A02,892728,Staff,0,4,16,16
1746575502947,MMW 13R,A03,958032,Staff,0,4,16,16
1746575502947,MMW 13R,A04,958033,Staff,0,4,16,16
1746575502947,MMW 13R,A05,958034,Staff,0,4,16,16
1746575503974,SIO 295LS,A00,894015,Staff,5,0,25,20
1746575504998,SIO 295S,A00,894020,Staff,5,0,25,20
1746575506021,SIOC 290S,B01,958918,Merrifield; Mark A,14,0,30,16
1746575507047,SIOC 291S,B01,958922,Gabriel; Corey John,14,0,30,16
1746575508074,SOCI 117,A01,895339,Staff,3,0,5,2
1746575509099,WES 237B,A00,894149,Staff,11,0,20,9
1746575511168,AESE 279B,A00,891859,Staff,13,0,35,22
1746575512194,AIP 197,001,891854,Vespa; Emanuel Ignacio,9999,0,9999,0
1746575513221,ANTH 289S,A00,891856,Gagneux; Pascal,12,0,12,0
1746575514246,BENG 196,001,957946,Engler; Adam J.,9996,0,9999,3
1746575515271,BISP 197,001,959851,Wilhelm; James E.,9998,0,9999,1
1746575516297,CAT 124RS,A01,956906,Staff,6,0,25,19
1746575517323,CAT 125RS,A01,922013,Staff,6,0,25,19
1746575518348,CLRE 250,A00,891860,Morris; Sheldon,9995,0,9999,4
1746575520400,CLRE 251R,A00,907817,Mehta; Ravindra L.,9994,0,9999,5
1746575521424,CLRE 252,A00,891864,Cuomo; Raphael Eduardo,9993,0,9999,6
1746575522450,CLRE 253,A00,891867,Vaida; Florin,9994,0,9999,5
1746575522450,CLRE 253,B00,907819,Staff,9999,0,9999,0
1746575523478,CLRE 259,A00,891868,Patel; Hemal,9998,0,9999,1
1746575524504,CLRE 260,A00,891872,Cuomo; Raphael Eduardo,9999,0,9999,0
1746575525529,CLRE 297,001,891888,Cuomo; Raphael Eduardo,9999,0,9999,0
1746575526557,CSE 191,A00,958773,Minnes Kemp; Mor Mia,9995,0,9999,4
1746575527597,CSE 197,001,959846,Minnes Kemp; Mor Mia,9990,0,9999,9
1746575528626,CSS 201S,A01,892054,Mignozzetti; Umberto,25,0,30,5
1746575529652,CSS 202S,A01,892056,Mignozzetti; Umberto,25,0,30,5
1746575530679,DSC 197,001,956898,Eldridge; Justin Matthew,9996,0,9999,3
1746575531705,DSC 297,001,958000,Mazumdar; Arya,9998,0,9999,1
1746575531705,DSC 297,002,959862,Wang; Yusu,9998,0,9999,1
1746575532731,EAP 100,A00,905686,Staff,9778,0,9999,221
1746575533755,ECE 45,A01,892618,Staff,0,0,65,65
1746575535805,ECE 111,A01,892719,Staff,5,0,65,60
1746575536830,ECE 197,001,957920,Mercier; Patrick Philip,9991,0,9999,8
1746575537856,ECON 178,A01,907814,Zhu; Ying,26,0,35,9
1746575538884,EDS 115,A00,895312,Staff,35,0,45,10
1746575539908,EDS 117,A01,895337,Staff,23,0,30,7
1746575540936,EDS 125,A00,895341,Jones; Gabrielle Anastasia,36,0,45,9
1746575541960,EDS 128A,A01,895459,Fargason; Sharon Gayle,44,0,45,1
1746575543026,EDS 128B,A01,895543,Pappas; Elizabeth,44,0,45,1
1746575544054,EDS 139,A00,897203,Pappas; Elizabeth,44,0,45,1
1746575544054,EDS 139,B00,897209,Fargason; Sharon Gayle,41,0,45,4
1746575545083,EDS 201,A00,895545,Staff,22,0,45,23
1746575546109,EDS 203,A01,895581,Halter; Christopher P.,22,0,45,23
1746575547134,EDS 204R,A01,895625,Heinzman; Erica M.,39,0,45,6
1746575547134,EDS 204R,B01,895693,Halter; Christopher P.,10,0,45,35
1746575548160,EDS 206R,A00,895694,Fargason; Sharon Gayle,1,0,30,29
1746575548160,EDS 206R,B00,895695,Choi; Bailey Miyeon,16,0,30,14
1746575549184,EDS 250,A00,895697,Hemans; Patricia Ann Benitez,22,0,45,23
1746575550211,EDS 281,A00,895701,Meyerott; Theresa Ann,1,0,15,14
1746575551238,EDS 284,A00,895736,Meyerott; Theresa Ann,1,0,15,14
1746575552262,EDS 286,A00,897210,Fine; Sarah,0,0,15,15
1746575553289,EDS 289C,A01,895770,Daly; Alan J.,1,0,15,14
1746575554315,EDS 290,A00,897211,Hofstetter; Carolyn,0,0,15,15
1746575555339,LIGM 5A,A00,896162,Fischer-Grunski; Eva K,12,0,20,8
1746575556368,LIGM 5B,A00,896260,Fischer-Grunski; Eva K,17,0,20,3
1746575557395,LIGM 5C,A00,896308,Fischer-Grunski; Eva K,18,0,20,2
1746575558420,LIIT 5AS,A00,896313,Carnelos; Chiara,18,0,20,2
1746575559448,LIIT 5BS,A00,896416,Carnelos; Chiara,20,0,20,0
1746575560472,LIIT 5CS,A00,896564,Carnelos; Chiara,20,0,20,0
1746575561498,LISP 5A,A00,896588,Munoz Sanchez; Alicia,2,0,20,18
1746575562527,LISP 5B,A00,896653,Munoz Sanchez; Alicia,7,0,20,13
1746575563555,LISP 5C,A00,896655,Munoz Sanchez; Alicia,0,1,20,20
1746575564579,MAE 197,001,957918,Kleissl; Jan,9996,0,9999,3
1746575564579,MAE 197,002,959806,Boechler; Nicholas Sebastia,9998,0,9999,1
1746575564579,MAE 197,003,959852,Mullin; Jennifer S,9998,0,9999,1
1746575565609,MATH 2,A01,957937,Staff,33,0,35,2
1746575566633,MATH 197,001,957876,Kedlaya; Kiran S.,9993,0,9999,6
1746575567657,MCWP 40,A00,892729,Duru; Nur,10,0,20,10
1746575567657,MCWP 40,B00,893304,Montejo; Carolina,14,0,20,6
1746575568682,MCWP 40R,A00,893757,Redela; Pamela Morgan,0,5,20,20
1746575569708,MCWP 50,A00,893758,Morshed; Michael James,0,0,20,20
1746575569708,MCWP 50,B00,893761,Bartulis; Jason Michael,17,0,20,3
1746575570736,MCWP 50R,A00,893766,Compas; Sean Matthew,0,1,20,20
1746575570736,MCWP 50R,B00,893769,Carter; Jennifer A,0,1,20,20
1746575570736,MCWP 50R,C00,893771,Krone; Jarret,0,3,20,20
1746575570736,MCWP 50R,D00,893772,Miller; Elizabeth Deen,0,0,20,20
1746575570736,MCWP 50R,E00,893775,Carter; Andrea L,0,1,20,20
1746575571762,MMW 11R,A01,892721,Herbst; Matthew,14,0,30,16
1746575571762,MMW 11R,A02,892722,Herbst; Matthew,0,0,0,3
1746575572786,MMW 12R,A01,892724,Herbst; Matthew,0,11,16,16
1746575572786,MMW 12R,A02,892725,Herbst; Matthew,0,10,16,16
1746575573814,MMW 13R,A01,892727,Staff,0,4,16,16
1746575573814,MMW 13R,A02,892728,Staff,0,4,16,16
1746575573814,MMW 13R,A03,958032,Staff,0,4,16,16
1746575573814,MMW 13R,A04,958033,Staff,0,4,16,16
1746575573814,MMW 13R,A05,958034,Staff,0,4,16,16
1746575574842,SIO 295LS,A00,894015,Staff,5,0,25,20
1746575575869,SIO 295S,A00,894020,Staff,5,0,25,20
1746575576893,SIOC 290S,B01,958918,Merrifield; Mark A,14,0,30,16
1746575577936,SIOC 291S,B01,958922,Gabriel; Corey John,14,0,30,16
1746575578962,SOCI 117,A01,895339,Staff,3,0,5,2
1746575579986,WES 237B,A00,894149,Staff,11,0,20,9
1746575582108,AESE 279B,A00,891859,Staff,13,0,35,22
1746575583135,AIP 197,001,891854,Vespa; Emanuel Ignacio,9999,0,9999,0
1746575584164,ANTH 289S,A00,891856,Gagneux; Pascal,12,0,12,0
1746575585190,BENG 196,001,957946,Engler; Adam J.,9996,0,9999,3
1746575586215,BISP 197,001,959851,Wilhelm; James E.,9998,0,9999,1
1746575587241,CAT 124RS,A01,956906,Staff,6,0,25,19
1746575588266,CAT 125RS,A01,922013,Staff,6,0,25,19
1746575589291,CLRE 250,A00,891860,Morris; Sheldon,9995,0,9999,4
1746575591347,CLRE 251R,A00,907817,Mehta; Ravindra L.,9994,0,9999,5
1746575592376,CLRE 252,A00,891864,Cuomo; Raphael Eduardo,9993,0,9999,6
1746575593400,CLRE 253,A00,891867,Vaida; Florin,9994,0,9999,5
1746575593400,CLRE 253,B00,907819,Staff,9999,0,9999,0
1746575594426,CLRE 259,A00,891868,Patel; Hemal,9998,0,9999,1
1746575595452,CLRE 260,A00,891872,Cuomo; Raphael Eduardo,9999,0,9999,0
1746575596477,CLRE 297,001,891888,Cuomo; Raphael Eduardo,9999,0,9999,0
1746575597502,CSE 191,A00,958773,Minnes Kemp; Mor Mia,9995,0,9999,4
1746575598531,CSE 197,001,959846,Minnes Kemp; Mor Mia,9990,0,9999,9
1746575599559,CSS 201S,A01,892054,Mignozzetti; Umberto,25,0,30,5
1746575600589,CSS 202S,A01,892056,Mignozzetti; Umberto,25,0,30,5
1746575601616,DSC 197,001,956898,Eldridge; Justin Matthew,9996,0,9999,3
1746575602642,DSC 297,001,958000,Mazumdar; Arya,9998,0,9999,1
1746575602642,DSC 297,002,959862,Wang; Yusu,9998,0,9999,1
1746575603668,EAP 100,A00,905686,Staff,9778,0,9999,221
1746575604693,ECE 45,A01,892618,Staff,0,0,65,65
1746575606743,ECE 111,A01,892719,Staff,5,0,65,60
1746575607766,ECE 197,001,957920,Mercier; Patrick Philip,9991,0,9999,8
1746575608791,ECON 178,A01,907814,Zhu; Ying,26,0,35,9
1746575609817,EDS 115,A00,895312,Staff,35,0,45,10
1746575610842,EDS 117,A01,895337,Staff,23,0,30,7
1746575611867,EDS 125,A00,895341,Jones; Gabrielle Anastasia,36,0,45,9
1746575612893,EDS 128A,A01,895459,Fargason; Sharon Gayle,44,0,45,1
1746575613920,EDS 128B,A01,895543,Pappas; Elizabeth,44,0,45,1
1746575614947,EDS 139,A00,897203,Pappas; Elizabeth,44,0,45,1
1746575614947,EDS 139,B00,897209,Fargason; Sharon Gayle,41,0,45,4
1746575615972,EDS 201,A00,895545,Staff,22,0,45,23
1746575616995,EDS 203,A01,895581,Halter; Christopher P.,22,0,45,23
1746575618020,EDS 204R,A01,895625,Heinzman; Erica M.,39,0,45,6
1746575618020,EDS 204R,B01,895693,Halter; Christopher P.,10,0,45,35
1746575619047,EDS 206R,A00,895694,Fargason; Sharon Gayle,1,0,30,29
1746575619047,EDS 206R,B00,895695,Choi; Bailey Miyeon,16,0,30,14
1746575620075,EDS 250,A00,895697,Hemans; Patricia Ann Benitez,22,0,45,23
1746575621102,EDS 281,A00,895701,Meyerott; Theresa Ann,1,0,15,14
1746575622130,EDS 284,A00,895736,Meyerott; Theresa Ann,1,0,15,14
1746575623156,EDS 286,A00,897210,Fine; Sarah,0,0,15,15
1746575624183,EDS 289C,A01,895770,Daly; Alan J.,1,0,15,14
1746575625209,EDS 290,A00,897211,Hofstetter; Carolyn,0,0,15,15
1746575626234,LIGM 5A,A00,896162,Fischer-Grunski; Eva K,12,0,20,8
1746575627259,LIGM 5B,A00,896260,Fischer-Grunski; Eva K,17,0,20,3
1746575628284,LIGM 5C,A00,896308,Fischer-Grunski; Eva K,18,0,20,2
1746575629308,LIIT 5AS,A00,896313,Carnelos; Chiara,18,0,20,2
1746575630332,LIIT 5BS,A00,896416,Carnelos; Chiara,20,0,20,0
1746575631356,LIIT 5CS,A00,896564,Carnelos; Chiara,20,0,20,0
1746575632381,LISP 5A,A00,896588,Munoz Sanchez; Alicia,2,0,20,18
1746575633407,LISP 5B,A00,896653,Munoz Sanchez; Alicia,7,0,20,13
1746575634435,LISP 5C,A00,896655,Munoz Sanchez; Alicia,0,1,20,20
1746575635459,MAE 197,001,957918,Kleissl; Jan,9996,0,9999,3
1746575635459,MAE 197,002,959806,Boechler; Nicholas Sebastia,9998,0,9999,1
1746575635459,MAE 197,003,959852,Mullin; Jennifer S,9998,0,9999,1
1746575636484,MATH 2,A01,957937,Staff,33,0,35,2
1746575637508,MATH 197,001,957876,Kedlaya; Kiran S.,9993,0,9999,6
1746575638535,MCWP 40,A00,892729,Duru; Nur,10,0,20,10
1746575638535,MCWP 40,B00,893304,Montejo; Carolina,14,0,20,6
1746575639561,MCWP 40R,A00,893757,Redela; Pamela Morgan,0,5,20,20
1746575640587,MCWP 50,A00,893758,Morshed; Michael James,0,0,20,20
1746575640587,MCWP 50,B00,893761,Bartulis; Jason Michael,17,0,20,3
1746575641611,MCWP 50R,A00,893766,Compas; Sean Matthew,0,1,20,20
1746575641611,MCWP 50R,B00,893769,Carter; Jennifer A,0,1,20,20
1746575641611,MCWP 50R,C00,893771,Krone; Jarret,0,3,20,20
1746575641611,MCWP 50R,D00,893772,Miller; Elizabeth Deen,0,0,20,20
1746575641611,MCWP 50R,E00,893775,Carter; Andrea L,0,1,20,20
1746575642639,MMW 11R,A01,892721,Herbst; Matthew,14,0,30,16
1746575642639,MMW 11R,A02,892722,Herbst; Matthew,0,0,0,3
1746575643663,MMW 12R,A01,892724,Herbst; Matthew,0,11,16,16
1746575643663,MMW 12R,A02,892725,Herbst; Matthew,0,10,16,16
1746575644688,MMW 13R,A01,892727,Staff,0,4,16,16
1746575644688,MMW 13R,A02,892728,Staff,0,4,16,16
1746575644688,MMW 13R,A03,958032,Staff,0,4,16,16
1746575644688,MMW 13R,A04,958033,Staff,0,4,16,16
1746575644688,MMW 13R,A05,958034,Staff,0,4,16,16
1746575645713,SIO 295LS,A00,894015,Staff,5,0,25,20
1746575646739,SIO 295S,A00,894020,Staff,5,0,25,20
1746575647766,SIOC 290S,B01,958918,Merrifield; Mark A,14,0,30,16
1746575648796,SIOC 291S,B01,958922,Gabriel; Corey John,14,0,30,16
1746575649821,SOCI 117,A01,895339,Staff,3,0,5,2
1746575650850,WES 237B,A00,894149,Staff,11,0,20,9
1746575652920,AESE 279B,A00,891859,Staff,13,0,35,22
1746575653946,AIP 197,001,891854,Vespa; Emanuel Ignacio,9999,0,9999,0
1746575654978,ANTH 289S,A00,891856,Gagneux; Pascal,12,0,12,0
1746575656008,BENG 196,001,957946,Engler; Adam J.,9996,0,9999,3
1746575657032,BISP 197,001,959851,Wilhelm; James E.,9998,0,9999,1
1746575658059,CAT 124RS,A01,956906,Staff,6,0,25,19
1746575659085,CAT 125RS,A01,922013,Staff,6,0,25,19
1746575660113,CLRE 250,A00,891860,Morris; Sheldon,9995,0,9999,4
1746575662163,CLRE 251R,A00,907817,Mehta; Ravindra L.,9994,0,9999,5
1746575663189,CLRE 252,A00,891864,Cuomo; Raphael Eduardo,9993,0,9999,6
1746575664212,CLRE 253,A00,891867,Vaida; Florin,9994,0,9999,5
1746575664212,CLRE 253,B00,907819,Staff,9999,0,9999,0
1746575665239,CLRE 259,A00,891868,Patel; Hemal,9998,0,9999,1
1746575666265,CLRE 260,A00,891872,Cuomo; Raphael Eduardo,9999,0,9999,0
1746575667291,CLRE 297,001,891888,Cuomo; Raphael Eduardo,9999,0,9999,0
1746575668318,CSE 191,A00,958773,Minnes Kemp; Mor Mia,9995,0,9999,4
1746575669347,CSE 197,001,959846,Minnes Kemp; Mor Mia,9990,0,9999,9
1746575670376,CSS 201S,A01,892054,Mignozzetti; Umberto,25,0,30,5
1746575671401,CSS 202S,A01,892056,Mignozzetti; Umberto,25,0,30,5
1746575672429,DSC 197,001,956898,Eldridge; Justin Matthew,9996,0,9999,3
1746575673456,DSC 297,001,958000,Mazumdar; Arya,9998,0,9999,1
1746575673456,DSC 297,002,959862,Wang; Yusu,9998,0,9999,1
1746575674479,EAP 100,A00,905686,Staff,9778,0,9999,221
1746575675506,ECE 45,A01,892618,Staff,0,0,65,65
1746575677554,ECE 111,A01,892719,Staff,5,0,65,60
1746575678578,ECE 197,001,957920,Mercier; Patrick Philip,9991,0,9999,8
1746575679607,ECON 178,A01,907814,Zhu; Ying,26,0,35,9
1746575680631,EDS 115,A00,895312,Staff,35,0,45,10
1746575681656,EDS 117,A01,895337,Staff,23,0,30,7
1746575682679,EDS 125,A00,895341,Jones; Gabrielle Anastasia,36,0,45,9
1746575683711,EDS 128A,A01,895459,Fargason; Sharon Gayle,44,0,45,1
1746575684737,EDS 128B,A01,895543,Pappas; Elizabeth,44,0,45,1
1746575685765,EDS 139,A00,897203,Pappas; Elizabeth,44,0,45,1
1746575685765,EDS 139,B00,897209,Fargason; Sharon Gayle,41,0,45,4
1746575686790,EDS 201,A00,895545,Staff,22,0,45,23
1746575687818,EDS 203,A01,895581,Halter; Christopher P.,22,0,45,23
1746575688842,EDS 204R,A01,895625,Heinzman; Erica M.,39,0,45,6
1746575688842,EDS 204R,B01,895693,Halter; Christopher P.,10,0,45,35
1746575689867,EDS 206R,A00,895694,Fargason; Sharon Gayle,1,0,30,29
1746575689867,EDS 206R,B00,895695,Choi; Bailey Miyeon,16,0,30,14
1746575690894,EDS 250,A00,895697,Hemans; Patricia Ann Benitez,22,0,45,23
1746575691918,EDS 281,A00,895701,Meyerott; Theresa Ann,1,0,15,14
1746575692944,EDS 284,A00,895736,Meyerott; Theresa Ann,1,0,15,14
1746575693970,EDS 286,A00,897210,Fine; Sarah,0,0,15,15
1746575694995,EDS 289C,A01,895770,Daly; Alan J.,1,0,15,14
1746575696021,EDS 290,A00,897211,Hofstetter; Carolyn,0,0,15,15
1746575697058,LIGM 5A,A00,896162,Fischer-Grunski; Eva K,12,0,20,8
1746575698082,LIGM 5B,A00,896260,Fischer-Grunski; Eva K,17,0,20,3
1746575699108,LIGM 5C,A00,896308,Fischer-Grunski; Eva K,18,0,20,2
1746575700132,LIIT 5AS,A00,896313,Carnelos; Chiara,18,0,20,2
1746575701157,LIIT 5BS,A00,896416,Carnelos; Chiara,20,0,20,0
1746575702181,LIIT 5CS,A00,896564,Carnelos; Chiara,20,0,20,0
1746575703207,LISP 5A,A00,896588,Munoz Sanchez; Alicia,2,0,20,18
1746575704235,LISP 5B,A00,896653,Munoz Sanchez; Alicia,7,0,20,13
1746575705260,LISP 5C,A00,896655,Munoz Sanchez; Alicia,0,1,20,20
1746575706286,MAE 197,001,957918,Kleissl; Jan,9996,0,9999,3
1746575706286,MAE 197,002,959806,Boechler; Nicholas Sebastia,9998,0,9999,1
1746575706286,MAE 197,003,959852,Mullin; Jennifer S,9998,0,9999,1
1746575707312,MATH 2,A01,957937,Staff,33,0,35,2
1746575708337,MATH 197,001,957876,Kedlaya; Kiran S.,9993,0,9999,6
1746575709365,MCWP 40,A00,892729,Duru; Nur,10,0,20,10
1746575709365,MCWP 40,B00,893304,Montejo; Carolina,14,0,20,6
1746575710391,MCWP 40R,A00,893757,Redela; Pamela Morgan,0,5,20,20
1746575711419,MCWP 50,A00,893758,Morshed; Michael James,0,0,20,20
1746575711419,MCWP 50,B00,893761,Bartulis; Jason Michael,17,0,20,3
1746575712445,MCWP 50R,A00,893766,Compas; Sean Matthew,0,1,20,20
1746575712445,MCWP 50R,B00,893769,Carter; Jennifer A,0,1,20,20
1746575712445,MCWP 50R,C00,893771,Krone; Jarret,0,3,20,20
1746575712445,MCWP 50R,D00,893772,Miller; Elizabeth Deen,0,0,20,20
1746575712445,MCWP 50R,E00,893775,Carter; Andrea L,0,1,20,20
1746575713472,MMW 11R,A01,892721,Herbst; Matthew,14,0,30,16
1746575713472,MMW 11R,A02,892722,Herbst; Matthew,0,0,0,3
1746575714498,MMW 12R,A01,892724,Herbst; Matthew,0,11,16,16
1746575714498,MMW 12R,A02,892725,Herbst; Matthew,0,10,16,16
1746575715524,MMW 13R,A01,892727,Staff,0,4,16,16
1746575715524,MMW 13R,A02,892728,Staff,0,4,16,16
1746575715524,MMW 13R,A03,958032,Staff,0,4,16,16
1746575715524,MMW 13R,A04,958033,Staff,0,4,16,16
1746575715524,MMW 13R,A05,958034,Staff,0,4,16,16
1746575716548,SIO 295LS,A00,894015,Staff,5,0,25,20
1746575717572,SIO 295S,A00,894020,Staff,5,0,25,20
1746575718600,SIOC 290S,B01,958918,Merrifield; Mark A,14,0,30,16
1746575719625,SIOC 291S,B01,958922,Gabriel; Corey John,14,0,30,16
1746575720648,SOCI 117,A01,895339,Staff,3,0,5,2
1746575721674,WES 237B,A00,894149,Staff,11,0,20,9
1746575723733,AESE 279B,A00,891859,Staff,13,0,35,22
1746575724756,AIP 197,001,891854,Vespa; Emanuel Ignacio,9999,0,9999,0
1746575725781,ANTH 289S,A00,891856,Gagneux; Pascal,12,0,12,0
1746575726804,BENG 196,001,957946,Engler; Adam J.,9996,0,9999,3
1746575727830,BISP 197,001,959851,Wilhelm; James E.,9998,0,9999,1
1746575728857,CAT 124RS,A01,956906,Staff,6,0,25,19
1746575729882,CAT 125RS,A01,922013,Staff,6,0,25,19
1746575731121,CLRE 250,A00,891860,Morris; Sheldon,9995,0,9999,4
1746575733177,CLRE 251R,A00,907817,Mehta; Ravindra L.,9994,0,9999,5
1746575734205,CLRE 252,A00,891864,Cuomo; Raphael Eduardo,9993,0,9999,6
1746575735229,CLRE 253,A00,891867,Vaida; Florin,9994,0,9999,5
1746575735229,CLRE 253,B00,907819,Staff,9999,0,9999,0
1746575736253,CLRE 259,A00,891868,Patel; Hemal,9998,0,9999,1
1746575737277,CLRE 260,A00,891872,Cuomo; Raphael Eduardo,9999,0,9999,0
1746575738305,CLRE 297,001,891888,Cuomo; Raphael Eduardo,9999,0,9999,0
1746575739331,CSE 191,A00,958773,Minnes Kemp; Mor Mia,9995,0,9999,4
1746575740359,CSE 197,001,959846,Minnes Kemp; Mor Mia,9990,0,9999,9
1746575741384,CSS 201S,A01,892054,Mignozzetti; Umberto,25,0,30,5
1746575742415,CSS 202S,A01,892056,Mignozzetti; Umberto,25,0,30,5
1746575743444,DSC 197,001,956898,Eldridge; Justin Matthew,9996,0,9999,3
1746575744472,DSC 297,001,958000,Mazumdar; Arya,9998,0,9999,1
1746575744472,DSC 297,002,959862,Wang; Yusu,9998,0,9999,1
1746575745500,EAP 100,A00,905686,Staff,9778,0,9999,221
1746575746526,ECE 45,A01,892618,Staff,0,0,65,65
1746575748581,ECE 111,A01,892719,Staff,5,0,65,60
1746575749605,ECE 197,001,957920,Mercier; Patrick Philip,9991,0,9999,8
1746575750631,ECON 178,A01,907814,Zhu; Ying,26,0,35,9
1746575751657,EDS 115,A00,895312,Staff,35,0,45,10
1746575752689,EDS 117,A01,895337,Staff,23,0,30,7
1746575753717,EDS 125,A00,895341,Jones; Gabrielle Anastasia,36,0,45,9
1746575754746,EDS 128A,A01,895459,Fargason; Sharon Gayle,44,0,45,1
1746575755769,EDS 128B,A01,895543,Pappas; Elizabeth,44,0,45,1
1746575756797,EDS 139,A00,897203,Pappas; Elizabeth,44,0,45,1
1746575756797,EDS 139,B00,897209,Fargason; Sharon Gayle,41,0,45,4
1746575757824,EDS 201,A00,895545,Staff,22,0,45,23
1746575758855,EDS 203,A01,895581,Halter; Christopher P.,22,0,45,23
1746575759879,EDS 204R,A01,895625,Heinzman; Erica M.,39,0,45,6
1746575759879,EDS 204R,B01,895693,Halter; Christopher P.,10,0,45,35
1746575760908,EDS 206R,A00,895694,Fargason; Sharon Gayle,1,0,30,29
1746575760908,EDS 206R,B00,895695,Choi; Bailey Miyeon,16,0,30,14
1746575761938,EDS 250,A00,895697,Hemans; Patricia Ann Benitez,22,0,45,23
1746575762961,EDS 281,A00,895701,Meyerott; Theresa Ann,1,0,15,14
1746575763988,EDS 284,A00,895736,Meyerott; Theresa Ann,1,0,15,14
1746575765036,EDS 286,A00,897210,Fine; Sarah,0,0,15,15
1746575766063,EDS 289C,A01,895770,Daly; Alan J.,1,0,15,14
1746575767092,EDS 290,A00,897211,Hofstetter; Carolyn,0,0,15,15
1746575768117,LIGM 5A,A00,896162,Fischer-Grunski; Eva K,12,0,20,8
1746575769156,LIGM 5B,A00,896260,Fischer-Grunski; Eva K,17,0,20,3
1746575770184,LIGM 5C,A00,896308,Fischer-Grunski; Eva K,18,0,20,2
1746575771212,LIIT 5AS,A00,896313,Carnelos; Chiara,18,0,20,2
1746575772237,LIIT 5BS,A00,896416,Carnelos; Chiara,20,0,20,0
1746575773261,LIIT 5CS,A00,896564,Carnelos; Chiara,20,0,20,0
1746575774289,LISP 5A,A00,896588,Munoz Sanchez; Alicia,2,0,20,18
1746575775316,LISP 5B,A00,896653,Munoz Sanchez; Alicia,7,0,20,13
1746575776343,LISP 5C,A00,896655,Munoz Sanchez; Alicia,0,1,20,20
1746575777371,MAE 197,001,957918,Kleissl; Jan,9996,0,9999,3
1746575777371,MAE 197,002,959806,Boechler; Nicholas Sebastia,9998,0,9999,1
1746575777371,MAE 197,003,959852,Mullin; Jennifer S,9998,0,9999,1
1746575778394,MATH 2,A01,957937,Staff,33,0,35,2
1746575779422,MATH 197,001,957876,Kedlaya; Kiran S.,9993,0,9999,6
1746575780447,MCWP 40,A00,892729,Duru; Nur,10,0,20,10
1746575780447,MCWP 40,B00,893304,Montejo; Carolina,14,0,20,6
1746575781472,MCWP 40R,A00,893757,Redela; Pamela Morgan,0,5,20,20
1746575782500,MCWP 50,A00,893758,Morshed; Michael James,0,0,20,20
1746575782500,MCWP 50,B00,893761,Bartulis; Jason Michael,17,0,20,3
1746575783525,MCWP 50R,A00,893766,Compas; Sean Matthew,0,1,20,20
1746575783525,MCWP 50R,B00,893769,Carter; Jennifer A,0,1,20,20
1746575783525,MCWP 50R,C00,893771,Krone; Jarret,0,3,20,20
1746575783525,MCWP 50R,D00,893772,Miller; Elizabeth Deen,0,0,20,20
1746575783525,MCWP 50R,E00,893775,Carter; Andrea L,0,1,20,20
1746575784554,MMW 11R,A01,892721,Herbst; Matthew,14,0,30,16
1746575784554,MMW 11R,A02,892722,Herbst; Matthew,0,0,0,3
1746575785578,MMW 12R,A01,892724,Herbst; Matthew,0,11,16,16
1746575785578,MMW 12R,A02,892725,Herbst; Matthew,0,10,16,16
1746575786602,MMW 13R,A01,892727,Staff,0,4,16,16
1746575786602,MMW 13R,A02,892728,Staff,0,4,16,16
1746575786602,MMW 13R,A03,958032,Staff,0,4,16,16
1746575786602,MMW 13R,A04,958033,Staff,0,4,16,16
1746575786602,MMW 13R,A05,958034,Staff,0,4,16,16
1746575787629,SIO 295LS,A00,894015,Staff,5,0,25,20
1746575788659,SIO 295S,A00,894020,Staff,5,0,25,20
1746575789686,SIOC 290S,B01,958918,Merrifield; Mark A,14,0,30,16
1746575790713,SIOC 291S,B01,958922,Gabriel; Corey John,14,0,30,16
1746575791742,SOCI 117,A01,895339,Staff,3,0,5,2
1746575792769,WES 237B,A00,894149,Staff,11,0,20,9
1746575794827,AESE 279B,A00,891859,Staff,13,0,35,22
1746575795851,AIP 197,001,891854,Vespa; Emanuel Ignacio,9999,0,9999,0
1746575796878,ANTH 289S,A00,891856,Gagneux; Pascal,12,0,12,0
1746575797906,BENG 196,001,957946,Engler; Adam J.,9996,0,9999,3
1746575798932,BISP 197,001,959851,Wilhelm; James E.,9998,0,9999,1
1746575799959,CAT 124RS,A01,956906,Staff,6,0,25,19
1746575800987,CAT 125RS,A01,922013,Staff,6,0,25,19
1746575802015,CLRE 250,A00,891860,Morris; Sheldon,9995,0,9999,4
1746575804066,CLRE 251R,A00,907817,Mehta; Ravindra L.,9994,0,9999,5
1746575805095,CLRE 252,A00,891864,Cuomo; Raphael Eduardo,9993,0,9999,6
1746575806122,CLRE 253,A00,891867,Vaida; Florin,9994,0,9999,5
1746575806122,CLRE 253,B00,907819,Staff,9999,0,9999,0
1746575807149,CLRE 259,A00,891868,Patel; Hemal,9998,0,9999,1
1746575808177,CLRE 260,A00,891872,Cuomo; Raphael Eduardo,9999,0,9999,0
1746575809200,CLRE 297,001,891888,Cuomo; Raphael Eduardo,9999,0,9999,0
1746575810226,CSE 191,A00,958773,Minnes Kemp; Mor Mia,9995,0,9999,4
1746575811251,CSE 197,001,959846,Minnes Kemp; Mor Mia,9990,0,9999,9
1746575812279,CSS 201S,A01,892054,Mignozzetti; Umberto,25,0,30,5
1746575813305,CSS 202S,A01,892056,Mignozzetti; Umberto,25,0,30,5
1746575814330,DSC 197,001,956898,Eldridge; Justin Matthew,9996,0,9999,3
1746575815355,DSC 297,001,958000,Mazumdar; Arya,9998,0,9999,1
1746575815355,DSC 297,002,959862,Wang; Yusu,9998,0,9999,1
1746575816379,EAP 100,A00,905686,Staff,9778,0,9999,221
1746575817407,ECE 45,A01,892618,Staff,0,0,65,65
1746575819456,ECE 111,A01,892719,Staff,5,0,65,60
1746575820485,ECE 197,001,957920,Mercier; Patrick Philip,9991,0,9999,8
1746575821513,ECON 178,A01,907814,Zhu; Ying,26,0,35,9
1746575822540,EDS 115,A00,895312,Staff,35,0,45,10
1746575823565,EDS 117,A01,895337,Staff,23,0,30,7
1746575824589,EDS 125,A00,895341,Jones; Gabrielle Anastasia,36,0,45,9
1746575825616,EDS 128A,A01,895459,Fargason; Sharon Gayle,44,0,45,1
1746575826642,EDS 128B,A01,895543,Pappas; Elizabeth,44,0,45,1
1746575827669,EDS 139,A00,897203,Pappas; Elizabeth,44,0,45,1
1746575827669,EDS 139,B00,897209,Fargason; Sharon Gayle,41,0,45,4
1746575828698,EDS 201,A00,895545,Staff,22,0,45,23
1746575829722,EDS 203,A01,895581,Halter; Christopher P.,22,0,45,23
1746575830752,EDS 204R,A01,895625,Heinzman; Erica M.,39,0,45,6
1746575830752,EDS 204R,B01,895693,Halter; Christopher P.,10,0,45,35
1746575831776,EDS 206R,A00,895694,Fargason; Sharon Gayle,1,0,30,29
1746575831776,EDS 206R,B00,895695,Choi; Bailey Miyeon,16,0,30,14
1746575832801,EDS 250,A00,895697,Hemans; Patricia Ann Benitez,22,0,45,23
1746575833828,EDS 281,A00,895701,Meyerott; Theresa Ann,1,0,15,14
1746575834857,EDS 284,A00,895736,Meyerott; Theresa Ann,1,0,15,14
1746575835883,EDS 286,A00,897210,Fine; Sarah,0,0,15,15
1746575836912,EDS 289C,A01,895770,Daly; Alan J.,1,0,15,14
1746575837936,EDS 290,A00,897211,Hofstetter; Carolyn,0,0,15,15
1746575838964,LIGM 5A,A00,896162,Fischer-Grunski; Eva K,12,0,20,8
1746575839996,LIGM 5B,A00,896260,Fischer-Grunski; Eva K,17,0,20,3
1746575841020,LIGM 5C,A00,896308,Fischer-Grunski; Eva K,18,0,20,2
1746575842045,LIIT 5AS,A00,896313,Carnelos; Chiara,18,0,20,2
1746575843076,LIIT 5BS,A00,896416,Carnelos; Chiara,20,0,20,0
1746575844100,LIIT 5CS,A00,896564,Carnelos; Chiara,20,0,20,0
1746575845130,LISP 5A,A00,896588,Munoz Sanchez; Alicia,2,0,20,18
1746575846156,LISP 5B,A00,896653,Munoz Sanchez; Alicia,7,0,20,13
1746575847184,LISP 5C,A00,896655,Munoz Sanchez; Alicia,0,1,20,20
1746575848210,MAE 197,001,957918,Kleissl; Jan,9996,0,9999,3
1746575848210,MAE 197,002,959806,Boechler; Nicholas Sebastia,9998,0,9999,1
1746575848210,MAE 197,003,959852,Mullin; Jennifer S,9998,0,9999,1
1746575849235,MATH 2,A01,957937,Staff,33,0,35,2
1746575850262,MATH 197,001,957876,Kedlaya; Kiran S.,9993,0,9999,6
1746575851289,MCWP 40,A00,892729,Duru; Nur,10,0,20,10
1746575851289,MCWP 40,B00,893304,Montejo; Carolina,14,0,20,6
1746575852318,MCWP 40R,A00,893757,Redela; Pamela Morgan,0,5,20,20
1746575853344,MCWP 50,A00,893758,Morshed; Michael James,0,0,20,20
1746575853344,MCWP 50,B00,893761,Bartulis; Jason Michael,17,0,20,3
1746575854368,MCWP 50R,A00,893766,Compas; Sean Matthew,0,1,20,20
1746575854368,MCWP 50R,B00,893769,Carter; Jennifer A,0,1,20,20
1746575854368,MCWP 50R,C00,893771,Krone; Jarret,0,3,20,20
1746575854368,MCWP 50R,D00,893772,Miller; Elizabeth Deen,0,0,20,20
1746575854368,MCWP 50R,E00,893775,Carter; Andrea L,0,1,20,20
1746575855393,MMW 11R,A01,892721,Herbst; Matthew,14,0,30,16
1746575855393,MMW 11R,A02,892722,Herbst; Matthew,0,0,0,3
1746575856417,MMW 12R,A01,892724,Herbst; Matthew,0,11,16,16
1746575856417,MMW 12R,A02,892725,Herbst; Matthew,0,10,16,16
1746575857447,MMW 13R,A01,892727,Staff,0,4,16,16
1746575857447,MMW 13R,A02,892728,Staff,0,4,16,16
1746575857447,MMW 13R,A03,958032,Staff,0,4,16,16
1746575857447,MMW 13R,A04,958033,Staff,0,4,16,16
1746575857447,MMW 13R,A05,958034,Staff,0,4,16,16
1746575858470,SIO 295LS,A00,894015,Staff,5,0,25,20
1746575859496,SIO 295S,A00,894020,Staff,5,0,25,20
1746575860525,SIOC 290S,B01,958918,Merrifield; Mark A,14,0,30,16
1746575861552,SIOC 291S,B01,958922,Gabriel; Corey John,14,0,30,16
1746575862579,SOCI 117,A01,895339,Staff,3,0,5,2
1746575863604,WES 237B,A00,894149,Staff,11,0,20,9
1746575865662,AESE 279B,A00,891859,Staff,13,0,35,22
1746575866689,AIP 197,001,891854,Vespa; Emanuel Ignacio,9999,0,9999,0
1746575867721,ANTH 289S,A00,891856,Gagneux; Pascal,12,0,12,0
1746575868747,BENG 196,001,957946,Engler; Adam J.,9996,0,9999,3
1746575869775,BISP 197,001,959851,Wilhelm; James E.,9998,0,9999,1
1746575870802,CAT 124RS,A01,956906,Staff,6,0,25,19
1746575871829,CAT 125RS,A01,922013,Staff,6,0,25,19
1746575872856,CLRE 250,A00,891860,Morris; Sheldon,9995,0,9999,4
1746575874906,CLRE 251R,A00,907817,Mehta; Ravindra L.,9994,0,9999,5
1746575875936,CLRE 252,A00,891864,Cuomo; Raphael Eduardo,9993,0,9999,6
1746575876965,CLRE 253,A00,891867,Vaida; Florin,9994,0,9999,5
1746575876965,CLRE 253,B00,907819,Staff,9999,0,9999,0
1746575877989,CLRE 259,A00,891868,Patel; Hemal,9998,0,9999,1
1746575879017,CLRE 260,A00,891872,Cuomo; Raphael Eduardo,9999,0,9999,0
1746575880042,CLRE 297,001,891888,Cuomo; Raphael Eduardo,9999,0,9999,0
1746575881067,CSE 191,A00,958773,Minnes Kemp; Mor Mia,9995,0,9999,4
1746575882092,CSE 197,001,959846,Minnes Kemp; Mor Mia,9990,0,9999,9
1746575883121,CSS 201S,A01,892054,Mignozzetti; Umberto,25,0,30,5
1746575884147,CSS 202S,A01,892056,Mignozzetti; Umberto,25,0,30,5
1746575885171,DSC 197,001,956898,Eldridge; Justin Matthew,9996,0,9999,3
1746575886196,DSC 297,001,958000,Mazumdar; Arya,9998,0,9999,1
1746575886196,DSC 297,002,959862,Wang; Yusu,9998,0,9999,1
1746575887225,EAP 100,A00,905686,Staff,9778,0,9999,221
1746575888256,ECE 45,A01,892618,Staff,0,0,65,65
1746575890313,ECE 111,A01,892719,Staff,5,0,65,60
1746575891339,ECE 197,001,957920,Mercier; Patrick Philip,9991,0,9999,8
1746575892367,ECON 178,A01,907814,Zhu; Ying,26,0,35,9
1746575893396,EDS 115,A00,895312,Staff,35,0,45,10
1746575894422,EDS 117,A01,895337,Staff,23,0,30,7
1746575895446,EDS 125,A00,895341,Jones; Gabrielle Anastasia,36,0,45,9
1746575896470,EDS 128A,A01,895459,Fargason; Sharon Gayle,44,0,45,1
1746575897497,EDS 128B,A01,895543,Pappas; Elizabeth,44,0,45,1
1746575898526,EDS 139,A00,897203,Pappas; Elizabeth,44,0,45,1
1746575898526,EDS 139,B00,897209,Fargason; Sharon Gayle,41,0,45,4
1746575899554,EDS 201,A00,895545,Staff,22,0,45,23
1746575900583,EDS 203,A01,895581,Halter; Christopher P.,22,0,45,23
1746575901611,EDS 204R,A01,895625,Heinzman; Erica M.,39,0,45,6
1746575901611,EDS 204R,B01,895693,Halter; Christopher P.,10,0,45,35
1746575902643,EDS 206R,A00,895694,Fargason; Sharon Gayle,1,0,30,29
1746575902643,EDS 206R,B00,895695,Choi; Bailey Miyeon,16,0,30,14
1746575903668,EDS 250,A00,895697,Hemans; Patricia Ann Benitez,22,0,45,23
1746575904694,EDS 281,A00,895701,Meyerott; Theresa Ann,1,0,15,14
1746575905720,EDS 284,A00,895736,Meyerott; Theresa Ann,1,0,15,14
1746575906743,EDS 286,A00,897210,Fine; Sarah,0,0,15,15
1746575907768,EDS 289C,A01,895770,Daly; Alan J.,1,0,15,14
1746575908793,EDS 290,A00,897211,Hofstetter; Carolyn,0,0,15,15
1746575909820,LIGM 5A,A00,896162,Fischer-Grunski; Eva K,12,0,20,8
1746575910846,LIGM 5B,A00,896260,Fischer-Grunski; Eva K,17,0,20,3
1746575911874,LIGM 5C,A00,896308,Fischer-Grunski; Eva K,18,0,20,2
1746575912900,LIIT 5AS,A00,896313,Carnelos; Chiara,18,0,20,2
1746575913927,LIIT 5BS,A00,896416,Carnelos; Chiara,20,0,20,0
1746575914952,LIIT 5CS,A00,896564,Carnelos; Chiara,20,0,20,0
1746575915982,LISP 5A,A00,896588,Munoz Sanchez; Alicia,2,0,20,18
1746575917008,LISP 5B,A00,896653,Munoz Sanchez; Alicia,7,0,20,13
1746575918038,LISP 5C,A00,896655,Munoz Sanchez; Alicia,0,1,20,20
1746575919065,MAE 197,001,957918,Kleissl; Jan,9996,0,9999,3
1746575919065,MAE 197,002,959806,Boechler; Nicholas Sebastia,9998,0,9999,1
1746575919065,MAE 197,003,959852,Mullin; Jennifer S,9998,0,9999,1
1746575920090,MATH 2,A01,957937,Staff,33,0,35,2
1746575921115,MATH 197,001,957876,Kedlaya; Kiran S.,9993,0,9999,6
1746575922139,MCWP 40,A00,892729,Duru; Nur,10,0,20,10
1746575922139,MCWP 40,B00,893304,Montejo; Carolina,14,0,20,6
1746575923167,MCWP 40R,A00,893757,Redela; Pamela Morgan,0,5,20,20
1746575924196,MCWP 50,A00,893758,Morshed; Michael James,0,0,20,20
1746575924196,MCWP 50,B00,893761,Bartulis; Jason Michael,17,0,20,3
1746575925227,MCWP 50R,A00,893766,Compas; Sean Matthew,0,1,20,20
1746575925227,MCWP 50R,B00,893769,Carter; Jennifer A,0,1,20,20
1746575925227,MCWP 50R,C00,893771,Krone; Jarret,0,3,20,20
1746575925227,MCWP 50R,D00,893772,Miller; Elizabeth Deen,0,0,20,20
1746575925227,MCWP 50R,E00,893775,Carter; Andrea L,0,1,20,20
1746575926255,MMW 11R,A01,892721,Herbst; Matthew,14,0,30,16
1746575926255,MMW 11R,A02,892722,Herbst; Matthew,0,0,0,3
1746575927279,MMW 12R,A01,892724,Herbst; Matthew,0,11,16,16
1746575927279,MMW 12R,A02,892725,Herbst; Matthew,0,10,16,16
1746575928308,MMW 13R,A01,892727,Staff,0,4,16,16
1746575928308,MMW 13R,A02,892728,Staff,0,4,16,16
1746575928308,MMW 13R,A03,958032,Staff,0,4,16,16
1746575928308,MMW 13R,A04,958033,Staff,0,4,16,16
1746575928308,MMW 13R,A05,958034,Staff,0,4,16,16
1746575929337,SIO 295LS,A00,894015,Staff,5,0,25,20
1746575930362,SIO 295S,A00,894020,Staff,5,0,25,20
1746575931393,SIOC 290S,B01,958918,Merrifield; Mark A,14,0,30,16
1746575932420,SIOC 291S,B01,958922,Gabriel; Corey John,14,0,30,16
1746575933448,SOCI 117,A01,895339,Staff,3,0,5,2
1746575934475,WES 237B,A00,894149,Staff,11,0,20,9
1746575936534,AESE 279B,A00,891859,Staff,13,0,35,22
1746575937559,AIP 197,001,891854,Vespa; Emanuel Ignacio,9999,0,9999,0
1746575938586,ANTH 289S,A00,891856,Gagneux; Pascal,12,0,12,0
1746575939611,BENG 196,001,957946,Engler; Adam J.,9996,0,9999,3
1746575940639,BISP 197,001,959851,Wilhelm; James E.,9998,0,9999,1
1746575941668,CAT 124RS,A01,956906,Staff,6,0,25,19
1746575942696,CAT 125RS,A01,922013,Staff,6,0,25,19
1746575943720,CLRE 250,A00,891860,Morris; Sheldon,9995,0,9999,4
1746575945800,CLRE 251R,A00,907817,Mehta; Ravindra L.,9994,0,9999,5
1746575946824,CLRE 252,A00,891864,Cuomo; Raphael Eduardo,9993,0,9999,6
1746575947848,CLRE 253,A00,891867,Vaida; Florin,9994,0,9999,5
1746575947848,CLRE 253,B00,907819,Staff,9999,0,9999,0
1746575948873,CLRE 259,A00,891868,Patel; Hemal,9998,0,9999,1
1746575949900,CLRE 260,A00,891872,Cuomo; Raphael Eduardo,9999,0,9999,0
1746575950926,CLRE 297,001,891888,Cuomo; Raphael Eduardo,9999,0,9999,0
1746575951949,CSE 191,A00,958773,Minnes Kemp; Mor Mia,9995,0,9999,4
1746575952974,CSE 197,001,959846,Minnes Kemp; Mor Mia,9990,0,9999,9
1746575953999,CSS 201S,A01,892054,Mignozzetti; Umberto,25,0,30,5
1746575955031,CSS 202S,A01,892056,Mignozzetti; Umberto,25,0,30,5
1746575956058,DSC 197,001,956898,Eldridge; Justin Matthew,9996,0,9999,3
1746575957085,DSC 297,001,958000,Mazumdar; Arya,9998,0,9999,1
1746575957085,DSC 297,002,959862,Wang; Yusu,9998,0,9999,1
1746575958111,EAP 100,A00,905686,Staff,9778,0,9999,221
1746575959136,ECE 45,A01,892618,Staff,0,0,65,65
1746575961183,ECE 111,A01,892719,Staff,5,0,65,60
1746575962208,ECE 197,001,957920,Mercier; Patrick Philip,9991,0,9999,8
1746575963232,ECON 178,A01,907814,Zhu; Ying,26,0,35,9
1746575964258,EDS 115,A00,895312,Staff,35,0,45,10
1746575965283,EDS 117,A01,895337,Staff,23,0,30,7
1746575966313,EDS 125,A00,895341,Jones; Gabrielle Anastasia,36,0,45,9
1746575967345,EDS 128A,A01,895459,Fargason; Sharon Gayle,44,0,45,1
1746575968368,EDS 128B,A01,895543,Pappas; Elizabeth,44,0,45,1
1746575969393,EDS 139,A00,897203,Pappas; Elizabeth,44,0,45,1
1746575969393,EDS 139,B00,897209,Fargason; Sharon Gayle,41,0,45,4
1746575970419,EDS 201,A00,895545,Staff,22,0,45,23
1746575971445,EDS 203,A01,895581,Halter; Christopher P.,22,0,45,23
1746575972470,EDS 204R,A01,895625,Heinzman; Erica M.,39,0,45,6
1746575972470,EDS 204R,B01,895693,Halter; Christopher P.,10,0,45,35
1746575973495,EDS 206R,A00,895694,Fargason; Sharon Gayle,1,0,30,29
1746575973495,EDS 206R,B00,895695,Choi; Bailey Miyeon,16,0,30,14
1746575974520,EDS 250,A00,895697,Hemans; Patricia Ann Benitez,22,0,45,23
1746575975551,EDS 281,A00,895701,Meyerott; Theresa Ann,1,0,15,14
1746575976574,EDS 284,A00,895736,Meyerott; Theresa Ann,1,0,15,14
1746575977602,EDS 286,A00,897210,Fine; Sarah,0,0,15,15
1746575978631,EDS 289C,A01,895770,Daly; Alan J.,1,0,15,14
1746575979656,EDS 290,A00,897211,Hofstetter; Carolyn,0,0,15,15
1746575980680,LIGM 5A,A00,896162,Fischer-Grunski; Eva K,12,0,20,8
1746575981707,LIGM 5B,A00,896260,Fischer-Grunski; Eva K,17,0,20,3
1746575982737,LIGM 5C,A00,896308,Fischer-Grunski; Eva K,18,0,20,2
1746575983762,LIIT 5AS,A00,896313,Carnelos; Chiara,18,0,20,2
1746575984793,LIIT 5BS,A00,896416,Carnelos; Chiara,20,0,20,0
1746575985818,LIIT 5CS,A00,896564,Carnelos; Chiara,20,0,20,0
1746575986843,LISP 5A,A00,896588,Munoz Sanchez; Alicia,2,0,20,18
1746575987873,LISP 5B,A00,896653,Munoz Sanchez; Alicia,7,0,20,13
1746575988899,LISP 5C,A00,896655,Munoz Sanchez; Alicia,0,1,20,20
1746575989923,MAE 197,001,957918,Kleissl; Jan,9996,0,9999,3
1746575989923,MAE 197,002,959806,Boechler; Nicholas Sebastia,9998,0,9999,1
1746575989923,MAE 197,003,959852,Mullin; Jennifer S,9998,0,9999,1
1746575990948,MATH 2,A01,957937,Staff,33,0,35,2
1746575991974,MATH 197,001,957876,Kedlaya; Kiran S.,9993,0,9999,6
1746575993002,MCWP 40,A00,892729,Duru; Nur,10,0,20,10
1746575993002,MCWP 40,B00,893304,Montejo; Carolina,14,0,20,6
1746575994028,MCWP 40R,A00,893757,Redela; Pamela Morgan,0,5,20,20
1746575995057,MCWP 50,A00,893758,Morshed; Michael James,0,0,20,20
1746575995057,MCWP 50,B00,893761,Bartulis; Jason Michael,17,0,20,3
1746575996085,MCWP 50R,A00,893766,Compas; Sean Matthew,0,1,20,20
1746575996085,MCWP 50R,B00,893769,Carter; Jennifer A,0,1,20,20
1746575996085,MCWP 50R,C00,893771,Krone; Jarret,0,3,20,20
1746575996085,MCWP 50R,D00,893772,Miller; Elizabeth Deen,0,0,20,20
1746575996085,MCWP 50R,E00,893775,Carter; Andrea L,0,1,20,20
1746575997110,MMW 11R,A01,892721,Herbst; Matthew,14,0,30,16
1746575997110,MMW 11R,A02,892722,Herbst; Matthew,0,0,0,3
1746575998136,MMW 12R,A01,892724,Herbst; Matthew,0,11,16,16
1746575998136,MMW 12R,A02,892725,Herbst; Matthew,0,10,16,16
1746575999166,MMW 13R,A01,892727,Staff,0,4,16,16
1746575999166,MMW 13R,A02,892728,Staff,0,4,16,16
1746575999166,MMW 13R,A03,958032,Staff,0,4,16,16
1746575999166,MMW 13R,A04,958033,Staff,0,4,16,16
1746575999166,MMW 13R,A05,958034,Staff,0,4,16,16
1746576000194,SIO 295LS,A00,894015,Staff,5,0,25,20
1746576001219,SIO 295S,A00,894020,Staff,5,0,25,20
1746576002249,SIOC 290S,B01,958918,Merrifield; Mark A,14,0,30,16
1746576003335,SIOC 291S,B01,958922,Gabriel; Corey John,14,0,30,16
1746576004361,SOCI 117,A01,895339,Staff,3,0,5,2
1746576005390,WES 237B,A00,894149,Staff,11,0,20,9
1746576007487,AESE 279B,A00,891859,Staff,13,0,35,22
1746576008511,AIP 197,001,891854,Vespa; Emanuel Ignacio,9999,0,9999,0
1746576009537,ANTH 289S,A00,891856,Gagneux; Pascal,12,0,12,0
1746576010570,BENG 196,001,957946,Engler; Adam J.,9996,0,9999,3
1746576011600,BISP 197,001,959851,Wilhelm; James E.,9998,0,9999,1
1746576012634,CAT 124RS,A01,956906,Staff,6,0,25,19
1746576013661,CAT 125RS,A01,922013,Staff,6,0,25,19
1746576014687,CLRE 250,A00,891860,Morris; Sheldon,9995,0,9999,4
1746576016740,CLRE 251R,A00,907817,Mehta; Ravindra L.,9994,0,9999,5
1746576017768,CLRE 252,A00,891864,Cuomo; Raphael Eduardo,9993,0,9999,6
1746576018795,CLRE 253,A00,891867,Vaida; Florin,9994,0,9999,5
1746576018795,CLRE 253,B00,907819,Staff,9999,0,9999,0
1746576019819,CLRE 259,A00,891868,Patel; Hemal,9998,0,9999,1
1746576020844,CLRE 260,A00,891872,Cuomo; Raphael Eduardo,9999,0,9999,0
1746576021869,CLRE 297,001,891888,Cuomo; Raphael Eduardo,9999,0,9999,0
1746576022895,CSE 191,A00,958773,Minnes Kemp; Mor Mia,9995,0,9999,4
1746576023924,CSE 197,001,959846,Minnes Kemp; Mor Mia,9990,0,9999,9
1746576024948,CSS 201S,A01,892054,Mignozzetti; Umberto,25,0,30,5
1746576025973,CSS 202S,A01,892056,Mignozzetti; Umberto,25,0,30,5
1746576027003,DSC 197,001,956898,Eldridge; Justin Matthew,9996,0,9999,3
1746576028031,DSC 297,001,958000,Mazumdar; Arya,9998,0,9999,1
1746576028031,DSC 297,002,959862,Wang; Yusu,9998,0,9999,1
1746576029055,EAP 100,A00,905686,Staff,9778,0,9999,221
1746576030083,ECE 45,A01,892618,Staff,0,0,65,65
1746576032130,ECE 111,A01,892719,Staff,5,0,65,60
1746576033159,ECE 197,001,957920,Mercier; Patrick Philip,9991,0,9999,8
1746576034188,ECON 178,A01,907814,Zhu; Ying,26,0,35,9
1746576035213,EDS 115,A00,895312,Staff,35,0,45,10
1746576036240,EDS 117,A01,895337,Staff,23,0,30,7
1746576037269,EDS 125,A00,895341,Jones; Gabrielle Anastasia,36,0,45,9
1746576038298,EDS 128A,A01,895459,Fargason; Sharon Gayle,44,0,45,1
1746576039321,EDS 128B,A01,895543,Pappas; Elizabeth,44,0,45,1
1746576040346,EDS 139,A00,897203,Pappas; Elizabeth,44,0,45,1
1746576040346,EDS 139,B00,897209,Fargason; Sharon Gayle,41,0,45,4
1746576041371,EDS 201,A00,895545,Staff,22,0,45,23
1746576042406,EDS 203,A01,895581,Halter; Christopher P.,22,0,45,23
1746576043431,EDS 204R,A01,895625,Heinzman; Erica M.,39,0,45,6
1746576043431,EDS 204R,B01,895693,Halter; Christopher P.,10,0,45,35
1746576044463,EDS 206R,A00,895694,Fargason; Sharon Gayle,1,0,30,29
1746576044463,EDS 206R,B00,895695,Choi; Bailey Miyeon,16,0,30,14
1746576045491,EDS 250,A00,895697,Hemans; Patricia Ann Benitez,22,0,45,23
1746576046517,EDS 281,A00,895701,Meyerott; Theresa Ann,1,0,15,14
1746576047542,EDS 284,A00,895736,Meyerott; Theresa Ann,1,0,15,14
1746576048592,EDS 286,A00,897210,Fine; Sarah,0,0,15,15
1746576049620,EDS 289C,A01,895770,Daly; Alan J.,1,0,15,14
1746576050649,EDS 290,A00,897211,Hofstetter; Carolyn,0,0,15,15
1746576051673,LIGM 5A,A00,896162,Fischer-Grunski; Eva K,12,0,20,8
1746576052702,LIGM 5B,A00,896260,Fischer-Grunski; Eva K,17,0,20,3
1746576053727,LIGM 5C,A00,896308,Fischer-Grunski; Eva K,18,0,20,2
1746576054751,LIIT 5AS,A00,896313,Carnelos; Chiara,18,0,20,2
1746576055774,LIIT 5BS,A00,896416,Carnelos; Chiara,20,0,20,0
1746576056802,LIIT 5CS,A00,896564,Carnelos; Chiara,20,0,20,0
1746576057832,LISP 5A,A00,896588,Munoz Sanchez; Alicia,2,0,20,18
1746576058860,LISP 5B,A00,896653,Munoz Sanchez; Alicia,7,0,20,13
1746576059890,LISP 5C,A00,896655,Munoz Sanchez; Alicia,0,1,20,20
1746576060916,MAE 197,001,957918,Kleissl; Jan,9996,0,9999,3
1746576060916,MAE 197,002,959806,Boechler; Nicholas Sebastia,9998,0,9999,1
1746576060916,MAE 197,003,959852,Mullin; Jennifer S,9998,0,9999,1
1746576061956,MATH 2,A01,957937,Staff,33,0,35,2
1746576062980,MATH 197,001,957876,Kedlaya; Kiran S.,9993,0,9999,6
1746576064011,MCWP 40,A00,892729,Duru; Nur,10,0,20,10
1746576064011,MCWP 40,B00,893304,Montejo; Carolina,14,0,20,6
1746576065040,MCWP 40R,A00,893757,Redela; Pamela Morgan,0,5,20,20
1746576066065,MCWP 50,A00,893758,Morshed; Michael James,0,0,20,20
1746576066065,MCWP 50,B00,893761,Bartulis; Jason Michael,17,0,20,3
1746576067101,MCWP 50R,A00,893766,Compas; Sean Matthew,0,1,20,20
1746576067101,MCWP 50R,B00,893769,Carter; Jennifer A,0,1,20,20
1746576067101,MCWP 50R,C00,893771,Krone; Jarret,0,3,20,20
1746576067101,MCWP 50R,D00,893772,Miller; Elizabeth Deen,0,0,20,20
1746576067101,MCWP 50R,E00,893775,Carter; Andrea L,0,1,20,20
1746576068130,MMW 11R,A01,892721,Herbst; Matthew,14,0,30,16
1746576068130,MMW 11R,A02,892722,Herbst; Matthew,0,0,0,3
1746576069158,MMW 12R,A01,892724,Herbst; Matthew,0,11,16,16
1746576069158,MMW 12R,A02,892725,Herbst; Matthew,0,10,16,16
1746576070182,MMW 13R,A01,892727,Staff,0,4,16,16
1746576070182,MMW 13R,A02,892728,Staff,0,4,16,16
1746576070182,MMW 13R,A03,958032,Staff,0,4,16,16
1746576070182,MMW 13R,A04,958033,Staff,0,4,16,16
1746576070182,MMW 13R,A05,958034,Staff,0,4,16,16
1746576071211,SIO 295LS,A00,894015,Staff,5,0,25,20
1746576072238,SIO 295S,A00,894020,Staff,5,0,25,20
1746576073262,SIOC 290S,B01,958918,Merrifield; Mark A,14,0,30,16
1746576074291,SIOC 291S,B01,958922,Gabriel; Corey John,14,0,30,16
1746576075317,SOCI 117,A01,895339,Staff,3,0,5,2
1746576076343,WES 237B,A00,894149,Staff,11,0,20,9
1746576078400,AESE 279B,A00,891859,Staff,13,0,35,22
1746576079429,AIP 197,001,891854,Vespa; Emanuel Ignacio,9999,0,9999,0
1746576080454,ANTH 289S,A00,891856,Gagneux; Pascal,12,0,12,0
1746576081479,BENG 196,001,957946,Engler; Adam J.,9996,0,9999,3
1746576082508,BISP 197,001,959851,Wilhelm; James E.,9998,0,9999,1
1746576083532,CAT 124RS,A01,956906,Staff,6,0,25,19
1746576084555,CAT 125RS,A01,922013,Staff,6,0,25,19
1746576085579,CLRE 250,A00,891860,Morris; Sheldon,9995,0,9999,4
1746576087628,CLRE 251R,A00,907817,Mehta; Ravindra L.,9994,0,9999,5
1746576088654,CLRE 252,A00,891864,Cuomo; Raphael Eduardo,9993,0,9999,6
1746576089679,CLRE 253,A00,891867,Vaida; Florin,9994,0,9999,5
1746576089679,CLRE 253,B00,907819,Staff,9999,0,9999,0
1746576090704,CLRE 259,A00,891868,Patel; Hemal,9998,0,9999,1
1746576091733,CLRE 260,A00,891872,Cuomo; Raphael Eduardo,9999,0,9999,0
1746576092758,CLRE 297,001,891888,Cuomo; Raphael Eduardo,9999,0,9999,0
1746576093790,CSE 191,A00,958773,Minnes Kemp; Mor Mia,9995,0,9999,4
1746576094817,CSE 197,001,959846,Minnes Kemp; Mor Mia,9990,0,9999,9
1746576095844,CSS 201S,A01,892054,Mignozzetti; Umberto,25,0,30,5
1746576096870,CSS 202S,A01,892056,Mignozzetti; Umberto,25,0,30,5
1746576097896,DSC 197,001,956898,Eldridge; Justin Matthew,9996,0,9999,3
1746576098923,DSC 297,001,958000,Mazumdar; Arya,9998,0,9999,1
1746576098923,DSC 297,002,959862,Wang; Yusu,9998,0,9999,1
1746576099953,EAP 100,A00,905686,Staff,9778,0,9999,221
1746576100978,ECE 45,A01,892618,Staff,0,0,65,65
1746576103034,ECE 111,A01,892719,Staff,5,0,65,60
1746576104062,ECE 197,001,957920,Mercier; Patrick Philip,9991,0,9999,8
1746576105092,ECON 178,A01,907814,Zhu; Ying,26,0,35,9
1746576106117,EDS 115,A00,895312,Staff,35,0,45,10
1746576107142,EDS 117,A01,895337,Staff,23,0,30,7
1746576108166,EDS 125,A00,895341,Jones; Gabrielle Anastasia,36,0,45,9
1746576109194,EDS 128A,A01,895459,Fargason; Sharon Gayle,44,0,45,1
1746576110221,EDS 128B,A01,895543,Pappas; Elizabeth,44,0,45,1
1746576111255,EDS 139,A00,897203,Pappas; Elizabeth,44,0,45,1
1746576111255,EDS 139,B00,897209,Fargason; Sharon Gayle,41,0,45,4
1746576112281,EDS 201,A00,895545,Staff,22,0,45,23
1746576113306,EDS 203,A01,895581,Halter; Christopher P.,22,0,45,23
1746576114334,EDS 204R,A01,895625,Heinzman; Erica M.,39,0,45,6
1746576114334,EDS 204R,B01,895693,Halter; Christopher P.,10,0,45,35
1746576115359,EDS 206R,A00,895694,Fargason; Sharon Gayle,1,0,30,29
1746576115359,EDS 206R,B00,895695,Choi; Bailey Miyeon,16,0,30,14
1746576116384,EDS 250,A00,895697,Hemans; Patricia Ann Benitez,22,0,45,23
1746576117409,EDS 281,A00,895701,Meyerott; Theresa Ann,1,0,15,14
1746576118435,EDS 284,A00,895736,Meyerott; Theresa Ann,1,0,15,14
1746576119467,EDS 286,A00,897210,Fine; Sarah,0,0,15,15
1746576120493,EDS 289C,A01,895770,Daly; Alan J.,1,0,15,14
1746576121522,EDS 290,A00,897211,Hofstetter; Carolyn,0,0,15,15
1746576122547,LIGM 5A,A00,896162,Fischer-Grunski; Eva K,12,0,20,8
1746576123572,LIGM 5B,A00,896260,Fischer-Grunski; Eva K,17,0,20,3
1746576124603,LIGM 5C,A00,896308,Fischer-Grunski; Eva K,18,0,20,2
1746576125627,LIIT 5AS,A00,896313,Carnelos; Chiara,18,0,20,2
1746576126697,LIIT 5BS,A00,896416,Carnelos; Chiara,20,0,20,0
1746576127723,LIIT 5CS,A00,896564,Carnelos; Chiara,20,0,20,0
1746576128748,LISP 5A,A00,896588,Munoz Sanchez; Alicia,2,0,20,18
1746576129774,LISP 5B,A00,896653,Munoz Sanchez; Alicia,7,0,20,13
1746576130805,LISP 5C,A00,896655,Munoz Sanchez; Alicia,0,1,20,20
1746576131830,MAE 197,001,957918,Kleissl; Jan,9996,0,9999,3
1746576131830,MAE 197,002,959806,Boechler; Nicholas Sebastia,9998,0,9999,1
1746576131830,MAE 197,003,959852,Mullin; Jennifer S,9998,0,9999,1
1746576132858,MATH 2,A01,957937,Staff,33,0,35,2
1746576133888,MATH 197,001,957876,Kedlaya; Kiran S.,9993,0,9999,6
1746576134915,MCWP 40,A00,892729,Duru; Nur,10,0,20,10
1746576134915,MCWP 40,B00,893304,Montejo; Carolina,14,0,20,6
1746576135943,MCWP 40R,A00,893757,Redela; Pamela Morgan,0,5,20,20
1746576136972,MCWP 50,A00,893758,Morshed; Michael James,0,0,20,20
1746576136972,MCWP 50,B00,893761,Bartulis; Jason Michael,17,0,20,3
1746576138003,MCWP 50R,A00,893766,Compas; Sean Matthew,0,1,20,20
1746576138003,MCWP 50R,B00,893769,Carter; Jennifer A,0,1,20,20
1746576138003,MCWP 50R,C00,893771,Krone; Jarret,0,3,20,20
1746576138003,MCWP 50R,D00,893772,Miller; Elizabeth Deen,0,0,20,20
1746576138003,MCWP 50R,E00,893775,Carter; Andrea L,0,1,20,20
1746576139033,MMW 11R,A01,892721,Herbst; Matthew,14,0,30,16
1746576139033,MMW 11R,A02,892722,Herbst; Matthew,0,0,0,3
1746576140062,MMW 12R,A01,892724,Herbst; Matthew,0,11,16,16
1746576140062,MMW 12R,A02,892725,Herbst; Matthew,0,10,16,16
1746576141089,MMW 13R,A01,892727,Staff,0,4,16,16
1746576141089,MMW 13R,A02,892728,Staff,0,4,16,16
1746576141089,MMW 13R,A03,958032,Staff,0,4,16,16
1746576141089,MMW 13R,A04,958033,Staff,0,4,16,16
1746576141089,MMW 13R,A05,958034,Staff,0,4,16,16
1746576142120,SIO 295LS,A00,894015,Staff,5,0,25,20
1746576143148,SIO 295S,A00,894020,Staff,5,0,25,20
1746576144178,SIOC 290S,B01,958918,Merrifield; Mark A,14,0,30,16
1746576145205,SIOC 291S,B01,958922,Gabriel; Corey John,14,0,30,16
1746576146231,SOCI 117,A01,895339,Staff,3,0,5,2
1746576147257,WES 237B,A00,894149,Staff,11,0,20,9
1746576149329,AESE 279B,A00,891859,Staff,13,0,35,22
1746576150356,AIP 197,001,891854,Vespa; Emanuel Ignacio,9999,0,9999,0
1746576151380,ANTH 289S,A00,891856,Gagneux; Pascal,12,0,12,0
1746576152415,BENG 196,001,957946,Engler; Adam J.,9996,0,9999,3
1746576153440,BISP 197,001,959851,Wilhelm; James E.,9998,0,9999,1
1746576154463,CAT 124RS,A01,956906,Staff,6,0,25,19
1746576155489,CAT 125RS,A01,922013,Staff,6,0,25,19
1746576156515,CLRE 250,A00,891860,Morris; Sheldon,9995,0,9999,4
1746576158567,CLRE 251R,A00,907817,Mehta; Ravindra L.,9994,0,9999,5
1746576159595,CLRE 252,A00,891864,Cuomo; Raphael Eduardo,9993,0,9999,6
1746576160623,CLRE 253,A00,891867,Vaida; Florin,9994,0,9999,5
1746576160623,CLRE 253,B00,907819,Staff,9999,0,9999,0
1746576161649,CLRE 259,A00,891868,Patel; Hemal,9998,0,9999,1
1746576162673,CLRE 260,A00,891872,Cuomo; Raphael Eduardo,9999,0,9999,0
1746576163702,CLRE 297,001,891888,Cuomo; Raphael Eduardo,9999,0,9999,0
1746576164729,CSE 191,A00,958773,Minnes Kemp; Mor Mia,9995,0,9999,4
1746576165753,CSE 197,001,959846,Minnes Kemp; Mor Mia,9990,0,9999,9
1746576166780,CSS 201S,A01,892054,Mignozzetti; Umberto,25,0,30,5
1746576167811,CSS 202S,A01,892056,Mignozzetti; Umberto,25,0,30,5
1746576168835,DSC 197,001,956898,Eldridge; Justin Matthew,9996,0,9999,3
1746576169863,DSC 297,001,958000,Mazumdar; Arya,9998,0,9999,1
1746576169863,DSC 297,002,959862,Wang; Yusu,9998,0,9999,1
1746576170887,EAP 100,A00,905686,Staff,9778,0,9999,221
1746576171917,ECE 45,A01,892618,Staff,0,0,65,65
1746576173966,ECE 111,A01,892719,Staff,5,0,65,60
1746576174992,ECE 197,001,957920,Mercier; Patrick Philip,9991,0,9999,8
1746576176020,ECON 178,A01,907814,Zhu; Ying,26,0,35,9
1746576177049,EDS 115,A00,895312,Staff,35,0,45,10
1746576178075,EDS 117,A01,895337,Staff,23,0,30,7
1746576179099,EDS 125,A00,895341,Jones; Gabrielle Anastasia,36,0,45,9
1746576180125,EDS 128A,A01,895459,Fargason; Sharon Gayle,44,0,45,1
1746576181149,EDS 128B,A01,895543,Pappas; Elizabeth,44,0,45,1
1746576182190,EDS 139,A00,897203,Pappas; Elizabeth,44,0,45,1
1746576182190,EDS 139,B00,897209,Fargason; Sharon Gayle,41,0,45,4
1746576183215,EDS 201,A00,895545,Staff,22,0,45,23
1746576184243,EDS 203,A01,895581,Halter; Christopher P.,22,0,45,23
1746576185267,EDS 204R,A01,895625,Heinzman; Erica M.,39,0,45,6
1746576185267,EDS 204R,B01,895693,Halter; Christopher P.,10,0,45,35
1746576186296,EDS 206R,A00,895694,Fargason; Sharon Gayle,1,0,30,29
1746576186296,EDS 206R,B00,895695,Choi; Bailey Miyeon,16,0,30,14
1746576187324,EDS 250,A00,895697,Hemans; Patricia Ann Benitez,22,0,45,23
1746576188349,EDS 281,A00,895701,Meyerott; Theresa Ann,1,0,15,14
1746576189375,EDS 284,A00,895736,Meyerott; Theresa Ann,1,0,15,14
1746576190398,EDS 286,A00,897210,Fine; Sarah,0,0,15,15
1746576191425,EDS 289C,A01,895770,Daly; Alan J.,1,0,15,14
1746576192450,EDS 290,A00,897211,Hofstetter; Carolyn,0,0,15,15
1746576193473,LIGM 5A,A00,896162,Fischer-Grunski; Eva K,12,0,20,8
1746576194498,LIGM 5B,A00,896260,Fischer-Grunski; Eva K,17,0,20,3
1746576195522,LIGM 5C,A00,896308,Fischer-Grunski; Eva K,18,0,20,2
1746576196547,LIIT 5AS,A00,896313,Carnelos; Chiara,18,0,20,2
1746576197575,LIIT 5BS,A00,896416,Carnelos; Chiara,20,0,20,0
1746576198601,LIIT 5CS,A00,896564,Carnelos; Chiara,20,0,20,0
1746576199628,LISP 5A,A00,896588,Munoz Sanchez; Alicia,2,0,20,18
1746576200664,LISP 5B,A00,896653,Munoz Sanchez; Alicia,7,0,20,13
1746576201692,LISP 5C,A00,896655,Munoz Sanchez; Alicia,0,1,20,20
1746576202720,MAE 197,001,957918,Kleissl; Jan,9996,0,9999,3
1746576202720,MAE 197,002,959806,Boechler; Nicholas Sebastia,9998,0,9999,1
1746576202720,MAE 197,003,959852,Mullin; Jennifer S,9998,0,9999,1
1746576203746,MATH 2,A01,957937,Staff,33,0,35,2
1746576204770,MATH 197,001,957876,Kedlaya; Kiran S.,9993,0,9999,6
1746576205794,MCWP 40,A00,892729,Duru; Nur,10,0,20,10
1746576205794,MCWP 40,B00,893304,Montejo; Carolina,14,0,20,6
1746576206819,MCWP 40R,A00,893757,Redela; Pamela Morgan,0,5,20,20
1746576207850,MCWP 50,A00,893758,Morshed; Michael James,0,0,20,20
1746576207850,MCWP 50,B00,893761,Bartulis; Jason Michael,17,0,20,3
1746576208878,MCWP 50R,A00,893766,Compas; Sean Matthew,0,1,20,20
1746576208878,MCWP 50R,B00,893769,Carter; Jennifer A,0,1,20,20
1746576208878,MCWP 50R,C00,893771,Krone; Jarret,0,3,20,20
1746576208878,MCWP 50R,D00,893772,Miller; Elizabeth Deen,0,0,20,20
1746576208878,MCWP 50R,E00,893775,Carter; Andrea L,0,1,20,20
1746576209904,MMW 11R,A01,892721,Herbst; Matthew,14,0,30,16
1746576209904,MMW 11R,A02,892722,Herbst; Matthew,0,0,0,3
1746576210936,MMW 12R,A01,892724,Herbst; Matthew,0,11,16,16
1746576210936,MMW 12R,A02,892725,Herbst; Matthew,0,10,16,16
1746576211962,MMW 13R,A01,892727,Staff,0,4,16,16
1746576211962,MMW 13R,A02,892728,Staff,0,4,16,16
1746576211962,MMW 13R,A03,958032,Staff,0,4,16,16
1746576211962,MMW 13R,A04,958033,Staff,0,4,16,16
1746576211962,MMW 13R,A05,958034,Staff,0,4,16,16
1746576212987,SIO 295LS,A00,894015,Staff,5,0,25,20
1746576214015,SIO 295S,A00,894020,Staff,5,0,25,20
1746576215044,SIOC 290S,B01,958918,Merrifield; Mark A,14,0,30,16
1746576216070,SIOC 291S,B01,958922,Gabriel; Corey John,14,0,30,16
1746576217104,SOCI 117,A01,895339,Staff,3,0,5,2
1746576218132,WES 237B,A00,894149,Staff,11,0,20,9
1746576220189,AESE 279B,A00,891859,Staff,13,0,35,22
1746576221216,AIP 197,001,891854,Vespa; Emanuel Ignacio,9999,0,9999,0
1746576222239,ANTH 289S,A00,891856,Gagneux; Pascal,12,0,12,0
1746576223266,BENG 196,001,957946,Engler; Adam J.,9996,0,9999,3
1746576224308,BISP 197,001,959851,Wilhelm; James E.,9998,0,9999,1
1746576225333,CAT 124RS,A01,956906,Staff,6,0,25,19
1746576226358,CAT 125RS,A01,922013,Staff,6,0,25,19
1746576227382,CLRE 250,A00,891860,Morris; Sheldon,9995,0,9999,4
1746576229433,CLRE 251R,A00,907817,Mehta; Ravindra L.,9994,0,9999,5
1746576230462,CLRE 252,A00,891864,Cuomo; Raphael Eduardo,9993,0,9999,6
1746576231490,CLRE 253,A00,891867,Vaida; Florin,9994,0,9999,5
1746576231490,CLRE 253,B00,907819,Staff,9999,0,9999,0
1746576232522,CLRE 259,A00,891868,Patel; Hemal,9998,0,9999,1
1746576233551,CLRE 260,A00,891872,Cuomo; Raphael Eduardo,9999,0,9999,0
1746576234577,CLRE 297,001,891888,Cuomo; Raphael Eduardo,9999,0,9999,0
1746576235602,CSE 191,A00,958773,Minnes Kemp; Mor Mia,9995,0,9999,4
1746576236627,CSE 197,001,959846,Minnes Kemp; Mor Mia,9990,0,9999,9
1746576237653,CSS 201S,A01,892054,Mignozzetti; Umberto,25,0,30,5
1746576238679,CSS 202S,A01,892056,Mignozzetti; Umberto,25,0,30,5
1746576239705,DSC 197,001,956898,Eldridge; Justin Matthew,9996,0,9999,3
1746576240730,DSC 297,001,958000,Mazumdar; Arya,9998,0,9999,1
1746576240730,DSC 297,002,959862,Wang; Yusu,9998,0,9999,1
1746576241759,EAP 100,A00,905686,Staff,9778,0,9999,221
1746576242792,ECE 45,A01,892618,Staff,0,0,65,65
1746576244851,ECE 111,A01,892719,Staff,5,0,65,60
1746576245879,ECE 197,001,957920,Mercier; Patrick Philip,9991,0,9999,8
1746576246905,ECON 178,A01,907814,Zhu; Ying,26,0,35,9
1746576247933,EDS 115,A00,895312,Staff,35,0,45,10
1746576248964,EDS 117,A01,895337,Staff,23,0,30,7
1746576250005,EDS 125,A00,895341,Jones; Gabrielle Anastasia,36,0,45,9
1746576251033,EDS 128A,A01,895459,Fargason; Sharon Gayle,44,0,45,1
1746576252063,EDS 128B,A01,895543,Pappas; Elizabeth,44,0,45,1
1746576253090,EDS 139,A00,897203,Pappas; Elizabeth,44,0,45,1
1746576253090,EDS 139,B00,897209,Fargason; Sharon Gayle,41,0,45,4
1746576254117,EDS 201,A00,895545,Staff,22,0,45,23
1746576255143,EDS 203,A01,895581,Halter; Christopher P.,22,0,45,23
1746576256167,EDS 204R,A01,895625,Heinzman; Erica M.,39,0,45,6
1746576256167,EDS 204R,B01,895693,Halter; Christopher P.,10,0,45,35
1746576257191,EDS 206R,A00,895694,Fargason; Sharon Gayle,1,0,30,29
1746576257191,EDS 206R,B00,895695,Choi; Bailey Miyeon,16,0,30,14
1746576258218,EDS 250,A00,895697,Hemans; Patricia Ann Benitez,22,0,45,23
1746576259241,EDS 281,A00,895701,Meyerott; Theresa Ann,1,0,15,14
1746576260269,EDS 284,A00,895736,Meyerott; Theresa Ann,1,0,15,14
1746576261292,EDS 286,A00,897210,Fine; Sarah,0,0,15,15
1746576262320,EDS 289C,A01,895770,Daly; Alan J.,1,0,15,14
1746576263350,EDS 290,A00,897211,Hofstetter; Carolyn,0,0,15,15
1746576264378,LIGM 5A,A00,896162,Fischer-Grunski; Eva K,12,0,20,8
1746576265405,LIGM 5B,A00,896260,Fischer-Grunski; Eva K,17,0,20,3
1746576266432,LIGM 5C,A00,896308,Fischer-Grunski; Eva K,18,0,20,2
1746576267459,LIIT 5AS,A00,896313,Carnelos; Chiara,18,0,20,2
1746576268491,LIIT 5BS,A00,896416,Carnelos; Chiara,20,0,20,0
1746576269516,LIIT 5CS,A00,896564,Carnelos; Chiara,20,0,20,0
1746576270542,LISP 5A,A00,896588,Munoz Sanchez; Alicia,2,0,20,18
1746576271567,LISP 5B,A00,896653,Munoz Sanchez; Alicia,7,0,20,13
1746576272594,LISP 5C,A00,896655,Munoz Sanchez; Alicia,0,1,20,20
1746576273624,MAE 197,001,957918,Kleissl; Jan,9996,0,9999,3
1746576273624,MAE 197,002,959806,Boechler; Nicholas Sebastia,9998,0,9999,1
1746576273624,MAE 197,003,959852,Mullin; Jennifer S,9998,0,9999,1
1746576274651,MATH 2,A01,957937,Staff,33,0,35,2
1746576275676,MATH 197,001,957876,Kedlaya; Kiran S.,9993,0,9999,6
1746576276703,MCWP 40,A00,892729,Duru; Nur,10,0,20,10
1746576276703,MCWP 40,B00,893304,Montejo; Carolina,14,0,20,6
1746576277729,MCWP 40R,A00,893757,Redela; Pamela Morgan,0,5,20,20
1746576278758,MCWP 50,A00,893758,Morshed; Michael James,0,0,20,20
1746576278758,MCWP 50,B00,893761,Bartulis; Jason Michael,17,0,20,3
1746576279787,MCWP 50R,A00,893766,Compas; Sean Matthew,0,1,20,20
1746576279787,MCWP 50R,B00,893769,Carter; Jennifer A,0,1,20,20
1746576279787,MCWP 50R,C00,893771,Krone; Jarret,0,3,20,20
1746576279787,MCWP 50R,D00,893772,Miller; Elizabeth Deen,0,0,20,20
1746576279787,MCWP 50R,E00,893775,Carter; Andrea L,0,1,20,20
1746576280812,MMW 11R,A01,892721,Herbst; Matthew,14,0,30,16
1746576280812,MMW 11R,A02,892722,Herbst; Matthew,0,0,0,3
1746576281837,MMW 12R,A01,892724,Herbst; Matthew,0,11,16,16
1746576281837,MMW 12R,A02,892725,Herbst; Matthew,0,10,16,16
1746576282863,MMW 13R,A01,892727,Staff,0,4,16,16
1746576282863,MMW 13R,A02,892728,Staff,0,4,16,16
1746576282863,MMW 13R,A03,958032,Staff,0,4,16,16
1746576282863,MMW 13R,A04,958033,Staff,0,4,16,16
1746576282863,MMW 13R,A05,958034,Staff,0,4,16,16
1746576283893,SIO 295LS,A00,894015,Staff,5,0,25,20
1746576284917,SIO 295S,A00,894020,Staff,5,0,25,20
1746576285944,SIOC 290S,B01,958918,Merrifield; Mark A,14,0,30,16
1746576286976,SIOC 291S,B01,958922,Gabriel; Corey John,14,0,30,16
1746576288008,SOCI 117,A01,895339,Staff,3,0,5,2
1746576289033,WES 237B,A00,894149,Staff,11,0,20,9
1746576291088,AESE 279B,A00,891859,Staff,13,0,35,22
1746576292118,AIP 197,001,891854,Vespa; Emanuel Ignacio,9999,0,9999,0
1746576293143,ANTH 289S,A00,891856,Gagneux; Pascal,12,0,12,0
1746576294168,BENG 196,001,957946,Engler; Adam J.,9996,0,9999,3
1746576295192,BISP 197,001,959851,Wilhelm; James E.,9998,0,9999,1
1746576296218,CAT 124RS,A01,956906,Staff,6,0,25,19
1746576297243,CAT 125RS,A01,922013,Staff,6,0,25,19
1746576298267,CLRE 250,A00,891860,Morris; Sheldon,9995,0,9999,4
1746576300331,CLRE 251R,A00,907817,Mehta; Ravindra L.,9994,0,9999,5
1746576301360,CLRE 252,A00,891864,Cuomo; Raphael Eduardo,9993,0,9999,6
1746576302407,CLRE 253,A00,891867,Vaida; Florin,9994,0,9999,5
1746576302407,CLRE 253,B00,907819,Staff,9999,0,9999,0
1746576303438,CLRE 259,A00,891868,Patel; Hemal,9998,0,9999,1
1746576304469,CLRE 260,A00,891872,Cuomo; Raphael Eduardo,9999,0,9999,0
1746576305502,CLRE 297,001,891888,Cuomo; Raphael Eduardo,9999,0,9999,0
1746576306529,CSE 191,A00,958773,Minnes Kemp; Mor Mia,9995,0,9999,4
1746576307555,CSE 197,001,959846,Minnes Kemp; Mor Mia,9990,0,9999,9
1746576308580,CSS 201S,A01,892054,Mignozzetti; Umberto,25,0,30,5
1746576309610,CSS 202S,A01,892056,Mignozzetti; Umberto,25,0,30,5
1746576310633,DSC 197,001,956898,Eldridge; Justin Matthew,9996,0,9999,3
1746576311662,DSC 297,001,958000,Mazumdar; Arya,9998,0,9999,1
1746576311662,DSC 297,002,959862,Wang; Yusu,9998,0,9999,1
1746576312687,EAP 100,A00,905686,Staff,9778,0,9999,221
1746576313713,ECE 45,A01,892618,Staff,0,0,65,65
1746576315766,ECE 111,A01,892719,Staff,5,0,65,60
1746576316793,ECE 197,001,957920,Mercier; Patrick Philip,9991,0,9999,8
1746576317817,ECON 178,A01,907814,Zhu; Ying,26,0,35,9
1746576318850,EDS 115,A00,895312,Staff,35,0,45,10
1746576319875,EDS 117,A01,895337,Staff,23,0,30,7
1746576320903,EDS 125,A00,895341,Jones; Gabrielle Anastasia,36,0,45,9
1746576321929,EDS 128A,A01,895459,Fargason; Sharon Gayle,44,0,45,1
1746576322960,EDS 128B,A01,895543,Pappas; Elizabeth,44,0,45,1
1746576323987,EDS 139,A00,897203,Pappas; Elizabeth,44,0,45,1
1746576323987,EDS 139,B00,897209,Fargason; Sharon Gayle,41,0,45,4
1746576325012,EDS 201,A00,895545,Staff,22,0,45,23
1746576326042,EDS 203,A01,895581,Halter; Christopher P.,22,0,45,23
1746576327071,EDS 204R,A01,895625,Heinzman; Erica M.,39,0,45,6
1746576327071,EDS 204R,B01,895693,Halter; Christopher P.,10,0,45,35
1746576328098,EDS 206R,A00,895694,Fargason; Sharon Gayle,1,0,30,29
1746576328098,EDS 206R,B00,895695,Choi; Bailey Miyeon,16,0,30,14
1746576329123,EDS 250,A00,895697,Hemans; Patricia Ann Benitez,22,0,45,23
1746576330148,EDS 281,A00,895701,Meyerott; Theresa Ann,1,0,15,14
1746576331178,EDS 284,A00,895736,Meyerott; Theresa Ann,1,0,15,14
1746576332207,EDS 286,A00,897210,Fine; Sarah,0,0,15,15
1746576333232,EDS 289C,A01,895770,Daly; Alan J.,1,0,15,14
1746576334260,EDS 290,A00,897211,Hofstetter; Carolyn,0,0,15,15
1746576335287,LIGM 5A,A00,896162,Fischer-Grunski; Eva K,12,0,20,8
1746576336312,LIGM 5B,A00,896260,Fischer-Grunski; Eva K,17,0,20,3
1746576337337,LIGM 5C,A00,896308,Fischer-Grunski; Eva K,18,0,20,2
1746576338365,LIIT 5AS,A00,896313,Carnelos; Chiara,18,0,20,2
1746576339392,LIIT 5BS,A00,896416,Carnelos; Chiara,20,0,20,0
1746576340417,LIIT 5CS,A00,896564,Carnelos; Chiara,20,0,20,0
1746576341444,LISP 5A,A00,896588,Munoz Sanchez; Alicia,2,0,20,18
1746576342470,LISP 5B,A00,896653,Munoz Sanchez; Alicia,7,0,20,13
1746576343497,LISP 5C,A00,896655,Munoz Sanchez; Alicia,0,1,20,20
1746576344524,MAE 197,001,957918,Kleissl; Jan,9996,0,9999,3
1746576344524,MAE 197,002,959806,Boechler; Nicholas Sebastia,9998,0,9999,1
1746576344524,MAE 197,003,959852,Mullin; Jennifer S,9998,0,9999,1
1746576345549,MATH 2,A01,957937,Staff,33,0,35,2
1746576346576,MATH 197,001,957876,Kedlaya; Kiran S.,9993,0,9999,6
1746576347601,MCWP 40,A00,892729,Duru; Nur,10,0,20,10
1746576347601,MCWP 40,B00,893304,Montejo; Carolina,14,0,20,6
1746576348628,MCWP 40R,A00,893757,Redela; Pamela Morgan,0,5,20,20
1746576349655,MCWP 50,A00,893758,Morshed; Michael James,0,0,20,20
1746576349655,MCWP 50,B00,893761,Bartulis; Jason Michael,17,0,20,3
1746576350687,MCWP 50R,A00,893766,Compas; Sean Matthew,0,1,20,20
1746576350687,MCWP 50R,B00,893769,Carter; Jennifer A,0,1,20,20
1746576350687,MCWP 50R,C00,893771,Krone; Jarret,0,3,20,20
1746576350687,MCWP 50R,D00,893772,Miller; Elizabeth Deen,0,0,20,20
1746576350687,MCWP 50R,E00,893775,Carter; Andrea L,0,1,20,20
1746576351713,MMW 11R,A01,892721,Herbst; Matthew,14,0,30,16
1746576351713,MMW 11R,A02,892722,Herbst; Matthew,0,0,0,3
1746576352738,MMW 12R,A01,892724,Herbst; Matthew,0,11,16,16
1746576352738,MMW 12R,A02,892725,Herbst; Matthew,0,10,16,16
1746576353765,MMW 13R,A01,892727,Staff,0,4,16,16
1746576353765,MMW 13R,A02,892728,Staff,0,4,16,16
1746576353765,MMW 13R,A03,958032,Staff,0,4,16,16
1746576353765,MMW 13R,A04,958033,Staff,0,4,16,16
1746576353765,MMW 13R,A05,958034,Staff,0,4,16,16
1746576354792,SIO 295LS,A00,894015,Staff,5,0,25,20
1746576355820,SIO 295S,A00,894020,Staff,5,0,25,20
1746576356859,SIOC 290S,B01,958918,Merrifield; Mark A,14,0,30,16
1746576357889,SIOC 291S,B01,958922,Gabriel; Corey John,14,0,30,16
1746576358918,SOCI 117,A01,895339,Staff,3,0,5,2
1746576359944,WES 237B,A00,894149,Staff,11,0,20,9
1746576362004,AESE 279B,A00,891859,Staff,13,0,35,22
1746576363030,AIP 197,001,891854,Vespa; Emanuel Ignacio,9999,0,9999,0
1746576364059,ANTH 289S,A00,891856,Gagneux; Pascal,12,0,12,0
1746576365086,BENG 196,001,957946,Engler; Adam J.,9996,0,9999,3
1746576366112,BISP 197,001,959851,Wilhelm; James E.,9998,0,9999,1
1746576367138,CAT 124RS,A01,956906,Staff,6,0,25,19
1746576368163,CAT 125RS,A01,922013,Staff,6,0,25,19
1746576369191,CLRE 250,A00,891860,Morris; Sheldon,9995,0,9999,4
1746576371245,CLRE 251R,A00,907817,Mehta; Ravindra L.,9994,0,9999,5
1746576372271,CLRE 252,A00,891864,Cuomo; Raphael Eduardo,9993,0,9999,6
1746576373301,CLRE 253,A00,891867,Vaida; Florin,9994,0,9999,5
1746576373301,CLRE 253,B00,907819,Staff,9999,0,9999,0
1746576374329,CLRE 259,A00,891868,Patel; Hemal,9998,0,9999,1
1746576375355,CLRE 260,A00,891872,Cuomo; Raphael Eduardo,9999,0,9999,0
1746576376380,CLRE 297,001,891888,Cuomo; Raphael Eduardo,9999,0,9999,0
1746576377405,CSE 191,A00,958773,Minnes Kemp; Mor Mia,9995,0,9999,4
1746576378434,CSE 197,001,959846,Minnes Kemp; Mor Mia,9990,0,9999,9
1746576379465,CSS 201S,A01,892054,Mignozzetti; Umberto,25,0,30,5
1746576380491,CSS 202S,A01,892056,Mignozzetti; Umberto,25,0,30,5
1746576381522,DSC 197,001,956898,Eldridge; Justin Matthew,9996,0,9999,3
1746576382549,DSC 297,001,958000,Mazumdar; Arya,9998,0,9999,1
1746576382549,DSC 297,002,959862,Wang; Yusu,9998,0,9999,1
1746576383580,EAP 100,A00,905686,Staff,9778,0,9999,221
1746576384611,ECE 45,A01,892618,Staff,0,0,65,65
1746576386662,ECE 111,A01,892719,Staff,5,0,65,60
1746576387709,ECE 197,001,957920,Mercier; Patrick Philip,9991,0,9999,8
1746576388736,ECON 178,A01,907814,Zhu; Ying,26,0,35,9
1746576389761,EDS 115,A00,895312,Staff,35,0,45,10
1746576390787,EDS 117,A01,895337,Staff,23,0,30,7
1746576391811,EDS 125,A00,895341,Jones; Gabrielle Anastasia,36,0,45,9
1746576392836,EDS 128A,A01,895459,Fargason; Sharon Gayle,44,0,45,1
1746576393867,EDS 128B,A01,895543,Pappas; Elizabeth,44,0,45,1
1746576394892,EDS 139,A00,897203,Pappas; Elizabeth,44,0,45,1
1746576394892,EDS 139,B00,897209,Fargason; Sharon Gayle,41,0,45,4
1746576395920,EDS 201,A00,895545,Staff,22,0,45,23
1746576396946,EDS 203,A01,895581,Halter; Christopher P.,22,0,45,23
1746576397974,EDS 204R,A01,895625,Heinzman; Erica M.,39,0,45,6
1746576397974,EDS 204R,B01,895693,Halter; Christopher P.,10,0,45,35
1746576399004,EDS 206R,A00,895694,Fargason; Sharon Gayle,1,0,30,29
1746576399004,EDS 206R,B00,895695,Choi; Bailey Miyeon,16,0,30,14
1746576400035,EDS 250,A00,895697,Hemans; Patricia Ann Benitez,22,0,45,23
1746576401060,EDS 281,A00,895701,Meyerott; Theresa Ann,1,0,15,14
1746576402086,EDS 284,A00,895736,Meyerott; Theresa Ann,1,0,15,14
1746576403115,EDS 286,A00,897210,Fine; Sarah,0,0,15,15
1746576404146,EDS 289C,A01,895770,Daly; Alan J.,1,0,15,14
1746576405178,EDS 290,A00,897211,Hofstetter; Carolyn,0,0,15,15
1746576406203,LIGM 5A,A00,896162,Fischer-Grunski; Eva K,12,0,20,8
1746576407234,LIGM 5B,A00,896260,Fischer-Grunski; Eva K,17,0,20,3
1746576408259,LIGM 5C,A00,896308,Fischer-Grunski; Eva K,18,0,20,2
1746576409291,LIIT 5AS,A00,896313,Carnelos; Chiara,18,0,20,2
1746576410316,LIIT 5BS,A00,896416,Carnelos; Chiara,20,0,20,0
1746576411342,LIIT 5CS,A00,896564,Carnelos; Chiara,20,0,20,0
1746576412374,LISP 5A,A00,896588,Munoz Sanchez; Alicia,2,0,20,18
1746576413406,LISP 5B,A00,896653,Munoz Sanchez; Alicia,7,0,20,13
1746576414434,LISP 5C,A00,896655,Munoz Sanchez; Alicia,0,1,20,20
1746576415463,MAE 197,001,957918,Kleissl; Jan,9996,0,9999,3
1746576415463,MAE 197,002,959806,Boechler; Nicholas Sebastia,9998,0,9999,1
1746576415463,MAE 197,003,959852,Mullin; Jennifer S,9998,0,9999,1
1746576416486,MATH 2,A01,957937,Staff,33,0,35,2
1746576417518,MATH 197,001,957876,Kedlaya; Kiran S.,9993,0,9999,6
1746576418544,MCWP 40,A00,892729,Duru; Nur,10,0,20,10
1746576418544,MCWP 40,B00,893304,Montejo; Carolina,14,0,20,6
1746576419570,MCWP 40R,A00,893757,Redela; Pamela Morgan,0,5,20,20
1746576420595,MCWP 50,A00,893758,Morshed; Michael James,0,0,20,20
1746576420595,MCWP 50,B00,893761,Bartulis; Jason Michael,17,0,20,3
1746576421642,MCWP 50R,A00,893766,Compas; Sean Matthew,0,1,20,20
1746576421642,MCWP 50R,B00,893769,Carter; Jennifer A,0,1,20,20
1746576421642,MCWP 50R,C00,893771,Krone; Jarret,0,3,20,20
1746576421642,MCWP 50R,D00,893772,Miller; Elizabeth Deen,0,0,20,20
1746576421642,MCWP 50R,E00,893775,Carter; Andrea L,0,1,20,20
1746576422667,MMW 11R,A01,892721,Herbst; Matthew,14,0,30,16
1746576422667,MMW 11R,A02,892722,Herbst; Matthew,0,0,0,3
1746576423692,MMW 12R,A01,892724,Herbst; Matthew,0,11,16,16
1746576423692,MMW 12R,A02,892725,Herbst; Matthew,0,10,16,16
1746576424720,MMW 13R,A01,892727,Staff,0,4,16,16
1746576424720,MMW 13R,A02,892728,Staff,0,4,16,16
1746576424720,MMW 13R,A03,958032,Staff,0,4,16,16
1746576424720,MMW 13R,A04,958033,Staff,0,4,16,16
1746576424720,MMW 13R,A05,958034,Staff,0,4,16,16
1746576425748,SIO 295LS,A00,894015,Staff,5,0,25,20
1746576426776,SIO 295S,A00,894020,Staff,5,0,25,20
1746576427802,SIOC 290S,B01,958918,Merrifield; Mark A,14,0,30,16
1746576428835,SIOC 291S,B01,958922,Gabriel; Corey John,14,0,30,16
1746576429859,SOCI 117,A01,895339,Staff,3,0,5,2
1746576430883,WES 237B,A00,894149,Staff,11,0,20,9
1746576432946,AESE 279B,A00,891859,Staff,13,0,35,22
1746576433970,AIP 197,001,891854,Vespa; Emanuel Ignacio,9999,0,9999,0
1746576435041,ANTH 289S,A00,891856,Gagneux; Pascal,12,0,12,0
1746576436069,BENG 196,001,957946,Engler; Adam J.,9996,0,9999,3
1746576437094,BISP 197,001,959851,Wilhelm; James E.,9998,0,9999,1
1746576438121,CAT 124RS,A01,956906,Staff,6,0,25,19
1746576439145,CAT 125RS,A01,922013,Staff,6,0,25,19
1746576440172,CLRE 250,A00,891860,Morris; Sheldon,9995,0,9999,4
1746576442226,CLRE 251R,A00,907817,Mehta; Ravindra L.,9994,0,9999,5
1746576443254,CLRE 252,A00,891864,Cuomo; Raphael Eduardo,9993,0,9999,6
1746576444280,CLRE 253,A00,891867,Vaida; Florin,9994,0,9999,5
1746576444280,CLRE 253,B00,907819,Staff,9999,0,9999,0
1746576445304,CLRE 259,A00,891868,Patel; Hemal,9998,0,9999,1
1746576446332,CLRE 260,A00,891872,Cuomo; Raphael Eduardo,9999,0,9999,0
1746576447356,CLRE 297,001,891888,Cuomo; Raphael Eduardo,9999,0,9999,0
1746576448380,CSE 191,A00,958773,Minnes Kemp; Mor Mia,9995,0,9999,4
1746576449404,CSE 197,001,959846,Minnes Kemp; Mor Mia,9990,0,9999,9
1746576450433,CSS 201S,A01,892054,Mignozzetti; Umberto,25,0,30,5
1746576451457,CSS 202S,A01,892056,Mignozzetti; Umberto,25,0,30,5
1746576452486,DSC 197,001,956898,Eldridge; Justin Matthew,9996,0,9999,3
1746576453518,DSC 297,001,958000,Mazumdar; Arya,9998,0,9999,1
1746576453518,DSC 297,002,959862,Wang; Yusu,9998,0,9999,1
1746576454545,EAP 100,A00,905686,Staff,9778,0,9999,221
1746576455574,ECE 45,A01,892618,Staff,0,0,65,65
1746576457625,ECE 111,A01,892719,Staff,5,0,65,60
1746576458649,ECE 197,001,957920,Mercier; Patrick Philip,9991,0,9999,8
1746576459673,ECON 178,A01,907814,Zhu; Ying,26,0,35,9
1746576460701,EDS 115,A00,895312,Staff,35,0,45,10
1746576461729,EDS 117,A01,895337,Staff,23,0,30,7
1746576462757,EDS 125,A00,895341,Jones; Gabrielle Anastasia,36,0,45,9
1746576463781,EDS 128A,A01,895459,Fargason; Sharon Gayle,44,0,45,1
1746576464810,EDS 128B,A01,895543,Pappas; Elizabeth,44,0,45,1
1746576465835,EDS 139,A00,897203,Pappas; Elizabeth,44,0,45,1
1746576465835,EDS 139,B00,897209,Fargason; Sharon Gayle,41,0,45,4
1746576466863,EDS 201,A00,895545,Staff,22,0,45,23
1746576467890,EDS 203,A01,895581,Halter; Christopher P.,22,0,45,23
1746576468918,EDS 204R,A01,895625,Heinzman; Erica M.,39,0,45,6
1746576468918,EDS 204R,B01,895693,Halter; Christopher P.,10,0,45,35
1746576469946,EDS 206R,A00,895694,Fargason; Sharon Gayle,1,0,30,29
1746576469946,EDS 206R,B00,895695,Choi; Bailey Miyeon,16,0,30,14
1746576470972,EDS 250,A00,895697,Hemans; Patricia Ann Benitez,22,0,45,23
1746576471998,EDS 281,A00,895701,Meyerott; Theresa Ann,1,0,15,14
1746576473024,EDS 284,A00,895736,Meyerott; Theresa Ann,1,0,15,14
1746576474053,EDS 286,A00,897210,Fine; Sarah,0,0,15,15
1746576475080,EDS 289C,A01,895770,Daly; Alan J.,1,0,15,14
1746576476104,EDS 290,A00,897211,Hofstetter; Carolyn,0,0,15,15
1746576477129,LIGM 5A,A00,896162,Fischer-Grunski; Eva K,12,0,20,8
1746576478154,LIGM 5B,A00,896260,Fischer-Grunski; Eva K,17,0,20,3
1746576479183,LIGM 5C,A00,896308,Fischer-Grunski; Eva K,18,0,20,2
1746576480213,LIIT 5AS,A00,896313,Carnelos; Chiara,18,0,20,2
1746576481236,LIIT 5BS,A00,896416,Carnelos; Chiara,20,0,20,0
1746576482265,LIIT 5CS,A00,896564,Carnelos; Chiara,20,0,20,0
1746576483294,LISP 5A,A00,896588,Munoz Sanchez; Alicia,2,0,20,18
1746576484318,LISP 5B,A00,896653,Munoz Sanchez; Alicia,7,0,20,13
1746576485346,LISP 5C,A00,896655,Munoz Sanchez; Alicia,0,1,20,20
1746576486370,MAE 197,001,957918,Kleissl; Jan,9996,0,9999,3
1746576486370,MAE 197,002,959806,Boechler; Nicholas Sebastia,9998,0,9999,1
1746576486370,MAE 197,003,959852,Mullin; Jennifer S,9998,0,9999,1
1746576487399,MATH 2,A01,957937,Staff,33,0,35,2
1746576488425,MATH 197,001,957876,Kedlaya; Kiran S.,9993,0,9999,6
1746576489450,MCWP 40,A00,892729,Duru; Nur,10,0,20,10
1746576489450,MCWP 40,B00,893304,Montejo; Carolina,14,0,20,6
1746576490474,MCWP 40R,A00,893757,Redela; Pamela Morgan,0,5,20,20
1746576491499,MCWP 50,A00,893758,Morshed; Michael James,0,0,20,20
1746576491499,MCWP 50,B00,893761,Bartulis; Jason Michael,17,0,20,3
1746576492562,MCWP 50R,A00,893766,Compas; Sean Matthew,0,1,20,20
1746576492562,MCWP 50R,B00,893769,Carter; Jennifer A,0,1,20,20
1746576492562,MCWP 50R,C00,893771,Krone; Jarret,0,3,20,20
1746576492562,MCWP 50R,D00,893772,Miller; Elizabeth Deen,0,0,20,20
1746576492562,MCWP 50R,E00,893775,Carter; Andrea L,0,1,20,20
1746576493590,MMW 11R,A01,892721,Herbst; Matthew,14,0,30,16
1746576493590,MMW 11R,A02,892722,Herbst; Matthew,0,0,0,3
1746576494616,MMW 12R,A01,892724,Herbst; Matthew,0,11,16,16
1746576494616,MMW 12R,A02,892725,Herbst; Matthew,0,10,16,16
1746576495640,MMW 13R,A01,892727,Staff,0,4,16,16
1746576495640,MMW 13R,A02,892728,Staff,0,4,16,16
1746576495640,MMW 13R,A03,958032,Staff,0,4,16,16
1746576495640,MMW 13R,A04,958033,Staff,0,4,16,16
1746576495640,MMW 13R,A05,958034,Staff,0,4,16,16
1746576496663,SIO 295LS,A00,894015,Staff,5,0,25,20
1746576497692,SIO 295S,A00,894020,Staff,5,0,25,20
1746576498726,SIOC 290S,B01,958918,Merrifield; Mark A,14,0,30,16
1746576499752,SIOC 291S,B01,958922,Gabriel; Corey John,14,0,30,16
1746576500780,SOCI 117,A01,895339,Staff,3,0,5,2
1746576501806,WES 237B,A00,894149,Staff,11,0,20,9
1746576503872,AESE 279B,A00,891859,Staff,13,0,35,22
1746576504897,AIP 197,001,891854,Vespa; Emanuel Ignacio,9999,0,9999,0
1746576505925,ANTH 289S,A00,891856,Gagneux; Pascal,12,0,12,0
1746576506949,BENG 196,001,957946,Engler; Adam J.,9996,0,9999,3
1746576507975,BISP 197,001,959851,Wilhelm; James E.,9998,0,9999,1
1746576508999,CAT 124RS,A01,956906,Staff,6,0,25,19
1746576510025,CAT 125RS,A01,922013,Staff,6,0,25,19
1746576511050,CLRE 250,A00,891860,Morris; Sheldon,9995,0,9999,4
1746576513100,CLRE 251R,A00,907817,Mehta; Ravindra L.,9994,0,9999,5
1746576514126,CLRE 252,A00,891864,Cuomo; Raphael Eduardo,9993,0,9999,6
1746576515152,CLRE 253,A00,891867,Vaida; Florin,9994,0,9999,5
1746576515152,CLRE 253,B00,907819,Staff,9999,0,9999,0
1746576516178,CLRE 259,A00,891868,Patel; Hemal,9998,0,9999,1
1746576517203,CLRE 260,A00,891872,Cuomo; Raphael Eduardo,9999,0,9999,0
1746576518227,CLRE 297,001,891888,Cuomo; Raphael Eduardo,9999,0,9999,0
1746576519257,CSE 191,A00,958773,Minnes Kemp; Mor Mia,9995,0,9999,4
1746576520284,CSE 197,001,959846,Minnes Kemp; Mor Mia,9990,0,9999,9
1746576521308,CSS 201S,A01,892054,Mignozzetti; Umberto,25,0,30,5
1746576522342,CSS 202S,A01,892056,Mignozzetti; Umberto,25,0,30,5
1746576523373,DSC 197,001,956898,Eldridge; Justin Matthew,9996,0,9999,3
1746576524402,DSC 297,001,958000,Mazumdar; Arya,9998,0,9999,1
1746576524402,DSC 297,002,959862,Wang; Yusu,9998,0,9999,1
1746576525430,EAP 100,A00,905686,Staff,9778,0,9999,221
1746576526456,ECE 45,A01,892618,Staff,0,0,65,65
1746576528510,ECE 111,A01,892719,Staff,5,0,65,60
1746576529540,ECE 197,001,957920,Mercier; Patrick Philip,9991,0,9999,8
1746576530572,ECON 178,A01,907814,Zhu; Ying,26,0,35,9
1746576531597,EDS 115,A00,895312,Staff,35,0,45,10
1746576532623,EDS 117,A01,895337,Staff,23,0,30,7
1746576533650,EDS 125,A00,895341,Jones; Gabrielle Anastasia,36,0,45,9
1746576534676,EDS 128A,A01,895459,Fargason; Sharon Gayle,44,0,45,1
1746576535705,EDS 128B,A01,895543,Pappas; Elizabeth,44,0,45,1
1746576536731,EDS 139,A00,897203,Pappas; Elizabeth,44,0,45,1
1746576536731,EDS 139,B00,897209,Fargason; Sharon Gayle,41,0,45,4
1746576537757,EDS 201,A00,895545,Staff,22,0,45,23
1746576538783,EDS 203,A01,895581,Halter; Christopher P.,22,0,45,23
1746576539810,EDS 204R,A01,895625,Heinzman; Erica M.,39,0,45,6
1746576539810,EDS 204R,B01,895693,Halter; Christopher P.,10,0,45,35
1746576540835,EDS 206R,A00,895694,Fargason; Sharon Gayle,1,0,30,29
1746576540835,EDS 206R,B00,895695,Choi; Bailey Miyeon,16,0,30,14
1746576541863,EDS 250,A00,895697,Hemans; Patricia Ann Benitez,22,0,45,23
1746576542890,EDS 281,A00,895701,Meyerott; Theresa Ann,1,0,15,14
1746576543915,EDS 284,A00,895736,Meyerott; Theresa Ann,1,0,15,14
1746576544944,EDS 286,A00,897210,Fine; Sarah,0,0,15,15
1746576545974,EDS 289C,A01,895770,Daly; Alan J.,1,0,15,14
1746576546998,EDS 290,A00,897211,Hofstetter; Carolyn,0,0,15,15
1746576548024,LIGM 5A,A00,896162,Fischer-Grunski; Eva K,12,0,20,8
1746576549053,LIGM 5B,A00,896260,Fischer-Grunski; Eva K,17,0,20,3
1746576550079,LIGM 5C,A00,896308,Fischer-Grunski; Eva K,18,0,20,2
1746576551105,LIIT 5AS,A00,896313,Carnelos; Chiara,18,0,20,2
1746576552131,LIIT 5BS,A00,896416,Carnelos; Chiara,20,0,20,0
1746576553157,LIIT 5CS,A00,896564,Carnelos; Chiara,20,0,20,0
1746576554185,LISP 5A,A00,896588,Munoz Sanchez; Alicia,2,0,20,18
1746576555211,LISP 5B,A00,896653,Munoz Sanchez; Alicia,7,0,20,13
1746576556237,LISP 5C,A00,896655,Munoz Sanchez; Alicia,0,1,20,20
1746576557271,MAE 197,001,957918,Kleissl; Jan,9996,0,9999,3
1746576557271,MAE 197,002,959806,Boechler; Nicholas Sebastia,9998,0,9999,1
1746576557271,MAE 197,003,959852,Mullin; Jennifer S,9998,0,9999,1
1746576558298,MATH 2,A01,957937,Staff,33,0,35,2
1746576559327,MATH 197,001,957876,Kedlaya; Kiran S.,9993,0,9999,6
1746576560354,MCWP 40,A00,892729,Duru; Nur,10,0,20,10
1746576560354,MCWP 40,B00,893304,Montejo; Carolina,14,0,20,6
1746576561380,MCWP 40R,A00,893757,Redela; Pamela Morgan,0,5,20,20
1746576562408,MCWP 50,A00,893758,Morshed; Michael James,0,0,20,20
1746576562408,MCWP 50,B00,893761,Bartulis; Jason Michael,17,0,20,3
1746576563434,MCWP 50R,A00,893766,Compas; Sean Matthew,0,1,20,20
1746576563434,MCWP 50R,B00,893769,Carter; Jennifer A,0,1,20,20
1746576563434,MCWP 50R,C00,893771,Krone; Jarret,0,3,20,20
1746576563434,MCWP 50R,D00,893772,Miller; Elizabeth Deen,0,0,20,20
1746576563434,MCWP 50R,E00,893775,Carter; Andrea L,0,1,20,20
1746576564461,MMW 11R,A01,892721,Herbst; Matthew,14,0,30,16
1746576564461,MMW 11R,A02,892722,Herbst; Matthew,0,0,0,3
1746576565486,MMW 12R,A01,892724,Herbst; Matthew,0,11,16,16
1746576565486,MMW 12R,A02,892725,Herbst; Matthew,0,10,16,16
1746576566516,MMW 13R,A01,892727,Staff,0,4,16,16
1746576566516,MMW 13R,A02,892728,Staff,0,4,16,16
1746576566516,MMW 13R,A03,958032,Staff,0,4,16,16
1746576566516,MMW 13R,A04,958033,Staff,0,4,16,16
1746576566516,MMW 13R,A05,958034,Staff,0,4,16,16
1746576567546,SIO 295LS,A00,894015,Staff,5,0,25,20
1746576568570,SIO 295S,A00,894020,Staff,5,0,25,20
1746576569602,SIOC 290S,B01,958918,Merrifield; Mark A,14,0,30,16
1746576570628,SIOC 291S,B01,958922,Gabriel; Corey John,14,0,30,16
1746576571654,SOCI 117,A01,895339,Staff,3,0,5,2
1746576572678,WES 237B,A00,894149,Staff,11,0,20,9
1746576574752,AESE 279B,A00,891859,Staff,13,0,35,22
1746576575782,AIP 197,001,891854,Vespa; Emanuel Ignacio,9999,0,9999,0
1746576576810,ANTH 289S,A00,891856,Gagneux; Pascal,12,0,12,0
1746576577839,BENG 196,001,957946,Engler; Adam J.,9996,0,9999,3
1746576578863,BISP 197,001,959851,Wilhelm; James E.,9998,0,9999,1
1746576579888,CAT 124RS,A01,956906,Staff,6,0,25,19
1746576580916,CAT 125RS,A01,922013,Staff,6,0,25,19
1746576581946,CLRE 250,A00,891860,Morris; Sheldon,9995,0,9999,4
1746576583999,CLRE 251R,A00,907817,Mehta; Ravindra L.,9994,0,9999,5
1746576585030,CLRE 252,A00,891864,Cuomo; Raphael Eduardo,9993,0,9999,6
1746576586056,CLRE 253,A00,891867,Vaida; Florin,9994,0,9999,5
1746576586056,CLRE 253,B00,907819,Staff,9999,0,9999,0
1746576587086,CLRE 259,A00,891868,Patel; Hemal,9998,0,9999,1
1746576588115,CLRE 260,A00,891872,Cuomo; Raphael Eduardo,9999,0,9999,0
1746576589141,CLRE 297,001,891888,Cuomo; Raphael Eduardo,9999,0,9999,0
1746576590172,CSE 191,A00,958773,Minnes Kemp; Mor Mia,9995,0,9999,4
1746576591201,CSE 197,001,959846,Minnes Kemp; Mor Mia,9990,0,9999,9
1746576592230,CSS 201S,A01,892054,Mignozzetti; Umberto,25,0,30,5
1746576593261,CSS 202S,A01,892056,Mignozzetti; Umberto,25,0,30,5
1746576594286,DSC 197,001,956898,Eldridge; Justin Matthew,9996,0,9999,3
1746576595314,DSC 297,001,958000,Mazumdar; Arya,9998,0,9999,1
1746576595314,DSC 297,002,959862,Wang; Yusu,9998,0,9999,1
1746576596340,EAP 100,A00,905686,Staff,9778,0,9999,221
1746576597369,ECE 45,A01,892618,Staff,0,0,65,65
1746576599421,ECE 111,A01,892719,Staff,5,0,65,60
1746576600446,ECE 197,001,957920,Mercier; Patrick Philip,9991,0,9999,8
1746576601476,ECON 178,A01,907814,Zhu; Ying,26,0,35,9
1746576602505,EDS 115,A00,895312,Staff,35,0,45,10
1746576603532,EDS 117,A01,895337,Staff,23,0,30,7
1746576604557,EDS 125,A00,895341,Jones; Gabrielle Anastasia,36,0,45,9
1746576605588,EDS 128A,A01,895459,Fargason; Sharon Gayle,44,0,45,1
1746576606615,EDS 128B,A01,895543,Pappas; Elizabeth,44,0,45,1
1746576607641,EDS 139,A00,897203,Pappas; Elizabeth,44,0,45,1
1746576607641,EDS 139,B00,897209,Fargason; Sharon Gayle,41,0,45,4
1746576608670,EDS 201,A00,895545,Staff,22,0,45,23
1746576609696,EDS 203,A01,895581,Halter; Christopher P.,22,0,45,23
1746576610724,EDS 204R,A01,895625,Heinzman; Erica M.,39,0,45,6
1746576610724,EDS 204R,B01,895693,Halter; Christopher P.,10,0,45,35
1746576611750,EDS 206R,A00,895694,Fargason; Sharon Gayle,1,0,30,29
1746576611750,EDS 206R,B00,895695,Choi; Bailey Miyeon,16,0,30,14
1746576612776,EDS 250,A00,895697,Hemans; Patricia Ann Benitez,22,0,45,23
1746576613806,EDS 281,A00,895701,Meyerott; Theresa Ann,1,0,15,14
1746576614830,EDS 284,A00,895736,Meyerott; Theresa Ann,1,0,15,14
1746576615857,EDS 286,A00,897210,Fine; Sarah,0,0,15,15
1746576616885,EDS 289C,A01,895770,Daly; Alan J.,1,0,15,14
1746576617910,EDS 290,A00,897211,Hofstetter; Carolyn,0,0,15,15
1746576618942,LIGM 5A,A00,896162,Fischer-Grunski; Eva K,12,0,20,8
1746576619970,LIGM 5B,A00,896260,Fischer-Grunski; Eva K,17,0,20,3
1746576620995,LIGM 5C,A00,896308,Fischer-Grunski; Eva K,18,0,20,2
1746576622022,LIIT 5AS,A00,896313,Carnelos; Chiara,18,0,20,2
1746576623047,LIIT 5BS,A00,896416,Carnelos; Chiara,20,0,20,0
1746576624073,LIIT 5CS,A00,896564,Carnelos; Chiara,20,0,20,0
1746576625099,LISP 5A,A00,896588,Munoz Sanchez; Alicia,2,0,20,18
1746576626123,LISP 5B,A00,896653,Munoz Sanchez; Alicia,7,0,20,13
1746576627148,LISP 5C,A00,896655,Munoz Sanchez; Alicia,0,1,20,20
1746576628175,MAE 197,001,957918,Kleissl; Jan,9996,0,9999,3
1746576628175,MAE 197,002,959806,Boechler; Nicholas Sebastia,9998,0,9999,1
1746576628175,MAE 197,003,959852,Mullin; Jennifer S,9998,0,9999,1
1746576629202,MATH 2,A01,957937,Staff,33,0,35,2
1746576630231,MATH 197,001,957876,Kedlaya; Kiran S.,9993,0,9999,6
1746576631259,MCWP 40,A00,892729,Duru; Nur,10,0,20,10
1746576631259,MCWP 40,B00,893304,Montejo; Carolina,14,0,20,6
1746576632283,MCWP 40R,A00,893757,Redela; Pamela Morgan,0,5,20,20
1746576633309,MCWP 50,A00,893758,Morshed; Michael James,0,0,20,20
1746576633309,MCWP 50,B00,893761,Bartulis; Jason Michael,17,0,20,3
1746576634338,MCWP 50R,A00,893766,Compas; Sean Matthew,0,1,20,20
1746576634338,MCWP 50R,B00,893769,Carter; Jennifer A,0,1,20,20
1746576634338,MCWP 50R,C00,893771,Krone; Jarret,0,3,20,20
1746576634338,MCWP 50R,D00,893772,Miller; Elizabeth Deen,0,0,20,20
1746576634338,MCWP 50R,E00,893775,Carter; Andrea L,0,1,20,20
1746576635366,MMW 11R,A01,892721,Herbst; Matthew,14,0,30,16
1746576635366,MMW 11R,A02,892722,Herbst; Matthew,0,0,0,3
1746576636396,MMW 12R,A01,892724,Herbst; Matthew,0,11,16,16
1746576636396,MMW 12R,A02,892725,Herbst; Matthew,0,10,16,16
1746576637425,MMW 13R,A01,892727,Staff,0,4,16,16
1746576637425,MMW 13R,A02,892728,Staff,0,4,16,16
1746576637425,MMW 13R,A03,958032,Staff,0,4,16,16
1746576637425,MMW 13R,A04,958033,Staff,0,4,16,16
1746576637425,MMW 13R,A05,958034,Staff,0,4,16,16
1746576638450,SIO 295LS,A00,894015,Staff,5,0,25,20
1746576639476,SIO 295S,A00,894020,Staff,5,0,25,20
1746576640506,SIOC 290S,B01,958918,Merrifield; Mark A,14,0,30,16
1746576641535,SIOC 291S,B01,958922,Gabriel; Corey John,14,0,30,16
1746576642561,SOCI 117,A01,895339,Staff,3,0,5,2
1746576643587,WES 237B,A00,894149,Staff,11,0,20,9
1746576645651,AESE 279B,A00,891859,Staff,13,0,35,22
1746576646676,AIP 197,001,891854,Vespa; Emanuel Ignacio,9999,0,9999,0
1746576647701,ANTH 289S,A00,891856,Gagneux; Pascal,12,0,12,0
1746576648724,BENG 196,001,957946,Engler; Adam J.,9996,0,9999,3
1746576649756,BISP 197,001,959851,Wilhelm; James E.,9998,0,9999,1
1746576650837,CAT 124RS,A01,956906,Staff,6,0,25,19
1746576651862,CAT 125RS,A01,922013,Staff,6,0,25,19
1746576652890,CLRE 250,A00,891860,Morris; Sheldon,9995,0,9999,4
1746576654942,CLRE 251R,A00,907817,Mehta; Ravindra L.,9994,0,9999,5
1746576655971,CLRE 252,A00,891864,Cuomo; Raphael Eduardo,9993,0,9999,6
1746576656997,CLRE 253,A00,891867,Vaida; Florin,9994,0,9999,5
1746576656997,CLRE 253,B00,907819,Staff,9999,0,9999,0
1746576658023,CLRE 259,A00,891868,Patel; Hemal,9998,0,9999,1
1746576659051,CLRE 260,A00,891872,Cuomo; Raphael Eduardo,9999,0,9999,0
1746576660076,CLRE 297,001,891888,Cuomo; Raphael Eduardo,9999,0,9999,0
1746576661107,CSE 191,A00,958773,Minnes Kemp; Mor Mia,9995,0,9999,4
1746576662136,CSE 197,001,959846,Minnes Kemp; Mor Mia,9990,0,9999,9
1746576663167,CSS 201S,A01,892054,Mignozzetti; Umberto,25,0,30,5
1746576664198,CSS 202S,A01,892056,Mignozzetti; Umberto,25,0,30,5
1746576665223,DSC 197,001,956898,Eldridge; Justin Matthew,9996,0,9999,3
1746576666249,DSC 297,001,958000,Mazumdar; Arya,9998,0,9999,1
1746576666249,DSC 297,002,959862,Wang; Yusu,9998,0,9999,1
1746576667279,EAP 100,A00,905686,Staff,9778,0,9999,221
1746576668304,ECE 45,A01,892618,Staff,0,0,65,65
1746576670358,ECE 111,A01,892719,Staff,5,0,65,60
1746576671389,ECE 197,001,957920,Mercier; Patrick Philip,9991,0,9999,8
1746576672422,ECON 178,A01,907814,Zhu; Ying,26,0,35,9
1746576673448,EDS 115,A00,895312,Staff,35,0,45,10
1746576674476,EDS 117,A01,895337,Staff,23,0,30,7
1746576675503,EDS 125,A00,895341,Jones; Gabrielle Anastasia,36,0,45,9
1746576676527,EDS 128A,A01,895459,Fargason; Sharon Gayle,44,0,45,1
1746576677554,EDS 128B,A01,895543,Pappas; Elizabeth,44,0,45,1
1746576678579,EDS 139,A00,897203,Pappas; Elizabeth,44,0,45,1
1746576678579,EDS 139,B00,897209,Fargason; Sharon Gayle,41,0,45,4
1746576679604,EDS 201,A00,895545,Staff,22,0,45,23
1746576680630,EDS 203,A01,895581,Halter; Christopher P.,22,0,45,23
1746576681655,EDS 204R,A01,895625,Heinzman; Erica M.,39,0,45,6
1746576681655,EDS 204R,B01,895693,Halter; Christopher P.,10,0,45,35
1746576682681,EDS 206R,A00,895694,Fargason; Sharon Gayle,1,0,30,29
1746576682681,EDS 206R,B00,895695,Choi; Bailey Miyeon,16,0,30,14
1746576683709,EDS 250,A00,895697,Hemans; Patricia Ann Benitez,22,0,45,23
1746576684735,EDS 281,A00,895701,Meyerott; Theresa Ann,1,0,15,14
1746576685760,EDS 284,A00,895736,Meyerott; Theresa Ann,1,0,15,14
1746576686787,EDS 286,A00,897210,Fine; Sarah,0,0,15,15
1746576687815,EDS 289C,A01,895770,Daly; Alan J.,1,0,15,14
1746576688840,EDS 290,A00,897211,Hofstetter; Carolyn,0,0,15,15
1746576689866,LIGM 5A,A00,896162,Fischer-Grunski; Eva K,12,0,20,8
1746576690891,LIGM 5B,A00,896260,Fischer-Grunski; Eva K,17,0,20,3
1746576691917,LIGM 5C,A00,896308,Fischer-Grunski; Eva K,18,0,20,2
1746576692943,LIIT 5AS,A00,896313,Carnelos; Chiara,18,0,20,2
1746576693968,LIIT 5BS,A00,896416,Carnelos; Chiara,20,0,20,0
1746576694994,LIIT 5CS,A00,896564,Carnelos; Chiara,20,0,20,0
1746576696026,LISP 5A,A00,896588,Munoz Sanchez; Alicia,2,0,20,18
1746576697056,LISP 5B,A00,896653,Munoz Sanchez; Alicia,7,0,20,13
1746576698082,LISP 5C,A00,896655,Munoz Sanchez; Alicia,0,1,20,20
1746576699108,MAE 197,001,957918,Kleissl; Jan,9996,0,9999,3
1746576699108,MAE 197,002,959806,Boechler; Nicholas Sebastia,9998,0,9999,1
1746576699108,MAE 197,003,959852,Mullin; Jennifer S,9998,0,9999,1
1746576700135,MATH 2,A01,957937,Staff,33,0,35,2
1746576701159,MATH 197,001,957876,Kedlaya; Kiran S.,9993,0,9999,6
1746576702187,MCWP 40,A00,892729,Duru; Nur,10,0,20,10
1746576702187,MCWP 40,B00,893304,Montejo; Carolina,14,0,20,6
1746576703214,MCWP 40R,A00,893757,Redela; Pamela Morgan,0,5,20,20
1746576704241,MCWP 50,A00,893758,Morshed; Michael James,0,0,20,20
1746576704241,MCWP 50,B00,893761,Bartulis; Jason Michael,17,0,20,3
1746576705268,MCWP 50R,A00,893766,Compas; Sean Matthew,0,1,20,20
1746576705268,MCWP 50R,B00,893769,Carter; Jennifer A,0,1,20,20
1746576705268,MCWP 50R,C00,893771,Krone; Jarret,0,3,20,20
1746576705268,MCWP 50R,D00,893772,Miller; Elizabeth Deen,0,0,20,20
1746576705268,MCWP 50R,E00,893775,Carter; Andrea L,0,1,20,20
1746576706292,MMW 11R,A01,892721,Herbst; Matthew,14,0,30,16
1746576706292,MMW 11R,A02,892722,Herbst; Matthew,0,0,0,3
1746576707317,MMW 12R,A01,892724,Herbst; Matthew,0,11,16,16
1746576707317,MMW 12R,A02,892725,Herbst; Matthew,0,10,16,16
1746576708345,MMW 13R,A01,892727,Staff,0,4,16,16
1746576708345,MMW 13R,A02,892728,Staff,0,4,16,16
1746576708345,MMW 13R,A03,958032,Staff,0,4,16,16
1746576708345,MMW 13R,A04,958033,Staff,0,4,16,16
1746576708345,MMW 13R,A05,958034,Staff,0,4,16,16
1746576709370,SIO 295LS,A00,894015,Staff,5,0,25,20
1746576710397,SIO 295S,A00,894020,Staff,5,0,25,20
1746576711423,SIOC 290S,B01,958918,Merrifield; Mark A,14,0,30,16
1746576712455,SIOC 291S,B01,958922,Gabriel; Corey John,14,0,30,16
1746576713481,SOCI 117,A01,895339,Staff,3,0,5,2
1746576714507,WES 237B,A00,894149,Staff,11,0,20,9
1746576716566,AESE 279B,A00,891859,Staff,13,0,35,22
1746576717592,AIP 197,001,891854,Vespa; Emanuel Ignacio,9999,0,9999,0
1746576718622,ANTH 289S,A00,891856,Gagneux; Pascal,12,0,12,0
1746576719652,BENG 196,001,957946,Engler; Adam J.,9996,0,9999,3
1746576720680,BISP 197,001,959851,Wilhelm; James E.,9998,0,9999,1
1746576721706,CAT 124RS,A01,956906,Staff,6,0,25,19
1746576722734,CAT 125RS,A01,922013,Staff,6,0,25,19
1746576723759,CLRE 250,A00,891860,Morris; Sheldon,9995,0,9999,4
1746576725813,CLRE 251R,A00,907817,Mehta; Ravindra L.,9994,0,9999,5
1746576726839,CLRE 252,A00,891864,Cuomo; Raphael Eduardo,9993,0,9999,6
1746576727865,CLRE 253,A00,891867,Vaida; Florin,9994,0,9999,5
1746576727865,CLRE 253,B00,907819,Staff,9999,0,9999,0
1746576728900,CLRE 259,A00,891868,Patel; Hemal,9998,0,9999,1
1746576729927,CLRE 260,A00,891872,Cuomo; Raphael Eduardo,9999,0,9999,0
1746576730964,CLRE 297,001,891888,Cuomo; Raphael Eduardo,9999,0,9999,0
1746576732011,CSE 191,A00,958773,Minnes Kemp; Mor Mia,9995,0,9999,4
1746576733036,CSE 197,001,959846,Minnes Kemp; Mor Mia,9990,0,9999,9
1746576734067,CSS 201S,A01,892054,Mignozzetti; Umberto,25,0,30,5
1746576735103,CSS 202S,A01,892056,Mignozzetti; Umberto,25,0,30,5
1746576736130,DSC 197,001,956898,Eldridge; Justin Matthew,9996,0,9999,3
1746576737162,DSC 297,001,958000,Mazumdar; Arya,9998,0,9999,1
1746576737162,DSC 297,002,959862,Wang; Yusu,9998,0,9999,1
1746576738191,EAP 100,A00,905686,Staff,9778,0,9999,221
1746576739221,ECE 45,A01,892618,Staff,0,0,65,65
1746576741274,ECE 111,A01,892719,Staff,5,0,65,60
1746576742302,ECE 197,001,957920,Mercier; Patrick Philip,9991,0,9999,8
1746576743335,ECON 178,A01,907814,Zhu; Ying,26,0,35,9
1746576744364,EDS 115,A00,895312,Staff,35,0,45,10
1746576745389,EDS 117,A01,895337,Staff,23,0,30,7
1746576746415,EDS 125,A00,895341,Jones; Gabrielle Anastasia,36,0,45,9
1746576747447,EDS 128A,A01,895459,Fargason; Sharon Gayle,44,0,45,1
1746576748474,EDS 128B,A01,895543,Pappas; Elizabeth,44,0,45,1
1746576749503,EDS 139,A00,897203,Pappas; Elizabeth,44,0,45,1
1746576749503,EDS 139,B00,897209,Fargason; Sharon Gayle,41,0,45,4
1746576750528,EDS 201,A00,895545,Staff,22,0,45,23
1746576751555,EDS 203,A01,895581,Halter; Christopher P.,22,0,45,23
1746576752579,EDS 204R,A01,895625,Heinzman; Erica M.,39,0,45,6
1746576752579,EDS 204R,B01,895693,Halter; Christopher P.,10,0,45,35
1746576753610,EDS 206R,A00,895694,Fargason; Sharon Gayle,1,0,30,29
1746576753610,EDS 206R,B00,895695,Choi; Bailey Miyeon,16,0,30,14
1746576754675,EDS 250,A00,895697,Hemans; Patricia Ann Benitez,22,0,45,23
1746576755705,EDS 281,A00,895701,Meyerott; Theresa Ann,1,0,15,14
1746576756735,EDS 284,A00,895736,Meyerott; Theresa Ann,1,0,15,14
1746576757764,EDS 286,A00,897210,Fine; Sarah,0,0,15,15
1746576758788,EDS 289C,A01,895770,Daly; Alan J.,1,0,15,14
1746576759814,EDS 290,A00,897211,Hofstetter; Carolyn,0,0,15,15
1746576760842,LIGM 5A,A00,896162,Fischer-Grunski; Eva K,12,0,20,8
1746576761868,LIGM 5B,A00,896260,Fischer-Grunski; Eva K,17,0,20,3
1746576762894,LIGM 5C,A00,896308,Fischer-Grunski; Eva K,18,0,20,2
1746576763918,LIIT 5AS,A00,896313,Carnelos; Chiara,18,0,20,2
1746576764946,LIIT 5BS,A00,896416,Carnelos; Chiara,20,0,20,0
1746576765975,LIIT 5CS,A00,896564,Carnelos; Chiara,20,0,20,0
1746576767003,LISP 5A,A00,896588,Munoz Sanchez; Alicia,2,0,20,18
1746576768030,LISP 5B,A00,896653,Munoz Sanchez; Alicia,7,0,20,13
1746576769056,LISP 5C,A00,896655,Munoz Sanchez; Alicia,0,1,20,20
1746576770084,MAE 197,001,957918,Kleissl; Jan,9996,0,9999,3
1746576770084,MAE 197,002,959806,Boechler; Nicholas Sebastia,9998,0,9999,1
1746576770084,MAE 197,003,959852,Mullin; Jennifer S,9998,0,9999,1
1746576771110,MATH 2,A01,957937,Staff,33,0,35,2
1746576772138,MATH 197,001,957876,Kedlaya; Kiran S.,9993,0,9999,6
1746576773166,MCWP 40,A00,892729,Duru; Nur,10,0,20,10
1746576773166,MCWP 40,B00,893304,Montejo; Carolina,14,0,20,6
1746576774191,MCWP 40R,A00,893757,Redela; Pamela Morgan,0,5,20,20
1746576775221,MCWP 50,A00,893758,Morshed; Michael James,0,0,20,20
1746576775221,MCWP 50,B00,893761,Bartulis; Jason Michael,17,0,20,3
1746576776247,MCWP 50R,A00,893766,Compas; Sean Matthew,0,1,20,20
1746576776247,MCWP 50R,B00,893769,Carter; Jennifer A,0,1,20,20
1746576776247,MCWP 50R,C00,893771,Krone; Jarret,0,3,20,20
1746576776247,MCWP 50R,D00,893772,Miller; Elizabeth Deen,0,0,20,20
1746576776247,MCWP 50R,E00,893775,Carter; Andrea L,0,1,20,20
1746576777277,MMW 11R,A01,892721,Herbst; Matthew,14,0,30,16
1746576777277,MMW 11R,A02,892722,Herbst; Matthew,0,0,0,3
1746576778303,MMW 12R,A01,892724,Herbst; Matthew,0,11,16,16
1746576778303,MMW 12R,A02,892725,Herbst; Matthew,0,10,16,16
1746576779331,MMW 13R,A01,892727,Staff,0,4,16,16
1746576779331,MMW 13R,A02,892728,Staff,0,4,16,16
1746576779331,MMW 13R,A03,958032,Staff,0,4,16,16
1746576779331,MMW 13R,A04,958033,Staff,0,4,16,16
1746576779331,MMW 13R,A05,958034,Staff,0,4,16,16
1746576780358,SIO 295LS,A00,894015,Staff,5,0,25,20
1746576781387,SIO 295S,A00,894020,Staff,5,0,25,20
1746576782422,SIOC 290S,B01,958918,Merrifield; Mark A,14,0,30,16
1746576783448,SIOC 291S,B01,958922,Gabriel; Corey John,14,0,30,16
1746576784473,SOCI 117,A01,895339,Staff,3,0,5,2
1746576785500,WES 237B,A00,894149,Staff,11,0,20,9
1746576787560,AESE 279B,A00,891859,Staff,13,0,35,22
1746576788584,AIP 197,001,891854,Vespa; Emanuel Ignacio,9999,0,9999,0
1746576789618,ANTH 289S,A00,891856,Gagneux; Pascal,12,0,12,0
1746576790648,BENG 196,001,957946,Engler; Adam J.,9996,0,9999,3
1746576791675,BISP 197,001,959851,Wilhelm; James E.,9998,0,9999,1
1746576792704,CAT 124RS,A01,956906,Staff,6,0,25,19
1746576793729,CAT 125RS,A01,922013,Staff,6,0,25,19
1746576794759,CLRE 250,A00,891860,Morris; Sheldon,9995,0,9999,4
1746576796810,CLRE 251R,A00,907817,Mehta; Ravindra L.,9994,0,9999,5
1746576797840,CLRE 252,A00,891864,Cuomo; Raphael Eduardo,9993,0,9999,6
1746576798863,CLRE 253,A00,891867,Vaida; Florin,9994,0,9999,5
1746576798863,CLRE 253,B00,907819,Staff,9999,0,9999,0
1746576799890,CLRE 259,A00,891868,Patel; Hemal,9998,0,9999,1
1746576800919,CLRE 260,A00,891872,Cuomo; Raphael Eduardo,9999,0,9999,0
1746576801944,CLRE 297,001,891888,Cuomo; Raphael Eduardo,9999,0,9999,0
1746576802976,CSE 191,A00,958773,Minnes Kemp; Mor Mia,9995,0,9999,4
1746576804005,CSE 197,001,959846,Minnes Kemp; Mor Mia,9990,0,9999,9
1746576805036,CSS 201S,A01,892054,Mignozzetti; Umberto,25,0,30,5
1746576806069,CSS 202S,A01,892056,Mignozzetti; Umberto,25,0,30,5
1746576807093,DSC 197,001,956898,Eldridge; Justin Matthew,9996,0,9999,3
1746576808122,DSC 297,001,958000,Mazumdar; Arya,9998,0,9999,1
1746576808122,DSC 297,002,959862,Wang; Yusu,9998,0,9999,1
1746576809152,EAP 100,A00,905686,Staff,9778,0,9999,221
1746576810178,ECE 45,A01,892618,Staff,0,0,65,65
1746576812232,ECE 111,A01,892719,Staff,5,0,65,60
1746576813259,ECE 197,001,957920,Mercier; Patrick Philip,9991,0,9999,8
1746576814285,ECON 178,A01,907814,Zhu; Ying,26,0,35,9
1746576815311,EDS 115,A00,895312,Staff,35,0,45,10
1746576816336,EDS 117,A01,895337,Staff,23,0,30,7
1746576817361,EDS 125,A00,895341,Jones; Gabrielle Anastasia,36,0,45,9
1746576818387,EDS 128A,A01,895459,Fargason; Sharon Gayle,44,0,45,1
1746576819417,EDS 128B,A01,895543,Pappas; Elizabeth,44,0,45,1
1746576820446,EDS 139,A00,897203,Pappas; Elizabeth,44,0,45,1
1746576820446,EDS 139,B00,897209,Fargason; Sharon Gayle,41,0,45,4
1746576821477,EDS 201,A00,895545,Staff,22,0,45,23
1746576822504,EDS 203,A01,895581,Halter; Christopher P.,22,0,45,23
1746576823529,EDS 204R,A01,895625,Heinzman; Erica M.,39,0,45,6
1746576823529,EDS 204R,B01,895693,Halter; Christopher P.,10,0,45,35
1746576824555,EDS 206R,A00,895694,Fargason; Sharon Gayle,1,0,30,29
1746576824555,EDS 206R,B00,895695,Choi; Bailey Miyeon,16,0,30,14
1746576825582,EDS 250,A00,895697,Hemans; Patricia Ann Benitez,22,0,45,23
1746576826612,EDS 281,A00,895701,Meyerott; Theresa Ann,1,0,15,14
1746576827638,EDS 284,A00,895736,Meyerott; Theresa Ann,1,0,15,14
1746576828668,EDS 286,A00,897210,Fine; Sarah,0,0,15,15
1746576829699,EDS 289C,A01,895770,Daly; Alan J.,1,0,15,14
1746576830730,EDS 290,A00,897211,Hofstetter; Carolyn,0,0,15,15
1746576831755,LIGM 5A,A00,896162,Fischer-Grunski; Eva K,12,0,20,8
1746576832784,LIGM 5B,A00,896260,Fischer-Grunski; Eva K,17,0,20,3
1746576833813,LIGM 5C,A00,896308,Fischer-Grunski; Eva K,18,0,20,2
1746576834838,LIIT 5AS,A00,896313,Carnelos; Chiara,18,0,20,2
1746576835865,LIIT 5BS,A00,896416,Carnelos; Chiara,20,0,20,0
1746576836891,LIIT 5CS,A00,896564,Carnelos; Chiara,20,0,20,0
1746576837920,LISP 5A,A00,896588,Munoz Sanchez; Alicia,2,0,20,18
1746576838948,LISP 5B,A00,896653,Munoz Sanchez; Alicia,7,0,20,13
1746576839978,LISP 5C,A00,896655,Munoz Sanchez; Alicia,0,1,20,20
1746576841007,MAE 197,001,957918,Kleissl; Jan,9996,0,9999,3
1746576841007,MAE 197,002,959806,Boechler; Nicholas Sebastia,9998,0,9999,1
1746576841007,MAE 197,003,959852,Mullin; Jennifer S,9998,0,9999,1
1746576842032,MATH 2,A01,957937,Staff,33,0,35,2
1746576843061,MATH 197,001,957876,Kedlaya; Kiran S.,9993,0,9999,6
1746576844088,MCWP 40,A00,892729,Duru; Nur,10,0,20,10
1746576844088,MCWP 40,B00,893304,Montejo; Carolina,14,0,20,6
1746576845115,MCWP 40R,A00,893757,Redela; Pamela Morgan,0,5,20,20
1746576846141,MCWP 50,A00,893758,Morshed; Michael James,0,0,20,20
1746576846141,MCWP 50,B00,893761,Bartulis; Jason Michael,17,0,20,3
1746576847169,MCWP 50R,A00,893766,Compas; Sean Matthew,0,1,20,20
1746576847169,MCWP 50R,B00,893769,Carter; Jennifer A,0,1,20,20
1746576847169,MCWP 50R,C00,893771,Krone; Jarret,0,3,20,20
1746576847169,MCWP 50R,D00,893772,Miller; Elizabeth Deen,0,0,20,20
1746576847169,MCWP 50R,E00,893775,Carter; Andrea L,0,1,20,20
1746576848200,MMW 11R,A01,892721,Herbst; Matthew,14,0,30,16
1746576848200,MMW 11R,A02,892722,Herbst; Matthew,0,0,0,3
1746576849226,MMW 12R,A01,892724,Herbst; Matthew,0,11,16,16
1746576849226,MMW 12R,A02,892725,Herbst; Matthew,0,10,16,16
1746576850253,MMW 13R,A01,892727,Staff,0,4,16,16
1746576850253,MMW 13R,A02,892728,Staff,0,4,16,16
1746576850253,MMW 13R,A03,958032,Staff,0,4,16,16
1746576850253,MMW 13R,A04,958033,Staff,0,4,16,16
1746576850253,MMW 13R,A05,958034,Staff,0,4,16,16
1746576851281,SIO 295LS,A00,894015,Staff,5,0,25,20
1746576852307,SIO 295S,A00,894020,Staff,5,0,25,20
1746576853332,SIOC 290S,B01,958918,Merrifield; Mark A,14,0,30,16
1746576854359,SIOC 291S,B01,958922,Gabriel; Corey John,14,0,30,16
1746576855385,SOCI 117,A01,895339,Staff,3,0,5,2
1746576856412,WES 237B,A00,894149,Staff,11,0,20,9
1746576858528,AESE 279B,A00,891859,Staff,13,0,35,22
1746576859554,AIP 197,001,891854,Vespa; Emanuel Ignacio,9999,0,9999,0
1746576860584,ANTH 289S,A00,891856,Gagneux; Pascal,12,0,12,0
1746576861612,BENG 196,001,957946,Engler; Adam J.,9996,0,9999,3
1746576862643,BISP 197,001,959851,Wilhelm; James E.,9998,0,9999,1
1746576863670,CAT 124RS,A01,956906,Staff,6,0,25,19
1746576864696,CAT 125RS,A01,922013,Staff,6,0,25,19
1746576865727,CLRE 250,A00,891860,Morris; Sheldon,9995,0,9999,4
1746576867783,CLRE 251R,A00,907817,Mehta; Ravindra L.,9994,0,9999,5
1746576868809,CLRE 252,A00,891864,Cuomo; Raphael Eduardo,9993,0,9999,6
1746576869839,CLRE 253,A00,891867,Vaida; Florin,9994,0,9999,5
1746576869839,CLRE 253,B00,907819,Staff,9999,0,9999,0
1746576870868,CLRE 259,A00,891868,Patel; Hemal,9998,0,9999,1
1746576871892,CLRE 260,A00,891872,Cuomo; Raphael Eduardo,9999,0,9999,0
1746576872918,CLRE 297,001,891888,Cuomo; Raphael Eduardo,9999,0,9999,0
1746576873944,CSE 191,A00,958773,Minnes Kemp; Mor Mia,9995,0,9999,4
1746576874970,CSE 197,001,959846,Minnes Kemp; Mor Mia,9990,0,9999,9
1746576876001,CSS 201S,A01,892054,Mignozzetti; Umberto,25,0,30,5
1746576877032,CSS 202S,A01,892056,Mignozzetti; Umberto,25,0,30,5
1746576878062,DSC 197,001,956898,Eldridge; Justin Matthew,9996,0,9999,3
1746576879089,DSC 297,001,958000,Mazumdar; Arya,9998,0,9999,1
1746576879089,DSC 297,002,959862,Wang; Yusu,9998,0,9999,1
1746576880115,EAP 100,A00,905686,Staff,9778,0,9999,221
1746576881141,ECE 45,A01,892618,Staff,0,0,65,65
1746576883198,ECE 111,A01,892719,Staff,5,0,65,60
1746576884222,ECE 197,001,957920,Mercier; Patrick Philip,9991,0,9999,8
1746576885249,ECON 178,A01,907814,Zhu; Ying,26,0,35,9
1746576886277,EDS 115,A00,895312,Staff,35,0,45,10
1746576887303,EDS 117,A01,895337,Staff,23,0,30,7
1746576888330,EDS 125,A00,895341,Jones; Gabrielle Anastasia,36,0,45,9
1746576889356,EDS 128A,A01,895459,Fargason; Sharon Gayle,44,0,45,1
1746576890382,EDS 128B,A01,895543,Pappas; Elizabeth,44,0,45,1
1746576891413,EDS 139,A00,897203,Pappas; Elizabeth,44,0,45,1
1746576891413,EDS 139,B00,897209,Fargason; Sharon Gayle,41,0,45,4
1746576892438,EDS 201,A00,895545,Staff,22,0,45,23
1746576893465,EDS 203,A01,895581,Halter; Christopher P.,22,0,45,23
1746576894492,EDS 204R,A01,895625,Heinzman; Erica M.,39,0,45,6
1746576894492,EDS 204R,B01,895693,Halter; Christopher P.,10,0,45,35
1746576895519,EDS 206R,A00,895694,Fargason; Sharon Gayle,1,0,30,29
1746576895519,EDS 206R,B00,895695,Choi; Bailey Miyeon,16,0,30,14
1746576896552,EDS 250,A00,895697,Hemans; Patricia Ann Benitez,22,0,45,23
1746576897576,EDS 281,A00,895701,Meyerott; Theresa Ann,1,0,15,14
1746576898607,EDS 284,A00,895736,Meyerott; Theresa Ann,1,0,15,14
1746576899634,EDS 286,A00,897210,Fine; Sarah,0,0,15,15
1746576900659,EDS 289C,A01,895770,Daly; Alan J.,1,0,15,14
1746576901684,EDS 290,A00,897211,Hofstetter; Carolyn,0,0,15,15
1746576902715,LIGM 5A,A00,896162,Fischer-Grunski; Eva K,12,0,20,8
1746576903743,LIGM 5B,A00,896260,Fischer-Grunski; Eva K,17,0,20,3
1746576904775,LIGM 5C,A00,896308,Fischer-Grunski; Eva K,18,0,20,2
1746576905801,LIIT 5AS,A00,896313,Carnelos; Chiara,18,0,20,2
1746576906827,LIIT 5BS,A00,896416,Carnelos; Chiara,20,0,20,0
1746576907854,LIIT 5CS,A00,896564,Carnelos; Chiara,20,0,20,0
1746576908879,LISP 5A,A00,896588,Munoz Sanchez; Alicia,2,0,20,18
1746576909911,LISP 5B,A00,896653,Munoz Sanchez; Alicia,7,0,20,13
1746576910937,LISP 5C,A00,896655,Munoz Sanchez; Alicia,0,1,20,20
1746576911963,MAE 197,001,957918,Kleissl; Jan,9996,0,9999,3
1746576911963,MAE 197,002,959806,Boechler; Nicholas Sebastia,9998,0,9999,1
1746576911963,MAE 197,003,959852,Mullin; Jennifer S,9998,0,9999,1
1746576912998,MATH 2,A01,957937,Staff,33,0,35,2
1746576914023,MATH 197,001,957876,Kedlaya; Kiran S.,9993,0,9999,6
1746576915047,MCWP 40,A00,892729,Duru; Nur,10,0,20,10
1746576915047,MCWP 40,B00,893304,Montejo; Carolina,14,0,20,6
1746576916076,MCWP 40R,A00,893757,Redela; Pamela Morgan,0,5,20,20
1746576917105,MCWP 50,A00,893758,Morshed; Michael James,0,0,20,20
1746576917105,MCWP 50,B00,893761,Bartulis; Jason Michael,17,0,20,3
1746576918133,MCWP 50R,A00,893766,Compas; Sean Matthew,0,1,20,20
1746576918133,MCWP 50R,B00,893769,Carter; Jennifer A,0,1,20,20
1746576918133,MCWP 50R,C00,893771,Krone; Jarret,0,3,20,20
1746576918133,MCWP 50R,D00,893772,Miller; Elizabeth Deen,0,0,20,20
1746576918133,MCWP 50R,E00,893775,Carter; Andrea L,0,1,20,20
1746576919160,MMW 11R,A01,892721,Herbst; Matthew,14,0,30,16
1746576919160,MMW 11R,A02,892722,Herbst; Matthew,0,0,0,3
1746576920186,MMW 12R,A01,892724,Herbst; Matthew,0,11,16,16
1746576920186,MMW 12R,A02,892725,Herbst; Matthew,0,10,16,16
1746576921212,MMW 13R,A01,892727,Staff,0,4,16,16
1746576921212,MMW 13R,A02,892728,Staff,0,4,16,16
1746576921212,MMW 13R,A03,958032,Staff,0,4,16,16
1746576921212,MMW 13R,A04,958033,Staff,0,4,16,16
1746576921212,MMW 13R,A05,958034,Staff,0,4,16,16
1746576922244,SIO 295LS,A00,894015,Staff,5,0,25,20
1746576923274,SIO 295S,A00,894020,Staff,5,0,25,20
1746576924303,SIOC 290S,B01,958918,Merrifield; Mark A,14,0,30,16
1746576925330,SIOC 291S,B01,958922,Gabriel; Corey John,14,0,30,16
1746576926354,SOCI 117,A01,895339,Staff,3,0,5,2
1746576927382,WES 237B,A00,894149,Staff,11,0,20,9
1746576929447,AESE 279B,A00,891859,Staff,13,0,35,22
1746576930473,AIP 197,001,891854,Vespa; Emanuel Ignacio,9999,0,9999,0
1746576931503,ANTH 289S,A00,891856,Gagneux; Pascal,12,0,12,0
1746576932532,BENG 196,001,957946,Engler; Adam J.,9996,0,9999,3
1746576933558,BISP 197,001,959851,Wilhelm; James E.,9998,0,9999,1
1746576934583,CAT 124RS,A01,956906,Staff,6,0,25,19
1746576935611,CAT 125RS,A01,922013,Staff,6,0,25,19
1746576936638,CLRE 250,A00,891860,Morris; Sheldon,9995,0,9999,4
1746576938689,CLRE 251R,A00,907817,Mehta; Ravindra L.,9994,0,9999,5
1746576939715,CLRE 252,A00,891864,Cuomo; Raphael Eduardo,9993,0,9999,6
1746576940742,CLRE 253,A00,891867,Vaida; Florin,9994,0,9999,5
1746576940742,CLRE 253,B00,907819,Staff,9999,0,9999,0
1746576941768,CLRE 259,A00,891868,Patel; Hemal,9998,0,9999,1
1746576942794,CLRE 260,A00,891872,Cuomo; Raphael Eduardo,9999,0,9999,0
1746576943821,CLRE 297,001,891888,Cuomo; Raphael Eduardo,9999,0,9999,0
1746576944847,CSE 191,A00,958773,Minnes Kemp; Mor Mia,9995,0,9999,4
1746576945873,CSE 197,001,959846,Minnes Kemp; Mor Mia,9990,0,9999,9
1746576946904,CSS 201S,A01,892054,Mignozzetti; Umberto,25,0,30,5
1746576947930,CSS 202S,A01,892056,Mignozzetti; Umberto,25,0,30,5
1746576948954,DSC 197,001,956898,Eldridge; Justin Matthew,9996,0,9999,3
1746576949987,DSC 297,001,958000,Mazumdar; Arya,9998,0,9999,1
1746576949987,DSC 297,002,959862,Wang; Yusu,9998,0,9999,1
1746576951012,EAP 100,A00,905686,Staff,9778,0,9999,221
1746576952038,ECE 45,A01,892618,Staff,0,0,65,65
1746576954094,ECE 111,A01,892719,Staff,5,0,65,60
1746576955119,ECE 197,001,957920,Mercier; Patrick Philip,9991,0,9999,8
1746576956151,ECON 178,A01,907814,Zhu; Ying,26,0,35,9
1746576957178,EDS 115,A00,895312,Staff,35,0,45,10
1746576958202,EDS 117,A01,895337,Staff,23,0,30,7
1746576959229,EDS 125,A00,895341,Jones; Gabrielle Anastasia,36,0,45,9
1746576960259,EDS 128A,A01,895459,Fargason; Sharon Gayle,44,0,45,1
1746576961285,EDS 128B,A01,895543,Pappas; Elizabeth,44,0,45,1
1746576962354,EDS 139,A00,897203,Pappas; Elizabeth,44,0,45,1
1746576962354,EDS 139,B00,897209,Fargason; Sharon Gayle,41,0,45,4
1746576963377,EDS 201,A00,895545,Staff,22,0,45,23
1746576964406,EDS 203,A01,895581,Halter; Christopher P.,22,0,45,23
1746576965431,EDS 204R,A01,895625,Heinzman; Erica M.,39,0,45,6
1746576965431,EDS 204R,B01,895693,Halter; Christopher P.,10,0,45,35
1746576966462,EDS 206R,A00,895694,Fargason; Sharon Gayle,1,0,30,29
1746576966462,EDS 206R,B00,895695,Choi; Bailey Miyeon,16,0,30,14
1746576967487,EDS 250,A00,895697,Hemans; Patricia Ann Benitez,22,0,45,23
1746576968512,EDS 281,A00,895701,Meyerott; Theresa Ann,1,0,15,14
1746576969540,EDS 284,A00,895736,Meyerott; Theresa Ann,1,0,15,14
1746576970570,EDS 286,A00,897210,Fine; Sarah,0,0,15,15
1746576971596,EDS 289C,A01,895770,Daly; Alan J.,1,0,15,14
1746576972624,EDS 290,A00,897211,Hofstetter; Carolyn,0,0,15,15
1746576973648,LIGM 5A,A00,896162,Fischer-Grunski; Eva K,12,0,20,8
1746576974672,LIGM 5B,A00,896260,Fischer-Grunski; Eva K,17,0,20,3
1746576975701,LIGM 5C,A00,896308,Fischer-Grunski; Eva K,18,0,20,2
1746576976727,LIIT 5AS,A00,896313,Carnelos; Chiara,18,0,20,2
1746576977752,LIIT 5BS,A00,896416,Carnelos; Chiara,20,0,20,0
1746576978781,LIIT 5CS,A00,896564,Carnelos; Chiara,20,0,20,0
1746576979808,LISP 5A,A00,896588,Munoz Sanchez; Alicia,2,0,20,18
1746576980834,LISP 5B,A00,896653,Munoz Sanchez; Alicia,7,0,20,13
1746576981859,LISP 5C,A00,896655,Munoz Sanchez; Alicia,0,1,20,20
1746576982887,MAE 197,001,957918,Kleissl; Jan,9996,0,9999,3
1746576982887,MAE 197,002,959806,Boechler; Nicholas Sebastia,9998,0,9999,1
1746576982887,MAE 197,003,959852,Mullin; Jennifer S,9998,0,9999,1
1746576983911,MATH 2,A01,957937,Staff,33,0,35,2
1746576984940,MATH 197,001,957876,Kedlaya; Kiran S.,9993,0,9999,6
1746576985965,MCWP 40,A00,892729,Duru; Nur,10,0,20,10
1746576985965,MCWP 40,B00,893304,Montejo; Carolina,14,0,20,6
1746576986994,MCWP 40R,A00,893757,Redela; Pamela Morgan,0,5,20,20
1746576988021,MCWP 50,A00,893758,Morshed; Michael James,0,0,20,20
1746576988021,MCWP 50,B00,893761,Bartulis; Jason Michael,17,0,20,3
1746576989047,MCWP 50R,A00,893766,Compas; Sean Matthew,0,1,20,20
1746576989047,MCWP 50R,B00,893769,Carter; Jennifer A,0,1,20,20
1746576989047,MCWP 50R,C00,893771,Krone; Jarret,0,3,20,20
1746576989047,MCWP 50R,D00,893772,Miller; Elizabeth Deen,0,0,20,20
1746576989047,MCWP 50R,E00,893775,Carter; Andrea L,0,1,20,20
1746576990076,MMW 11R,A01,892721,Herbst; Matthew,14,0,30,16
1746576990076,MMW 11R,A02,892722,Herbst; Matthew,0,0,0,3
1746576991103,MMW 12R,A01,892724,Herbst; Matthew,0,11,16,16
1746576991103,MMW 12R,A02,892725,Herbst; Matthew,0,10,16,16
1746576992131,MMW 13R,A01,892727,Staff,0,4,16,16
1746576992131,MMW 13R,A02,892728,Staff,0,4,16,16
1746576992131,MMW 13R,A03,958032,Staff,0,4,16,16
1746576992131,MMW 13R,A04,958033,Staff,0,4,16,16
1746576992131,MMW 13R,A05,958034,Staff,0,4,16,16
1746576993159,SIO 295LS,A00,894015,Staff,5,0,25,20
1746576994196,SIO 295S,A00,894020,Staff,5,0,25,20
1746576995222,SIOC 290S,B01,958918,Merrifield; Mark A,14,0,30,16
1746576996248,SIOC 291S,B01,958922,Gabriel; Corey John,14,0,30,16
1746576997274,SOCI 117,A01,895339,Staff,3,0,5,2
1746576998299,WES 237B,A00,894149,Staff,11,0,20,9
1746577000359,AESE 279B,A00,891859,Staff,13,0,35,22
1746577001386,AIP 197,001,891854,Vespa; Emanuel Ignacio,9999,0,9999,0
1746577002412,ANTH 289S,A00,891856,Gagneux; Pascal,12,0,12,0
1746577003436,BENG 196,001,957946,Engler; Adam J.,9996,0,9999,3
1746577004460,BISP 197,001,959851,Wilhelm; James E.,9998,0,9999,1
1746577005489,CAT 124RS,A01,956906,Staff,6,0,25,19
1746577006519,CAT 125RS,A01,922013,Staff,6,0,25,19
1746577007545,CLRE 250,A00,891860,Morris; Sheldon,9995,0,9999,4
1746577009600,CLRE 251R,A00,907817,Mehta; Ravindra L.,9994,0,9999,5
1746577010631,CLRE 252,A00,891864,Cuomo; Raphael Eduardo,9993,0,9999,6
1746577011656,CLRE 253,A00,891867,Vaida; Florin,9994,0,9999,5
1746577011656,CLRE 253,B00,907819,Staff,9999,0,9999,0
1746577012685,CLRE 259,A00,891868,Patel; Hemal,9998,0,9999,1
1746577013710,CLRE 260,A00,891872,Cuomo; Raphael Eduardo,9999,0,9999,0
1746577014734,CLRE 297,001,891888,Cuomo; Raphael Eduardo,9999,0,9999,0
1746577015762,CSE 191,A00,958773,Minnes Kemp; Mor Mia,9995,0,9999,4
1746577016787,CSE 197,001,959846,Minnes Kemp; Mor Mia,9990,0,9999,9
1746577017812,CSS 201S,A01,892054,Mignozzetti; Umberto,25,0,30,5
1746577018839,CSS 202S,A01,892056,Mignozzetti; Umberto,25,0,30,5
1746577019874,DSC 197,001,956898,Eldridge; Justin Matthew,9996,0,9999,3
1746577020900,DSC 297,001,958000,Mazumdar; Arya,9998,0,9999,1
1746577020900,DSC 297,002,959862,Wang; Yusu,9998,0,9999,1
1746577021924,EAP 100,A00,905686,Staff,9778,0,9999,221
1746577022957,ECE 45,A01,892618,Staff,0,0,65,65
1746577025016,ECE 111,A01,892719,Staff,5,0,65,60
1746577026045,ECE 197,001,957920,Mercier; Patrick Philip,9991,0,9999,8
1746577027075,ECON 178,A01,907814,Zhu; Ying,26,0,35,9
1746577028100,EDS 115,A00,895312,Staff,35,0,45,10
1746577029126,EDS 117,A01,895337,Staff,23,0,30,7
1746577030152,EDS 125,A00,895341,Jones; Gabrielle Anastasia,36,0,45,9
1746577031178,EDS 128A,A01,895459,Fargason; Sharon Gayle,44,0,45,1
1746577032205,EDS 128B,A01,895543,Pappas; Elizabeth,44,0,45,1
1746577033233,EDS 139,A00,897203,Pappas; Elizabeth,44,0,45,1
1746577033233,EDS 139,B00,897209,Fargason; Sharon Gayle,41,0,45,4
1746577034261,EDS 201,A00,895545,Staff,22,0,45,23
1746577035290,EDS 203,A01,895581,Halter; Christopher P.,22,0,45,23
1746577036314,EDS 204R,A01,895625,Heinzman; Erica M.,39,0,45,6
1746577036314,EDS 204R,B01,895693,Halter; Christopher P.,10,0,45,35
1746577037349,EDS 206R,A00,895694,Fargason; Sharon Gayle,1,0,30,29
1746577037349,EDS 206R,B00,895695,Choi; Bailey Miyeon,16,0,30,14
1746577038375,EDS 250,A00,895697,Hemans; Patricia Ann Benitez,22,0,45,23
1746577039404,EDS 281,A00,895701,Meyerott; Theresa Ann,1,0,15,14
1746577040429,EDS 284,A00,895736,Meyerott; Theresa Ann,1,0,15,14
1746577041454,EDS 286,A00,897210,Fine; Sarah,0,0,15,15
1746577042478,EDS 289C,A01,895770,Daly; Alan J.,1,0,15,14
1746577043504,EDS 290,A00,897211,Hofstetter; Carolyn,0,0,15,15
1746577044535,LIGM 5A,A00,896162,Fischer-Grunski; Eva K,12,0,20,8
1746577045566,LIGM 5B,A00,896260,Fischer-Grunski; Eva K,17,0,20,3
1746577046592,LIGM 5C,A00,896308,Fischer-Grunski; Eva K,18,0,20,2
1746577047618,LIIT 5AS,A00,896313,Carnelos; Chiara,18,0,20,2
1746577048643,LIIT 5BS,A00,896416,Carnelos; Chiara,20,0,20,0
1746577049672,LIIT 5CS,A00,896564,Carnelos; Chiara,20,0,20,0
1746577050697,LISP 5A,A00,896588,Munoz Sanchez; Alicia,2,0,20,18
1746577051728,LISP 5B,A00,896653,Munoz Sanchez; Alicia,7,0,20,13
1746577052754,LISP 5C,A00,896655,Munoz Sanchez; Alicia,0,1,20,20
1746577053780,MAE 197,001,957918,Kleissl; Jan,9996,0,9999,3
1746577053780,MAE 197,002,959806,Boechler; Nicholas Sebastia,9998,0,9999,1
1746577053780,MAE 197,003,959852,Mullin; Jennifer S,9998,0,9999,1
1746577054808,MATH 2,A01,957937,Staff,33,0,35,2
1746577055836,MATH 197,001,957876,Kedlaya; Kiran S.,9993,0,9999,6
1746577056866,MCWP 40,A00,892729,Duru; Nur,10,0,20,10
1746577056866,MCWP 40,B00,893304,Montejo; Carolina,14,0,20,6
1746577057895,MCWP 40R,A00,893757,Redela; Pamela Morgan,0,5,20,20
1746577058925,MCWP 50,A00,893758,Morshed; Michael James,0,0,20,20
1746577058925,MCWP 50,B00,893761,Bartulis; Jason Michael,17,0,20,3
1746577059951,MCWP 50R,A00,893766,Compas; Sean Matthew,0,1,20,20
1746577059951,MCWP 50R,B00,893769,Carter; Jennifer A,0,1,20,20
1746577059951,MCWP 50R,C00,893771,Krone; Jarret,0,3,20,20
1746577059951,MCWP 50R,D00,893772,Miller; Elizabeth Deen,0,0,20,20
1746577059951,MCWP 50R,E00,893775,Carter; Andrea L,0,1,20,20
1746577060976,MMW 11R,A01,892721,Herbst; Matthew,14,0,30,16
1746577060976,MMW 11R,A02,892722,Herbst; Matthew,0,0,0,3
1746577062004,MMW 12R,A01,892724,Herbst; Matthew,0,11,16,16
1746577062004,MMW 12R,A02,892725,Herbst; Matthew,0,10,16,16
1746577063029,MMW 13R,A01,892727,Staff,0,4,16,16
1746577063029,MMW 13R,A02,892728,Staff,0,4,16,16
1746577063029,MMW 13R,A03,958032,Staff,0,4,16,16
1746577063029,MMW 13R,A04,958033,Staff,0,4,16,16
1746577063029,MMW 13R,A05,958034,Staff,0,4,16,16
1746577064057,SIO 295LS,A00,894015,Staff,5,0,25,20
1746577065090,SIO 295S,A00,894020,Staff,5,0,25,20
1746577066171,SIOC 290S,B01,958918,Merrifield; Mark A,14,0,30,16
1746577067196,SIOC 291S,B01,958922,Gabriel; Corey John,14,0,30,16
1746577068221,SOCI 117,A01,895339,Staff,3,0,5,2
1746577069246,WES 237B,A00,894149,Staff,11,0,20,9
1746577071299,AESE 279B,A00,891859,Staff,13,0,35,22
1746577072328,AIP 197,001,891854,Vespa; Emanuel Ignacio,9999,0,9999,0
1746577073352,ANTH 289S,A00,891856,Gagneux; Pascal,12,0,12,0
1746577074378,BENG 196,001,957946,Engler; Adam J.,9996,0,9999,3
1746577075402,BISP 197,001,959851,Wilhelm; James E.,9998,0,9999,1
1746577076430,CAT 124RS,A01,956906,Staff,6,0,25,19
1746577077455,CAT 125RS,A01,922013,Staff,6,0,25,19
1746577078480,CLRE 250,A00,891860,Morris; Sheldon,9995,0,9999,4
1746577080539,CLRE 251R,A00,907817,Mehta; Ravindra L.,9994,0,9999,5
1746577081566,CLRE 252,A00,891864,Cuomo; Raphael Eduardo,9993,0,9999,6
1746577082597,CLRE 253,A00,891867,Vaida; Florin,9994,0,9999,5
1746577082597,CLRE 253,B00,907819,Staff,9999,0,9999,0
1746577083626,CLRE 259,A00,891868,Patel; Hemal,9998,0,9999,1
1746577084654,CLRE 260,A00,891872,Cuomo; Raphael Eduardo,9999,0,9999,0
1746577085681,CLRE 297,001,891888,Cuomo; Raphael Eduardo,9999,0,9999,0
1746577086705,CSE 191,A00,958773,Minnes Kemp; Mor Mia,9995,0,9999,4
1746577087730,CSE 197,001,959846,Minnes Kemp; Mor Mia,9990,0,9999,9
1746577088762,CSS 201S,A01,892054,Mignozzetti; Umberto,25,0,30,5
1746577089788,CSS 202S,A01,892056,Mignozzetti; Umberto,25,0,30,5
1746577090818,DSC 197,001,956898,Eldridge; Justin Matthew,9996,0,9999,3
1746577091847,DSC 297,001,958000,Mazumdar; Arya,9998,0,9999,1
1746577091847,DSC 297,002,959862,Wang; Yusu,9998,0,9999,1
1746577092871,EAP 100,A00,905686,Staff,9778,0,9999,221
1746577093897,ECE 45,A01,892618,Staff,0,0,65,65
1746577095956,ECE 111,A01,892719,Staff,5,0,65,60
1746577096986,ECE 197,001,957920,Mercier; Patrick Philip,9991,0,9999,8
1746577098012,ECON 178,A01,907814,Zhu; Ying,26,0,35,9
1746577099044,EDS 115,A00,895312,Staff,35,0,45,10
1746577100072,EDS 117,A01,895337,Staff,23,0,30,7
1746577101098,EDS 125,A00,895341,Jones; Gabrielle Anastasia,36,0,45,9
1746577102123,EDS 128A,A01,895459,Fargason; Sharon Gayle,44,0,45,1
1746577103154,EDS 128B,A01,895543,Pappas; Elizabeth,44,0,45,1
1746577104177,EDS 139,A00,897203,Pappas; Elizabeth,44,0,45,1
1746577104177,EDS 139,B00,897209,Fargason; Sharon Gayle,41,0,45,4
1746577105207,EDS 201,A00,895545,Staff,22,0,45,23
1746577106232,EDS 203,A01,895581,Halter; Christopher P.,22,0,45,23
1746577107261,EDS 204R,A01,895625,Heinzman; Erica M.,39,0,45,6
1746577107261,EDS 204R,B01,895693,Halter; Christopher P.,10,0,45,35
1746577108284,EDS 206R,A00,895694,Fargason; Sharon Gayle,1,0,30,29
1746577108284,EDS 206R,B00,895695,Choi; Bailey Miyeon,16,0,30,14
1746577109310,EDS 250,A00,895697,Hemans; Patricia Ann Benitez,22,0,45,23
1746577110339,EDS 281,A00,895701,Meyerott; Theresa Ann,1,0,15,14
1746577111368,EDS 284,A00,895736,Meyerott; Theresa Ann,1,0,15,14
1746577112394,EDS 286,A00,897210,Fine; Sarah,0,0,15,15
1746577113418,EDS 289C,A01,895770,Daly; Alan J.,1,0,15,14
1746577114441,EDS 290,A00,897211,Hofstetter; Carolyn,0,0,15,15
1746577115471,LIGM 5A,A00,896162,Fischer-Grunski; Eva K,12,0,20,8
1746577116500,LIGM 5B,A00,896260,Fischer-Grunski; Eva K,17,0,20,3
1746577117530,LIGM 5C,A00,896308,Fischer-Grunski; Eva K,18,0,20,2
1746577118557,LIIT 5AS,A00,896313,Carnelos; Chiara,18,0,20,2
1746577119585,LIIT 5BS,A00,896416,Carnelos; Chiara,20,0,20,0
1746577120609,LIIT 5CS,A00,896564,Carnelos; Chiara,20,0,20,0
1746577121639,LISP 5A,A00,896588,Munoz Sanchez; Alicia,2,0,20,18
1746577122671,LISP 5B,A00,896653,Munoz Sanchez; Alicia,7,0,20,13
1746577123701,LISP 5C,A00,896655,Munoz Sanchez; Alicia,0,1,20,20
1746577124728,MAE 197,001,957918,Kleissl; Jan,9996,0,9999,3
1746577124728,MAE 197,002,959806,Boechler; Nicholas Sebastia,9998,0,9999,1
1746577124728,MAE 197,003,959852,Mullin; Jennifer S,9998,0,9999,1
1746577125754,MATH 2,A01,957937,Staff,33,0,35,2
1746577126782,MATH 197,001,957876,Kedlaya; Kiran S.,9993,0,9999,6
1746577127812,MCWP 40,A00,892729,Duru; Nur,10,0,20,10
1746577127812,MCWP 40,B00,893304,Montejo; Carolina,14,0,20,6
1746577128837,MCWP 40R,A00,893757,Redela; Pamela Morgan,0,5,20,20
1746577129863,MCWP 50,A00,893758,Morshed; Michael James,0,0,20,20
1746577129863,MCWP 50,B00,893761,Bartulis; Jason Michael,17,0,20,3
1746577130893,MCWP 50R,A00,893766,Compas; Sean Matthew,0,1,20,20
1746577130893,MCWP 50R,B00,893769,Carter; Jennifer A,0,1,20,20
1746577130893,MCWP 50R,C00,893771,Krone; Jarret,0,3,20,20
1746577130893,MCWP 50R,D00,893772,Miller; Elizabeth Deen,0,0,20,20
1746577130893,MCWP 50R,E00,893775,Carter; Andrea L,0,1,20,20
1746577131918,MMW 11R,A01,892721,Herbst; Matthew,14,0,30,16
1746577131918,MMW 11R,A02,892722,Herbst; Matthew,0,0,0,3
1746577132949,MMW 12R,A01,892724,Herbst; Matthew,0,11,16,16
1746577132949,MMW 12R,A02,892725,Herbst; Matthew,0,10,16,16
1746577133978,MMW 13R,A01,892727,Staff,0,4,16,16
1746577133978,MMW 13R,A02,892728,Staff,0,4,16,16
1746577133978,MMW 13R,A03,958032,Staff,0,4,16,16
1746577133978,MMW 13R,A04,958033,Staff,0,4,16,16
1746577133978,MMW 13R,A05,958034,Staff,0,4,16,16
1746577135003,SIO 295LS,A00,894015,Staff,5,0,25,20
1746577136031,SIO 295S,A00,894020,Staff,5,0,25,20
1746577137058,SIOC 290S,B01,958918,Merrifield; Mark A,14,0,30,16
1746577138089,SIOC 291S,B01,958922,Gabriel; Corey John,14,0,30,16
1746577139114,SOCI 117,A01,895339,Staff,3,0,5,2
1746577140142,WES 237B,A00,894149,Staff,11,0,20,9
1746577142200,AESE 279B,A00,891859,Staff,13,0,35,22
1746577143229,AIP 197,001,891854,Vespa; Emanuel Ignacio,9999,0,9999,0
1746577144258,ANTH 289S,A00,891856,Gagneux; Pascal,12,0,12,0
1746577145286,BENG 196,001,957946,Engler; Adam J.,9996,0,9999,3
1746577146310,BISP 197,001,959851,Wilhelm; James E.,9998,0,9999,1
1746577147335,CAT 124RS,A01,956906,Staff,6,0,25,19
1746577148361,CAT 125RS,A01,922013,Staff,6,0,25,19
1746577149390,CLRE 250,A00,891860,Morris; Sheldon,9995,0,9999,4
1746577151440,CLRE 251R,A00,907817,Mehta; Ravindra L.,9994,0,9999,5
1746577152467,CLRE 252,A00,891864,Cuomo; Raphael Eduardo,9993,0,9999,6
1746577153492,CLRE 253,A00,891867,Vaida; Florin,9994,0,9999,5
1746577153492,CLRE 253,B00,907819,Staff,9999,0,9999,0
1746577154517,CLRE 259,A00,891868,Patel; Hemal,9998,0,9999,1
1746577155546,CLRE 260,A00,891872,Cuomo; Raphael Eduardo,9999,0,9999,0
1746577156574,CLRE 297,001,891888,Cuomo; Raphael Eduardo,9999,0,9999,0
1746577157600,CSE 191,A00,958773,Minnes Kemp; Mor Mia,9995,0,9999,4
1746577158624,CSE 197,001,959846,Minnes Kemp; Mor Mia,9990,0,9999,9
1746577159652,CSS 201S,A01,892054,Mignozzetti; Umberto,25,0,30,5
1746577160679,CSS 202S,A01,892056,Mignozzetti; Umberto,25,0,30,5
1746577161705,DSC 197,001,956898,Eldridge; Justin Matthew,9996,0,9999,3
1746577162734,DSC 297,001,958000,Mazumdar; Arya,9998,0,9999,1
1746577162734,DSC 297,002,959862,Wang; Yusu,9998,0,9999,1
1746577163760,EAP 100,A00,905686,Staff,9778,0,9999,221
1746577164786,ECE 45,A01,892618,Staff,0,0,65,65
1746577166835,ECE 111,A01,892719,Staff,5,0,65,60
1746577167862,ECE 197,001,957920,Mercier; Patrick Philip,9991,0,9999,8
1746577168888,ECON 178,A01,907814,Zhu; Ying,26,0,35,9
1746577169971,EDS 115,A00,895312,Staff,35,0,45,10
1746577170999,EDS 117,A01,895337,Staff,23,0,30,7
1746577172025,EDS 125,A00,895341,Jones; Gabrielle Anastasia,36,0,45,9
1746577173050,EDS 128A,A01,895459,Fargason; Sharon Gayle,44,0,45,1
1746577174078,EDS 128B,A01,895543,Pappas; Elizabeth,44,0,45,1
1746577175102,EDS 139,A00,897203,Pappas; Elizabeth,44,0,45,1
1746577175102,EDS 139,B00,897209,Fargason; Sharon Gayle,41,0,45,4
1746577176127,EDS 201,A00,895545,Staff,22,0,45,23
1746577177152,EDS 203,A01,895581,Halter; Christopher P.,22,0,45,23
1746577178178,EDS 204R,A01,895625,Heinzman; Erica M.,39,0,45,6
1746577178178,EDS 204R,B01,895693,Halter; Christopher P.,10,0,45,35
1746577179204,EDS 206R,A00,895694,Fargason; Sharon Gayle,1,0,30,29
1746577179204,EDS 206R,B00,895695,Choi; Bailey Miyeon,16,0,30,14
1746577180231,EDS 250,A00,895697,Hemans; Patricia Ann Benitez,22,0,45,23
1746577181257,EDS 281,A00,895701,Meyerott; Theresa Ann,1,0,15,14
1746577182284,EDS 284,A00,895736,Meyerott; Theresa Ann,1,0,15,14
1746577183310,EDS 286,A00,897210,Fine; Sarah,0,0,15,15
1746577184337,EDS 289C,A01,895770,Daly; Alan J.,1,0,15,14
1746577185365,EDS 290,A00,897211,Hofstetter; Carolyn,0,0,15,15
1746577186389,LIGM 5A,A00,896162,Fischer-Grunski; Eva K,12,0,20,8
1746577187418,LIGM 5B,A00,896260,Fischer-Grunski; Eva K,17,0,20,3
1746577188447,LIGM 5C,A00,896308,Fischer-Grunski; Eva K,18,0,20,2
1746577189472,LIIT 5AS,A00,896313,Carnelos; Chiara,18,0,20,2
1746577190499,LIIT 5BS,A00,896416,Carnelos; Chiara,20,0,20,0
1746577191524,LIIT 5CS,A00,896564,Carnelos; Chiara,20,0,20,0
1746577192554,LISP 5A,A00,896588,Munoz Sanchez; Alicia,2,0,20,18
1746577193579,LISP 5B,A00,896653,Munoz Sanchez; Alicia,7,0,20,13
1746577194606,LISP 5C,A00,896655,Munoz Sanchez; Alicia,0,1,20,20
1746577195630,MAE 197,001,957918,Kleissl; Jan,9996,0,9999,3
1746577195630,MAE 197,002,959806,Boechler; Nicholas Sebastia,9998,0,9999,1
1746577195630,MAE 197,003,959852,Mullin; Jennifer S,9998,0,9999,1
1746577196658,MATH 2,A01,957937,Staff,33,0,35,2
1746577197685,MATH 197,001,957876,Kedlaya; Kiran S.,9993,0,9999,6
1746577198714,MCWP 40,A00,892729,Duru; Nur,10,0,20,10
1746577198714,MCWP 40,B00,893304,Montejo; Carolina,14,0,20,6
1746577199743,MCWP 40R,A00,893757,Redela; Pamela Morgan,0,5,20,20
1746577200771,MCWP 50,A00,893758,Morshed; Michael James,0,0,20,20
1746577200771,MCWP 50,B00,893761,Bartulis; Jason Michael,17,0,20,3
1746577201797,MCWP 50R,A00,893766,Compas; Sean Matthew,0,1,20,20
1746577201797,MCWP 50R,B00,893769,Carter; Jennifer A,0,1,20,20
1746577201797,MCWP 50R,C00,893771,Krone; Jarret,0,3,20,20
1746577201797,MCWP 50R,D00,893772,Miller; Elizabeth Deen,0,0,20,20
1746577201797,MCWP 50R,E00,893775,Carter; Andrea L,0,1,20,20
1746577202822,MMW 11R,A01,892721,Herbst; Matthew,14,0,30,16
1746577202822,MMW 11R,A02,892722,Herbst; Matthew,0,0,0,3
1746577203846,MMW 12R,A01,892724,Herbst; Matthew,0,11,16,16
1746577203846,MMW 12R,A02,892725,Herbst; Matthew,0,10,16,16
1746577204872,MMW 13R,A01,892727,Staff,0,4,16,16
1746577204872,MMW 13R,A02,892728,Staff,0,4,16,16
1746577204872,MMW 13R,A03,958032,Staff,0,4,16,16
1746577204872,MMW 13R,A04,958033,Staff,0,4,16,16
1746577204872,MMW 13R,A05,958034,Staff,0,4,16,16
1746577205902,SIO 295LS,A00,894015,Staff,5,0,25,20
1746577206928,SIO 295S,A00,894020,Staff,5,0,25,20
1746577207955,SIOC 290S,B01,958918,Merrifield; Mark A,14,0,30,16
1746577208985,SIOC 291S,B01,958922,Gabriel; Corey John,14,0,30,16
1746577210010,SOCI 117,A01,895339,Staff,3,0,5,2
1746577211035,WES 237B,A00,894149,Staff,11,0,20,9
1746577213106,AESE 279B,A00,891859,Staff,13,0,35,22
1746577214131,AIP 197,001,891854,Vespa; Emanuel Ignacio,9999,0,9999,0
1746577215157,ANTH 289S,A00,891856,Gagneux; Pascal,12,0,12,0
1746577216184,BENG 196,001,957946,Engler; Adam J.,9996,0,9999,3
1746577217212,BISP 197,001,959851,Wilhelm; James E.,9998,0,9999,1
1746577218242,CAT 124RS,A01,956906,Staff,6,0,25,19
1746577219270,CAT 125RS,A01,922013,Staff,6,0,25,19
1746577220296,CLRE 250,A00,891860,Morris; Sheldon,9995,0,9999,4
1746577222355,CLRE 251R,A00,907817,Mehta; Ravindra L.,9994,0,9999,5
1746577223382,CLRE 252,A00,891864,Cuomo; Raphael Eduardo,9993,0,9999,6
1746577224405,CLRE 253,A00,891867,Vaida; Florin,9994,0,9999,5
1746577224405,CLRE 253,B00,907819,Staff,9999,0,9999,0
1746577225430,CLRE 259,A00,891868,Patel; Hemal,9998,0,9999,1
1746577226454,CLRE 260,A00,891872,Cuomo; Raphael Eduardo,9999,0,9999,0
1746577227477,CLRE 297,001,891888,Cuomo; Raphael Eduardo,9999,0,9999,0
1746577228505,CSE 191,A00,958773,Minnes Kemp; Mor Mia,9995,0,9999,4
1746577229534,CSE 197,001,959846,Minnes Kemp; Mor Mia,9990,0,9999,9
1746577230563,CSS 201S,A01,892054,Mignozzetti; Umberto,25,0,30,5
1746577231591,CSS 202S,A01,892056,Mignozzetti; Umberto,25,0,30,5
1746577232619,DSC 197,001,956898,Eldridge; Justin Matthew,9996,0,9999,3
1746577233644,DSC 297,001,958000,Mazumdar; Arya,9998,0,9999,1
1746577233644,DSC 297,002,959862,Wang; Yusu,9998,0,9999,1
1746577234673,EAP 100,A00,905686,Staff,9778,0,9999,221
1746577235699,ECE 45,A01,892618,Staff,0,0,65,65
1746577237755,ECE 111,A01,892719,Staff,5,0,65,60
1746577238780,ECE 197,001,957920,Mercier; Patrick Philip,9991,0,9999,8
1746577239805,ECON 178,A01,907814,Zhu; Ying,26,0,35,9
1746577240829,EDS 115,A00,895312,Staff,35,0,45,10
1746577241857,EDS 117,A01,895337,Staff,23,0,30,7
1746577242882,EDS 125,A00,895341,Jones; Gabrielle Anastasia,36,0,45,9
1746577243906,EDS 128A,A01,895459,Fargason; Sharon Gayle,44,0,45,1
1746577244932,EDS 128B,A01,895543,Pappas; Elizabeth,44,0,45,1
1746577245959,EDS 139,A00,897203,Pappas; Elizabeth,44,0,45,1
1746577245959,EDS 139,B00,897209,Fargason; Sharon Gayle,41,0,45,4
1746577246987,EDS 201,A00,895545,Staff,22,0,45,23
1746577248015,EDS 203,A01,895581,Halter; Christopher P.,22,0,45,23
1746577249041,EDS 204R,A01,895625,Heinzman; Erica M.,39,0,45,6
1746577249041,EDS 204R,B01,895693,Halter; Christopher P.,10,0,45,35
1746577250068,EDS 206R,A00,895694,Fargason; Sharon Gayle,1,0,30,29
1746577250068,EDS 206R,B00,895695,Choi; Bailey Miyeon,16,0,30,14
1746577251095,EDS 250,A00,895697,Hemans; Patricia Ann Benitez,22,0,45,23
1746577252126,EDS 281,A00,895701,Meyerott; Theresa Ann,1,0,15,14
1746577253150,EDS 284,A00,895736,Meyerott; Theresa Ann,1,0,15,14
1746577254178,EDS 286,A00,897210,Fine; Sarah,0,0,15,15
1746577255203,EDS 289C,A01,895770,Daly; Alan J.,1,0,15,14
1746577256232,EDS 290,A00,897211,Hofstetter; Carolyn,0,0,15,15
1746577257257,LIGM 5A,A00,896162,Fischer-Grunski; Eva K,12,0,20,8
1746577258282,LIGM 5B,A00,896260,Fischer-Grunski; Eva K,17,0,20,3
1746577259307,LIGM 5C,A00,896308,Fischer-Grunski; Eva K,18,0,20,2
1746577260337,LIIT 5AS,A00,896313,Carnelos; Chiara,18,0,20,2
1746577261363,LIIT 5BS,A00,896416,Carnelos; Chiara,20,0,20,0
1746577262394,LIIT 5CS,A00,896564,Carnelos; Chiara,20,0,20,0
1746577263424,LISP 5A,A00,896588,Munoz Sanchez; Alicia,2,0,20,18
1746577264448,LISP 5B,A00,896653,Munoz Sanchez; Alicia,7,0,20,13
1746577265472,LISP 5C,A00,896655,Munoz Sanchez; Alicia,0,1,20,20
1746577266501,MAE 197,001,957918,Kleissl; Jan,9996,0,9999,3
1746577266501,MAE 197,002,959806,Boechler; Nicholas Sebastia,9998,0,9999,1
1746577266501,MAE 197,003,959852,Mullin; Jennifer S,9998,0,9999,1
1746577267526,MATH 2,A01,957937,Staff,33,0,35,2
1746577268554,MATH 197,001,957876,Kedlaya; Kiran S.,9993,0,9999,6
1746577269578,MCWP 40,A00,892729,Duru; Nur,10,0,20,10
1746577269578,MCWP 40,B00,893304,Montejo; Carolina,14,0,20,6
1746577270609,MCWP 40R,A00,893757,Redela; Pamela Morgan,0,5,20,20
1746577271639,MCWP 50,A00,893758,Morshed; Michael James,0,0,20,20
1746577271639,MCWP 50,B00,893761,Bartulis; Jason Michael,17,0,20,3
1746577272663,MCWP 50R,A00,893766,Compas; Sean Matthew,0,1,20,20
1746577272663,MCWP 50R,B00,893769,Carter; Jennifer A,0,1,20,20
1746577272663,MCWP 50R,C00,893771,Krone; Jarret,0,3,20,20
1746577272663,MCWP 50R,D00,893772,Miller; Elizabeth Deen,0,0,20,20
1746577272663,MCWP 50R,E00,893775,Carter; Andrea L,0,1,20,20
1746577273751,MMW 11R,A01,892721,Herbst; Matthew,14,0,30,16
1746577273751,MMW 11R,A02,892722,Herbst; Matthew,0,0,0,3
1746577274780,MMW 12R,A01,892724,Herbst; Matthew,0,11,16,16
1746577274780,MMW 12R,A02,892725,Herbst; Matthew,0,10,16,16
1746577275806,MMW 13R,A01,892727,Staff,0,4,16,16
1746577275806,MMW 13R,A02,892728,Staff,0,4,16,16
1746577275806,MMW 13R,A03,958032,Staff,0,4,16,16
1746577275806,MMW 13R,A04,958033,Staff,0,4,16,16
1746577275806,MMW 13R,A05,958034,Staff,0,4,16,16
1746577276832,SIO 295LS,A00,894015,Staff,5,0,25,20
1746577277859,SIO 295S,A00,894020,Staff,5,0,25,20
1746577278885,SIOC 290S,B01,958918,Merrifield; Mark A,14,0,30,16
1746577279915,SIOC 291S,B01,958922,Gabriel; Corey John,14,0,30,16
1746577280939,SOCI 117,A01,895339,Staff,3,0,5,2
1746577281968,WES 237B,A00,894149,Staff,11,0,20,9
1746577284030,AESE 279B,A00,891859,Staff,13,0,35,22
1746577285055,AIP 197,001,891854,Vespa; Emanuel Ignacio,9999,0,9999,0
1746577286079,ANTH 289S,A00,891856,Gagneux; Pascal,12,0,12,0
1746577287105,BENG 196,001,957946,Engler; Adam J.,9996,0,9999,3
1746577288134,BISP 197,001,959851,Wilhelm; James E.,9998,0,9999,1
1746577289162,CAT 124RS,A01,956906,Staff,6,0,25,19
1746577290188,CAT 125RS,A01,922013,Staff,6,0,25,19
1746577291218,CLRE 250,A00,891860,Morris; Sheldon,9995,0,9999,4
1746577293271,CLRE 251R,A00,907817,Mehta; Ravindra L.,9994,0,9999,5
1746577294296,CLRE 252,A00,891864,Cuomo; Raphael Eduardo,9993,0,9999,6
1746577295325,CLRE 253,A00,891867,Vaida; Florin,9994,0,9999,5
1746577295325,CLRE 253,B00,907819,Staff,9999,0,9999,0
1746577296351,CLRE 259,A00,891868,Patel; Hemal,9998,0,9999,1
1746577297379,CLRE 260,A00,891872,Cuomo; Raphael Eduardo,9999,0,9999,0
1746577298405,CLRE 297,001,891888,Cuomo; Raphael Eduardo,9999,0,9999,0
1746577299434,CSE 191,A00,958773,Minnes Kemp; Mor Mia,9995,0,9999,4
1746577300462,CSE 197,001,959846,Minnes Kemp; Mor Mia,9990,0,9999,9
1746577301492,CSS 201S,A01,892054,Mignozzetti; Umberto,25,0,30,5
1746577302518,CSS 202S,A01,892056,Mignozzetti; Umberto,25,0,30,5
1746577303545,DSC 197,001,956898,Eldridge; Justin Matthew,9996,0,9999,3
1746577304570,DSC 297,001,958000,Mazumdar; Arya,9998,0,9999,1
1746577304570,DSC 297,002,959862,Wang; Yusu,9998,0,9999,1
1746577305600,EAP 100,A00,905686,Staff,9778,0,9999,221
1746577306626,ECE 45,A01,892618,Staff,0,0,65,65
1746577308684,ECE 111,A01,892719,Staff,5,0,65,60
1746577309708,ECE 197,001,957920,Mercier; Patrick Philip,9991,0,9999,8
1746577310734,ECON 178,A01,907814,Zhu; Ying,26,0,35,9
1746577311763,EDS 115,A00,895312,Staff,35,0,45,10
1746577312793,EDS 117,A01,895337,Staff,23,0,30,7
1746577313816,EDS 125,A00,895341,Jones; Gabrielle Anastasia,36,0,45,9
1746577314842,EDS 128A,A01,895459,Fargason; Sharon Gayle,44,0,45,1
1746577315867,EDS 128B,A01,895543,Pappas; Elizabeth,44,0,45,1
1746577316893,EDS 139,A00,897203,Pappas; Elizabeth,44,0,45,1
1746577316893,EDS 139,B00,897209,Fargason; Sharon Gayle,41,0,45,4
1746577317920,EDS 201,A00,895545,Staff,22,0,45,23
1746577318948,EDS 203,A01,895581,Halter; Christopher P.,22,0,45,23
1746577319985,EDS 204R,A01,895625,Heinzman; Erica M.,39,0,45,6
1746577319985,EDS 204R,B01,895693,Halter; Christopher P.,10,0,45,35
1746577321011,EDS 206R,A00,895694,Fargason; Sharon Gayle,1,0,30,29
1746577321011,EDS 206R,B00,895695,Choi; Bailey Miyeon,16,0,30,14
1746577322035,EDS 250,A00,895697,Hemans; Patricia Ann Benitez,22,0,45,23
1746577323064,EDS 281,A00,895701,Meyerott; Theresa Ann,1,0,15,14
1746577324089,EDS 284,A00,895736,Meyerott; Theresa Ann,1,0,15,14
1746577325114,EDS 286,A00,897210,Fine; Sarah,0,0,15,15
1746577326139,EDS 289C,A01,895770,Daly; Alan J.,1,0,15,14
1746577327172,EDS 290,A00,897211,Hofstetter; Carolyn,0,0,15,15
1746577328201,LIGM 5A,A00,896162,Fischer-Grunski; Eva K,12,0,20,8
1746577329225,LIGM 5B,A00,896260,Fischer-Grunski; Eva K,17,0,20,3
1746577330250,LIGM 5C,A00,896308,Fischer-Grunski; Eva K,18,0,20,2
1746577331274,LIIT 5AS,A00,896313,Carnelos; Chiara,18,0,20,2
1746577332298,LIIT 5BS,A00,896416,Carnelos; Chiara,20,0,20,0
1746577333325,LIIT 5CS,A00,896564,Carnelos; Chiara,20,0,20,0
1746577334351,LISP 5A,A00,896588,Munoz Sanchez; Alicia,2,0,20,18
1746577335377,LISP 5B,A00,896653,Munoz Sanchez; Alicia,7,0,20,13
1746577336406,LISP 5C,A00,896655,Munoz Sanchez; Alicia,0,1,20,20
1746577337438,MAE 197,001,957918,Kleissl; Jan,9996,0,9999,3
1746577337438,MAE 197,002,959806,Boechler; Nicholas Sebastia,9998,0,9999,1
1746577337438,MAE 197,003,959852,Mullin; Jennifer S,9998,0,9999,1
1746577338465,MATH 2,A01,957937,Staff,33,0,35,2
1746577339491,MATH 197,001,957876,Kedlaya; Kiran S.,9993,0,9999,6
1746577340517,MCWP 40,A00,892729,Duru; Nur,10,0,20,10
1746577340517,MCWP 40,B00,893304,Montejo; Carolina,14,0,20,6
1746577341541,MCWP 40R,A00,893757,Redela; Pamela Morgan,0,5,20,20
1746577342623,MCWP 50,A00,893758,Morshed; Michael James,0,0,20,20
1746577342623,MCWP 50,B00,893761,Bartulis; Jason Michael,17,0,20,3
1746577343649,MCWP 50R,A00,893766,Compas; Sean Matthew,0,1,20,20
1746577343649,MCWP 50R,B00,893769,Carter; Jennifer A,0,1,20,20
1746577343649,MCWP 50R,C00,893771,Krone; Jarret,0,3,20,20
1746577343649,MCWP 50R,D00,893772,Miller; Elizabeth Deen,0,0,20,20
1746577343649,MCWP 50R,E00,893775,Carter; Andrea L,0,1,20,20
1746577344675,MMW 11R,A01,892721,Herbst; Matthew,14,0,30,16
1746577344675,MMW 11R,A02,892722,Herbst; Matthew,0,0,0,3
1746577345700,MMW 12R,A01,892724,Herbst; Matthew,0,11,16,16
1746577345700,MMW 12R,A02,892725,Herbst; Matthew,0,10,16,16
1746577346727,MMW 13R,A01,892727,Staff,0,4,16,16
1746577346727,MMW 13R,A02,892728,Staff,0,4,16,16
1746577346727,MMW 13R,A03,958032,Staff,0,4,16,16
1746577346727,MMW 13R,A04,958033,Staff,0,4,16,16
1746577346727,MMW 13R,A05,958034,Staff,0,4,16,16
1746577347755,SIO 295LS,A00,894015,Staff,5,0,25,20
1746577348780,SIO 295S,A00,894020,Staff,5,0,25,20
1746577349803,SIOC 290S,B01,958918,Merrifield; Mark A,14,0,30,16
1746577350830,SIOC 291S,B01,958922,Gabriel; Corey John,14,0,30,16
1746577351855,SOCI 117,A01,895339,Staff,3,0,5,2
1746577352879,WES 237B,A00,894149,Staff,11,0,20,9
1746577354951,AESE 279B,A00,891859,Staff,13,0,35,22
1746577355979,AIP 197,001,891854,Vespa; Emanuel Ignacio,9999,0,9999,0
1746577357009,ANTH 289S,A00,891856,Gagneux; Pascal,12,0,12,0
1746577358056,BENG 196,001,957946,Engler; Adam J.,9996,0,9999,3
1746577359080,BISP 197,001,959851,Wilhelm; James E.,9998,0,9999,1
1746577360110,CAT 124RS,A01,956906,Staff,6,0,25,19
1746577361134,CAT 125RS,A01,922013,Staff,6,0,25,19
1746577362160,CLRE 250,A00,891860,Morris; Sheldon,9995,0,9999,4
1746577364210,CLRE 251R,A00,907817,Mehta; Ravindra L.,9994,0,9999,5
1746577365241,CLRE 252,A00,891864,Cuomo; Raphael Eduardo,9993,0,9999,6
1746577366269,CLRE 253,A00,891867,Vaida; Florin,9994,0,9999,5
1746577366269,CLRE 253,B00,907819,Staff,9999,0,9999,0
1746577367293,CLRE 259,A00,891868,Patel; Hemal,9998,0,9999,1
1746577368322,CLRE 260,A00,891872,Cuomo; Raphael Eduardo,9999,0,9999,0
1746577369351,CLRE 297,001,891888,Cuomo; Raphael Eduardo,9999,0,9999,0
1746577370380,CSE 191,A00,958773,Minnes Kemp; Mor Mia,9995,0,9999,4
1746577371410,CSE 197,001,959846,Minnes Kemp; Mor Mia,9990,0,9999,9
1746577372438,CSS 201S,A01,892054,Mignozzetti; Umberto,25,0,30,5
1746577373468,CSS 202S,A01,892056,Mignozzetti; Umberto,25,0,30,5
1746577374494,DSC 197,001,956898,Eldridge; Justin Matthew,9996,0,9999,3
1746577375518,DSC 297,001,958000,Mazumdar; Arya,9998,0,9999,1
1746577375518,DSC 297,002,959862,Wang; Yusu,9998,0,9999,1
1746577376544,EAP 100,A00,905686,Staff,9778,0,9999,221
1746577377569,ECE 45,A01,892618,Staff,0,0,65,65
1746577379626,ECE 111,A01,892719,Staff,5,0,65,60
1746577380650,ECE 197,001,957920,Mercier; Patrick Philip,9991,0,9999,8
1746577381680,ECON 178,A01,907814,Zhu; Ying,26,0,35,9
1746577382709,EDS 115,A00,895312,Staff,35,0,45,10
1746577383735,EDS 117,A01,895337,Staff,23,0,30,7
1746577384759,EDS 125,A00,895341,Jones; Gabrielle Anastasia,36,0,45,9
1746577385792,EDS 128A,A01,895459,Fargason; Sharon Gayle,44,0,45,1
1746577386816,EDS 128B,A01,895543,Pappas; Elizabeth,44,0,45,1
1746577387848,EDS 139,A00,897203,Pappas; Elizabeth,44,0,45,1
1746577387848,EDS 139,B00,897209,Fargason; Sharon Gayle,41,0,45,4
1746577388876,EDS 201,A00,895545,Staff,22,0,45,23
1746577389906,EDS 203,A01,895581,Halter; Christopher P.,22,0,45,23
1746577390931,EDS 204R,A01,895625,Heinzman; Erica M.,39,0,45,6
1746577390931,EDS 204R,B01,895693,Halter; Christopher P.,10,0,45,35
1746577391961,EDS 206R,A00,895694,Fargason; Sharon Gayle,1,0,30,29
1746577391961,EDS 206R,B00,895695,Choi; Bailey Miyeon,16,0,30,14
1746577392984,EDS 250,A00,895697,Hemans; Patricia Ann Benitez,22,0,45,23
1746577394012,EDS 281,A00,895701,Meyerott; Theresa Ann,1,0,15,14
1746577395037,EDS 284,A00,895736,Meyerott; Theresa Ann,1,0,15,14
1746577396062,EDS 286,A00,897210,Fine; Sarah,0,0,15,15
1746577397091,EDS 289C,A01,895770,Daly; Alan J.,1,0,15,14
1746577398119,EDS 290,A00,897211,Hofstetter; Carolyn,0,0,15,15
1746577399144,LIGM 5A,A00,896162,Fischer-Grunski; Eva K,12,0,20,8
1746577400178,LIGM 5B,A00,896260,Fischer-Grunski; Eva K,17,0,20,3
1746577401204,LIGM 5C,A00,896308,Fischer-Grunski; Eva K,18,0,20,2
1746577402230,LIIT 5AS,A00,896313,Carnelos; Chiara,18,0,20,2
1746577403257,LIIT 5BS,A00,896416,Carnelos; Chiara,20,0,20,0
1746577404288,LIIT 5CS,A00,896564,Carnelos; Chiara,20,0,20,0
1746577405313,LISP 5A,A00,896588,Munoz Sanchez; Alicia,2,0,20,18
1746577406339,LISP 5B,A00,896653,Munoz Sanchez; Alicia,7,0,20,13
1746577407367,LISP 5C,A00,896655,Munoz Sanchez; Alicia,0,1,20,20
1746577408396,MAE 197,001,957918,Kleissl; Jan,9996,0,9999,3
1746577408396,MAE 197,002,959806,Boechler; Nicholas Sebastia,9998,0,9999,1
1746577408396,MAE 197,003,959852,Mullin; Jennifer S,9998,0,9999,1
1746577409421,MATH 2,A01,957937,Staff,33,0,35,2
1746577410446,MATH 197,001,957876,Kedlaya; Kiran S.,9993,0,9999,6
1746577411471,MCWP 40,A00,892729,Duru; Nur,10,0,20,10
1746577411471,MCWP 40,B00,893304,Montejo; Carolina,14,0,20,6
1746577412501,MCWP 40R,A00,893757,Redela; Pamela Morgan,0,5,20,20
1746577413529,MCWP 50,A00,893758,Morshed; Michael James,0,0,20,20
1746577413529,MCWP 50,B00,893761,Bartulis; Jason Michael,17,0,20,3
1746577414559,MCWP 50R,A00,893766,Compas; Sean Matthew,0,1,20,20
1746577414559,MCWP 50R,B00,893769,Carter; Jennifer A,0,1,20,20
1746577414559,MCWP 50R,C00,893771,Krone; Jarret,0,3,20,20
1746577414559,MCWP 50R,D00,893772,Miller; Elizabeth Deen,0,0,20,20
1746577414559,MCWP 50R,E00,893775,Carter; Andrea L,0,1,20,20
1746577415588,MMW 11R,A01,892721,Herbst; Matthew,14,0,30,16
1746577415588,MMW 11R,A02,892722,Herbst; Matthew,0,0,0,3
1746577416614,MMW 12R,A01,892724,Herbst; Matthew,0,11,16,16
1746577416614,MMW 12R,A02,892725,Herbst; Matthew,0,10,16,16
1746577417639,MMW 13R,A01,892727,Staff,0,4,16,16
1746577417639,MMW 13R,A02,892728,Staff,0,4,16,16
1746577417639,MMW 13R,A03,958032,Staff,0,4,16,16
1746577417639,MMW 13R,A04,958033,Staff,0,4,16,16
1746577417639,MMW 13R,A05,958034,Staff,0,4,16,16
1746577418665,SIO 295LS,A00,894015,Staff,5,0,25,20
1746577419692,SIO 295S,A00,894020,Staff,5,0,25,20
1746577420722,SIOC 290S,B01,958918,Merrifield; Mark A,14,0,30,16
1746577421752,SIOC 291S,B01,958922,Gabriel; Corey John,14,0,30,16
1746577422777,SOCI 117,A01,895339,Staff,3,0,5,2
1746577423805,WES 237B,A00,894149,Staff,11,0,20,9
1746577425880,AESE 279B,A00,891859,Staff,13,0,35,22
1746577426909,AIP 197,001,891854,Vespa; Emanuel Ignacio,9999,0,9999,0
1746577427934,ANTH 289S,A00,891856,Gagneux; Pascal,12,0,12,0
1746577428961,BENG 196,001,957946,Engler; Adam J.,9996,0,9999,3
1746577429989,BISP 197,001,959851,Wilhelm; James E.,9998,0,9999,1
1746577431014,CAT 124RS,A01,956906,Staff,6,0,25,19
1746577432038,CAT 125RS,A01,922013,Staff,6,0,25,19
1746577433061,CLRE 250,A00,891860,Morris; Sheldon,9995,0,9999,4
1746577435115,CLRE 251R,A00,907817,Mehta; Ravindra L.,9994,0,9999,5
1746577436140,CLRE 252,A00,891864,Cuomo; Raphael Eduardo,9993,0,9999,6
1746577437165,CLRE 253,A00,891867,Vaida; Florin,9994,0,9999,5
1746577437165,CLRE 253,B00,907819,Staff,9999,0,9999,0
1746577438192,CLRE 259,A00,891868,Patel; Hemal,9998,0,9999,1
1746577439217,CLRE 260,A00,891872,Cuomo; Raphael Eduardo,9999,0,9999,0
1746577440241,CLRE 297,001,891888,Cuomo; Raphael Eduardo,9999,0,9999,0
1746577441272,CSE 191,A00,958773,Minnes Kemp; Mor Mia,9995,0,9999,4
1746577442299,CSE 197,001,959846,Minnes Kemp; Mor Mia,9990,0,9999,9
1746577443325,CSS 201S,A01,892054,Mignozzetti; Umberto,25,0,30,5
1746577444350,CSS 202S,A01,892056,Mignozzetti; Umberto,25,0,30,5
1746577445378,DSC 197,001,956898,Eldridge; Justin Matthew,9996,0,9999,3
1746577446402,DSC 297,001,958000,Mazumdar; Arya,9998,0,9999,1
1746577446402,DSC 297,002,959862,Wang; Yusu,9998,0,9999,1
1746577447427,EAP 100,A00,905686,Staff,9778,0,9999,221
1746577448457,ECE 45,A01,892618,Staff,0,0,65,65
1746577450509,ECE 111,A01,892719,Staff,5,0,65,60
1746577451533,ECE 197,001,957920,Mercier; Patrick Philip,9991,0,9999,8
1746577452558,ECON 178,A01,907814,Zhu; Ying,26,0,35,9
1746577453584,EDS 115,A00,895312,Staff,35,0,45,10
1746577454612,EDS 117,A01,895337,Staff,23,0,30,7
1746577455635,EDS 125,A00,895341,Jones; Gabrielle Anastasia,36,0,45,9
1746577456662,EDS 128A,A01,895459,Fargason; Sharon Gayle,44,0,45,1
1746577457689,EDS 128B,A01,895543,Pappas; Elizabeth,44,0,45,1
1746577458714,EDS 139,A00,897203,Pappas; Elizabeth,44,0,45,1
1746577458714,EDS 139,B00,897209,Fargason; Sharon Gayle,41,0,45,4
1746577459744,EDS 201,A00,895545,Staff,22,0,45,23
1746577460772,EDS 203,A01,895581,Halter; Christopher P.,22,0,45,23
1746577461795,EDS 204R,A01,895625,Heinzman; Erica M.,39,0,45,6
1746577461795,EDS 204R,B01,895693,Halter; Christopher P.,10,0,45,35
1746577462820,EDS 206R,A00,895694,Fargason; Sharon Gayle,1,0,30,29
1746577462820,EDS 206R,B00,895695,Choi; Bailey Miyeon,16,0,30,14
1746577463845,EDS 250,A00,895697,Hemans; Patricia Ann Benitez,22,0,45,23
1746577464872,EDS 281,A00,895701,Meyerott; Theresa Ann,1,0,15,14
1746577465901,EDS 284,A00,895736,Meyerott; Theresa Ann,1,0,15,14
1746577466928,EDS 286,A00,897210,Fine; Sarah,0,0,15,15
1746577467954,EDS 289C,A01,895770,Daly; Alan J.,1,0,15,14
1746577468982,EDS 290,A00,897211,Hofstetter; Carolyn,0,0,15,15
1746577470013,LIGM 5A,A00,896162,Fischer-Grunski; Eva K,12,0,20,8
1746577471038,LIGM 5B,A00,896260,Fischer-Grunski; Eva K,17,0,20,3
1746577472063,LIGM 5C,A00,896308,Fischer-Grunski; Eva K,18,0,20,2
1746577473089,LIIT 5AS,A00,896313,Carnelos; Chiara,18,0,20,2
1746577474116,LIIT 5BS,A00,896416,Carnelos; Chiara,20,0,20,0
1746577475141,LIIT 5CS,A00,896564,Carnelos; Chiara,20,0,20,0
1746577476167,LISP 5A,A00,896588,Munoz Sanchez; Alicia,2,0,20,18
1746577477201,LISP 5B,A00,896653,Munoz Sanchez; Alicia,7,0,20,13
1746577478234,LISP 5C,A00,896655,Munoz Sanchez; Alicia,0,1,20,20
1746577479258,MAE 197,001,957918,Kleissl; Jan,9996,0,9999,3
1746577479258,MAE 197,002,959806,Boechler; Nicholas Sebastia,9998,0,9999,1
1746577479258,MAE 197,003,959852,Mullin; Jennifer S,9998,0,9999,1
1746577480284,MATH 2,A01,957937,Staff,33,0,35,2
1746577481309,MATH 197,001,957876,Kedlaya; Kiran S.,9993,0,9999,6
1746577482334,MCWP 40,A00,892729,Duru; Nur,10,0,20,10
1746577482334,MCWP 40,B00,893304,Montejo; Carolina,14,0,20,6
1746577483362,MCWP 40R,A00,893757,Redela; Pamela Morgan,0,5,20,20
1746577484391,MCWP 50,A00,893758,Morshed; Michael James,0,0,20,20
1746577484391,MCWP 50,B00,893761,Bartulis; Jason Michael,17,0,20,3
1746577485417,MCWP 50R,A00,893766,Compas; Sean Matthew,0,1,20,20
1746577485417,MCWP 50R,B00,893769,Carter; Jennifer A,0,1,20,20
1746577485417,MCWP 50R,C00,893771,Krone; Jarret,0,3,20,20
1746577485417,MCWP 50R,D00,893772,Miller; Elizabeth Deen,0,0,20,20
1746577485417,MCWP 50R,E00,893775,Carter; Andrea L,0,1,20,20
1746577486446,MMW 11R,A01,892721,Herbst; Matthew,14,0,30,16
1746577486446,MMW 11R,A02,892722,Herbst; Matthew,0,0,0,3
1746577487474,MMW 12R,A01,892724,Herbst; Matthew,0,11,16,16
1746577487474,MMW 12R,A02,892725,Herbst; Matthew,0,10,16,16
1746577488504,MMW 13R,A01,892727,Staff,0,4,16,16
1746577488504,MMW 13R,A02,892728,Staff,0,4,16,16
1746577488504,MMW 13R,A03,958032,Staff,0,4,16,16
1746577488504,MMW 13R,A04,958033,Staff,0,4,16,16
1746577488504,MMW 13R,A05,958034,Staff,0,4,16,16
1746577489533,SIO 295LS,A00,894015,Staff,5,0,25,20
1746577490560,SIO 295S,A00,894020,Staff,5,0,25,20
1746577491592,SIOC 290S,B01,958918,Merrifield; Mark A,14,0,30,16
1746577492623,SIOC 291S,B01,958922,Gabriel; Corey John,14,0,30,16
1746577493648,SOCI 117,A01,895339,Staff,3,0,5,2
1746577494678,WES 237B,A00,894149,Staff,11,0,20,9
1746577496741,AESE 279B,A00,891859,Staff,13,0,35,22
1746577497776,AIP 197,001,891854,Vespa; Emanuel Ignacio,9999,0,9999,0
1746577498800,ANTH 289S,A00,891856,Gagneux; Pascal,12,0,12,0
1746577499845,BENG 196,001,957946,Engler; Adam J.,9996,0,9999,3
1746577500874,BISP 197,001,959851,Wilhelm; James E.,9998,0,9999,1
1746577501901,CAT 124RS,A01,956906,Staff,6,0,25,19
1746577502930,CAT 125RS,A01,922013,Staff,6,0,25,19
1746577503958,CLRE 250,A00,891860,Morris; Sheldon,9995,0,9999,4
1746577506016,CLRE 251R,A00,907817,Mehta; Ravindra L.,9994,0,9999,5
1746577507045,CLRE 252,A00,891864,Cuomo; Raphael Eduardo,9993,0,9999,6
1746577508071,CLRE 253,A00,891867,Vaida; Florin,9994,0,9999,5
1746577508071,CLRE 253,B00,907819,Staff,9999,0,9999,0
1746577509155,CLRE 259,A00,891868,Patel; Hemal,9998,0,9999,1
1746577510180,CLRE 260,A00,891872,Cuomo; Raphael Eduardo,9999,0,9999,0
1746577511209,CLRE 297,001,891888,Cuomo; Raphael Eduardo,9999,0,9999,0
1746577512238,CSE 191,A00,958773,Minnes Kemp; Mor Mia,9995,0,9999,4
1746577513265,CSE 197,001,959846,Minnes Kemp; Mor Mia,9990,0,9999,9
1746577514292,CSS 201S,A01,892054,Mignozzetti; Umberto,25,0,30,5
1746577515323,CSS 202S,A01,892056,Mignozzetti; Umberto,25,0,30,5
1746577516353,DSC 197,001,956898,Eldridge; Justin Matthew,9996,0,9999,3
1746577517380,DSC 297,001,958000,Mazumdar; Arya,9998,0,9999,1
1746577517380,DSC 297,002,959862,Wang; Yusu,9998,0,9999,1
1746577518408,EAP 100,A00,905686,Staff,9778,0,9999,221
1746577519436,ECE 45,A01,892618,Staff,0,0,65,65
1746577521490,ECE 111,A01,892719,Staff,5,0,65,60
1746577522516,ECE 197,001,957920,Mercier; Patrick Philip,9991,0,9999,8
1746577523547,ECON 178,A01,907814,Zhu; Ying,26,0,35,9
1746577524575,EDS 115,A00,895312,Staff,35,0,45,10
1746577525600,EDS 117,A01,895337,Staff,23,0,30,7
1746577526626,EDS 125,A00,895341,Jones; Gabrielle Anastasia,36,0,45,9
1746577527652,EDS 128A,A01,895459,Fargason; Sharon Gayle,44,0,45,1
1746577528676,EDS 128B,A01,895543,Pappas; Elizabeth,44,0,45,1
1746577529701,EDS 139,A00,897203,Pappas; Elizabeth,44,0,45,1
1746577529701,EDS 139,B00,897209,Fargason; Sharon Gayle,41,0,45,4
1746577530726,EDS 201,A00,895545,Staff,22,0,45,23
1746577531754,EDS 203,A01,895581,Halter; Christopher P.,22,0,45,23
1746577532783,EDS 204R,A01,895625,Heinzman; Erica M.,39,0,45,6
1746577532783,EDS 204R,B01,895693,Halter; Christopher P.,10,0,45,35
1746577533808,EDS 206R,A00,895694,Fargason; Sharon Gayle,1,0,30,29
1746577533808,EDS 206R,B00,895695,Choi; Bailey Miyeon,16,0,30,14
1746577534836,EDS 250,A00,895697,Hemans; Patricia Ann Benitez,22,0,45,23
1746577535861,EDS 281,A00,895701,Meyerott; Theresa Ann,1,0,15,14
1746577536886,EDS 284,A00,895736,Meyerott; Theresa Ann,1,0,15,14
1746577537914,EDS 286,A00,897210,Fine; Sarah,0,0,15,15
1746577538982,EDS 289C,A01,895770,Daly; Alan J.,1,0,15,14
1746577540010,EDS 290,A00,897211,Hofstetter; Carolyn,0,0,15,15
1746577541038,LIGM 5A,A00,896162,Fischer-Grunski; Eva K,12,0,20,8
1746577542067,LIGM 5B,A00,896260,Fischer-Grunski; Eva K,17,0,20,3
1746577543096,LIGM 5C,A00,896308,Fischer-Grunski; Eva K,18,0,20,2
1746577544120,LIIT 5AS,A00,896313,Carnelos; Chiara,18,0,20,2
1746577545145,LIIT 5BS,A00,896416,Carnelos; Chiara,20,0,20,0
1746577546172,LIIT 5CS,A00,896564,Carnelos; Chiara,20,0,20,0
1746577547196,LISP 5A,A00,896588,Munoz Sanchez; Alicia,2,0,20,18
1746577548223,LISP 5B,A00,896653,Munoz Sanchez; Alicia,7,0,20,13
1746577549251,LISP 5C,A00,896655,Munoz Sanchez; Alicia,0,1,20,20
1746577550275,MAE 197,001,957918,Kleissl; Jan,9996,0,9999,3
1746577550275,MAE 197,002,959806,Boechler; Nicholas Sebastia,9998,0,9999,1
1746577550275,MAE 197,003,959852,Mullin; Jennifer S,9998,0,9999,1
1746577551300,MATH 2,A01,957937,Staff,33,0,35,2
1746577552328,MATH 197,001,957876,Kedlaya; Kiran S.,9993,0,9999,6
1746577553355,MCWP 40,A00,892729,Duru; Nur,10,0,20,10
1746577553355,MCWP 40,B00,893304,Montejo; Carolina,14,0,20,6
1746577554379,MCWP 40R,A00,893757,Redela; Pamela Morgan,0,5,20,20
1746577555409,MCWP 50,A00,893758,Morshed; Michael James,0,0,20,20
1746577555409,MCWP 50,B00,893761,Bartulis; Jason Michael,17,0,20,3
1746577556436,MCWP 50R,A00,893766,Compas; Sean Matthew,0,1,20,20
1746577556436,MCWP 50R,B00,893769,Carter; Jennifer A,0,1,20,20
1746577556436,MCWP 50R,C00,893771,Krone; Jarret,0,3,20,20
1746577556436,MCWP 50R,D00,893772,Miller; Elizabeth Deen,0,0,20,20
1746577556436,MCWP 50R,E00,893775,Carter; Andrea L,0,1,20,20
1746577557463,MMW 11R,A01,892721,Herbst; Matthew,14,0,30,16
1746577557463,MMW 11R,A02,892722,Herbst; Matthew,0,0,0,3
1746577558490,MMW 12R,A01,892724,Herbst; Matthew,0,11,16,16
1746577558490,MMW 12R,A02,892725,Herbst; Matthew,0,10,16,16
1746577559517,MMW 13R,A01,892727,Staff,0,4,16,16
1746577559517,MMW 13R,A02,892728,Staff,0,4,16,16
1746577559517,MMW 13R,A03,958032,Staff,0,4,16,16
1746577559517,MMW 13R,A04,958033,Staff,0,4,16,16
1746577559517,MMW 13R,A05,958034,Staff,0,4,16,16
1746577560543,SIO 295LS,A00,894015,Staff,5,0,25,20
1746577561574,SIO 295S,A00,894020,Staff,5,0,25,20
1746577562598,SIOC 290S,B01,958918,Merrifield; Mark A,14,0,30,16
1746577563634,SIOC 291S,B01,958922,Gabriel; Corey John,14,0,30,16
1746577564661,SOCI 117,A01,895339,Staff,3,0,5,2
1746577565687,WES 237B,A00,894149,Staff,11,0,20,9
1746577567748,AESE 279B,A00,891859,Staff,13,0,35,22
1746577568774,AIP 197,001,891854,Vespa; Emanuel Ignacio,9999,0,9999,0
1746577569799,ANTH 289S,A00,891856,Gagneux; Pascal,12,0,12,0
1746577570824,BENG 196,001,957946,Engler; Adam J.,9996,0,9999,3
1746577571849,BISP 197,001,959851,Wilhelm; James E.,9998,0,9999,1
1746577572876,CAT 124RS,A01,956906,Staff,6,0,25,19
1746577573903,CAT 125RS,A01,922013,Staff,6,0,25,19
1746577574928,CLRE 250,A00,891860,Morris; Sheldon,9995,0,9999,4
1746577576978,CLRE 251R,A00,907817,Mehta; Ravindra L.,9994,0,9999,5
1746577578004,CLRE 252,A00,891864,Cuomo; Raphael Eduardo,9993,0,9999,6
1746577579031,CLRE 253,A00,891867,Vaida; Florin,9994,0,9999,5
1746577579031,CLRE 253,B00,907819,Staff,9999,0,9999,0
1746577580059,CLRE 259,A00,891868,Patel; Hemal,9998,0,9999,1
1746577581088,CLRE 260,A00,891872,Cuomo; Raphael Eduardo,9999,0,9999,0
1746577582113,CLRE 297,001,891888,Cuomo; Raphael Eduardo,9999,0,9999,0
1746577583139,CSE 191,A00,958773,Minnes Kemp; Mor Mia,9995,0,9999,4
1746577584167,CSE 197,001,959846,Minnes Kemp; Mor Mia,9990,0,9999,9
1746577585199,CSS 201S,A01,892054,Mignozzetti; Umberto,25,0,30,5
1746577586228,CSS 202S,A01,892056,Mignozzetti; Umberto,25,0,30,5
1746577587256,DSC 197,001,956898,Eldridge; Justin Matthew,9996,0,9999,3
1746577588281,DSC 297,001,958000,Mazumdar; Arya,9998,0,9999,1
1746577588281,DSC 297,002,959862,Wang; Yusu,9998,0,9999,1
1746577589309,EAP 100,A00,905686,Staff,9778,0,9999,221
1746577590335,ECE 45,A01,892618,Staff,0,0,65,65
1746577592399,ECE 111,A01,892719,Staff,5,0,65,60
1746577593423,ECE 197,001,957920,Mercier; Patrick Philip,9991,0,9999,8
1746577594451,ECON 178,A01,907814,Zhu; Ying,26,0,35,9
1746577595481,EDS 115,A00,895312,Staff,35,0,45,10
1746577596510,EDS 117,A01,895337,Staff,23,0,30,7
1746577597535,EDS 125,A00,895341,Jones; Gabrielle Anastasia,36,0,45,9
1746577598560,EDS 128A,A01,895459,Fargason; Sharon Gayle,44,0,45,1
1746577599587,EDS 128B,A01,895543,Pappas; Elizabeth,44,0,45,1
1746577600616,EDS 139,A00,897203,Pappas; Elizabeth,44,0,45,1
1746577600616,EDS 139,B00,897209,Fargason; Sharon Gayle,41,0,45,4
1746577601643,EDS 201,A00,895545,Staff,22,0,45,23
1746577602669,EDS 203,A01,895581,Halter; Christopher P.,22,0,45,23
1746577603694,EDS 204R,A01,895625,Heinzman; Erica M.,39,0,45,6
1746577603694,EDS 204R,B01,895693,Halter; Christopher P.,10,0,45,35
1746577604724,EDS 206R,A00,895694,Fargason; Sharon Gayle,1,0,30,29
1746577604724,EDS 206R,B00,895695,Choi; Bailey Miyeon,16,0,30,14
1746577605753,EDS 250,A00,895697,Hemans; Patricia Ann Benitez,22,0,45,23
1746577606778,EDS 281,A00,895701,Meyerott; Theresa Ann,1,0,15,14
1746577607806,EDS 284,A00,895736,Meyerott; Theresa Ann,1,0,15,14
1746577608832,EDS 286,A00,897210,Fine; Sarah,0,0,15,15
1746577609865,EDS 289C,A01,895770,Daly; Alan J.,1,0,15,14
1746577610889,EDS 290,A00,897211,Hofstetter; Carolyn,0,0,15,15
1746577611919,LIGM 5A,A00,896162,Fischer-Grunski; Eva K,12,0,20,8
1746577612946,LIGM 5B,A00,896260,Fischer-Grunski; Eva K,17,0,20,3
1746577613973,LIGM 5C,A00,896308,Fischer-Grunski; Eva K,18,0,20,2
1746577614999,LIIT 5AS,A00,896313,Carnelos; Chiara,18,0,20,2
1746577616028,LIIT 5BS,A00,896416,Carnelos; Chiara,20,0,20,0
1746577617054,LIIT 5CS,A00,896564,Carnelos; Chiara,20,0,20,0
1746577618080,LISP 5A,A00,896588,Munoz Sanchez; Alicia,2,0,20,18
1746577619107,LISP 5B,A00,896653,Munoz Sanchez; Alicia,7,0,20,13
1746577620132,LISP 5C,A00,896655,Munoz Sanchez; Alicia,0,1,20,20
1746577621163,MAE 197,001,957918,Kleissl; Jan,9996,0,9999,3
1746577621163,MAE 197,002,959806,Boechler; Nicholas Sebastia,9998,0,9999,1
1746577621163,MAE 197,003,959852,Mullin; Jennifer S,9998,0,9999,1
1746577622187,MATH 2,A01,957937,Staff,33,0,35,2
1746577623215,MATH 197,001,957876,Kedlaya; Kiran S.,9993,0,9999,6
1746577624243,MCWP 40,A00,892729,Duru; Nur,10,0,20,10
1746577624243,MCWP 40,B00,893304,Montejo; Carolina,14,0,20,6
1746577625268,MCWP 40R,A00,893757,Redela; Pamela Morgan,0,5,20,20
1746577626296,MCWP 50,A00,893758,Morshed; Michael James,0,0,20,20
1746577626296,MCWP 50,B00,893761,Bartulis; Jason Michael,17,0,20,3
1746577627320,MCWP 50R,A00,893766,Compas; Sean Matthew,0,1,20,20
1746577627320,MCWP 50R,B00,893769,Carter; Jennifer A,0,1,20,20
1746577627320,MCWP 50R,C00,893771,Krone; Jarret,0,3,20,20
1746577627320,MCWP 50R,D00,893772,Miller; Elizabeth Deen,0,0,20,20
1746577627320,MCWP 50R,E00,893775,Carter; Andrea L,0,1,20,20
1746577628348,MMW 11R,A01,892721,Herbst; Matthew,14,0,30,16
1746577628348,MMW 11R,A02,892722,Herbst; Matthew,0,0,0,3
1746577629376,MMW 12R,A01,892724,Herbst; Matthew,0,11,16,16
1746577629376,MMW 12R,A02,892725,Herbst; Matthew,0,10,16,16
1746577630399,MMW 13R,A01,892727,Staff,0,4,16,16
1746577630399,MMW 13R,A02,892728,Staff,0,4,16,16
1746577630399,MMW 13R,A03,958032,Staff,0,4,16,16
1746577630399,MMW 13R,A04,958033,Staff,0,4,16,16
1746577630399,MMW 13R,A05,958034,Staff,0,4,16,16
1746577631428,SIO 295LS,A00,894015,Staff,5,0,25,20
1746577632455,SIO 295S,A00,894020,Staff,5,0,25,20
1746577633480,SIOC 290S,B01,958918,Merrifield; Mark A,14,0,30,16
1746577634512,SIOC 291S,B01,958922,Gabriel; Corey John,14,0,30,16
1746577635537,SOCI 117,A01,895339,Staff,3,0,5,2
1746577636561,WES 237B,A00,894149,Staff,11,0,20,9
1746577638623,AESE 279B,A00,891859,Staff,13,0,35,22
1746577639647,AIP 197,001,891854,Vespa; Emanuel Ignacio,9999,0,9999,0
1746577640674,ANTH 289S,A00,891856,Gagneux; Pascal,12,0,12,0
1746577641701,BENG 196,001,957946,Engler; Adam J.,9996,0,9999,3
1746577642781,BISP 197,001,959851,Wilhelm; James E.,9998,0,9999,1
1746577643809,CAT 124RS,A01,956906,Staff,6,0,25,19
1746577644833,CAT 125RS,A01,922013,Staff,6,0,25,19
1746577645857,CLRE 250,A00,891860,Morris; Sheldon,9995,0,9999,4
1746577647916,CLRE 251R,A00,907817,Mehta; Ravindra L.,9994,0,9999,5
1746577648943,CLRE 252,A00,891864,Cuomo; Raphael Eduardo,9993,0,9999,6
1746577649973,CLRE 253,A00,891867,Vaida; Florin,9994,0,9999,5
1746577649973,CLRE 253,B00,907819,Staff,9999,0,9999,0
1746577650998,CLRE 259,A00,891868,Patel; Hemal,9998,0,9999,1
1746577652025,CLRE 260,A00,891872,Cuomo; Raphael Eduardo,9999,0,9999,0
1746577653054,CLRE 297,001,891888,Cuomo; Raphael Eduardo,9999,0,9999,0
1746577654081,CSE 191,A00,958773,Minnes Kemp; Mor Mia,9995,0,9999,4
1746577655106,CSE 197,001,959846,Minnes Kemp; Mor Mia,9990,0,9999,9
1746577656135,CSS 201S,A01,892054,Mignozzetti; Umberto,25,0,30,5
1746577657160,CSS 202S,A01,892056,Mignozzetti; Umberto,25,0,30,5
1746577658185,DSC 197,001,956898,Eldridge; Justin Matthew,9996,0,9999,3
1746577659213,DSC 297,001,958000,Mazumdar; Arya,9998,0,9999,1
1746577659213,DSC 297,002,959862,Wang; Yusu,9998,0,9999,1
1746577660237,EAP 100,A00,905686,Staff,9778,0,9999,221
1746577661267,ECE 45,A01,892618,Staff,0,0,65,65
1746577663321,ECE 111,A01,892719,Staff,5,0,65,60
1746577664346,ECE 197,001,957920,Mercier; Patrick Philip,9991,0,9999,8
1746577665378,ECON 178,A01,907814,Zhu; Ying,26,0,35,9
1746577666403,EDS 115,A00,895312,Staff,35,0,45,10
1746577667432,EDS 117,A01,895337,Staff,23,0,30,7
1746577668457,EDS 125,A00,895341,Jones; Gabrielle Anastasia,36,0,45,9
1746577669482,EDS 128A,A01,895459,Fargason; Sharon Gayle,44,0,45,1
1746577670507,EDS 128B,A01,895543,Pappas; Elizabeth,44,0,45,1
1746577671534,EDS 139,A00,897203,Pappas; Elizabeth,44,0,45,1
1746577671534,EDS 139,B00,897209,Fargason; Sharon Gayle,41,0,45,4
1746577672563,EDS 201,A00,895545,Staff,22,0,45,23
1746577673591,EDS 203,A01,895581,Halter; Christopher P.,22,0,45,23
1746577674617,EDS 204R,A01,895625,Heinzman; Erica M.,39,0,45,6
1746577674617,EDS 204R,B01,895693,Halter; Christopher P.,10,0,45,35
1746577675642,EDS 206R,A00,895694,Fargason; Sharon Gayle,1,0,30,29
1746577675642,EDS 206R,B00,895695,Choi; Bailey Miyeon,16,0,30,14
1746577676667,EDS 250,A00,895697,Hemans; Patricia Ann Benitez,22,0,45,23
1746577677695,EDS 281,A00,895701,Meyerott; Theresa Ann,1,0,15,14
1746577678724,EDS 284,A00,895736,Meyerott; Theresa Ann,1,0,15,14
1746577679748,EDS 286,A00,897210,Fine; Sarah,0,0,15,15
1746577680777,EDS 289C,A01,895770,Daly; Alan J.,1,0,15,14
1746577681802,EDS 290,A00,897211,Hofstetter; Carolyn,0,0,15,15
1746577682827,LIGM 5A,A00,896162,Fischer-Grunski; Eva K,12,0,20,8
1746577683854,LIGM 5B,A00,896260,Fischer-Grunski; Eva K,17,0,20,3
1746577684882,LIGM 5C,A00,896308,Fischer-Grunski; Eva K,18,0,20,2
1746577685908,LIIT 5AS,A00,896313,Carnelos; Chiara,18,0,20,2
1746577686936,LIIT 5BS,A00,896416,Carnelos; Chiara,20,0,20,0
1746577687962,LIIT 5CS,A00,896564,Carnelos; Chiara,20,0,20,0
1746577688989,LISP 5A,A00,896588,Munoz Sanchez; Alicia,2,0,20,18
1746577690014,LISP 5B,A00,896653,Munoz Sanchez; Alicia,7,0,20,13
1746577691040,LISP 5C,A00,896655,Munoz Sanchez; Alicia,0,1,20,20
1746577692069,MAE 197,001,957918,Kleissl; Jan,9996,0,9999,3
1746577692069,MAE 197,002,959806,Boechler; Nicholas Sebastia,9998,0,9999,1
1746577692069,MAE 197,003,959852,Mullin; Jennifer S,9998,0,9999,1
1746577693094,MATH 2,A01,957937,Staff,33,0,35,2
1746577694119,MATH 197,001,957876,Kedlaya; Kiran S.,9993,0,9999,6
1746577695147,MCWP 40,A00,892729,Duru; Nur,10,0,20,10
1746577695147,MCWP 40,B00,893304,Montejo; Carolina,14,0,20,6
1746577696173,MCWP 40R,A00,893757,Redela; Pamela Morgan,0,5,20,20
1746577697197,MCWP 50,A00,893758,Morshed; Michael James,0,0,20,20
1746577697197,MCWP 50,B00,893761,Bartulis; Jason Michael,17,0,20,3
1746577698224,MCWP 50R,A00,893766,Compas; Sean Matthew,0,1,20,20
1746577698224,MCWP 50R,B00,893769,Carter; Jennifer A,0,1,20,20
1746577698224,MCWP 50R,C00,893771,Krone; Jarret,0,3,20,20
1746577698224,MCWP 50R,D00,893772,Miller; Elizabeth Deen,0,0,20,20
1746577698224,MCWP 50R,E00,893775,Carter; Andrea L,0,1,20,20
1746577699247,MMW 11R,A01,892721,Herbst; Matthew,14,0,30,16
1746577699247,MMW 11R,A02,892722,Herbst; Matthew,0,0,0,3
1746577700273,MMW 12R,A01,892724,Herbst; Matthew,0,11,16,16
1746577700273,MMW 12R,A02,892725,Herbst; Matthew,0,10,16,16
1746577701298,MMW 13R,A01,892727,Staff,0,4,16,16
1746577701298,MMW 13R,A02,892728,Staff,0,4,16,16
1746577701298,MMW 13R,A03,958032,Staff,0,4,16,16
1746577701298,MMW 13R,A04,958033,Staff,0,4,16,16
1746577701298,MMW 13R,A05,958034,Staff,0,4,16,16
1746577702323,SIO 295LS,A00,894015,Staff,5,0,25,20
1746577703349,SIO 295S,A00,894020,Staff,5,0,25,20
1746577704377,SIOC 290S,B01,958918,Merrifield; Mark A,14,0,30,16
1746577705407,SIOC 291S,B01,958922,Gabriel; Corey John,14,0,30,16
1746577706433,SOCI 117,A01,895339,Staff,3,0,5,2
1746577707459,WES 237B,A00,894149,Staff,11,0,20,9
1746577709523,AESE 279B,A00,891859,Staff,13,0,35,22
1746577710555,AIP 197,001,891854,Vespa; Emanuel Ignacio,9999,0,9999,0
1746577711580,ANTH 289S,A00,891856,Gagneux; Pascal,12,0,12,0
1746577712605,BENG 196,001,957946,Engler; Adam J.,9996,0,9999,3
1746577713632,BISP 197,001,959851,Wilhelm; James E.,9998,0,9999,1
1746577714658,CAT 124RS,A01,956906,Staff,6,0,25,19
1746577715687,CAT 125RS,A01,922013,Staff,6,0,25,19
1746577716716,CLRE 250,A00,891860,Morris; Sheldon,9995,0,9999,4
1746577718768,CLRE 251R,A00,907817,Mehta; Ravindra L.,9994,0,9999,5
1746577719798,CLRE 252,A00,891864,Cuomo; Raphael Eduardo,9993,0,9999,6
1746577720825,CLRE 253,A00,891867,Vaida; Florin,9994,0,9999,5
1746577720825,CLRE 253,B00,907819,Staff,9999,0,9999,0
1746577721851,CLRE 259,A00,891868,Patel; Hemal,9998,0,9999,1
1746577722875,CLRE 260,A00,891872,Cuomo; Raphael Eduardo,9999,0,9999,0
1746577723900,CLRE 297,001,891888,Cuomo; Raphael Eduardo,9999,0,9999,0
1746577724927,CSE 191,A00,958773,Minnes Kemp; Mor Mia,9995,0,9999,4
1746577725954,CSE 197,001,959846,Minnes Kemp; Mor Mia,9990,0,9999,9
1746577726983,CSS 201S,A01,892054,Mignozzetti; Umberto,25,0,30,5
1746577728023,CSS 202S,A01,892056,Mignozzetti; Umberto,25,0,30,5
1746577729047,DSC 197,001,956898,Eldridge; Justin Matthew,9996,0,9999,3
1746577730071,DSC 297,001,958000,Mazumdar; Arya,9998,0,9999,1
1746577730071,DSC 297,002,959862,Wang; Yusu,9998,0,9999,1
1746577731097,EAP 100,A00,905686,Staff,9778,0,9999,221
1746577732129,ECE 45,A01,892618,Staff,0,0,65,65
1746577734181,ECE 111,A01,892719,Staff,5,0,65,60
1746577735206,ECE 197,001,957920,Mercier; Patrick Philip,9991,0,9999,8
1746577736232,ECON 178,A01,907814,Zhu; Ying,26,0,35,9
1746577737268,EDS 115,A00,895312,Staff,35,0,45,10
1746577738294,EDS 117,A01,895337,Staff,23,0,30,7
1746577739320,EDS 125,A00,895341,Jones; Gabrielle Anastasia,36,0,45,9
1746577740344,EDS 128A,A01,895459,Fargason; Sharon Gayle,44,0,45,1
1746577741368,EDS 128B,A01,895543,Pappas; Elizabeth,44,0,45,1
1746577742407,EDS 139,A00,897203,Pappas; Elizabeth,44,0,45,1
1746577742407,EDS 139,B00,897209,Fargason; Sharon Gayle,41,0,45,4
1746577743432,EDS 201,A00,895545,Staff,22,0,45,23
1746577744458,EDS 203,A01,895581,Halter; Christopher P.,22,0,45,23
1746577745486,EDS 204R,A01,895625,Heinzman; Erica M.,39,0,45,6
1746577745486,EDS 204R,B01,895693,Halter; Christopher P.,10,0,45,35
1746577746509,EDS 206R,A00,895694,Fargason; Sharon Gayle,1,0,30,29
1746577746509,EDS 206R,B00,895695,Choi; Bailey Miyeon,16,0,30,14
1746577747537,EDS 250,A00,895697,Hemans; Patricia Ann Benitez,22,0,45,23
1746577748564,EDS 281,A00,895701,Meyerott; Theresa Ann,1,0,15,14
1746577749590,EDS 284,A00,895736,Meyerott; Theresa Ann,1,0,15,14
1746577750616,EDS 286,A00,897210,Fine; Sarah,0,0,15,15
1746577751641,EDS 289C,A01,895770,Daly; Alan J.,1,0,15,14
1746577752664,EDS 290,A00,897211,Hofstetter; Carolyn,0,0,15,15
1746577753690,LIGM 5A,A00,896162,Fischer-Grunski; Eva K,12,0,20,8
1746577754715,LIGM 5B,A00,896260,Fischer-Grunski; Eva K,17,0,20,3
1746577755742,LIGM 5C,A00,896308,Fischer-Grunski; Eva K,18,0,20,2
1746577756771,LIIT 5AS,A00,896313,Carnelos; Chiara,18,0,20,2
1746577757799,LIIT 5BS,A00,896416,Carnelos; Chiara,20,0,20,0
1746577758825,LIIT 5CS,A00,896564,Carnelos; Chiara,20,0,20,0
1746577759849,LISP 5A,A00,896588,Munoz Sanchez; Alicia,2,0,20,18
1746577760878,LISP 5B,A00,896653,Munoz Sanchez; Alicia,7,0,20,13
1746577761904,LISP 5C,A00,896655,Munoz Sanchez; Alicia,0,1,20,20
1746577762928,MAE 197,001,957918,Kleissl; Jan,9996,0,9999,3
1746577762928,MAE 197,002,959806,Boechler; Nicholas Sebastia,9998,0,9999,1
1746577762928,MAE 197,003,959852,Mullin; Jennifer S,9998,0,9999,1
1746577763956,MATH 2,A01,957937,Staff,33,0,35,2
1746577764981,MATH 197,001,957876,Kedlaya; Kiran S.,9993,0,9999,6
1746577766006,MCWP 40,A00,892729,Duru; Nur,10,0,20,10
1746577766006,MCWP 40,B00,893304,Montejo; Carolina,14,0,20,6
1746577767045,MCWP 40R,A00,893757,Redela; Pamela Morgan,0,5,20,20
1746577768069,MCWP 50,A00,893758,Morshed; Michael James,0,0,20,20
1746577768069,MCWP 50,B00,893761,Bartulis; Jason Michael,17,0,20,3
1746577769103,MCWP 50R,A00,893766,Compas; Sean Matthew,0,1,20,20
1746577769103,MCWP 50R,B00,893769,Carter; Jennifer A,0,1,20,20
1746577769103,MCWP 50R,C00,893771,Krone; Jarret,0,3,20,20
1746577769103,MCWP 50R,D00,893772,Miller; Elizabeth Deen,0,0,20,20
1746577769103,MCWP 50R,E00,893775,Carter; Andrea L,0,1,20,20
1746577770127,MMW 11R,A01,892721,Herbst; Matthew,14,0,30,16
1746577770127,MMW 11R,A02,892722,Herbst; Matthew,0,0,0,3
1746577771151,MMW 12R,A01,892724,Herbst; Matthew,0,11,16,16
1746577771151,MMW 12R,A02,892725,Herbst; Matthew,0,10,16,16
1746577772179,MMW 13R,A01,892727,Staff,0,4,16,16
1746577772179,MMW 13R,A02,892728,Staff,0,4,16,16
1746577772179,MMW 13R,A03,958032,Staff,0,4,16,16
1746577772179,MMW 13R,A04,958033,Staff,0,4,16,16
1746577772179,MMW 13R,A05,958034,Staff,0,4,16,16
1746577773205,SIO 295LS,A00,894015,Staff,5,0,25,20
1746577774229,SIO 295S,A00,894020,Staff,5,0,25,20
1746577775254,SIOC 290S,B01,958918,Merrifield; Mark A,14,0,30,16
1746577776277,SIOC 291S,B01,958922,Gabriel; Corey John,14,0,30,16
1746577777302,SOCI 117,A01,895339,Staff,3,0,5,2
1746577778327,WES 237B,A00,894149,Staff,11,0,20,9
1746577780384,AESE 279B,A00,891859,Staff,13,0,35,22
1746577781409,AIP 197,001,891854,Vespa; Emanuel Ignacio,9999,0,9999,0
1746577782436,ANTH 289S,A00,891856,Gagneux; Pascal,12,0,12,0
1746577783463,BENG 196,001,957946,Engler; Adam J.,9996,0,9999,3
1746577784488,BISP 197,001,959851,Wilhelm; James E.,9998,0,9999,1
1746577785514,CAT 124RS,A01,956906,Staff,6,0,25,19
1746577786541,CAT 125RS,A01,922013,Staff,6,0,25,19
1746577787567,CLRE 250,A00,891860,Morris; Sheldon,9995,0,9999,4
1746577789617,CLRE 251R,A00,907817,Mehta; Ravindra L.,9994,0,9999,5
1746577790640,CLRE 252,A00,891864,Cuomo; Raphael Eduardo,9993,0,9999,6
1746577791666,CLRE 253,A00,891867,Vaida; Florin,9994,0,9999,5
1746577791666,CLRE 253,B00,907819,Staff,9999,0,9999,0
1746577792693,CLRE 259,A00,891868,Patel; Hemal,9998,0,9999,1
1746577793718,CLRE 260,A00,891872,Cuomo; Raphael Eduardo,9999,0,9999,0
1746577794746,CLRE 297,001,891888,Cuomo; Raphael Eduardo,9999,0,9999,0
1746577795832,CSE 191,A00,958773,Minnes Kemp; Mor Mia,9995,0,9999,4
1746577796859,CSE 197,001,959846,Minnes Kemp; Mor Mia,9990,0,9999,9
1746577797885,CSS 201S,A01,892054,Mignozzetti; Umberto,25,0,30,5
1746577798909,CSS 202S,A01,892056,Mignozzetti; Umberto,25,0,30,5
1746577799938,DSC 197,001,956898,Eldridge; Justin Matthew,9996,0,9999,3
1746577800963,DSC 297,001,958000,Mazumdar; Arya,9998,0,9999,1
1746577800963,DSC 297,002,959862,Wang; Yusu,9998,0,9999,1
1746577801989,EAP 100,A00,905686,Staff,9778,0,9999,221
1746577803017,ECE 45,A01,892618,Staff,0,0,65,65
1746577805072,ECE 111,A01,892719,Staff,5,0,65,60
1746577806109,ECE 197,001,957920,Mercier; Patrick Philip,9991,0,9999,8
1746577807135,ECON 178,A01,907814,Zhu; Ying,26,0,35,9
1746577808159,EDS 115,A00,895312,Staff,35,0,45,10
1746577809184,EDS 117,A01,895337,Staff,23,0,30,7
1746577810207,EDS 125,A00,895341,Jones; Gabrielle Anastasia,36,0,45,9
1746577811235,EDS 128A,A01,895459,Fargason; Sharon Gayle,44,0,45,1
1746577812263,EDS 128B,A01,895543,Pappas; Elizabeth,44,0,45,1
1746577813289,EDS 139,A00,897203,Pappas; Elizabeth,44,0,45,1
1746577813289,EDS 139,B00,897209,Fargason; Sharon Gayle,41,0,45,4
1746577814317,EDS 201,A00,895545,Staff,22,0,45,23
1746577815347,EDS 203,A01,895581,Halter; Christopher P.,22,0,45,23
1746577816376,EDS 204R,A01,895625,Heinzman; Erica M.,39,0,45,6
1746577816376,EDS 204R,B01,895693,Halter; Christopher P.,10,0,45,35
1746577817403,EDS 206R,A00,895694,Fargason; Sharon Gayle,1,0,30,29
1746577817403,EDS 206R,B00,895695,Choi; Bailey Miyeon,16,0,30,14
1746577818431,EDS 250,A00,895697,Hemans; Patricia Ann Benitez,22,0,45,23
1746577819455,EDS 281,A00,895701,Meyerott; Theresa Ann,1,0,15,14
1746577820480,EDS 284,A00,895736,Meyerott; Theresa Ann,1,0,15,14
1746577821505,EDS 286,A00,897210,Fine; Sarah,0,0,15,15
1746577822532,EDS 289C,A01,895770,Daly; Alan J.,1,0,15,14
1746577823558,EDS 290,A00,897211,Hofstetter; Carolyn,0,0,15,15
1746577824583,LIGM 5A,A00,896162,Fischer-Grunski; Eva K,12,0,20,8
1746577825613,LIGM 5B,A00,896260,Fischer-Grunski; Eva K,17,0,20,3
1746577826643,LIGM 5C,A00,896308,Fischer-Grunski; Eva K,18,0,20,2
1746577827670,LIIT 5AS,A00,896313,Carnelos; Chiara,18,0,20,2
1746577828696,LIIT 5BS,A00,896416,Carnelos; Chiara,20,0,20,0
1746577829721,LIIT 5CS,A00,896564,Carnelos; Chiara,20,0,20,0
1746577830746,LISP 5A,A00,896588,Munoz Sanchez; Alicia,2,0,20,18
1746577831775,LISP 5B,A00,896653,Munoz Sanchez; Alicia,7,0,20,13
1746577832800,LISP 5C,A00,896655,Munoz Sanchez; Alicia,0,1,20,20
1746577833825,MAE 197,001,957918,Kleissl; Jan,9996,0,9999,3
1746577833825,MAE 197,002,959806,Boechler; Nicholas Sebastia,9998,0,9999,1
1746577833825,MAE 197,003,959852,Mullin; Jennifer S,9998,0,9999,1
1746577834853,MATH 2,A01,957937,Staff,33,0,35,2
1746577835877,MATH 197,001,957876,Kedlaya; Kiran S.,9993,0,9999,6
1746577836904,MCWP 40,A00,892729,Duru; Nur,10,0,20,10
1746577836904,MCWP 40,B00,893304,Montejo; Carolina,14,0,20,6
1746577837929,MCWP 40R,A00,893757,Redela; Pamela Morgan,0,5,20,20
1746577838957,MCWP 50,A00,893758,Morshed; Michael James,0,0,20,20
1746577838957,MCWP 50,B00,893761,Bartulis; Jason Michael,17,0,20,3
1746577839984,MCWP 50R,A00,893766,Compas; Sean Matthew,0,1,20,20
1746577839984,MCWP 50R,B00,893769,Carter; Jennifer A,0,1,20,20
1746577839984,MCWP 50R,C00,893771,Krone; Jarret,0,3,20,20
1746577839984,MCWP 50R,D00,893772,Miller; Elizabeth Deen,0,0,20,20
1746577839984,MCWP 50R,E00,893775,Carter; Andrea L,0,1,20,20
1746577841010,MMW 11R,A01,892721,Herbst; Matthew,14,0,30,16
1746577841010,MMW 11R,A02,892722,Herbst; Matthew,0,0,0,3
1746577842037,MMW 12R,A01,892724,Herbst; Matthew,0,11,16,16
1746577842037,MMW 12R,A02,892725,Herbst; Matthew,0,10,16,16
1746577843063,MMW 13R,A01,892727,Staff,0,4,16,16
1746577843063,MMW 13R,A02,892728,Staff,0,4,16,16
1746577843063,MMW 13R,A03,958032,Staff,0,4,16,16
1746577843063,MMW 13R,A04,958033,Staff,0,4,16,16
1746577843063,MMW 13R,A05,958034,Staff,0,4,16,16
1746577844089,SIO 295LS,A00,894015,Staff,5,0,25,20
1746577845118,SIO 295S,A00,894020,Staff,5,0,25,20
1746577846144,SIOC 290S,B01,958918,Merrifield; Mark A,14,0,30,16
1746577847174,SIOC 291S,B01,958922,Gabriel; Corey John,14,0,30,16
1746577848200,SOCI 117,A01,895339,Staff,3,0,5,2
1746577849226,WES 237B,A00,894149,Staff,11,0,20,9
1746577851281,AESE 279B,A00,891859,Staff,13,0,35,22
1746577852306,AIP 197,001,891854,Vespa; Emanuel Ignacio,9999,0,9999,0
1746577853335,ANTH 289S,A00,891856,Gagneux; Pascal,12,0,12,0
1746577854362,BENG 196,001,957946,Engler; Adam J.,9996,0,9999,3
1746577855386,BISP 197,001,959851,Wilhelm; James E.,9998,0,9999,1
1746577856413,CAT 124RS,A01,956906,Staff,6,0,25,19
1746577857439,CAT 125RS,A01,922013,Staff,6,0,25,19
1746577858463,CLRE 250,A00,891860,Morris; Sheldon,9995,0,9999,4
1746577860521,CLRE 251R,A00,907817,Mehta; Ravindra L.,9994,0,9999,5
1746577861546,CLRE 252,A00,891864,Cuomo; Raphael Eduardo,9993,0,9999,6
1746577862571,CLRE 253,A00,891867,Vaida; Florin,9994,0,9999,5
1746577862571,CLRE 253,B00,907819,Staff,9999,0,9999,0
1746577863597,CLRE 259,A00,891868,Patel; Hemal,9998,0,9999,1
1746577864626,CLRE 260,A00,891872,Cuomo; Raphael Eduardo,9999,0,9999,0
1746577865656,CLRE 297,001,891888,Cuomo; Raphael Eduardo,9999,0,9999,0
1746577866682,CSE 191,A00,958773,Minnes Kemp; Mor Mia,9995,0,9999,4
1746577867710,CSE 197,001,959846,Minnes Kemp; Mor Mia,9990,0,9999,9
1746577868734,CSS 201S,A01,892054,Mignozzetti; Umberto,25,0,30,5
1746577869760,CSS 202S,A01,892056,Mignozzetti; Umberto,25,0,30,5
1746577870824,DSC 197,001,956898,Eldridge; Justin Matthew,9996,0,9999,3
1746577871849,DSC 297,001,958000,Mazumdar; Arya,9998,0,9999,1
1746577871849,DSC 297,002,959862,Wang; Yusu,9998,0,9999,1
1746577872874,EAP 100,A00,905686,Staff,9778,0,9999,221
1746577873898,ECE 45,A01,892618,Staff,0,0,65,65
1746577875954,ECE 111,A01,892719,Staff,5,0,65,60
1746577876981,ECE 197,001,957920,Mercier; Patrick Philip,9991,0,9999,8
1746577878007,ECON 178,A01,907814,Zhu; Ying,26,0,35,9
1746577879034,EDS 115,A00,895312,Staff,35,0,45,10
1746577880063,EDS 117,A01,895337,Staff,23,0,30,7
1746577881092,EDS 125,A00,895341,Jones; Gabrielle Anastasia,36,0,45,9
1746577882116,EDS 128A,A01,895459,Fargason; Sharon Gayle,44,0,45,1
1746577883144,EDS 128B,A01,895543,Pappas; Elizabeth,44,0,45,1
1746577884169,EDS 139,A00,897203,Pappas; Elizabeth,44,0,45,1
1746577884169,EDS 139,B00,897209,Fargason; Sharon Gayle,41,0,45,4
1746577885193,EDS 201,A00,895545,Staff,22,0,45,23
1746577886221,EDS 203,A01,895581,Halter; Christopher P.,22,0,45,23
1746577887251,EDS 204R,A01,895625,Heinzman; Erica M.,39,0,45,6
1746577887251,EDS 204R,B01,895693,Halter; Christopher P.,10,0,45,35
1746577888279,EDS 206R,A00,895694,Fargason; Sharon Gayle,1,0,30,29
1746577888279,EDS 206R,B00,895695,Choi; Bailey Miyeon,16,0,30,14
1746577889304,EDS 250,A00,895697,Hemans; Patricia Ann Benitez,22,0,45,23
1746577890332,EDS 281,A00,895701,Meyerott; Theresa Ann,1,0,15,14
1746577891359,EDS 284,A00,895736,Meyerott; Theresa Ann,1,0,15,14
1746577892386,EDS 286,A00,897210,Fine; Sarah,0,0,15,15
1746577893411,EDS 289C,A01,895770,Daly; Alan J.,1,0,15,14
1746577894438,EDS 290,A00,897211,Hofstetter; Carolyn,0,0,15,15
1746577895468,LIGM 5A,A00,896162,Fischer-Grunski; Eva K,12,0,20,8
1746577896495,LIGM 5B,A00,896260,Fischer-Grunski; Eva K,17,0,20,3
1746577897520,LIGM 5C,A00,896308,Fischer-Grunski; Eva K,18,0,20,2
1746577898550,LIIT 5AS,A00,896313,Carnelos; Chiara,18,0,20,2
1746577899580,LIIT 5BS,A00,896416,Carnelos; Chiara,20,0,20,0
1746577900610,LIIT 5CS,A00,896564,Carnelos; Chiara,20,0,20,0
1746577901635,LISP 5A,A00,896588,Munoz Sanchez; Alicia,2,0,20,18
1746577902661,LISP 5B,A00,896653,Munoz Sanchez; Alicia,7,0,20,13
1746577903686,LISP 5C,A00,896655,Munoz Sanchez; Alicia,0,1,20,20
1746577904711,MAE 197,001,957918,Kleissl; Jan,9996,0,9999,3
1746577904711,MAE 197,002,959806,Boechler; Nicholas Sebastia,9998,0,9999,1
1746577904711,MAE 197,003,959852,Mullin; Jennifer S,9998,0,9999,1
1746577905734,MATH 2,A01,957937,Staff,33,0,35,2
1746577906762,MATH 197,001,957876,Kedlaya; Kiran S.,9993,0,9999,6
1746577907792,MCWP 40,A00,892729,Duru; Nur,10,0,20,10
1746577907792,MCWP 40,B00,893304,Montejo; Carolina,14,0,20,6
1746577908822,MCWP 40R,A00,893757,Redela; Pamela Morgan,0,5,20,20
1746577909847,MCWP 50,A00,893758,Morshed; Michael James,0,0,20,20
1746577909847,MCWP 50,B00,893761,Bartulis; Jason Michael,17,0,20,3
1746577910873,MCWP 50R,A00,893766,Compas; Sean Matthew,0,1,20,20
1746577910873,MCWP 50R,B00,893769,Carter; Jennifer A,0,1,20,20
1746577910873,MCWP 50R,C00,893771,Krone; Jarret,0,3,20,20
1746577910873,MCWP 50R,D00,893772,Miller; Elizabeth Deen,0,0,20,20
1746577910873,MCWP 50R,E00,893775,Carter; Andrea L,0,1,20,20
1746577911899,MMW 11R,A01,892721,Herbst; Matthew,14,0,30,16
1746577911899,MMW 11R,A02,892722,Herbst; Matthew,0,0,0,3
1746577912924,MMW 12R,A01,892724,Herbst; Matthew,0,11,16,16
1746577912924,MMW 12R,A02,892725,Herbst; Matthew,0,10,16,16
1746577913952,MMW 13R,A01,892727,Staff,0,4,16,16
1746577913952,MMW 13R,A02,892728,Staff,0,4,16,16
1746577913952,MMW 13R,A03,958032,Staff,0,4,16,16
1746577913952,MMW 13R,A04,958033,Staff,0,4,16,16
1746577913952,MMW 13R,A05,958034,Staff,0,4,16,16
1746577914982,SIO 295LS,A00,894015,Staff,5,0,25,20
1746577916008,SIO 295S,A00,894020,Staff,5,0,25,20
1746577917036,SIOC 290S,B01,958918,Merrifield; Mark A,14,0,30,16
1746577918061,SIOC 291S,B01,958922,Gabriel; Corey John,14,0,30,16
1746577919085,SOCI 117,A01,895339,Staff,3,0,5,2
1746577920112,WES 237B,A00,894149,Staff,11,0,20,9
1746577922177,AESE 279B,A00,891859,Staff,13,0,35,22
1746577923203,AIP 197,001,891854,Vespa; Emanuel Ignacio,9999,0,9999,0
1746577924228,ANTH 289S,A00,891856,Gagneux; Pascal,12,0,12,0
1746577925251,BENG 196,001,957946,Engler; Adam J.,9996,0,9999,3
1746577926276,BISP 197,001,959851,Wilhelm; James E.,9998,0,9999,1
1746577927300,CAT 124RS,A01,956906,Staff,6,0,25,19
1746577928345,CAT 125RS,A01,922013,Staff,6,0,25,19
1746577929374,CLRE 250,A00,891860,Morris; Sheldon,9995,0,9999,4
1746577931430,CLRE 251R,A00,907817,Mehta; Ravindra L.,9994,0,9999,5
1746577932459,CLRE 252,A00,891864,Cuomo; Raphael Eduardo,9993,0,9999,6
1746577933485,CLRE 253,A00,891867,Vaida; Florin,9994,0,9999,5
1746577933485,CLRE 253,B00,907819,Staff,9999,0,9999,0
1746577934513,CLRE 259,A00,891868,Patel; Hemal,9998,0,9999,1
1746577935538,CLRE 260,A00,891872,Cuomo; Raphael Eduardo,9999,0,9999,0
1746577936561,CLRE 297,001,891888,Cuomo; Raphael Eduardo,9999,0,9999,0
1746577937587,CSE 191,A00,958773,Minnes Kemp; Mor Mia,9995,0,9999,4
1746577938614,CSE 197,001,959846,Minnes Kemp; Mor Mia,9990,0,9999,9
1746577939643,CSS 201S,A01,892054,Mignozzetti; Umberto,25,0,30,5
1746577940668,CSS 202S,A01,892056,Mignozzetti; Umberto,25,0,30,5
1746577941694,DSC 197,001,956898,Eldridge; Justin Matthew,9996,0,9999,3
1746577942720,DSC 297,001,958000,Mazumdar; Arya,9998,0,9999,1
1746577942720,DSC 297,002,959862,Wang; Yusu,9998,0,9999,1
1746577943747,EAP 100,A00,905686,Staff,9778,0,9999,221
1746577944773,ECE 45,A01,892618,Staff,0,0,65,65
1746577946825,ECE 111,A01,892719,Staff,5,0,65,60
1746577947849,ECE 197,001,957920,Mercier; Patrick Philip,9991,0,9999,8
1746577948877,ECON 178,A01,907814,Zhu; Ying,26,0,35,9
1746577949902,EDS 115,A00,895312,Staff,35,0,45,10
1746577950926,EDS 117,A01,895337,Staff,23,0,30,7
1746577951950,EDS 125,A00,895341,Jones; Gabrielle Anastasia,36,0,45,9
1746577952980,EDS 128A,A01,895459,Fargason; Sharon Gayle,44,0,45,1
1746577954008,EDS 128B,A01,895543,Pappas; Elizabeth,44,0,45,1
1746577955033,EDS 139,A00,897203,Pappas; Elizabeth,44,0,45,1
1746577955033,EDS 139,B00,897209,Fargason; Sharon Gayle,41,0,45,4
1746577956057,EDS 201,A00,895545,Staff,22,0,45,23
1746577957097,EDS 203,A01,895581,Halter; Christopher P.,22,0,45,23
1746577958125,EDS 204R,A01,895625,Heinzman; Erica M.,39,0,45,6
1746577958125,EDS 204R,B01,895693,Halter; Christopher P.,10,0,45,35
1746577959153,EDS 206R,A00,895694,Fargason; Sharon Gayle,1,0,30,29
1746577959153,EDS 206R,B00,895695,Choi; Bailey Miyeon,16,0,30,14
1746577960179,EDS 250,A00,895697,Hemans; Patricia Ann Benitez,22,0,45,23
1746577961202,EDS 281,A00,895701,Meyerott; Theresa Ann,1,0,15,14
1746577962228,EDS 284,A00,895736,Meyerott; Theresa Ann,1,0,15,14
1746577963254,EDS 286,A00,897210,Fine; Sarah,0,0,15,15
1746577964278,EDS 289C,A01,895770,Daly; Alan J.,1,0,15,14
1746577965303,EDS 290,A00,897211,Hofstetter; Carolyn,0,0,15,15
1746577966332,LIGM 5A,A00,896162,Fischer-Grunski; Eva K,12,0,20,8
1746577967355,LIGM 5B,A00,896260,Fischer-Grunski; Eva K,17,0,20,3
1746577968379,LIGM 5C,A00,896308,Fischer-Grunski; Eva K,18,0,20,2
1746577969405,LIIT 5AS,A00,896313,Carnelos; Chiara,18,0,20,2
1746577970433,LIIT 5BS,A00,896416,Carnelos; Chiara,20,0,20,0
1746577971458,LIIT 5CS,A00,896564,Carnelos; Chiara,20,0,20,0
1746577972486,LISP 5A,A00,896588,Munoz Sanchez; Alicia,2,0,20,18
1746577973512,LISP 5B,A00,896653,Munoz Sanchez; Alicia,7,0,20,13
1746577974535,LISP 5C,A00,896655,Munoz Sanchez; Alicia,0,1,20,20
1746577975565,MAE 197,001,957918,Kleissl; Jan,9996,0,9999,3
1746577975565,MAE 197,002,959806,Boechler; Nicholas Sebastia,9998,0,9999,1
1746577975565,MAE 197,003,959852,Mullin; Jennifer S,9998,0,9999,1
1746577976591,MATH 2,A01,957937,Staff,33,0,35,2
1746577977620,MATH 197,001,957876,Kedlaya; Kiran S.,9993,0,9999,6
1746577978644,MCWP 40,A00,892729,Duru; Nur,10,0,20,10
1746577978644,MCWP 40,B00,893304,Montejo; Carolina,14,0,20,6
1746577979668,MCWP 40R,A00,893757,Redela; Pamela Morgan,0,5,20,20
1746577980694,MCWP 50,A00,893758,Morshed; Michael James,0,0,20,20
1746577980694,MCWP 50,B00,893761,Bartulis; Jason Michael,17,0,20,3
1746577981721,MCWP 50R,A00,893766,Compas; Sean Matthew,0,1,20,20
1746577981721,MCWP 50R,B00,893769,Carter; Jennifer A,0,1,20,20
1746577981721,MCWP 50R,C00,893771,Krone; Jarret,0,3,20,20
1746577981721,MCWP 50R,D00,893772,Miller; Elizabeth Deen,0,0,20,20
1746577981721,MCWP 50R,E00,893775,Carter; Andrea L,0,1,20,20
1746577982751,MMW 11R,A01,892721,Herbst; Matthew,14,0,30,16
1746577982751,MMW 11R,A02,892722,Herbst; Matthew,0,0,0,3
1746577983780,MMW 12R,A01,892724,Herbst; Matthew,0,11,16,16
1746577983780,MMW 12R,A02,892725,Herbst; Matthew,0,10,16,16
1746577984807,MMW 13R,A01,892727,Staff,0,4,16,16
1746577984807,MMW 13R,A02,892728,Staff,0,4,16,16
1746577984807,MMW 13R,A03,958032,Staff,0,4,16,16
1746577984807,MMW 13R,A04,958033,Staff,0,4,16,16
1746577984807,MMW 13R,A05,958034,Staff,0,4,16,16
1746577985834,SIO 295LS,A00,894015,Staff,5,0,25,20
1746577986858,SIO 295S,A00,894020,Staff,5,0,25,20
1746577987884,SIOC 290S,B01,958918,Merrifield; Mark A,14,0,30,16
1746577988913,SIOC 291S,B01,958922,Gabriel; Corey John,14,0,30,16
1746577989966,SOCI 117,A01,895339,Staff,3,0,5,2
1746577990994,WES 237B,A00,894149,Staff,11,0,20,9
1746577993059,AESE 279B,A00,891859,Staff,13,0,35,22
1746577994087,AIP 197,001,891854,Vespa; Emanuel Ignacio,9999,0,9999,0
1746577995115,ANTH 289S,A00,891856,Gagneux; Pascal,12,0,12,0
1746577996144,BENG 196,001,957946,Engler; Adam J.,9996,0,9999,3
1746577997170,BISP 197,001,959851,Wilhelm; James E.,9998,0,9999,1
1746577998209,CAT 124RS,A01,956906,Staff,6,0,25,19
1746577999234,CAT 125RS,A01,922013,Staff,6,0,25,19
1746578000263,CLRE 250,A00,891860,Morris; Sheldon,9995,0,9999,4
1746578002318,CLRE 251R,A00,907817,Mehta; Ravindra L.,9994,0,9999,5
1746578003346,CLRE 252,A00,891864,Cuomo; Raphael Eduardo,9993,0,9999,6
1746578004373,CLRE 253,A00,891867,Vaida; Florin,9994,0,9999,5
1746578004373,CLRE 253,B00,907819,Staff,9999,0,9999,0
1746578005397,CLRE 259,A00,891868,Patel; Hemal,9998,0,9999,1
1746578006422,CLRE 260,A00,891872,Cuomo; Raphael Eduardo,9999,0,9999,0
1746578007445,CLRE 297,001,891888,Cuomo; Raphael Eduardo,9999,0,9999,0
1746578008473,CSE 191,A00,958773,Minnes Kemp; Mor Mia,9995,0,9999,4
1746578009499,CSE 197,001,959846,Minnes Kemp; Mor Mia,9990,0,9999,9
1746578010526,CSS 201S,A01,892054,Mignozzetti; Umberto,25,0,30,5
1746578011557,CSS 202S,A01,892056,Mignozzetti; Umberto,25,0,30,5
1746578012584,DSC 197,001,956898,Eldridge; Justin Matthew,9996,0,9999,3
1746578013610,DSC 297,001,958000,Mazumdar; Arya,9998,0,9999,1
1746578013610,DSC 297,002,959862,Wang; Yusu,9998,0,9999,1
1746578014637,EAP 100,A00,905686,Staff,9778,0,9999,221
1746578015667,ECE 45,A01,892618,Staff,0,0,65,65
1746578017722,ECE 111,A01,892719,Staff,5,0,65,60
1746578018746,ECE 197,001,957920,Mercier; Patrick Philip,9991,0,9999,8
1746578019770,ECON 178,A01,907814,Zhu; Ying,26,0,35,9
1746578020798,EDS 115,A00,895312,Staff,35,0,45,10
1746578021823,EDS 117,A01,895337,Staff,23,0,30,7
1746578022849,EDS 125,A00,895341,Jones; Gabrielle Anastasia,36,0,45,9
1746578023875,EDS 128A,A01,895459,Fargason; Sharon Gayle,44,0,45,1
1746578024902,EDS 128B,A01,895543,Pappas; Elizabeth,44,0,45,1
1746578025967,EDS 139,A00,897203,Pappas; Elizabeth,44,0,45,1
1746578025967,EDS 139,B00,897209,Fargason; Sharon Gayle,41,0,45,4
1746578026992,EDS 201,A00,895545,Staff,22,0,45,23
1746578028017,EDS 203,A01,895581,Halter; Christopher P.,22,0,45,23
1746578029042,EDS 204R,A01,895625,Heinzman; Erica M.,39,0,45,6
1746578029042,EDS 204R,B01,895693,Halter; Christopher P.,10,0,45,35
1746578030067,EDS 206R,A00,895694,Fargason; Sharon Gayle,1,0,30,29
1746578030067,EDS 206R,B00,895695,Choi; Bailey Miyeon,16,0,30,14
1746578031101,EDS 250,A00,895697,Hemans; Patricia Ann Benitez,22,0,45,23
1746578032128,EDS 281,A00,895701,Meyerott; Theresa Ann,1,0,15,14
1746578033156,EDS 284,A00,895736,Meyerott; Theresa Ann,1,0,15,14
1746578034182,EDS 286,A00,897210,Fine; Sarah,0,0,15,15
1746578035212,EDS 289C,A01,895770,Daly; Alan J.,1,0,15,14
1746578036236,EDS 290,A00,897211,Hofstetter; Carolyn,0,0,15,15
1746578037263,LIGM 5A,A00,896162,Fischer-Grunski; Eva K,12,0,20,8
1746578038293,LIGM 5B,A00,896260,Fischer-Grunski; Eva K,17,0,20,3
1746578039322,LIGM 5C,A00,896308,Fischer-Grunski; Eva K,18,0,20,2
1746578040350,LIIT 5AS,A00,896313,Carnelos; Chiara,18,0,20,2
1746578041374,LIIT 5BS,A00,896416,Carnelos; Chiara,20,0,20,0
1746578042416,LIIT 5CS,A00,896564,Carnelos; Chiara,20,0,20,0
1746578043444,LISP 5A,A00,896588,Munoz Sanchez; Alicia,2,0,20,18
1746578044471,LISP 5B,A00,896653,Munoz Sanchez; Alicia,7,0,20,13
1746578045496,LISP 5C,A00,896655,Munoz Sanchez; Alicia,0,1,20,20
1746578046525,MAE 197,001,957918,Kleissl; Jan,9996,0,9999,3
1746578046525,MAE 197,002,959806,Boechler; Nicholas Sebastia,9998,0,9999,1
1746578046525,MAE 197,003,959852,Mullin; Jennifer S,9998,0,9999,1
1746578047548,MATH 2,A01,957937,Staff,33,0,35,2
1746578048572,MATH 197,001,957876,Kedlaya; Kiran S.,9993,0,9999,6
1746578049598,MCWP 40,A00,892729,Duru; Nur,10,0,20,10
1746578049598,MCWP 40,B00,893304,Montejo; Carolina,14,0,20,6
1746578050626,MCWP 40R,A00,893757,Redela; Pamela Morgan,0,5,20,20
1746578051654,MCWP 50,A00,893758,Morshed; Michael James,0,0,20,20
1746578051654,MCWP 50,B00,893761,Bartulis; Jason Michael,17,0,20,3
1746578052685,MCWP 50R,A00,893766,Compas; Sean Matthew,0,1,20,20
1746578052685,MCWP 50R,B00,893769,Carter; Jennifer A,0,1,20,20
1746578052685,MCWP 50R,C00,893771,Krone; Jarret,0,3,20,20
1746578052685,MCWP 50R,D00,893772,Miller; Elizabeth Deen,0,0,20,20
1746578052685,MCWP 50R,E00,893775,Carter; Andrea L,0,1,20,20
1746578053709,MMW 11R,A01,892721,Herbst; Matthew,14,0,30,16
1746578053709,MMW 11R,A02,892722,Herbst; Matthew,0,0,0,3
1746578054735,MMW 12R,A01,892724,Herbst; Matthew,0,11,16,16
1746578054735,MMW 12R,A02,892725,Herbst; Matthew,0,10,16,16
1746578055760,MMW 13R,A01,892727,Staff,0,4,16,16
1746578055760,MMW 13R,A02,892728,Staff,0,4,16,16
1746578055760,MMW 13R,A03,958032,Staff,0,4,16,16
1746578055760,MMW 13R,A04,958033,Staff,0,4,16,16
1746578055760,MMW 13R,A05,958034,Staff,0,4,16,16
1746578056788,SIO 295LS,A00,894015,Staff,5,0,25,20
1746578057816,SIO 295S,A00,894020,Staff,5,0,25,20
1746578058846,SIOC 290S,B01,958918,Merrifield; Mark A,14,0,30,16
1746578059878,SIOC 291S,B01,958922,Gabriel; Corey John,14,0,30,16
1746578060906,SOCI 117,A01,895339,Staff,3,0,5,2
1746578061936,WES 237B,A00,894149,Staff,11,0,20,9
1746578063996,AESE 279B,A00,891859,Staff,13,0,35,22
1746578065026,AIP 197,001,891854,Vespa; Emanuel Ignacio,9999,0,9999,0
1746578066054,ANTH 289S,A00,891856,Gagneux; Pascal,12,0,12,0
1746578067083,BENG 196,001,957946,Engler; Adam J.,9996,0,9999,3
1746578068108,BISP 197,001,959851,Wilhelm; James E.,9998,0,9999,1
1746578069131,CAT 124RS,A01,956906,Staff,6,0,25,19
1746578070156,CAT 125RS,A01,922013,Staff,6,0,25,19
1746578071180,CLRE 250,A00,891860,Morris; Sheldon,9995,0,9999,4
1746578073231,CLRE 251R,A00,907817,Mehta; Ravindra L.,9994,0,9999,5
1746578074258,CLRE 252,A00,891864,Cuomo; Raphael Eduardo,9993,0,9999,6
1746578075284,CLRE 253,A00,891867,Vaida; Florin,9994,0,9999,5
1746578075284,CLRE 253,B00,907819,Staff,9999,0,9999,0
1746578076309,CLRE 259,A00,891868,Patel; Hemal,9998,0,9999,1
1746578077337,CLRE 260,A00,891872,Cuomo; Raphael Eduardo,9999,0,9999,0
1746578078366,CLRE 297,001,891888,Cuomo; Raphael Eduardo,9999,0,9999,0
1746578079393,CSE 191,A00,958773,Minnes Kemp; Mor Mia,9995,0,9999,4
1746578080420,CSE 197,001,959846,Minnes Kemp; Mor Mia,9990,0,9999,9
1746578081446,CSS 201S,A01,892054,Mignozzetti; Umberto,25,0,30,5
1746578082475,CSS 202S,A01,892056,Mignozzetti; Umberto,25,0,30,5
1746578083501,DSC 197,001,956898,Eldridge; Justin Matthew,9996,0,9999,3
1746578084526,DSC 297,001,958000,Mazumdar; Arya,9998,0,9999,1
1746578084526,DSC 297,002,959862,Wang; Yusu,9998,0,9999,1
1746578085554,EAP 100,A00,905686,Staff,9778,0,9999,221
1746578086580,ECE 45,A01,892618,Staff,0,0,65,65
1746578088634,ECE 111,A01,892719,Staff,6,0,65,59
1746578089658,ECE 197,001,957920,Mercier; Patrick Philip,9991,0,9999,8
1746578090683,ECON 178,A01,907814,Zhu; Ying,26,0,35,9
1746578091710,EDS 115,A00,895312,Staff,35,0,45,10
1746578092735,EDS 117,A01,895337,Staff,23,0,30,7
1746578093759,EDS 125,A00,895341,Jones; Gabrielle Anastasia,36,0,45,9
1746578094784,EDS 128A,A01,895459,Fargason; Sharon Gayle,44,0,45,1
1746578095808,EDS 128B,A01,895543,Pappas; Elizabeth,44,0,45,1
1746578096833,EDS 139,A00,897203,Pappas; Elizabeth,44,0,45,1
1746578096833,EDS 139,B00,897209,Fargason; Sharon Gayle,41,0,45,4
1746578097857,EDS 201,A00,895545,Staff,22,0,45,23
1746578098880,EDS 203,A01,895581,Halter; Christopher P.,22,0,45,23
1746578099907,EDS 204R,A01,895625,Heinzman; Erica M.,39,0,45,6
1746578099907,EDS 204R,B01,895693,Halter; Christopher P.,10,0,45,35
1746578100934,EDS 206R,A00,895694,Fargason; Sharon Gayle,1,0,30,29
1746578100934,EDS 206R,B00,895695,Choi; Bailey Miyeon,16,0,30,14
1746578101957,EDS 250,A00,895697,Hemans; Patricia Ann Benitez,22,0,45,23
1746578102986,EDS 281,A00,895701,Meyerott; Theresa Ann,1,0,15,14
1746578104011,EDS 284,A00,895736,Meyerott; Theresa Ann,1,0,15,14
1746578105036,EDS 286,A00,897210,Fine; Sarah,0,0,15,15
1746578106064,EDS 289C,A01,895770,Daly; Alan J.,1,0,15,14
1746578107091,EDS 290,A00,897211,Hofstetter; Carolyn,0,0,15,15
1746578108117,LIGM 5A,A00,896162,Fischer-Grunski; Eva K,12,0,20,8
1746578109146,LIGM 5B,A00,896260,Fischer-Grunski; Eva K,17,0,20,3
1746578110174,LIGM 5C,A00,896308,Fischer-Grunski; Eva K,18,0,20,2
1746578111199,LIIT 5AS,A00,896313,Carnelos; Chiara,18,0,20,2
1746578112225,LIIT 5BS,A00,896416,Carnelos; Chiara,20,0,20,0
1746578113249,LIIT 5CS,A00,896564,Carnelos; Chiara,20,0,20,0
1746578114279,LISP 5A,A00,896588,Munoz Sanchez; Alicia,2,0,20,18
1746578115305,LISP 5B,A00,896653,Munoz Sanchez; Alicia,7,0,20,13
1746578116335,LISP 5C,A00,896655,Munoz Sanchez; Alicia,0,1,20,20
1746578117364,MAE 197,001,957918,Kleissl; Jan,9996,0,9999,3
1746578117364,MAE 197,002,959806,Boechler; Nicholas Sebastia,9998,0,9999,1
1746578117364,MAE 197,003,959852,Mullin; Jennifer S,9998,0,9999,1
1746578118389,MATH 2,A01,957937,Staff,33,0,35,2
1746578119414,MATH 197,001,957876,Kedlaya; Kiran S.,9993,0,9999,6
1746578120443,MCWP 40,A00,892729,Duru; Nur,10,0,20,10
1746578120443,MCWP 40,B00,893304,Montejo; Carolina,14,0,20,6
1746578121468,MCWP 40R,A00,893757,Redela; Pamela Morgan,0,5,20,20
1746578122495,MCWP 50,A00,893758,Morshed; Michael James,0,0,20,20
1746578122495,MCWP 50,B00,893761,Bartulis; Jason Michael,17,0,20,3
1746578123522,MCWP 50R,A00,893766,Compas; Sean Matthew,0,1,20,20
1746578123522,MCWP 50R,B00,893769,Carter; Jennifer A,0,1,20,20
1746578123522,MCWP 50R,C00,893771,Krone; Jarret,0,3,20,20
1746578123522,MCWP 50R,D00,893772,Miller; Elizabeth Deen,0,0,20,20
1746578123522,MCWP 50R,E00,893775,Carter; Andrea L,0,1,20,20
1746578124547,MMW 11R,A01,892721,Herbst; Matthew,14,0,30,16
1746578124547,MMW 11R,A02,892722,Herbst; Matthew,0,0,0,3
1746578125576,MMW 12R,A01,892724,Herbst; Matthew,0,11,16,16
1746578125576,MMW 12R,A02,892725,Herbst; Matthew,0,10,16,16
1746578126605,MMW 13R,A01,892727,Staff,0,4,16,16
1746578126605,MMW 13R,A02,892728,Staff,0,4,16,16
1746578126605,MMW 13R,A03,958032,Staff,0,4,16,16
1746578126605,MMW 13R,A04,958033,Staff,0,4,16,16
1746578126605,MMW 13R,A05,958034,Staff,0,4,16,16
1746578127630,SIO 295LS,A00,894015,Staff,5,0,25,20
1746578128657,SIO 295S,A00,894020,Staff,5,0,25,20
1746578129721,SIOC 290S,B01,958918,Merrifield; Mark A,14,0,30,16
1746578130746,SIOC 291S,B01,958922,Gabriel; Corey John,14,0,30,16
1746578131775,SOCI 117,A01,895339,Staff,3,0,5,2
1746578132799,WES 237B,A00,894149,Staff,11,0,20,9
1746578134871,AESE 279B,A00,891859,Staff,13,0,35,22
1746578135895,AIP 197,001,891854,Vespa; Emanuel Ignacio,9999,0,9999,0
1746578136922,ANTH 289S,A00,891856,Gagneux; Pascal,12,0,12,0
1746578137945,BENG 196,001,957946,Engler; Adam J.,9996,0,9999,3
1746578138971,BISP 197,001,959851,Wilhelm; James E.,9998,0,9999,1
1746578139997,CAT 124RS,A01,956906,Staff,6,0,25,19
1746578141021,CAT 125RS,A01,922013,Staff,6,0,25,19
1746578142047,CLRE 250,A00,891860,Morris; Sheldon,9995,0,9999,4
1746578144101,CLRE 251R,A00,907817,Mehta; Ravindra L.,9994,0,9999,5
1746578145125,CLRE 252,A00,891864,Cuomo; Raphael Eduardo,9993,0,9999,6
1746578146154,CLRE 253,A00,891867,Vaida; Florin,9994,0,9999,5
1746578146154,CLRE 253,B00,907819,Staff,9999,0,9999,0
1746578147180,CLRE 259,A00,891868,Patel; Hemal,9998,0,9999,1
1746578148204,CLRE 260,A00,891872,Cuomo; Raphael Eduardo,9999,0,9999,0
1746578149233,CLRE 297,001,891888,Cuomo; Raphael Eduardo,9999,0,9999,0
1746578150257,CSE 191,A00,958773,Minnes Kemp; Mor Mia,9995,0,9999,4
1746578151284,CSE 197,001,959846,Minnes Kemp; Mor Mia,9990,0,9999,9
1746578152311,CSS 201S,A01,892054,Mignozzetti; Umberto,25,0,30,5
1746578153340,CSS 202S,A01,892056,Mignozzetti; Umberto,25,0,30,5
1746578154363,DSC 197,001,956898,Eldridge; Justin Matthew,9996,0,9999,3
1746578155388,DSC 297,001,958000,Mazumdar; Arya,9998,0,9999,1
1746578155388,DSC 297,002,959862,Wang; Yusu,9998,0,9999,1
1746578156415,EAP 100,A00,905686,Staff,9778,0,9999,221
1746578157445,ECE 45,A01,892618,Staff,0,0,65,65
1746578159499,ECE 111,A01,892719,Staff,6,0,65,59
1746578160536,ECE 197,001,957920,Mercier; Patrick Philip,9991,0,9999,8
1746578161565,ECON 178,A01,907814,Zhu; Ying,26,0,35,9
1746578162593,EDS 115,A00,895312,Staff,35,0,45,10
1746578163623,EDS 117,A01,895337,Staff,23,0,30,7
1746578164653,EDS 125,A00,895341,Jones; Gabrielle Anastasia,36,0,45,9
1746578165678,EDS 128A,A01,895459,Fargason; Sharon Gayle,44,0,45,1
1746578166708,EDS 128B,A01,895543,Pappas; Elizabeth,44,0,45,1
1746578167736,EDS 139,A00,897203,Pappas; Elizabeth,44,0,45,1
1746578167736,EDS 139,B00,897209,Fargason; Sharon Gayle,41,0,45,4
1746578168772,EDS 201,A00,895545,Staff,22,0,45,23
1746578169798,EDS 203,A01,895581,Halter; Christopher P.,22,0,45,23
1746578170833,EDS 204R,A01,895625,Heinzman; Erica M.,39,0,45,6
1746578170833,EDS 204R,B01,895693,Halter; Christopher P.,10,0,45,35
1746578171860,EDS 206R,A00,895694,Fargason; Sharon Gayle,1,0,30,29
1746578171860,EDS 206R,B00,895695,Choi; Bailey Miyeon,16,0,30,14
1746578172893,EDS 250,A00,895697,Hemans; Patricia Ann Benitez,22,0,45,23
1746578173917,EDS 281,A00,895701,Meyerott; Theresa Ann,1,0,15,14
1746578174944,EDS 284,A00,895736,Meyerott; Theresa Ann,1,0,15,14
1746578175971,EDS 286,A00,897210,Fine; Sarah,0,0,15,15
1746578176998,EDS 289C,A01,895770,Daly; Alan J.,1,0,15,14
1746578178024,EDS 290,A00,897211,Hofstetter; Carolyn,0,0,15,15
1746578179053,LIGM 5A,A00,896162,Fischer-Grunski; Eva K,12,0,20,8
1746578180079,LIGM 5B,A00,896260,Fischer-Grunski; Eva K,17,0,20,3
1746578181105,LIGM 5C,A00,896308,Fischer-Grunski; Eva K,18,0,20,2
1746578182135,LIIT 5AS,A00,896313,Carnelos; Chiara,18,0,20,2
1746578183160,LIIT 5BS,A00,896416,Carnelos; Chiara,20,0,20,0
1746578184186,LIIT 5CS,A00,896564,Carnelos; Chiara,20,0,20,0
1746578185215,LISP 5A,A00,896588,Munoz Sanchez; Alicia,2,0,20,18
1746578186242,LISP 5B,A00,896653,Munoz Sanchez; Alicia,7,0,20,13
1746578187269,LISP 5C,A00,896655,Munoz Sanchez; Alicia,0,1,20,20
1746578188295,MAE 197,001,957918,Kleissl; Jan,9996,0,9999,3
1746578188295,MAE 197,002,959806,Boechler; Nicholas Sebastia,9998,0,9999,1
1746578188295,MAE 197,003,959852,Mullin; Jennifer S,9998,0,9999,1
1746578189322,MATH 2,A01,957937,Staff,33,0,35,2
1746578190352,MATH 197,001,957876,Kedlaya; Kiran S.,9993,0,9999,6
1746578191377,MCWP 40,A00,892729,Duru; Nur,10,0,20,10
1746578191377,MCWP 40,B00,893304,Montejo; Carolina,14,0,20,6
1746578192410,MCWP 40R,A00,893757,Redela; Pamela Morgan,0,5,20,20
1746578193436,MCWP 50,A00,893758,Morshed; Michael James,0,0,20,20
1746578193436,MCWP 50,B00,893761,Bartulis; Jason Michael,17,0,20,3
1746578194463,MCWP 50R,A00,893766,Compas; Sean Matthew,0,1,20,20
1746578194463,MCWP 50R,B00,893769,Carter; Jennifer A,0,1,20,20
1746578194463,MCWP 50R,C00,893771,Krone; Jarret,0,3,20,20
1746578194463,MCWP 50R,D00,893772,Miller; Elizabeth Deen,0,0,20,20
1746578194463,MCWP 50R,E00,893775,Carter; Andrea L,0,1,20,20
1746578195488,MMW 11R,A01,892721,Herbst; Matthew,14,0,30,16
1746578195488,MMW 11R,A02,892722,Herbst; Matthew,0,0,0,3
1746578196513,MMW 12R,A01,892724,Herbst; Matthew,0,11,16,16
1746578196513,MMW 12R,A02,892725,Herbst; Matthew,0,10,16,16
1746578197538,MMW 13R,A01,892727,Staff,0,4,16,16
1746578197538,MMW 13R,A02,892728,Staff,0,4,16,16
1746578197538,MMW 13R,A03,958032,Staff,0,4,16,16
1746578197538,MMW 13R,A04,958033,Staff,0,4,16,16
1746578197538,MMW 13R,A05,958034,Staff,0,4,16,16
1746578198565,SIO 295LS,A00,894015,Staff,5,0,25,20
1746578199595,SIO 295S,A00,894020,Staff,5,0,25,20
1746578200622,SIOC 290S,B01,958918,Merrifield; Mark A,14,0,30,16
1746578201653,SIOC 291S,B01,958922,Gabriel; Corey John,14,0,30,16
1746578202679,SOCI 117,A01,895339,Staff,3,0,5,2
1746578203704,WES 237B,A00,894149,Staff,11,0,20,9
1746578205770,AESE 279B,A00,891859,Staff,13,0,35,22
1746578206799,AIP 197,001,891854,Vespa; Emanuel Ignacio,9999,0,9999,0
1746578207826,ANTH 289S,A00,891856,Gagneux; Pascal,12,0,12,0
1746578208850,BENG 196,001,957946,Engler; Adam J.,9996,0,9999,3
1746578209877,BISP 197,001,959851,Wilhelm; James E.,9998,0,9999,1
1746578210902,CAT 124RS,A01,956906,Staff,6,0,25,19
1746578211928,CAT 125RS,A01,922013,Staff,6,0,25,19
1746578212957,CLRE 250,A00,891860,Morris; Sheldon,9995,0,9999,4
1746578215009,CLRE 251R,A00,907817,Mehta; Ravindra L.,9994,0,9999,5
1746578216033,CLRE 252,A00,891864,Cuomo; Raphael Eduardo,9993,0,9999,6
1746578217059,CLRE 253,A00,891867,Vaida; Florin,9994,0,9999,5
1746578217059,CLRE 253,B00,907819,Staff,9999,0,9999,0
1746578218084,CLRE 259,A00,891868,Patel; Hemal,9998,0,9999,1
1746578219115,CLRE 260,A00,891872,Cuomo; Raphael Eduardo,9999,0,9999,0
1746578220146,CLRE 297,001,891888,Cuomo; Raphael Eduardo,9999,0,9999,0
1746578221174,CSE 191,A00,958773,Minnes Kemp; Mor Mia,9995,0,9999,4
1746578222201,CSE 197,001,959846,Minnes Kemp; Mor Mia,9990,0,9999,9
1746578223231,CSS 201S,A01,892054,Mignozzetti; Umberto,25,0,30,5
1746578224259,CSS 202S,A01,892056,Mignozzetti; Umberto,25,0,30,5
1746578225286,DSC 197,001,956898,Eldridge; Justin Matthew,9996,0,9999,3
1746578226313,DSC 297,001,958000,Mazumdar; Arya,9998,0,9999,1
1746578226313,DSC 297,002,959862,Wang; Yusu,9998,0,9999,1
1746578227342,EAP 100,A00,905686,Staff,9778,0,9999,221
1746578228371,ECE 45,A01,892618,Staff,0,0,65,65
1746578230420,ECE 111,A01,892719,Staff,6,0,65,59
1746578231448,ECE 197,001,957920,Mercier; Patrick Philip,9991,0,9999,8
1746578232478,ECON 178,A01,907814,Zhu; Ying,26,0,35,9
1746578233506,EDS 115,A00,895312,Staff,35,0,45,10
1746578234533,EDS 117,A01,895337,Staff,23,0,30,7
1746578235562,EDS 125,A00,895341,Jones; Gabrielle Anastasia,36,0,45,9
1746578236588,EDS 128A,A01,895459,Fargason; Sharon Gayle,44,0,45,1
1746578237614,EDS 128B,A01,895543,Pappas; Elizabeth,44,0,45,1
1746578238640,EDS 139,A00,897203,Pappas; Elizabeth,44,0,45,1
1746578238640,EDS 139,B00,897209,Fargason; Sharon Gayle,41,0,45,4
1746578239668,EDS 201,A00,895545,Staff,22,0,45,23
1746578240693,EDS 203,A01,895581,Halter; Christopher P.,22,0,45,23
1746578241721,EDS 204R,A01,895625,Heinzman; Erica M.,39,0,45,6
1746578241721,EDS 204R,B01,895693,Halter; Christopher P.,10,0,45,35
1746578242748,EDS 206R,A00,895694,Fargason; Sharon Gayle,1,0,30,29
1746578242748,EDS 206R,B00,895695,Choi; Bailey Miyeon,16,0,30,14
1746578243775,EDS 250,A00,895697,Hemans; Patricia Ann Benitez,22,0,45,23
1746578244798,EDS 281,A00,895701,Meyerott; Theresa Ann,1,0,15,14
1746578245825,EDS 284,A00,895736,Meyerott; Theresa Ann,1,0,15,14
1746578246850,EDS 286,A00,897210,Fine; Sarah,0,0,15,15
1746578247877,EDS 289C,A01,895770,Daly; Alan J.,1,0,15,14
1746578248901,EDS 290,A00,897211,Hofstetter; Carolyn,0,0,15,15
1746578249925,LIGM 5A,A00,896162,Fischer-Grunski; Eva K,12,0,20,8
1746578250954,LIGM 5B,A00,896260,Fischer-Grunski; Eva K,17,0,20,3
1746578251982,LIGM 5C,A00,896308,Fischer-Grunski; Eva K,18,0,20,2
1746578253008,LIIT 5AS,A00,896313,Carnelos; Chiara,18,0,20,2
1746578254035,LIIT 5BS,A00,896416,Carnelos; Chiara,20,0,20,0
1746578255097,LIIT 5CS,A00,896564,Carnelos; Chiara,20,0,20,0
1746578256122,LISP 5A,A00,896588,Munoz Sanchez; Alicia,2,0,20,18
1746578257148,LISP 5B,A00,896653,Munoz Sanchez; Alicia,7,0,20,13
1746578258173,LISP 5C,A00,896655,Munoz Sanchez; Alicia,0,1,20,20
1746578259202,MAE 197,001,957918,Kleissl; Jan,9996,0,9999,3
1746578259202,MAE 197,002,959806,Boechler; Nicholas Sebastia,9998,0,9999,1
1746578259202,MAE 197,003,959852,Mullin; Jennifer S,9998,0,9999,1
1746578260225,MATH 2,A01,957937,Staff,33,0,35,2
1746578261252,MATH 197,001,957876,Kedlaya; Kiran S.,9993,0,9999,6
1746578262276,MCWP 40,A00,892729,Duru; Nur,10,0,20,10
1746578262276,MCWP 40,B00,893304,Montejo; Carolina,14,0,20,6
1746578263301,MCWP 40R,A00,893757,Redela; Pamela Morgan,0,5,20,20
1746578264329,MCWP 50,A00,893758,Morshed; Michael James,0,0,20,20
1746578264329,MCWP 50,B00,893761,Bartulis; Jason Michael,17,0,20,3
1746578265355,MCWP 50R,A00,893766,Compas; Sean Matthew,0,1,20,20
1746578265355,MCWP 50R,B00,893769,Carter; Jennifer A,0,1,20,20
1746578265355,MCWP 50R,C00,893771,Krone; Jarret,0,3,20,20
1746578265355,MCWP 50R,D00,893772,Miller; Elizabeth Deen,0,0,20,20
1746578265355,MCWP 50R,E00,893775,Carter; Andrea L,0,1,20,20
1746578266380,MMW 11R,A01,892721,Herbst; Matthew,14,0,30,16
1746578266380,MMW 11R,A02,892722,Herbst; Matthew,0,0,0,3
1746578267408,MMW 12R,A01,892724,Herbst; Matthew,0,11,16,16
1746578267408,MMW 12R,A02,892725,Herbst; Matthew,0,10,16,16
1746578268433,MMW 13R,A01,892727,Staff,0,4,16,16
1746578268433,MMW 13R,A02,892728,Staff,0,4,16,16
1746578268433,MMW 13R,A03,958032,Staff,0,4,16,16
1746578268433,MMW 13R,A04,958033,Staff,0,4,16,16
1746578268433,MMW 13R,A05,958034,Staff,0,4,16,16
1746578269458,SIO 295LS,A00,894015,Staff,5,0,25,20
1746578270482,SIO 295S,A00,894020,Staff,5,0,25,20
1746578271507,SIOC 290S,B01,958918,Merrifield; Mark A,14,0,30,16
1746578272533,SIOC 291S,B01,958922,Gabriel; Corey John,14,0,30,16
1746578273561,SOCI 117,A01,895339,Staff,3,0,5,2
1746578274588,WES 237B,A00,894149,Staff,11,0,20,9
1746578276642,AESE 279B,A00,891859,Staff,13,0,35,22
1746578277667,AIP 197,001,891854,Vespa; Emanuel Ignacio,9999,0,9999,0
1746578278693,ANTH 289S,A00,891856,Gagneux; Pascal,12,0,12,0
1746578279718,BENG 196,001,957946,Engler; Adam J.,9996,0,9999,3
1746578280744,BISP 197,001,959851,Wilhelm; James E.,9998,0,9999,1
1746578281772,CAT 124RS,A01,956906,Staff,6,0,25,19
1746578282802,CAT 125RS,A01,922013,Staff,6,0,25,19
1746578283828,CLRE 250,A00,891860,Morris; Sheldon,9995,0,9999,4
1746578285883,CLRE 251R,A00,907817,Mehta; Ravindra L.,9994,0,9999,5
1746578286906,CLRE 252,A00,891864,Cuomo; Raphael Eduardo,9993,0,9999,6
1746578287931,CLRE 253,A00,891867,Vaida; Florin,9994,0,9999,5
1746578287931,CLRE 253,B00,907819,Staff,9999,0,9999,0
1746578288959,CLRE 259,A00,891868,Patel; Hemal,9998,0,9999,1
1746578290014,CLRE 260,A00,891872,Cuomo; Raphael Eduardo,9999,0,9999,0
1746578291038,CLRE 297,001,891888,Cuomo; Raphael Eduardo,9999,0,9999,0
1746578292063,CSE 191,A00,958773,Minnes Kemp; Mor Mia,9995,0,9999,4
1746578293089,CSE 197,001,959846,Minnes Kemp; Mor Mia,9990,0,9999,9
1746578294117,CSS 201S,A01,892054,Mignozzetti; Umberto,25,0,30,5
1746578295145,CSS 202S,A01,892056,Mignozzetti; Umberto,25,0,30,5
1746578296171,DSC 197,001,956898,Eldridge; Justin Matthew,9996,0,9999,3
1746578297199,DSC 297,001,958000,Mazumdar; Arya,9998,0,9999,1
1746578297199,DSC 297,002,959862,Wang; Yusu,9998,0,9999,1
1746578298224,EAP 100,A00,905686,Staff,9778,0,9999,221
1746578299250,ECE 45,A01,892618,Staff,0,0,65,65
1746578301302,ECE 111,A01,892719,Staff,6,0,65,59
1746578302329,ECE 197,001,957920,Mercier; Patrick Philip,9991,0,9999,8
1746578303353,ECON 178,A01,907814,Zhu; Ying,26,0,35,9
1746578304378,EDS 115,A00,895312,Staff,35,0,45,10
1746578305402,EDS 117,A01,895337,Staff,23,0,30,7
1746578306426,EDS 125,A00,895341,Jones; Gabrielle Anastasia,36,0,45,9
1746578307452,EDS 128A,A01,895459,Fargason; Sharon Gayle,44,0,45,1
1746578308490,EDS 128B,A01,895543,Pappas; Elizabeth,44,0,45,1
1746578309515,EDS 139,A00,897203,Pappas; Elizabeth,44,0,45,1
1746578309515,EDS 139,B00,897209,Fargason; Sharon Gayle,41,0,45,4
1746578310542,EDS 201,A00,895545,Staff,22,0,45,23
1746578311566,EDS 203,A01,895581,Halter; Christopher P.,22,0,45,23
1746578312594,EDS 204R,A01,895625,Heinzman; Erica M.,39,0,45,6
1746578312594,EDS 204R,B01,895693,Halter; Christopher P.,10,0,45,35
1746578313622,EDS 206R,A00,895694,Fargason; Sharon Gayle,1,0,30,29
1746578313622,EDS 206R,B00,895695,Choi; Bailey Miyeon,16,0,30,14
1746578314647,EDS 250,A00,895697,Hemans; Patricia Ann Benitez,22,0,45,23
1746578315673,EDS 281,A00,895701,Meyerott; Theresa Ann,1,0,15,14
1746578316700,EDS 284,A00,895736,Meyerott; Theresa Ann,1,0,15,14
1746578317726,EDS 286,A00,897210,Fine; Sarah,0,0,15,15
1746578318750,EDS 289C,A01,895770,Daly; Alan J.,1,0,15,14
1746578319774,EDS 290,A00,897211,Hofstetter; Carolyn,0,0,15,15
1746578320799,LIGM 5A,A00,896162,Fischer-Grunski; Eva K,12,0,20,8
1746578321829,LIGM 5B,A00,896260,Fischer-Grunski; Eva K,17,0,20,3
1746578322856,LIGM 5C,A00,896308,Fischer-Grunski; Eva K,18,0,20,2
1746578323883,LIIT 5AS,A00,896313,Carnelos; Chiara,18,0,20,2
1746578324908,LIIT 5BS,A00,896416,Carnelos; Chiara,20,0,20,0
1746578325934,LIIT 5CS,A00,896564,Carnelos; Chiara,20,0,20,0
1746578326963,LISP 5A,A00,896588,Munoz Sanchez; Alicia,2,0,20,18
1746578328042,LISP 5B,A00,896653,Munoz Sanchez; Alicia,7,0,20,13
1746578329069,LISP 5C,A00,896655,Munoz Sanchez; Alicia,0,1,20,20
1746578330095,MAE 197,001,957918,Kleissl; Jan,9996,0,9999,3
1746578330095,MAE 197,002,959806,Boechler; Nicholas Sebastia,9998,0,9999,1
1746578330095,MAE 197,003,959852,Mullin; Jennifer S,9998,0,9999,1
1746578331123,MATH 2,A01,957937,Staff,33,0,35,2
1746578332148,MATH 197,001,957876,Kedlaya; Kiran S.,9993,0,9999,6
1746578333171,MCWP 40,A00,892729,Duru; Nur,10,0,20,10
1746578333171,MCWP 40,B00,893304,Montejo; Carolina,14,0,20,6
1746578334196,MCWP 40R,A00,893757,Redela; Pamela Morgan,0,5,20,20
1746578335225,MCWP 50,A00,893758,Morshed; Michael James,0,0,20,20
1746578335225,MCWP 50,B00,893761,Bartulis; Jason Michael,17,0,20,3
1746578336250,MCWP 50R,A00,893766,Compas; Sean Matthew,0,1,20,20
1746578336250,MCWP 50R,B00,893769,Carter; Jennifer A,0,1,20,20
1746578336250,MCWP 50R,C00,893771,Krone; Jarret,0,3,20,20
1746578336250,MCWP 50R,D00,893772,Miller; Elizabeth Deen,0,0,20,20
1746578336250,MCWP 50R,E00,893775,Carter; Andrea L,0,1,20,20
1746578337275,MMW 11R,A01,892721,Herbst; Matthew,14,0,30,16
1746578337275,MMW 11R,A02,892722,Herbst; Matthew,0,0,0,3
1746578338300,MMW 12R,A01,892724,Herbst; Matthew,0,11,16,16
1746578338300,MMW 12R,A02,892725,Herbst; Matthew,0,10,16,16
1746578339326,MMW 13R,A01,892727,Staff,0,4,16,16
1746578339326,MMW 13R,A02,892728,Staff,0,4,16,16
1746578339326,MMW 13R,A03,958032,Staff,0,4,16,16
1746578339326,MMW 13R,A04,958033,Staff,0,4,16,16
1746578339326,MMW 13R,A05,958034,Staff,0,4,16,16
1746578340354,SIO 295LS,A00,894015,Staff,5,0,25,20
1746578341382,SIO 295S,A00,894020,Staff,5,0,25,20
1746578342418,SIOC 290S,B01,958918,Merrifield; Mark A,14,0,30,16
1746578343448,SIOC 291S,B01,958922,Gabriel; Corey John,14,0,30,16
1746578344477,SOCI 117,A01,895339,Staff,3,0,5,2
1746578345503,WES 237B,A00,894149,Staff,11,0,20,9
1746578347571,AESE 279B,A00,891859,Staff,13,0,35,22
1746578348596,AIP 197,001,891854,Vespa; Emanuel Ignacio,9999,0,9999,0
1746578349620,ANTH 289S,A00,891856,Gagneux; Pascal,12,0,12,0
1746578350648,BENG 196,001,957946,Engler; Adam J.,9996,0,9999,3
1746578351675,BISP 197,001,959851,Wilhelm; James E.,9998,0,9999,1
1746578352703,CAT 124RS,A01,956906,Staff,6,0,25,19
1746578353730,CAT 125RS,A01,922013,Staff,6,0,25,19
1746578354755,CLRE 250,A00,891860,Morris; Sheldon,9995,0,9999,4
1746578356810,CLRE 251R,A00,907817,Mehta; Ravindra L.,9994,0,9999,5
1746578357838,CLRE 252,A00,891864,Cuomo; Raphael Eduardo,9993,0,9999,6
1746578358865,CLRE 253,A00,891867,Vaida; Florin,9994,0,9999,5
1746578358865,CLRE 253,B00,907819,Staff,9999,0,9999,0
1746578359892,CLRE 259,A00,891868,Patel; Hemal,9998,0,9999,1
1746578360916,CLRE 260,A00,891872,Cuomo; Raphael Eduardo,9999,0,9999,0
1746578361941,CLRE 297,001,891888,Cuomo; Raphael Eduardo,9999,0,9999,0
1746578362965,CSE 191,A00,958773,Minnes Kemp; Mor Mia,9995,0,9999,4
1746578363993,CSE 197,001,959846,Minnes Kemp; Mor Mia,9990,0,9999,9
1746578365019,CSS 201S,A01,892054,Mignozzetti; Umberto,25,0,30,5
1746578366049,CSS 202S,A01,892056,Mignozzetti; Umberto,25,0,30,5
1746578367077,DSC 197,001,956898,Eldridge; Justin Matthew,9996,0,9999,3
1746578368100,DSC 297,001,958000,Mazumdar; Arya,9998,0,9999,1
1746578368100,DSC 297,002,959862,Wang; Yusu,9998,0,9999,1
1746578369124,EAP 100,A00,905686,Staff,9778,0,9999,221
1746578370149,ECE 45,A01,892618,Staff,0,0,65,65
1746578372203,ECE 111,A01,892719,Staff,6,0,65,59
1746578373228,ECE 197,001,957920,Mercier; Patrick Philip,9991,0,9999,8
1746578374257,ECON 178,A01,907814,Zhu; Ying,26,0,35,9
1746578375279,EDS 115,A00,895312,Staff,35,0,45,10
1746578376308,EDS 117,A01,895337,Staff,23,0,30,7
1746578377335,EDS 125,A00,895341,Jones; Gabrielle Anastasia,36,0,45,9
1746578378364,EDS 128A,A01,895459,Fargason; Sharon Gayle,44,0,45,1
1746578379393,EDS 128B,A01,895543,Pappas; Elizabeth,44,0,45,1
1746578380417,EDS 139,A00,897203,Pappas; Elizabeth,44,0,45,1
1746578380417,EDS 139,B00,897209,Fargason; Sharon Gayle,41,0,45,4
1746578381441,EDS 201,A00,895545,Staff,22,0,45,23
1746578382469,EDS 203,A01,895581,Halter; Christopher P.,22,0,45,23
1746578383495,EDS 204R,A01,895625,Heinzman; Erica M.,39,0,45,6
1746578383495,EDS 204R,B01,895693,Halter; Christopher P.,10,0,45,35
1746578384520,EDS 206R,A00,895694,Fargason; Sharon Gayle,1,0,30,29
1746578384520,EDS 206R,B00,895695,Choi; Bailey Miyeon,16,0,30,14
1746578385544,EDS 250,A00,895697,Hemans; Patricia Ann Benitez,22,0,45,23
1746578386573,EDS 281,A00,895701,Meyerott; Theresa Ann,1,0,15,14
1746578387603,EDS 284,A00,895736,Meyerott; Theresa Ann,1,0,15,14
1746578388629,EDS 286,A00,897210,Fine; Sarah,0,0,15,15
1746578389654,EDS 289C,A01,895770,Daly; Alan J.,1,0,15,14
1746578390681,EDS 290,A00,897211,Hofstetter; Carolyn,0,0,15,15
1746578391707,LIGM 5A,A00,896162,Fischer-Grunski; Eva K,12,0,20,8
1746578392735,LIGM 5B,A00,896260,Fischer-Grunski; Eva K,17,0,20,3
1746578393759,LIGM 5C,A00,896308,Fischer-Grunski; Eva K,18,0,20,2
1746578394785,LIIT 5AS,A00,896313,Carnelos; Chiara,18,0,20,2
1746578395812,LIIT 5BS,A00,896416,Carnelos; Chiara,20,0,20,0
1746578396841,LIIT 5CS,A00,896564,Carnelos; Chiara,20,0,20,0
1746578397865,LISP 5A,A00,896588,Munoz Sanchez; Alicia,2,0,20,18
1746578398890,LISP 5B,A00,896653,Munoz Sanchez; Alicia,7,0,20,13
1746578399916,LISP 5C,A00,896655,Munoz Sanchez; Alicia,0,1,20,20
1746578400940,MAE 197,001,957918,Kleissl; Jan,9996,0,9999,3
1746578400940,MAE 197,002,959806,Boechler; Nicholas Sebastia,9998,0,9999,1
1746578400940,MAE 197,003,959852,Mullin; Jennifer S,9998,0,9999,1
1746578401970,MATH 2,A01,957937,Staff,33,0,35,2
1746578402995,MATH 197,001,957876,Kedlaya; Kiran S.,9993,0,9999,6
1746578404025,MCWP 40,A00,892729,Duru; Nur,10,0,20,10
1746578404025,MCWP 40,B00,893304,Montejo; Carolina,14,0,20,6
1746578405054,MCWP 40R,A00,893757,Redela; Pamela Morgan,0,5,20,20
1746578406079,MCWP 50,A00,893758,Morshed; Michael James,0,0,20,20
1746578406079,MCWP 50,B00,893761,Bartulis; Jason Michael,17,0,20,3
1746578407105,MCWP 50R,A00,893766,Compas; Sean Matthew,0,1,20,20
1746578407105,MCWP 50R,B00,893769,Carter; Jennifer A,0,1,20,20
1746578407105,MCWP 50R,C00,893771,Krone; Jarret,0,3,20,20
1746578407105,MCWP 50R,D00,893772,Miller; Elizabeth Deen,0,0,20,20
1746578407105,MCWP 50R,E00,893775,Carter; Andrea L,0,1,20,20
1746578408131,MMW 11R,A01,892721,Herbst; Matthew,14,0,30,16
1746578408131,MMW 11R,A02,892722,Herbst; Matthew,0,0,0,3
1746578409158,MMW 12R,A01,892724,Herbst; Matthew,0,11,16,16
1746578409158,MMW 12R,A02,892725,Herbst; Matthew,0,10,16,16
1746578410187,MMW 13R,A01,892727,Staff,0,4,16,16
1746578410187,MMW 13R,A02,892728,Staff,0,4,16,16
1746578410187,MMW 13R,A03,958032,Staff,0,4,16,16
1746578410187,MMW 13R,A04,958033,Staff,0,4,16,16
1746578410187,MMW 13R,A05,958034,Staff,0,4,16,16
1746578411214,SIO 295LS,A00,894015,Staff,5,0,25,20
1746578412242,SIO 295S,A00,894020,Staff,5,0,25,20
1746578413267,SIOC 290S,B01,958918,Merrifield; Mark A,14,0,30,16
1746578414297,SIOC 291S,B01,958922,Gabriel; Corey John,14,0,30,16
1746578415326,SOCI 117,A01,895339,Staff,3,0,5,2
1746578416351,WES 237B,A00,894149,Staff,11,0,20,9
1746578418420,AESE 279B,A00,891859,Staff,13,0,35,22
1746578419445,AIP 197,001,891854,Vespa; Emanuel Ignacio,9999,0,9999,0
1746578420469,ANTH 289S,A00,891856,Gagneux; Pascal,12,0,12,0
1746578421496,BENG 196,001,957946,Engler; Adam J.,9996,0,9999,3
1746578422525,BISP 197,001,959851,Wilhelm; James E.,9998,0,9999,1
1746578423550,CAT 124RS,A01,956906,Staff,6,0,25,19
1746578424579,CAT 125RS,A01,922013,Staff,6,0,25,19
1746578425605,CLRE 250,A00,891860,Morris; Sheldon,9995,0,9999,4
1746578427658,CLRE 251R,A00,907817,Mehta; Ravindra L.,9994,0,9999,5
1746578428683,CLRE 252,A00,891864,Cuomo; Raphael Eduardo,9993,0,9999,6
1746578429708,CLRE 253,A00,891867,Vaida; Florin,9994,0,9999,5
1746578429708,CLRE 253,B00,907819,Staff,9999,0,9999,0
1746578430736,CLRE 259,A00,891868,Patel; Hemal,9998,0,9999,1
1746578431975,CLRE 260,A00,891872,Cuomo; Raphael Eduardo,9999,0,9999,0
1746578433006,CLRE 297,001,891888,Cuomo; Raphael Eduardo,9999,0,9999,0
1746578434030,CSE 191,A00,958773,Minnes Kemp; Mor Mia,9995,0,9999,4
1746578435056,CSE 197,001,959846,Minnes Kemp; Mor Mia,9990,0,9999,9
1746578436086,CSS 201S,A01,892054,Mignozzetti; Umberto,25,0,30,5
1746578437111,CSS 202S,A01,892056,Mignozzetti; Umberto,25,0,30,5
1746578438137,DSC 197,001,956898,Eldridge; Justin Matthew,9996,0,9999,3
1746578439163,DSC 297,001,958000,Mazumdar; Arya,9998,0,9999,1
1746578439163,DSC 297,002,959862,Wang; Yusu,9998,0,9999,1
1746578440191,EAP 100,A00,905686,Staff,9778,0,9999,221
1746578441224,ECE 45,A01,892618,Staff,0,0,65,65
1746578443277,ECE 111,A01,892719,Staff,6,0,65,59
1746578444304,ECE 197,001,957920,Mercier; Patrick Philip,9991,0,9999,8
1746578445334,ECON 178,A01,907814,Zhu; Ying,26,0,35,9
1746578446357,EDS 115,A00,895312,Staff,35,0,45,10
1746578447382,EDS 117,A01,895337,Staff,23,0,30,7
1746578448410,EDS 125,A00,895341,Jones; Gabrielle Anastasia,36,0,45,9
1746578449437,EDS 128A,A01,895459,Fargason; Sharon Gayle,44,0,45,1
1746578450462,EDS 128B,A01,895543,Pappas; Elizabeth,44,0,45,1
1746578451487,EDS 139,A00,897203,Pappas; Elizabeth,44,0,45,1
1746578451487,EDS 139,B00,897209,Fargason; Sharon Gayle,41,0,45,4
1746578452513,EDS 201,A00,895545,Staff,22,0,45,23
1746578453540,EDS 203,A01,895581,Halter; Christopher P.,22,0,45,23
1746578454565,EDS 204R,A01,895625,Heinzman; Erica M.,39,0,45,6
1746578454565,EDS 204R,B01,895693,Halter; Christopher P.,10,0,45,35
1746578455597,EDS 206R,A00,895694,Fargason; Sharon Gayle,1,0,30,29
1746578455597,EDS 206R,B00,895695,Choi; Bailey Miyeon,16,0,30,14
1746578456626,EDS 250,A00,895697,Hemans; Patricia Ann Benitez,22,0,45,23
1746578457672,EDS 281,A00,895701,Meyerott; Theresa Ann,1,0,15,14
1746578458695,EDS 284,A00,895736,Meyerott; Theresa Ann,1,0,15,14
1746578459722,EDS 286,A00,897210,Fine; Sarah,0,0,15,15
1746578460747,EDS 289C,A01,895770,Daly; Alan J.,1,0,15,14
1746578461772,EDS 290,A00,897211,Hofstetter; Carolyn,0,0,15,15
1746578462797,LIGM 5A,A00,896162,Fischer-Grunski; Eva K,12,0,20,8
1746578463824,LIGM 5B,A00,896260,Fischer-Grunski; Eva K,17,0,20,3
1746578464850,LIGM 5C,A00,896308,Fischer-Grunski; Eva K,18,0,20,2
1746578465881,LIIT 5AS,A00,896313,Carnelos; Chiara,18,0,20,2
1746578466910,LIIT 5BS,A00,896416,Carnelos; Chiara,20,0,20,0
1746578467935,LIIT 5CS,A00,896564,Carnelos; Chiara,20,0,20,0
1746578468963,LISP 5A,A00,896588,Munoz Sanchez; Alicia,2,0,20,18
1746578469992,LISP 5B,A00,896653,Munoz Sanchez; Alicia,7,0,20,13
1746578471017,LISP 5C,A00,896655,Munoz Sanchez; Alicia,0,1,20,20
1746578472039,MAE 197,001,957918,Kleissl; Jan,9996,0,9999,3
1746578472039,MAE 197,002,959806,Boechler; Nicholas Sebastia,9998,0,9999,1
1746578472039,MAE 197,003,959852,Mullin; Jennifer S,9998,0,9999,1
1746578473064,MATH 2,A01,957937,Staff,33,0,35,2
1746578474087,MATH 197,001,957876,Kedlaya; Kiran S.,9993,0,9999,6
1746578475113,MCWP 40,A00,892729,Duru; Nur,10,0,20,10
1746578475113,MCWP 40,B00,893304,Montejo; Carolina,14,0,20,6
1746578476139,MCWP 40R,A00,893757,Redela; Pamela Morgan,0,5,20,20
1746578477163,MCWP 50,A00,893758,Morshed; Michael James,0,0,20,20
1746578477163,MCWP 50,B00,893761,Bartulis; Jason Michael,17,0,20,3
1746578478196,MCWP 50R,A00,893766,Compas; Sean Matthew,0,1,20,20
1746578478196,MCWP 50R,B00,893769,Carter; Jennifer A,0,1,20,20
1746578478196,MCWP 50R,C00,893771,Krone; Jarret,0,3,20,20
1746578478196,MCWP 50R,D00,893772,Miller; Elizabeth Deen,0,0,20,20
1746578478196,MCWP 50R,E00,893775,Carter; Andrea L,0,1,20,20
1746578479221,MMW 11R,A01,892721,Herbst; Matthew,14,0,30,16
1746578479221,MMW 11R,A02,892722,Herbst; Matthew,0,0,0,3
1746578480250,MMW 12R,A01,892724,Herbst; Matthew,0,11,16,16
1746578480250,MMW 12R,A02,892725,Herbst; Matthew,0,10,16,16
1746578481276,MMW 13R,A01,892727,Staff,0,4,16,16
1746578481276,MMW 13R,A02,892728,Staff,0,4,16,16
1746578481276,MMW 13R,A03,958032,Staff,0,4,16,16
1746578481276,MMW 13R,A04,958033,Staff,0,4,16,16
1746578481276,MMW 13R,A05,958034,Staff,0,4,16,16
1746578482305,SIO 295LS,A00,894015,Staff,5,0,25,20
1746578483333,SIO 295S,A00,894020,Staff,5,0,25,20
1746578484364,SIOC 290S,B01,958918,Merrifield; Mark A,14,0,30,16
1746578485391,SIOC 291S,B01,958922,Gabriel; Corey John,14,0,30,16
1746578486415,SOCI 117,A01,895339,Staff,3,0,5,2
1746578487441,WES 237B,A00,894149,Staff,11,0,20,9
1746578489498,AESE 279B,A00,891859,Staff,13,0,35,22
1746578490524,AIP 197,001,891854,Vespa; Emanuel Ignacio,9999,0,9999,0
1746578491547,ANTH 289S,A00,891856,Gagneux; Pascal,12,0,12,0
1746578492572,BENG 196,001,957946,Engler; Adam J.,9996,0,9999,3
1746578493600,BISP 197,001,959851,Wilhelm; James E.,9998,0,9999,1
1746578494623,CAT 124RS,A01,956906,Staff,6,0,25,19
1746578495646,CAT 125RS,A01,922013,Staff,6,0,25,19
1746578496674,CLRE 250,A00,891860,Morris; Sheldon,9995,0,9999,4
1746578498731,CLRE 251R,A00,907817,Mehta; Ravindra L.,9994,0,9999,5
1746578499761,CLRE 252,A00,891864,Cuomo; Raphael Eduardo,9993,0,9999,6
1746578500790,CLRE 253,A00,891867,Vaida; Florin,9994,0,9999,5
1746578500790,CLRE 253,B00,907819,Staff,9999,0,9999,0
1746578501819,CLRE 259,A00,891868,Patel; Hemal,9998,0,9999,1
1746578502848,CLRE 260,A00,891872,Cuomo; Raphael Eduardo,9999,0,9999,0
1746578503875,CLRE 297,001,891888,Cuomo; Raphael Eduardo,9999,0,9999,0
1746578504903,CSE 191,A00,958773,Minnes Kemp; Mor Mia,9995,0,9999,4
1746578505928,CSE 197,001,959846,Minnes Kemp; Mor Mia,9990,0,9999,9
1746578506964,CSS 201S,A01,892054,Mignozzetti; Umberto,25,0,30,5
1746578507993,CSS 202S,A01,892056,Mignozzetti; Umberto,25,0,30,5
1746578509021,DSC 197,001,956898,Eldridge; Justin Matthew,9996,0,9999,3
1746578510047,DSC 297,001,958000,Mazumdar; Arya,9998,0,9999,1
1746578510047,DSC 297,002,959862,Wang; Yusu,9998,0,9999,1
1746578511074,EAP 100,A00,905686,Staff,9778,0,9999,221
1746578512118,ECE 45,A01,892618,Staff,0,0,65,65
1746578514167,ECE 111,A01,892719,Staff,6,0,65,59
1746578515192,ECE 197,001,957920,Mercier; Patrick Philip,9991,0,9999,8
1746578516220,ECON 178,A01,907814,Zhu; Ying,26,0,35,9
1746578517247,EDS 115,A00,895312,Staff,35,0,45,10
1746578518271,EDS 117,A01,895337,Staff,23,0,30,7
1746578519299,EDS 125,A00,895341,Jones; Gabrielle Anastasia,36,0,45,9
1746578520326,EDS 128A,A01,895459,Fargason; Sharon Gayle,44,0,45,1
1746578521352,EDS 128B,A01,895543,Pappas; Elizabeth,44,0,45,1
1746578522381,EDS 139,A00,897203,Pappas; Elizabeth,44,0,45,1
1746578522381,EDS 139,B00,897209,Fargason; Sharon Gayle,41,0,45,4
1746578523408,EDS 201,A00,895545,Staff,22,0,45,23
1746578524434,EDS 203,A01,895581,Halter; Christopher P.,22,0,45,23
1746578525458,EDS 204R,A01,895625,Heinzman; Erica M.,39,0,45,6
1746578525458,EDS 204R,B01,895693,Halter; Christopher P.,10,0,45,35
1746578526482,EDS 206R,A00,895694,Fargason; Sharon Gayle,1,0,30,29
1746578526482,EDS 206R,B00,895695,Choi; Bailey Miyeon,16,0,30,14
1746578527509,EDS 250,A00,895697,Hemans; Patricia Ann Benitez,22,0,45,23
1746578528537,EDS 281,A00,895701,Meyerott; Theresa Ann,1,0,15,14
1746578529568,EDS 284,A00,895736,Meyerott; Theresa Ann,1,0,15,14
1746578530604,EDS 286,A00,897210,Fine; Sarah,0,0,15,15
1746578531633,EDS 289C,A01,895770,Daly; Alan J.,1,0,15,14
1746578532657,EDS 290,A00,897211,Hofstetter; Carolyn,0,0,15,15
1746578533681,LIGM 5A,A00,896162,Fischer-Grunski; Eva K,12,0,20,8
1746578534706,LIGM 5B,A00,896260,Fischer-Grunski; Eva K,17,0,20,3
1746578535732,LIGM 5C,A00,896308,Fischer-Grunski; Eva K,18,0,20,2
1746578536756,LIIT 5AS,A00,896313,Carnelos; Chiara,18,0,20,2
1746578537784,LIIT 5BS,A00,896416,Carnelos; Chiara,20,0,20,0
1746578538810,LIIT 5CS,A00,896564,Carnelos; Chiara,20,0,20,0
1746578539835,LISP 5A,A00,896588,Munoz Sanchez; Alicia,2,0,20,18
1746578540860,LISP 5B,A00,896653,Munoz Sanchez; Alicia,7,0,20,13
1746578541884,LISP 5C,A00,896655,Munoz Sanchez; Alicia,0,1,20,20
1746578542911,MAE 197,001,957918,Kleissl; Jan,9996,0,9999,3
1746578542911,MAE 197,002,959806,Boechler; Nicholas Sebastia,9998,0,9999,1
1746578542911,MAE 197,003,959852,Mullin; Jennifer S,9998,0,9999,1
1746578543937,MATH 2,A01,957937,Staff,33,0,35,2
1746578544961,MATH 197,001,957876,Kedlaya; Kiran S.,9993,0,9999,6
1746578545987,MCWP 40,A00,892729,Duru; Nur,10,0,20,10
1746578545987,MCWP 40,B00,893304,Montejo; Carolina,14,0,20,6
1746578547012,MCWP 40R,A00,893757,Redela; Pamela Morgan,0,5,20,20
1746578548038,MCWP 50,A00,893758,Morshed; Michael James,0,0,20,20
1746578548038,MCWP 50,B00,893761,Bartulis; Jason Michael,17,0,20,3
1746578549063,MCWP 50R,A00,893766,Compas; Sean Matthew,0,1,20,20
1746578549063,MCWP 50R,B00,893769,Carter; Jennifer A,0,1,20,20
1746578549063,MCWP 50R,C00,893771,Krone; Jarret,0,3,20,20
1746578549063,MCWP 50R,D00,893772,Miller; Elizabeth Deen,0,0,20,20
1746578549063,MCWP 50R,E00,893775,Carter; Andrea L,0,1,20,20
1746578550093,MMW 11R,A01,892721,Herbst; Matthew,14,0,30,16
1746578550093,MMW 11R,A02,892722,Herbst; Matthew,0,0,0,3
1746578551120,MMW 12R,A01,892724,Herbst; Matthew,0,11,16,16
1746578551120,MMW 12R,A02,892725,Herbst; Matthew,0,10,16,16
1746578552147,MMW 13R,A01,892727,Staff,0,4,16,16
1746578552147,MMW 13R,A02,892728,Staff,0,4,16,16
1746578552147,MMW 13R,A03,958032,Staff,0,4,16,16
1746578552147,MMW 13R,A04,958033,Staff,0,4,16,16
1746578552147,MMW 13R,A05,958034,Staff,0,4,16,16
1746578553176,SIO 295LS,A00,894015,Staff,5,0,25,20
1746578554204,SIO 295S,A00,894020,Staff,5,0,25,20
1746578555230,SIOC 290S,B01,958918,Merrifield; Mark A,14,0,30,16
1746578556262,SIOC 291S,B01,958922,Gabriel; Corey John,14,0,30,16
1746578557289,SOCI 117,A01,895339,Staff,3,0,5,2
1746578558315,WES 237B,A00,894149,Staff,11,0,20,9
1746578560397,AESE 279B,A00,891859,Staff,13,0,35,22
1746578561423,AIP 197,001,891854,Vespa; Emanuel Ignacio,9999,0,9999,0
1746578562451,ANTH 289S,A00,891856,Gagneux; Pascal,12,0,12,0
1746578563474,BENG 196,001,957946,Engler; Adam J.,9996,0,9999,3
1746578564500,BISP 197,001,959851,Wilhelm; James E.,9998,0,9999,1
1746578565525,CAT 124RS,A01,956906,Staff,6,0,25,19
1746578566610,CAT 125RS,A01,922013,Staff,6,0,25,19
1746578567635,CLRE 250,A00,891860,Morris; Sheldon,9995,0,9999,4
1746578569691,CLRE 251R,A00,907817,Mehta; Ravindra L.,9994,0,9999,5
1746578570716,CLRE 252,A00,891864,Cuomo; Raphael Eduardo,9993,0,9999,6
1746578571744,CLRE 253,A00,891867,Vaida; Florin,9994,0,9999,5
1746578571744,CLRE 253,B00,907819,Staff,9999,0,9999,0
1746578572773,CLRE 259,A00,891868,Patel; Hemal,9998,0,9999,1
1746578573798,CLRE 260,A00,891872,Cuomo; Raphael Eduardo,9999,0,9999,0
1746578574826,CLRE 297,001,891888,Cuomo; Raphael Eduardo,9999,0,9999,0
1746578575850,CSE 191,A00,958773,Minnes Kemp; Mor Mia,9995,0,9999,4
1746578576874,CSE 197,001,959846,Minnes Kemp; Mor Mia,9990,0,9999,9
1746578577899,CSS 201S,A01,892054,Mignozzetti; Umberto,25,0,30,5
1746578578923,CSS 202S,A01,892056,Mignozzetti; Umberto,25,0,30,5
1746578579950,DSC 197,001,956898,Eldridge; Justin Matthew,9996,0,9999,3
1746578580976,DSC 297,001,958000,Mazumdar; Arya,9998,0,9999,1
1746578580976,DSC 297,002,959862,Wang; Yusu,9998,0,9999,1
1746578582002,EAP 100,A00,905686,Staff,9778,0,9999,221
1746578583028,ECE 45,A01,892618,Staff,0,0,65,65
1746578585082,ECE 111,A01,892719,Staff,6,0,65,59
1746578586107,ECE 197,001,957920,Mercier; Patrick Philip,9991,0,9999,8
1746578587131,ECON 178,A01,907814,Zhu; Ying,26,0,35,9
1746578588157,EDS 115,A00,895312,Staff,35,0,45,10
1746578589183,EDS 117,A01,895337,Staff,23,0,30,7
1746578590208,EDS 125,A00,895341,Jones; Gabrielle Anastasia,36,0,45,9
1746578591232,EDS 128A,A01,895459,Fargason; Sharon Gayle,44,0,45,1
1746578592257,EDS 128B,A01,895543,Pappas; Elizabeth,44,0,45,1
1746578593282,EDS 139,A00,897203,Pappas; Elizabeth,44,0,45,1
1746578593282,EDS 139,B00,897209,Fargason; Sharon Gayle,41,0,45,4
1746578594307,EDS 201,A00,895545,Staff,22,0,45,23
1746578595336,EDS 203,A01,895581,Halter; Christopher P.,22,0,45,23
1746578596360,EDS 204R,A01,895625,Heinzman; Erica M.,39,0,45,6
1746578596360,EDS 204R,B01,895693,Halter; Christopher P.,10,0,45,35
1746578597387,EDS 206R,A00,895694,Fargason; Sharon Gayle,1,0,30,29
1746578597387,EDS 206R,B00,895695,Choi; Bailey Miyeon,16,0,30,14
1746578598410,EDS 250,A00,895697,Hemans; Patricia Ann Benitez,22,0,45,23
1746578599438,EDS 281,A00,895701,Meyerott; Theresa Ann,1,0,15,14
1746578600464,EDS 284,A00,895736,Meyerott; Theresa Ann,1,0,15,14
1746578601493,EDS 286,A00,897210,Fine; Sarah,0,0,15,15
1746578602519,EDS 289C,A01,895770,Daly; Alan J.,1,0,15,14
1746578603545,EDS 290,A00,897211,Hofstetter; Carolyn,0,0,15,15
1746578604575,LIGM 5A,A00,896162,Fischer-Grunski; Eva K,12,0,20,8
1746578605605,LIGM 5B,A00,896260,Fischer-Grunski; Eva K,17,0,20,3
1746578606633,LIGM 5C,A00,896308,Fischer-Grunski; Eva K,18,0,20,2
1746578607663,LIIT 5AS,A00,896313,Carnelos; Chiara,18,0,20,2
1746578608687,LIIT 5BS,A00,896416,Carnelos; Chiara,20,0,20,0
1746578609715,LIIT 5CS,A00,896564,Carnelos; Chiara,20,0,20,0
1746578610745,LISP 5A,A00,896588,Munoz Sanchez; Alicia,2,0,20,18
1746578611775,LISP 5B,A00,896653,Munoz Sanchez; Alicia,7,0,20,13
1746578612800,LISP 5C,A00,896655,Munoz Sanchez; Alicia,0,1,20,20
1746578613823,MAE 197,001,957918,Kleissl; Jan,9996,0,9999,3
1746578613823,MAE 197,002,959806,Boechler; Nicholas Sebastia,9998,0,9999,1
1746578613823,MAE 197,003,959852,Mullin; Jennifer S,9998,0,9999,1
1746578614852,MATH 2,A01,957937,Staff,33,0,35,2
1746578615876,MATH 197,001,957876,Kedlaya; Kiran S.,9993,0,9999,6
1746578616900,MCWP 40,A00,892729,Duru; Nur,10,0,20,10
1746578616900,MCWP 40,B00,893304,Montejo; Carolina,14,0,20,6
1746578617925,MCWP 40R,A00,893757,Redela; Pamela Morgan,0,5,20,20
1746578618950,MCWP 50,A00,893758,Morshed; Michael James,0,0,20,20
1746578618950,MCWP 50,B00,893761,Bartulis; Jason Michael,17,0,20,3
1746578619975,MCWP 50R,A00,893766,Compas; Sean Matthew,0,1,20,20
1746578619975,MCWP 50R,B00,893769,Carter; Jennifer A,0,1,20,20
1746578619975,MCWP 50R,C00,893771,Krone; Jarret,0,3,20,20
1746578619975,MCWP 50R,D00,893772,Miller; Elizabeth Deen,0,0,20,20
1746578619975,MCWP 50R,E00,893775,Carter; Andrea L,0,1,20,20
1746578621005,MMW 11R,A01,892721,Herbst; Matthew,14,0,30,16
1746578621005,MMW 11R,A02,892722,Herbst; Matthew,0,0,0,3
1746578622029,MMW 12R,A01,892724,Herbst; Matthew,0,11,16,16
1746578622029,MMW 12R,A02,892725,Herbst; Matthew,0,10,16,16
1746578623054,MMW 13R,A01,892727,Staff,0,4,16,16
1746578623054,MMW 13R,A02,892728,Staff,0,4,16,16
1746578623054,MMW 13R,A03,958032,Staff,0,4,16,16
1746578623054,MMW 13R,A04,958033,Staff,0,4,16,16
1746578623054,MMW 13R,A05,958034,Staff,0,4,16,16
1746578624077,SIO 295LS,A00,894015,Staff,5,0,25,20
1746578625103,SIO 295S,A00,894020,Staff,5,0,25,20
1746578626133,SIOC 290S,B01,958918,Merrifield; Mark A,14,0,30,16
1746578627158,SIOC 291S,B01,958922,Gabriel; Corey John,14,0,30,16
1746578628184,SOCI 117,A01,895339,Staff,3,0,5,2
1746578629208,WES 237B,A00,894149,Staff,11,0,20,9
1746578631268,AESE 279B,A00,891859,Staff,13,0,35,22
1746578632297,AIP 197,001,891854,Vespa; Emanuel Ignacio,9999,0,9999,0
1746578633321,ANTH 289S,A00,891856,Gagneux; Pascal,12,0,12,0
1746578634349,BENG 196,001,957946,Engler; Adam J.,9996,0,9999,3
1746578635375,BISP 197,001,959851,Wilhelm; James E.,9998,0,9999,1
1746578636401,CAT 124RS,A01,956906,Staff,6,0,25,19
1746578637429,CAT 125RS,A01,922013,Staff,6,0,25,19
1746578638457,CLRE 250,A00,891860,Morris; Sheldon,9995,0,9999,4
1746578640508,CLRE 251R,A00,907817,Mehta; Ravindra L.,9994,0,9999,5
1746578641535,CLRE 252,A00,891864,Cuomo; Raphael Eduardo,9993,0,9999,6
1746578642566,CLRE 253,A00,891867,Vaida; Florin,9994,0,9999,5
1746578642566,CLRE 253,B00,907819,Staff,9999,0,9999,0
1746578643611,CLRE 259,A00,891868,Patel; Hemal,9998,0,9999,1
1746578644636,CLRE 260,A00,891872,Cuomo; Raphael Eduardo,9999,0,9999,0
1746578645659,CLRE 297,001,891888,Cuomo; Raphael Eduardo,9999,0,9999,0
1746578646687,CSE 191,A00,958773,Minnes Kemp; Mor Mia,9995,0,9999,4
1746578647712,CSE 197,001,959846,Minnes Kemp; Mor Mia,9990,0,9999,9
1746578648744,CSS 201S,A01,892054,Mignozzetti; Umberto,25,0,30,5
1746578649776,CSS 202S,A01,892056,Mignozzetti; Umberto,25,0,30,5
1746578650804,DSC 197,001,956898,Eldridge; Justin Matthew,9996,0,9999,3
1746578651829,DSC 297,001,958000,Mazumdar; Arya,9998,0,9999,1
1746578651829,DSC 297,002,959862,Wang; Yusu,9998,0,9999,1
1746578652853,EAP 100,A00,905686,Staff,9778,0,9999,221
1746578653877,ECE 45,A01,892618,Staff,0,0,65,65
1746578655929,ECE 111,A01,892719,Staff,6,0,65,59
1746578656958,ECE 197,001,957920,Mercier; Patrick Philip,9991,0,9999,8
1746578657983,ECON 178,A01,907814,Zhu; Ying,26,0,35,9
1746578659013,EDS 115,A00,895312,Staff,35,0,45,10
1746578660039,EDS 117,A01,895337,Staff,23,0,30,7
1746578661064,EDS 125,A00,895341,Jones; Gabrielle Anastasia,36,0,45,9
1746578662090,EDS 128A,A01,895459,Fargason; Sharon Gayle,44,0,45,1
1746578663124,EDS 128B,A01,895543,Pappas; Elizabeth,44,0,45,1
1746578664152,EDS 139,A00,897203,Pappas; Elizabeth,44,0,45,1
1746578664152,EDS 139,B00,897209,Fargason; Sharon Gayle,41,0,45,4
1746578665177,EDS 201,A00,895545,Staff,22,0,45,23
1746578666201,EDS 203,A01,895581,Halter; Christopher P.,22,0,45,23
1746578667229,EDS 204R,A01,895625,Heinzman; Erica M.,39,0,45,6
1746578667229,EDS 204R,B01,895693,Halter; Christopher P.,10,0,45,35
1746578668256,EDS 206R,A00,895694,Fargason; Sharon Gayle,1,0,30,29
1746578668256,EDS 206R,B00,895695,Choi; Bailey Miyeon,16,0,30,14
1746578669281,EDS 250,A00,895697,Hemans; Patricia Ann Benitez,22,0,45,23
1746578670311,EDS 281,A00,895701,Meyerott; Theresa Ann,1,0,15,14
1746578671336,EDS 284,A00,895736,Meyerott; Theresa Ann,1,0,15,14
1746578672363,EDS 286,A00,897210,Fine; Sarah,0,0,15,15
1746578673388,EDS 289C,A01,895770,Daly; Alan J.,1,0,15,14
1746578674411,EDS 290,A00,897211,Hofstetter; Carolyn,0,0,15,15
1746578675437,LIGM 5A,A00,896162,Fischer-Grunski; Eva K,12,0,20,8
1746578676466,LIGM 5B,A00,896260,Fischer-Grunski; Eva K,17,0,20,3
1746578677489,LIGM 5C,A00,896308,Fischer-Grunski; Eva K,18,0,20,2
1746578678517,LIIT 5AS,A00,896313,Carnelos; Chiara,18,0,20,2
1746578690617,LIIT 5BS,A00,896416,Carnelos; Chiara,20,0,20,0
1746578691641,LIIT 5CS,A00,896564,Carnelos; Chiara,20,0,20,0
1746578692671,LISP 5A,A00,896588,Munoz Sanchez; Alicia,2,0,20,18
1746578693699,LISP 5B,A00,896653,Munoz Sanchez; Alicia,7,0,20,13
1746578694727,LISP 5C,A00,896655,Munoz Sanchez; Alicia,0,1,20,20
1746578695751,MAE 197,001,957918,Kleissl; Jan,9996,0,9999,3
1746578695751,MAE 197,002,959806,Boechler; Nicholas Sebastia,9998,0,9999,1
1746578695751,MAE 197,003,959852,Mullin; Jennifer S,9998,0,9999,1
1746578696779,MATH 2,A01,957937,Staff,33,0,35,2
1746578697807,MATH 197,001,957876,Kedlaya; Kiran S.,9993,0,9999,6
1746578698833,MCWP 40,A00,892729,Duru; Nur,10,0,20,10
1746578698833,MCWP 40,B00,893304,Montejo; Carolina,14,0,20,6
1746578699858,MCWP 40R,A00,893757,Redela; Pamela Morgan,0,5,20,20
1746578700887,MCWP 50,A00,893758,Morshed; Michael James,0,0,20,20
1746578700887,MCWP 50,B00,893761,Bartulis; Jason Michael,17,0,20,3
1746578701914,MCWP 50R,A00,893766,Compas; Sean Matthew,0,1,20,20
1746578701914,MCWP 50R,B00,893769,Carter; Jennifer A,0,1,20,20
1746578701914,MCWP 50R,C00,893771,Krone; Jarret,0,3,20,20
1746578701914,MCWP 50R,D00,893772,Miller; Elizabeth Deen,0,0,20,20
1746578701914,MCWP 50R,E00,893775,Carter; Andrea L,0,1,20,20
1746578702942,MMW 11R,A01,892721,Herbst; Matthew,14,0,30,16
1746578702942,MMW 11R,A02,892722,Herbst; Matthew,0,0,0,3
1746578703971,MMW 12R,A01,892724,Herbst; Matthew,0,11,16,16
1746578703971,MMW 12R,A02,892725,Herbst; Matthew,0,10,16,16
1746578704998,MMW 13R,A01,892727,Staff,0,4,16,16
1746578704998,MMW 13R,A02,892728,Staff,0,4,16,16
1746578704998,MMW 13R,A03,958032,Staff,0,4,16,16
1746578704998,MMW 13R,A04,958033,Staff,0,4,16,16
1746578704998,MMW 13R,A05,958034,Staff,0,4,16,16
1746578706026,SIO 295LS,A00,894015,Staff,5,0,25,20
1746578707051,SIO 295S,A00,894020,Staff,5,0,25,20
1746578708076,SIOC 290S,B01,958918,Merrifield; Mark A,14,0,30,16
1746578709103,SIOC 291S,B01,958922,Gabriel; Corey John,14,0,30,16
1746578710129,SOCI 117,A01,895339,Staff,3,0,5,2
1746578711155,WES 237B,A00,894149,Staff,11,0,20,9
1746578713215,AESE 279B,A00,891859,Staff,13,0,35,22
1746578714238,AIP 197,001,891854,Vespa; Emanuel Ignacio,9999,0,9999,0
1746578715266,ANTH 289S,A00,891856,Gagneux; Pascal,12,0,12,0
1746578716291,BENG 196,001,957946,Engler; Adam J.,9996,0,9999,3
1746578717317,BISP 197,001,959851,Wilhelm; James E.,9998,0,9999,1
1746578718345,CAT 124RS,A01,956906,Staff,6,0,25,19
1746578719373,CAT 125RS,A01,922013,Staff,6,0,25,19
1746578720397,CLRE 250,A00,891860,Morris; Sheldon,9995,0,9999,4
1746578722446,CLRE 251R,A00,907817,Mehta; Ravindra L.,9994,0,9999,5
1746578723476,CLRE 252,A00,891864,Cuomo; Raphael Eduardo,9993,0,9999,6
1746578724502,CLRE 253,A00,891867,Vaida; Florin,9994,0,9999,5
1746578724502,CLRE 253,B00,907819,Staff,9999,0,9999,0
1746578725531,CLRE 259,A00,891868,Patel; Hemal,9998,0,9999,1
1746578726556,CLRE 260,A00,891872,Cuomo; Raphael Eduardo,9999,0,9999,0
1746578727581,CLRE 297,001,891888,Cuomo; Raphael Eduardo,9999,0,9999,0
1746578728605,CSE 191,A00,958773,Minnes Kemp; Mor Mia,9995,0,9999,4
1746578729635,CSE 197,001,959846,Minnes Kemp; Mor Mia,9990,0,9999,9
1746578730665,CSS 201S,A01,892054,Mignozzetti; Umberto,25,0,30,5
1746578731691,CSS 202S,A01,892056,Mignozzetti; Umberto,25,0,30,5
1746578732718,DSC 197,001,956898,Eldridge; Justin Matthew,9996,0,9999,3
1746578733743,DSC 297,001,958000,Mazumdar; Arya,9998,0,9999,1
1746578733743,DSC 297,002,959862,Wang; Yusu,9998,0,9999,1
1746578734767,EAP 100,A00,905686,Staff,9778,0,9999,221
1746578735791,ECE 45,A01,892618,Staff,0,0,65,65
1746578737841,ECE 111,A01,892719,Staff,6,0,65,59
1746578738866,ECE 197,001,957920,Mercier; Patrick Philip,9991,0,9999,8
1746578739891,ECON 178,A01,907814,Zhu; Ying,26,0,35,9
1746578740915,EDS 115,A00,895312,Staff,35,0,45,10
1746578741940,EDS 117,A01,895337,Staff,23,0,30,7
1746578742966,EDS 125,A00,895341,Jones; Gabrielle Anastasia,36,0,45,9
1746578743996,EDS 128A,A01,895459,Fargason; Sharon Gayle,44,0,45,1
1746578745024,EDS 128B,A01,895543,Pappas; Elizabeth,44,0,45,1
1746578746052,EDS 139,A00,897203,Pappas; Elizabeth,44,0,45,1
1746578746052,EDS 139,B00,897209,Fargason; Sharon Gayle,41,0,45,4
1746578747076,EDS 201,A00,895545,Staff,22,0,45,23
1746578748100,EDS 203,A01,895581,Halter; Christopher P.,22,0,45,23
1746578749124,EDS 204R,A01,895625,Heinzman; Erica M.,39,0,45,6
1746578749124,EDS 204R,B01,895693,Halter; Christopher P.,10,0,45,35
1746578750150,EDS 206R,A00,895694,Fargason; Sharon Gayle,1,0,30,29
1746578750150,EDS 206R,B00,895695,Choi; Bailey Miyeon,16,0,30,14
1746578751180,EDS 250,A00,895697,Hemans; Patricia Ann Benitez,22,0,45,23
1746578752208,EDS 281,A00,895701,Meyerott; Theresa Ann,1,0,15,14
1746578753237,EDS 284,A00,895736,Meyerott; Theresa Ann,1,0,15,14
1746578754262,EDS 286,A00,897210,Fine; Sarah,0,0,15,15
1746578755291,EDS 289C,A01,895770,Daly; Alan J.,1,0,15,14
1746578756317,EDS 290,A00,897211,Hofstetter; Carolyn,0,0,15,15
1746578757345,LIGM 5A,A00,896162,Fischer-Grunski; Eva K,12,0,20,8
1746578758374,LIGM 5B,A00,896260,Fischer-Grunski; Eva K,17,0,20,3
1746578759398,LIGM 5C,A00,896308,Fischer-Grunski; Eva K,18,0,20,2
1746578760428,LIIT 5AS,A00,896313,Carnelos; Chiara,18,0,20,2
1746578761453,LIIT 5BS,A00,896416,Carnelos; Chiara,20,0,20,0
1746578762483,LIIT 5CS,A00,896564,Carnelos; Chiara,20,0,20,0
1746578763508,LISP 5A,A00,896588,Munoz Sanchez; Alicia,2,0,20,18
1746578764539,LISP 5B,A00,896653,Munoz Sanchez; Alicia,7,0,20,13
1746578765563,LISP 5C,A00,896655,Munoz Sanchez; Alicia,0,1,20,20
1746578766587,MAE 197,001,957918,Kleissl; Jan,9996,0,9999,3
1746578766587,MAE 197,002,959806,Boechler; Nicholas Sebastia,9998,0,9999,1
1746578766587,MAE 197,003,959852,Mullin; Jennifer S,9998,0,9999,1
1746578767613,MATH 2,A01,957937,Staff,33,0,35,2
1746578768638,MATH 197,001,957876,Kedlaya; Kiran S.,9993,0,9999,6
1746578769663,MCWP 40,A00,892729,Duru; Nur,10,0,20,10
1746578769663,MCWP 40,B00,893304,Montejo; Carolina,14,0,20,6
1746578770688,MCWP 40R,A00,893757,Redela; Pamela Morgan,0,5,20,20
1746578771713,MCWP 50,A00,893758,Morshed; Michael James,0,0,20,20
1746578771713,MCWP 50,B00,893761,Bartulis; Jason Michael,17,0,20,3
1746578772740,MCWP 50R,A00,893766,Compas; Sean Matthew,0,1,20,20
1746578772740,MCWP 50R,B00,893769,Carter; Jennifer A,0,1,20,20
1746578772740,MCWP 50R,C00,893771,Krone; Jarret,0,3,20,20
1746578772740,MCWP 50R,D00,893772,Miller; Elizabeth Deen,0,0,20,20
1746578772740,MCWP 50R,E00,893775,Carter; Andrea L,0,1,20,20
1746578773764,MMW 11R,A01,892721,Herbst; Matthew,14,0,30,16
1746578773764,MMW 11R,A02,892722,Herbst; Matthew,0,0,0,3
1746578774790,MMW 12R,A01,892724,Herbst; Matthew,0,11,16,16
1746578774790,MMW 12R,A02,892725,Herbst; Matthew,0,10,16,16
1746578775815,MMW 13R,A01,892727,Staff,0,4,16,16
1746578775815,MMW 13R,A02,892728,Staff,0,4,16,16
1746578775815,MMW 13R,A03,958032,Staff,0,4,16,16
1746578775815,MMW 13R,A04,958033,Staff,0,4,16,16
1746578775815,MMW 13R,A05,958034,Staff,0,4,16,16
1746578776841,SIO 295LS,A00,894015,Staff,5,0,25,20
1746578777869,SIO 295S,A00,894020,Staff,5,0,25,20
1746578778898,SIOC 290S,B01,958918,Merrifield; Mark A,14,0,30,16
1746578779925,SIOC 291S,B01,958922,Gabriel; Corey John,14,0,30,16
1746578780953,SOCI 117,A01,895339,Staff,3,0,5,2
1746578781982,WES 237B,A00,894149,Staff,11,0,20,9
1746578784042,AESE 279B,A00,891859,Staff,13,0,35,22
1746578785067,AIP 197,001,891854,Vespa; Emanuel Ignacio,9999,0,9999,0
1746578786095,ANTH 289S,A00,891856,Gagneux; Pascal,12,0,12,0
1746578787119,BENG 196,001,957946,Engler; Adam J.,9996,0,9999,3
1746578788145,BISP 197,001,959851,Wilhelm; James E.,9998,0,9999,1
1746578789169,CAT 124RS,A01,956906,Staff,6,0,25,19
1746578790195,CAT 125RS,A01,922013,Staff,6,0,25,19
1746578791221,CLRE 250,A00,891860,Morris; Sheldon,9995,0,9999,4
1746578793269,CLRE 251R,A00,907817,Mehta; Ravindra L.,9994,0,9999,5
1746578794297,CLRE 252,A00,891864,Cuomo; Raphael Eduardo,9993,0,9999,6
1746578795325,CLRE 253,A00,891867,Vaida; Florin,9994,0,9999,5
1746578795325,CLRE 253,B00,907819,Staff,9999,0,9999,0
1746578796354,CLRE 259,A00,891868,Patel; Hemal,9998,0,9999,1
1746578797378,CLRE 260,A00,891872,Cuomo; Raphael Eduardo,9999,0,9999,0
1746578798402,CLRE 297,001,891888,Cuomo; Raphael Eduardo,9999,0,9999,0
1746578799428,CSE 191,A00,958773,Minnes Kemp; Mor Mia,9995,0,9999,4
1746578800453,CSE 197,001,959846,Minnes Kemp; Mor Mia,9990,0,9999,9
1746578801483,CSS 201S,A01,892054,Mignozzetti; Umberto,25,0,30,5
1746578802509,CSS 202S,A01,892056,Mignozzetti; Umberto,25,0,30,5
1746578803535,DSC 197,001,956898,Eldridge; Justin Matthew,9996,0,9999,3
1746578804603,DSC 297,001,958000,Mazumdar; Arya,9998,0,9999,1
1746578804603,DSC 297,002,959862,Wang; Yusu,9998,0,9999,1
1746578805628,EAP 100,A00,905686,Staff,9778,0,9999,221
1746578806654,ECE 45,A01,892618,Staff,0,0,65,65
1746578808703,ECE 111,A01,892719,Staff,6,0,65,59
1746578809731,ECE 197,001,957920,Mercier; Patrick Philip,9991,0,9999,8
1746578810755,ECON 178,A01,907814,Zhu; Ying,26,0,35,9
1746578811785,EDS 115,A00,895312,Staff,35,0,45,10
1746578812813,EDS 117,A01,895337,Staff,23,0,30,7
1746578813842,EDS 125,A00,895341,Jones; Gabrielle Anastasia,36,0,45,9
1746578814869,EDS 128A,A01,895459,Fargason; Sharon Gayle,44,0,45,1
1746578815894,EDS 128B,A01,895543,Pappas; Elizabeth,44,0,45,1
1746578816920,EDS 139,A00,897203,Pappas; Elizabeth,44,0,45,1
1746578816920,EDS 139,B00,897209,Fargason; Sharon Gayle,41,0,45,4
1746578817944,EDS 201,A00,895545,Staff,22,0,45,23
1746578818974,EDS 203,A01,895581,Halter; Christopher P.,22,0,45,23
1746578820007,EDS 204R,A01,895625,Heinzman; Erica M.,39,0,45,6
1746578820007,EDS 204R,B01,895693,Halter; Christopher P.,10,0,45,35
1746578821033,EDS 206R,A00,895694,Fargason; Sharon Gayle,1,0,30,29
1746578821033,EDS 206R,B00,895695,Choi; Bailey Miyeon,16,0,30,14
1746578822058,EDS 250,A00,895697,Hemans; Patricia Ann Benitez,22,0,45,23
1746578823083,EDS 281,A00,895701,Meyerott; Theresa Ann,1,0,15,14
1746578824111,EDS 284,A00,895736,Meyerott; Theresa Ann,1,0,15,14
1746578825135,EDS 286,A00,897210,Fine; Sarah,0,0,15,15
1746578826160,EDS 289C,A01,895770,Daly; Alan J.,1,0,15,14
1746578827189,EDS 290,A00,897211,Hofstetter; Carolyn,0,0,15,15
1746578828215,LIGM 5A,A00,896162,Fischer-Grunski; Eva K,12,0,20,8
1746578829240,LIGM 5B,A00,896260,Fischer-Grunski; Eva K,17,0,20,3
1746578830266,LIGM 5C,A00,896308,Fischer-Grunski; Eva K,18,0,20,2
1746578831291,LIIT 5AS,A00,896313,Carnelos; Chiara,18,0,20,2
1746578832320,LIIT 5BS,A00,896416,Carnelos; Chiara,20,0,20,0
1746578833344,LIIT 5CS,A00,896564,Carnelos; Chiara,20,0,20,0
1746578834373,LISP 5A,A00,896588,Munoz Sanchez; Alicia,2,0,20,18
1746578835399,LISP 5B,A00,896653,Munoz Sanchez; Alicia,7,0,20,13
1746578836426,LISP 5C,A00,896655,Munoz Sanchez; Alicia,0,1,20,20
1746578837450,MAE 197,001,957918,Kleissl; Jan,9996,0,9999,3
1746578837450,MAE 197,002,959806,Boechler; Nicholas Sebastia,9998,0,9999,1
1746578837450,MAE 197,003,959852,Mullin; Jennifer S,9998,0,9999,1
1746578838474,MATH 2,A01,957937,Staff,33,0,35,2
1746578839498,MATH 197,001,957876,Kedlaya; Kiran S.,9993,0,9999,6
1746578840525,MCWP 40,A00,892729,Duru; Nur,10,0,20,10
1746578840525,MCWP 40,B00,893304,Montejo; Carolina,14,0,20,6
1746578841553,MCWP 40R,A00,893757,Redela; Pamela Morgan,0,5,20,20
1746578842579,MCWP 50,A00,893758,Morshed; Michael James,0,0,20,20
1746578842579,MCWP 50,B00,893761,Bartulis; Jason Michael,17,0,20,3
1746578843604,MCWP 50R,A00,893766,Compas; Sean Matthew,0,1,20,20
1746578843604,MCWP 50R,B00,893769,Carter; Jennifer A,0,1,20,20
1746578843604,MCWP 50R,C00,893771,Krone; Jarret,0,3,20,20
1746578843604,MCWP 50R,D00,893772,Miller; Elizabeth Deen,0,0,20,20
1746578843604,MCWP 50R,E00,893775,Carter; Andrea L,0,1,20,20
1746578844631,MMW 11R,A01,892721,Herbst; Matthew,14,0,30,16
1746578844631,MMW 11R,A02,892722,Herbst; Matthew,0,0,0,3
1746578845659,MMW 12R,A01,892724,Herbst; Matthew,0,11,16,16
1746578845659,MMW 12R,A02,892725,Herbst; Matthew,0,10,16,16
1746578846687,MMW 13R,A01,892727,Staff,0,4,16,16
1746578846687,MMW 13R,A02,892728,Staff,0,4,16,16
1746578846687,MMW 13R,A03,958032,Staff,0,4,16,16
1746578846687,MMW 13R,A04,958033,Staff,0,4,16,16
1746578846687,MMW 13R,A05,958034,Staff,0,4,16,16
1746578847713,SIO 295LS,A00,894015,Staff,5,0,25,20
1746578848737,SIO 295S,A00,894020,Staff,5,0,25,20
1746578849767,SIOC 290S,B01,958918,Merrifield; Mark A,14,0,30,16
1746578850792,SIOC 291S,B01,958922,Gabriel; Corey John,14,0,30,16
1746578851819,SOCI 117,A01,895339,Staff,3,0,5,2
1746578852843,WES 237B,A00,894149,Staff,11,0,20,9
1746578854904,AESE 279B,A00,891859,Staff,13,0,35,22
1746578855932,AIP 197,001,891854,Vespa; Emanuel Ignacio,9999,0,9999,0
1746578856958,ANTH 289S,A00,891856,Gagneux; Pascal,12,0,12,0
1746578857982,BENG 196,001,957946,Engler; Adam J.,9996,0,9999,3
1746578859008,BISP 197,001,959851,Wilhelm; James E.,9998,0,9999,1
1746578860035,CAT 124RS,A01,956906,Staff,6,0,25,19
1746578861060,CAT 125RS,A01,922013,Staff,6,0,25,19
1746578862090,CLRE 250,A00,891860,Morris; Sheldon,9995,0,9999,4
1746578864143,CLRE 251R,A00,907817,Mehta; Ravindra L.,9994,0,9999,5
1746578865170,CLRE 252,A00,891864,Cuomo; Raphael Eduardo,9993,0,9999,6
1746578866200,CLRE 253,A00,891867,Vaida; Florin,9994,0,9999,5
1746578866200,CLRE 253,B00,907819,Staff,9999,0,9999,0
1746578867225,CLRE 259,A00,891868,Patel; Hemal,9998,0,9999,1
1746578868251,CLRE 260,A00,891872,Cuomo; Raphael Eduardo,9999,0,9999,0
1746578869280,CLRE 297,001,891888,Cuomo; Raphael Eduardo,9999,0,9999,0
1746578870309,CSE 191,A00,958773,Minnes Kemp; Mor Mia,9995,0,9999,4
1746578871335,CSE 197,001,959846,Minnes Kemp; Mor Mia,9990,0,9999,9
1746578872361,CSS 201S,A01,892054,Mignozzetti; Umberto,25,0,30,5
1746578873391,CSS 202S,A01,892056,Mignozzetti; Umberto,25,0,30,5
1746578874416,DSC 197,001,956898,Eldridge; Justin Matthew,9996,0,9999,3
1746578875441,DSC 297,001,958000,Mazumdar; Arya,9998,0,9999,1
1746578875441,DSC 297,002,959862,Wang; Yusu,9998,0,9999,1
1746578876467,EAP 100,A00,905686,Staff,9778,0,9999,221
1746578877492,ECE 45,A01,892618,Staff,0,0,65,65
1746578879542,ECE 111,A01,892719,Staff,6,0,65,59
1746578880566,ECE 197,001,957920,Mercier; Patrick Philip,9991,0,9999,8
1746578881599,ECON 178,A01,907814,Zhu; Ying,26,0,35,9
1746578882627,EDS 115,A00,895312,Staff,35,0,45,10
1746578883656,EDS 117,A01,895337,Staff,23,0,30,7
1746578884684,EDS 125,A00,895341,Jones; Gabrielle Anastasia,36,0,45,9
1746578885711,EDS 128A,A01,895459,Fargason; Sharon Gayle,44,0,45,1
1746578886737,EDS 128B,A01,895543,Pappas; Elizabeth,44,0,45,1
1746578887764,EDS 139,A00,897203,Pappas; Elizabeth,44,0,45,1
1746578887764,EDS 139,B00,897209,Fargason; Sharon Gayle,41,0,45,4
1746578888793,EDS 201,A00,895545,Staff,22,0,45,23
1746578889819,EDS 203,A01,895581,Halter; Christopher P.,22,0,45,23
1746578890844,EDS 204R,A01,895625,Heinzman; Erica M.,39,0,45,6
1746578890844,EDS 204R,B01,895693,Halter; Christopher P.,10,0,45,35
1746578891873,EDS 206R,A00,895694,Fargason; Sharon Gayle,1,0,30,29
1746578891873,EDS 206R,B00,895695,Choi; Bailey Miyeon,16,0,30,14
1746578892899,EDS 250,A00,895697,Hemans; Patricia Ann Benitez,22,0,45,23
1746578893924,EDS 281,A00,895701,Meyerott; Theresa Ann,1,0,15,14
1746578894951,EDS 284,A00,895736,Meyerott; Theresa Ann,1,0,15,14
1746578895975,EDS 286,A00,897210,Fine; Sarah,0,0,15,15
1746578897001,EDS 289C,A01,895770,Daly; Alan J.,1,0,15,14
1746578898028,EDS 290,A00,897211,Hofstetter; Carolyn,0,0,15,15
1746578899054,LIGM 5A,A00,896162,Fischer-Grunski; Eva K,12,0,20,8
1746578900086,LIGM 5B,A00,896260,Fischer-Grunski; Eva K,17,0,20,3
1746578901111,LIGM 5C,A00,896308,Fischer-Grunski; Eva K,18,0,20,2
1746578902142,LIIT 5AS,A00,896313,Carnelos; Chiara,18,0,20,2
1746578903169,LIIT 5BS,A00,896416,Carnelos; Chiara,20,0,20,0
1746578904195,LIIT 5CS,A00,896564,Carnelos; Chiara,20,0,20,0
1746578905221,LISP 5A,A00,896588,Munoz Sanchez; Alicia,2,0,20,18
1746578906246,LISP 5B,A00,896653,Munoz Sanchez; Alicia,7,0,20,13
1746578907273,LISP 5C,A00,896655,Munoz Sanchez; Alicia,0,1,20,20
1746578908303,MAE 197,001,957918,Kleissl; Jan,9996,0,9999,3
1746578908303,MAE 197,002,959806,Boechler; Nicholas Sebastia,9998,0,9999,1
1746578908303,MAE 197,003,959852,Mullin; Jennifer S,9998,0,9999,1
1746578909331,MATH 2,A01,957937,Staff,33,0,35,2
1746578910356,MATH 197,001,957876,Kedlaya; Kiran S.,9993,0,9999,6
1746578911385,MCWP 40,A00,892729,Duru; Nur,10,0,20,10
1746578911385,MCWP 40,B00,893304,Montejo; Carolina,14,0,20,6
1746578912414,MCWP 40R,A00,893757,Redela; Pamela Morgan,0,5,20,20
1746578913442,MCWP 50,A00,893758,Morshed; Michael James,0,0,20,20
1746578913442,MCWP 50,B00,893761,Bartulis; Jason Michael,17,0,20,3
1746578914466,MCWP 50R,A00,893766,Compas; Sean Matthew,0,1,20,20
1746578914466,MCWP 50R,B00,893769,Carter; Jennifer A,0,1,20,20
1746578914466,MCWP 50R,C00,893771,Krone; Jarret,0,3,20,20
1746578914466,MCWP 50R,D00,893772,Miller; Elizabeth Deen,0,0,20,20
1746578914466,MCWP 50R,E00,893775,Carter; Andrea L,0,1,20,20
1746578915491,MMW 11R,A01,892721,Herbst; Matthew,14,0,30,16
1746578915491,MMW 11R,A02,892722,Herbst; Matthew,0,0,0,3
1746578916516,MMW 12R,A01,892724,Herbst; Matthew,0,11,16,16
1746578916516,MMW 12R,A02,892725,Herbst; Matthew,0,10,16,16
1746578917592,MMW 13R,A01,892727,Staff,0,4,16,16
1746578917592,MMW 13R,A02,892728,Staff,0,4,16,16
1746578917592,MMW 13R,A03,958032,Staff,0,4,16,16
1746578917592,MMW 13R,A04,958033,Staff,0,4,16,16
1746578917592,MMW 13R,A05,958034,Staff,0,4,16,16
1746578918620,SIO 295LS,A00,894015,Staff,5,0,25,20
1746578919648,SIO 295S,A00,894020,Staff,5,0,25,20
1746578920676,SIOC 290S,B01,958918,Merrifield; Mark A,14,0,30,16
1746578921708,SIOC 291S,B01,958922,Gabriel; Corey John,14,0,30,16
1746578922736,SOCI 117,A01,895339,Staff,3,0,5,2
1746578923763,WES 237B,A00,894149,Staff,11,0,20,9
1746578925816,AESE 279B,A00,891859,Staff,13,0,35,22
1746578926842,AIP 197,001,891854,Vespa; Emanuel Ignacio,9999,0,9999,0
1746578927870,ANTH 289S,A00,891856,Gagneux; Pascal,12,0,12,0
1746578928899,BENG 196,001,957946,Engler; Adam J.,9996,0,9999,3
1746578929923,BISP 197,001,959851,Wilhelm; James E.,9998,0,9999,1
1746578930947,CAT 124RS,A01,956906,Staff,6,0,25,19
1746578931970,CAT 125RS,A01,922013,Staff,6,0,25,19
1746578932995,CLRE 250,A00,891860,Morris; Sheldon,9995,0,9999,4
1746578935046,CLRE 251R,A00,907817,Mehta; Ravindra L.,9994,0,9999,5
1746578936072,CLRE 252,A00,891864,Cuomo; Raphael Eduardo,9993,0,9999,6
1746578937101,CLRE 253,A00,891867,Vaida; Florin,9994,0,9999,5
1746578937101,CLRE 253,B00,907819,Staff,9999,0,9999,0
1746578938126,CLRE 259,A00,891868,Patel; Hemal,9998,0,9999,1
1746578939157,CLRE 260,A00,891872,Cuomo; Raphael Eduardo,9999,0,9999,0
1746578940182,CLRE 297,001,891888,Cuomo; Raphael Eduardo,9999,0,9999,0
1746578941209,CSE 191,A00,958773,Minnes Kemp; Mor Mia,9995,0,9999,4
1746578942235,CSE 197,001,959846,Minnes Kemp; Mor Mia,9990,0,9999,9
1746578943266,CSS 201S,A01,892054,Mignozzetti; Umberto,25,0,30,5
1746578944291,CSS 202S,A01,892056,Mignozzetti; Umberto,25,0,30,5
1746578945318,DSC 197,001,956898,Eldridge; Justin Matthew,9996,0,9999,3
1746578946348,DSC 297,001,958000,Mazumdar; Arya,9998,0,9999,1
1746578946348,DSC 297,002,959862,Wang; Yusu,9998,0,9999,1
1746578947373,EAP 100,A00,905686,Staff,9778,0,9999,221
1746578948401,ECE 45,A01,892618,Staff,0,0,65,65
1746578950452,ECE 111,A01,892719,Staff,6,0,65,59
1746578951481,ECE 197,001,957920,Mercier; Patrick Philip,9991,0,9999,8
1746578952508,ECON 178,A01,907814,Zhu; Ying,26,0,35,9
1746578953533,EDS 115,A00,895312,Staff,35,0,45,10
1746578954561,EDS 117,A01,895337,Staff,23,0,30,7
1746578955590,EDS 125,A00,895341,Jones; Gabrielle Anastasia,36,0,45,9
1746578956614,EDS 128A,A01,895459,Fargason; Sharon Gayle,44,0,45,1
1746578957640,EDS 128B,A01,895543,Pappas; Elizabeth,44,0,45,1
1746578958664,EDS 139,A00,897203,Pappas; Elizabeth,44,0,45,1
1746578958664,EDS 139,B00,897209,Fargason; Sharon Gayle,41,0,45,4
1746578959694,EDS 201,A00,895545,Staff,22,0,45,23
1746578960718,EDS 203,A01,895581,Halter; Christopher P.,22,0,45,23
1746578961750,EDS 204R,A01,895625,Heinzman; Erica M.,39,0,45,6
1746578961750,EDS 204R,B01,895693,Halter; Christopher P.,10,0,45,35
1746578962776,EDS 206R,A00,895694,Fargason; Sharon Gayle,1,0,30,29
1746578962776,EDS 206R,B00,895695,Choi; Bailey Miyeon,16,0,30,14
1746578963805,EDS 250,A00,895697,Hemans; Patricia Ann Benitez,22,0,45,23
1746578964831,EDS 281,A00,895701,Meyerott; Theresa Ann,1,0,15,14
1746578965857,EDS 284,A00,895736,Meyerott; Theresa Ann,1,0,15,14
1746578966881,EDS 286,A00,897210,Fine; Sarah,0,0,15,15
1746578967906,EDS 289C,A01,895770,Daly; Alan J.,1,0,15,14
1746578968931,EDS 290,A00,897211,Hofstetter; Carolyn,0,0,15,15
1746578969957,LIGM 5A,A00,896162,Fischer-Grunski; Eva K,12,0,20,8
1746578970986,LIGM 5B,A00,896260,Fischer-Grunski; Eva K,17,0,20,3
1746578972011,LIGM 5C,A00,896308,Fischer-Grunski; Eva K,18,0,20,2
1746578973096,LIIT 5AS,A00,896313,Carnelos; Chiara,18,0,20,2
1746578974122,LIIT 5BS,A00,896416,Carnelos; Chiara,20,0,20,0
1746578975147,LIIT 5CS,A00,896564,Carnelos; Chiara,20,0,20,0
1746578976173,LISP 5A,A00,896588,Munoz Sanchez; Alicia,2,0,20,18
1746578977198,LISP 5B,A00,896653,Munoz Sanchez; Alicia,7,0,20,13
1746578978222,LISP 5C,A00,896655,Munoz Sanchez; Alicia,0,1,20,20
1746578979247,MAE 197,001,957918,Kleissl; Jan,9996,0,9999,3
1746578979247,MAE 197,002,959806,Boechler; Nicholas Sebastia,9998,0,9999,1
1746578979247,MAE 197,003,959852,Mullin; Jennifer S,9998,0,9999,1
1746578980272,MATH 2,A01,957937,Staff,33,0,35,2
1746578981298,MATH 197,001,957876,Kedlaya; Kiran S.,9993,0,9999,6
1746578982327,MCWP 40,A00,892729,Duru; Nur,10,0,20,10
1746578982327,MCWP 40,B00,893304,Montejo; Carolina,14,0,20,6
1746578983356,MCWP 40R,A00,893757,Redela; Pamela Morgan,0,5,20,20
1746578984384,MCWP 50,A00,893758,Morshed; Michael James,0,0,20,20
1746578984384,MCWP 50,B00,893761,Bartulis; Jason Michael,17,0,20,3
1746578985412,MCWP 50R,A00,893766,Compas; Sean Matthew,0,1,20,20
1746578985412,MCWP 50R,B00,893769,Carter; Jennifer A,0,1,20,20
1746578985412,MCWP 50R,C00,893771,Krone; Jarret,0,3,20,20
1746578985412,MCWP 50R,D00,893772,Miller; Elizabeth Deen,0,0,20,20
1746578985412,MCWP 50R,E00,893775,Carter; Andrea L,0,1,20,20
1746578986442,MMW 11R,A01,892721,Herbst; Matthew,14,0,30,16
1746578986442,MMW 11R,A02,892722,Herbst; Matthew,0,0,0,3
1746578987469,MMW 12R,A01,892724,Herbst; Matthew,0,11,16,16
1746578987469,MMW 12R,A02,892725,Herbst; Matthew,0,10,16,16
1746578988497,MMW 13R,A01,892727,Staff,0,4,16,16
1746578988497,MMW 13R,A02,892728,Staff,0,4,16,16
1746578988497,MMW 13R,A03,958032,Staff,0,4,16,16
1746578988497,MMW 13R,A04,958033,Staff,0,4,16,16
1746578988497,MMW 13R,A05,958034,Staff,0,4,16,16
1746578989524,SIO 295LS,A00,894015,Staff,5,0,25,20
1746578990556,SIO 295S,A00,894020,Staff,5,0,25,20
1746578991586,SIOC 290S,B01,958918,Merrifield; Mark A,14,0,30,16
1746578992611,SIOC 291S,B01,958922,Gabriel; Corey John,14,0,30,16
1746578993635,SOCI 117,A01,895339,Staff,3,0,5,2
1746578994658,WES 237B,A00,894149,Staff,11,0,20,9
1746578996721,AESE 279B,A00,891859,Staff,13,0,35,22
1746578997747,AIP 197,001,891854,Vespa; Emanuel Ignacio,9999,0,9999,0
1746578998772,ANTH 289S,A00,891856,Gagneux; Pascal,12,0,12,0
1746578999798,BENG 196,001,957946,Engler; Adam J.,9996,0,9999,3
1746579000826,BISP 197,001,959851,Wilhelm; James E.,9998,0,9999,1
1746579001855,CAT 124RS,A01,956906,Staff,6,0,25,19
1746579002882,CAT 125RS,A01,922013,Staff,6,0,25,19
1746579003908,CLRE 250,A00,891860,Morris; Sheldon,9995,0,9999,4
1746579005967,CLRE 251R,A00,907817,Mehta; Ravindra L.,9994,0,9999,5
1746579006995,CLRE 252,A00,891864,Cuomo; Raphael Eduardo,9993,0,9999,6
1746579008020,CLRE 253,A00,891867,Vaida; Florin,9994,0,9999,5
1746579008020,CLRE 253,B00,907819,Staff,9999,0,9999,0
1746579009044,CLRE 259,A00,891868,Patel; Hemal,9998,0,9999,1
1746579010076,CLRE 260,A00,891872,Cuomo; Raphael Eduardo,9999,0,9999,0
1746579011105,CLRE 297,001,891888,Cuomo; Raphael Eduardo,9999,0,9999,0
1746579012132,CSE 191,A00,958773,Minnes Kemp; Mor Mia,9995,0,9999,4
1746579013158,CSE 197,001,959846,Minnes Kemp; Mor Mia,9990,0,9999,9
1746579014189,CSS 201S,A01,892054,Mignozzetti; Umberto,25,0,30,5
1746579015216,CSS 202S,A01,892056,Mignozzetti; Umberto,25,0,30,5
1746579016241,DSC 197,001,956898,Eldridge; Justin Matthew,9996,0,9999,3
1746579017268,DSC 297,001,958000,Mazumdar; Arya,9998,0,9999,1
1746579017268,DSC 297,002,959862,Wang; Yusu,9998,0,9999,1
1746579018296,EAP 100,A00,905686,Staff,9778,0,9999,221
1746579019327,ECE 45,A01,892618,Staff,0,0,65,65
1746579021384,ECE 111,A01,892719,Staff,6,0,65,59
1746579022418,ECE 197,001,957920,Mercier; Patrick Philip,9991,0,9999,8
1746579023443,ECON 178,A01,907814,Zhu; Ying,26,0,35,9
1746579024466,EDS 115,A00,895312,Staff,35,0,45,10
1746579025491,EDS 117,A01,895337,Staff,23,0,30,7
1746579026517,EDS 125,A00,895341,Jones; Gabrielle Anastasia,36,0,45,9
1746579027544,EDS 128A,A01,895459,Fargason; Sharon Gayle,44,0,45,1
1746579028571,EDS 128B,A01,895543,Pappas; Elizabeth,44,0,45,1
1746579029597,EDS 139,A00,897203,Pappas; Elizabeth,44,0,45,1
1746579029597,EDS 139,B00,897209,Fargason; Sharon Gayle,41,0,45,4
1746579030633,EDS 201,A00,895545,Staff,22,0,45,23
1746579031659,EDS 203,A01,895581,Halter; Christopher P.,22,0,45,23
1746579032738,EDS 204R,A01,895625,Heinzman; Erica M.,39,0,45,6
1746579032738,EDS 204R,B01,895693,Halter; Christopher P.,10,0,45,35
1746579033768,EDS 206R,A00,895694,Fargason; Sharon Gayle,1,0,30,29
1746579033768,EDS 206R,B00,895695,Choi; Bailey Miyeon,16,0,30,14
1746579034796,EDS 250,A00,895697,Hemans; Patricia Ann Benitez,22,0,45,23
1746579035821,EDS 281,A00,895701,Meyerott; Theresa Ann,1,0,15,14
1746579036846,EDS 284,A00,895736,Meyerott; Theresa Ann,1,0,15,14
1746579037876,EDS 286,A00,897210,Fine; Sarah,0,0,15,15
1746579038905,EDS 289C,A01,895770,Daly; Alan J.,1,0,15,14
1746579039932,EDS 290,A00,897211,Hofstetter; Carolyn,0,0,15,15
1746579040964,LIGM 5A,A00,896162,Fischer-Grunski; Eva K,12,0,20,8
1746579041996,LIGM 5B,A00,896260,Fischer-Grunski; Eva K,17,0,20,3
1746579043021,LIGM 5C,A00,896308,Fischer-Grunski; Eva K,18,0,20,2
1746579044049,LIIT 5AS,A00,896313,Carnelos; Chiara,18,0,20,2
1746579045074,LIIT 5BS,A00,896416,Carnelos; Chiara,20,0,20,0
1746579046103,LIIT 5CS,A00,896564,Carnelos; Chiara,20,0,20,0
1746579047126,LISP 5A,A00,896588,Munoz Sanchez; Alicia,2,0,20,18
1746579048150,LISP 5B,A00,896653,Munoz Sanchez; Alicia,7,0,20,13
1746579049176,LISP 5C,A00,896655,Munoz Sanchez; Alicia,0,1,20,20
1746579050209,MAE 197,001,957918,Kleissl; Jan,9996,0,9999,3
1746579050209,MAE 197,002,959806,Boechler; Nicholas Sebastia,9998,0,9999,1
1746579050209,MAE 197,003,959852,Mullin; Jennifer S,9998,0,9999,1
1746579051232,MATH 2,A01,957937,Staff,33,0,35,2
1746579052258,MATH 197,001,957876,Kedlaya; Kiran S.,9993,0,9999,6
1746579053285,MCWP 40,A00,892729,Duru; Nur,10,0,20,10
1746579053285,MCWP 40,B00,893304,Montejo; Carolina,14,0,20,6
1746579054311,MCWP 40R,A00,893757,Redela; Pamela Morgan,0,5,20,20
1746579055336,MCWP 50,A00,893758,Morshed; Michael James,0,0,20,20
1746579055336,MCWP 50,B00,893761,Bartulis; Jason Michael,17,0,20,3
1746579056368,MCWP 50R,A00,893766,Compas; Sean Matthew,0,1,20,20
1746579056368,MCWP 50R,B00,893769,Carter; Jennifer A,0,1,20,20
1746579056368,MCWP 50R,C00,893771,Krone; Jarret,0,3,20,20
1746579056368,MCWP 50R,D00,893772,Miller; Elizabeth Deen,0,0,20,20
1746579056368,MCWP 50R,E00,893775,Carter; Andrea L,0,1,20,20
1746579057393,MMW 11R,A01,892721,Herbst; Matthew,14,0,30,16
1746579057393,MMW 11R,A02,892722,Herbst; Matthew,0,0,0,3
1746579058422,MMW 12R,A01,892724,Herbst; Matthew,0,11,16,16
1746579058422,MMW 12R,A02,892725,Herbst; Matthew,0,10,16,16
1746579059450,MMW 13R,A01,892727,Staff,0,4,16,16
1746579059450,MMW 13R,A02,892728,Staff,0,4,16,16
1746579059450,MMW 13R,A03,958032,Staff,0,4,16,16
1746579059450,MMW 13R,A04,958033,Staff,0,4,16,16
1746579059450,MMW 13R,A05,958034,Staff,0,4,16,16
1746579060475,SIO 295LS,A00,894015,Staff,5,0,25,20
1746579061505,SIO 295S,A00,894020,Staff,5,0,25,20
1746579062532,SIOC 290S,B01,958918,Merrifield; Mark A,14,0,30,16
1746579063557,SIOC 291S,B01,958922,Gabriel; Corey John,14,0,30,16
1746579064582,SOCI 117,A01,895339,Staff,3,0,5,2
1746579065609,WES 237B,A00,894149,Staff,11,0,20,9
1746579067673,AESE 279B,A00,891859,Staff,13,0,35,22
1746579068703,AIP 197,001,891854,Vespa; Emanuel Ignacio,9999,0,9999,0
1746579069726,ANTH 289S,A00,891856,Gagneux; Pascal,12,0,12,0
1746579070755,BENG 196,001,957946,Engler; Adam J.,9996,0,9999,3
1746579071787,BISP 197,001,959851,Wilhelm; James E.,9998,0,9999,1
1746579072814,CAT 124RS,A01,956906,Staff,6,0,25,19
1746579073837,CAT 125RS,A01,922013,Staff,6,0,25,19
1746579074863,CLRE 250,A00,891860,Morris; Sheldon,9995,0,9999,4
1746579076920,CLRE 251R,A00,907817,Mehta; Ravindra L.,9994,0,9999,5
1746579077944,CLRE 252,A00,891864,Cuomo; Raphael Eduardo,9993,0,9999,6
1746579078968,CLRE 253,A00,891867,Vaida; Florin,9994,0,9999,5
1746579078968,CLRE 253,B00,907819,Staff,9999,0,9999,0
1746579079996,CLRE 259,A00,891868,Patel; Hemal,9998,0,9999,1
1746579081019,CLRE 260,A00,891872,Cuomo; Raphael Eduardo,9999,0,9999,0
1746579082046,CLRE 297,001,891888,Cuomo; Raphael Eduardo,9999,0,9999,0
1746579083071,CSE 191,A00,958773,Minnes Kemp; Mor Mia,9995,0,9999,4
1746579084097,CSE 197,001,959846,Minnes Kemp; Mor Mia,9990,0,9999,9
1746579085123,CSS 201S,A01,892054,Mignozzetti; Umberto,25,0,30,5
1746579086154,CSS 202S,A01,892056,Mignozzetti; Umberto,25,0,30,5
1746579087179,DSC 197,001,956898,Eldridge; Justin Matthew,9996,0,9999,3
1746579088208,DSC 297,001,958000,Mazumdar; Arya,9998,0,9999,1
1746579088208,DSC 297,002,959862,Wang; Yusu,9998,0,9999,1
1746579089235,EAP 100,A00,905686,Staff,9778,0,9999,221
1746579090262,ECE 45,A01,892618,Staff,0,0,65,65
1746579092320,ECE 111,A01,892719,Staff,6,0,65,59
1746579093349,ECE 197,001,957920,Mercier; Patrick Philip,9991,0,9999,8
1746579094378,ECON 178,A01,907814,Zhu; Ying,26,0,35,9
1746579095406,EDS 115,A00,895312,Staff,35,0,45,10
1746579096433,EDS 117,A01,895337,Staff,23,0,30,7
1746579097461,EDS 125,A00,895341,Jones; Gabrielle Anastasia,36,0,45,9
1746579098487,EDS 128A,A01,895459,Fargason; Sharon Gayle,44,0,45,1
1746579099513,EDS 128B,A01,895543,Pappas; Elizabeth,44,0,45,1
1746579100536,EDS 139,A00,897203,Pappas; Elizabeth,44,0,45,1
1746579100536,EDS 139,B00,897209,Fargason; Sharon Gayle,41,0,45,4
1746579101560,EDS 201,A00,895545,Staff,22,0,45,23
1746579102588,EDS 203,A01,895581,Halter; Christopher P.,22,0,45,23
1746579103614,EDS 204R,A01,895625,Heinzman; Erica M.,39,0,45,6
1746579103614,EDS 204R,B01,895693,Halter; Christopher P.,10,0,45,35
1746579104642,EDS 206R,A00,895694,Fargason; Sharon Gayle,1,0,30,29
1746579104642,EDS 206R,B00,895695,Choi; Bailey Miyeon,16,0,30,14
1746579105668,EDS 250,A00,895697,Hemans; Patricia Ann Benitez,22,0,45,23
1746579106693,EDS 281,A00,895701,Meyerott; Theresa Ann,1,0,15,14
1746579107717,EDS 284,A00,895736,Meyerott; Theresa Ann,1,0,15,14
1746579108741,EDS 286,A00,897210,Fine; Sarah,0,0,15,15
1746579109766,EDS 289C,A01,895770,Daly; Alan J.,1,0,15,14
1746579110791,EDS 290,A00,897211,Hofstetter; Carolyn,0,0,15,15
1746579111823,LIGM 5A,A00,896162,Fischer-Grunski; Eva K,12,0,20,8
1746579112850,LIGM 5B,A00,896260,Fischer-Grunski; Eva K,17,0,20,3
1746579113877,LIGM 5C,A00,896308,Fischer-Grunski; Eva K,18,0,20,2
1746579114903,LIIT 5AS,A00,896313,Carnelos; Chiara,18,0,20,2
1746579115931,LIIT 5BS,A00,896416,Carnelos; Chiara,20,0,20,0
1746579116956,LIIT 5CS,A00,896564,Carnelos; Chiara,20,0,20,0
1746579117986,LISP 5A,A00,896588,Munoz Sanchez; Alicia,2,0,20,18
1746579119011,LISP 5B,A00,896653,Munoz Sanchez; Alicia,7,0,20,13
1746579120043,LISP 5C,A00,896655,Munoz Sanchez; Alicia,0,1,20,20
1746579121167,MAE 197,001,957918,Kleissl; Jan,9996,0,9999,3
1746579121167,MAE 197,002,959806,Boechler; Nicholas Sebastia,9998,0,9999,1
1746579121167,MAE 197,003,959852,Mullin; Jennifer S,9998,0,9999,1
1746579122191,MATH 2,A01,957937,Staff,33,0,35,2
1746579123262,MATH 197,001,957876,Kedlaya; Kiran S.,9993,0,9999,6
1746579124290,MCWP 40,A00,892729,Duru; Nur,10,0,20,10
1746579124290,MCWP 40,B00,893304,Montejo; Carolina,14,0,20,6
1746579125320,MCWP 40R,A00,893757,Redela; Pamela Morgan,0,5,20,20
1746579126344,MCWP 50,A00,893758,Morshed; Michael James,0,0,20,20
1746579126344,MCWP 50,B00,893761,Bartulis; Jason Michael,17,0,20,3
1746579127378,MCWP 50R,A00,893766,Compas; Sean Matthew,0,1,20,20
1746579127378,MCWP 50R,B00,893769,Carter; Jennifer A,0,1,20,20
1746579127378,MCWP 50R,C00,893771,Krone; Jarret,0,3,20,20
1746579127378,MCWP 50R,D00,893772,Miller; Elizabeth Deen,0,0,20,20
1746579127378,MCWP 50R,E00,893775,Carter; Andrea L,0,1,20,20
1746579128401,MMW 11R,A01,892721,Herbst; Matthew,14,0,30,16
1746579128401,MMW 11R,A02,892722,Herbst; Matthew,0,0,0,3
1746579129425,MMW 12R,A01,892724,Herbst; Matthew,0,11,16,16
1746579129425,MMW 12R,A02,892725,Herbst; Matthew,0,10,16,16
1746579130450,MMW 13R,A01,892727,Staff,0,4,16,16
1746579130450,MMW 13R,A02,892728,Staff,0,4,16,16
1746579130450,MMW 13R,A03,958032,Staff,0,4,16,16
1746579130450,MMW 13R,A04,958033,Staff,0,4,16,16
1746579130450,MMW 13R,A05,958034,Staff,0,4,16,16
1746579131478,SIO 295LS,A00,894015,Staff,5,0,25,20
1746579132501,SIO 295S,A00,894020,Staff,5,0,25,20
1746579133527,SIOC 290S,B01,958918,Merrifield; Mark A,14,0,30,16
1746579134553,SIOC 291S,B01,958922,Gabriel; Corey John,14,0,30,16
1746579135580,SOCI 117,A01,895339,Staff,3,0,5,2
1746579136607,WES 237B,A00,894149,Staff,11,0,20,9
1746579138667,AESE 279B,A00,891859,Staff,13,0,35,22
1746579139690,AIP 197,001,891854,Vespa; Emanuel Ignacio,9999,0,9999,0
1746579140723,ANTH 289S,A00,891856,Gagneux; Pascal,12,0,12,0
1746579141748,BENG 196,001,957946,Engler; Adam J.,9996,0,9999,3
1746579142772,BISP 197,001,959851,Wilhelm; James E.,9998,0,9999,1
1746579143801,CAT 124RS,A01,956906,Staff,6,0,25,19
1746579144826,CAT 125RS,A01,922013,Staff,6,0,25,19
1746579145852,CLRE 250,A00,891860,Morris; Sheldon,9995,0,9999,4
1746579147905,CLRE 251R,A00,907817,Mehta; Ravindra L.,9994,0,9999,5
1746579148932,CLRE 252,A00,891864,Cuomo; Raphael Eduardo,9993,0,9999,6
1746579149961,CLRE 253,A00,891867,Vaida; Florin,9994,0,9999,5
1746579149961,CLRE 253,B00,907819,Staff,9999,0,9999,0
1746579150988,CLRE 259,A00,891868,Patel; Hemal,9998,0,9999,1
1746579152014,CLRE 260,A00,891872,Cuomo; Raphael Eduardo,9999,0,9999,0
1746579153038,CLRE 297,001,891888,Cuomo; Raphael Eduardo,9999,0,9999,0
1746579154064,CSE 191,A00,958773,Minnes Kemp; Mor Mia,9995,0,9999,4
1746579155089,CSE 197,001,959846,Minnes Kemp; Mor Mia,9990,0,9999,9
1746579156114,CSS 201S,A01,892054,Mignozzetti; Umberto,25,0,30,5
1746579157142,CSS 202S,A01,892056,Mignozzetti; Umberto,25,0,30,5
1746579158167,DSC 197,001,956898,Eldridge; Justin Matthew,9996,0,9999,3
1746579159197,DSC 297,001,958000,Mazumdar; Arya,9998,0,9999,1
1746579159197,DSC 297,002,959862,Wang; Yusu,9998,0,9999,1
1746579160222,EAP 100,A00,905686,Staff,9778,0,9999,221
1746579161252,ECE 45,A01,892618,Staff,0,0,65,65
1746579163306,ECE 111,A01,892719,Staff,6,0,65,59
1746579164331,ECE 197,001,957920,Mercier; Patrick Philip,9991,0,9999,8
1746579165360,ECON 178,A01,907814,Zhu; Ying,26,0,35,9
1746579166388,EDS 115,A00,895312,Staff,35,0,45,10
1746579167413,EDS 117,A01,895337,Staff,23,0,30,7
1746579168437,EDS 125,A00,895341,Jones; Gabrielle Anastasia,36,0,45,9
1746579169462,EDS 128A,A01,895459,Fargason; Sharon Gayle,44,0,45,1
1746579170490,EDS 128B,A01,895543,Pappas; Elizabeth,44,0,45,1
1746579171515,EDS 139,A00,897203,Pappas; Elizabeth,44,0,45,1
1746579171515,EDS 139,B00,897209,Fargason; Sharon Gayle,41,0,45,4
1746579172544,EDS 201,A00,895545,Staff,22,0,45,23
1746579173570,EDS 203,A01,895581,Halter; Christopher P.,22,0,45,23
1746579174598,EDS 204R,A01,895625,Heinzman; Erica M.,39,0,45,6
1746579174598,EDS 204R,B01,895693,Halter; Christopher P.,10,0,45,35
1746579175624,EDS 206R,A00,895694,Fargason; Sharon Gayle,1,0,30,29
1746579175624,EDS 206R,B00,895695,Choi; Bailey Miyeon,16,0,30,14
1746579176648,EDS 250,A00,895697,Hemans; Patricia Ann Benitez,22,0,45,23
1746579177677,EDS 281,A00,895701,Meyerott; Theresa Ann,1,0,15,14
1746579178706,EDS 284,A00,895736,Meyerott; Theresa Ann,1,0,15,14
1746579179730,EDS 286,A00,897210,Fine; Sarah,0,0,15,15
1746579180758,EDS 289C,A01,895770,Daly; Alan J.,1,0,15,14
1746579181787,EDS 290,A00,897211,Hofstetter; Carolyn,0,0,15,15
1746579182817,LIGM 5A,A00,896162,Fischer-Grunski; Eva K,12,0,20,8
1746579183848,LIGM 5B,A00,896260,Fischer-Grunski; Eva K,17,0,20,3
1746579184880,LIGM 5C,A00,896308,Fischer-Grunski; Eva K,18,0,20,2
1746579185907,LIIT 5AS,A00,896313,Carnelos; Chiara,18,0,20,2
1746579186935,LIIT 5BS,A00,896416,Carnelos; Chiara,20,0,20,0
1746579187961,LIIT 5CS,A00,896564,Carnelos; Chiara,20,0,20,0
1746579188992,LISP 5A,A00,896588,Munoz Sanchez; Alicia,2,0,20,18
1746579190023,LISP 5B,A00,896653,Munoz Sanchez; Alicia,7,0,20,13
1746579191052,LISP 5C,A00,896655,Munoz Sanchez; Alicia,0,1,20,20
1746579192081,MAE 197,001,957918,Kleissl; Jan,9996,0,9999,3
1746579192081,MAE 197,002,959806,Boechler; Nicholas Sebastia,9998,0,9999,1
1746579192081,MAE 197,003,959852,Mullin; Jennifer S,9998,0,9999,1
1746579193104,MATH 2,A01,957937,Staff,33,0,35,2
1746579194132,MATH 197,001,957876,Kedlaya; Kiran S.,9993,0,9999,6
1746579195162,MCWP 40,A00,892729,Duru; Nur,10,0,20,10
1746579195162,MCWP 40,B00,893304,Montejo; Carolina,14,0,20,6
1746579196190,MCWP 40R,A00,893757,Redela; Pamela Morgan,0,5,20,20
1746579197220,MCWP 50,A00,893758,Morshed; Michael James,0,0,20,20
1746579197220,MCWP 50,B00,893761,Bartulis; Jason Michael,17,0,20,3
1746579198244,MCWP 50R,A00,893766,Compas; Sean Matthew,0,1,20,20
1746579198244,MCWP 50R,B00,893769,Carter; Jennifer A,0,1,20,20
1746579198244,MCWP 50R,C00,893771,Krone; Jarret,0,3,20,20
1746579198244,MCWP 50R,D00,893772,Miller; Elizabeth Deen,0,0,20,20
1746579198244,MCWP 50R,E00,893775,Carter; Andrea L,0,1,20,20
1746579199277,MMW 11R,A01,892721,Herbst; Matthew,14,0,30,16
1746579199277,MMW 11R,A02,892722,Herbst; Matthew,0,0,0,3
1746579200305,MMW 12R,A01,892724,Herbst; Matthew,0,11,16,16
1746579200305,MMW 12R,A02,892725,Herbst; Matthew,0,10,16,16
1746579201333,MMW 13R,A01,892727,Staff,0,4,16,16
1746579201333,MMW 13R,A02,892728,Staff,0,4,16,16
1746579201333,MMW 13R,A03,958032,Staff,0,4,16,16
1746579201333,MMW 13R,A04,958033,Staff,0,4,16,16
1746579201333,MMW 13R,A05,958034,Staff,0,4,16,16
1746579202360,SIO 295LS,A00,894015,Staff,5,0,25,20
1746579203386,SIO 295S,A00,894020,Staff,5,0,25,20
1746579204416,SIOC 290S,B01,958918,Merrifield; Mark A,14,0,30,16
1746579205447,SIOC 291S,B01,958922,Gabriel; Corey John,14,0,30,16
1746579206469,SOCI 117,A01,895339,Staff,3,0,5,2
1746579207495,WES 237B,A00,894149,Staff,11,0,20,9
1746579209564,AESE 279B,A00,891859,Staff,13,0,35,22
1746579210592,AIP 197,001,891854,Vespa; Emanuel Ignacio,9999,0,9999,0
1746579211616,ANTH 289S,A00,891856,Gagneux; Pascal,12,0,12,0
1746579212641,BENG 196,001,957946,Engler; Adam J.,9996,0,9999,3
1746579213667,BISP 197,001,959851,Wilhelm; James E.,9998,0,9999,1
1746579214693,CAT 124RS,A01,956906,Staff,6,0,25,19
1746579215716,CAT 125RS,A01,922013,Staff,6,0,25,19
1746579216744,CLRE 250,A00,891860,Morris; Sheldon,9995,0,9999,4
1746579218796,CLRE 251R,A00,907817,Mehta; Ravindra L.,9994,0,9999,5
1746579219821,CLRE 252,A00,891864,Cuomo; Raphael Eduardo,9993,0,9999,6
1746579220845,CLRE 253,A00,891867,Vaida; Florin,9994,0,9999,5
1746579220845,CLRE 253,B00,907819,Staff,9999,0,9999,0
1746579221872,CLRE 259,A00,891868,Patel; Hemal,9998,0,9999,1
1746579222897,CLRE 260,A00,891872,Cuomo; Raphael Eduardo,9999,0,9999,0
1746579223925,CLRE 297,001,891888,Cuomo; Raphael Eduardo,9999,0,9999,0
1746579224954,CSE 191,A00,958773,Minnes Kemp; Mor Mia,9995,0,9999,4
1746579225979,CSE 197,001,959846,Minnes Kemp; Mor Mia,9990,0,9999,9
1746579227008,CSS 201S,A01,892054,Mignozzetti; Umberto,25,0,30,5
1746579228036,CSS 202S,A01,892056,Mignozzetti; Umberto,25,0,30,5
1746579229061,DSC 197,001,956898,Eldridge; Justin Matthew,9996,0,9999,3
1746579230087,DSC 297,001,958000,Mazumdar; Arya,9998,0,9999,1
1746579230087,DSC 297,002,959862,Wang; Yusu,9998,0,9999,1
1746579231113,EAP 100,A00,905686,Staff,9778,0,9999,221
1746579232141,ECE 45,A01,892618,Staff,0,0,65,65
1746579234191,ECE 111,A01,892719,Staff,6,0,65,59
1746579235230,ECE 197,001,957920,Mercier; Patrick Philip,9991,0,9999,8
1746579236258,ECON 178,A01,907814,Zhu; Ying,26,0,35,9
1746579237286,EDS 115,A00,895312,Staff,35,0,45,10
1746579238311,EDS 117,A01,895337,Staff,23,0,30,7
1746579239338,EDS 125,A00,895341,Jones; Gabrielle Anastasia,36,0,45,9
1746579240363,EDS 128A,A01,895459,Fargason; Sharon Gayle,44,0,45,1
1746579241389,EDS 128B,A01,895543,Pappas; Elizabeth,44,0,45,1
1746579242419,EDS 139,A00,897203,Pappas; Elizabeth,44,0,45,1
1746579242419,EDS 139,B00,897209,Fargason; Sharon Gayle,41,0,45,4
1746579243445,EDS 201,A00,895545,Staff,22,0,45,23
1746579244468,EDS 203,A01,895581,Halter; Christopher P.,22,0,45,23
1746579245494,EDS 204R,A01,895625,Heinzman; Erica M.,39,0,45,6
1746579245494,EDS 204R,B01,895693,Halter; Christopher P.,10,0,45,35
1746579246519,EDS 206R,A00,895694,Fargason; Sharon Gayle,1,0,30,29
1746579246519,EDS 206R,B00,895695,Choi; Bailey Miyeon,16,0,30,14
1746579247559,EDS 250,A00,895697,Hemans; Patricia Ann Benitez,22,0,45,23
1746579248586,EDS 281,A00,895701,Meyerott; Theresa Ann,1,0,15,14
1746579249611,EDS 284,A00,895736,Meyerott; Theresa Ann,1,0,15,14
1746579250636,EDS 286,A00,897210,Fine; Sarah,0,0,15,15
1746579251660,EDS 289C,A01,895770,Daly; Alan J.,1,0,15,14
1746579252684,EDS 290,A00,897211,Hofstetter; Carolyn,0,0,15,15
1746579253709,LIGM 5A,A00,896162,Fischer-Grunski; Eva K,12,0,20,8
1746579254737,LIGM 5B,A00,896260,Fischer-Grunski; Eva K,17,0,20,3
1746579255762,LIGM 5C,A00,896308,Fischer-Grunski; Eva K,18,0,20,2
1746579256792,LIIT 5AS,A00,896313,Carnelos; Chiara,18,0,20,2
1746579257817,LIIT 5BS,A00,896416,Carnelos; Chiara,20,0,20,0
1746579258844,LIIT 5CS,A00,896564,Carnelos; Chiara,20,0,20,0
1746579259870,LISP 5A,A00,896588,Munoz Sanchez; Alicia,2,0,20,18
1746579260896,LISP 5B,A00,896653,Munoz Sanchez; Alicia,7,0,20,13
1746579261923,LISP 5C,A00,896655,Munoz Sanchez; Alicia,0,1,20,20
1746579262952,MAE 197,001,957918,Kleissl; Jan,9996,0,9999,3
1746579262952,MAE 197,002,959806,Boechler; Nicholas Sebastia,9998,0,9999,1
1746579262952,MAE 197,003,959852,Mullin; Jennifer S,9998,0,9999,1
1746579263980,MATH 2,A01,957937,Staff,33,0,35,2
1746579265008,MATH 197,001,957876,Kedlaya; Kiran S.,9993,0,9999,6
1746579266035,MCWP 40,A00,892729,Duru; Nur,10,0,20,10
1746579266035,MCWP 40,B00,893304,Montejo; Carolina,14,0,20,6
1746579267060,MCWP 40R,A00,893757,Redela; Pamela Morgan,0,5,20,20
1746579268086,MCWP 50,A00,893758,Morshed; Michael James,0,0,20,20
1746579268086,MCWP 50,B00,893761,Bartulis; Jason Michael,17,0,20,3
1746579269112,MCWP 50R,A00,893766,Compas; Sean Matthew,0,1,20,20
1746579269112,MCWP 50R,B00,893769,Carter; Jennifer A,0,1,20,20
1746579269112,MCWP 50R,C00,893771,Krone; Jarret,0,3,20,20
1746579269112,MCWP 50R,D00,893772,Miller; Elizabeth Deen,0,0,20,20
1746579269112,MCWP 50R,E00,893775,Carter; Andrea L,0,1,20,20
1746579270142,MMW 11R,A01,892721,Herbst; Matthew,14,0,30,16
1746579270142,MMW 11R,A02,892722,Herbst; Matthew,0,0,0,3
1746579271167,MMW 12R,A01,892724,Herbst; Matthew,0,11,16,16
1746579271167,MMW 12R,A02,892725,Herbst; Matthew,0,10,16,16
1746579272196,MMW 13R,A01,892727,Staff,0,4,16,16
1746579272196,MMW 13R,A02,892728,Staff,0,4,16,16
1746579272196,MMW 13R,A03,958032,Staff,0,4,16,16
1746579272196,MMW 13R,A04,958033,Staff,0,4,16,16
1746579272196,MMW 13R,A05,958034,Staff,0,4,16,16
1746579273223,SIO 295LS,A00,894015,Staff,5,0,25,20
1746579274251,SIO 295S,A00,894020,Staff,5,0,25,20
1746579275282,SIOC 290S,B01,958918,Merrifield; Mark A,14,0,30,16
1746579276314,SIOC 291S,B01,958922,Gabriel; Corey John,14,0,30,16
1746579277341,SOCI 117,A01,895339,Staff,3,0,5,2
1746579278367,WES 237B,A00,894149,Staff,11,0,20,9
1746579280427,AESE 279B,A00,891859,Staff,13,0,35,22
1746579281452,AIP 197,001,891854,Vespa; Emanuel Ignacio,9999,0,9999,0
1746579282481,ANTH 289S,A00,891856,Gagneux; Pascal,12,0,12,0
1746579283505,BENG 196,001,957946,Engler; Adam J.,9996,0,9999,3
1746579284534,BISP 197,001,959851,Wilhelm; James E.,9998,0,9999,1
1746579285562,CAT 124RS,A01,956906,Staff,6,0,25,19
1746579286590,CAT 125RS,A01,922013,Staff,6,0,25,19
1746579287615,CLRE 250,A00,891860,Morris; Sheldon,9995,0,9999,4
1746579289670,CLRE 251R,A00,907817,Mehta; Ravindra L.,9994,0,9999,5
1746579290699,CLRE 252,A00,891864,Cuomo; Raphael Eduardo,9993,0,9999,6
1746579291725,CLRE 253,A00,891867,Vaida; Florin,9994,0,9999,5
1746579291725,CLRE 253,B00,907819,Staff,9999,0,9999,0
1746579292753,CLRE 259,A00,891868,Patel; Hemal,9998,0,9999,1
1746579293780,CLRE 260,A00,891872,Cuomo; Raphael Eduardo,9999,0,9999,0
1746579294806,CLRE 297,001,891888,Cuomo; Raphael Eduardo,9999,0,9999,0
1746579295831,CSE 191,A00,958773,Minnes Kemp; Mor Mia,9995,0,9999,4
1746579296856,CSE 197,001,959846,Minnes Kemp; Mor Mia,9990,0,9999,9
1746579297885,CSS 201S,A01,892054,Mignozzetti; Umberto,25,0,30,5
1746579298910,CSS 202S,A01,892056,Mignozzetti; Umberto,25,0,30,5
1746579299936,DSC 197,001,956898,Eldridge; Justin Matthew,9996,0,9999,3
1746579300961,DSC 297,001,958000,Mazumdar; Arya,9998,0,9999,1
1746579300961,DSC 297,002,959862,Wang; Yusu,9998,0,9999,1
1746579301989,EAP 100,A00,905686,Staff,9778,0,9999,221
1746579303016,ECE 45,A01,892618,Staff,0,0,65,65
1746579305074,ECE 111,A01,892719,Staff,6,0,65,59
1746579306105,ECE 197,001,957920,Mercier; Patrick Philip,9991,0,9999,8
1746579307134,ECON 178,A01,907814,Zhu; Ying,26,0,35,9
1746579308163,EDS 115,A00,895312,Staff,35,0,45,10
1746579309192,EDS 117,A01,895337,Staff,23,0,30,7
1746579310217,EDS 125,A00,895341,Jones; Gabrielle Anastasia,36,0,45,9
1746579311243,EDS 128A,A01,895459,Fargason; Sharon Gayle,44,0,45,1
1746579312275,EDS 128B,A01,895543,Pappas; Elizabeth,44,0,45,1
1746579313303,EDS 139,A00,897203,Pappas; Elizabeth,44,0,45,1
1746579313303,EDS 139,B00,897209,Fargason; Sharon Gayle,41,0,45,4
1746579314329,EDS 201,A00,895545,Staff,22,0,45,23
1746579315353,EDS 203,A01,895581,Halter; Christopher P.,22,0,45,23
1746579316377,EDS 204R,A01,895625,Heinzman; Erica M.,39,0,45,6
1746579316377,EDS 204R,B01,895693,Halter; Christopher P.,10,0,45,35
1746579317404,EDS 206R,A00,895694,Fargason; Sharon Gayle,1,0,30,29
1746579317404,EDS 206R,B00,895695,Choi; Bailey Miyeon,16,0,30,14
1746579318433,EDS 250,A00,895697,Hemans; Patricia Ann Benitez,22,0,45,23
1746579319458,EDS 281,A00,895701,Meyerott; Theresa Ann,1,0,15,14
1746579320486,EDS 284,A00,895736,Meyerott; Theresa Ann,1,0,15,14
1746579321515,EDS 286,A00,897210,Fine; Sarah,0,0,15,15
1746579322541,EDS 289C,A01,895770,Daly; Alan J.,1,0,15,14
1746579323568,EDS 290,A00,897211,Hofstetter; Carolyn,0,0,15,15
1746579324595,LIGM 5A,A00,896162,Fischer-Grunski; Eva K,12,0,20,8
1746579325622,LIGM 5B,A00,896260,Fischer-Grunski; Eva K,17,0,20,3
1746579326649,LIGM 5C,A00,896308,Fischer-Grunski; Eva K,18,0,20,2
1746579327675,LIIT 5AS,A00,896313,Carnelos; Chiara,18,0,20,2
1746579328700,LIIT 5BS,A00,896416,Carnelos; Chiara,20,0,20,0
1746579329734,LIIT 5CS,A00,896564,Carnelos; Chiara,20,0,20,0
1746579330760,LISP 5A,A00,896588,Munoz Sanchez; Alicia,2,0,20,18
1746579331791,LISP 5B,A00,896653,Munoz Sanchez; Alicia,7,0,20,13
1746579332817,LISP 5C,A00,896655,Munoz Sanchez; Alicia,0,1,20,20
1746579333841,MAE 197,001,957918,Kleissl; Jan,9996,0,9999,3
1746579333841,MAE 197,002,959806,Boechler; Nicholas Sebastia,9998,0,9999,1
1746579333841,MAE 197,003,959852,Mullin; Jennifer S,9998,0,9999,1
1746579334868,MATH 2,A01,957937,Staff,33,0,35,2
1746579335895,MATH 197,001,957876,Kedlaya; Kiran S.,9993,0,9999,6
1746579336946,MCWP 40,A00,892729,Duru; Nur,10,0,20,10
1746579336946,MCWP 40,B00,893304,Montejo; Carolina,14,0,20,6
1746579337973,MCWP 40R,A00,893757,Redela; Pamela Morgan,0,5,20,20
1746579339004,MCWP 50,A00,893758,Morshed; Michael James,0,0,20,20
1746579339004,MCWP 50,B00,893761,Bartulis; Jason Michael,17,0,20,3
1746579340033,MCWP 50R,A00,893766,Compas; Sean Matthew,0,1,20,20
1746579340033,MCWP 50R,B00,893769,Carter; Jennifer A,0,1,20,20
1746579340033,MCWP 50R,C00,893771,Krone; Jarret,0,3,20,20
1746579340033,MCWP 50R,D00,893772,Miller; Elizabeth Deen,0,0,20,20
1746579340033,MCWP 50R,E00,893775,Carter; Andrea L,0,1,20,20
1746579341062,MMW 11R,A01,892721,Herbst; Matthew,14,0,30,16
1746579341062,MMW 11R,A02,892722,Herbst; Matthew,0,0,0,3
1746579342091,MMW 12R,A01,892724,Herbst; Matthew,0,11,16,16
1746579342091,MMW 12R,A02,892725,Herbst; Matthew,0,10,16,16
1746579343118,MMW 13R,A01,892727,Staff,0,4,16,16
1746579343118,MMW 13R,A02,892728,Staff,0,4,16,16
1746579343118,MMW 13R,A03,958032,Staff,0,4,16,16
1746579343118,MMW 13R,A04,958033,Staff,0,4,16,16
1746579343118,MMW 13R,A05,958034,Staff,0,4,16,16
1746579344142,SIO 295LS,A00,894015,Staff,5,0,25,20
1746579345171,SIO 295S,A00,894020,Staff,5,0,25,20
1746579346195,SIOC 290S,B01,958918,Merrifield; Mark A,14,0,30,16
1746579347224,SIOC 291S,B01,958922,Gabriel; Corey John,14,0,30,16
1746579348253,SOCI 117,A01,895339,Staff,3,0,5,2
1746579349279,WES 237B,A00,894149,Staff,11,0,20,9
1746579351340,AESE 279B,A00,891859,Staff,13,0,35,22
1746579352364,AIP 197,001,891854,Vespa; Emanuel Ignacio,9999,0,9999,0
1746579353392,ANTH 289S,A00,891856,Gagneux; Pascal,12,0,12,0
1746579354417,BENG 196,001,957946,Engler; Adam J.,9996,0,9999,3
1746579355441,BISP 197,001,959851,Wilhelm; James E.,9998,0,9999,1
1746579356468,CAT 124RS,A01,956906,Staff,6,0,25,19
1746579357497,CAT 125RS,A01,922013,Staff,6,0,25,19
1746579358525,CLRE 250,A00,891860,Morris; Sheldon,9995,0,9999,4
1746579360583,CLRE 251R,A00,907817,Mehta; Ravindra L.,9994,0,9999,5
1746579361609,CLRE 252,A00,891864,Cuomo; Raphael Eduardo,9993,0,9999,6
1746579362634,CLRE 253,A00,891867,Vaida; Florin,9994,0,9999,5
1746579362634,CLRE 253,B00,907819,Staff,9999,0,9999,0
1746579363659,CLRE 259,A00,891868,Patel; Hemal,9998,0,9999,1
1746579364685,CLRE 260,A00,891872,Cuomo; Raphael Eduardo,9999,0,9999,0
1746579365725,CLRE 297,001,891888,Cuomo; Raphael Eduardo,9999,0,9999,0
1746579366753,CSE 191,A00,958773,Minnes Kemp; Mor Mia,9995,0,9999,4
1746579367781,CSE 197,001,959846,Minnes Kemp; Mor Mia,9990,0,9999,9
1746579368811,CSS 201S,A01,892054,Mignozzetti; Umberto,25,0,30,5
1746579369836,CSS 202S,A01,892056,Mignozzetti; Umberto,25,0,30,5
1746579370863,DSC 197,001,956898,Eldridge; Justin Matthew,9996,0,9999,3
1746579371887,DSC 297,001,958000,Mazumdar; Arya,9998,0,9999,1
1746579371887,DSC 297,002,959862,Wang; Yusu,9998,0,9999,1
1746579372916,EAP 100,A00,905686,Staff,9778,0,9999,221
1746579373946,ECE 45,A01,892618,Staff,0,0,65,65
1746579376000,ECE 111,A01,892719,Staff,6,0,65,59
1746579377025,ECE 197,001,957920,Mercier; Patrick Philip,9991,0,9999,8
1746579378051,ECON 178,A01,907814,Zhu; Ying,26,0,35,9
1746579379077,EDS 115,A00,895312,Staff,35,0,45,10
1746579380107,EDS 117,A01,895337,Staff,23,0,30,7
1746579381137,EDS 125,A00,895341,Jones; Gabrielle Anastasia,36,0,45,9
1746579382162,EDS 128A,A01,895459,Fargason; Sharon Gayle,44,0,45,1
1746579383191,EDS 128B,A01,895543,Pappas; Elizabeth,44,0,45,1
1746579384220,EDS 139,A00,897203,Pappas; Elizabeth,44,0,45,1
1746579384220,EDS 139,B00,897209,Fargason; Sharon Gayle,41,0,45,4
1746579385248,EDS 201,A00,895545,Staff,22,0,45,23
1746579386273,EDS 203,A01,895581,Halter; Christopher P.,22,0,45,23
1746579387301,EDS 204R,A01,895625,Heinzman; Erica M.,39,0,45,6
1746579387301,EDS 204R,B01,895693,Halter; Christopher P.,10,0,45,35
1746579388328,EDS 206R,A00,895694,Fargason; Sharon Gayle,1,0,30,29
1746579388328,EDS 206R,B00,895695,Choi; Bailey Miyeon,16,0,30,14
1746579389355,EDS 250,A00,895697,Hemans; Patricia Ann Benitez,22,0,45,23
1746579390381,EDS 281,A00,895701,Meyerott; Theresa Ann,1,0,15,14
1746579391408,EDS 284,A00,895736,Meyerott; Theresa Ann,1,0,15,14
1746579392436,EDS 286,A00,897210,Fine; Sarah,0,0,15,15
1746579393464,EDS 289C,A01,895770,Daly; Alan J.,1,0,15,14
1746579394489,EDS 290,A00,897211,Hofstetter; Carolyn,0,0,15,15
1746579395513,LIGM 5A,A00,896162,Fischer-Grunski; Eva K,12,0,20,8
1746579396540,LIGM 5B,A00,896260,Fischer-Grunski; Eva K,17,0,20,3
1746579397569,LIGM 5C,A00,896308,Fischer-Grunski; Eva K,18,0,20,2
1746579398595,LIIT 5AS,A00,896313,Carnelos; Chiara,18,0,20,2
1746579399621,LIIT 5BS,A00,896416,Carnelos; Chiara,20,0,20,0
1746579400650,LIIT 5CS,A00,896564,Carnelos; Chiara,20,0,20,0
1746579401676,LISP 5A,A00,896588,Munoz Sanchez; Alicia,2,0,20,18
1746579402703,LISP 5B,A00,896653,Munoz Sanchez; Alicia,7,0,20,13
1746579403729,LISP 5C,A00,896655,Munoz Sanchez; Alicia,0,1,20,20
1746579404757,MAE 197,001,957918,Kleissl; Jan,9996,0,9999,3
1746579404757,MAE 197,002,959806,Boechler; Nicholas Sebastia,9998,0,9999,1
1746579404757,MAE 197,003,959852,Mullin; Jennifer S,9998,0,9999,1
1746579405781,MATH 2,A01,957937,Staff,33,0,35,2
1746579406807,MATH 197,001,957876,Kedlaya; Kiran S.,9993,0,9999,6
1746579407833,MCWP 40,A00,892729,Duru; Nur,10,0,20,10
1746579407833,MCWP 40,B00,893304,Montejo; Carolina,14,0,20,6
1746579408859,MCWP 40R,A00,893757,Redela; Pamela Morgan,0,5,20,20
1746579409884,MCWP 50,A00,893758,Morshed; Michael James,0,0,20,20
1746579409884,MCWP 50,B00,893761,Bartulis; Jason Michael,17,0,20,3
1746579410910,MCWP 50R,A00,893766,Compas; Sean Matthew,0,1,20,20
1746579410910,MCWP 50R,B00,893769,Carter; Jennifer A,0,1,20,20
1746579410910,MCWP 50R,C00,893771,Krone; Jarret,0,3,20,20
1746579410910,MCWP 50R,D00,893772,Miller; Elizabeth Deen,0,0,20,20
1746579410910,MCWP 50R,E00,893775,Carter; Andrea L,0,1,20,20
1746579411935,MMW 11R,A01,892721,Herbst; Matthew,14,0,30,16
1746579411935,MMW 11R,A02,892722,Herbst; Matthew,0,0,0,3
1746579412959,MMW 12R,A01,892724,Herbst; Matthew,0,11,16,16
1746579412959,MMW 12R,A02,892725,Herbst; Matthew,0,10,16,16
1746579413983,MMW 13R,A01,892727,Staff,0,4,16,16
1746579413983,MMW 13R,A02,892728,Staff,0,4,16,16
1746579413983,MMW 13R,A03,958032,Staff,0,4,16,16
1746579413983,MMW 13R,A04,958033,Staff,0,4,16,16
1746579413983,MMW 13R,A05,958034,Staff,0,4,16,16
1746579415011,SIO 295LS,A00,894015,Staff,5,0,25,20
1746579416038,SIO 295S,A00,894020,Staff,5,0,25,20
1746579417062,SIOC 290S,B01,958918,Merrifield; Mark A,14,0,30,16
1746579418087,SIOC 291S,B01,958922,Gabriel; Corey John,14,0,30,16
1746579419115,SOCI 117,A01,895339,Staff,3,0,5,2
1746579420141,WES 237B,A00,894149,Staff,11,0,20,9
1746579422206,AESE 279B,A00,891859,Staff,13,0,35,22
1746579423235,AIP 197,001,891854,Vespa; Emanuel Ignacio,9999,0,9999,0
1746579424261,ANTH 289S,A00,891856,Gagneux; Pascal,12,0,12,0
1746579425288,BENG 196,001,957946,Engler; Adam J.,9996,0,9999,3
1746579426315,BISP 197,001,959851,Wilhelm; James E.,9998,0,9999,1
1746579427339,CAT 124RS,A01,956906,Staff,6,0,25,19
1746579428365,CAT 125RS,A01,922013,Staff,6,0,25,19
1746579429388,CLRE 250,A00,891860,Morris; Sheldon,9995,0,9999,4
1746579431448,CLRE 251R,A00,907817,Mehta; Ravindra L.,9994,0,9999,5
1746579432474,CLRE 252,A00,891864,Cuomo; Raphael Eduardo,9993,0,9999,6
1746579433498,CLRE 253,A00,891867,Vaida; Florin,9994,0,9999,5
1746579433498,CLRE 253,B00,907819,Staff,9999,0,9999,0
1746579434522,CLRE 259,A00,891868,Patel; Hemal,9998,0,9999,1
1746579435550,CLRE 260,A00,891872,Cuomo; Raphael Eduardo,9999,0,9999,0
1746579436575,CLRE 297,001,891888,Cuomo; Raphael Eduardo,9999,0,9999,0
1746579437600,CSE 191,A00,958773,Minnes Kemp; Mor Mia,9995,0,9999,4
1746579438624,CSE 197,001,959846,Minnes Kemp; Mor Mia,9990,0,9999,9
1746579439651,CSS 201S,A01,892054,Mignozzetti; Umberto,25,0,30,5
1746579440676,CSS 202S,A01,892056,Mignozzetti; Umberto,25,0,30,5
1746579441700,DSC 197,001,956898,Eldridge; Justin Matthew,9996,0,9999,3
1746579442725,DSC 297,001,958000,Mazumdar; Arya,9998,0,9999,1
1746579442725,DSC 297,002,959862,Wang; Yusu,9998,0,9999,1
1746579443750,EAP 100,A00,905686,Staff,9778,0,9999,221
1746579444781,ECE 45,A01,892618,Staff,0,0,65,65
1746579446834,ECE 111,A01,892719,Staff,6,0,65,59
1746579447858,ECE 197,001,957920,Mercier; Patrick Philip,9991,0,9999,8
1746579448884,ECON 178,A01,907814,Zhu; Ying,26,0,35,9
1746579449909,EDS 115,A00,895312,Staff,35,0,45,10
1746579450935,EDS 117,A01,895337,Staff,23,0,30,7
1746579451960,EDS 125,A00,895341,Jones; Gabrielle Anastasia,36,0,45,9
1746579452984,EDS 128A,A01,895459,Fargason; Sharon Gayle,44,0,45,1
1746579454014,EDS 128B,A01,895543,Pappas; Elizabeth,44,0,45,1
1746579455040,EDS 139,A00,897203,Pappas; Elizabeth,44,0,45,1
1746579455040,EDS 139,B00,897209,Fargason; Sharon Gayle,41,0,45,4
1746579456067,EDS 201,A00,895545,Staff,22,0,45,23
1746579457092,EDS 203,A01,895581,Halter; Christopher P.,22,0,45,23
1746579458120,EDS 204R,A01,895625,Heinzman; Erica M.,39,0,45,6
1746579458120,EDS 204R,B01,895693,Halter; Christopher P.,10,0,45,35
1746579459144,EDS 206R,A00,895694,Fargason; Sharon Gayle,1,0,30,29
1746579459144,EDS 206R,B00,895695,Choi; Bailey Miyeon,16,0,30,14
1746579460169,EDS 250,A00,895697,Hemans; Patricia Ann Benitez,22,0,45,23
1746579461196,EDS 281,A00,895701,Meyerott; Theresa Ann,1,0,15,14
1746579462227,EDS 284,A00,895736,Meyerott; Theresa Ann,1,0,15,14
1746579463250,EDS 286,A00,897210,Fine; Sarah,0,0,15,15
1746579464280,EDS 289C,A01,895770,Daly; Alan J.,1,0,15,14
1746579465307,EDS 290,A00,897211,Hofstetter; Carolyn,0,0,15,15
1746579466335,LIGM 5A,A00,896162,Fischer-Grunski; Eva K,12,0,20,8
1746579467360,LIGM 5B,A00,896260,Fischer-Grunski; Eva K,17,0,20,3
1746579468390,LIGM 5C,A00,896308,Fischer-Grunski; Eva K,18,0,20,2
1746579469419,LIIT 5AS,A00,896313,Carnelos; Chiara,18,0,20,2
1746579470445,LIIT 5BS,A00,896416,Carnelos; Chiara,20,0,20,0
1746579471471,LIIT 5CS,A00,896564,Carnelos; Chiara,20,0,20,0
1746579472499,LISP 5A,A00,896588,Munoz Sanchez; Alicia,2,0,20,18
1746579473526,LISP 5B,A00,896653,Munoz Sanchez; Alicia,7,0,20,13
1746579474556,LISP 5C,A00,896655,Munoz Sanchez; Alicia,0,1,20,20
1746579475586,MAE 197,001,957918,Kleissl; Jan,9996,0,9999,3
1746579475586,MAE 197,002,959806,Boechler; Nicholas Sebastia,9998,0,9999,1
1746579475586,MAE 197,003,959852,Mullin; Jennifer S,9998,0,9999,1
1746579476615,MATH 2,A01,957937,Staff,33,0,35,2
1746579477644,MATH 197,001,957876,Kedlaya; Kiran S.,9993,0,9999,6
1746579478670,MCWP 40,A00,892729,Duru; Nur,10,0,20,10
1746579478670,MCWP 40,B00,893304,Montejo; Carolina,14,0,20,6
1746579479700,MCWP 40R,A00,893757,Redela; Pamela Morgan,0,5,20,20
1746579480725,MCWP 50,A00,893758,Morshed; Michael James,0,0,20,20
1746579480725,MCWP 50,B00,893761,Bartulis; Jason Michael,17,0,20,3
1746579481752,MCWP 50R,A00,893766,Compas; Sean Matthew,0,1,20,20
1746579481752,MCWP 50R,B00,893769,Carter; Jennifer A,0,1,20,20
1746579481752,MCWP 50R,C00,893771,Krone; Jarret,0,3,20,20
1746579481752,MCWP 50R,D00,893772,Miller; Elizabeth Deen,0,0,20,20
1746579481752,MCWP 50R,E00,893775,Carter; Andrea L,0,1,20,20
1746579482778,MMW 11R,A01,892721,Herbst; Matthew,14,0,30,16
1746579482778,MMW 11R,A02,892722,Herbst; Matthew,0,0,0,3
1746579483804,MMW 12R,A01,892724,Herbst; Matthew,0,11,16,16
1746579483804,MMW 12R,A02,892725,Herbst; Matthew,0,10,16,16
1746579484829,MMW 13R,A01,892727,Staff,0,4,16,16
1746579484829,MMW 13R,A02,892728,Staff,0,4,16,16
1746579484829,MMW 13R,A03,958032,Staff,0,4,16,16
1746579484829,MMW 13R,A04,958033,Staff,0,4,16,16
1746579484829,MMW 13R,A05,958034,Staff,0,4,16,16
1746579485856,SIO 295LS,A00,894015,Staff,5,0,25,20
1746579486886,SIO 295S,A00,894020,Staff,5,0,25,20
1746579487913,SIOC 290S,B01,958918,Merrifield; Mark A,14,0,30,16
1746579488945,SIOC 291S,B01,958922,Gabriel; Corey John,14,0,30,16
1746579489971,SOCI 117,A01,895339,Staff,3,0,5,2
1746579491002,WES 237B,A00,894149,Staff,11,0,20,9
1746579493062,AESE 279B,A00,891859,Staff,13,0,35,22
1746579494086,AIP 197,001,891854,Vespa; Emanuel Ignacio,9999,0,9999,0
1746579495114,ANTH 289S,A00,891856,Gagneux; Pascal,12,0,12,0
1746579496142,BENG 196,001,957946,Engler; Adam J.,9996,0,9999,3
1746579497171,BISP 197,001,959851,Wilhelm; James E.,9998,0,9999,1
1746579498195,CAT 124RS,A01,956906,Staff,6,0,25,19
1746579499219,CAT 125RS,A01,922013,Staff,6,0,25,19
1746579500244,CLRE 250,A00,891860,Morris; Sheldon,9995,0,9999,4
1746579502300,CLRE 251R,A00,907817,Mehta; Ravindra L.,9994,0,9999,5
1746579503330,CLRE 252,A00,891864,Cuomo; Raphael Eduardo,9993,0,9999,6
1746579504359,CLRE 253,A00,891867,Vaida; Florin,9994,0,9999,5
1746579504359,CLRE 253,B00,907819,Staff,9999,0,9999,0
1746579505383,CLRE 259,A00,891868,Patel; Hemal,9998,0,9999,1
1746579506411,CLRE 260,A00,891872,Cuomo; Raphael Eduardo,9999,0,9999,0
1746579507436,CLRE 297,001,891888,Cuomo; Raphael Eduardo,9999,0,9999,0
1746579508461,CSE 191,A00,958773,Minnes Kemp; Mor Mia,9995,0,9999,4
1746579509488,CSE 197,001,959846,Minnes Kemp; Mor Mia,9990,0,9999,9
1746579510518,CSS 201S,A01,892054,Mignozzetti; Umberto,25,0,30,5
1746579511543,CSS 202S,A01,892056,Mignozzetti; Umberto,25,0,30,5
1746579512572,DSC 197,001,956898,Eldridge; Justin Matthew,9996,0,9999,3
1746579513598,DSC 297,001,958000,Mazumdar; Arya,9998,0,9999,1
1746579513598,DSC 297,002,959862,Wang; Yusu,9998,0,9999,1
1746579514624,EAP 100,A00,905686,Staff,9778,0,9999,221
1746579515655,ECE 45,A01,892618,Staff,0,0,65,65
1746579517715,ECE 111,A01,892719,Staff,6,0,65,59
1746579518743,ECE 197,001,957920,Mercier; Patrick Philip,9991,0,9999,8
1746579519770,ECON 178,A01,907814,Zhu; Ying,26,0,35,9
1746579520796,EDS 115,A00,895312,Staff,35,0,45,10
1746579521822,EDS 117,A01,895337,Staff,23,0,30,7
1746579522849,EDS 125,A00,895341,Jones; Gabrielle Anastasia,36,0,45,9
1746579523875,EDS 128A,A01,895459,Fargason; Sharon Gayle,44,0,45,1
1746579524900,EDS 128B,A01,895543,Pappas; Elizabeth,44,0,45,1
1746579525930,EDS 139,A00,897203,Pappas; Elizabeth,44,0,45,1
1746579525930,EDS 139,B00,897209,Fargason; Sharon Gayle,41,0,45,4
1746579526958,EDS 201,A00,895545,Staff,22,0,45,23
1746579527982,EDS 203,A01,895581,Halter; Christopher P.,22,0,45,23
1746579529013,EDS 204R,A01,895625,Heinzman; Erica M.,39,0,45,6
1746579529013,EDS 204R,B01,895693,Halter; Christopher P.,10,0,45,35
1746579530038,EDS 206R,A00,895694,Fargason; Sharon Gayle,1,0,30,29
1746579530038,EDS 206R,B00,895695,Choi; Bailey Miyeon,16,0,30,14
1746579531068,EDS 250,A00,895697,Hemans; Patricia Ann Benitez,22,0,45,23
1746579532093,EDS 281,A00,895701,Meyerott; Theresa Ann,1,0,15,14
1746579533119,EDS 284,A00,895736,Meyerott; Theresa Ann,1,0,15,14
1746579534147,EDS 286,A00,897210,Fine; Sarah,0,0,15,15
1746579535198,EDS 289C,A01,895770,Daly; Alan J.,1,0,15,14
1746579536224,EDS 290,A00,897211,Hofstetter; Carolyn,0,0,15,15
1746579537252,LIGM 5A,A00,896162,Fischer-Grunski; Eva K,12,0,20,8
1746579538279,LIGM 5B,A00,896260,Fischer-Grunski; Eva K,17,0,20,3
1746579539305,LIGM 5C,A00,896308,Fischer-Grunski; Eva K,18,0,20,2
1746579540330,LIIT 5AS,A00,896313,Carnelos; Chiara,18,0,20,2
1746579541355,LIIT 5BS,A00,896416,Carnelos; Chiara,20,0,20,0
1746579542382,LIIT 5CS,A00,896564,Carnelos; Chiara,20,0,20,0
1746579543417,LISP 5A,A00,896588,Munoz Sanchez; Alicia,2,0,20,18
1746579544441,LISP 5B,A00,896653,Munoz Sanchez; Alicia,7,0,20,13
1746579545470,LISP 5C,A00,896655,Munoz Sanchez; Alicia,0,1,20,20
1746579546495,MAE 197,001,957918,Kleissl; Jan,9996,0,9999,3
1746579546495,MAE 197,002,959806,Boechler; Nicholas Sebastia,9998,0,9999,1
1746579546495,MAE 197,003,959852,Mullin; Jennifer S,9998,0,9999,1
1746579547519,MATH 2,A01,957937,Staff,33,0,35,2
1746579548544,MATH 197,001,957876,Kedlaya; Kiran S.,9993,0,9999,6
1746579549573,MCWP 40,A00,892729,Duru; Nur,10,0,20,10
1746579549573,MCWP 40,B00,893304,Montejo; Carolina,14,0,20,6
1746579550603,MCWP 40R,A00,893757,Redela; Pamela Morgan,0,5,20,20
1746579551638,MCWP 50,A00,893758,Morshed; Michael James,0,0,20,20
1746579551638,MCWP 50,B00,893761,Bartulis; Jason Michael,17,0,20,3
1746579552664,MCWP 50R,A00,893766,Compas; Sean Matthew,0,1,20,20
1746579552664,MCWP 50R,B00,893769,Carter; Jennifer A,0,1,20,20
1746579552664,MCWP 50R,C00,893771,Krone; Jarret,0,3,20,20
1746579552664,MCWP 50R,D00,893772,Miller; Elizabeth Deen,0,0,20,20
1746579552664,MCWP 50R,E00,893775,Carter; Andrea L,0,1,20,20
1746579553691,MMW 11R,A01,892721,Herbst; Matthew,14,0,30,16
1746579553691,MMW 11R,A02,892722,Herbst; Matthew,0,0,0,3
1746579554718,MMW 12R,A01,892724,Herbst; Matthew,0,11,16,16
1746579554718,MMW 12R,A02,892725,Herbst; Matthew,0,10,16,16
1746579555745,MMW 13R,A01,892727,Staff,0,4,16,16
1746579555745,MMW 13R,A02,892728,Staff,0,4,16,16
1746579555745,MMW 13R,A03,958032,Staff,0,4,16,16
1746579555745,MMW 13R,A04,958033,Staff,0,4,16,16
1746579555745,MMW 13R,A05,958034,Staff,0,4,16,16
1746579556770,SIO 295LS,A00,894015,Staff,5,0,25,20
1746579557799,SIO 295S,A00,894020,Staff,5,0,25,20
1746579558827,SIOC 290S,B01,958918,Merrifield; Mark A,14,0,30,16
1746579559858,SIOC 291S,B01,958922,Gabriel; Corey John,14,0,30,16
1746579560882,SOCI 117,A01,895339,Staff,3,0,5,2
1746579561906,WES 237B,A00,894149,Staff,11,0,20,9
1746579563968,AESE 279B,A00,891859,Staff,13,0,35,22
1746579564994,AIP 197,001,891854,Vespa; Emanuel Ignacio,9999,0,9999,0
1746579566021,ANTH 289S,A00,891856,Gagneux; Pascal,12,0,12,0
1746579567045,BENG 196,001,957946,Engler; Adam J.,9996,0,9999,3
1746579568073,BISP 197,001,959851,Wilhelm; James E.,9998,0,9999,1
1746579569101,CAT 124RS,A01,956906,Staff,6,0,25,19
1746579570127,CAT 125RS,A01,922013,Staff,6,0,25,19
1746579571151,CLRE 250,A00,891860,Morris; Sheldon,9995,0,9999,4
1746579573204,CLRE 251R,A00,907817,Mehta; Ravindra L.,9994,0,9999,5
1746579574229,CLRE 252,A00,891864,Cuomo; Raphael Eduardo,9993,0,9999,6
1746579575256,CLRE 253,A00,891867,Vaida; Florin,9994,0,9999,5
1746579575256,CLRE 253,B00,907819,Staff,9999,0,9999,0
1746579576284,CLRE 259,A00,891868,Patel; Hemal,9998,0,9999,1
1746579577307,CLRE 260,A00,891872,Cuomo; Raphael Eduardo,9999,0,9999,0
1746579578335,CLRE 297,001,891888,Cuomo; Raphael Eduardo,9999,0,9999,0
1746579579363,CSE 191,A00,958773,Minnes Kemp; Mor Mia,9995,0,9999,4
1746579580387,CSE 197,001,959846,Minnes Kemp; Mor Mia,9990,0,9999,9
1746579581416,CSS 201S,A01,892054,Mignozzetti; Umberto,25,0,30,5
1746579582483,CSS 202S,A01,892056,Mignozzetti; Umberto,25,0,30,5
1746579583508,DSC 197,001,956898,Eldridge; Justin Matthew,9996,0,9999,3
1746579584535,DSC 297,001,958000,Mazumdar; Arya,9998,0,9999,1
1746579584535,DSC 297,002,959862,Wang; Yusu,9998,0,9999,1
1746579585563,EAP 100,A00,905686,Staff,9778,0,9999,221
1746579586591,ECE 45,A01,892618,Staff,0,0,65,65
1746579588644,ECE 111,A01,892719,Staff,6,0,65,59
1746579589672,ECE 197,001,957920,Mercier; Patrick Philip,9991,0,9999,8
1746579590696,ECON 178,A01,907814,Zhu; Ying,26,0,35,9
1746579591722,EDS 115,A00,895312,Staff,35,0,45,10
1746579592751,EDS 117,A01,895337,Staff,23,0,30,7
1746579593781,EDS 125,A00,895341,Jones; Gabrielle Anastasia,36,0,45,9
1746579594807,EDS 128A,A01,895459,Fargason; Sharon Gayle,44,0,45,1
1746579595836,EDS 128B,A01,895543,Pappas; Elizabeth,44,0,45,1
1746579596863,EDS 139,A00,897203,Pappas; Elizabeth,44,0,45,1
1746579596863,EDS 139,B00,897209,Fargason; Sharon Gayle,41,0,45,4
1746579597890,EDS 201,A00,895545,Staff,22,0,45,23
1746579598922,EDS 203,A01,895581,Halter; Christopher P.,22,0,45,23
1746579599947,EDS 204R,A01,895625,Heinzman; Erica M.,39,0,45,6
1746579599947,EDS 204R,B01,895693,Halter; Christopher P.,10,0,45,35
1746579600971,EDS 206R,A00,895694,Fargason; Sharon Gayle,1,0,30,29
1746579600971,EDS 206R,B00,895695,Choi; Bailey Miyeon,16,0,30,14
1746579601996,EDS 250,A00,895697,Hemans; Patricia Ann Benitez,22,0,45,23
1746579603021,EDS 281,A00,895701,Meyerott; Theresa Ann,1,0,15,14
1746579604050,EDS 284,A00,895736,Meyerott; Theresa Ann,1,0,15,14
1746579605080,EDS 286,A00,897210,Fine; Sarah,0,0,15,15
1746579606104,EDS 289C,A01,895770,Daly; Alan J.,1,0,15,14
1746579607133,EDS 290,A00,897211,Hofstetter; Carolyn,0,0,15,15
1746579608162,LIGM 5A,A00,896162,Fischer-Grunski; Eva K,12,0,20,8
1746579609193,LIGM 5B,A00,896260,Fischer-Grunski; Eva K,17,0,20,3
1746579610223,LIGM 5C,A00,896308,Fischer-Grunski; Eva K,18,0,20,2
1746579611252,LIIT 5AS,A00,896313,Carnelos; Chiara,18,0,20,2
1746579612282,LIIT 5BS,A00,896416,Carnelos; Chiara,20,0,20,0
1746579613311,LIIT 5CS,A00,896564,Carnelos; Chiara,20,0,20,0
1746579614340,LISP 5A,A00,896588,Munoz Sanchez; Alicia,2,0,20,18
1746579615369,LISP 5B,A00,896653,Munoz Sanchez; Alicia,7,0,20,13
1746579616395,LISP 5C,A00,896655,Munoz Sanchez; Alicia,0,1,20,20
1746579617423,MAE 197,001,957918,Kleissl; Jan,9996,0,9999,3
1746579617423,MAE 197,002,959806,Boechler; Nicholas Sebastia,9998,0,9999,1
1746579617423,MAE 197,003,959852,Mullin; Jennifer S,9998,0,9999,1
1746579618448,MATH 2,A01,957937,Staff,33,0,35,2
1746579619474,MATH 197,001,957876,Kedlaya; Kiran S.,9993,0,9999,6
1746579620501,MCWP 40,A00,892729,Duru; Nur,10,0,20,10
1746579620501,MCWP 40,B00,893304,Montejo; Carolina,14,0,20,6
1746579621526,MCWP 40R,A00,893757,Redela; Pamela Morgan,0,5,20,20
1746579622550,MCWP 50,A00,893758,Morshed; Michael James,0,0,20,20
1746579622550,MCWP 50,B00,893761,Bartulis; Jason Michael,17,0,20,3
1746579623575,MCWP 50R,A00,893766,Compas; Sean Matthew,0,1,20,20
1746579623575,MCWP 50R,B00,893769,Carter; Jennifer A,0,1,20,20
1746579623575,MCWP 50R,C00,893771,Krone; Jarret,0,3,20,20
1746579623575,MCWP 50R,D00,893772,Miller; Elizabeth Deen,0,0,20,20
1746579623575,MCWP 50R,E00,893775,Carter; Andrea L,0,1,20,20
1746579624603,MMW 11R,A01,892721,Herbst; Matthew,14,0,30,16
1746579624603,MMW 11R,A02,892722,Herbst; Matthew,0,0,0,3
1746579625628,MMW 12R,A01,892724,Herbst; Matthew,0,11,16,16
1746579625628,MMW 12R,A02,892725,Herbst; Matthew,0,10,16,16
1746579626655,MMW 13R,A01,892727,Staff,0,4,16,16
1746579626655,MMW 13R,A02,892728,Staff,0,4,16,16
1746579626655,MMW 13R,A03,958032,Staff,0,4,16,16
1746579626655,MMW 13R,A04,958033,Staff,0,4,16,16
1746579626655,MMW 13R,A05,958034,Staff,0,4,16,16
1746579627681,SIO 295LS,A00,894015,Staff,5,0,25,20
1746579628707,SIO 295S,A00,894020,Staff,5,0,25,20
1746579629732,SIOC 290S,B01,958918,Merrifield; Mark A,14,0,30,16
1746579630762,SIOC 291S,B01,958922,Gabriel; Corey John,14,0,30,16
1746579631788,SOCI 117,A01,895339,Staff,3,0,5,2
1746579632816,WES 237B,A00,894149,Staff,11,0,20,9
1746579634873,AESE 279B,A00,891859,Staff,13,0,35,22
1746579635901,AIP 197,001,891854,Vespa; Emanuel Ignacio,9999,0,9999,0
1746579636930,ANTH 289S,A00,891856,Gagneux; Pascal,12,0,12,0
1746579637957,BENG 196,001,957946,Engler; Adam J.,9996,0,9999,3
1746579638983,BISP 197,001,959851,Wilhelm; James E.,9998,0,9999,1
1746579640012,CAT 124RS,A01,956906,Staff,6,0,25,19
1746579641036,CAT 125RS,A01,922013,Staff,6,0,25,19
1746579642061,CLRE 250,A00,891860,Morris; Sheldon,9995,0,9999,4
1746579644114,CLRE 251R,A00,907817,Mehta; Ravindra L.,9994,0,9999,5
1746579645140,CLRE 252,A00,891864,Cuomo; Raphael Eduardo,9993,0,9999,6
1746579646167,CLRE 253,A00,891867,Vaida; Florin,9994,0,9999,5
1746579646167,CLRE 253,B00,907819,Staff,9999,0,9999,0
1746579647195,CLRE 259,A00,891868,Patel; Hemal,9998,0,9999,1
1746579648221,CLRE 260,A00,891872,Cuomo; Raphael Eduardo,9999,0,9999,0
1746579649246,CLRE 297,001,891888,Cuomo; Raphael Eduardo,9999,0,9999,0
1746579650274,CSE 191,A00,958773,Minnes Kemp; Mor Mia,9995,0,9999,4
1746579651299,CSE 197,001,959846,Minnes Kemp; Mor Mia,9990,0,9999,9
1746579652327,CSS 201S,A01,892054,Mignozzetti; Umberto,25,0,30,5
1746579653351,CSS 202S,A01,892056,Mignozzetti; Umberto,25,0,30,5
1746579654379,DSC 197,001,956898,Eldridge; Justin Matthew,9996,0,9999,3
1746579655404,DSC 297,001,958000,Mazumdar; Arya,9998,0,9999,1
1746579655404,DSC 297,002,959862,Wang; Yusu,9998,0,9999,1
1746579656432,EAP 100,A00,905686,Staff,9778,0,9999,221
1746579657458,ECE 45,A01,892618,Staff,0,0,65,65
1746579659513,ECE 111,A01,892719,Staff,6,0,65,59
1746579660540,ECE 197,001,957920,Mercier; Patrick Philip,9991,0,9999,8
1746579661564,ECON 178,A01,907814,Zhu; Ying,26,0,35,9
1746579662591,EDS 115,A00,895312,Staff,35,0,45,10
1746579663621,EDS 117,A01,895337,Staff,23,0,30,7
1746579664650,EDS 125,A00,895341,Jones; Gabrielle Anastasia,36,0,45,9
1746579665680,EDS 128A,A01,895459,Fargason; Sharon Gayle,44,0,45,1
1746579666711,EDS 128B,A01,895543,Pappas; Elizabeth,44,0,45,1
1746579667739,EDS 139,A00,897203,Pappas; Elizabeth,44,0,45,1
1746579667739,EDS 139,B00,897209,Fargason; Sharon Gayle,41,0,45,4
1746579668763,EDS 201,A00,895545,Staff,22,0,45,23
1746579669789,EDS 203,A01,895581,Halter; Christopher P.,22,0,45,23
1746579670821,EDS 204R,A01,895625,Heinzman; Erica M.,39,0,45,6
1746579670821,EDS 204R,B01,895693,Halter; Christopher P.,10,0,45,35
1746579671847,EDS 206R,A00,895694,Fargason; Sharon Gayle,1,0,30,29
1746579671847,EDS 206R,B00,895695,Choi; Bailey Miyeon,16,0,30,14
1746579672877,EDS 250,A00,895697,Hemans; Patricia Ann Benitez,22,0,45,23
1746579673906,EDS 281,A00,895701,Meyerott; Theresa Ann,1,0,15,14
1746579674934,EDS 284,A00,895736,Meyerott; Theresa Ann,1,0,15,14
1746579675963,EDS 286,A00,897210,Fine; Sarah,0,0,15,15
1746579676989,EDS 289C,A01,895770,Daly; Alan J.,1,0,15,14
1746579678015,EDS 290,A00,897211,Hofstetter; Carolyn,0,0,15,15
1746579679044,LIGM 5A,A00,896162,Fischer-Grunski; Eva K,12,0,20,8
1746579680074,LIGM 5B,A00,896260,Fischer-Grunski; Eva K,17,0,20,3
1746579681104,LIGM 5C,A00,896308,Fischer-Grunski; Eva K,18,0,20,2
1746579682131,LIIT 5AS,A00,896313,Carnelos; Chiara,18,0,20,2
1746579683158,LIIT 5BS,A00,896416,Carnelos; Chiara,20,0,20,0
1746579684184,LIIT 5CS,A00,896564,Carnelos; Chiara,20,0,20,0
1746579685211,LISP 5A,A00,896588,Munoz Sanchez; Alicia,2,0,20,18
1746579686239,LISP 5B,A00,896653,Munoz Sanchez; Alicia,7,0,20,13
1746579687268,LISP 5C,A00,896655,Munoz Sanchez; Alicia,0,1,20,20
1746579688293,MAE 197,001,957918,Kleissl; Jan,9996,0,9999,3
1746579688293,MAE 197,002,959806,Boechler; Nicholas Sebastia,9998,0,9999,1
1746579688293,MAE 197,003,959852,Mullin; Jennifer S,9998,0,9999,1
1746579689323,MATH 2,A01,957937,Staff,33,0,35,2
1746579690349,MATH 197,001,957876,Kedlaya; Kiran S.,9993,0,9999,6
1746579691380,MCWP 40,A00,892729,Duru; Nur,10,0,20,10
1746579691380,MCWP 40,B00,893304,Montejo; Carolina,14,0,20,6
1746579692417,MCWP 40R,A00,893757,Redela; Pamela Morgan,0,5,20,20
1746579693446,MCWP 50,A00,893758,Morshed; Michael James,0,0,20,20
1746579693446,MCWP 50,B00,893761,Bartulis; Jason Michael,17,0,20,3
1746579694471,MCWP 50R,A00,893766,Compas; Sean Matthew,0,1,20,20
1746579694471,MCWP 50R,B00,893769,Carter; Jennifer A,0,1,20,20
1746579694471,MCWP 50R,C00,893771,Krone; Jarret,0,3,20,20
1746579694471,MCWP 50R,D00,893772,Miller; Elizabeth Deen,0,0,20,20
1746579694471,MCWP 50R,E00,893775,Carter; Andrea L,0,1,20,20
1746579695497,MMW 11R,A01,892721,Herbst; Matthew,14,0,30,16
1746579695497,MMW 11R,A02,892722,Herbst; Matthew,0,0,0,3
1746579696526,MMW 12R,A01,892724,Herbst; Matthew,0,11,16,16
1746579696526,MMW 12R,A02,892725,Herbst; Matthew,0,10,16,16
1746579697551,MMW 13R,A01,892727,Staff,0,4,16,16
1746579697551,MMW 13R,A02,892728,Staff,0,4,16,16
1746579697551,MMW 13R,A03,958032,Staff,0,4,16,16
1746579697551,MMW 13R,A04,958033,Staff,0,4,16,16
1746579697551,MMW 13R,A05,958034,Staff,0,4,16,16
1746579698578,SIO 295LS,A00,894015,Staff,5,0,25,20
1746579699609,SIO 295S,A00,894020,Staff,5,0,25,20
1746579700639,SIOC 290S,B01,958918,Merrifield; Mark A,14,0,30,16
1746579701666,SIOC 291S,B01,958922,Gabriel; Corey John,14,0,30,16
1746579702692,SOCI 117,A01,895339,Staff,3,0,5,2
1746579703721,WES 237B,A00,894149,Staff,11,0,20,9
1746579705791,AESE 279B,A00,891859,Staff,13,0,35,22
1746579706819,AIP 197,001,891854,Vespa; Emanuel Ignacio,9999,0,9999,0
1746579707843,ANTH 289S,A00,891856,Gagneux; Pascal,12,0,12,0
1746579708872,BENG 196,001,957946,Engler; Adam J.,9996,0,9999,3
1746579709900,BISP 197,001,959851,Wilhelm; James E.,9998,0,9999,1
1746579710925,CAT 124RS,A01,956906,Staff,6,0,25,19
1746579711950,CAT 125RS,A01,922013,Staff,6,0,25,19
1746579712974,CLRE 250,A00,891860,Morris; Sheldon,9995,0,9999,4
1746579715025,CLRE 251R,A00,907817,Mehta; Ravindra L.,9994,0,9999,5
1746579716051,CLRE 252,A00,891864,Cuomo; Raphael Eduardo,9993,0,9999,6
1746579717079,CLRE 253,A00,891867,Vaida; Florin,9994,0,9999,5
1746579717079,CLRE 253,B00,907819,Staff,9999,0,9999,0
1746579718103,CLRE 259,A00,891868,Patel; Hemal,9998,0,9999,1
1746579719127,CLRE 260,A00,891872,Cuomo; Raphael Eduardo,9999,0,9999,0
1746579720152,CLRE 297,001,891888,Cuomo; Raphael Eduardo,9999,0,9999,0
1746579721179,CSE 191,A00,958773,Minnes Kemp; Mor Mia,9995,0,9999,4
1746579722205,CSE 197,001,959846,Minnes Kemp; Mor Mia,9990,0,9999,9
1746579723229,CSS 201S,A01,892054,Mignozzetti; Umberto,25,0,30,5
1746579724259,CSS 202S,A01,892056,Mignozzetti; Umberto,25,0,30,5
1746579725283,DSC 197,001,956898,Eldridge; Justin Matthew,9996,0,9999,3
1746579726307,DSC 297,001,958000,Mazumdar; Arya,9998,0,9999,1
1746579726307,DSC 297,002,959862,Wang; Yusu,9998,0,9999,1
1746579727331,EAP 100,A00,905686,Staff,9778,0,9999,221
1746579728357,ECE 45,A01,892618,Staff,0,0,65,65
1746579730407,ECE 111,A01,892719,Staff,6,0,65,59
1746579731434,ECE 197,001,957920,Mercier; Patrick Philip,9991,0,9999,8
1746579732464,ECON 178,A01,907814,Zhu; Ying,26,0,35,9
1746579733490,EDS 115,A00,895312,Staff,35,0,45,10
1746579734521,EDS 117,A01,895337,Staff,23,0,30,7
1746579735546,EDS 125,A00,895341,Jones; Gabrielle Anastasia,36,0,45,9
1746579736570,EDS 128A,A01,895459,Fargason; Sharon Gayle,44,0,45,1
1746579737596,EDS 128B,A01,895543,Pappas; Elizabeth,44,0,45,1
1746579738621,EDS 139,A00,897203,Pappas; Elizabeth,44,0,45,1
1746579738621,EDS 139,B00,897209,Fargason; Sharon Gayle,41,0,45,4
1746579739647,EDS 201,A00,895545,Staff,22,0,45,23
1746579740672,EDS 203,A01,895581,Halter; Christopher P.,22,0,45,23
1746579741696,EDS 204R,A01,895625,Heinzman; Erica M.,39,0,45,6
1746579741696,EDS 204R,B01,895693,Halter; Christopher P.,10,0,45,35
1746579742725,EDS 206R,A00,895694,Fargason; Sharon Gayle,1,0,30,29
1746579742725,EDS 206R,B00,895695,Choi; Bailey Miyeon,16,0,30,14
1746579743749,EDS 250,A00,895697,Hemans; Patricia Ann Benitez,22,0,45,23
1746579744775,EDS 281,A00,895701,Meyerott; Theresa Ann,1,0,15,14
1746579745803,EDS 284,A00,895736,Meyerott; Theresa Ann,1,0,15,14
1746579746832,EDS 286,A00,897210,Fine; Sarah,0,0,15,15
1746579747857,EDS 289C,A01,895770,Daly; Alan J.,1,0,15,14
1746579748886,EDS 290,A00,897211,Hofstetter; Carolyn,0,0,15,15
1746579749913,LIGM 5A,A00,896162,Fischer-Grunski; Eva K,12,0,20,8
1746579750942,LIGM 5B,A00,896260,Fischer-Grunski; Eva K,17,0,20,3
1746579751968,LIGM 5C,A00,896308,Fischer-Grunski; Eva K,18,0,20,2
1746579752995,LIIT 5AS,A00,896313,Carnelos; Chiara,18,0,20,2
1746579754024,LIIT 5BS,A00,896416,Carnelos; Chiara,20,0,20,0
1746579755050,LIIT 5CS,A00,896564,Carnelos; Chiara,20,0,20,0
1746579756076,LISP 5A,A00,896588,Munoz Sanchez; Alicia,2,0,20,18
1746579757101,LISP 5B,A00,896653,Munoz Sanchez; Alicia,7,0,20,13
1746579758126,LISP 5C,A00,896655,Munoz Sanchez; Alicia,0,1,20,20
1746579759151,MAE 197,001,957918,Kleissl; Jan,9996,0,9999,3
1746579759151,MAE 197,002,959806,Boechler; Nicholas Sebastia,9998,0,9999,1
1746579759151,MAE 197,003,959852,Mullin; Jennifer S,9998,0,9999,1
1746579760178,MATH 2,A01,957937,Staff,33,0,35,2
1746579761202,MATH 197,001,957876,Kedlaya; Kiran S.,9993,0,9999,6
1746579762227,MCWP 40,A00,892729,Duru; Nur,10,0,20,10
1746579762227,MCWP 40,B00,893304,Montejo; Carolina,14,0,20,6
1746579763255,MCWP 40R,A00,893757,Redela; Pamela Morgan,0,5,20,20
1746579764279,MCWP 50,A00,893758,Morshed; Michael James,0,0,20,20
1746579764279,MCWP 50,B00,893761,Bartulis; Jason Michael,17,0,20,3
1746579765304,MCWP 50R,A00,893766,Compas; Sean Matthew,0,1,20,20
1746579765304,MCWP 50R,B00,893769,Carter; Jennifer A,0,1,20,20
1746579765304,MCWP 50R,C00,893771,Krone; Jarret,0,3,20,20
1746579765304,MCWP 50R,D00,893772,Miller; Elizabeth Deen,0,0,20,20
1746579765304,MCWP 50R,E00,893775,Carter; Andrea L,0,1,20,20
1746579766331,MMW 11R,A01,892721,Herbst; Matthew,14,0,30,16
1746579766331,MMW 11R,A02,892722,Herbst; Matthew,0,0,0,3
1746579767359,MMW 12R,A01,892724,Herbst; Matthew,0,11,16,16
1746579767359,MMW 12R,A02,892725,Herbst; Matthew,0,10,16,16
1746579768384,MMW 13R,A01,892727,Staff,0,4,16,16
1746579768384,MMW 13R,A02,892728,Staff,0,4,16,16
1746579768384,MMW 13R,A03,958032,Staff,0,4,16,16
1746579768384,MMW 13R,A04,958033,Staff,0,4,16,16
1746579768384,MMW 13R,A05,958034,Staff,0,4,16,16
1746579769412,SIO 295LS,A00,894015,Staff,5,0,25,20
1746579770440,SIO 295S,A00,894020,Staff,5,0,25,20
1746579771470,SIOC 290S,B01,958918,Merrifield; Mark A,14,0,30,16
1746579772499,SIOC 291S,B01,958922,Gabriel; Corey John,14,0,30,16
1746579773524,SOCI 117,A01,895339,Staff,3,0,5,2
1746579774552,WES 237B,A00,894149,Staff,11,0,20,9
1746579776617,AESE 279B,A00,891859,Staff,13,0,35,22
1746579777642,AIP 197,001,891854,Vespa; Emanuel Ignacio,9999,0,9999,0
1746579778667,ANTH 289S,A00,891856,Gagneux; Pascal,12,0,12,0
1746579779692,BENG 196,001,957946,Engler; Adam J.,9996,0,9999,3
1746579780719,BISP 197,001,959851,Wilhelm; James E.,9998,0,9999,1
1746579781747,CAT 124RS,A01,956906,Staff,6,0,25,19
1746579782775,CAT 125RS,A01,922013,Staff,6,0,25,19
1746579783800,CLRE 250,A00,891860,Morris; Sheldon,9995,0,9999,4
1746579785855,CLRE 251R,A00,907817,Mehta; Ravindra L.,9994,0,9999,5
1746579786880,CLRE 252,A00,891864,Cuomo; Raphael Eduardo,9993,0,9999,6
1746579787934,CLRE 253,A00,891867,Vaida; Florin,9994,0,9999,5
1746579787934,CLRE 253,B00,907819,Staff,9999,0,9999,0
1746579788959,CLRE 259,A00,891868,Patel; Hemal,9998,0,9999,1
1746579789985,CLRE 260,A00,891872,Cuomo; Raphael Eduardo,9999,0,9999,0
1746579791012,CLRE 297,001,891888,Cuomo; Raphael Eduardo,9999,0,9999,0
1746579792038,CSE 191,A00,958773,Minnes Kemp; Mor Mia,9995,0,9999,4
1746579793065,CSE 197,001,959846,Minnes Kemp; Mor Mia,9990,0,9999,9
1746579794093,CSS 201S,A01,892054,Mignozzetti; Umberto,25,0,30,5
1746579795120,CSS 202S,A01,892056,Mignozzetti; Umberto,25,0,30,5
1746579796145,DSC 197,001,956898,Eldridge; Justin Matthew,9996,0,9999,3
1746579797170,DSC 297,001,958000,Mazumdar; Arya,9998,0,9999,1
1746579797170,DSC 297,002,959862,Wang; Yusu,9998,0,9999,1
1746579798201,EAP 100,A00,905686,Staff,9778,0,9999,221
1746579799231,ECE 45,A01,892618,Staff,0,0,65,65
1746579801284,ECE 111,A01,892719,Staff,6,0,65,59
1746579802312,ECE 197,001,957920,Mercier; Patrick Philip,9991,0,9999,8
1746579803336,ECON 178,A01,907814,Zhu; Ying,26,0,35,9
1746579804361,EDS 115,A00,895312,Staff,35,0,45,10
1746579805388,EDS 117,A01,895337,Staff,23,0,30,7
1746579806416,EDS 125,A00,895341,Jones; Gabrielle Anastasia,36,0,45,9
1746579807440,EDS 128A,A01,895459,Fargason; Sharon Gayle,44,0,45,1
1746579808465,EDS 128B,A01,895543,Pappas; Elizabeth,44,0,45,1
1746579809492,EDS 139,A00,897203,Pappas; Elizabeth,44,0,45,1
1746579809492,EDS 139,B00,897209,Fargason; Sharon Gayle,41,0,45,4
1746579810518,EDS 201,A00,895545,Staff,22,0,45,23
1746579811547,EDS 203,A01,895581,Halter; Christopher P.,22,0,45,23
1746579812573,EDS 204R,A01,895625,Heinzman; Erica M.,39,0,45,6
1746579812573,EDS 204R,B01,895693,Halter; Christopher P.,10,0,45,35
1746579813599,EDS 206R,A00,895694,Fargason; Sharon Gayle,1,0,30,29
1746579813599,EDS 206R,B00,895695,Choi; Bailey Miyeon,16,0,30,14
1746579814625,EDS 250,A00,895697,Hemans; Patricia Ann Benitez,22,0,45,23
1746579815652,EDS 281,A00,895701,Meyerott; Theresa Ann,1,0,15,14
1746579816677,EDS 284,A00,895736,Meyerott; Theresa Ann,1,0,15,14
1746579817704,EDS 286,A00,897210,Fine; Sarah,0,0,15,15
1746579818732,EDS 289C,A01,895770,Daly; Alan J.,1,0,15,14
1746579819755,EDS 290,A00,897211,Hofstetter; Carolyn,0,0,15,15
1746579820781,LIGM 5A,A00,896162,Fischer-Grunski; Eva K,12,0,20,8
1746579821806,LIGM 5B,A00,896260,Fischer-Grunski; Eva K,17,0,20,3
1746579822834,LIGM 5C,A00,896308,Fischer-Grunski; Eva K,18,0,20,2
1746579823858,LIIT 5AS,A00,896313,Carnelos; Chiara,18,0,20,2
1746579824882,LIIT 5BS,A00,896416,Carnelos; Chiara,20,0,20,0
1746579825905,LIIT 5CS,A00,896564,Carnelos; Chiara,20,0,20,0
1746579826936,LISP 5A,A00,896588,Munoz Sanchez; Alicia,2,0,20,18
1746579827962,LISP 5B,A00,896653,Munoz Sanchez; Alicia,7,0,20,13
1746579828990,LISP 5C,A00,896655,Munoz Sanchez; Alicia,0,1,20,20
1746579830016,MAE 197,001,957918,Kleissl; Jan,9996,0,9999,3
1746579830016,MAE 197,002,959806,Boechler; Nicholas Sebastia,9998,0,9999,1
1746579830016,MAE 197,003,959852,Mullin; Jennifer S,9998,0,9999,1
1746579831043,MATH 2,A01,957937,Staff,33,0,35,2
1746579832071,MATH 197,001,957876,Kedlaya; Kiran S.,9993,0,9999,6
1746579833110,MCWP 40,A00,892729,Duru; Nur,10,0,20,10
1746579833110,MCWP 40,B00,893304,Montejo; Carolina,14,0,20,6
1746579834135,MCWP 40R,A00,893757,Redela; Pamela Morgan,0,5,20,20
1746579835164,MCWP 50,A00,893758,Morshed; Michael James,0,0,20,20
1746579835164,MCWP 50,B00,893761,Bartulis; Jason Michael,17,0,20,3
1746579836188,MCWP 50R,A00,893766,Compas; Sean Matthew,0,1,20,20
1746579836188,MCWP 50R,B00,893769,Carter; Jennifer A,0,1,20,20
1746579836188,MCWP 50R,C00,893771,Krone; Jarret,0,3,20,20
1746579836188,MCWP 50R,D00,893772,Miller; Elizabeth Deen,0,0,20,20
1746579836188,MCWP 50R,E00,893775,Carter; Andrea L,0,1,20,20
1746579837216,MMW 11R,A01,892721,Herbst; Matthew,14,0,30,16
1746579837216,MMW 11R,A02,892722,Herbst; Matthew,0,0,0,3
1746579838244,MMW 12R,A01,892724,Herbst; Matthew,0,11,16,16
1746579838244,MMW 12R,A02,892725,Herbst; Matthew,0,10,16,16
1746579839269,MMW 13R,A01,892727,Staff,0,4,16,16
1746579839269,MMW 13R,A02,892728,Staff,0,4,16,16
1746579839269,MMW 13R,A03,958032,Staff,0,4,16,16
1746579839269,MMW 13R,A04,958033,Staff,0,4,16,16
1746579839269,MMW 13R,A05,958034,Staff,0,4,16,16
1746579840295,SIO 295LS,A00,894015,Staff,5,0,25,20
1746579841317,SIO 295S,A00,894020,Staff,5,0,25,20
1746579842342,SIOC 290S,B01,958918,Merrifield; Mark A,14,0,30,16
1746579843384,SIOC 291S,B01,958922,Gabriel; Corey John,14,0,30,16
1746579844408,SOCI 117,A01,895339,Staff,3,0,5,2
1746579845434,WES 237B,A00,894149,Staff,11,0,20,9
1746579847489,AESE 279B,A00,891859,Staff,13,0,35,22
1746579848514,AIP 197,001,891854,Vespa; Emanuel Ignacio,9999,0,9999,0
1746579849543,ANTH 289S,A00,891856,Gagneux; Pascal,12,0,12,0
1746579850571,BENG 196,001,957946,Engler; Adam J.,9996,0,9999,3
1746579851598,BISP 197,001,959851,Wilhelm; James E.,9998,0,9999,1
1746579852623,CAT 124RS,A01,956906,Staff,6,0,25,19
1746579853651,CAT 125RS,A01,922013,Staff,6,0,25,19
1746579854676,CLRE 250,A00,891860,Morris; Sheldon,9995,0,9999,4
1746579856732,CLRE 251R,A00,907817,Mehta; Ravindra L.,9994,0,9999,5
1746579857760,CLRE 252,A00,891864,Cuomo; Raphael Eduardo,9993,0,9999,6
1746579858784,CLRE 253,A00,891867,Vaida; Florin,9994,0,9999,5
1746579858784,CLRE 253,B00,907819,Staff,9999,0,9999,0
1746579859814,CLRE 259,A00,891868,Patel; Hemal,9998,0,9999,1
1746579860842,CLRE 260,A00,891872,Cuomo; Raphael Eduardo,9999,0,9999,0
1746579861867,CLRE 297,001,891888,Cuomo; Raphael Eduardo,9999,0,9999,0
1746579862892,CSE 191,A00,958773,Minnes Kemp; Mor Mia,9995,0,9999,4
1746579863917,CSE 197,001,959846,Minnes Kemp; Mor Mia,9990,0,9999,9
1746579864945,CSS 201S,A01,892054,Mignozzetti; Umberto,25,0,30,5
1746579865974,CSS 202S,A01,892056,Mignozzetti; Umberto,25,0,30,5
1746579867002,DSC 197,001,956898,Eldridge; Justin Matthew,9996,0,9999,3
1746579868030,DSC 297,001,958000,Mazumdar; Arya,9998,0,9999,1
1746579868030,DSC 297,002,959862,Wang; Yusu,9998,0,9999,1
1746579869053,EAP 100,A00,905686,Staff,9778,0,9999,221
1746579870078,ECE 45,A01,892618,Staff,0,0,65,65
1746579872128,ECE 111,A01,892719,Staff,6,0,65,59
1746579873155,ECE 197,001,957920,Mercier; Patrick Philip,9991,0,9999,8
1746579874181,ECON 178,A01,907814,Zhu; Ying,26,0,35,9
1746579875209,EDS 115,A00,895312,Staff,35,0,45,10
1746579876235,EDS 117,A01,895337,Staff,23,0,30,7
1746579877263,EDS 125,A00,895341,Jones; Gabrielle Anastasia,36,0,45,9
1746579878291,EDS 128A,A01,895459,Fargason; Sharon Gayle,44,0,45,1
1746579879321,EDS 128B,A01,895543,Pappas; Elizabeth,44,0,45,1
1746579880347,EDS 139,A00,897203,Pappas; Elizabeth,44,0,45,1
1746579880347,EDS 139,B00,897209,Fargason; Sharon Gayle,41,0,45,4
1746579881375,EDS 201,A00,895545,Staff,22,0,45,23
1746579882400,EDS 203,A01,895581,Halter; Christopher P.,22,0,45,23
1746579883425,EDS 204R,A01,895625,Heinzman; Erica M.,39,0,45,6
1746579883425,EDS 204R,B01,895693,Halter; Christopher P.,10,0,45,35
1746579884450,EDS 206R,A00,895694,Fargason; Sharon Gayle,1,0,30,29
1746579884450,EDS 206R,B00,895695,Choi; Bailey Miyeon,16,0,30,14
1746579885478,EDS 250,A00,895697,Hemans; Patricia Ann Benitez,22,0,45,23
1746579886502,EDS 281,A00,895701,Meyerott; Theresa Ann,1,0,15,14
1746579887533,EDS 284,A00,895736,Meyerott; Theresa Ann,1,0,15,14
1746579888557,EDS 286,A00,897210,Fine; Sarah,0,0,15,15
1746579889585,EDS 289C,A01,895770,Daly; Alan J.,1,0,15,14
1746579890610,EDS 290,A00,897211,Hofstetter; Carolyn,0,0,15,15
1746579891639,LIGM 5A,A00,896162,Fischer-Grunski; Eva K,12,0,20,8
1746579892670,LIGM 5B,A00,896260,Fischer-Grunski; Eva K,17,0,20,3
1746579893699,LIGM 5C,A00,896308,Fischer-Grunski; Eva K,18,0,20,2
1746579894730,LIIT 5AS,A00,896313,Carnelos; Chiara,18,0,20,2
1746579895756,LIIT 5BS,A00,896416,Carnelos; Chiara,20,0,20,0
1746579896782,LIIT 5CS,A00,896564,Carnelos; Chiara,20,0,20,0
1746579897808,LISP 5A,A00,896588,Munoz Sanchez; Alicia,2,0,20,18
1746579898838,LISP 5B,A00,896653,Munoz Sanchez; Alicia,7,0,20,13
1746579899868,LISP 5C,A00,896655,Munoz Sanchez; Alicia,0,1,20,20
1746579900893,MAE 197,001,957918,Kleissl; Jan,9996,0,9999,3
1746579900893,MAE 197,002,959806,Boechler; Nicholas Sebastia,9998,0,9999,1
1746579900893,MAE 197,003,959852,Mullin; Jennifer S,9998,0,9999,1
1746579901933,MATH 2,A01,957937,Staff,33,0,35,2
1746579902964,MATH 197,001,957876,Kedlaya; Kiran S.,9993,0,9999,6
1746579903990,MCWP 40,A00,892729,Duru; Nur,10,0,20,10
1746579903990,MCWP 40,B00,893304,Montejo; Carolina,14,0,20,6
1746579905016,MCWP 40R,A00,893757,Redela; Pamela Morgan,0,5,20,20
1746579906041,MCWP 50,A00,893758,Morshed; Michael James,0,0,20,20
1746579906041,MCWP 50,B00,893761,Bartulis; Jason Michael,17,0,20,3
1746579907072,MCWP 50R,A00,893766,Compas; Sean Matthew,0,1,20,20
1746579907072,MCWP 50R,B00,893769,Carter; Jennifer A,0,1,20,20
1746579907072,MCWP 50R,C00,893771,Krone; Jarret,0,3,20,20
1746579907072,MCWP 50R,D00,893772,Miller; Elizabeth Deen,0,0,20,20
1746579907072,MCWP 50R,E00,893775,Carter; Andrea L,0,1,20,20
1746579908102,MMW 11R,A01,892721,Herbst; Matthew,14,0,30,16
1746579908102,MMW 11R,A02,892722,Herbst; Matthew,0,0,0,3
1746579909128,MMW 12R,A01,892724,Herbst; Matthew,0,11,16,16
1746579909128,MMW 12R,A02,892725,Herbst; Matthew,0,10,16,16
1746579910157,MMW 13R,A01,892727,Staff,0,4,16,16
1746579910157,MMW 13R,A02,892728,Staff,0,4,16,16
1746579910157,MMW 13R,A03,958032,Staff,0,4,16,16
1746579910157,MMW 13R,A04,958033,Staff,0,4,16,16
1746579910157,MMW 13R,A05,958034,Staff,0,4,16,16
1746579911185,SIO 295LS,A00,894015,Staff,5,0,25,20
1746579912216,SIO 295S,A00,894020,Staff,5,0,25,20
1746579913241,SIOC 290S,B01,958918,Merrifield; Mark A,14,0,30,16
1746579914271,SIOC 291S,B01,958922,Gabriel; Corey John,14,0,30,16
1746579915295,SOCI 117,A01,895339,Staff,3,0,5,2
1746579916324,WES 237B,A00,894149,Staff,11,0,20,9
1746579918389,AESE 279B,A00,891859,Staff,13,0,35,22
1746579919415,AIP 197,001,891854,Vespa; Emanuel Ignacio,9999,0,9999,0
1746579920441,ANTH 289S,A00,891856,Gagneux; Pascal,12,0,12,0
1746579921469,BENG 196,001,957946,Engler; Adam J.,9996,0,9999,3
1746579922497,BISP 197,001,959851,Wilhelm; James E.,9998,0,9999,1
1746579923523,CAT 124RS,A01,956906,Staff,6,0,25,19
1746579924550,CAT 125RS,A01,922013,Staff,6,0,25,19
1746579925575,CLRE 250,A00,891860,Morris; Sheldon,9995,0,9999,4
1746579927630,CLRE 251R,A00,907817,Mehta; Ravindra L.,9994,0,9999,5
1746579928657,CLRE 252,A00,891864,Cuomo; Raphael Eduardo,9993,0,9999,6
1746579929683,CLRE 253,A00,891867,Vaida; Florin,9994,0,9999,5
1746579929683,CLRE 253,B00,907819,Staff,9999,0,9999,0
1746579930713,CLRE 259,A00,891868,Patel; Hemal,9998,0,9999,1
1746579931738,CLRE 260,A00,891872,Cuomo; Raphael Eduardo,9999,0,9999,0
1746579932767,CLRE 297,001,891888,Cuomo; Raphael Eduardo,9999,0,9999,0
1746579933792,CSE 191,A00,958773,Minnes Kemp; Mor Mia,9995,0,9999,4
1746579934821,CSE 197,001,959846,Minnes Kemp; Mor Mia,9990,0,9999,9
1746579935851,CSS 201S,A01,892054,Mignozzetti; Umberto,25,0,30,5
1746579936881,CSS 202S,A01,892056,Mignozzetti; Umberto,25,0,30,5
1746579937906,DSC 197,001,956898,Eldridge; Justin Matthew,9996,0,9999,3
1746579938934,DSC 297,001,958000,Mazumdar; Arya,9998,0,9999,1
1746579938934,DSC 297,002,959862,Wang; Yusu,9998,0,9999,1
1746579939961,EAP 100,A00,905686,Staff,9778,0,9999,221
1746579940988,ECE 45,A01,892618,Staff,0,0,65,65
1746579943044,ECE 111,A01,892719,Staff,6,0,65,59
1746579944071,ECE 197,001,957920,Mercier; Patrick Philip,9991,0,9999,8
1746579945095,ECON 178,A01,907814,Zhu; Ying,26,0,35,9
1746579946122,EDS 115,A00,895312,Staff,35,0,45,10
1746579947150,EDS 117,A01,895337,Staff,23,0,30,7
1746579948179,EDS 125,A00,895341,Jones; Gabrielle Anastasia,36,0,45,9
1746579949204,EDS 128A,A01,895459,Fargason; Sharon Gayle,44,0,45,1
1746579950228,EDS 128B,A01,895543,Pappas; Elizabeth,44,0,45,1
1746579951253,EDS 139,A00,897203,Pappas; Elizabeth,44,0,45,1
1746579951253,EDS 139,B00,897209,Fargason; Sharon Gayle,41,0,45,4
1746579952279,EDS 201,A00,895545,Staff,22,0,45,23
1746579953305,EDS 203,A01,895581,Halter; Christopher P.,22,0,45,23
1746579954333,EDS 204R,A01,895625,Heinzman; Erica M.,39,0,45,6
1746579954333,EDS 204R,B01,895693,Halter; Christopher P.,10,0,45,35
1746579955359,EDS 206R,A00,895694,Fargason; Sharon Gayle,1,0,30,29
1746579955359,EDS 206R,B00,895695,Choi; Bailey Miyeon,16,0,30,14
1746579956385,EDS 250,A00,895697,Hemans; Patricia Ann Benitez,22,0,45,23
1746579957411,EDS 281,A00,895701,Meyerott; Theresa Ann,1,0,15,14
1746579958436,EDS 284,A00,895736,Meyerott; Theresa Ann,1,0,15,14
1746579959461,EDS 286,A00,897210,Fine; Sarah,0,0,15,15
1746579960491,EDS 289C,A01,895770,Daly; Alan J.,1,0,15,14
1746579961517,EDS 290,A00,897211,Hofstetter; Carolyn,0,0,15,15
1746579962544,LIGM 5A,A00,896162,Fischer-Grunski; Eva K,12,0,20,8
1746579963570,LIGM 5B,A00,896260,Fischer-Grunski; Eva K,17,0,20,3
1746579964597,LIGM 5C,A00,896308,Fischer-Grunski; Eva K,18,0,20,2
1746579965627,LIIT 5AS,A00,896313,Carnelos; Chiara,18,0,20,2
1746579966653,LIIT 5BS,A00,896416,Carnelos; Chiara,20,0,20,0
1746579967679,LIIT 5CS,A00,896564,Carnelos; Chiara,20,0,20,0
1746579968709,LISP 5A,A00,896588,Munoz Sanchez; Alicia,2,0,20,18
1746579969734,LISP 5B,A00,896653,Munoz Sanchez; Alicia,7,0,20,13
1746579970761,LISP 5C,A00,896655,Munoz Sanchez; Alicia,0,1,20,20
1746579971787,MAE 197,001,957918,Kleissl; Jan,9996,0,9999,3
1746579971787,MAE 197,002,959806,Boechler; Nicholas Sebastia,9998,0,9999,1
1746579971787,MAE 197,003,959852,Mullin; Jennifer S,9998,0,9999,1
1746579972817,MATH 2,A01,957937,Staff,33,0,35,2
1746579973840,MATH 197,001,957876,Kedlaya; Kiran S.,9993,0,9999,6
1746579974866,MCWP 40,A00,892729,Duru; Nur,10,0,20,10
1746579974866,MCWP 40,B00,893304,Montejo; Carolina,14,0,20,6
1746579975892,MCWP 40R,A00,893757,Redela; Pamela Morgan,0,5,20,20
1746579976924,MCWP 50,A00,893758,Morshed; Michael James,0,0,20,20
1746579976924,MCWP 50,B00,893761,Bartulis; Jason Michael,17,0,20,3
1746579977951,MCWP 50R,A00,893766,Compas; Sean Matthew,0,1,20,20
1746579977951,MCWP 50R,B00,893769,Carter; Jennifer A,0,1,20,20
1746579977951,MCWP 50R,C00,893771,Krone; Jarret,0,3,20,20
1746579977951,MCWP 50R,D00,893772,Miller; Elizabeth Deen,0,0,20,20
1746579977951,MCWP 50R,E00,893775,Carter; Andrea L,0,1,20,20
1746579978976,MMW 11R,A01,892721,Herbst; Matthew,14,0,30,16
1746579978976,MMW 11R,A02,892722,Herbst; Matthew,0,0,0,3
1746579980005,MMW 12R,A01,892724,Herbst; Matthew,0,11,16,16
1746579980005,MMW 12R,A02,892725,Herbst; Matthew,0,10,16,16
1746579981031,MMW 13R,A01,892727,Staff,0,4,16,16
1746579981031,MMW 13R,A02,892728,Staff,0,4,16,16
1746579981031,MMW 13R,A03,958032,Staff,0,4,16,16
1746579981031,MMW 13R,A04,958033,Staff,0,4,16,16
1746579981031,MMW 13R,A05,958034,Staff,0,4,16,16
1746579982060,SIO 295LS,A00,894015,Staff,5,0,25,20
1746579983088,SIO 295S,A00,894020,Staff,5,0,25,20
1746579984116,SIOC 290S,B01,958918,Merrifield; Mark A,14,0,30,16
1746579985142,SIOC 291S,B01,958922,Gabriel; Corey John,14,0,30,16
1746579986171,SOCI 117,A01,895339,Staff,3,0,5,2
1746579987197,WES 237B,A00,894149,Staff,11,0,20,9
1746579989260,AESE 279B,A00,891859,Staff,13,0,35,22
1746579990285,AIP 197,001,891854,Vespa; Emanuel Ignacio,9999,0,9999,0
1746579991313,ANTH 289S,A00,891856,Gagneux; Pascal,12,0,12,0
1746579992339,BENG 196,001,957946,Engler; Adam J.,9996,0,9999,3
1746579993369,BISP 197,001,959851,Wilhelm; James E.,9998,0,9999,1
1746579994393,CAT 124RS,A01,956906,Staff,6,0,25,19
1746579995421,CAT 125RS,A01,922013,Staff,6,0,25,19
1746579996448,CLRE 250,A00,891860,Morris; Sheldon,9995,0,9999,4
1746579998504,CLRE 251R,A00,907817,Mehta; Ravindra L.,9994,0,9999,5
1746579999531,CLRE 252,A00,891864,Cuomo; Raphael Eduardo,9993,0,9999,6
1746580000557,CLRE 253,A00,891867,Vaida; Florin,9994,0,9999,5
1746580000557,CLRE 253,B00,907819,Staff,9999,0,9999,0
1746580001582,CLRE 259,A00,891868,Patel; Hemal,9998,0,9999,1
1746580002606,CLRE 260,A00,891872,Cuomo; Raphael Eduardo,9999,0,9999,0
1746580003635,CLRE 297,001,891888,Cuomo; Raphael Eduardo,9999,0,9999,0
1746580004659,CSE 191,A00,958773,Minnes Kemp; Mor Mia,9995,0,9999,4
1746580005684,CSE 197,001,959846,Minnes Kemp; Mor Mia,9990,0,9999,9
1746580006714,CSS 201S,A01,892054,Mignozzetti; Umberto,25,0,30,5
1746580007740,CSS 202S,A01,892056,Mignozzetti; Umberto,25,0,30,5
1746580008766,DSC 197,001,956898,Eldridge; Justin Matthew,9996,0,9999,3
1746580009791,DSC 297,001,958000,Mazumdar; Arya,9998,0,9999,1
1746580009791,DSC 297,002,959862,Wang; Yusu,9998,0,9999,1
1746580010816,EAP 100,A00,905686,Staff,9778,0,9999,221
1746580011844,ECE 45,A01,892618,Staff,0,0,65,65
1746580013893,ECE 111,A01,892719,Staff,6,0,65,59
1746580014918,ECE 197,001,957920,Mercier; Patrick Philip,9991,0,9999,8
1746580015943,ECON 178,A01,907814,Zhu; Ying,26,0,35,9
1746580016972,EDS 115,A00,895312,Staff,35,0,45,10
1746580018001,EDS 117,A01,895337,Staff,23,0,30,7
1746580019026,EDS 125,A00,895341,Jones; Gabrielle Anastasia,36,0,45,9
1746580020051,EDS 128A,A01,895459,Fargason; Sharon Gayle,44,0,45,1
1746580021082,EDS 128B,A01,895543,Pappas; Elizabeth,44,0,45,1
1746580022108,EDS 139,A00,897203,Pappas; Elizabeth,44,0,45,1
1746580022108,EDS 139,B00,897209,Fargason; Sharon Gayle,41,0,45,4
1746580023138,EDS 201,A00,895545,Staff,22,0,45,23
1746580024164,EDS 203,A01,895581,Halter; Christopher P.,22,0,45,23
1746580025189,EDS 204R,A01,895625,Heinzman; Erica M.,39,0,45,6
1746580025189,EDS 204R,B01,895693,Halter; Christopher P.,10,0,45,35
1746580026215,EDS 206R,A00,895694,Fargason; Sharon Gayle,1,0,30,29
1746580026215,EDS 206R,B00,895695,Choi; Bailey Miyeon,16,0,30,14
1746580027241,EDS 250,A00,895697,Hemans; Patricia Ann Benitez,22,0,45,23
1746580028270,EDS 281,A00,895701,Meyerott; Theresa Ann,1,0,15,14
1746580029295,EDS 284,A00,895736,Meyerott; Theresa Ann,1,0,15,14
1746580030324,EDS 286,A00,897210,Fine; Sarah,0,0,15,15
1746580031386,EDS 289C,A01,895770,Daly; Alan J.,1,0,15,14
1746580032413,EDS 290,A00,897211,Hofstetter; Carolyn,0,0,15,15
1746580033438,LIGM 5A,A00,896162,Fischer-Grunski; Eva K,12,0,20,8
1746580034469,LIGM 5B,A00,896260,Fischer-Grunski; Eva K,17,0,20,3
1746580035497,LIGM 5C,A00,896308,Fischer-Grunski; Eva K,18,0,20,2
1746580036527,LIIT 5AS,A00,896313,Carnelos; Chiara,18,0,20,2
1746580037556,LIIT 5BS,A00,896416,Carnelos; Chiara,20,0,20,0
1746580038583,LIIT 5CS,A00,896564,Carnelos; Chiara,20,0,20,0
1746580039609,LISP 5A,A00,896588,Munoz Sanchez; Alicia,2,0,20,18
1746580040635,LISP 5B,A00,896653,Munoz Sanchez; Alicia,7,0,20,13
1746580041659,LISP 5C,A00,896655,Munoz Sanchez; Alicia,0,1,20,20
1746580042686,MAE 197,001,957918,Kleissl; Jan,9996,0,9999,3
1746580042686,MAE 197,002,959806,Boechler; Nicholas Sebastia,9998,0,9999,1
1746580042686,MAE 197,003,959852,Mullin; Jennifer S,9998,0,9999,1
1746580043710,MATH 2,A01,957937,Staff,33,0,35,2
1746580044743,MATH 197,001,957876,Kedlaya; Kiran S.,9993,0,9999,6
1746580045768,MCWP 40,A00,892729,Duru; Nur,10,0,20,10
1746580045768,MCWP 40,B00,893304,Montejo; Carolina,14,0,20,6
1746580046793,MCWP 40R,A00,893757,Redela; Pamela Morgan,0,5,20,20
1746580048025,MCWP 50,A00,893758,Morshed; Michael James,0,0,20,20
1746580048025,MCWP 50,B00,893761,Bartulis; Jason Michael,17,0,20,3
1746580049052,MCWP 50R,A00,893766,Compas; Sean Matthew,0,1,20,20
1746580049052,MCWP 50R,B00,893769,Carter; Jennifer A,0,1,20,20
1746580049052,MCWP 50R,C00,893771,Krone; Jarret,0,3,20,20
1746580049052,MCWP 50R,D00,893772,Miller; Elizabeth Deen,0,0,20,20
1746580049052,MCWP 50R,E00,893775,Carter; Andrea L,0,1,20,20
1746580050079,MMW 11R,A01,892721,Herbst; Matthew,14,0,30,16
1746580050079,MMW 11R,A02,892722,Herbst; Matthew,0,0,0,3
1746580051107,MMW 12R,A01,892724,Herbst; Matthew,0,11,16,16
1746580051107,MMW 12R,A02,892725,Herbst; Matthew,0,10,16,16
1746580052134,MMW 13R,A01,892727,Staff,0,4,16,16
1746580052134,MMW 13R,A02,892728,Staff,0,4,16,16
1746580052134,MMW 13R,A03,958032,Staff,0,4,16,16
1746580052134,MMW 13R,A04,958033,Staff,0,4,16,16
1746580052134,MMW 13R,A05,958034,Staff,0,4,16,16
1746580053161,SIO 295LS,A00,894015,Staff,5,0,25,20
1746580054195,SIO 295S,A00,894020,Staff,5,0,25,20
1746580055221,SIOC 290S,B01,958918,Merrifield; Mark A,14,0,30,16
1746580056253,SIOC 291S,B01,958922,Gabriel; Corey John,14,0,30,16
1746580057277,SOCI 117,A01,895339,Staff,3,0,5,2
1746580058304,WES 237B,A00,894149,Staff,11,0,20,9
1746580060369,AESE 279B,A00,891859,Staff,13,0,35,22
1746580061393,AIP 197,001,891854,Vespa; Emanuel Ignacio,9999,0,9999,0
1746580062418,ANTH 289S,A00,891856,Gagneux; Pascal,12,0,12,0
1746580063447,BENG 196,001,957946,Engler; Adam J.,9996,0,9999,3
1746580064473,BISP 197,001,959851,Wilhelm; James E.,9998,0,9999,1
1746580065498,CAT 124RS,A01,956906,Staff,6,0,25,19
1746580066528,CAT 125RS,A01,922013,Staff,6,0,25,19
1746580067558,CLRE 250,A00,891860,Morris; Sheldon,9995,0,9999,4
1746580069614,CLRE 251R,A00,907817,Mehta; Ravindra L.,9994,0,9999,5
1746580070644,CLRE 252,A00,891864,Cuomo; Raphael Eduardo,9993,0,9999,6
1746580071670,CLRE 253,A00,891867,Vaida; Florin,9994,0,9999,5
1746580071670,CLRE 253,B00,907819,Staff,9999,0,9999,0
1746580072694,CLRE 259,A00,891868,Patel; Hemal,9998,0,9999,1
1746580073721,CLRE 260,A00,891872,Cuomo; Raphael Eduardo,9999,0,9999,0
1746580074745,CLRE 297,001,891888,Cuomo; Raphael Eduardo,9999,0,9999,0
1746580075774,CSE 191,A00,958773,Minnes Kemp; Mor Mia,9995,0,9999,4
1746580076800,CSE 197,001,959846,Minnes Kemp; Mor Mia,9990,0,9999,9
1746580077826,CSS 201S,A01,892054,Mignozzetti; Umberto,25,0,30,5
1746580078857,CSS 202S,A01,892056,Mignozzetti; Umberto,25,0,30,5
1746580079887,DSC 197,001,956898,Eldridge; Justin Matthew,9996,0,9999,3
1746580080915,DSC 297,001,958000,Mazumdar; Arya,9998,0,9999,1
1746580080915,DSC 297,002,959862,Wang; Yusu,9998,0,9999,1
1746580081939,EAP 100,A00,905686,Staff,9778,0,9999,221
1746580082968,ECE 45,A01,892618,Staff,0,0,65,65
1746580085022,ECE 111,A01,892719,Staff,6,0,65,59
1746580086048,ECE 197,001,957920,Mercier; Patrick Philip,9991,0,9999,8
1746580087072,ECON 178,A01,907814,Zhu; Ying,26,0,35,9
1746580088101,EDS 115,A00,895312,Staff,35,0,45,10
1746580089128,EDS 117,A01,895337,Staff,23,0,30,7
1746580090155,EDS 125,A00,895341,Jones; Gabrielle Anastasia,36,0,45,9
1746580091183,EDS 128A,A01,895459,Fargason; Sharon Gayle,44,0,45,1
1746580092220,EDS 128B,A01,895543,Pappas; Elizabeth,44,0,45,1
1746580093245,EDS 139,A00,897203,Pappas; Elizabeth,44,0,45,1
1746580093245,EDS 139,B00,897209,Fargason; Sharon Gayle,41,0,45,4
1746580094274,EDS 201,A00,895545,Staff,22,0,45,23
1746580095302,EDS 203,A01,895581,Halter; Christopher P.,22,0,45,23
1746580096326,EDS 204R,A01,895625,Heinzman; Erica M.,39,0,45,6
1746580096326,EDS 204R,B01,895693,Halter; Christopher P.,10,0,45,35
1746580097355,EDS 206R,A00,895694,Fargason; Sharon Gayle,1,0,30,29
1746580097355,EDS 206R,B00,895695,Choi; Bailey Miyeon,16,0,30,14
1746580098379,EDS 250,A00,895697,Hemans; Patricia Ann Benitez,22,0,45,23
1746580099403,EDS 281,A00,895701,Meyerott; Theresa Ann,1,0,15,14
1746580100433,EDS 284,A00,895736,Meyerott; Theresa Ann,1,0,15,14
1746580101458,EDS 286,A00,897210,Fine; Sarah,0,0,15,15
1746580102483,EDS 289C,A01,895770,Daly; Alan J.,1,0,15,14
1746580103507,EDS 290,A00,897211,Hofstetter; Carolyn,0,0,15,15
1746580104536,LIGM 5A,A00,896162,Fischer-Grunski; Eva K,12,0,20,8
1746580105561,LIGM 5B,A00,896260,Fischer-Grunski; Eva K,17,0,20,3
1746580106586,LIGM 5C,A00,896308,Fischer-Grunski; Eva K,18,0,20,2
1746580107613,LIIT 5AS,A00,896313,Carnelos; Chiara,18,0,20,2
1746580108638,LIIT 5BS,A00,896416,Carnelos; Chiara,20,0,20,0
1746580109667,LIIT 5CS,A00,896564,Carnelos; Chiara,20,0,20,0
1746580110692,LISP 5A,A00,896588,Munoz Sanchez; Alicia,2,0,20,18
1746580111722,LISP 5B,A00,896653,Munoz Sanchez; Alicia,7,0,20,13
1746580112750,LISP 5C,A00,896655,Munoz Sanchez; Alicia,0,1,20,20
1746580113779,MAE 197,001,957918,Kleissl; Jan,9996,0,9999,3
1746580113779,MAE 197,002,959806,Boechler; Nicholas Sebastia,9998,0,9999,1
1746580113779,MAE 197,003,959852,Mullin; Jennifer S,9998,0,9999,1
1746580114804,MATH 2,A01,957937,Staff,33,0,35,2
1746580115833,MATH 197,001,957876,Kedlaya; Kiran S.,9993,0,9999,6
1746580116862,MCWP 40,A00,892729,Duru; Nur,10,0,20,10
1746580116862,MCWP 40,B00,893304,Montejo; Carolina,14,0,20,6
1746580117886,MCWP 40R,A00,893757,Redela; Pamela Morgan,0,5,20,20
1746580118911,MCWP 50,A00,893758,Morshed; Michael James,0,0,20,20
1746580118911,MCWP 50,B00,893761,Bartulis; Jason Michael,17,0,20,3
1746580119936,MCWP 50R,A00,893766,Compas; Sean Matthew,0,1,20,20
1746580119936,MCWP 50R,B00,893769,Carter; Jennifer A,0,1,20,20
1746580119936,MCWP 50R,C00,893771,Krone; Jarret,0,3,20,20
1746580119936,MCWP 50R,D00,893772,Miller; Elizabeth Deen,0,0,20,20
1746580119936,MCWP 50R,E00,893775,Carter; Andrea L,0,1,20,20
1746580120961,MMW 11R,A01,892721,Herbst; Matthew,14,0,30,16
1746580120961,MMW 11R,A02,892722,Herbst; Matthew,0,0,0,3
1746580121985,MMW 12R,A01,892724,Herbst; Matthew,0,11,16,16
1746580121985,MMW 12R,A02,892725,Herbst; Matthew,0,10,16,16
1746580123009,MMW 13R,A01,892727,Staff,0,4,16,16
1746580123009,MMW 13R,A02,892728,Staff,0,4,16,16
1746580123009,MMW 13R,A03,958032,Staff,0,4,16,16
1746580123009,MMW 13R,A04,958033,Staff,0,4,16,16
1746580123009,MMW 13R,A05,958034,Staff,0,4,16,16
1746580124034,SIO 295LS,A00,894015,Staff,5,0,25,20
1746580125061,SIO 295S,A00,894020,Staff,5,0,25,20
1746580126085,SIOC 290S,B01,958918,Merrifield; Mark A,14,0,30,16
1746580127113,SIOC 291S,B01,958922,Gabriel; Corey John,14,0,30,16
1746580128139,SOCI 117,A01,895339,Staff,3,0,5,2
1746580129164,WES 237B,A00,894149,Staff,11,0,20,9
1746580131234,AESE 279B,A00,891859,Staff,13,0,35,22
1746580132259,AIP 197,001,891854,Vespa; Emanuel Ignacio,9999,0,9999,0
1746580133288,ANTH 289S,A00,891856,Gagneux; Pascal,12,0,12,0
1746580134317,BENG 196,001,957946,Engler; Adam J.,9996,0,9999,3
1746580135344,BISP 197,001,959851,Wilhelm; James E.,9998,0,9999,1
1746580136369,CAT 124RS,A01,956906,Staff,6,0,25,19
1746580137394,CAT 125RS,A01,922013,Staff,6,0,25,19
1746580138419,CLRE 250,A00,891860,Morris; Sheldon,9995,0,9999,4
1746580140472,CLRE 251R,A00,907817,Mehta; Ravindra L.,9994,0,9999,5
1746580141497,CLRE 252,A00,891864,Cuomo; Raphael Eduardo,9993,0,9999,6
1746580142525,CLRE 253,A00,891867,Vaida; Florin,9994,0,9999,5
1746580142525,CLRE 253,B00,907819,Staff,9999,0,9999,0
1746580143554,CLRE 259,A00,891868,Patel; Hemal,9998,0,9999,1
1746580144578,CLRE 260,A00,891872,Cuomo; Raphael Eduardo,9999,0,9999,0
1746580145603,CLRE 297,001,891888,Cuomo; Raphael Eduardo,9999,0,9999,0
1746580146627,CSE 191,A00,958773,Minnes Kemp; Mor Mia,9995,0,9999,4
1746580147655,CSE 197,001,959846,Minnes Kemp; Mor Mia,9990,0,9999,9
1746580148680,CSS 201S,A01,892054,Mignozzetti; Umberto,25,0,30,5
1746580149706,CSS 202S,A01,892056,Mignozzetti; Umberto,25,0,30,5
1746580150731,DSC 197,001,956898,Eldridge; Justin Matthew,9996,0,9999,3
1746580151756,DSC 297,001,958000,Mazumdar; Arya,9998,0,9999,1
1746580151756,DSC 297,002,959862,Wang; Yusu,9998,0,9999,1
1746580152779,EAP 100,A00,905686,Staff,9778,0,9999,221
1746580153808,ECE 45,A01,892618,Staff,0,0,65,65
1746580155861,ECE 111,A01,892719,Staff,6,0,65,59
1746580156884,ECE 197,001,957920,Mercier; Patrick Philip,9991,0,9999,8
1746580157909,ECON 178,A01,907814,Zhu; Ying,26,0,35,9
1746580158939,EDS 115,A00,895312,Staff,35,0,45,10
1746580159966,EDS 117,A01,895337,Staff,23,0,30,7
1746580160991,EDS 125,A00,895341,Jones; Gabrielle Anastasia,36,0,45,9
1746580162020,EDS 128A,A01,895459,Fargason; Sharon Gayle,44,0,45,1
1746580163050,EDS 128B,A01,895543,Pappas; Elizabeth,44,0,45,1
1746580164078,EDS 139,A00,897203,Pappas; Elizabeth,44,0,45,1
1746580164078,EDS 139,B00,897209,Fargason; Sharon Gayle,41,0,45,4
1746580165107,EDS 201,A00,895545,Staff,22,0,45,23
1746580166136,EDS 203,A01,895581,Halter; Christopher P.,22,0,45,23
1746580167163,EDS 204R,A01,895625,Heinzman; Erica M.,39,0,45,6
1746580167163,EDS 204R,B01,895693,Halter; Christopher P.,10,0,45,35
1746580168191,EDS 206R,A00,895694,Fargason; Sharon Gayle,1,0,30,29
1746580168191,EDS 206R,B00,895695,Choi; Bailey Miyeon,16,0,30,14
1746580169222,EDS 250,A00,895697,Hemans; Patricia Ann Benitez,22,0,45,23
1746580170247,EDS 281,A00,895701,Meyerott; Theresa Ann,1,0,15,14
1746580171272,EDS 284,A00,895736,Meyerott; Theresa Ann,1,0,15,14
1746580172301,EDS 286,A00,897210,Fine; Sarah,0,0,15,15
1746580173329,EDS 289C,A01,895770,Daly; Alan J.,1,0,15,14
1746580174354,EDS 290,A00,897211,Hofstetter; Carolyn,0,0,15,15
1746580175380,LIGM 5A,A00,896162,Fischer-Grunski; Eva K,12,0,20,8
1746580176405,LIGM 5B,A00,896260,Fischer-Grunski; Eva K,17,0,20,3
1746580177434,LIGM 5C,A00,896308,Fischer-Grunski; Eva K,18,0,20,2
1746580178459,LIIT 5AS,A00,896313,Carnelos; Chiara,18,0,20,2
1746580179484,LIIT 5BS,A00,896416,Carnelos; Chiara,20,0,20,0
1746580180515,LIIT 5CS,A00,896564,Carnelos; Chiara,20,0,20,0
1746580181543,LISP 5A,A00,896588,Munoz Sanchez; Alicia,2,0,20,18
1746580182572,LISP 5B,A00,896653,Munoz Sanchez; Alicia,7,0,20,13
1746580183600,LISP 5C,A00,896655,Munoz Sanchez; Alicia,0,1,20,20
1746580184629,MAE 197,001,957918,Kleissl; Jan,9996,0,9999,3
1746580184629,MAE 197,002,959806,Boechler; Nicholas Sebastia,9998,0,9999,1
1746580184629,MAE 197,003,959852,Mullin; Jennifer S,9998,0,9999,1
1746580185657,MATH 2,A01,957937,Staff,33,0,35,2
1746580186682,MATH 197,001,957876,Kedlaya; Kiran S.,9993,0,9999,6
1746580187708,MCWP 40,A00,892729,Duru; Nur,10,0,20,10
1746580187708,MCWP 40,B00,893304,Montejo; Carolina,14,0,20,6
1746580188732,MCWP 40R,A00,893757,Redela; Pamela Morgan,0,5,20,20
1746580189757,MCWP 50,A00,893758,Morshed; Michael James,0,0,20,20
1746580189757,MCWP 50,B00,893761,Bartulis; Jason Michael,17,0,20,3
1746580190783,MCWP 50R,A00,893766,Compas; Sean Matthew,0,1,20,20
1746580190783,MCWP 50R,B00,893769,Carter; Jennifer A,0,1,20,20
1746580190783,MCWP 50R,C00,893771,Krone; Jarret,0,3,20,20
1746580190783,MCWP 50R,D00,893772,Miller; Elizabeth Deen,0,0,20,20
1746580190783,MCWP 50R,E00,893775,Carter; Andrea L,0,1,20,20
1746580191814,MMW 11R,A01,892721,Herbst; Matthew,14,0,30,16
1746580191814,MMW 11R,A02,892722,Herbst; Matthew,0,0,0,3
1746580192839,MMW 12R,A01,892724,Herbst; Matthew,0,11,16,16
1746580192839,MMW 12R,A02,892725,Herbst; Matthew,0,10,16,16
1746580193863,MMW 13R,A01,892727,Staff,0,4,16,16
1746580193863,MMW 13R,A02,892728,Staff,0,4,16,16
1746580193863,MMW 13R,A03,958032,Staff,0,4,16,16
1746580193863,MMW 13R,A04,958033,Staff,0,4,16,16
1746580193863,MMW 13R,A05,958034,Staff,0,4,16,16
1746580194891,SIO 295LS,A00,894015,Staff,5,0,25,20
1746580195920,SIO 295S,A00,894020,Staff,5,0,25,20
1746580196948,SIOC 290S,B01,958918,Merrifield; Mark A,14,0,30,16
1746580197973,SIOC 291S,B01,958922,Gabriel; Corey John,14,0,30,16
1746580199006,SOCI 117,A01,895339,Staff,3,0,5,2
1746580200032,WES 237B,A00,894149,Staff,11,0,20,9
1746580202093,AESE 279B,A00,891859,Staff,13,0,35,22
1746580203122,AIP 197,001,891854,Vespa; Emanuel Ignacio,9999,0,9999,0
1746580204152,ANTH 289S,A00,891856,Gagneux; Pascal,12,0,12,0
1746580205178,BENG 196,001,957946,Engler; Adam J.,9996,0,9999,3
1746580206204,BISP 197,001,959851,Wilhelm; James E.,9998,0,9999,1
1746580207229,CAT 124RS,A01,956906,Staff,6,0,25,19
1746580208257,CAT 125RS,A01,922013,Staff,6,0,25,19
1746580209284,CLRE 250,A00,891860,Morris; Sheldon,9995,0,9999,4
1746580211341,CLRE 251R,A00,907817,Mehta; Ravindra L.,9994,0,9999,5
1746580212369,CLRE 252,A00,891864,Cuomo; Raphael Eduardo,9993,0,9999,6
1746580213395,CLRE 253,A00,891867,Vaida; Florin,9994,0,9999,5
1746580213395,CLRE 253,B00,907819,Staff,9999,0,9999,0
1746580214421,CLRE 259,A00,891868,Patel; Hemal,9998,0,9999,1
1746580215446,CLRE 260,A00,891872,Cuomo; Raphael Eduardo,9999,0,9999,0
1746580216471,CLRE 297,001,891888,Cuomo; Raphael Eduardo,9999,0,9999,0
1746580217495,CSE 191,A00,958773,Minnes Kemp; Mor Mia,9995,0,9999,4
1746580218519,CSE 197,001,959846,Minnes Kemp; Mor Mia,9990,0,9999,9
1746580219548,CSS 201S,A01,892054,Mignozzetti; Umberto,25,0,30,5
1746580220577,CSS 202S,A01,892056,Mignozzetti; Umberto,25,0,30,5
1746580221605,DSC 197,001,956898,Eldridge; Justin Matthew,9996,0,9999,3
1746580222630,DSC 297,001,958000,Mazumdar; Arya,9998,0,9999,1
1746580222630,DSC 297,002,959862,Wang; Yusu,9998,0,9999,1
1746580223657,EAP 100,A00,905686,Staff,9778,0,9999,221
1746580224694,ECE 45,A01,892618,Staff,0,0,65,65
1746580226743,ECE 111,A01,892719,Staff,6,0,65,59
1746580227768,ECE 197,001,957920,Mercier; Patrick Philip,9991,0,9999,8
1746580228799,ECON 178,A01,907814,Zhu; Ying,26,0,35,9
1746580229823,EDS 115,A00,895312,Staff,35,0,45,10
1746580230850,EDS 117,A01,895337,Staff,23,0,30,7
1746580231875,EDS 125,A00,895341,Jones; Gabrielle Anastasia,36,0,45,9
1746580232905,EDS 128A,A01,895459,Fargason; Sharon Gayle,44,0,45,1
1746580233929,EDS 128B,A01,895543,Pappas; Elizabeth,44,0,45,1
1746580234955,EDS 139,A00,897203,Pappas; Elizabeth,44,0,45,1
1746580234955,EDS 139,B00,897209,Fargason; Sharon Gayle,41,0,45,4
1746580235982,EDS 201,A00,895545,Staff,22,0,45,23
1746580237011,EDS 203,A01,895581,Halter; Christopher P.,22,0,45,23
1746580238040,EDS 204R,A01,895625,Heinzman; Erica M.,39,0,45,6
1746580238040,EDS 204R,B01,895693,Halter; Christopher P.,10,0,45,35
1746580239065,EDS 206R,A00,895694,Fargason; Sharon Gayle,1,0,30,29
1746580239065,EDS 206R,B00,895695,Choi; Bailey Miyeon,16,0,30,14
1746580240090,EDS 250,A00,895697,Hemans; Patricia Ann Benitez,22,0,45,23
1746580241118,EDS 281,A00,895701,Meyerott; Theresa Ann,1,0,15,14
1746580242147,EDS 284,A00,895736,Meyerott; Theresa Ann,1,0,15,14
1746580243173,EDS 286,A00,897210,Fine; Sarah,0,0,15,15
1746580244201,EDS 289C,A01,895770,Daly; Alan J.,1,0,15,14
1746580245226,EDS 290,A00,897211,Hofstetter; Carolyn,0,0,15,15
1746580246251,LIGM 5A,A00,896162,Fischer-Grunski; Eva K,12,0,20,8
1746580247281,LIGM 5B,A00,896260,Fischer-Grunski; Eva K,17,0,20,3
1746580248309,LIGM 5C,A00,896308,Fischer-Grunski; Eva K,18,0,20,2
1746580249333,LIIT 5AS,A00,896313,Carnelos; Chiara,18,0,20,2
1746580250360,LIIT 5BS,A00,896416,Carnelos; Chiara,20,0,20,0
1746580251391,LIIT 5CS,A00,896564,Carnelos; Chiara,20,0,20,0
1746580252423,LISP 5A,A00,896588,Munoz Sanchez; Alicia,2,0,20,18
1746580253452,LISP 5B,A00,896653,Munoz Sanchez; Alicia,7,0,20,13
1746580254480,LISP 5C,A00,896655,Munoz Sanchez; Alicia,0,1,20,20
1746580255510,MAE 197,001,957918,Kleissl; Jan,9996,0,9999,3
1746580255510,MAE 197,002,959806,Boechler; Nicholas Sebastia,9998,0,9999,1
1746580255510,MAE 197,003,959852,Mullin; Jennifer S,9998,0,9999,1
1746580256538,MATH 2,A01,957937,Staff,33,0,35,2
1746580257564,MATH 197,001,957876,Kedlaya; Kiran S.,9993,0,9999,6
1746580258593,MCWP 40,A00,892729,Duru; Nur,10,0,20,10
1746580258593,MCWP 40,B00,893304,Montejo; Carolina,14,0,20,6
1746580259620,MCWP 40R,A00,893757,Redela; Pamela Morgan,0,5,20,20
1746580260651,MCWP 50,A00,893758,Morshed; Michael James,0,0,20,20
1746580260651,MCWP 50,B00,893761,Bartulis; Jason Michael,17,0,20,3
1746580261677,MCWP 50R,A00,893766,Compas; Sean Matthew,0,1,20,20
1746580261677,MCWP 50R,B00,893769,Carter; Jennifer A,0,1,20,20
1746580261677,MCWP 50R,C00,893771,Krone; Jarret,0,3,20,20
1746580261677,MCWP 50R,D00,893772,Miller; Elizabeth Deen,0,0,20,20
1746580261677,MCWP 50R,E00,893775,Carter; Andrea L,0,1,20,20
1746580262702,MMW 11R,A01,892721,Herbst; Matthew,14,0,30,16
1746580262702,MMW 11R,A02,892722,Herbst; Matthew,0,0,0,3
1746580263732,MMW 12R,A01,892724,Herbst; Matthew,0,11,16,16
1746580263732,MMW 12R,A02,892725,Herbst; Matthew,0,10,16,16
1746580264756,MMW 13R,A01,892727,Staff,0,4,16,16
1746580264756,MMW 13R,A02,892728,Staff,0,4,16,16
1746580264756,MMW 13R,A03,958032,Staff,0,4,16,16
1746580264756,MMW 13R,A04,958033,Staff,0,4,16,16
1746580264756,MMW 13R,A05,958034,Staff,0,4,16,16
1746580265782,SIO 295LS,A00,894015,Staff,5,0,25,20
1746580266808,SIO 295S,A00,894020,Staff,5,0,25,20
1746580267835,SIOC 290S,B01,958918,Merrifield; Mark A,14,0,30,16
1746580268863,SIOC 291S,B01,958922,Gabriel; Corey John,14,0,30,16
1746580269891,SOCI 117,A01,895339,Staff,3,0,5,2
1746580270916,WES 237B,A00,894149,Staff,11,0,20,9
1746580272975,AESE 279B,A00,891859,Staff,13,0,35,22
1746580274004,AIP 197,001,891854,Vespa; Emanuel Ignacio,9999,0,9999,0
1746580275035,ANTH 289S,A00,891856,Gagneux; Pascal,12,0,12,0
1746580276060,BENG 196,001,957946,Engler; Adam J.,9996,0,9999,3
1746580277084,BISP 197,001,959851,Wilhelm; James E.,9998,0,9999,1
1746580278109,CAT 124RS,A01,956906,Staff,6,0,25,19
1746580279134,CAT 125RS,A01,922013,Staff,6,0,25,19
1746580280158,CLRE 250,A00,891860,Morris; Sheldon,9995,0,9999,4
1746580282215,CLRE 251R,A00,907817,Mehta; Ravindra L.,9994,0,9999,5
1746580283243,CLRE 252,A00,891864,Cuomo; Raphael Eduardo,9993,0,9999,6
1746580284271,CLRE 253,A00,891867,Vaida; Florin,9994,0,9999,5
1746580284271,CLRE 253,B00,907819,Staff,9999,0,9999,0
1746580285297,CLRE 259,A00,891868,Patel; Hemal,9998,0,9999,1
1746580286322,CLRE 260,A00,891872,Cuomo; Raphael Eduardo,9999,0,9999,0
1746580287351,CLRE 297,001,891888,Cuomo; Raphael Eduardo,9999,0,9999,0
1746580288379,CSE 191,A00,958773,Minnes Kemp; Mor Mia,9995,0,9999,4
1746580289403,CSE 197,001,959846,Minnes Kemp; Mor Mia,9990,0,9999,9
1746580290435,CSS 201S,A01,892054,Mignozzetti; Umberto,25,0,30,5
1746580291463,CSS 202S,A01,892056,Mignozzetti; Umberto,25,0,30,5
1746580292492,DSC 197,001,956898,Eldridge; Justin Matthew,9996,0,9999,3
1746580293517,DSC 297,001,958000,Mazumdar; Arya,9998,0,9999,1
1746580293517,DSC 297,002,959862,Wang; Yusu,9998,0,9999,1
1746580294540,EAP 100,A00,905686,Staff,9778,0,9999,221
1746580295566,ECE 45,A01,892618,Staff,0,0,65,65
1746580297628,ECE 111,A01,892719,Staff,6,0,65,59
1746580298653,ECE 197,001,957920,Mercier; Patrick Philip,9991,0,9999,8
1746580299679,ECON 178,A01,907814,Zhu; Ying,26,0,35,9
1746580300709,EDS 115,A00,895312,Staff,35,0,45,10
1746580301735,EDS 117,A01,895337,Staff,23,0,30,7
1746580302760,EDS 125,A00,895341,Jones; Gabrielle Anastasia,36,0,45,9
1746580303790,EDS 128A,A01,895459,Fargason; Sharon Gayle,44,0,45,1
1746580304814,EDS 128B,A01,895543,Pappas; Elizabeth,44,0,45,1
1746580305841,EDS 139,A00,897203,Pappas; Elizabeth,44,0,45,1
1746580305841,EDS 139,B00,897209,Fargason; Sharon Gayle,41,0,45,4
1746580306870,EDS 201,A00,895545,Staff,22,0,45,23
1746580307894,EDS 203,A01,895581,Halter; Christopher P.,22,0,45,23
1746580308923,EDS 204R,A01,895625,Heinzman; Erica M.,39,0,45,6
1746580308923,EDS 204R,B01,895693,Halter; Christopher P.,10,0,45,35
1746580309951,EDS 206R,A00,895694,Fargason; Sharon Gayle,1,0,30,29
1746580309951,EDS 206R,B00,895695,Choi; Bailey Miyeon,16,0,30,14
1746580310976,EDS 250,A00,895697,Hemans; Patricia Ann Benitez,22,0,45,23
1746580312002,EDS 281,A00,895701,Meyerott; Theresa Ann,1,0,15,14
1746580313029,EDS 284,A00,895736,Meyerott; Theresa Ann,1,0,15,14
1746580314054,EDS 286,A00,897210,Fine; Sarah,0,0,15,15
1746580315083,EDS 289C,A01,895770,Daly; Alan J.,1,0,15,14
1746580316112,EDS 290,A00,897211,Hofstetter; Carolyn,0,0,15,15
1746580317142,LIGM 5A,A00,896162,Fischer-Grunski; Eva K,12,0,20,8
1746580318169,LIGM 5B,A00,896260,Fischer-Grunski; Eva K,17,0,20,3
1746580319196,LIGM 5C,A00,896308,Fischer-Grunski; Eva K,18,0,20,2
1746580320235,LIIT 5AS,A00,896313,Carnelos; Chiara,18,0,20,2
1746580321261,LIIT 5BS,A00,896416,Carnelos; Chiara,20,0,20,0
1746580322286,LIIT 5CS,A00,896564,Carnelos; Chiara,20,0,20,0
1746580323315,LISP 5A,A00,896588,Munoz Sanchez; Alicia,2,0,20,18
1746580324340,LISP 5B,A00,896653,Munoz Sanchez; Alicia,7,0,20,13
1746580325365,LISP 5C,A00,896655,Munoz Sanchez; Alicia,0,1,20,20
1746580326395,MAE 197,001,957918,Kleissl; Jan,9996,0,9999,3
1746580326395,MAE 197,002,959806,Boechler; Nicholas Sebastia,9998,0,9999,1
1746580326395,MAE 197,003,959852,Mullin; Jennifer S,9998,0,9999,1
1746580327419,MATH 2,A01,957937,Staff,33,0,35,2
1746580328444,MATH 197,001,957876,Kedlaya; Kiran S.,9993,0,9999,6
1746580329482,MCWP 40,A00,892729,Duru; Nur,10,0,20,10
1746580329482,MCWP 40,B00,893304,Montejo; Carolina,14,0,20,6
1746580330505,MCWP 40R,A00,893757,Redela; Pamela Morgan,0,5,20,20
1746580331534,MCWP 50,A00,893758,Morshed; Michael James,0,0,20,20
1746580331534,MCWP 50,B00,893761,Bartulis; Jason Michael,17,0,20,3
1746580332564,MCWP 50R,A00,893766,Compas; Sean Matthew,0,1,20,20
1746580332564,MCWP 50R,B00,893769,Carter; Jennifer A,0,1,20,20
1746580332564,MCWP 50R,C00,893771,Krone; Jarret,0,3,20,20
1746580332564,MCWP 50R,D00,893772,Miller; Elizabeth Deen,0,0,20,20
1746580332564,MCWP 50R,E00,893775,Carter; Andrea L,0,1,20,20
1746580333590,MMW 11R,A01,892721,Herbst; Matthew,14,0,30,16
1746580333590,MMW 11R,A02,892722,Herbst; Matthew,0,0,0,3
1746580334618,MMW 12R,A01,892724,Herbst; Matthew,0,11,16,16
1746580334618,MMW 12R,A02,892725,Herbst; Matthew,0,10,16,16
1746580335647,MMW 13R,A01,892727,Staff,0,4,16,16
1746580335647,MMW 13R,A02,892728,Staff,0,4,16,16
1746580335647,MMW 13R,A03,958032,Staff,0,4,16,16
1746580335647,MMW 13R,A04,958033,Staff,0,4,16,16
1746580335647,MMW 13R,A05,958034,Staff,0,4,16,16
1746580336673,SIO 295LS,A00,894015,Staff,5,0,25,20
1746580337702,SIO 295S,A00,894020,Staff,5,0,25,20
1746580338728,SIOC 290S,B01,958918,Merrifield; Mark A,14,0,30,16
1746580339756,SIOC 291S,B01,958922,Gabriel; Corey John,14,0,30,16
1746580340781,SOCI 117,A01,895339,Staff,3,0,5,2
1746580341810,WES 237B,A00,894149,Staff,11,0,20,9
1746580343870,AESE 279B,A00,891859,Staff,13,0,35,22
1746580344896,AIP 197,001,891854,Vespa; Emanuel Ignacio,9999,0,9999,0
1746580345925,ANTH 289S,A00,891856,Gagneux; Pascal,12,0,12,0
1746580346951,BENG 196,001,957946,Engler; Adam J.,9996,0,9999,3
1746580347976,BISP 197,001,959851,Wilhelm; James E.,9998,0,9999,1
1746580349005,CAT 124RS,A01,956906,Staff,6,0,25,19
1746580350035,CAT 125RS,A01,922013,Staff,6,0,25,19
1746580351060,CLRE 250,A00,891860,Morris; Sheldon,9995,0,9999,4
1746580353110,CLRE 251R,A00,907817,Mehta; Ravindra L.,9994,0,9999,5
1746580354139,CLRE 252,A00,891864,Cuomo; Raphael Eduardo,9993,0,9999,6
1746580355166,CLRE 253,A00,891867,Vaida; Florin,9994,0,9999,5
1746580355166,CLRE 253,B00,907819,Staff,9999,0,9999,0
1746580356191,CLRE 259,A00,891868,Patel; Hemal,9998,0,9999,1
1746580357215,CLRE 260,A00,891872,Cuomo; Raphael Eduardo,9999,0,9999,0
1746580358242,CLRE 297,001,891888,Cuomo; Raphael Eduardo,9999,0,9999,0
1746580359270,CSE 191,A00,958773,Minnes Kemp; Mor Mia,9995,0,9999,4
1746580360298,CSE 197,001,959846,Minnes Kemp; Mor Mia,9990,0,9999,9
1746580361326,CSS 201S,A01,892054,Mignozzetti; Umberto,25,0,30,5
1746580362352,CSS 202S,A01,892056,Mignozzetti; Umberto,25,0,30,5
1746580363376,DSC 197,001,956898,Eldridge; Justin Matthew,9996,0,9999,3
1746580364444,DSC 297,001,958000,Mazumdar; Arya,9998,0,9999,1
1746580364444,DSC 297,002,959862,Wang; Yusu,9998,0,9999,1
1746580365470,EAP 100,A00,905686,Staff,9778,0,9999,221
1746580366517,ECE 45,A01,892618,Staff,0,0,65,65
1746580368574,ECE 111,A01,892719,Staff,6,0,65,59
1746580369601,ECE 197,001,957920,Mercier; Patrick Philip,9991,0,9999,8
1746580370626,ECON 178,A01,907814,Zhu; Ying,26,0,35,9
1746580371652,EDS 115,A00,895312,Staff,35,0,45,10
1746580372680,EDS 117,A01,895337,Staff,23,0,30,7
1746580373706,EDS 125,A00,895341,Jones; Gabrielle Anastasia,36,0,45,9
1746580374731,EDS 128A,A01,895459,Fargason; Sharon Gayle,44,0,45,1
1746580375759,EDS 128B,A01,895543,Pappas; Elizabeth,44,0,45,1
1746580376787,EDS 139,A00,897203,Pappas; Elizabeth,44,0,45,1
1746580376787,EDS 139,B00,897209,Fargason; Sharon Gayle,41,0,45,4
1746580377812,EDS 201,A00,895545,Staff,22,0,45,23
1746580378838,EDS 203,A01,895581,Halter; Christopher P.,22,0,45,23
1746580379863,EDS 204R,A01,895625,Heinzman; Erica M.,39,0,45,6
1746580379863,EDS 204R,B01,895693,Halter; Christopher P.,10,0,45,35
1746580380888,EDS 206R,A00,895694,Fargason; Sharon Gayle,1,0,30,29
1746580380888,EDS 206R,B00,895695,Choi; Bailey Miyeon,16,0,30,14
1746580381917,EDS 250,A00,895697,Hemans; Patricia Ann Benitez,22,0,45,23
1746580382946,EDS 281,A00,895701,Meyerott; Theresa Ann,1,0,15,14
1746580383972,EDS 284,A00,895736,Meyerott; Theresa Ann,1,0,15,14
1746580384998,EDS 286,A00,897210,Fine; Sarah,0,0,15,15
1746580386025,EDS 289C,A01,895770,Daly; Alan J.,1,0,15,14
1746580387054,EDS 290,A00,897211,Hofstetter; Carolyn,0,0,15,15
1746580388079,LIGM 5A,A00,896162,Fischer-Grunski; Eva K,12,0,20,8
1746580389111,LIGM 5B,A00,896260,Fischer-Grunski; Eva K,17,0,20,3
1746580390136,LIGM 5C,A00,896308,Fischer-Grunski; Eva K,18,0,20,2
1746580391170,LIIT 5AS,A00,896313,Carnelos; Chiara,18,0,20,2
1746580392197,LIIT 5BS,A00,896416,Carnelos; Chiara,20,0,20,0
1746580393225,LIIT 5CS,A00,896564,Carnelos; Chiara,20,0,20,0
1746580394250,LISP 5A,A00,896588,Munoz Sanchez; Alicia,2,0,20,18
1746580395279,LISP 5B,A00,896653,Munoz Sanchez; Alicia,7,0,20,13
1746580396303,LISP 5C,A00,896655,Munoz Sanchez; Alicia,0,1,20,20
1746580397330,MAE 197,001,957918,Kleissl; Jan,9996,0,9999,3
1746580397330,MAE 197,002,959806,Boechler; Nicholas Sebastia,9998,0,9999,1
1746580397330,MAE 197,003,959852,Mullin; Jennifer S,9998,0,9999,1
1746580398359,MATH 2,A01,957937,Staff,33,0,35,2
1746580399383,MATH 197,001,957876,Kedlaya; Kiran S.,9993,0,9999,6
1746580400413,MCWP 40,A00,892729,Duru; Nur,10,0,20,10
1746580400413,MCWP 40,B00,893304,Montejo; Carolina,14,0,20,6
1746580401443,MCWP 40R,A00,893757,Redela; Pamela Morgan,0,5,20,20
1746580402470,MCWP 50,A00,893758,Morshed; Michael James,0,0,20,20
1746580402470,MCWP 50,B00,893761,Bartulis; Jason Michael,17,0,20,3
1746580403495,MCWP 50R,A00,893766,Compas; Sean Matthew,0,1,20,20
1746580403495,MCWP 50R,B00,893769,Carter; Jennifer A,0,1,20,20
1746580403495,MCWP 50R,C00,893771,Krone; Jarret,0,3,20,20
1746580403495,MCWP 50R,D00,893772,Miller; Elizabeth Deen,0,0,20,20
1746580403495,MCWP 50R,E00,893775,Carter; Andrea L,0,1,20,20
1746580404520,MMW 11R,A01,892721,Herbst; Matthew,14,0,30,16
1746580404520,MMW 11R,A02,892722,Herbst; Matthew,0,0,0,3
1746580405550,MMW 12R,A01,892724,Herbst; Matthew,0,11,16,16
1746580405550,MMW 12R,A02,892725,Herbst; Matthew,0,10,16,16
1746580406579,MMW 13R,A01,892727,Staff,0,4,16,16
1746580406579,MMW 13R,A02,892728,Staff,0,4,16,16
1746580406579,MMW 13R,A03,958032,Staff,0,4,16,16
1746580406579,MMW 13R,A04,958033,Staff,0,4,16,16
1746580406579,MMW 13R,A05,958034,Staff,0,4,16,16
1746580407610,SIO 295LS,A00,894015,Staff,5,0,25,20
1746580408634,SIO 295S,A00,894020,Staff,5,0,25,20
1746580409659,SIOC 290S,B01,958918,Merrifield; Mark A,14,0,30,16
1746580410689,SIOC 291S,B01,958922,Gabriel; Corey John,14,0,30,16
1746580411714,SOCI 117,A01,895339,Staff,3,0,5,2
1746580412739,WES 237B,A00,894149,Staff,11,0,20,9
1746580414803,AESE 279B,A00,891859,Staff,13,0,35,22
1746580415829,AIP 197,001,891854,Vespa; Emanuel Ignacio,9999,0,9999,0
1746580416857,ANTH 289S,A00,891856,Gagneux; Pascal,12,0,12,0
1746580417883,BENG 196,001,957946,Engler; Adam J.,9996,0,9999,3
1746580418907,BISP 197,001,959851,Wilhelm; James E.,9998,0,9999,1
1746580419934,CAT 124RS,A01,956906,Staff,6,0,25,19
1746580420961,CAT 125RS,A01,922013,Staff,6,0,25,19
1746580421987,CLRE 250,A00,891860,Morris; Sheldon,9995,0,9999,4
1746580424038,CLRE 251R,A00,907817,Mehta; Ravindra L.,9994,0,9999,5
1746580425062,CLRE 252,A00,891864,Cuomo; Raphael Eduardo,9993,0,9999,6
1746580426088,CLRE 253,A00,891867,Vaida; Florin,9994,0,9999,5
1746580426088,CLRE 253,B00,907819,Staff,9999,0,9999,0
1746580427115,CLRE 259,A00,891868,Patel; Hemal,9998,0,9999,1
1746580428141,CLRE 260,A00,891872,Cuomo; Raphael Eduardo,9999,0,9999,0
1746580429167,CLRE 297,001,891888,Cuomo; Raphael Eduardo,9999,0,9999,0
1746580430192,CSE 191,A00,958773,Minnes Kemp; Mor Mia,9995,0,9999,4
1746580431222,CSE 197,001,959846,Minnes Kemp; Mor Mia,9990,0,9999,9
1746580432320,CSS 201S,A01,892054,Mignozzetti; Umberto,25,0,30,5
1746580433350,CSS 202S,A01,892056,Mignozzetti; Umberto,25,0,30,5
1746580434375,DSC 197,001,956898,Eldridge; Justin Matthew,9996,0,9999,3
1746580435398,DSC 297,001,958000,Mazumdar; Arya,9998,0,9999,1
1746580435398,DSC 297,002,959862,Wang; Yusu,9998,0,9999,1
1746580436423,EAP 100,A00,905686,Staff,9778,0,9999,221
1746580437453,ECE 45,A01,892618,Staff,0,0,65,65
1746580439506,ECE 111,A01,892719,Staff,6,0,65,59
1746580440530,ECE 197,001,957920,Mercier; Patrick Philip,9991,0,9999,8
1746580441556,ECON 178,A01,907814,Zhu; Ying,26,0,35,9
1746580442590,EDS 115,A00,895312,Staff,35,0,45,10
1746580443677,EDS 117,A01,895337,Staff,23,0,30,7
1746580444701,EDS 125,A00,895341,Jones; Gabrielle Anastasia,36,0,45,9
1746580445739,EDS 128A,A01,895459,Fargason; Sharon Gayle,44,0,45,1
1746580446767,EDS 128B,A01,895543,Pappas; Elizabeth,44,0,45,1
1746580447847,EDS 139,A00,897203,Pappas; Elizabeth,44,0,45,1
1746580447847,EDS 139,B00,897209,Fargason; Sharon Gayle,41,0,45,4
1746580448875,EDS 201,A00,895545,Staff,22,0,45,23
1746580449899,EDS 203,A01,895581,Halter; Christopher P.,22,0,45,23
1746580450929,EDS 204R,A01,895625,Heinzman; Erica M.,39,0,45,6
1746580450929,EDS 204R,B01,895693,Halter; Christopher P.,10,0,45,35
1746580451957,EDS 206R,A00,895694,Fargason; Sharon Gayle,1,0,30,29
1746580451957,EDS 206R,B00,895695,Choi; Bailey Miyeon,16,0,30,14
1746580452982,EDS 250,A00,895697,Hemans; Patricia Ann Benitez,22,0,45,23
1746580454011,EDS 281,A00,895701,Meyerott; Theresa Ann,1,0,15,14
1746580455042,EDS 284,A00,895736,Meyerott; Theresa Ann,1,0,15,14
1746580456070,EDS 286,A00,897210,Fine; Sarah,0,0,15,15
1746580457098,EDS 289C,A01,895770,Daly; Alan J.,1,0,15,14
1746580458124,EDS 290,A00,897211,Hofstetter; Carolyn,0,0,15,15
1746580459153,LIGM 5A,A00,896162,Fischer-Grunski; Eva K,12,0,20,8
1746580460182,LIGM 5B,A00,896260,Fischer-Grunski; Eva K,17,0,20,3
1746580461206,LIGM 5C,A00,896308,Fischer-Grunski; Eva K,18,0,20,2
1746580462236,LIIT 5AS,A00,896313,Carnelos; Chiara,18,0,20,2
1746580463262,LIIT 5BS,A00,896416,Carnelos; Chiara,20,0,20,0
1746580464288,LIIT 5CS,A00,896564,Carnelos; Chiara,20,0,20,0
1746580465313,LISP 5A,A00,896588,Munoz Sanchez; Alicia,2,0,20,18
1746580466337,LISP 5B,A00,896653,Munoz Sanchez; Alicia,7,0,20,13
1746580467364,LISP 5C,A00,896655,Munoz Sanchez; Alicia,0,1,20,20
1746580468443,MAE 197,001,957918,Kleissl; Jan,9996,0,9999,3
1746580468443,MAE 197,002,959806,Boechler; Nicholas Sebastia,9998,0,9999,1
1746580468443,MAE 197,003,959852,Mullin; Jennifer S,9998,0,9999,1
1746580469468,MATH 2,A01,957937,Staff,33,0,35,2
1746580470494,MATH 197,001,957876,Kedlaya; Kiran S.,9993,0,9999,6
1746580471523,MCWP 40,A00,892729,Duru; Nur,10,0,20,10
1746580471523,MCWP 40,B00,893304,Montejo; Carolina,14,0,20,6
1746580472548,MCWP 40R,A00,893757,Redela; Pamela Morgan,0,5,20,20
1746580473578,MCWP 50,A00,893758,Morshed; Michael James,0,0,20,20
1746580473578,MCWP 50,B00,893761,Bartulis; Jason Michael,17,0,20,3
1746580474607,MCWP 50R,A00,893766,Compas; Sean Matthew,0,1,20,20
1746580474607,MCWP 50R,B00,893769,Carter; Jennifer A,0,1,20,20
1746580474607,MCWP 50R,C00,893771,Krone; Jarret,0,3,20,20
1746580474607,MCWP 50R,D00,893772,Miller; Elizabeth Deen,0,0,20,20
1746580474607,MCWP 50R,E00,893775,Carter; Andrea L,0,1,20,20
1746580475632,MMW 11R,A01,892721,Herbst; Matthew,14,0,30,16
1746580475632,MMW 11R,A02,892722,Herbst; Matthew,0,0,0,3
1746580476661,MMW 12R,A01,892724,Herbst; Matthew,0,11,16,16
1746580476661,MMW 12R,A02,892725,Herbst; Matthew,0,10,16,16
1746580477689,MMW 13R,A01,892727,Staff,0,4,16,16
1746580477689,MMW 13R,A02,892728,Staff,0,4,16,16
1746580477689,MMW 13R,A03,958032,Staff,0,4,16,16
1746580477689,MMW 13R,A04,958033,Staff,0,4,16,16
1746580477689,MMW 13R,A05,958034,Staff,0,4,16,16
1746580478719,SIO 295LS,A00,894015,Staff,5,0,25,20
1746580479745,SIO 295S,A00,894020,Staff,5,0,25,20
1746580480771,SIOC 290S,B01,958918,Merrifield; Mark A,14,0,30,16
1746580481799,SIOC 291S,B01,958922,Gabriel; Corey John,14,0,30,16
1746580482826,SOCI 117,A01,895339,Staff,3,0,5,2
1746580483854,WES 237B,A00,894149,Staff,11,0,20,9
1746580485921,AESE 279B,A00,891859,Staff,13,0,35,22
1746580486945,AIP 197,001,891854,Vespa; Emanuel Ignacio,9999,0,9999,0
1746580487975,ANTH 289S,A00,891856,Gagneux; Pascal,12,0,12,0
1746580489005,BENG 196,001,957946,Engler; Adam J.,9996,0,9999,3
1746580490029,BISP 197,001,959851,Wilhelm; James E.,9998,0,9999,1
1746580491054,CAT 124RS,A01,956906,Staff,6,0,25,19
1746580492082,CAT 125RS,A01,922013,Staff,6,0,25,19
1746580493107,CLRE 250,A00,891860,Morris; Sheldon,9995,0,9999,4
1746580495162,CLRE 251R,A00,907817,Mehta; Ravindra L.,9994,0,9999,5
1746580496188,CLRE 252,A00,891864,Cuomo; Raphael Eduardo,9993,0,9999,6
1746580497217,CLRE 253,A00,891867,Vaida; Florin,9994,0,9999,5
1746580497217,CLRE 253,B00,907819,Staff,9999,0,9999,0
1746580498242,CLRE 259,A00,891868,Patel; Hemal,9998,0,9999,1
1746580499267,CLRE 260,A00,891872,Cuomo; Raphael Eduardo,9999,0,9999,0
1746580500293,CLRE 297,001,891888,Cuomo; Raphael Eduardo,9999,0,9999,0
1746580501322,CSE 191,A00,958773,Minnes Kemp; Mor Mia,9995,0,9999,4
1746580502347,CSE 197,001,959846,Minnes Kemp; Mor Mia,9990,0,9999,9
1746580503377,CSS 201S,A01,892054,Mignozzetti; Umberto,25,0,30,5
1746580504402,CSS 202S,A01,892056,Mignozzetti; Umberto,25,0,30,5
1746580505439,DSC 197,001,956898,Eldridge; Justin Matthew,9996,0,9999,3
1746580506465,DSC 297,001,958000,Mazumdar; Arya,9998,0,9999,1
1746580506465,DSC 297,002,959862,Wang; Yusu,9998,0,9999,1
1746580507490,EAP 100,A00,905686,Staff,9778,0,9999,221
1746580508521,ECE 45,A01,892618,Staff,0,0,65,65
1746580510575,ECE 111,A01,892719,Staff,6,0,65,59
1746580511601,ECE 197,001,957920,Mercier; Patrick Philip,9991,0,9999,8
1746580512625,ECON 178,A01,907814,Zhu; Ying,26,0,35,9
1746580513653,EDS 115,A00,895312,Staff,35,0,45,10
1746580514678,EDS 117,A01,895337,Staff,23,0,30,7
1746580515707,EDS 125,A00,895341,Jones; Gabrielle Anastasia,36,0,45,9
1746580516734,EDS 128A,A01,895459,Fargason; Sharon Gayle,44,0,45,1
1746580517760,EDS 128B,A01,895543,Pappas; Elizabeth,44,0,45,1
1746580518785,EDS 139,A00,897203,Pappas; Elizabeth,44,0,45,1
1746580518785,EDS 139,B00,897209,Fargason; Sharon Gayle,41,0,45,4
1746580519808,EDS 201,A00,895545,Staff,22,0,45,23
1746580520834,EDS 203,A01,895581,Halter; Christopher P.,22,0,45,23
1746580521861,EDS 204R,A01,895625,Heinzman; Erica M.,39,0,45,6
1746580521861,EDS 204R,B01,895693,Halter; Christopher P.,10,0,45,35
1746580522887,EDS 206R,A00,895694,Fargason; Sharon Gayle,1,0,30,29
1746580522887,EDS 206R,B00,895695,Choi; Bailey Miyeon,16,0,30,14
1746580523915,EDS 250,A00,895697,Hemans; Patricia Ann Benitez,22,0,45,23
1746580524943,EDS 281,A00,895701,Meyerott; Theresa Ann,1,0,15,14
1746580525971,EDS 284,A00,895736,Meyerott; Theresa Ann,1,0,15,14
1746580526999,EDS 286,A00,897210,Fine; Sarah,0,0,15,15
1746580528027,EDS 289C,A01,895770,Daly; Alan J.,1,0,15,14
1746580529057,EDS 290,A00,897211,Hofstetter; Carolyn,0,0,15,15
1746580530082,LIGM 5A,A00,896162,Fischer-Grunski; Eva K,12,0,20,8
1746580531110,LIGM 5B,A00,896260,Fischer-Grunski; Eva K,17,0,20,3
1746580532139,LIGM 5C,A00,896308,Fischer-Grunski; Eva K,18,0,20,2
1746580533164,LIIT 5AS,A00,896313,Carnelos; Chiara,18,0,20,2
1746580534190,LIIT 5BS,A00,896416,Carnelos; Chiara,20,0,20,0
1746580535221,LIIT 5CS,A00,896564,Carnelos; Chiara,20,0,20,0
1746580536246,LISP 5A,A00,896588,Munoz Sanchez; Alicia,2,0,20,18
1746580537272,LISP 5B,A00,896653,Munoz Sanchez; Alicia,7,0,20,13
1746580538301,LISP 5C,A00,896655,Munoz Sanchez; Alicia,0,1,20,20
1746580539330,MAE 197,001,957918,Kleissl; Jan,9996,0,9999,3
1746580539330,MAE 197,002,959806,Boechler; Nicholas Sebastia,9998,0,9999,1
1746580539330,MAE 197,003,959852,Mullin; Jennifer S,9998,0,9999,1
1746580540360,MATH 2,A01,957937,Staff,33,0,35,2
1746580541384,MATH 197,001,957876,Kedlaya; Kiran S.,9993,0,9999,6
1746580542415,MCWP 40,A00,892729,Duru; Nur,10,0,20,10
1746580542415,MCWP 40,B00,893304,Montejo; Carolina,14,0,20,6
1746580543438,MCWP 40R,A00,893757,Redela; Pamela Morgan,0,5,20,20
1746580544463,MCWP 50,A00,893758,Morshed; Michael James,0,0,20,20
1746580544463,MCWP 50,B00,893761,Bartulis; Jason Michael,17,0,20,3
1746580545488,MCWP 50R,A00,893766,Compas; Sean Matthew,0,1,20,20
1746580545488,MCWP 50R,B00,893769,Carter; Jennifer A,0,1,20,20
1746580545488,MCWP 50R,C00,893771,Krone; Jarret,0,3,20,20
1746580545488,MCWP 50R,D00,893772,Miller; Elizabeth Deen,0,0,20,20
1746580545488,MCWP 50R,E00,893775,Carter; Andrea L,0,1,20,20
1746580546512,MMW 11R,A01,892721,Herbst; Matthew,14,0,30,16
1746580546512,MMW 11R,A02,892722,Herbst; Matthew,0,0,0,3
1746580547537,MMW 12R,A01,892724,Herbst; Matthew,0,11,16,16
1746580547537,MMW 12R,A02,892725,Herbst; Matthew,0,10,16,16
1746580548562,MMW 13R,A01,892727,Staff,0,4,16,16
1746580548562,MMW 13R,A02,892728,Staff,0,4,16,16
1746580548562,MMW 13R,A03,958032,Staff,0,4,16,16
1746580548562,MMW 13R,A04,958033,Staff,0,4,16,16
1746580548562,MMW 13R,A05,958034,Staff,0,4,16,16
1746580549589,SIO 295LS,A00,894015,Staff,5,0,25,20
1746580550619,SIO 295S,A00,894020,Staff,5,0,25,20
1746580551644,SIOC 290S,B01,958918,Merrifield; Mark A,14,0,30,16
1746580552674,SIOC 291S,B01,958922,Gabriel; Corey John,14,0,30,16
1746580553702,SOCI 117,A01,895339,Staff,3,0,5,2
1746580554729,WES 237B,A00,894149,Staff,11,0,20,9
1746580556800,AESE 279B,A00,891859,Staff,13,0,35,22
1746580557826,AIP 197,001,891854,Vespa; Emanuel Ignacio,9999,0,9999,0
1746580558853,ANTH 289S,A00,891856,Gagneux; Pascal,12,0,12,0
1746580559877,BENG 196,001,957946,Engler; Adam J.,9996,0,9999,3
1746580560902,BISP 197,001,959851,Wilhelm; James E.,9998,0,9999,1
1746580561928,CAT 124RS,A01,956906,Staff,6,0,25,19
1746580562955,CAT 125RS,A01,922013,Staff,6,0,25,19
1746580563986,CLRE 250,A00,891860,Morris; Sheldon,9995,0,9999,4
1746580566040,CLRE 251R,A00,907817,Mehta; Ravindra L.,9994,0,9999,5
1746580567065,CLRE 252,A00,891864,Cuomo; Raphael Eduardo,9993,0,9999,6
1746580568094,CLRE 253,A00,891867,Vaida; Florin,9994,0,9999,5
1746580568094,CLRE 253,B00,907819,Staff,9999,0,9999,0
1746580569122,CLRE 259,A00,891868,Patel; Hemal,9998,0,9999,1
1746580570150,CLRE 260,A00,891872,Cuomo; Raphael Eduardo,9999,0,9999,0
1746580571173,CLRE 297,001,891888,Cuomo; Raphael Eduardo,9999,0,9999,0
1746580572238,CSE 191,A00,958773,Minnes Kemp; Mor Mia,9995,0,9999,4
1746580573266,CSE 197,001,959846,Minnes Kemp; Mor Mia,9990,0,9999,9
1746580574290,CSS 201S,A01,892054,Mignozzetti; Umberto,25,0,30,5
1746580575320,CSS 202S,A01,892056,Mignozzetti; Umberto,25,0,30,5
1746580576344,DSC 197,001,956898,Eldridge; Justin Matthew,9996,0,9999,3
1746580577375,DSC 297,001,958000,Mazumdar; Arya,9998,0,9999,1
1746580577375,DSC 297,002,959862,Wang; Yusu,9998,0,9999,1
1746580578400,EAP 100,A00,905686,Staff,9778,0,9999,221
1746580579425,ECE 45,A01,892618,Staff,0,0,65,65
1746580581480,ECE 111,A01,892719,Staff,6,0,65,59
1746580582505,ECE 197,001,957920,Mercier; Patrick Philip,9991,0,9999,8
1746580583536,ECON 178,A01,907814,Zhu; Ying,26,0,35,9
1746580584562,EDS 115,A00,895312,Staff,35,0,45,10
1746580585588,EDS 117,A01,895337,Staff,23,0,30,7
1746580586613,EDS 125,A00,895341,Jones; Gabrielle Anastasia,36,0,45,9
1746580587642,EDS 128A,A01,895459,Fargason; Sharon Gayle,44,0,45,1
1746580588672,EDS 128B,A01,895543,Pappas; Elizabeth,44,0,45,1
1746580589696,EDS 139,A00,897203,Pappas; Elizabeth,44,0,45,1
1746580589696,EDS 139,B00,897209,Fargason; Sharon Gayle,41,0,45,4
1746580590722,EDS 201,A00,895545,Staff,22,0,45,23
1746580591746,EDS 203,A01,895581,Halter; Christopher P.,22,0,45,23
1746580592774,EDS 204R,A01,895625,Heinzman; Erica M.,39,0,45,6
1746580592774,EDS 204R,B01,895693,Halter; Christopher P.,10,0,45,35
1746580593805,EDS 206R,A00,895694,Fargason; Sharon Gayle,1,0,30,29
1746580593805,EDS 206R,B00,895695,Choi; Bailey Miyeon,16,0,30,14
1746580594833,EDS 250,A00,895697,Hemans; Patricia Ann Benitez,22,0,45,23
1746580595862,EDS 281,A00,895701,Meyerott; Theresa Ann,1,0,15,14
1746580596891,EDS 284,A00,895736,Meyerott; Theresa Ann,1,0,15,14
1746580597919,EDS 286,A00,897210,Fine; Sarah,0,0,15,15
1746580598948,EDS 289C,A01,895770,Daly; Alan J.,1,0,15,14
1746580599977,EDS 290,A00,897211,Hofstetter; Carolyn,0,0,15,15
1746580601008,LIGM 5A,A00,896162,Fischer-Grunski; Eva K,12,0,20,8
1746580602033,LIGM 5B,A00,896260,Fischer-Grunski; Eva K,17,0,20,3
1746580603059,LIGM 5C,A00,896308,Fischer-Grunski; Eva K,18,0,20,2
1746580604083,LIIT 5AS,A00,896313,Carnelos; Chiara,18,0,20,2
1746580605108,LIIT 5BS,A00,896416,Carnelos; Chiara,20,0,20,0
1746580606141,LIIT 5CS,A00,896564,Carnelos; Chiara,20,0,20,0
1746580607168,LISP 5A,A00,896588,Munoz Sanchez; Alicia,2,0,20,18
1746580608197,LISP 5B,A00,896653,Munoz Sanchez; Alicia,7,0,20,13
1746580609223,LISP 5C,A00,896655,Munoz Sanchez; Alicia,0,1,20,20
1746580610248,MAE 197,001,957918,Kleissl; Jan,9996,0,9999,3
1746580610248,MAE 197,002,959806,Boechler; Nicholas Sebastia,9998,0,9999,1
1746580610248,MAE 197,003,959852,Mullin; Jennifer S,9998,0,9999,1
1746580611274,MATH 2,A01,957937,Staff,33,0,35,2
1746580612303,MATH 197,001,957876,Kedlaya; Kiran S.,9993,0,9999,6
1746580613328,MCWP 40,A00,892729,Duru; Nur,10,0,20,10
1746580613328,MCWP 40,B00,893304,Montejo; Carolina,14,0,20,6
1746580614352,MCWP 40R,A00,893757,Redela; Pamela Morgan,0,5,20,20
1746580615382,MCWP 50,A00,893758,Morshed; Michael James,0,0,20,20
1746580615382,MCWP 50,B00,893761,Bartulis; Jason Michael,17,0,20,3
1746580616406,MCWP 50R,A00,893766,Compas; Sean Matthew,0,1,20,20
1746580616406,MCWP 50R,B00,893769,Carter; Jennifer A,0,1,20,20
1746580616406,MCWP 50R,C00,893771,Krone; Jarret,0,3,20,20
1746580616406,MCWP 50R,D00,893772,Miller; Elizabeth Deen,0,0,20,20
1746580616406,MCWP 50R,E00,893775,Carter; Andrea L,0,1,20,20
1746580617432,MMW 11R,A01,892721,Herbst; Matthew,14,0,30,16
1746580617432,MMW 11R,A02,892722,Herbst; Matthew,0,0,0,3
1746580618457,MMW 12R,A01,892724,Herbst; Matthew,0,11,16,16
1746580618457,MMW 12R,A02,892725,Herbst; Matthew,0,10,16,16
1746580619482,MMW 13R,A01,892727,Staff,0,4,16,16
1746580619482,MMW 13R,A02,892728,Staff,0,4,16,16
1746580619482,MMW 13R,A03,958032,Staff,0,4,16,16
1746580619482,MMW 13R,A04,958033,Staff,0,4,16,16
1746580619482,MMW 13R,A05,958034,Staff,0,4,16,16
1746580620512,SIO 295LS,A00,894015,Staff,5,0,25,20
1746580621538,SIO 295S,A00,894020,Staff,5,0,25,20
1746580622563,SIOC 290S,B01,958918,Merrifield; Mark A,14,0,30,16
1746580623589,SIOC 291S,B01,958922,Gabriel; Corey John,14,0,30,16
1746580624617,SOCI 117,A01,895339,Staff,3,0,5,2
1746580625642,WES 237B,A00,894149,Staff,11,0,20,9
1746580627707,AESE 279B,A00,891859,Staff,13,0,35,22
1746580628736,AIP 197,001,891854,Vespa; Emanuel Ignacio,9999,0,9999,0
1746580629763,ANTH 289S,A00,891856,Gagneux; Pascal,12,0,12,0
1746580630787,BENG 196,001,957946,Engler; Adam J.,9996,0,9999,3
1746580631812,BISP 197,001,959851,Wilhelm; James E.,9998,0,9999,1
1746580632837,CAT 124RS,A01,956906,Staff,6,0,25,19
1746580633866,CAT 125RS,A01,922013,Staff,6,0,25,19
1746580634895,CLRE 250,A00,891860,Morris; Sheldon,9995,0,9999,4
1746580636949,CLRE 251R,A00,907817,Mehta; Ravindra L.,9994,0,9999,5
1746580637974,CLRE 252,A00,891864,Cuomo; Raphael Eduardo,9993,0,9999,6
1746580638999,CLRE 253,A00,891867,Vaida; Florin,9994,0,9999,5
1746580638999,CLRE 253,B00,907819,Staff,9999,0,9999,0
1746580640024,CLRE 259,A00,891868,Patel; Hemal,9998,0,9999,1
1746580641049,CLRE 260,A00,891872,Cuomo; Raphael Eduardo,9999,0,9999,0
1746580642076,CLRE 297,001,891888,Cuomo; Raphael Eduardo,9999,0,9999,0
1746580643105,CSE 191,A00,958773,Minnes Kemp; Mor Mia,9995,0,9999,4
1746580644133,CSE 197,001,959846,Minnes Kemp; Mor Mia,9990,0,9999,9
1746580645164,CSS 201S,A01,892054,Mignozzetti; Umberto,25,0,30,5
1746580646192,CSS 202S,A01,892056,Mignozzetti; Umberto,25,0,30,5
1746580647218,DSC 197,001,956898,Eldridge; Justin Matthew,9996,0,9999,3
1746580648243,DSC 297,001,958000,Mazumdar; Arya,9998,0,9999,1
1746580648243,DSC 297,002,959862,Wang; Yusu,9998,0,9999,1
1746580649269,EAP 100,A00,905686,Staff,9778,0,9999,221
1746580650296,ECE 45,A01,892618,Staff,0,0,65,65
1746580652353,ECE 111,A01,892719,Staff,6,0,65,59
1746580653380,ECE 197,001,957920,Mercier; Patrick Philip,9991,0,9999,8
1746580654405,ECON 178,A01,907814,Zhu; Ying,26,0,35,9
1746580655430,EDS 115,A00,895312,Staff,35,0,45,10
1746580656454,EDS 117,A01,895337,Staff,23,0,30,7
1746580657483,EDS 125,A00,895341,Jones; Gabrielle Anastasia,36,0,45,9
1746580658509,EDS 128A,A01,895459,Fargason; Sharon Gayle,44,0,45,1
1746580659537,EDS 128B,A01,895543,Pappas; Elizabeth,44,0,45,1
1746580660562,EDS 139,A00,897203,Pappas; Elizabeth,44,0,45,1
1746580660562,EDS 139,B00,897209,Fargason; Sharon Gayle,41,0,45,4
1746580661591,EDS 201,A00,895545,Staff,22,0,45,23
1746580662617,EDS 203,A01,895581,Halter; Christopher P.,22,0,45,23
1746580663643,EDS 204R,A01,895625,Heinzman; Erica M.,39,0,45,6
1746580663643,EDS 204R,B01,895693,Halter; Christopher P.,10,0,45,35
1746580664673,EDS 206R,A00,895694,Fargason; Sharon Gayle,1,0,30,29
1746580664673,EDS 206R,B00,895695,Choi; Bailey Miyeon,16,0,30,14
1746580665703,EDS 250,A00,895697,Hemans; Patricia Ann Benitez,22,0,45,23
1746580666727,EDS 281,A00,895701,Meyerott; Theresa Ann,1,0,15,14
1746580667755,EDS 284,A00,895736,Meyerott; Theresa Ann,1,0,15,14
1746580668781,EDS 286,A00,897210,Fine; Sarah,0,0,15,15
1746580669810,EDS 289C,A01,895770,Daly; Alan J.,1,0,15,14
1746580670836,EDS 290,A00,897211,Hofstetter; Carolyn,0,0,15,15
1746580671860,LIGM 5A,A00,896162,Fischer-Grunski; Eva K,12,0,20,8
1746580672888,LIGM 5B,A00,896260,Fischer-Grunski; Eva K,17,0,20,3
1746580673913,LIGM 5C,A00,896308,Fischer-Grunski; Eva K,18,0,20,2
1746580674939,LIIT 5AS,A00,896313,Carnelos; Chiara,18,0,20,2
1746580676011,LIIT 5BS,A00,896416,Carnelos; Chiara,20,0,20,0
1746580677037,LIIT 5CS,A00,896564,Carnelos; Chiara,20,0,20,0
1746580678063,LISP 5A,A00,896588,Munoz Sanchez; Alicia,2,0,20,18
1746580679090,LISP 5B,A00,896653,Munoz Sanchez; Alicia,7,0,20,13
1746580680122,LISP 5C,A00,896655,Munoz Sanchez; Alicia,0,1,20,20
1746580681149,MAE 197,001,957918,Kleissl; Jan,9996,0,9999,3
1746580681149,MAE 197,002,959806,Boechler; Nicholas Sebastia,9998,0,9999,1
1746580681149,MAE 197,003,959852,Mullin; Jennifer S,9998,0,9999,1
1746580682176,MATH 2,A01,957937,Staff,33,0,35,2
1746580683204,MATH 197,001,957876,Kedlaya; Kiran S.,9993,0,9999,6
1746580684228,MCWP 40,A00,892729,Duru; Nur,10,0,20,10
1746580684228,MCWP 40,B00,893304,Montejo; Carolina,14,0,20,6
1746580685254,MCWP 40R,A00,893757,Redela; Pamela Morgan,0,5,20,20
1746580686284,MCWP 50,A00,893758,Morshed; Michael James,0,0,20,20
1746580686284,MCWP 50,B00,893761,Bartulis; Jason Michael,17,0,20,3
1746580687310,MCWP 50R,A00,893766,Compas; Sean Matthew,0,1,20,20
1746580687310,MCWP 50R,B00,893769,Carter; Jennifer A,0,1,20,20
1746580687310,MCWP 50R,C00,893771,Krone; Jarret,0,3,20,20
1746580687310,MCWP 50R,D00,893772,Miller; Elizabeth Deen,0,0,20,20
1746580687310,MCWP 50R,E00,893775,Carter; Andrea L,0,1,20,20
1746580688336,MMW 11R,A01,892721,Herbst; Matthew,14,0,30,16
1746580688336,MMW 11R,A02,892722,Herbst; Matthew,0,0,0,3
1746580689362,MMW 12R,A01,892724,Herbst; Matthew,0,11,16,16
1746580689362,MMW 12R,A02,892725,Herbst; Matthew,0,10,16,16
1746580690386,MMW 13R,A01,892727,Staff,0,4,16,16
1746580690386,MMW 13R,A02,892728,Staff,0,4,16,16
1746580690386,MMW 13R,A03,958032,Staff,0,4,16,16
1746580690386,MMW 13R,A04,958033,Staff,0,4,16,16
1746580690386,MMW 13R,A05,958034,Staff,0,4,16,16
1746580691412,SIO 295LS,A00,894015,Staff,5,0,25,20
1746580692442,SIO 295S,A00,894020,Staff,5,0,25,20
1746580693468,SIOC 290S,B01,958918,Merrifield; Mark A,14,0,30,16
1746580694499,SIOC 291S,B01,958922,Gabriel; Corey John,14,0,30,16
1746580695523,SOCI 117,A01,895339,Staff,3,0,5,2
1746580696551,WES 237B,A00,894149,Staff,11,0,20,9
1746580698613,AESE 279B,A00,891859,Staff,13,0,35,22
1746580699639,AIP 197,001,891854,Vespa; Emanuel Ignacio,9999,0,9999,0
1746580700665,ANTH 289S,A00,891856,Gagneux; Pascal,12,0,12,0
1746580701690,BENG 196,001,957946,Engler; Adam J.,9996,0,9999,3
1746580702717,BISP 197,001,959851,Wilhelm; James E.,9998,0,9999,1
1746580703745,CAT 124RS,A01,956906,Staff,6,0,25,19
1746580704775,CAT 125RS,A01,922013,Staff,6,0,25,19
1746580705800,CLRE 250,A00,891860,Morris; Sheldon,9995,0,9999,4
1746580707855,CLRE 251R,A00,907817,Mehta; Ravindra L.,9994,0,9999,5
1746580708880,CLRE 252,A00,891864,Cuomo; Raphael Eduardo,9993,0,9999,6
1746580709906,CLRE 253,A00,891867,Vaida; Florin,9994,0,9999,5
1746580709906,CLRE 253,B00,907819,Staff,9999,0,9999,0
1746580710935,CLRE 259,A00,891868,Patel; Hemal,9998,0,9999,1
1746580711961,CLRE 260,A00,891872,Cuomo; Raphael Eduardo,9999,0,9999,0
1746580712990,CLRE 297,001,891888,Cuomo; Raphael Eduardo,9999,0,9999,0
1746580714015,CSE 191,A00,958773,Minnes Kemp; Mor Mia,9995,0,9999,4
1746580715039,CSE 197,001,959846,Minnes Kemp; Mor Mia,9990,0,9999,9
1746580716068,CSS 201S,A01,892054,Mignozzetti; Umberto,25,0,30,5
1746580717094,CSS 202S,A01,892056,Mignozzetti; Umberto,25,0,30,5
1746580718123,DSC 197,001,956898,Eldridge; Justin Matthew,9996,0,9999,3
1746580719147,DSC 297,001,958000,Mazumdar; Arya,9998,0,9999,1
1746580719147,DSC 297,002,959862,Wang; Yusu,9998,0,9999,1
1746580720175,EAP 100,A00,905686,Staff,9778,0,9999,221
1746580721202,ECE 45,A01,892618,Staff,0,0,65,65
1746580723256,ECE 111,A01,892719,Staff,6,0,65,59
1746580724285,ECE 197,001,957920,Mercier; Patrick Philip,9991,0,9999,8
1746580725311,ECON 178,A01,907814,Zhu; Ying,26,0,35,9
1746580726335,EDS 115,A00,895312,Staff,35,0,45,10
1746580727361,EDS 117,A01,895337,Staff,23,0,30,7
1746580728391,EDS 125,A00,895341,Jones; Gabrielle Anastasia,36,0,45,9
1746580729417,EDS 128A,A01,895459,Fargason; Sharon Gayle,44,0,45,1
1746580730446,EDS 128B,A01,895543,Pappas; Elizabeth,44,0,45,1
1746580731474,EDS 139,A00,897203,Pappas; Elizabeth,44,0,45,1
1746580731474,EDS 139,B00,897209,Fargason; Sharon Gayle,41,0,45,4
1746580732500,EDS 201,A00,895545,Staff,22,0,45,23
1746580733525,EDS 203,A01,895581,Halter; Christopher P.,22,0,45,23
1746580734552,EDS 204R,A01,895625,Heinzman; Erica M.,39,0,45,6
1746580734552,EDS 204R,B01,895693,Halter; Christopher P.,10,0,45,35
1746580735578,EDS 206R,A00,895694,Fargason; Sharon Gayle,1,0,30,29
1746580735578,EDS 206R,B00,895695,Choi; Bailey Miyeon,16,0,30,14
1746580736608,EDS 250,A00,895697,Hemans; Patricia Ann Benitez,22,0,45,23
1746580737636,EDS 281,A00,895701,Meyerott; Theresa Ann,1,0,15,14
1746580738661,EDS 284,A00,895736,Meyerott; Theresa Ann,1,0,15,14
1746580739687,EDS 286,A00,897210,Fine; Sarah,0,0,15,15
1746580740713,EDS 289C,A01,895770,Daly; Alan J.,1,0,15,14
1746580741739,EDS 290,A00,897211,Hofstetter; Carolyn,0,0,15,15
1746580742767,LIGM 5A,A00,896162,Fischer-Grunski; Eva K,12,0,20,8
1746580743798,LIGM 5B,A00,896260,Fischer-Grunski; Eva K,17,0,20,3
1746580744827,LIGM 5C,A00,896308,Fischer-Grunski; Eva K,18,0,20,2
1746580745854,LIIT 5AS,A00,896313,Carnelos; Chiara,18,0,20,2
1746580746878,LIIT 5BS,A00,896416,Carnelos; Chiara,20,0,20,0
1746580747902,LIIT 5CS,A00,896564,Carnelos; Chiara,20,0,20,0
1746580748932,LISP 5A,A00,896588,Munoz Sanchez; Alicia,2,0,20,18
1746580749959,LISP 5B,A00,896653,Munoz Sanchez; Alicia,7,0,20,13
1746580750986,LISP 5C,A00,896655,Munoz Sanchez; Alicia,0,1,20,20
1746580752018,MAE 197,001,957918,Kleissl; Jan,9996,0,9999,3
1746580752018,MAE 197,002,959806,Boechler; Nicholas Sebastia,9998,0,9999,1
1746580752018,MAE 197,003,959852,Mullin; Jennifer S,9998,0,9999,1
1746580753046,MATH 2,A01,957937,Staff,33,0,35,2
1746580754074,MATH 197,001,957876,Kedlaya; Kiran S.,9993,0,9999,6
1746580755105,MCWP 40,A00,892729,Duru; Nur,10,0,20,10
1746580755105,MCWP 40,B00,893304,Montejo; Carolina,14,0,20,6
1746580756131,MCWP 40R,A00,893757,Redela; Pamela Morgan,0,5,20,20
1746580757155,MCWP 50,A00,893758,Morshed; Michael James,0,0,20,20
1746580757155,MCWP 50,B00,893761,Bartulis; Jason Michael,17,0,20,3
1746580758186,MCWP 50R,A00,893766,Compas; Sean Matthew,0,1,20,20
1746580758186,MCWP 50R,B00,893769,Carter; Jennifer A,0,1,20,20
1746580758186,MCWP 50R,C00,893771,Krone; Jarret,0,3,20,20
1746580758186,MCWP 50R,D00,893772,Miller; Elizabeth Deen,0,0,20,20
1746580758186,MCWP 50R,E00,893775,Carter; Andrea L,0,1,20,20
1746580759210,MMW 11R,A01,892721,Herbst; Matthew,14,0,30,16
1746580759210,MMW 11R,A02,892722,Herbst; Matthew,0,0,0,3
1746580760239,MMW 12R,A01,892724,Herbst; Matthew,0,11,16,16
1746580760239,MMW 12R,A02,892725,Herbst; Matthew,0,10,16,16
1746580761267,MMW 13R,A01,892727,Staff,0,4,16,16
1746580761267,MMW 13R,A02,892728,Staff,0,4,16,16
1746580761267,MMW 13R,A03,958032,Staff,0,4,16,16
1746580761267,MMW 13R,A04,958033,Staff,0,4,16,16
1746580761267,MMW 13R,A05,958034,Staff,0,4,16,16
1746580762296,SIO 295LS,A00,894015,Staff,5,0,25,20
1746580763322,SIO 295S,A00,894020,Staff,5,0,25,20
1746580764352,SIOC 290S,B01,958918,Merrifield; Mark A,14,0,30,16
1746580765381,SIOC 291S,B01,958922,Gabriel; Corey John,14,0,30,16
1746580766407,SOCI 117,A01,895339,Staff,3,0,5,2
1746580767431,WES 237B,A00,894149,Staff,11,0,20,9
1746580769487,AESE 279B,A00,891859,Staff,13,0,35,22
1746580770513,AIP 197,001,891854,Vespa; Emanuel Ignacio,9999,0,9999,0
1746580771538,ANTH 289S,A00,891856,Gagneux; Pascal,12,0,12,0
1746580772563,BENG 196,001,957946,Engler; Adam J.,9996,0,9999,3
1746580773589,BISP 197,001,959851,Wilhelm; James E.,9998,0,9999,1
1746580774614,CAT 124RS,A01,956906,Staff,6,0,25,19
1746580775638,CAT 125RS,A01,922013,Staff,6,0,25,19
1746580776664,CLRE 250,A00,891860,Morris; Sheldon,9995,0,9999,4
1746580778716,CLRE 251R,A00,907817,Mehta; Ravindra L.,9994,0,9999,5
1746580779781,CLRE 252,A00,891864,Cuomo; Raphael Eduardo,9993,0,9999,6
1746580780807,CLRE 253,A00,891867,Vaida; Florin,9994,0,9999,5
1746580780807,CLRE 253,B00,907819,Staff,9999,0,9999,0
1746580781831,CLRE 259,A00,891868,Patel; Hemal,9998,0,9999,1
1746580782861,CLRE 260,A00,891872,Cuomo; Raphael Eduardo,9999,0,9999,0
1746580783888,CLRE 297,001,891888,Cuomo; Raphael Eduardo,9999,0,9999,0
1746580784917,CSE 191,A00,958773,Minnes Kemp; Mor Mia,9995,0,9999,4
1746580785943,CSE 197,001,959846,Minnes Kemp; Mor Mia,9990,0,9999,9
1746580786967,CSS 201S,A01,892054,Mignozzetti; Umberto,25,0,30,5
1746580787999,CSS 202S,A01,892056,Mignozzetti; Umberto,25,0,30,5
1746580789025,DSC 197,001,956898,Eldridge; Justin Matthew,9996,0,9999,3
1746580790050,DSC 297,001,958000,Mazumdar; Arya,9998,0,9999,1
1746580790050,DSC 297,002,959862,Wang; Yusu,9998,0,9999,1
1746580791076,EAP 100,A00,905686,Staff,9778,0,9999,221
1746580792108,ECE 45,A01,892618,Staff,0,0,65,65
1746580794159,ECE 111,A01,892719,Staff,6,0,65,59
1746580795183,ECE 197,001,957920,Mercier; Patrick Philip,9991,0,9999,8
1746580796209,ECON 178,A01,907814,Zhu; Ying,26,0,35,9
1746580797233,EDS 115,A00,895312,Staff,35,0,45,10
1746580798258,EDS 117,A01,895337,Staff,23,0,30,7
1746580799284,EDS 125,A00,895341,Jones; Gabrielle Anastasia,36,0,45,9
1746580800314,EDS 128A,A01,895459,Fargason; Sharon Gayle,44,0,45,1
1746580801343,EDS 128B,A01,895543,Pappas; Elizabeth,44,0,45,1
1746580802372,EDS 139,A00,897203,Pappas; Elizabeth,44,0,45,1
1746580802372,EDS 139,B00,897209,Fargason; Sharon Gayle,41,0,45,4
1746580803400,EDS 201,A00,895545,Staff,22,0,45,23
1746580804425,EDS 203,A01,895581,Halter; Christopher P.,22,0,45,23
1746580805450,EDS 204R,A01,895625,Heinzman; Erica M.,39,0,45,6
1746580805450,EDS 204R,B01,895693,Halter; Christopher P.,10,0,45,35
1746580806478,EDS 206R,A00,895694,Fargason; Sharon Gayle,1,0,30,29
1746580806478,EDS 206R,B00,895695,Choi; Bailey Miyeon,16,0,30,14
1746580807504,EDS 250,A00,895697,Hemans; Patricia Ann Benitez,22,0,45,23
1746580808528,EDS 281,A00,895701,Meyerott; Theresa Ann,1,0,15,14
1746580809553,EDS 284,A00,895736,Meyerott; Theresa Ann,1,0,15,14
1746580810581,EDS 286,A00,897210,Fine; Sarah,0,0,15,15
1746580811605,EDS 289C,A01,895770,Daly; Alan J.,1,0,15,14
1746580812634,EDS 290,A00,897211,Hofstetter; Carolyn,0,0,15,15
1746580813665,LIGM 5A,A00,896162,Fischer-Grunski; Eva K,12,0,20,8
1746580814690,LIGM 5B,A00,896260,Fischer-Grunski; Eva K,17,0,20,3
1746580815781,LIGM 5C,A00,896308,Fischer-Grunski; Eva K,18,0,20,2
1746580816811,LIIT 5AS,A00,896313,Carnelos; Chiara,18,0,20,2
1746580817845,LIIT 5BS,A00,896416,Carnelos; Chiara,20,0,20,0
1746580818870,LIIT 5CS,A00,896564,Carnelos; Chiara,20,0,20,0
1746580819894,LISP 5A,A00,896588,Munoz Sanchez; Alicia,2,0,20,18
1746580820919,LISP 5B,A00,896653,Munoz Sanchez; Alicia,7,0,20,13
1746580821948,LISP 5C,A00,896655,Munoz Sanchez; Alicia,0,1,20,20
1746580822973,MAE 197,001,957918,Kleissl; Jan,9996,0,9999,3
1746580822973,MAE 197,002,959806,Boechler; Nicholas Sebastia,9998,0,9999,1
1746580822973,MAE 197,003,959852,Mullin; Jennifer S,9998,0,9999,1
1746580824000,MATH 2,A01,957937,Staff,33,0,35,2
1746580825032,MATH 197,001,957876,Kedlaya; Kiran S.,9993,0,9999,6
1746580826062,MCWP 40,A00,892729,Duru; Nur,10,0,20,10
1746580826062,MCWP 40,B00,893304,Montejo; Carolina,14,0,20,6
1746580827087,MCWP 40R,A00,893757,Redela; Pamela Morgan,0,5,20,20
1746580828116,MCWP 50,A00,893758,Morshed; Michael James,0,0,20,20
1746580828116,MCWP 50,B00,893761,Bartulis; Jason Michael,17,0,20,3
1746580829142,MCWP 50R,A00,893766,Compas; Sean Matthew,0,1,20,20
1746580829142,MCWP 50R,B00,893769,Carter; Jennifer A,0,1,20,20
1746580829142,MCWP 50R,C00,893771,Krone; Jarret,0,3,20,20
1746580829142,MCWP 50R,D00,893772,Miller; Elizabeth Deen,0,0,20,20
1746580829142,MCWP 50R,E00,893775,Carter; Andrea L,0,1,20,20
1746580830173,MMW 11R,A01,892721,Herbst; Matthew,14,0,30,16
1746580830173,MMW 11R,A02,892722,Herbst; Matthew,0,0,0,3
1746580831201,MMW 12R,A01,892724,Herbst; Matthew,0,11,16,16
1746580831201,MMW 12R,A02,892725,Herbst; Matthew,0,10,16,16
1746580832230,MMW 13R,A01,892727,Staff,0,4,16,16
1746580832230,MMW 13R,A02,892728,Staff,0,4,16,16
1746580832230,MMW 13R,A03,958032,Staff,0,4,16,16
1746580832230,MMW 13R,A04,958033,Staff,0,4,16,16
1746580832230,MMW 13R,A05,958034,Staff,0,4,16,16
1746580833258,SIO 295LS,A00,894015,Staff,5,0,25,20
1746580834283,SIO 295S,A00,894020,Staff,5,0,25,20
1746580835314,SIOC 290S,B01,958918,Merrifield; Mark A,14,0,30,16
1746580836341,SIOC 291S,B01,958922,Gabriel; Corey John,14,0,30,16
1746580837366,SOCI 117,A01,895339,Staff,3,0,5,2
1746580838391,WES 237B,A00,894149,Staff,11,0,20,9
1746580840458,AESE 279B,A00,891859,Staff,13,0,35,22
1746580841487,AIP 197,001,891854,Vespa; Emanuel Ignacio,9999,0,9999,0
1746580842510,ANTH 289S,A00,891856,Gagneux; Pascal,12,0,12,0
1746580843535,BENG 196,001,957946,Engler; Adam J.,9996,0,9999,3
1746580844561,BISP 197,001,959851,Wilhelm; James E.,9998,0,9999,1
1746580845589,CAT 124RS,A01,956906,Staff,6,0,25,19
1746580846613,CAT 125RS,A01,922013,Staff,6,0,25,19
1746580847641,CLRE 250,A00,891860,Morris; Sheldon,9995,0,9999,4
1746580849692,CLRE 251R,A00,907817,Mehta; Ravindra L.,9994,0,9999,5
1746580850717,CLRE 252,A00,891864,Cuomo; Raphael Eduardo,9993,0,9999,6
1746580851744,CLRE 253,A00,891867,Vaida; Florin,9994,0,9999,5
1746580851744,CLRE 253,B00,907819,Staff,9999,0,9999,0
1746580852768,CLRE 259,A00,891868,Patel; Hemal,9998,0,9999,1
1746580853796,CLRE 260,A00,891872,Cuomo; Raphael Eduardo,9999,0,9999,0
1746580854823,CLRE 297,001,891888,Cuomo; Raphael Eduardo,9999,0,9999,0
1746580855853,CSE 191,A00,958773,Minnes Kemp; Mor Mia,9995,0,9999,4
1746580856881,CSE 197,001,959846,Minnes Kemp; Mor Mia,9990,0,9999,9
1746580857910,CSS 201S,A01,892054,Mignozzetti; Umberto,25,0,30,5
1746580858940,CSS 202S,A01,892056,Mignozzetti; Umberto,25,0,30,5
1746580859969,DSC 197,001,956898,Eldridge; Justin Matthew,9996,0,9999,3
1746580860999,DSC 297,001,958000,Mazumdar; Arya,9998,0,9999,1
1746580860999,DSC 297,002,959862,Wang; Yusu,9998,0,9999,1
1746580862028,EAP 100,A00,905686,Staff,9778,0,9999,221
1746580863054,ECE 45,A01,892618,Staff,0,0,65,65
1746580865108,ECE 111,A01,892719,Staff,6,0,65,59
1746580866134,ECE 197,001,957920,Mercier; Patrick Philip,9991,0,9999,8
1746580867158,ECON 178,A01,907814,Zhu; Ying,26,0,35,9
1746580868188,EDS 115,A00,895312,Staff,35,0,45,10
1746580869216,EDS 117,A01,895337,Staff,23,0,30,7
1746580870241,EDS 125,A00,895341,Jones; Gabrielle Anastasia,36,0,45,9
1746580871269,EDS 128A,A01,895459,Fargason; Sharon Gayle,44,0,45,1
1746580872297,EDS 128B,A01,895543,Pappas; Elizabeth,44,0,45,1
1746580873321,EDS 139,A00,897203,Pappas; Elizabeth,44,0,45,1
1746580873321,EDS 139,B00,897209,Fargason; Sharon Gayle,41,0,45,4
1746580874347,EDS 201,A00,895545,Staff,22,0,45,23
1746580875373,EDS 203,A01,895581,Halter; Christopher P.,22,0,45,23
1746580876402,EDS 204R,A01,895625,Heinzman; Erica M.,39,0,45,6
1746580876402,EDS 204R,B01,895693,Halter; Christopher P.,10,0,45,35
1746580877428,EDS 206R,A00,895694,Fargason; Sharon Gayle,1,0,30,29
1746580877428,EDS 206R,B00,895695,Choi; Bailey Miyeon,16,0,30,14
1746580878452,EDS 250,A00,895697,Hemans; Patricia Ann Benitez,22,0,45,23
1746580879478,EDS 281,A00,895701,Meyerott; Theresa Ann,1,0,15,14
1746580880505,EDS 284,A00,895736,Meyerott; Theresa Ann,1,0,15,14
1746580881533,EDS 286,A00,897210,Fine; Sarah,0,0,15,15
1746580882558,EDS 289C,A01,895770,Daly; Alan J.,1,0,15,14
1746580883625,EDS 290,A00,897211,Hofstetter; Carolyn,0,0,15,15
1746580884655,LIGM 5A,A00,896162,Fischer-Grunski; Eva K,12,0,20,8
1746580885686,LIGM 5B,A00,896260,Fischer-Grunski; Eva K,17,0,20,3
1746580886715,LIGM 5C,A00,896308,Fischer-Grunski; Eva K,18,0,20,2
1746580887742,LIIT 5AS,A00,896313,Carnelos; Chiara,18,0,20,2
1746580888768,LIIT 5BS,A00,896416,Carnelos; Chiara,20,0,20,0
1746580889793,LIIT 5CS,A00,896564,Carnelos; Chiara,20,0,20,0
1746580890819,LISP 5A,A00,896588,Munoz Sanchez; Alicia,2,0,20,18
1746580891849,LISP 5B,A00,896653,Munoz Sanchez; Alicia,7,0,20,13
1746580892876,LISP 5C,A00,896655,Munoz Sanchez; Alicia,0,1,20,20
1746580893902,MAE 197,001,957918,Kleissl; Jan,9996,0,9999,3
1746580893902,MAE 197,002,959806,Boechler; Nicholas Sebastia,9998,0,9999,1
1746580893902,MAE 197,003,959852,Mullin; Jennifer S,9998,0,9999,1
1746580894926,MATH 2,A01,957937,Staff,33,0,35,2
1746580895951,MATH 197,001,957876,Kedlaya; Kiran S.,9993,0,9999,6
1746580896977,MCWP 40,A00,892729,Duru; Nur,10,0,20,10
1746580896977,MCWP 40,B00,893304,Montejo; Carolina,14,0,20,6
1746580898006,MCWP 40R,A00,893757,Redela; Pamela Morgan,0,5,20,20
1746580899031,MCWP 50,A00,893758,Morshed; Michael James,0,0,20,20
1746580899031,MCWP 50,B00,893761,Bartulis; Jason Michael,17,0,20,3
1746580900058,MCWP 50R,A00,893766,Compas; Sean Matthew,0,1,20,20
1746580900058,MCWP 50R,B00,893769,Carter; Jennifer A,0,1,20,20
1746580900058,MCWP 50R,C00,893771,Krone; Jarret,0,3,20,20
1746580900058,MCWP 50R,D00,893772,Miller; Elizabeth Deen,0,0,20,20
1746580900058,MCWP 50R,E00,893775,Carter; Andrea L,0,1,20,20
1746580901085,MMW 11R,A01,892721,Herbst; Matthew,14,0,30,16
1746580901085,MMW 11R,A02,892722,Herbst; Matthew,0,0,0,3
1746580902110,MMW 12R,A01,892724,Herbst; Matthew,0,11,16,16
1746580902110,MMW 12R,A02,892725,Herbst; Matthew,0,10,16,16
1746580903136,MMW 13R,A01,892727,Staff,0,4,16,16
1746580903136,MMW 13R,A02,892728,Staff,0,4,16,16
1746580903136,MMW 13R,A03,958032,Staff,0,4,16,16
1746580903136,MMW 13R,A04,958033,Staff,0,4,16,16
1746580903136,MMW 13R,A05,958034,Staff,0,4,16,16
1746580904165,SIO 295LS,A00,894015,Staff,5,0,25,20
1746580905194,SIO 295S,A00,894020,Staff,5,0,25,20
1746580906220,SIOC 290S,B01,958918,Merrifield; Mark A,14,0,30,16
1746580907247,SIOC 291S,B01,958922,Gabriel; Corey John,14,0,30,16
1746580908275,SOCI 117,A01,895339,Staff,3,0,5,2
1746580909300,WES 237B,A00,894149,Staff,11,0,20,9
1746580911362,AESE 279B,A00,891859,Staff,13,0,35,22
1746580912398,AIP 197,001,891854,Vespa; Emanuel Ignacio,9999,0,9999,0
1746580913429,ANTH 289S,A00,891856,Gagneux; Pascal,12,0,12,0
1746580914453,BENG 196,001,957946,Engler; Adam J.,9996,0,9999,3
1746580915478,BISP 197,001,959851,Wilhelm; James E.,9998,0,9999,1
1746580916505,CAT 124RS,A01,956906,Staff,6,0,25,19
1746580917531,CAT 125RS,A01,922013,Staff,6,0,25,19
1746580918561,CLRE 250,A00,891860,Morris; Sheldon,9995,0,9999,4
1746580920611,CLRE 251R,A00,907817,Mehta; Ravindra L.,9994,0,9999,5
1746580921636,CLRE 252,A00,891864,Cuomo; Raphael Eduardo,9993,0,9999,6
1746580922666,CLRE 253,A00,891867,Vaida; Florin,9994,0,9999,5
1746580922666,CLRE 253,B00,907819,Staff,9999,0,9999,0
1746580923693,CLRE 259,A00,891868,Patel; Hemal,9998,0,9999,1
1746580924721,CLRE 260,A00,891872,Cuomo; Raphael Eduardo,9999,0,9999,0
1746580925747,CLRE 297,001,891888,Cuomo; Raphael Eduardo,9999,0,9999,0
1746580926771,CSE 191,A00,958773,Minnes Kemp; Mor Mia,9995,0,9999,4
1746580927796,CSE 197,001,959846,Minnes Kemp; Mor Mia,9990,0,9999,9
1746580928828,CSS 201S,A01,892054,Mignozzetti; Umberto,25,0,30,5
1746580929856,CSS 202S,A01,892056,Mignozzetti; Umberto,25,0,30,5
1746580930884,DSC 197,001,956898,Eldridge; Justin Matthew,9996,0,9999,3
1746580931913,DSC 297,001,958000,Mazumdar; Arya,9998,0,9999,1
1746580931913,DSC 297,002,959862,Wang; Yusu,9998,0,9999,1
1746580932940,EAP 100,A00,905686,Staff,9778,0,9999,221
1746580933970,ECE 45,A01,892618,Staff,0,0,65,65
1746580936027,ECE 111,A01,892719,Staff,6,0,65,59
1746580937053,ECE 197,001,957920,Mercier; Patrick Philip,9991,0,9999,8
1746580938077,ECON 178,A01,907814,Zhu; Ying,26,0,35,9
1746580939107,EDS 115,A00,895312,Staff,35,0,45,10
1746580940137,EDS 117,A01,895337,Staff,23,0,30,7
1746580941162,EDS 125,A00,895341,Jones; Gabrielle Anastasia,36,0,45,9
1746580942187,EDS 128A,A01,895459,Fargason; Sharon Gayle,44,0,45,1
1746580943213,EDS 128B,A01,895543,Pappas; Elizabeth,44,0,45,1
1746580944238,EDS 139,A00,897203,Pappas; Elizabeth,44,0,45,1
1746580944238,EDS 139,B00,897209,Fargason; Sharon Gayle,41,0,45,4
1746580945263,EDS 201,A00,895545,Staff,22,0,45,23
1746580946287,EDS 203,A01,895581,Halter; Christopher P.,22,0,45,23
1746580947316,EDS 204R,A01,895625,Heinzman; Erica M.,39,0,45,6
1746580947316,EDS 204R,B01,895693,Halter; Christopher P.,10,0,45,35
1746580948342,EDS 206R,A00,895694,Fargason; Sharon Gayle,1,0,30,29
1746580948342,EDS 206R,B00,895695,Choi; Bailey Miyeon,16,0,30,14
1746580949367,EDS 250,A00,895697,Hemans; Patricia Ann Benitez,22,0,45,23
1746580950394,EDS 281,A00,895701,Meyerott; Theresa Ann,1,0,15,14
1746580951417,EDS 284,A00,895736,Meyerott; Theresa Ann,1,0,15,14
1746580952443,EDS 286,A00,897210,Fine; Sarah,0,0,15,15
1746580953473,EDS 289C,A01,895770,Daly; Alan J.,1,0,15,14
1746580954496,EDS 290,A00,897211,Hofstetter; Carolyn,0,0,15,15
1746580955525,LIGM 5A,A00,896162,Fischer-Grunski; Eva K,12,0,20,8
1746580956551,LIGM 5B,A00,896260,Fischer-Grunski; Eva K,17,0,20,3
1746580957580,LIGM 5C,A00,896308,Fischer-Grunski; Eva K,18,0,20,2
1746580958614,LIIT 5AS,A00,896313,Carnelos; Chiara,18,0,20,2
1746580959643,LIIT 5BS,A00,896416,Carnelos; Chiara,20,0,20,0
1746580960679,LIIT 5CS,A00,896564,Carnelos; Chiara,20,0,20,0
1746580961704,LISP 5A,A00,896588,Munoz Sanchez; Alicia,2,0,20,18
1746580962735,LISP 5B,A00,896653,Munoz Sanchez; Alicia,7,0,20,13
1746580963764,LISP 5C,A00,896655,Munoz Sanchez; Alicia,0,1,20,20
1746580964791,MAE 197,001,957918,Kleissl; Jan,9996,0,9999,3
1746580964791,MAE 197,002,959806,Boechler; Nicholas Sebastia,9998,0,9999,1
1746580964791,MAE 197,003,959852,Mullin; Jennifer S,9998,0,9999,1
1746580965816,MATH 2,A01,957937,Staff,33,0,35,2
1746580966840,MATH 197,001,957876,Kedlaya; Kiran S.,9993,0,9999,6
1746580967866,MCWP 40,A00,892729,Duru; Nur,10,0,20,10
1746580967866,MCWP 40,B00,893304,Montejo; Carolina,14,0,20,6
1746580968894,MCWP 40R,A00,893757,Redela; Pamela Morgan,0,5,20,20
1746580969919,MCWP 50,A00,893758,Morshed; Michael James,0,0,20,20
1746580969919,MCWP 50,B00,893761,Bartulis; Jason Michael,17,0,20,3
1746580970946,MCWP 50R,A00,893766,Compas; Sean Matthew,0,1,20,20
1746580970946,MCWP 50R,B00,893769,Carter; Jennifer A,0,1,20,20
1746580970946,MCWP 50R,C00,893771,Krone; Jarret,0,3,20,20
1746580970946,MCWP 50R,D00,893772,Miller; Elizabeth Deen,0,0,20,20
1746580970946,MCWP 50R,E00,893775,Carter; Andrea L,0,1,20,20
1746580971969,MMW 11R,A01,892721,Herbst; Matthew,14,0,30,16
1746580971969,MMW 11R,A02,892722,Herbst; Matthew,0,0,0,3
1746580973007,MMW 12R,A01,892724,Herbst; Matthew,0,11,16,16
1746580973007,MMW 12R,A02,892725,Herbst; Matthew,0,10,16,16
1746580974035,MMW 13R,A01,892727,Staff,0,4,16,16
1746580974035,MMW 13R,A02,892728,Staff,0,4,16,16
1746580974035,MMW 13R,A03,958032,Staff,0,4,16,16
1746580974035,MMW 13R,A04,958033,Staff,0,4,16,16
1746580974035,MMW 13R,A05,958034,Staff,0,4,16,16
1746580975059,SIO 295LS,A00,894015,Staff,5,0,25,20
1746580976087,SIO 295S,A00,894020,Staff,5,0,25,20
1746580977118,SIOC 290S,B01,958918,Merrifield; Mark A,14,0,30,16
1746580978149,SIOC 291S,B01,958922,Gabriel; Corey John,14,0,30,16
1746580979178,SOCI 117,A01,895339,Staff,3,0,5,2
1746580980205,WES 237B,A00,894149,Staff,11,0,20,9
1746580982260,AESE 279B,A00,891859,Staff,13,0,35,22
1746580983285,AIP 197,001,891854,Vespa; Emanuel Ignacio,9999,0,9999,0
1746580984311,ANTH 289S,A00,891856,Gagneux; Pascal,12,0,12,0
1746580985337,BENG 196,001,957946,Engler; Adam J.,9996,0,9999,3
1746580986364,BISP 197,001,959851,Wilhelm; James E.,9998,0,9999,1
1746580987442,CAT 124RS,A01,956906,Staff,6,0,25,19
1746580988469,CAT 125RS,A01,922013,Staff,6,0,25,19
1746580989495,CLRE 250,A00,891860,Morris; Sheldon,9995,0,9999,4
1746580991547,CLRE 251R,A00,907817,Mehta; Ravindra L.,9994,0,9999,5
1746580992577,CLRE 252,A00,891864,Cuomo; Raphael Eduardo,9993,0,9999,6
1746580993602,CLRE 253,A00,891867,Vaida; Florin,9994,0,9999,5
1746580993602,CLRE 253,B00,907819,Staff,9999,0,9999,0
1746580994630,CLRE 259,A00,891868,Patel; Hemal,9998,0,9999,1
1746580995660,CLRE 260,A00,891872,Cuomo; Raphael Eduardo,9999,0,9999,0
1746580996688,CLRE 297,001,891888,Cuomo; Raphael Eduardo,9999,0,9999,0
1746580997717,CSE 191,A00,958773,Minnes Kemp; Mor Mia,9995,0,9999,4
1746580998743,CSE 197,001,959846,Minnes Kemp; Mor Mia,9990,0,9999,9
1746580999769,CSS 201S,A01,892054,Mignozzetti; Umberto,25,0,30,5
1746581000794,CSS 202S,A01,892056,Mignozzetti; Umberto,25,0,30,5
1746581001819,DSC 197,001,956898,Eldridge; Justin Matthew,9996,0,9999,3
1746581002848,DSC 297,001,958000,Mazumdar; Arya,9998,0,9999,1
1746581002848,DSC 297,002,959862,Wang; Yusu,9998,0,9999,1
1746581003877,EAP 100,A00,905686,Staff,9778,0,9999,221
1746581004903,ECE 45,A01,892618,Staff,0,0,65,65
1746581006956,ECE 111,A01,892719,Staff,6,0,65,59
1746581007984,ECE 197,001,957920,Mercier; Patrick Philip,9991,0,9999,8
1746581009009,ECON 178,A01,907814,Zhu; Ying,26,0,35,9
1746581010036,EDS 115,A00,895312,Staff,35,0,45,10
1746581011064,EDS 117,A01,895337,Staff,23,0,30,7
1746581012088,EDS 125,A00,895341,Jones; Gabrielle Anastasia,36,0,45,9
1746581013117,EDS 128A,A01,895459,Fargason; Sharon Gayle,44,0,45,1
1746581014142,EDS 128B,A01,895543,Pappas; Elizabeth,44,0,45,1
1746581015169,EDS 139,A00,897203,Pappas; Elizabeth,44,0,45,1
1746581015169,EDS 139,B00,897209,Fargason; Sharon Gayle,41,0,45,4
1746581016194,EDS 201,A00,895545,Staff,22,0,45,23
1746581017222,EDS 203,A01,895581,Halter; Christopher P.,22,0,45,23
1746581018251,EDS 204R,A01,895625,Heinzman; Erica M.,39,0,45,6
1746581018251,EDS 204R,B01,895693,Halter; Christopher P.,10,0,45,35
1746581019277,EDS 206R,A00,895694,Fargason; Sharon Gayle,1,0,30,29
1746581019277,EDS 206R,B00,895695,Choi; Bailey Miyeon,16,0,30,14
1746581020305,EDS 250,A00,895697,Hemans; Patricia Ann Benitez,22,0,45,23
1746581021331,EDS 281,A00,895701,Meyerott; Theresa Ann,1,0,15,14
1746581022356,EDS 284,A00,895736,Meyerott; Theresa Ann,1,0,15,14
1746581023380,EDS 286,A00,897210,Fine; Sarah,0,0,15,15
1746581024407,EDS 289C,A01,895770,Daly; Alan J.,1,0,15,14
1746581025435,EDS 290,A00,897211,Hofstetter; Carolyn,0,0,15,15
1746581026463,LIGM 5A,A00,896162,Fischer-Grunski; Eva K,12,0,20,8
1746581027489,LIGM 5B,A00,896260,Fischer-Grunski; Eva K,17,0,20,3
1746581028518,LIGM 5C,A00,896308,Fischer-Grunski; Eva K,18,0,20,2
1746581029544,LIIT 5AS,A00,896313,Carnelos; Chiara,18,0,20,2
1746581030569,LIIT 5BS,A00,896416,Carnelos; Chiara,20,0,20,0
1746581031604,LIIT 5CS,A00,896564,Carnelos; Chiara,20,0,20,0
1746581032629,LISP 5A,A00,896588,Munoz Sanchez; Alicia,2,0,20,18
1746581033660,LISP 5B,A00,896653,Munoz Sanchez; Alicia,7,0,20,13
1746581034686,LISP 5C,A00,896655,Munoz Sanchez; Alicia,0,1,20,20
1746581035712,MAE 197,001,957918,Kleissl; Jan,9996,0,9999,3
1746581035712,MAE 197,002,959806,Boechler; Nicholas Sebastia,9998,0,9999,1
1746581035712,MAE 197,003,959852,Mullin; Jennifer S,9998,0,9999,1
1746581036735,MATH 2,A01,957937,Staff,33,0,35,2
1746581037761,MATH 197,001,957876,Kedlaya; Kiran S.,9993,0,9999,6
1746581038789,MCWP 40,A00,892729,Duru; Nur,10,0,20,10
1746581038789,MCWP 40,B00,893304,Montejo; Carolina,14,0,20,6
1746581039814,MCWP 40R,A00,893757,Redela; Pamela Morgan,0,5,20,20
1746581040839,MCWP 50,A00,893758,Morshed; Michael James,0,0,20,20
1746581040839,MCWP 50,B00,893761,Bartulis; Jason Michael,17,0,20,3
1746581041868,MCWP 50R,A00,893766,Compas; Sean Matthew,0,1,20,20
1746581041868,MCWP 50R,B00,893769,Carter; Jennifer A,0,1,20,20
1746581041868,MCWP 50R,C00,893771,Krone; Jarret,0,3,20,20
1746581041868,MCWP 50R,D00,893772,Miller; Elizabeth Deen,0,0,20,20
1746581041868,MCWP 50R,E00,893775,Carter; Andrea L,0,1,20,20
1746581042897,MMW 11R,A01,892721,Herbst; Matthew,14,0,30,16
1746581042897,MMW 11R,A02,892722,Herbst; Matthew,0,0,0,3
1746581043921,MMW 12R,A01,892724,Herbst; Matthew,0,11,16,16
1746581043921,MMW 12R,A02,892725,Herbst; Matthew,0,10,16,16
1746581044951,MMW 13R,A01,892727,Staff,0,4,16,16
1746581044951,MMW 13R,A02,892728,Staff,0,4,16,16
1746581044951,MMW 13R,A03,958032,Staff,0,4,16,16
1746581044951,MMW 13R,A04,958033,Staff,0,4,16,16
1746581044951,MMW 13R,A05,958034,Staff,0,4,16,16
1746581045980,SIO 295LS,A00,894015,Staff,5,0,25,20
1746581047009,SIO 295S,A00,894020,Staff,5,0,25,20
1746581048039,SIOC 290S,B01,958918,Merrifield; Mark A,14,0,30,16
1746581049065,SIOC 291S,B01,958922,Gabriel; Corey John,14,0,30,16
1746581050090,SOCI 117,A01,895339,Staff,3,0,5,2
1746581051115,WES 237B,A00,894149,Staff,11,0,20,9
1746581053183,AESE 279B,A00,891859,Staff,13,0,35,22
1746581054208,AIP 197,001,891854,Vespa; Emanuel Ignacio,9999,0,9999,0
1746581055237,ANTH 289S,A00,891856,Gagneux; Pascal,12,0,12,0
1746581056262,BENG 196,001,957946,Engler; Adam J.,9996,0,9999,3
1746581057287,BISP 197,001,959851,Wilhelm; James E.,9998,0,9999,1
1746581058316,CAT 124RS,A01,956906,Staff,6,0,25,19
1746581059344,CAT 125RS,A01,922013,Staff,6,0,25,19
1746581060369,CLRE 250,A00,891860,Morris; Sheldon,9995,0,9999,4
1746581062419,CLRE 251R,A00,907817,Mehta; Ravindra L.,9994,0,9999,5
1746581063446,CLRE 252,A00,891864,Cuomo; Raphael Eduardo,9993,0,9999,6
1746581064470,CLRE 253,A00,891867,Vaida; Florin,9994,0,9999,5
1746581064470,CLRE 253,B00,907819,Staff,9999,0,9999,0
1746581065495,CLRE 259,A00,891868,Patel; Hemal,9998,0,9999,1
1746581066524,CLRE 260,A00,891872,Cuomo; Raphael Eduardo,9999,0,9999,0
1746581067548,CLRE 297,001,891888,Cuomo; Raphael Eduardo,9999,0,9999,0
1746581068574,CSE 191,A00,958773,Minnes Kemp; Mor Mia,9995,0,9999,4
1746581069602,CSE 197,001,959846,Minnes Kemp; Mor Mia,9990,0,9999,9
1746581070634,CSS 201S,A01,892054,Mignozzetti; Umberto,25,0,30,5
1746581071660,CSS 202S,A01,892056,Mignozzetti; Umberto,25,0,30,5
1746581072688,DSC 197,001,956898,Eldridge; Justin Matthew,9996,0,9999,3
1746581073713,DSC 297,001,958000,Mazumdar; Arya,9998,0,9999,1
1746581073713,DSC 297,002,959862,Wang; Yusu,9998,0,9999,1
1746581074740,EAP 100,A00,905686,Staff,9778,0,9999,221
1746581075764,ECE 45,A01,892618,Staff,0,0,65,65
1746581077817,ECE 111,A01,892719,Staff,6,0,65,59
1746581078844,ECE 197,001,957920,Mercier; Patrick Philip,9991,0,9999,8
1746581079874,ECON 178,A01,907814,Zhu; Ying,26,0,35,9
1746581080899,EDS 115,A00,895312,Staff,35,0,45,10
1746581081924,EDS 117,A01,895337,Staff,23,0,30,7
1746581082950,EDS 125,A00,895341,Jones; Gabrielle Anastasia,36,0,45,9
1746581083975,EDS 128A,A01,895459,Fargason; Sharon Gayle,44,0,45,1
1746581085004,EDS 128B,A01,895543,Pappas; Elizabeth,44,0,45,1
1746581086029,EDS 139,A00,897203,Pappas; Elizabeth,44,0,45,1
1746581086029,EDS 139,B00,897209,Fargason; Sharon Gayle,41,0,45,4
1746581087056,EDS 201,A00,895545,Staff,22,0,45,23
1746581088081,EDS 203,A01,895581,Halter; Christopher P.,22,0,45,23
1746581089106,EDS 204R,A01,895625,Heinzman; Erica M.,39,0,45,6
1746581089106,EDS 204R,B01,895693,Halter; Christopher P.,10,0,45,35
1746581090130,EDS 206R,A00,895694,Fargason; Sharon Gayle,1,0,30,29
1746581090130,EDS 206R,B00,895695,Choi; Bailey Miyeon,16,0,30,14
1746581091195,EDS 250,A00,895697,Hemans; Patricia Ann Benitez,22,0,45,23
1746581092219,EDS 281,A00,895701,Meyerott; Theresa Ann,1,0,15,14
1746581093245,EDS 284,A00,895736,Meyerott; Theresa Ann,1,0,15,14
1746581094269,EDS 286,A00,897210,Fine; Sarah,0,0,15,15
1746581095293,EDS 289C,A01,895770,Daly; Alan J.,1,0,15,14
1746581096318,EDS 290,A00,897211,Hofstetter; Carolyn,0,0,15,15
1746581097345,LIGM 5A,A00,896162,Fischer-Grunski; Eva K,12,0,20,8
1746581098369,LIGM 5B,A00,896260,Fischer-Grunski; Eva K,17,0,20,3
1746581099401,LIGM 5C,A00,896308,Fischer-Grunski; Eva K,18,0,20,2
1746581100431,LIIT 5AS,A00,896313,Carnelos; Chiara,18,0,20,2
1746581101457,LIIT 5BS,A00,896416,Carnelos; Chiara,20,0,20,0
1746581102489,LIIT 5CS,A00,896564,Carnelos; Chiara,20,0,20,0
1746581103514,LISP 5A,A00,896588,Munoz Sanchez; Alicia,2,0,20,18
1746581104546,LISP 5B,A00,896653,Munoz Sanchez; Alicia,7,0,20,13
1746581105575,LISP 5C,A00,896655,Munoz Sanchez; Alicia,0,1,20,20
1746581106602,MAE 197,001,957918,Kleissl; Jan,9996,0,9999,3
1746581106602,MAE 197,002,959806,Boechler; Nicholas Sebastia,9998,0,9999,1
1746581106602,MAE 197,003,959852,Mullin; Jennifer S,9998,0,9999,1
1746581107626,MATH 2,A01,957937,Staff,33,0,35,2
1746581108653,MATH 197,001,957876,Kedlaya; Kiran S.,9993,0,9999,6
1746581109680,MCWP 40,A00,892729,Duru; Nur,10,0,20,10
1746581109680,MCWP 40,B00,893304,Montejo; Carolina,14,0,20,6
1746581110704,MCWP 40R,A00,893757,Redela; Pamela Morgan,0,5,20,20
1746581111732,MCWP 50,A00,893758,Morshed; Michael James,0,0,20,20
1746581111732,MCWP 50,B00,893761,Bartulis; Jason Michael,17,0,20,3
1746581112758,MCWP 50R,A00,893766,Compas; Sean Matthew,0,1,20,20
1746581112758,MCWP 50R,B00,893769,Carter; Jennifer A,0,1,20,20
1746581112758,MCWP 50R,C00,893771,Krone; Jarret,0,3,20,20
1746581112758,MCWP 50R,D00,893772,Miller; Elizabeth Deen,0,0,20,20
1746581112758,MCWP 50R,E00,893775,Carter; Andrea L,0,1,20,20
1746581113788,MMW 11R,A01,892721,Herbst; Matthew,14,0,30,16
1746581113788,MMW 11R,A02,892722,Herbst; Matthew,0,0,0,3
1746581114812,MMW 12R,A01,892724,Herbst; Matthew,0,11,16,16
1746581114812,MMW 12R,A02,892725,Herbst; Matthew,0,10,16,16
1746581115838,MMW 13R,A01,892727,Staff,0,4,16,16
1746581115838,MMW 13R,A02,892728,Staff,0,4,16,16
1746581115838,MMW 13R,A03,958032,Staff,0,4,16,16
1746581115838,MMW 13R,A04,958033,Staff,0,4,16,16
1746581115838,MMW 13R,A05,958034,Staff,0,4,16,16
1746581116863,SIO 295LS,A00,894015,Staff,5,0,25,20
1746581117887,SIO 295S,A00,894020,Staff,5,0,25,20
1746581118917,SIOC 290S,B01,958918,Merrifield; Mark A,14,0,30,16
1746581119942,SIOC 291S,B01,958922,Gabriel; Corey John,14,0,30,16
1746581120968,SOCI 117,A01,895339,Staff,3,0,5,2
1746581121996,WES 237B,A00,894149,Staff,11,0,20,9
1746581124057,AESE 279B,A00,891859,Staff,13,0,35,22
1746581125083,AIP 197,001,891854,Vespa; Emanuel Ignacio,9999,0,9999,0
1746581126108,ANTH 289S,A00,891856,Gagneux; Pascal,12,0,12,0
1746581127135,BENG 196,001,957946,Engler; Adam J.,9996,0,9999,3
1746581128160,BISP 197,001,959851,Wilhelm; James E.,9998,0,9999,1
1746581129188,CAT 124RS,A01,956906,Staff,6,0,25,19
1746581130214,CAT 125RS,A01,922013,Staff,6,0,25,19
1746581131238,CLRE 250,A00,891860,Morris; Sheldon,9995,0,9999,4
1746581133291,CLRE 251R,A00,907817,Mehta; Ravindra L.,9994,0,9999,5
1746581134318,CLRE 252,A00,891864,Cuomo; Raphael Eduardo,9993,0,9999,6
1746581135349,CLRE 253,A00,891867,Vaida; Florin,9994,0,9999,5
1746581135349,CLRE 253,B00,907819,Staff,9999,0,9999,0
1746581136375,CLRE 259,A00,891868,Patel; Hemal,9998,0,9999,1
1746581137400,CLRE 260,A00,891872,Cuomo; Raphael Eduardo,9999,0,9999,0
1746581138424,CLRE 297,001,891888,Cuomo; Raphael Eduardo,9999,0,9999,0
1746581139452,CSE 191,A00,958773,Minnes Kemp; Mor Mia,9995,0,9999,4
1746581140482,CSE 197,001,959846,Minnes Kemp; Mor Mia,9990,0,9999,9
1746581141510,CSS 201S,A01,892054,Mignozzetti; Umberto,25,0,30,5
1746581142540,CSS 202S,A01,892056,Mignozzetti; Umberto,25,0,30,5
1746581143567,DSC 197,001,956898,Eldridge; Justin Matthew,9996,0,9999,3
1746581144592,DSC 297,001,958000,Mazumdar; Arya,9998,0,9999,1
1746581144592,DSC 297,002,959862,Wang; Yusu,9998,0,9999,1
1746581145617,EAP 100,A00,905686,Staff,9778,0,9999,221
1746581146643,ECE 45,A01,892618,Staff,0,0,65,65
1746581148697,ECE 111,A01,892719,Staff,6,0,65,59
1746581149726,ECE 197,001,957920,Mercier; Patrick Philip,9991,0,9999,8
1746581150752,ECON 178,A01,907814,Zhu; Ying,26,0,35,9
1746581151776,EDS 115,A00,895312,Staff,35,0,45,10
1746581152816,EDS 117,A01,895337,Staff,23,0,30,7
1746581153841,EDS 125,A00,895341,Jones; Gabrielle Anastasia,36,0,45,9
1746581154867,EDS 128A,A01,895459,Fargason; Sharon Gayle,44,0,45,1
1746581155893,EDS 128B,A01,895543,Pappas; Elizabeth,44,0,45,1
1746581156918,EDS 139,A00,897203,Pappas; Elizabeth,44,0,45,1
1746581156918,EDS 139,B00,897209,Fargason; Sharon Gayle,41,0,45,4
1746581157947,EDS 201,A00,895545,Staff,22,0,45,23
1746581158972,EDS 203,A01,895581,Halter; Christopher P.,22,0,45,23
1746581160000,EDS 204R,A01,895625,Heinzman; Erica M.,39,0,45,6
1746581160000,EDS 204R,B01,895693,Halter; Christopher P.,10,0,45,35
1746581161027,EDS 206R,A00,895694,Fargason; Sharon Gayle,1,0,30,29
1746581161027,EDS 206R,B00,895695,Choi; Bailey Miyeon,16,0,30,14
1746581162056,EDS 250,A00,895697,Hemans; Patricia Ann Benitez,22,0,45,23
1746581163080,EDS 281,A00,895701,Meyerott; Theresa Ann,1,0,15,14
1746581164105,EDS 284,A00,895736,Meyerott; Theresa Ann,1,0,15,14
1746581165130,EDS 286,A00,897210,Fine; Sarah,0,0,15,15
1746581166158,EDS 289C,A01,895770,Daly; Alan J.,1,0,15,14
1746581167185,EDS 290,A00,897211,Hofstetter; Carolyn,0,0,15,15
1746581168210,LIGM 5A,A00,896162,Fischer-Grunski; Eva K,12,0,20,8
1746581169235,LIGM 5B,A00,896260,Fischer-Grunski; Eva K,17,0,20,3
1746581170261,LIGM 5C,A00,896308,Fischer-Grunski; Eva K,18,0,20,2
1746581171286,LIIT 5AS,A00,896313,Carnelos; Chiara,18,0,20,2
1746581172317,LIIT 5BS,A00,896416,Carnelos; Chiara,20,0,20,0
1746581173347,LIIT 5CS,A00,896564,Carnelos; Chiara,20,0,20,0
1746581174373,LISP 5A,A00,896588,Munoz Sanchez; Alicia,2,0,20,18
1746581175398,LISP 5B,A00,896653,Munoz Sanchez; Alicia,7,0,20,13
1746581176427,LISP 5C,A00,896655,Munoz Sanchez; Alicia,0,1,20,20
1746581177452,MAE 197,001,957918,Kleissl; Jan,9996,0,9999,3
1746581177452,MAE 197,002,959806,Boechler; Nicholas Sebastia,9998,0,9999,1
1746581177452,MAE 197,003,959852,Mullin; Jennifer S,9998,0,9999,1
1746581178477,MATH 2,A01,957937,Staff,33,0,35,2
1746581179504,MATH 197,001,957876,Kedlaya; Kiran S.,9993,0,9999,6
1746581180532,MCWP 40,A00,892729,Duru; Nur,10,0,20,10
1746581180532,MCWP 40,B00,893304,Montejo; Carolina,14,0,20,6
1746581181562,MCWP 40R,A00,893757,Redela; Pamela Morgan,0,5,20,20
1746581182590,MCWP 50,A00,893758,Morshed; Michael James,0,0,20,20
1746581182590,MCWP 50,B00,893761,Bartulis; Jason Michael,17,0,20,3
1746581183616,MCWP 50R,A00,893766,Compas; Sean Matthew,0,1,20,20
1746581183616,MCWP 50R,B00,893769,Carter; Jennifer A,0,1,20,20
1746581183616,MCWP 50R,C00,893771,Krone; Jarret,0,3,20,20
1746581183616,MCWP 50R,D00,893772,Miller; Elizabeth Deen,0,0,20,20
1746581183616,MCWP 50R,E00,893775,Carter; Andrea L,0,1,20,20
1746581184642,MMW 11R,A01,892721,Herbst; Matthew,14,0,30,16
1746581184642,MMW 11R,A02,892722,Herbst; Matthew,0,0,0,3
1746581185672,MMW 12R,A01,892724,Herbst; Matthew,0,11,16,16
1746581185672,MMW 12R,A02,892725,Herbst; Matthew,0,10,16,16
1746581186702,MMW 13R,A01,892727,Staff,0,4,16,16
1746581186702,MMW 13R,A02,892728,Staff,0,4,16,16
1746581186702,MMW 13R,A03,958032,Staff,0,4,16,16
1746581186702,MMW 13R,A04,958033,Staff,0,4,16,16
1746581186702,MMW 13R,A05,958034,Staff,0,4,16,16
1746581187729,SIO 295LS,A00,894015,Staff,5,0,25,20
1746581188757,SIO 295S,A00,894020,Staff,5,0,25,20
1746581189784,SIOC 290S,B01,958918,Merrifield; Mark A,14,0,30,16
1746581190813,SIOC 291S,B01,958922,Gabriel; Corey John,14,0,30,16
1746581191841,SOCI 117,A01,895339,Staff,3,0,5,2
1746581192868,WES 237B,A00,894149,Staff,11,0,20,9
1746581194974,AESE 279B,A00,891859,Staff,13,0,35,22
1746581196003,AIP 197,001,891854,Vespa; Emanuel Ignacio,9999,0,9999,0
1746581197028,ANTH 289S,A00,891856,Gagneux; Pascal,12,0,12,0
1746581198053,BENG 196,001,957946,Engler; Adam J.,9996,0,9999,3
1746581199078,BISP 197,001,959851,Wilhelm; James E.,9998,0,9999,1
1746581200105,CAT 124RS,A01,956906,Staff,6,0,25,19
1746581201134,CAT 125RS,A01,922013,Staff,6,0,25,19
1746581202159,CLRE 250,A00,891860,Morris; Sheldon,9995,0,9999,4
1746581204212,CLRE 251R,A00,907817,Mehta; Ravindra L.,9994,0,9999,5
1746581205241,CLRE 252,A00,891864,Cuomo; Raphael Eduardo,9993,0,9999,6
1746581206267,CLRE 253,A00,891867,Vaida; Florin,9994,0,9999,5
1746581206267,CLRE 253,B00,907819,Staff,9999,0,9999,0
1746581207292,CLRE 259,A00,891868,Patel; Hemal,9998,0,9999,1
1746581208322,CLRE 260,A00,891872,Cuomo; Raphael Eduardo,9999,0,9999,0
1746581209347,CLRE 297,001,891888,Cuomo; Raphael Eduardo,9999,0,9999,0
1746581210374,CSE 191,A00,958773,Minnes Kemp; Mor Mia,9995,0,9999,4
1746581211400,CSE 197,001,959846,Minnes Kemp; Mor Mia,9990,0,9999,9
1746581212427,CSS 201S,A01,892054,Mignozzetti; Umberto,25,0,30,5
1746581213457,CSS 202S,A01,892056,Mignozzetti; Umberto,25,0,30,5
1746581214483,DSC 197,001,956898,Eldridge; Justin Matthew,9996,0,9999,3
1746581215509,DSC 297,001,958000,Mazumdar; Arya,9998,0,9999,1
1746581215509,DSC 297,002,959862,Wang; Yusu,9998,0,9999,1
1746581216536,EAP 100,A00,905686,Staff,9778,0,9999,221
1746581217562,ECE 45,A01,892618,Staff,0,0,65,65
1746581219611,ECE 111,A01,892719,Staff,6,0,65,59
1746581220637,ECE 197,001,957920,Mercier; Patrick Philip,9991,0,9999,8
1746581221662,ECON 178,A01,907814,Zhu; Ying,26,0,35,9
1746581222686,EDS 115,A00,895312,Staff,35,0,45,10
1746581223712,EDS 117,A01,895337,Staff,23,0,30,7
1746581224737,EDS 125,A00,895341,Jones; Gabrielle Anastasia,36,0,45,9
1746581225765,EDS 128A,A01,895459,Fargason; Sharon Gayle,44,0,45,1
1746581226793,EDS 128B,A01,895543,Pappas; Elizabeth,44,0,45,1
1746581227821,EDS 139,A00,897203,Pappas; Elizabeth,44,0,45,1
1746581227821,EDS 139,B00,897209,Fargason; Sharon Gayle,41,0,45,4
1746581228847,EDS 201,A00,895545,Staff,22,0,45,23
1746581229880,EDS 203,A01,895581,Halter; Christopher P.,22,0,45,23
1746581230906,EDS 204R,A01,895625,Heinzman; Erica M.,39,0,45,6
1746581230906,EDS 204R,B01,895693,Halter; Christopher P.,10,0,45,35
1746581231936,EDS 206R,A00,895694,Fargason; Sharon Gayle,1,0,30,29
1746581231936,EDS 206R,B00,895695,Choi; Bailey Miyeon,16,0,30,14
1746581232960,EDS 250,A00,895697,Hemans; Patricia Ann Benitez,22,0,45,23
1746581233989,EDS 281,A00,895701,Meyerott; Theresa Ann,1,0,15,14
1746581235015,EDS 284,A00,895736,Meyerott; Theresa Ann,1,0,15,14
1746581236040,EDS 286,A00,897210,Fine; Sarah,0,0,15,15
1746581237069,EDS 289C,A01,895770,Daly; Alan J.,1,0,15,14
1746581238094,EDS 290,A00,897211,Hofstetter; Carolyn,0,0,15,15
1746581239120,LIGM 5A,A00,896162,Fischer-Grunski; Eva K,12,0,20,8
1746581240146,LIGM 5B,A00,896260,Fischer-Grunski; Eva K,17,0,20,3
1746581241176,LIGM 5C,A00,896308,Fischer-Grunski; Eva K,18,0,20,2
1746581242202,LIIT 5AS,A00,896313,Carnelos; Chiara,18,0,20,2
1746581243228,LIIT 5BS,A00,896416,Carnelos; Chiara,20,0,20,0
1746581244252,LIIT 5CS,A00,896564,Carnelos; Chiara,20,0,20,0
1746581245277,LISP 5A,A00,896588,Munoz Sanchez; Alicia,2,0,20,18
1746581246303,LISP 5B,A00,896653,Munoz Sanchez; Alicia,7,0,20,13
1746581247333,LISP 5C,A00,896655,Munoz Sanchez; Alicia,0,1,20,20
1746581248357,MAE 197,001,957918,Kleissl; Jan,9996,0,9999,3
1746581248357,MAE 197,002,959806,Boechler; Nicholas Sebastia,9998,0,9999,1
1746581248357,MAE 197,003,959852,Mullin; Jennifer S,9998,0,9999,1
1746581249384,MATH 2,A01,957937,Staff,33,0,35,2
1746581250409,MATH 197,001,957876,Kedlaya; Kiran S.,9993,0,9999,6
1746581251434,MCWP 40,A00,892729,Duru; Nur,10,0,20,10
1746581251434,MCWP 40,B00,893304,Montejo; Carolina,14,0,20,6
1746581252458,MCWP 40R,A00,893757,Redela; Pamela Morgan,0,5,20,20
1746581253484,MCWP 50,A00,893758,Morshed; Michael James,0,0,20,20
1746581253484,MCWP 50,B00,893761,Bartulis; Jason Michael,17,0,20,3
1746581254521,MCWP 50R,A00,893766,Compas; Sean Matthew,0,1,20,20
1746581254521,MCWP 50R,B00,893769,Carter; Jennifer A,0,1,20,20
1746581254521,MCWP 50R,C00,893771,Krone; Jarret,0,3,20,20
1746581254521,MCWP 50R,D00,893772,Miller; Elizabeth Deen,0,0,20,20
1746581254521,MCWP 50R,E00,893775,Carter; Andrea L,0,1,20,20
1746581255549,MMW 11R,A01,892721,Herbst; Matthew,14,0,30,16
1746581255549,MMW 11R,A02,892722,Herbst; Matthew,0,0,0,3
1746581256578,MMW 12R,A01,892724,Herbst; Matthew,0,11,16,16
1746581256578,MMW 12R,A02,892725,Herbst; Matthew,0,10,16,16
1746581257609,MMW 13R,A01,892727,Staff,0,4,16,16
1746581257609,MMW 13R,A02,892728,Staff,0,4,16,16
1746581257609,MMW 13R,A03,958032,Staff,0,4,16,16
1746581257609,MMW 13R,A04,958033,Staff,0,4,16,16
1746581257609,MMW 13R,A05,958034,Staff,0,4,16,16
1746581258634,SIO 295LS,A00,894015,Staff,5,0,25,20
1746581259664,SIO 295S,A00,894020,Staff,5,0,25,20
1746581260690,SIOC 290S,B01,958918,Merrifield; Mark A,14,0,30,16
1746581261718,SIOC 291S,B01,958922,Gabriel; Corey John,14,0,30,16
1746581262748,SOCI 117,A01,895339,Staff,3,0,5,2
1746581263772,WES 237B,A00,894149,Staff,11,0,20,9
1746581265830,AESE 279B,A00,891859,Staff,13,0,35,22
1746581266859,AIP 197,001,891854,Vespa; Emanuel Ignacio,9999,0,9999,0
1746581267885,ANTH 289S,A00,891856,Gagneux; Pascal,12,0,12,0
1746581268910,BENG 196,001,957946,Engler; Adam J.,9996,0,9999,3
1746581269934,BISP 197,001,959851,Wilhelm; James E.,9998,0,9999,1
1746581270960,CAT 124RS,A01,956906,Staff,6,0,25,19
1746581271986,CAT 125RS,A01,922013,Staff,6,0,25,19
1746581273014,CLRE 250,A00,891860,Morris; Sheldon,9995,0,9999,4
1746581275067,CLRE 251R,A00,907817,Mehta; Ravindra L.,9994,0,9999,5
1746581276096,CLRE 252,A00,891864,Cuomo; Raphael Eduardo,9993,0,9999,6
1746581277123,CLRE 253,A00,891867,Vaida; Florin,9994,0,9999,5
1746581277123,CLRE 253,B00,907819,Staff,9999,0,9999,0
1746581278147,CLRE 259,A00,891868,Patel; Hemal,9998,0,9999,1
1746581279174,CLRE 260,A00,891872,Cuomo; Raphael Eduardo,9999,0,9999,0
1746581280200,CLRE 297,001,891888,Cuomo; Raphael Eduardo,9999,0,9999,0
1746581281226,CSE 191,A00,958773,Minnes Kemp; Mor Mia,9995,0,9999,4
1746581282252,CSE 197,001,959846,Minnes Kemp; Mor Mia,9990,0,9999,9
1746581283278,CSS 201S,A01,892054,Mignozzetti; Umberto,25,0,30,5
1746581284303,CSS 202S,A01,892056,Mignozzetti; Umberto,25,0,30,5
1746581285332,DSC 197,001,956898,Eldridge; Justin Matthew,9996,0,9999,3
1746581286359,DSC 297,001,958000,Mazumdar; Arya,9998,0,9999,1
1746581286359,DSC 297,002,959862,Wang; Yusu,9998,0,9999,1
1746581287384,EAP 100,A00,905686,Staff,9778,0,9999,221
1746581288410,ECE 45,A01,892618,Staff,0,0,65,65
1746581290460,ECE 111,A01,892719,Staff,6,0,65,59
1746581291486,ECE 197,001,957920,Mercier; Patrick Philip,9991,0,9999,8
1746581292511,ECON 178,A01,907814,Zhu; Ying,26,0,35,9
1746581293535,EDS 115,A00,895312,Staff,35,0,45,10
1746581294560,EDS 117,A01,895337,Staff,23,0,30,7
1746581295585,EDS 125,A00,895341,Jones; Gabrielle Anastasia,36,0,45,9
1746581296615,EDS 128A,A01,895459,Fargason; Sharon Gayle,44,0,45,1
1746581297641,EDS 128B,A01,895543,Pappas; Elizabeth,44,0,45,1
1746581298707,EDS 139,A00,897203,Pappas; Elizabeth,44,0,45,1
1746581298707,EDS 139,B00,897209,Fargason; Sharon Gayle,41,0,45,4
1746581299736,EDS 201,A00,895545,Staff,22,0,45,23
1746581300760,EDS 203,A01,895581,Halter; Christopher P.,22,0,45,23
1746581301788,EDS 204R,A01,895625,Heinzman; Erica M.,39,0,45,6
1746581301788,EDS 204R,B01,895693,Halter; Christopher P.,10,0,45,35
1746581302816,EDS 206R,A00,895694,Fargason; Sharon Gayle,1,0,30,29
1746581302816,EDS 206R,B00,895695,Choi; Bailey Miyeon,16,0,30,14
1746581303843,EDS 250,A00,895697,Hemans; Patricia Ann Benitez,22,0,45,23
1746581304868,EDS 281,A00,895701,Meyerott; Theresa Ann,1,0,15,14
1746581305892,EDS 284,A00,895736,Meyerott; Theresa Ann,1,0,15,14
1746581306916,EDS 286,A00,897210,Fine; Sarah,0,0,15,15
1746581307942,EDS 289C,A01,895770,Daly; Alan J.,1,0,15,14
1746581308967,EDS 290,A00,897211,Hofstetter; Carolyn,0,0,15,15
1746581309996,LIGM 5A,A00,896162,Fischer-Grunski; Eva K,12,0,20,8
1746581311026,LIGM 5B,A00,896260,Fischer-Grunski; Eva K,17,0,20,3
1746581312055,LIGM 5C,A00,896308,Fischer-Grunski; Eva K,18,0,20,2
1746581313084,LIIT 5AS,A00,896313,Carnelos; Chiara,18,0,20,2
1746581314110,LIIT 5BS,A00,896416,Carnelos; Chiara,20,0,20,0
1746581315137,LIIT 5CS,A00,896564,Carnelos; Chiara,20,0,20,0
1746581316168,LISP 5A,A00,896588,Munoz Sanchez; Alicia,2,0,20,18
1746581317193,LISP 5B,A00,896653,Munoz Sanchez; Alicia,7,0,20,13
1746581318219,LISP 5C,A00,896655,Munoz Sanchez; Alicia,0,1,20,20
1746581319248,MAE 197,001,957918,Kleissl; Jan,9996,0,9999,3
1746581319248,MAE 197,002,959806,Boechler; Nicholas Sebastia,9998,0,9999,1
1746581319248,MAE 197,003,959852,Mullin; Jennifer S,9998,0,9999,1
1746581320275,MATH 2,A01,957937,Staff,33,0,35,2
1746581321301,MATH 197,001,957876,Kedlaya; Kiran S.,9993,0,9999,6
1746581322327,MCWP 40,A00,892729,Duru; Nur,10,0,20,10
1746581322327,MCWP 40,B00,893304,Montejo; Carolina,14,0,20,6
1746581323354,MCWP 40R,A00,893757,Redela; Pamela Morgan,0,5,20,20
1746581324380,MCWP 50,A00,893758,Morshed; Michael James,0,0,20,20
1746581324380,MCWP 50,B00,893761,Bartulis; Jason Michael,17,0,20,3
1746581325409,MCWP 50R,A00,893766,Compas; Sean Matthew,0,1,20,20
1746581325409,MCWP 50R,B00,893769,Carter; Jennifer A,0,1,20,20
1746581325409,MCWP 50R,C00,893771,Krone; Jarret,0,3,20,20
1746581325409,MCWP 50R,D00,893772,Miller; Elizabeth Deen,0,0,20,20
1746581325409,MCWP 50R,E00,893775,Carter; Andrea L,0,1,20,20
1746581326433,MMW 11R,A01,892721,Herbst; Matthew,14,0,30,16
1746581326433,MMW 11R,A02,892722,Herbst; Matthew,0,0,0,3
1746581327462,MMW 12R,A01,892724,Herbst; Matthew,0,11,16,16
1746581327462,MMW 12R,A02,892725,Herbst; Matthew,0,10,16,16
1746581328487,MMW 13R,A01,892727,Staff,0,4,16,16
1746581328487,MMW 13R,A02,892728,Staff,0,4,16,16
1746581328487,MMW 13R,A03,958032,Staff,0,4,16,16
1746581328487,MMW 13R,A04,958033,Staff,0,4,16,16
1746581328487,MMW 13R,A05,958034,Staff,0,4,16,16
1746581329512,SIO 295LS,A00,894015,Staff,5,0,25,20
1746581330540,SIO 295S,A00,894020,Staff,5,0,25,20
1746581331571,SIOC 290S,B01,958918,Merrifield; Mark A,14,0,30,16
1746581332596,SIOC 291S,B01,958922,Gabriel; Corey John,14,0,30,16
1746581333627,SOCI 117,A01,895339,Staff,3,0,5,2
1746581334653,WES 237B,A00,894149,Staff,11,0,20,9
1746581336711,AESE 279B,A00,891859,Staff,13,0,35,22
1746581337736,AIP 197,001,891854,Vespa; Emanuel Ignacio,9999,0,9999,0
1746581338761,ANTH 289S,A00,891856,Gagneux; Pascal,12,0,12,0
1746581339787,BENG 196,001,957946,Engler; Adam J.,9996,0,9999,3
1746581340810,BISP 197,001,959851,Wilhelm; James E.,9998,0,9999,1
1746581341836,CAT 124RS,A01,956906,Staff,6,0,25,19
1746581342864,CAT 125RS,A01,922013,Staff,6,0,25,19
1746581343897,CLRE 250,A00,891860,Morris; Sheldon,9995,0,9999,4
1746581345951,CLRE 251R,A00,907817,Mehta; Ravindra L.,9994,0,9999,5
1746581346979,CLRE 252,A00,891864,Cuomo; Raphael Eduardo,9993,0,9999,6
1746581348005,CLRE 253,A00,891867,Vaida; Florin,9994,0,9999,5
1746581348005,CLRE 253,B00,907819,Staff,9999,0,9999,0
1746581349034,CLRE 259,A00,891868,Patel; Hemal,9998,0,9999,1
1746581350058,CLRE 260,A00,891872,Cuomo; Raphael Eduardo,9999,0,9999,0
1746581351088,CLRE 297,001,891888,Cuomo; Raphael Eduardo,9999,0,9999,0
1746581352113,CSE 191,A00,958773,Minnes Kemp; Mor Mia,9995,0,9999,4
1746581353138,CSE 197,001,959846,Minnes Kemp; Mor Mia,9990,0,9999,9
1746581354169,CSS 201S,A01,892054,Mignozzetti; Umberto,25,0,30,5
1746581355198,CSS 202S,A01,892056,Mignozzetti; Umberto,25,0,30,5
1746581356228,DSC 197,001,956898,Eldridge; Justin Matthew,9996,0,9999,3
1746581357254,DSC 297,001,958000,Mazumdar; Arya,9998,0,9999,1
1746581357254,DSC 297,002,959862,Wang; Yusu,9998,0,9999,1
1746581358279,EAP 100,A00,905686,Staff,9778,0,9999,221
1746581359308,ECE 45,A01,892618,Staff,0,0,65,65
1746581361359,ECE 111,A01,892719,Staff,6,0,65,59
1746581362384,ECE 197,001,957920,Mercier; Patrick Philip,9991,0,9999,8
1746581363414,ECON 178,A01,907814,Zhu; Ying,26,0,35,9
1746581364442,EDS 115,A00,895312,Staff,35,0,45,10
1746581365471,EDS 117,A01,895337,Staff,23,0,30,7
1746581366502,EDS 125,A00,895341,Jones; Gabrielle Anastasia,36,0,45,9
1746581367528,EDS 128A,A01,895459,Fargason; Sharon Gayle,44,0,45,1
1746581368558,EDS 128B,A01,895543,Pappas; Elizabeth,44,0,45,1
1746581369584,EDS 139,A00,897203,Pappas; Elizabeth,44,0,45,1
1746581369584,EDS 139,B00,897209,Fargason; Sharon Gayle,41,0,45,4
1746581370613,EDS 201,A00,895545,Staff,22,0,45,23
1746581371640,EDS 203,A01,895581,Halter; Christopher P.,22,0,45,23
1746581372663,EDS 204R,A01,895625,Heinzman; Erica M.,39,0,45,6
1746581372663,EDS 204R,B01,895693,Halter; Christopher P.,10,0,45,35
1746581373689,EDS 206R,A00,895694,Fargason; Sharon Gayle,1,0,30,29
1746581373689,EDS 206R,B00,895695,Choi; Bailey Miyeon,16,0,30,14
1746581374714,EDS 250,A00,895697,Hemans; Patricia Ann Benitez,22,0,45,23
1746581375738,EDS 281,A00,895701,Meyerott; Theresa Ann,1,0,15,14
1746581376762,EDS 284,A00,895736,Meyerott; Theresa Ann,1,0,15,14
1746581377791,EDS 286,A00,897210,Fine; Sarah,0,0,15,15
1746581378817,EDS 289C,A01,895770,Daly; Alan J.,1,0,15,14
1746581379842,EDS 290,A00,897211,Hofstetter; Carolyn,0,0,15,15
1746581380867,LIGM 5A,A00,896162,Fischer-Grunski; Eva K,12,0,20,8
1746581381893,LIGM 5B,A00,896260,Fischer-Grunski; Eva K,17,0,20,3
1746581382919,LIGM 5C,A00,896308,Fischer-Grunski; Eva K,18,0,20,2
1746581383945,LIIT 5AS,A00,896313,Carnelos; Chiara,18,0,20,2
1746581384970,LIIT 5BS,A00,896416,Carnelos; Chiara,20,0,20,0
1746581386001,LIIT 5CS,A00,896564,Carnelos; Chiara,20,0,20,0
1746581387027,LISP 5A,A00,896588,Munoz Sanchez; Alicia,2,0,20,18
1746581388052,LISP 5B,A00,896653,Munoz Sanchez; Alicia,7,0,20,13
1746581389077,LISP 5C,A00,896655,Munoz Sanchez; Alicia,0,1,20,20
1746581390103,MAE 197,001,957918,Kleissl; Jan,9996,0,9999,3
1746581390103,MAE 197,002,959806,Boechler; Nicholas Sebastia,9998,0,9999,1
1746581390103,MAE 197,003,959852,Mullin; Jennifer S,9998,0,9999,1
1746581391132,MATH 2,A01,957937,Staff,33,0,35,2
1746581392158,MATH 197,001,957876,Kedlaya; Kiran S.,9993,0,9999,6
1746581393183,MCWP 40,A00,892729,Duru; Nur,10,0,20,10
1746581393183,MCWP 40,B00,893304,Montejo; Carolina,14,0,20,6
1746581394210,MCWP 40R,A00,893757,Redela; Pamela Morgan,0,5,20,20
1746581395234,MCWP 50,A00,893758,Morshed; Michael James,0,0,20,20
1746581395234,MCWP 50,B00,893761,Bartulis; Jason Michael,17,0,20,3
1746581396264,MCWP 50R,A00,893766,Compas; Sean Matthew,0,1,20,20
1746581396264,MCWP 50R,B00,893769,Carter; Jennifer A,0,1,20,20
1746581396264,MCWP 50R,C00,893771,Krone; Jarret,0,3,20,20
1746581396264,MCWP 50R,D00,893772,Miller; Elizabeth Deen,0,0,20,20
1746581396264,MCWP 50R,E00,893775,Carter; Andrea L,0,1,20,20
1746581397291,MMW 11R,A01,892721,Herbst; Matthew,14,0,30,16
1746581397291,MMW 11R,A02,892722,Herbst; Matthew,0,0,0,3
1746581398319,MMW 12R,A01,892724,Herbst; Matthew,0,11,16,16
1746581398319,MMW 12R,A02,892725,Herbst; Matthew,0,10,16,16
1746581399348,MMW 13R,A01,892727,Staff,0,4,16,16
1746581399348,MMW 13R,A02,892728,Staff,0,4,16,16
1746581399348,MMW 13R,A03,958032,Staff,0,4,16,16
1746581399348,MMW 13R,A04,958033,Staff,0,4,16,16
1746581399348,MMW 13R,A05,958034,Staff,0,4,16,16
1746581400373,SIO 295LS,A00,894015,Staff,5,0,25,20
1746581401397,SIO 295S,A00,894020,Staff,5,0,25,20
1746581402470,SIOC 290S,B01,958918,Merrifield; Mark A,14,0,30,16
1746581403495,SIOC 291S,B01,958922,Gabriel; Corey John,14,0,30,16
1746581404526,SOCI 117,A01,895339,Staff,3,0,5,2
1746581405552,WES 237B,A00,894149,Staff,11,0,20,9
1746581407617,AESE 279B,A00,891859,Staff,13,0,35,22
1746581408643,AIP 197,001,891854,Vespa; Emanuel Ignacio,9999,0,9999,0
1746581409670,ANTH 289S,A00,891856,Gagneux; Pascal,12,0,12,0
1746581410699,BENG 196,001,957946,Engler; Adam J.,9996,0,9999,3
1746581411723,BISP 197,001,959851,Wilhelm; James E.,9998,0,9999,1
1746581412749,CAT 124RS,A01,956906,Staff,6,0,25,19
1746581413773,CAT 125RS,A01,922013,Staff,6,0,25,19
1746581414798,CLRE 250,A00,891860,Morris; Sheldon,9995,0,9999,4
1746581416852,CLRE 251R,A00,907817,Mehta; Ravindra L.,9994,0,9999,5
1746581417878,CLRE 252,A00,891864,Cuomo; Raphael Eduardo,9993,0,9999,6
1746581418906,CLRE 253,A00,891867,Vaida; Florin,9994,0,9999,5
1746581418906,CLRE 253,B00,907819,Staff,9999,0,9999,0
1746581419935,CLRE 259,A00,891868,Patel; Hemal,9998,0,9999,1
1746581420962,CLRE 260,A00,891872,Cuomo; Raphael Eduardo,9999,0,9999,0
1746581421986,CLRE 297,001,891888,Cuomo; Raphael Eduardo,9999,0,9999,0
1746581423014,CSE 191,A00,958773,Minnes Kemp; Mor Mia,9995,0,9999,4
1746581424040,CSE 197,001,959846,Minnes Kemp; Mor Mia,9990,0,9999,9
1746581425069,CSS 201S,A01,892054,Mignozzetti; Umberto,25,0,30,5
1746581426100,CSS 202S,A01,892056,Mignozzetti; Umberto,25,0,30,5
1746581427125,DSC 197,001,956898,Eldridge; Justin Matthew,9996,0,9999,3
1746581428149,DSC 297,001,958000,Mazumdar; Arya,9998,0,9999,1
1746581428149,DSC 297,002,959862,Wang; Yusu,9998,0,9999,1
1746581429172,EAP 100,A00,905686,Staff,9778,0,9999,221
1746581430198,ECE 45,A01,892618,Staff,0,0,65,65
1746581432256,ECE 111,A01,892719,Staff,6,0,65,59
1746581433284,ECE 197,001,957920,Mercier; Patrick Philip,9991,0,9999,8
1746581434312,ECON 178,A01,907814,Zhu; Ying,26,0,35,9
1746581435340,EDS 115,A00,895312,Staff,35,0,45,10
1746581436370,EDS 117,A01,895337,Staff,23,0,30,7
1746581437396,EDS 125,A00,895341,Jones; Gabrielle Anastasia,36,0,45,9
1746581438424,EDS 128A,A01,895459,Fargason; Sharon Gayle,44,0,45,1
1746581439452,EDS 128B,A01,895543,Pappas; Elizabeth,44,0,45,1
1746581440481,EDS 139,A00,897203,Pappas; Elizabeth,44,0,45,1
1746581440481,EDS 139,B00,897209,Fargason; Sharon Gayle,41,0,45,4
1746581441507,EDS 201,A00,895545,Staff,22,0,45,23
1746581442534,EDS 203,A01,895581,Halter; Christopher P.,22,0,45,23
1746581443630,EDS 204R,A01,895625,Heinzman; Erica M.,39,0,45,6
1746581443630,EDS 204R,B01,895693,Halter; Christopher P.,10,0,45,35
1746581444659,EDS 206R,A00,895694,Fargason; Sharon Gayle,1,0,30,29
1746581444659,EDS 206R,B00,895695,Choi; Bailey Miyeon,16,0,30,14
1746581445683,EDS 250,A00,895697,Hemans; Patricia Ann Benitez,22,0,45,23
1746581446714,EDS 281,A00,895701,Meyerott; Theresa Ann,1,0,15,14
1746581447738,EDS 284,A00,895736,Meyerott; Theresa Ann,1,0,15,14
1746581448766,EDS 286,A00,897210,Fine; Sarah,0,0,15,15
1746581449793,EDS 289C,A01,895770,Daly; Alan J.,1,0,15,14
1746581450817,EDS 290,A00,897211,Hofstetter; Carolyn,0,0,15,15
1746581451843,LIGM 5A,A00,896162,Fischer-Grunski; Eva K,12,0,20,8
1746581452873,LIGM 5B,A00,896260,Fischer-Grunski; Eva K,17,0,20,3
1746581453899,LIGM 5C,A00,896308,Fischer-Grunski; Eva K,18,0,20,2
1746581454923,LIIT 5AS,A00,896313,Carnelos; Chiara,18,0,20,2
1746581455950,LIIT 5BS,A00,896416,Carnelos; Chiara,20,0,20,0
1746581456975,LIIT 5CS,A00,896564,Carnelos; Chiara,20,0,20,0
1746581458004,LISP 5A,A00,896588,Munoz Sanchez; Alicia,2,0,20,18
1746581459035,LISP 5B,A00,896653,Munoz Sanchez; Alicia,7,0,20,13
1746581460060,LISP 5C,A00,896655,Munoz Sanchez; Alicia,0,1,20,20
1746581461085,MAE 197,001,957918,Kleissl; Jan,9996,0,9999,3
1746581461085,MAE 197,002,959806,Boechler; Nicholas Sebastia,9998,0,9999,1
1746581461085,MAE 197,003,959852,Mullin; Jennifer S,9998,0,9999,1
1746581462109,MATH 2,A01,957937,Staff,33,0,35,2
1746581463136,MATH 197,001,957876,Kedlaya; Kiran S.,9993,0,9999,6
1746581464163,MCWP 40,A00,892729,Duru; Nur,10,0,20,10
1746581464163,MCWP 40,B00,893304,Montejo; Carolina,14,0,20,6
1746581465188,MCWP 40R,A00,893757,Redela; Pamela Morgan,0,5,20,20
1746581466216,MCWP 50,A00,893758,Morshed; Michael James,0,0,20,20
1746581466216,MCWP 50,B00,893761,Bartulis; Jason Michael,17,0,20,3
1746581467245,MCWP 50R,A00,893766,Compas; Sean Matthew,0,1,20,20
1746581467245,MCWP 50R,B00,893769,Carter; Jennifer A,0,1,20,20
1746581467245,MCWP 50R,C00,893771,Krone; Jarret,0,3,20,20
1746581467245,MCWP 50R,D00,893772,Miller; Elizabeth Deen,0,0,20,20
1746581467245,MCWP 50R,E00,893775,Carter; Andrea L,0,1,20,20
1746581468273,MMW 11R,A01,892721,Herbst; Matthew,14,0,30,16
1746581468273,MMW 11R,A02,892722,Herbst; Matthew,0,0,0,3
1746581469299,MMW 12R,A01,892724,Herbst; Matthew,0,11,16,16
1746581469299,MMW 12R,A02,892725,Herbst; Matthew,0,10,16,16
1746581470325,MMW 13R,A01,892727,Staff,0,4,16,16
1746581470325,MMW 13R,A02,892728,Staff,0,4,16,16
1746581470325,MMW 13R,A03,958032,Staff,0,4,16,16
1746581470325,MMW 13R,A04,958033,Staff,0,4,16,16
1746581470325,MMW 13R,A05,958034,Staff,0,4,16,16
1746581471350,SIO 295LS,A00,894015,Staff,5,0,25,20
1746581472375,SIO 295S,A00,894020,Staff,5,0,25,20
1746581473402,SIOC 290S,B01,958918,Merrifield; Mark A,14,0,30,16
1746581474433,SIOC 291S,B01,958922,Gabriel; Corey John,14,0,30,16
1746581475456,SOCI 117,A01,895339,Staff,3,0,5,2
1746581476481,WES 237B,A00,894149,Staff,11,0,20,9
1746581478543,AESE 279B,A00,891859,Staff,13,0,35,22
1746581479572,AIP 197,001,891854,Vespa; Emanuel Ignacio,9999,0,9999,0
1746581480598,ANTH 289S,A00,891856,Gagneux; Pascal,12,0,12,0
1746581481628,BENG 196,001,957946,Engler; Adam J.,9996,0,9999,3
1746581482658,BISP 197,001,959851,Wilhelm; James E.,9998,0,9999,1
1746581483682,CAT 124RS,A01,956906,Staff,6,0,25,19
1746581484708,CAT 125RS,A01,922013,Staff,6,0,25,19
1746581485737,CLRE 250,A00,891860,Morris; Sheldon,9995,0,9999,4
1746581487791,CLRE 251R,A00,907817,Mehta; Ravindra L.,9994,0,9999,5
1746581488816,CLRE 252,A00,891864,Cuomo; Raphael Eduardo,9993,0,9999,6
1746581489841,CLRE 253,A00,891867,Vaida; Florin,9994,0,9999,5
1746581489841,CLRE 253,B00,907819,Staff,9999,0,9999,0
1746581490865,CLRE 259,A00,891868,Patel; Hemal,9998,0,9999,1
1746581491890,CLRE 260,A00,891872,Cuomo; Raphael Eduardo,9999,0,9999,0
1746581492921,CLRE 297,001,891888,Cuomo; Raphael Eduardo,9999,0,9999,0
1746581493945,CSE 191,A00,958773,Minnes Kemp; Mor Mia,9995,0,9999,4
1746581494971,CSE 197,001,959846,Minnes Kemp; Mor Mia,9990,0,9999,9
1746581495996,CSS 201S,A01,892054,Mignozzetti; Umberto,25,0,30,5
1746581497026,CSS 202S,A01,892056,Mignozzetti; Umberto,25,0,30,5
1746581498052,DSC 197,001,956898,Eldridge; Justin Matthew,9996,0,9999,3
1746581499079,DSC 297,001,958000,Mazumdar; Arya,9998,0,9999,1
1746581499079,DSC 297,002,959862,Wang; Yusu,9998,0,9999,1
1746581500104,EAP 100,A00,905686,Staff,9778,0,9999,221
1746581501140,ECE 45,A01,892618,Staff,0,0,65,65
1746581503195,ECE 111,A01,892719,Staff,6,0,65,59
1746581504220,ECE 197,001,957920,Mercier; Patrick Philip,9991,0,9999,8
1746581505249,ECON 178,A01,907814,Zhu; Ying,26,0,35,9
1746581506313,EDS 115,A00,895312,Staff,35,0,45,10
1746581507342,EDS 117,A01,895337,Staff,23,0,30,7
1746581508368,EDS 125,A00,895341,Jones; Gabrielle Anastasia,36,0,45,9
1746581509397,EDS 128A,A01,895459,Fargason; Sharon Gayle,44,0,45,1
1746581510422,EDS 128B,A01,895543,Pappas; Elizabeth,44,0,45,1
1746581511452,EDS 139,A00,897203,Pappas; Elizabeth,44,0,45,1
1746581511452,EDS 139,B00,897209,Fargason; Sharon Gayle,41,0,45,4
1746581512478,EDS 201,A00,895545,Staff,22,0,45,23
1746581513506,EDS 203,A01,895581,Halter; Christopher P.,22,0,45,23
1746581514535,EDS 204R,A01,895625,Heinzman; Erica M.,39,0,45,6
1746581514535,EDS 204R,B01,895693,Halter; Christopher P.,10,0,45,35
1746581515560,EDS 206R,A00,895694,Fargason; Sharon Gayle,1,0,30,29
1746581515560,EDS 206R,B00,895695,Choi; Bailey Miyeon,16,0,30,14
1746581516589,EDS 250,A00,895697,Hemans; Patricia Ann Benitez,22,0,45,23
1746581517613,EDS 281,A00,895701,Meyerott; Theresa Ann,1,0,15,14
1746581518638,EDS 284,A00,895736,Meyerott; Theresa Ann,1,0,15,14
1746581519663,EDS 286,A00,897210,Fine; Sarah,0,0,15,15
1746581520691,EDS 289C,A01,895770,Daly; Alan J.,1,0,15,14
1746581521719,EDS 290,A00,897211,Hofstetter; Carolyn,0,0,15,15
1746581522750,LIGM 5A,A00,896162,Fischer-Grunski; Eva K,12,0,20,8
1746581523775,LIGM 5B,A00,896260,Fischer-Grunski; Eva K,17,0,20,3
1746581524807,LIGM 5C,A00,896308,Fischer-Grunski; Eva K,18,0,20,2
1746581525832,LIIT 5AS,A00,896313,Carnelos; Chiara,18,0,20,2
1746581526857,LIIT 5BS,A00,896416,Carnelos; Chiara,20,0,20,0
1746581527884,LIIT 5CS,A00,896564,Carnelos; Chiara,20,0,20,0
1746581528909,LISP 5A,A00,896588,Munoz Sanchez; Alicia,2,0,20,18
1746581529936,LISP 5B,A00,896653,Munoz Sanchez; Alicia,7,0,20,13
1746581530960,LISP 5C,A00,896655,Munoz Sanchez; Alicia,0,1,20,20
1746581531985,MAE 197,001,957918,Kleissl; Jan,9996,0,9999,3
1746581531985,MAE 197,002,959806,Boechler; Nicholas Sebastia,9998,0,9999,1
1746581531985,MAE 197,003,959852,Mullin; Jennifer S,9998,0,9999,1
1746581533010,MATH 2,A01,957937,Staff,33,0,35,2
1746581534034,MATH 197,001,957876,Kedlaya; Kiran S.,9993,0,9999,6
1746581535060,MCWP 40,A00,892729,Duru; Nur,10,0,20,10
1746581535060,MCWP 40,B00,893304,Montejo; Carolina,14,0,20,6
1746581536089,MCWP 40R,A00,893757,Redela; Pamela Morgan,0,5,20,20
1746581537114,MCWP 50,A00,893758,Morshed; Michael James,0,0,20,20
1746581537114,MCWP 50,B00,893761,Bartulis; Jason Michael,17,0,20,3
1746581538139,MCWP 50R,A00,893766,Compas; Sean Matthew,0,1,20,20
1746581538139,MCWP 50R,B00,893769,Carter; Jennifer A,0,1,20,20
1746581538139,MCWP 50R,C00,893771,Krone; Jarret,0,3,20,20
1746581538139,MCWP 50R,D00,893772,Miller; Elizabeth Deen,0,0,20,20
1746581538139,MCWP 50R,E00,893775,Carter; Andrea L,0,1,20,20
1746581539168,MMW 11R,A01,892721,Herbst; Matthew,14,0,30,16
1746581539168,MMW 11R,A02,892722,Herbst; Matthew,0,0,0,3
1746581540192,MMW 12R,A01,892724,Herbst; Matthew,0,11,16,16
1746581540192,MMW 12R,A02,892725,Herbst; Matthew,0,10,16,16
1746581541218,MMW 13R,A01,892727,Staff,0,4,16,16
1746581541218,MMW 13R,A02,892728,Staff,0,4,16,16
1746581541218,MMW 13R,A03,958032,Staff,0,4,16,16
1746581541218,MMW 13R,A04,958033,Staff,0,4,16,16
1746581541218,MMW 13R,A05,958034,Staff,0,4,16,16
1746581542242,SIO 295LS,A00,894015,Staff,5,0,25,20
1746581543272,SIO 295S,A00,894020,Staff,5,0,25,20
1746581544299,SIOC 290S,B01,958918,Merrifield; Mark A,14,0,30,16
1746581545330,SIOC 291S,B01,958922,Gabriel; Corey John,14,0,30,16
1746581546354,SOCI 117,A01,895339,Staff,3,0,5,2
1746581547381,WES 237B,A00,894149,Staff,11,0,20,9
1746581549461,AESE 279B,A00,891859,Staff,13,0,35,22
1746581550488,AIP 197,001,891854,Vespa; Emanuel Ignacio,9999,0,9999,0
1746581551518,ANTH 289S,A00,891856,Gagneux; Pascal,12,0,12,0
1746581552544,BENG 196,001,957946,Engler; Adam J.,9996,0,9999,3
1746581553572,BISP 197,001,959851,Wilhelm; James E.,9998,0,9999,1
1746581554595,CAT 124RS,A01,956906,Staff,6,0,25,19
1746581555621,CAT 125RS,A01,922013,Staff,6,0,25,19
1746581556649,CLRE 250,A00,891860,Morris; Sheldon,9995,0,9999,4
1746581558697,CLRE 251R,A00,907817,Mehta; Ravindra L.,9994,0,9999,5
1746581559721,CLRE 252,A00,891864,Cuomo; Raphael Eduardo,9993,0,9999,6
1746581560747,CLRE 253,A00,891867,Vaida; Florin,9994,0,9999,5
1746581560747,CLRE 253,B00,907819,Staff,9999,0,9999,0
1746581561775,CLRE 259,A00,891868,Patel; Hemal,9998,0,9999,1
1746581562799,CLRE 260,A00,891872,Cuomo; Raphael Eduardo,9999,0,9999,0
1746581563826,CLRE 297,001,891888,Cuomo; Raphael Eduardo,9999,0,9999,0
1746581564852,CSE 191,A00,958773,Minnes Kemp; Mor Mia,9995,0,9999,4
1746581565880,CSE 197,001,959846,Minnes Kemp; Mor Mia,9990,0,9999,9
1746581566905,CSS 201S,A01,892054,Mignozzetti; Umberto,25,0,30,5
1746581567930,CSS 202S,A01,892056,Mignozzetti; Umberto,25,0,30,5
1746581568954,DSC 197,001,956898,Eldridge; Justin Matthew,9996,0,9999,3
1746581569981,DSC 297,001,958000,Mazumdar; Arya,9998,0,9999,1
1746581569981,DSC 297,002,959862,Wang; Yusu,9998,0,9999,1
1746581571008,EAP 100,A00,905686,Staff,9778,0,9999,221
1746581572038,ECE 45,A01,892618,Staff,0,0,65,65
1746581574095,ECE 111,A01,892719,Staff,6,0,65,59
1746581575124,ECE 197,001,957920,Mercier; Patrick Philip,9991,0,9999,8
1746581576149,ECON 178,A01,907814,Zhu; Ying,26,0,35,9
1746581577176,EDS 115,A00,895312,Staff,35,0,45,10
1746581578201,EDS 117,A01,895337,Staff,23,0,30,7
1746581579226,EDS 125,A00,895341,Jones; Gabrielle Anastasia,36,0,45,9
1746581580252,EDS 128A,A01,895459,Fargason; Sharon Gayle,44,0,45,1
1746581581276,EDS 128B,A01,895543,Pappas; Elizabeth,44,0,45,1
1746581582303,EDS 139,A00,897203,Pappas; Elizabeth,44,0,45,1
1746581582303,EDS 139,B00,897209,Fargason; Sharon Gayle,41,0,45,4
1746581583328,EDS 201,A00,895545,Staff,22,0,45,23
1746581584355,EDS 203,A01,895581,Halter; Christopher P.,22,0,45,23
1746581585382,EDS 204R,A01,895625,Heinzman; Erica M.,39,0,45,6
1746581585382,EDS 204R,B01,895693,Halter; Christopher P.,10,0,45,35
1746581586407,EDS 206R,A00,895694,Fargason; Sharon Gayle,1,0,30,29
1746581586407,EDS 206R,B00,895695,Choi; Bailey Miyeon,16,0,30,14
1746581587431,EDS 250,A00,895697,Hemans; Patricia Ann Benitez,22,0,45,23
1746581588456,EDS 281,A00,895701,Meyerott; Theresa Ann,1,0,15,14
1746581589480,EDS 284,A00,895736,Meyerott; Theresa Ann,1,0,15,14
1746581590504,EDS 286,A00,897210,Fine; Sarah,0,0,15,15
1746581591529,EDS 289C,A01,895770,Daly; Alan J.,1,0,15,14
1746581592553,EDS 290,A00,897211,Hofstetter; Carolyn,0,0,15,15
1746581593578,LIGM 5A,A00,896162,Fischer-Grunski; Eva K,12,0,20,8
1746581594603,LIGM 5B,A00,896260,Fischer-Grunski; Eva K,17,0,20,3
1746581595631,LIGM 5C,A00,896308,Fischer-Grunski; Eva K,18,0,20,2
1746581596662,LIIT 5AS,A00,896313,Carnelos; Chiara,18,0,20,2
1746581597690,LIIT 5BS,A00,896416,Carnelos; Chiara,20,0,20,0
1746581598713,LIIT 5CS,A00,896564,Carnelos; Chiara,20,0,20,0
1746581599739,LISP 5A,A00,896588,Munoz Sanchez; Alicia,2,0,20,18
1746581600763,LISP 5B,A00,896653,Munoz Sanchez; Alicia,7,0,20,13
1746581601789,LISP 5C,A00,896655,Munoz Sanchez; Alicia,0,1,20,20
1746581602813,MAE 197,001,957918,Kleissl; Jan,9996,0,9999,3
1746581602813,MAE 197,002,959806,Boechler; Nicholas Sebastia,9998,0,9999,1
1746581602813,MAE 197,003,959852,Mullin; Jennifer S,9998,0,9999,1
1746581603841,MATH 2,A01,957937,Staff,33,0,35,2
1746581604868,MATH 197,001,957876,Kedlaya; Kiran S.,9993,0,9999,6
1746581605894,MCWP 40,A00,892729,Duru; Nur,10,0,20,10
1746581605894,MCWP 40,B00,893304,Montejo; Carolina,14,0,20,6
1746581606925,MCWP 40R,A00,893757,Redela; Pamela Morgan,0,5,20,20
1746581607949,MCWP 50,A00,893758,Morshed; Michael James,0,0,20,20
1746581607949,MCWP 50,B00,893761,Bartulis; Jason Michael,17,0,20,3
1746581608974,MCWP 50R,A00,893766,Compas; Sean Matthew,0,1,20,20
1746581608974,MCWP 50R,B00,893769,Carter; Jennifer A,0,1,20,20
1746581608974,MCWP 50R,C00,893771,Krone; Jarret,0,3,20,20
1746581608974,MCWP 50R,D00,893772,Miller; Elizabeth Deen,0,0,20,20
1746581608974,MCWP 50R,E00,893775,Carter; Andrea L,0,1,20,20
1746581610053,MMW 11R,A01,892721,Herbst; Matthew,14,0,30,16
1746581610053,MMW 11R,A02,892722,Herbst; Matthew,0,0,0,3
1746581611081,MMW 12R,A01,892724,Herbst; Matthew,0,11,16,16
1746581611081,MMW 12R,A02,892725,Herbst; Matthew,0,10,16,16
1746581612108,MMW 13R,A01,892727,Staff,0,4,16,16
1746581612108,MMW 13R,A02,892728,Staff,0,4,16,16
1746581612108,MMW 13R,A03,958032,Staff,0,4,16,16
1746581612108,MMW 13R,A04,958033,Staff,0,4,16,16
1746581612108,MMW 13R,A05,958034,Staff,0,4,16,16
1746581613137,SIO 295LS,A00,894015,Staff,5,0,25,20
1746581614164,SIO 295S,A00,894020,Staff,5,0,25,20
1746581615190,SIOC 290S,B01,958918,Merrifield; Mark A,14,0,30,16
1746581616216,SIOC 291S,B01,958922,Gabriel; Corey John,14,0,30,16
1746581617241,SOCI 117,A01,895339,Staff,3,0,5,2
1746581618266,WES 237B,A00,894149,Staff,11,0,20,9
1746581620323,AESE 279B,A00,891859,Staff,13,0,35,22
1746581621354,AIP 197,001,891854,Vespa; Emanuel Ignacio,9999,0,9999,0
1746581622378,ANTH 289S,A00,891856,Gagneux; Pascal,12,0,12,0
1746581623404,BENG 196,001,957946,Engler; Adam J.,9996,0,9999,3
1746581624429,BISP 197,001,959851,Wilhelm; James E.,9998,0,9999,1
1746581625457,CAT 124RS,A01,956906,Staff,6,0,25,19
1746581626481,CAT 125RS,A01,922013,Staff,6,0,25,19
1746581627509,CLRE 250,A00,891860,Morris; Sheldon,9995,0,9999,4
1746581629558,CLRE 251R,A00,907817,Mehta; Ravindra L.,9994,0,9999,5
1746581630585,CLRE 252,A00,891864,Cuomo; Raphael Eduardo,9993,0,9999,6
1746581631609,CLRE 253,A00,891867,Vaida; Florin,9994,0,9999,5
1746581631609,CLRE 253,B00,907819,Staff,9999,0,9999,0
1746581632634,CLRE 259,A00,891868,Patel; Hemal,9998,0,9999,1
1746581633659,CLRE 260,A00,891872,Cuomo; Raphael Eduardo,9999,0,9999,0
1746581634682,CLRE 297,001,891888,Cuomo; Raphael Eduardo,9999,0,9999,0
1746581635708,CSE 191,A00,958773,Minnes Kemp; Mor Mia,9995,0,9999,4
1746581636733,CSE 197,001,959846,Minnes Kemp; Mor Mia,9990,0,9999,9
1746581637758,CSS 201S,A01,892054,Mignozzetti; Umberto,25,0,30,5
1746581638784,CSS 202S,A01,892056,Mignozzetti; Umberto,25,0,30,5
1746581639808,DSC 197,001,956898,Eldridge; Justin Matthew,9996,0,9999,3
1746581640834,DSC 297,001,958000,Mazumdar; Arya,9998,0,9999,1
1746581640834,DSC 297,002,959862,Wang; Yusu,9998,0,9999,1
1746581641862,EAP 100,A00,905686,Staff,9778,0,9999,221
1746581642888,ECE 45,A01,892618,Staff,0,0,65,65
1746581644953,ECE 111,A01,892719,Staff,6,0,65,59
1746581645977,ECE 197,001,957920,Mercier; Patrick Philip,9991,0,9999,8
1746581647004,ECON 178,A01,907814,Zhu; Ying,26,0,35,9
1746581648030,EDS 115,A00,895312,Staff,35,0,45,10
1746581649053,EDS 117,A01,895337,Staff,23,0,30,7
1746581650080,EDS 125,A00,895341,Jones; Gabrielle Anastasia,36,0,45,9
1746581651108,EDS 128A,A01,895459,Fargason; Sharon Gayle,44,0,45,1
1746581652132,EDS 128B,A01,895543,Pappas; Elizabeth,44,0,45,1
1746581653159,EDS 139,A00,897203,Pappas; Elizabeth,44,0,45,1
1746581653159,EDS 139,B00,897209,Fargason; Sharon Gayle,41,0,45,4
1746581654184,EDS 201,A00,895545,Staff,22,0,45,23
1746581655211,EDS 203,A01,895581,Halter; Christopher P.,22,0,45,23
1746581656234,EDS 204R,A01,895625,Heinzman; Erica M.,39,0,45,6
1746581656234,EDS 204R,B01,895693,Halter; Christopher P.,10,0,45,35
1746581657259,EDS 206R,A00,895694,Fargason; Sharon Gayle,1,0,30,29
1746581657259,EDS 206R,B00,895695,Choi; Bailey Miyeon,16,0,30,14
1746581658283,EDS 250,A00,895697,Hemans; Patricia Ann Benitez,22,0,45,23
1746581659310,EDS 281,A00,895701,Meyerott; Theresa Ann,1,0,15,14
1746581660335,EDS 284,A00,895736,Meyerott; Theresa Ann,1,0,15,14
1746581661362,EDS 286,A00,897210,Fine; Sarah,0,0,15,15
1746581662390,EDS 289C,A01,895770,Daly; Alan J.,1,0,15,14
1746581663418,EDS 290,A00,897211,Hofstetter; Carolyn,0,0,15,15
1746581664445,LIGM 5A,A00,896162,Fischer-Grunski; Eva K,12,0,20,8
1746581665474,LIGM 5B,A00,896260,Fischer-Grunski; Eva K,17,0,20,3
1746581666500,LIGM 5C,A00,896308,Fischer-Grunski; Eva K,18,0,20,2
1746581667528,LIIT 5AS,A00,896313,Carnelos; Chiara,18,0,20,2
1746581668553,LIIT 5BS,A00,896416,Carnelos; Chiara,20,0,20,0
1746581669580,LIIT 5CS,A00,896564,Carnelos; Chiara,20,0,20,0
1746581670607,LISP 5A,A00,896588,Munoz Sanchez; Alicia,2,0,20,18
1746581671633,LISP 5B,A00,896653,Munoz Sanchez; Alicia,7,0,20,13
1746581672659,LISP 5C,A00,896655,Munoz Sanchez; Alicia,0,1,20,20
1746581673688,MAE 197,001,957918,Kleissl; Jan,9996,0,9999,3
1746581673688,MAE 197,002,959806,Boechler; Nicholas Sebastia,9998,0,9999,1
1746581673688,MAE 197,003,959852,Mullin; Jennifer S,9998,0,9999,1
1746581674713,MATH 2,A01,957937,Staff,33,0,35,2
1746581675740,MATH 197,001,957876,Kedlaya; Kiran S.,9993,0,9999,6
1746581676767,MCWP 40,A00,892729,Duru; Nur,10,0,20,10
1746581676767,MCWP 40,B00,893304,Montejo; Carolina,14,0,20,6
1746581677791,MCWP 40R,A00,893757,Redela; Pamela Morgan,0,5,20,20
1746581678822,MCWP 50,A00,893758,Morshed; Michael James,0,0,20,20
1746581678822,MCWP 50,B00,893761,Bartulis; Jason Michael,17,0,20,3
1746581679852,MCWP 50R,A00,893766,Compas; Sean Matthew,0,1,20,20
1746581679852,MCWP 50R,B00,893769,Carter; Jennifer A,0,1,20,20
1746581679852,MCWP 50R,C00,893771,Krone; Jarret,0,3,20,20
1746581679852,MCWP 50R,D00,893772,Miller; Elizabeth Deen,0,0,20,20
1746581679852,MCWP 50R,E00,893775,Carter; Andrea L,0,1,20,20
1746581680879,MMW 11R,A01,892721,Herbst; Matthew,14,0,30,16
1746581680879,MMW 11R,A02,892722,Herbst; Matthew,0,0,0,3
1746581681906,MMW 12R,A01,892724,Herbst; Matthew,0,11,16,16
1746581681906,MMW 12R,A02,892725,Herbst; Matthew,0,10,16,16
1746581682933,MMW 13R,A01,892727,Staff,0,4,16,16
1746581682933,MMW 13R,A02,892728,Staff,0,4,16,16
1746581682933,MMW 13R,A03,958032,Staff,0,4,16,16
1746581682933,MMW 13R,A04,958033,Staff,0,4,16,16
1746581682933,MMW 13R,A05,958034,Staff,0,4,16,16
1746581683960,SIO 295LS,A00,894015,Staff,5,0,25,20
1746581684986,SIO 295S,A00,894020,Staff,5,0,25,20
1746581686012,SIOC 290S,B01,958918,Merrifield; Mark A,14,0,30,16
1746581687045,SIOC 291S,B01,958922,Gabriel; Corey John,14,0,30,16
1746581688071,SOCI 117,A01,895339,Staff,3,0,5,2
1746581689097,WES 237B,A00,894149,Staff,11,0,20,9
1746581691149,AESE 279B,A00,891859,Staff,13,0,35,22
1746581692173,AIP 197,001,891854,Vespa; Emanuel Ignacio,9999,0,9999,0
1746581693197,ANTH 289S,A00,891856,Gagneux; Pascal,12,0,12,0
1746581694225,BENG 196,001,957946,Engler; Adam J.,9996,0,9999,3
1746581695249,BISP 197,001,959851,Wilhelm; James E.,9998,0,9999,1
1746581696277,CAT 124RS,A01,956906,Staff,6,0,25,19
1746581697301,CAT 125RS,A01,922013,Staff,6,0,25,19
1746581698326,CLRE 250,A00,891860,Morris; Sheldon,9995,0,9999,4
1746581700376,CLRE 251R,A00,907817,Mehta; Ravindra L.,9994,0,9999,5
1746581701402,CLRE 252,A00,891864,Cuomo; Raphael Eduardo,9993,0,9999,6
1746581702430,CLRE 253,A00,891867,Vaida; Florin,9994,0,9999,5
1746581702430,CLRE 253,B00,907819,Staff,9999,0,9999,0
1746581703459,CLRE 259,A00,891868,Patel; Hemal,9998,0,9999,1
1746581704482,CLRE 260,A00,891872,Cuomo; Raphael Eduardo,9999,0,9999,0
1746581705507,CLRE 297,001,891888,Cuomo; Raphael Eduardo,9999,0,9999,0
1746581706534,CSE 191,A00,958773,Minnes Kemp; Mor Mia,9995,0,9999,4
1746581707559,CSE 197,001,959846,Minnes Kemp; Mor Mia,9990,0,9999,9
1746581708589,CSS 201S,A01,892054,Mignozzetti; Umberto,25,0,30,5
1746581709614,CSS 202S,A01,892056,Mignozzetti; Umberto,25,0,30,5
1746581710640,DSC 197,001,956898,Eldridge; Justin Matthew,9996,0,9999,3
1746581711665,DSC 297,001,958000,Mazumdar; Arya,9998,0,9999,1
1746581711665,DSC 297,002,959862,Wang; Yusu,9998,0,9999,1
1746581712692,EAP 100,A00,905686,Staff,9778,0,9999,221
1746581713719,ECE 45,A01,892618,Staff,0,0,65,65
1746581715776,ECE 111,A01,892719,Staff,6,0,65,59
1746581716801,ECE 197,001,957920,Mercier; Patrick Philip,9991,0,9999,8
1746581717827,ECON 178,A01,907814,Zhu; Ying,26,0,35,9
1746581718852,EDS 115,A00,895312,Staff,35,0,45,10
1746581719879,EDS 117,A01,895337,Staff,23,0,30,7
1746581720903,EDS 125,A00,895341,Jones; Gabrielle Anastasia,36,0,45,9
1746581721929,EDS 128A,A01,895459,Fargason; Sharon Gayle,44,0,45,1
1746581722954,EDS 128B,A01,895543,Pappas; Elizabeth,44,0,45,1
1746581723981,EDS 139,A00,897203,Pappas; Elizabeth,44,0,45,1
1746581723981,EDS 139,B00,897209,Fargason; Sharon Gayle,41,0,45,4
1746581725010,EDS 201,A00,895545,Staff,22,0,45,23
1746581726035,EDS 203,A01,895581,Halter; Christopher P.,22,0,45,23
1746581727061,EDS 204R,A01,895625,Heinzman; Erica M.,39,0,45,6
1746581727061,EDS 204R,B01,895693,Halter; Christopher P.,10,0,45,35
1746581728087,EDS 206R,A00,895694,Fargason; Sharon Gayle,1,0,30,29
1746581728087,EDS 206R,B00,895695,Choi; Bailey Miyeon,16,0,30,14
1746581729111,EDS 250,A00,895697,Hemans; Patricia Ann Benitez,22,0,45,23
1746581730141,EDS 281,A00,895701,Meyerott; Theresa Ann,1,0,15,14
1746581731166,EDS 284,A00,895736,Meyerott; Theresa Ann,1,0,15,14
1746581732190,EDS 286,A00,897210,Fine; Sarah,0,0,15,15
1746581733216,EDS 289C,A01,895770,Daly; Alan J.,1,0,15,14
1746581734241,EDS 290,A00,897211,Hofstetter; Carolyn,0,0,15,15
1746581735267,LIGM 5A,A00,896162,Fischer-Grunski; Eva K,12,0,20,8
1746581736292,LIGM 5B,A00,896260,Fischer-Grunski; Eva K,17,0,20,3
1746581737318,LIGM 5C,A00,896308,Fischer-Grunski; Eva K,18,0,20,2
1746581738344,LIIT 5AS,A00,896313,Carnelos; Chiara,18,0,20,2
1746581739372,LIIT 5BS,A00,896416,Carnelos; Chiara,20,0,20,0
1746581740402,LIIT 5CS,A00,896564,Carnelos; Chiara,20,0,20,0
1746581741427,LISP 5A,A00,896588,Munoz Sanchez; Alicia,2,0,20,18
1746581742454,LISP 5B,A00,896653,Munoz Sanchez; Alicia,7,0,20,13
1746581743484,LISP 5C,A00,896655,Munoz Sanchez; Alicia,0,1,20,20
1746581744513,MAE 197,001,957918,Kleissl; Jan,9996,0,9999,3
1746581744513,MAE 197,002,959806,Boechler; Nicholas Sebastia,9998,0,9999,1
1746581744513,MAE 197,003,959852,Mullin; Jennifer S,9998,0,9999,1
1746581745540,MATH 2,A01,957937,Staff,33,0,35,2
1746581746566,MATH 197,001,957876,Kedlaya; Kiran S.,9993,0,9999,6
1746581747592,MCWP 40,A00,892729,Duru; Nur,10,0,20,10
1746581747592,MCWP 40,B00,893304,Montejo; Carolina,14,0,20,6
1746581748618,MCWP 40R,A00,893757,Redela; Pamela Morgan,0,5,20,20
1746581749643,MCWP 50,A00,893758,Morshed; Michael James,0,0,20,20
1746581749643,MCWP 50,B00,893761,Bartulis; Jason Michael,17,0,20,3
1746581750673,MCWP 50R,A00,893766,Compas; Sean Matthew,0,1,20,20
1746581750673,MCWP 50R,B00,893769,Carter; Jennifer A,0,1,20,20
1746581750673,MCWP 50R,C00,893771,Krone; Jarret,0,3,20,20
1746581750673,MCWP 50R,D00,893772,Miller; Elizabeth Deen,0,0,20,20
1746581750673,MCWP 50R,E00,893775,Carter; Andrea L,0,1,20,20
1746581751703,MMW 11R,A01,892721,Herbst; Matthew,14,0,30,16
1746581751703,MMW 11R,A02,892722,Herbst; Matthew,0,0,0,3
1746581752731,MMW 12R,A01,892724,Herbst; Matthew,0,11,16,16
1746581752731,MMW 12R,A02,892725,Herbst; Matthew,0,10,16,16
1746581753759,MMW 13R,A01,892727,Staff,0,4,16,16
1746581753759,MMW 13R,A02,892728,Staff,0,4,16,16
1746581753759,MMW 13R,A03,958032,Staff,0,4,16,16
1746581753759,MMW 13R,A04,958033,Staff,0,4,16,16
1746581753759,MMW 13R,A05,958034,Staff,0,4,16,16
1746581754787,SIO 295LS,A00,894015,Staff,5,0,25,20
1746581755811,SIO 295S,A00,894020,Staff,5,0,25,20
1746581756836,SIOC 290S,B01,958918,Merrifield; Mark A,14,0,30,16
1746581757863,SIOC 291S,B01,958922,Gabriel; Corey John,14,0,30,16
1746581758892,SOCI 117,A01,895339,Staff,3,0,5,2
1746581759916,WES 237B,A00,894149,Staff,11,0,20,9
1746581761974,AESE 279B,A00,891859,Staff,13,0,35,22
1746581762998,AIP 197,001,891854,Vespa; Emanuel Ignacio,9999,0,9999,0
1746581764026,ANTH 289S,A00,891856,Gagneux; Pascal,12,0,12,0
1746581765051,BENG 196,001,957946,Engler; Adam J.,9996,0,9999,3
1746581766074,BISP 197,001,959851,Wilhelm; James E.,9998,0,9999,1
1746581767100,CAT 124RS,A01,956906,Staff,6,0,25,19
1746581768129,CAT 125RS,A01,922013,Staff,6,0,25,19
1746581769155,CLRE 250,A00,891860,Morris; Sheldon,9995,0,9999,4
1746581771207,CLRE 251R,A00,907817,Mehta; Ravindra L.,9994,0,9999,5
1746581772236,CLRE 252,A00,891864,Cuomo; Raphael Eduardo,9993,0,9999,6
1746581773262,CLRE 253,A00,891867,Vaida; Florin,9994,0,9999,5
1746581773262,CLRE 253,B00,907819,Staff,9999,0,9999,0
1746581774288,CLRE 259,A00,891868,Patel; Hemal,9998,0,9999,1
1746581775316,CLRE 260,A00,891872,Cuomo; Raphael Eduardo,9999,0,9999,0
1746581776340,CLRE 297,001,891888,Cuomo; Raphael Eduardo,9999,0,9999,0
1746581777364,CSE 191,A00,958773,Minnes Kemp; Mor Mia,9995,0,9999,4
1746581778388,CSE 197,001,959846,Minnes Kemp; Mor Mia,9990,0,9999,9
1746581779417,CSS 201S,A01,892054,Mignozzetti; Umberto,25,0,30,5
1746581780443,CSS 202S,A01,892056,Mignozzetti; Umberto,25,0,30,5
1746581781468,DSC 197,001,956898,Eldridge; Justin Matthew,9996,0,9999,3
1746581782497,DSC 297,001,958000,Mazumdar; Arya,9998,0,9999,1
1746581782497,DSC 297,002,959862,Wang; Yusu,9998,0,9999,1
1746581783527,EAP 100,A00,905686,Staff,9778,0,9999,221
1746581784557,ECE 45,A01,892618,Staff,0,0,65,65
1746581786644,ECE 111,A01,892719,Staff,6,0,65,59
1746581787668,ECE 197,001,957920,Mercier; Patrick Philip,9991,0,9999,8
1746581788695,ECON 178,A01,907814,Zhu; Ying,26,0,35,9
1746581789720,EDS 115,A00,895312,Staff,35,0,45,10
1746581790745,EDS 117,A01,895337,Staff,23,0,30,7
1746581791773,EDS 125,A00,895341,Jones; Gabrielle Anastasia,36,0,45,9
1746581792798,EDS 128A,A01,895459,Fargason; Sharon Gayle,44,0,45,1
1746581793821,EDS 128B,A01,895543,Pappas; Elizabeth,44,0,45,1
1746581794850,EDS 139,A00,897203,Pappas; Elizabeth,44,0,45,1
1746581794850,EDS 139,B00,897209,Fargason; Sharon Gayle,41,0,45,4
1746581795875,EDS 201,A00,895545,Staff,22,0,45,23
1746581796903,EDS 203,A01,895581,Halter; Christopher P.,22,0,45,23
1746581797929,EDS 204R,A01,895625,Heinzman; Erica M.,39,0,45,6
1746581797929,EDS 204R,B01,895693,Halter; Christopher P.,10,0,45,35
1746581798957,EDS 206R,A00,895694,Fargason; Sharon Gayle,1,0,30,29
1746581798957,EDS 206R,B00,895695,Choi; Bailey Miyeon,16,0,30,14
1746581799982,EDS 250,A00,895697,Hemans; Patricia Ann Benitez,22,0,45,23
1746581801009,EDS 281,A00,895701,Meyerott; Theresa Ann,1,0,15,14
1746581802033,EDS 284,A00,895736,Meyerott; Theresa Ann,1,0,15,14
1746581803059,EDS 286,A00,897210,Fine; Sarah,0,0,15,15
1746581804086,EDS 289C,A01,895770,Daly; Alan J.,1,0,15,14
1746581805114,EDS 290,A00,897211,Hofstetter; Carolyn,0,0,15,15
1746581806139,LIGM 5A,A00,896162,Fischer-Grunski; Eva K,12,0,20,8
1746581807168,LIGM 5B,A00,896260,Fischer-Grunski; Eva K,17,0,20,3
1746581808192,LIGM 5C,A00,896308,Fischer-Grunski; Eva K,18,0,20,2
1746581809221,LIIT 5AS,A00,896313,Carnelos; Chiara,18,0,20,2
1746581810250,LIIT 5BS,A00,896416,Carnelos; Chiara,20,0,20,0
1746581811275,LIIT 5CS,A00,896564,Carnelos; Chiara,20,0,20,0
1746581812299,LISP 5A,A00,896588,Munoz Sanchez; Alicia,2,0,20,18
1746581813326,LISP 5B,A00,896653,Munoz Sanchez; Alicia,7,0,20,13
1746581814354,LISP 5C,A00,896655,Munoz Sanchez; Alicia,0,1,20,20
1746581815378,MAE 197,001,957918,Kleissl; Jan,9996,0,9999,3
1746581815378,MAE 197,002,959806,Boechler; Nicholas Sebastia,9998,0,9999,1
1746581815378,MAE 197,003,959852,Mullin; Jennifer S,9998,0,9999,1
1746581816407,MATH 2,A01,957937,Staff,33,0,35,2
1746581817433,MATH 197,001,957876,Kedlaya; Kiran S.,9993,0,9999,6
1746581818458,MCWP 40,A00,892729,Duru; Nur,10,0,20,10
1746581818458,MCWP 40,B00,893304,Montejo; Carolina,14,0,20,6
1746581819482,MCWP 40R,A00,893757,Redela; Pamela Morgan,0,5,20,20
1746581820507,MCWP 50,A00,893758,Morshed; Michael James,0,0,20,20
1746581820507,MCWP 50,B00,893761,Bartulis; Jason Michael,17,0,20,3
1746581821531,MCWP 50R,A00,893766,Compas; Sean Matthew,0,1,20,20
1746581821531,MCWP 50R,B00,893769,Carter; Jennifer A,0,1,20,20
1746581821531,MCWP 50R,C00,893771,Krone; Jarret,0,3,20,20
1746581821531,MCWP 50R,D00,893772,Miller; Elizabeth Deen,0,0,20,20
1746581821531,MCWP 50R,E00,893775,Carter; Andrea L,0,1,20,20
1746581822560,MMW 11R,A01,892721,Herbst; Matthew,14,0,30,16
1746581822560,MMW 11R,A02,892722,Herbst; Matthew,0,0,0,3
1746581823584,MMW 12R,A01,892724,Herbst; Matthew,0,11,16,16
1746581823584,MMW 12R,A02,892725,Herbst; Matthew,0,10,16,16
1746581824610,MMW 13R,A01,892727,Staff,0,4,16,16
1746581824610,MMW 13R,A02,892728,Staff,0,4,16,16
1746581824610,MMW 13R,A03,958032,Staff,0,4,16,16
1746581824610,MMW 13R,A04,958033,Staff,0,4,16,16
1746581824610,MMW 13R,A05,958034,Staff,0,4,16,16
1746581825639,SIO 295LS,A00,894015,Staff,5,0,25,20
1746581826665,SIO 295S,A00,894020,Staff,5,0,25,20
1746581827694,SIOC 290S,B01,958918,Merrifield; Mark A,14,0,30,16
1746581828724,SIOC 291S,B01,958922,Gabriel; Corey John,14,0,30,16
1746581829750,SOCI 117,A01,895339,Staff,3,0,5,2
1746581830778,WES 237B,A00,894149,Staff,11,0,20,9
1746581832844,AESE 279B,A00,891859,Staff,13,0,35,22
1746581833868,AIP 197,001,891854,Vespa; Emanuel Ignacio,9999,0,9999,0
1746581834895,ANTH 289S,A00,891856,Gagneux; Pascal,12,0,12,0
1746581835920,BENG 196,001,957946,Engler; Adam J.,9996,0,9999,3
1746581836945,BISP 197,001,959851,Wilhelm; James E.,9998,0,9999,1
1746581837969,CAT 124RS,A01,956906,Staff,6,0,25,19
1746581838996,CAT 125RS,A01,922013,Staff,6,0,25,19
1746581840023,CLRE 250,A00,891860,Morris; Sheldon,9995,0,9999,4
1746581842078,CLRE 251R,A00,907817,Mehta; Ravindra L.,9994,0,9999,5
1746581843102,CLRE 252,A00,891864,Cuomo; Raphael Eduardo,9993,0,9999,6
1746581844128,CLRE 253,A00,891867,Vaida; Florin,9994,0,9999,5
1746581844128,CLRE 253,B00,907819,Staff,9999,0,9999,0
1746581845157,CLRE 259,A00,891868,Patel; Hemal,9998,0,9999,1
1746581846185,CLRE 260,A00,891872,Cuomo; Raphael Eduardo,9999,0,9999,0
1746581847210,CLRE 297,001,891888,Cuomo; Raphael Eduardo,9999,0,9999,0
1746581848237,CSE 191,A00,958773,Minnes Kemp; Mor Mia,9995,0,9999,4
1746581849264,CSE 197,001,959846,Minnes Kemp; Mor Mia,9990,0,9999,9
1746581850289,CSS 201S,A01,892054,Mignozzetti; Umberto,25,0,30,5
1746581851885,CSS 202S,A01,892056,Mignozzetti; Umberto,25,0,30,5
1746581852910,DSC 197,001,956898,Eldridge; Justin Matthew,9996,0,9999,3
1746581853935,DSC 297,001,958000,Mazumdar; Arya,9998,0,9999,1
1746581853935,DSC 297,002,959862,Wang; Yusu,9998,0,9999,1
1746581854961,EAP 100,A00,905686,Staff,9778,0,9999,221
1746581855990,ECE 45,A01,892618,Staff,0,0,65,65
1746581858040,ECE 111,A01,892719,Staff,6,0,65,59
1746581859068,ECE 197,001,957920,Mercier; Patrick Philip,9991,0,9999,8
1746581860094,ECON 178,A01,907814,Zhu; Ying,26,0,35,9
1746581861122,EDS 115,A00,895312,Staff,35,0,45,10
1746581862145,EDS 117,A01,895337,Staff,23,0,30,7
1746581863171,EDS 125,A00,895341,Jones; Gabrielle Anastasia,36,0,45,9
1746581864200,EDS 128A,A01,895459,Fargason; Sharon Gayle,44,0,45,1
1746581865225,EDS 128B,A01,895543,Pappas; Elizabeth,44,0,45,1
1746581866251,EDS 139,A00,897203,Pappas; Elizabeth,44,0,45,1
1746581866251,EDS 139,B00,897209,Fargason; Sharon Gayle,41,0,45,4
1746581867278,EDS 201,A00,895545,Staff,22,0,45,23
1746581868307,EDS 203,A01,895581,Halter; Christopher P.,22,0,45,23
1746581869334,EDS 204R,A01,895625,Heinzman; Erica M.,39,0,45,6
1746581869334,EDS 204R,B01,895693,Halter; Christopher P.,10,0,45,35
1746581870358,EDS 206R,A00,895694,Fargason; Sharon Gayle,1,0,30,29
1746581870358,EDS 206R,B00,895695,Choi; Bailey Miyeon,16,0,30,14
1746581871383,EDS 250,A00,895697,Hemans; Patricia Ann Benitez,22,0,45,23
1746581872408,EDS 281,A00,895701,Meyerott; Theresa Ann,1,0,15,14
1746581873433,EDS 284,A00,895736,Meyerott; Theresa Ann,1,0,15,14
1746581874457,EDS 286,A00,897210,Fine; Sarah,0,0,15,15
1746581875488,EDS 289C,A01,895770,Daly; Alan J.,1,0,15,14
1746581876513,EDS 290,A00,897211,Hofstetter; Carolyn,0,0,15,15
1746581877539,LIGM 5A,A00,896162,Fischer-Grunski; Eva K,12,0,20,8
1746581878568,LIGM 5B,A00,896260,Fischer-Grunski; Eva K,17,0,20,3
1746581879594,LIGM 5C,A00,896308,Fischer-Grunski; Eva K,18,0,20,2
1746581880623,LIIT 5AS,A00,896313,Carnelos; Chiara,18,0,20,2
1746581881648,LIIT 5BS,A00,896416,Carnelos; Chiara,20,0,20,0
1746581882674,LIIT 5CS,A00,896564,Carnelos; Chiara,20,0,20,0
1746581883698,LISP 5A,A00,896588,Munoz Sanchez; Alicia,2,0,20,18
1746581884724,LISP 5B,A00,896653,Munoz Sanchez; Alicia,7,0,20,13
1746581885752,LISP 5C,A00,896655,Munoz Sanchez; Alicia,0,1,20,20
1746581886780,MAE 197,001,957918,Kleissl; Jan,9996,0,9999,3
1746581886780,MAE 197,002,959806,Boechler; Nicholas Sebastia,9998,0,9999,1
1746581886780,MAE 197,003,959852,Mullin; Jennifer S,9998,0,9999,1
1746581887808,MATH 2,A01,957937,Staff,33,0,35,2
1746581888833,MATH 197,001,957876,Kedlaya; Kiran S.,9993,0,9999,6
1746581889860,MCWP 40,A00,892729,Duru; Nur,10,0,20,10
1746581889860,MCWP 40,B00,893304,Montejo; Carolina,14,0,20,6
1746581890926,MCWP 40R,A00,893757,Redela; Pamela Morgan,0,5,20,20
1746581891950,MCWP 50,A00,893758,Morshed; Michael James,0,0,20,20
1746581891950,MCWP 50,B00,893761,Bartulis; Jason Michael,17,0,20,3
1746581892977,MCWP 50R,A00,893766,Compas; Sean Matthew,0,1,20,20
1746581892977,MCWP 50R,B00,893769,Carter; Jennifer A,0,1,20,20
1746581892977,MCWP 50R,C00,893771,Krone; Jarret,0,3,20,20
1746581892977,MCWP 50R,D00,893772,Miller; Elizabeth Deen,0,0,20,20
1746581892977,MCWP 50R,E00,893775,Carter; Andrea L,0,1,20,20
1746581894004,MMW 11R,A01,892721,Herbst; Matthew,14,0,30,16
1746581894004,MMW 11R,A02,892722,Herbst; Matthew,0,0,0,3
1746581895028,MMW 12R,A01,892724,Herbst; Matthew,0,11,16,16
1746581895028,MMW 12R,A02,892725,Herbst; Matthew,0,10,16,16
1746581896052,MMW 13R,A01,892727,Staff,0,4,16,16
1746581896052,MMW 13R,A02,892728,Staff,0,4,16,16
1746581896052,MMW 13R,A03,958032,Staff,0,4,16,16
1746581896052,MMW 13R,A04,958033,Staff,0,4,16,16
1746581896052,MMW 13R,A05,958034,Staff,0,4,16,16
1746581897079,SIO 295LS,A00,894015,Staff,5,0,25,20
1746581898104,SIO 295S,A00,894020,Staff,5,0,25,20
1746581899132,SIOC 290S,B01,958918,Merrifield; Mark A,14,0,30,16
1746581900161,SIOC 291S,B01,958922,Gabriel; Corey John,14,0,30,16
1746581901186,SOCI 117,A01,895339,Staff,3,0,5,2
1746581902212,WES 237B,A00,894149,Staff,11,0,20,9
1746581904270,AESE 279B,A00,891859,Staff,13,0,35,22
1746581905296,AIP 197,001,891854,Vespa; Emanuel Ignacio,9999,0,9999,0
1746581906321,ANTH 289S,A00,891856,Gagneux; Pascal,12,0,12,0
1746581907347,BENG 196,001,957946,Engler; Adam J.,9996,0,9999,3
1746581908374,BISP 197,001,959851,Wilhelm; James E.,9998,0,9999,1
1746581909400,CAT 124RS,A01,956906,Staff,6,0,25,19
1746581910424,CAT 125RS,A01,922013,Staff,6,0,25,19
1746581911460,CLRE 250,A00,891860,Morris; Sheldon,9995,0,9999,4
1746581913514,CLRE 251R,A00,907817,Mehta; Ravindra L.,9994,0,9999,5
1746581914542,CLRE 252,A00,891864,Cuomo; Raphael Eduardo,9993,0,9999,6
1746581915569,CLRE 253,A00,891867,Vaida; Florin,9994,0,9999,5
1746581915569,CLRE 253,B00,907819,Staff,9999,0,9999,0
1746581916597,CLRE 259,A00,891868,Patel; Hemal,9998,0,9999,1
1746581917625,CLRE 260,A00,891872,Cuomo; Raphael Eduardo,9999,0,9999,0
1746581918651,CLRE 297,001,891888,Cuomo; Raphael Eduardo,9999,0,9999,0
1746581919675,CSE 191,A00,958773,Minnes Kemp; Mor Mia,9995,0,9999,4
1746581920703,CSE 197,001,959846,Minnes Kemp; Mor Mia,9990,0,9999,9
1746581921726,CSS 201S,A01,892054,Mignozzetti; Umberto,25,0,30,5
1746581922752,CSS 202S,A01,892056,Mignozzetti; Umberto,25,0,30,5
1746581923780,DSC 197,001,956898,Eldridge; Justin Matthew,9996,0,9999,3
1746581924807,DSC 297,001,958000,Mazumdar; Arya,9998,0,9999,1
1746581924807,DSC 297,002,959862,Wang; Yusu,9998,0,9999,1
1746581925832,EAP 100,A00,905686,Staff,9778,0,9999,221
1746581926862,ECE 45,A01,892618,Staff,0,0,65,65
1746581928915,ECE 111,A01,892719,Staff,6,0,65,59
1746581929942,ECE 197,001,957920,Mercier; Patrick Philip,9991,0,9999,8
1746581930966,ECON 178,A01,907814,Zhu; Ying,26,0,35,9
1746581931993,EDS 115,A00,895312,Staff,35,0,45,10
1746581933020,EDS 117,A01,895337,Staff,23,0,30,7
1746581934044,EDS 125,A00,895341,Jones; Gabrielle Anastasia,36,0,45,9
1746581935071,EDS 128A,A01,895459,Fargason; Sharon Gayle,44,0,45,1
1746581936096,EDS 128B,A01,895543,Pappas; Elizabeth,44,0,45,1
1746581937123,EDS 139,A00,897203,Pappas; Elizabeth,44,0,45,1
1746581937123,EDS 139,B00,897209,Fargason; Sharon Gayle,41,0,45,4
1746581938147,EDS 201,A00,895545,Staff,22,0,45,23
1746581939172,EDS 203,A01,895581,Halter; Christopher P.,22,0,45,23
1746581940198,EDS 204R,A01,895625,Heinzman; Erica M.,39,0,45,6
1746581940198,EDS 204R,B01,895693,Halter; Christopher P.,10,0,45,35
1746581941226,EDS 206R,A00,895694,Fargason; Sharon Gayle,1,0,30,29
1746581941226,EDS 206R,B00,895695,Choi; Bailey Miyeon,16,0,30,14
1746581942255,EDS 250,A00,895697,Hemans; Patricia Ann Benitez,22,0,45,23
1746581943278,EDS 281,A00,895701,Meyerott; Theresa Ann,1,0,15,14
1746581944303,EDS 284,A00,895736,Meyerott; Theresa Ann,1,0,15,14
1746581945330,EDS 286,A00,897210,Fine; Sarah,0,0,15,15
1746581946355,EDS 289C,A01,895770,Daly; Alan J.,1,0,15,14
1746581947382,EDS 290,A00,897211,Hofstetter; Carolyn,0,0,15,15
1746581948473,LIGM 5A,A00,896162,Fischer-Grunski; Eva K,12,0,20,8
1746581949502,LIGM 5B,A00,896260,Fischer-Grunski; Eva K,17,0,20,3
1746581950530,LIGM 5C,A00,896308,Fischer-Grunski; Eva K,18,0,20,2
1746581951556,LIIT 5AS,A00,896313,Carnelos; Chiara,18,0,20,2
1746581952582,LIIT 5BS,A00,896416,Carnelos; Chiara,20,0,20,0
1746581953609,LIIT 5CS,A00,896564,Carnelos; Chiara,20,0,20,0
1746581954638,LISP 5A,A00,896588,Munoz Sanchez; Alicia,2,0,20,18
1746581955666,LISP 5B,A00,896653,Munoz Sanchez; Alicia,7,0,20,13
1746581956690,LISP 5C,A00,896655,Munoz Sanchez; Alicia,0,1,20,20
1746581957717,MAE 197,001,957918,Kleissl; Jan,9996,0,9999,3
1746581957717,MAE 197,002,959806,Boechler; Nicholas Sebastia,9998,0,9999,1
1746581957717,MAE 197,003,959852,Mullin; Jennifer S,9998,0,9999,1
1746581958740,MATH 2,A01,957937,Staff,33,0,35,2
1746581959820,MATH 197,001,957876,Kedlaya; Kiran S.,9993,0,9999,6
1746581960850,MCWP 40,A00,892729,Duru; Nur,10,0,20,10
1746581960850,MCWP 40,B00,893304,Montejo; Carolina,14,0,20,6
1746581961880,MCWP 40R,A00,893757,Redela; Pamela Morgan,0,5,20,20
1746581962907,MCWP 50,A00,893758,Morshed; Michael James,0,0,20,20
1746581962907,MCWP 50,B00,893761,Bartulis; Jason Michael,17,0,20,3
1746581963935,MCWP 50R,A00,893766,Compas; Sean Matthew,0,1,20,20
1746581963935,MCWP 50R,B00,893769,Carter; Jennifer A,0,1,20,20
1746581963935,MCWP 50R,C00,893771,Krone; Jarret,0,3,20,20
1746581963935,MCWP 50R,D00,893772,Miller; Elizabeth Deen,0,0,20,20
1746581963935,MCWP 50R,E00,893775,Carter; Andrea L,0,1,20,20
1746581964960,MMW 11R,A01,892721,Herbst; Matthew,14,0,30,16
1746581964960,MMW 11R,A02,892722,Herbst; Matthew,0,0,0,3
1746581965985,MMW 12R,A01,892724,Herbst; Matthew,0,11,16,16
1746581965985,MMW 12R,A02,892725,Herbst; Matthew,0,10,16,16
1746581967009,MMW 13R,A01,892727,Staff,0,4,16,16
1746581967009,MMW 13R,A02,892728,Staff,0,4,16,16
1746581967009,MMW 13R,A03,958032,Staff,0,4,16,16
1746581967009,MMW 13R,A04,958033,Staff,0,4,16,16
1746581967009,MMW 13R,A05,958034,Staff,0,4,16,16
1746581968037,SIO 295LS,A00,894015,Staff,5,0,25,20
1746581969064,SIO 295S,A00,894020,Staff,5,0,25,20
1746581970089,SIOC 290S,B01,958918,Merrifield; Mark A,14,0,30,16
1746581971116,SIOC 291S,B01,958922,Gabriel; Corey John,14,0,30,16
1746581972143,SOCI 117,A01,895339,Staff,3,0,5,2
1746581973168,WES 237B,A00,894149,Staff,11,0,20,9
1746581975227,AESE 279B,A00,891859,Staff,13,0,35,22
1746581976251,AIP 197,001,891854,Vespa; Emanuel Ignacio,9999,0,9999,0
1746581977280,ANTH 289S,A00,891856,Gagneux; Pascal,12,0,12,0
1746581978309,BENG 196,001,957946,Engler; Adam J.,9996,0,9999,3
1746581979335,BISP 197,001,959851,Wilhelm; James E.,9998,0,9999,1
1746581980358,CAT 124RS,A01,956906,Staff,6,0,25,19
1746581981381,CAT 125RS,A01,922013,Staff,6,0,25,19
1746581982415,CLRE 250,A00,891860,Morris; Sheldon,9995,0,9999,4
1746581984469,CLRE 251R,A00,907817,Mehta; Ravindra L.,9994,0,9999,5
1746581985493,CLRE 252,A00,891864,Cuomo; Raphael Eduardo,9993,0,9999,6
1746581986521,CLRE 253,A00,891867,Vaida; Florin,9994,0,9999,5
1746581986521,CLRE 253,B00,907819,Staff,9999,0,9999,0
1746581987547,CLRE 259,A00,891868,Patel; Hemal,9998,0,9999,1
1746581988576,CLRE 260,A00,891872,Cuomo; Raphael Eduardo,9999,0,9999,0
1746581989603,CLRE 297,001,891888,Cuomo; Raphael Eduardo,9999,0,9999,0
1746581990625,CSE 191,A00,958773,Minnes Kemp; Mor Mia,9995,0,9999,4
1746581991649,CSE 197,001,959846,Minnes Kemp; Mor Mia,9990,0,9999,9
1746581992677,CSS 201S,A01,892054,Mignozzetti; Umberto,25,0,30,5
1746581993703,CSS 202S,A01,892056,Mignozzetti; Umberto,25,0,30,5
1746581994728,DSC 197,001,956898,Eldridge; Justin Matthew,9996,0,9999,3
1746581995759,DSC 297,001,958000,Mazumdar; Arya,9998,0,9999,1
1746581995759,DSC 297,002,959862,Wang; Yusu,9998,0,9999,1
1746581996783,EAP 100,A00,905686,Staff,9778,0,9999,221
1746581997808,ECE 45,A01,892618,Staff,0,0,65,65
1746581999863,ECE 111,A01,892719,Staff,6,0,65,59
1746582000889,ECE 197,001,957920,Mercier; Patrick Philip,9991,0,9999,8
1746582001915,ECON 178,A01,907814,Zhu; Ying,26,0,35,9
1746582002941,EDS 115,A00,895312,Staff,35,0,45,10
1746582003965,EDS 117,A01,895337,Staff,23,0,30,7
1746582004990,EDS 125,A00,895341,Jones; Gabrielle Anastasia,36,0,45,9
1746582006019,EDS 128A,A01,895459,Fargason; Sharon Gayle,44,0,45,1
1746582007045,EDS 128B,A01,895543,Pappas; Elizabeth,44,0,45,1
1746582008074,EDS 139,A00,897203,Pappas; Elizabeth,44,0,45,1
1746582008074,EDS 139,B00,897209,Fargason; Sharon Gayle,41,0,45,4
1746582009103,EDS 201,A00,895545,Staff,22,0,45,23
1746582010126,EDS 203,A01,895581,Halter; Christopher P.,22,0,45,23
1746582011154,EDS 204R,A01,895625,Heinzman; Erica M.,39,0,45,6
1746582011154,EDS 204R,B01,895693,Halter; Christopher P.,10,0,45,35
1746582012179,EDS 206R,A00,895694,Fargason; Sharon Gayle,1,0,30,29
1746582012179,EDS 206R,B00,895695,Choi; Bailey Miyeon,16,0,30,14
1746582013203,EDS 250,A00,895697,Hemans; Patricia Ann Benitez,22,0,45,23
1746582014229,EDS 281,A00,895701,Meyerott; Theresa Ann,1,0,15,14
1746582015253,EDS 284,A00,895736,Meyerott; Theresa Ann,1,0,15,14
1746582016277,EDS 286,A00,897210,Fine; Sarah,0,0,15,15
1746582017309,EDS 289C,A01,895770,Daly; Alan J.,1,0,15,14
1746582018335,EDS 290,A00,897211,Hofstetter; Carolyn,0,0,15,15
1746582019363,LIGM 5A,A00,896162,Fischer-Grunski; Eva K,12,0,20,8
1746582020392,LIGM 5B,A00,896260,Fischer-Grunski; Eva K,17,0,20,3
1746582021417,LIGM 5C,A00,896308,Fischer-Grunski; Eva K,18,0,20,2
1746582022442,LIIT 5AS,A00,896313,Carnelos; Chiara,18,0,20,2
1746582023468,LIIT 5BS,A00,896416,Carnelos; Chiara,20,0,20,0
1746582024494,LIIT 5CS,A00,896564,Carnelos; Chiara,20,0,20,0
1746582025521,LISP 5A,A00,896588,Munoz Sanchez; Alicia,2,0,20,18
1746582026551,LISP 5B,A00,896653,Munoz Sanchez; Alicia,7,0,20,13
1746582027580,LISP 5C,A00,896655,Munoz Sanchez; Alicia,0,1,20,20
1746582028647,MAE 197,001,957918,Kleissl; Jan,9996,0,9999,3
1746582028647,MAE 197,002,959806,Boechler; Nicholas Sebastia,9998,0,9999,1
1746582028647,MAE 197,003,959852,Mullin; Jennifer S,9998,0,9999,1
1746582029672,MATH 2,A01,957937,Staff,33,0,35,2
1746582030700,MATH 197,001,957876,Kedlaya; Kiran S.,9993,0,9999,6
1746582031727,MCWP 40,A00,892729,Duru; Nur,10,0,20,10
1746582031727,MCWP 40,B00,893304,Montejo; Carolina,14,0,20,6
1746582032755,MCWP 40R,A00,893757,Redela; Pamela Morgan,0,5,20,20
1746582033779,MCWP 50,A00,893758,Morshed; Michael James,0,0,20,20
1746582033779,MCWP 50,B00,893761,Bartulis; Jason Michael,17,0,20,3
1746582034811,MCWP 50R,A00,893766,Compas; Sean Matthew,0,1,20,20
1746582034811,MCWP 50R,B00,893769,Carter; Jennifer A,0,1,20,20
1746582034811,MCWP 50R,C00,893771,Krone; Jarret,0,3,20,20
1746582034811,MCWP 50R,D00,893772,Miller; Elizabeth Deen,0,0,20,20
1746582034811,MCWP 50R,E00,893775,Carter; Andrea L,0,1,20,20
1746582035836,MMW 11R,A01,892721,Herbst; Matthew,14,0,30,16
1746582035836,MMW 11R,A02,892722,Herbst; Matthew,0,0,0,3
1746582036864,MMW 12R,A01,892724,Herbst; Matthew,0,11,16,16
1746582036864,MMW 12R,A02,892725,Herbst; Matthew,0,10,16,16
1746582037891,MMW 13R,A01,892727,Staff,0,4,16,16
1746582037891,MMW 13R,A02,892728,Staff,0,4,16,16
1746582037891,MMW 13R,A03,958032,Staff,0,4,16,16
1746582037891,MMW 13R,A04,958033,Staff,0,4,16,16
1746582037891,MMW 13R,A05,958034,Staff,0,4,16,16
1746582038920,SIO 295LS,A00,894015,Staff,5,0,25,20
1746582039948,SIO 295S,A00,894020,Staff,5,0,25,20
1746582040977,SIOC 290S,B01,958918,Merrifield; Mark A,14,0,30,16
1746582042008,SIOC 291S,B01,958922,Gabriel; Corey John,14,0,30,16
1746582043035,SOCI 117,A01,895339,Staff,3,0,5,2
1746582044065,WES 237B,A00,894149,Staff,11,0,20,9
1746582046128,AESE 279B,A00,891859,Staff,13,0,35,22
1746582047152,AIP 197,001,891854,Vespa; Emanuel Ignacio,9999,0,9999,0
1746582048179,ANTH 289S,A00,891856,Gagneux; Pascal,12,0,12,0
1746582049207,BENG 196,001,957946,Engler; Adam J.,9996,0,9999,3
1746582050236,BISP 197,001,959851,Wilhelm; James E.,9998,0,9999,1
1746582051260,CAT 124RS,A01,956906,Staff,6,0,25,19
1746582052285,CAT 125RS,A01,922013,Staff,6,0,25,19
1746582053311,CLRE 250,A00,891860,Morris; Sheldon,9995,0,9999,4
1746582055367,CLRE 251R,A00,907817,Mehta; Ravindra L.,9994,0,9999,5
1746582056396,CLRE 252,A00,891864,Cuomo; Raphael Eduardo,9993,0,9999,6
1746582057421,CLRE 253,A00,891867,Vaida; Florin,9994,0,9999,5
1746582057421,CLRE 253,B00,907819,Staff,9999,0,9999,0
1746582058450,CLRE 259,A00,891868,Patel; Hemal,9998,0,9999,1
1746582059477,CLRE 260,A00,891872,Cuomo; Raphael Eduardo,9999,0,9999,0
1746582060503,CLRE 297,001,891888,Cuomo; Raphael Eduardo,9999,0,9999,0
1746582061531,CSE 191,A00,958773,Minnes Kemp; Mor Mia,9995,0,9999,4
1746582062560,CSE 197,001,959846,Minnes Kemp; Mor Mia,9990,0,9999,9
1746582063590,CSS 201S,A01,892054,Mignozzetti; Umberto,25,0,30,5
1746582064614,CSS 202S,A01,892056,Mignozzetti; Umberto,25,0,30,5
1746582065641,DSC 197,001,956898,Eldridge; Justin Matthew,9996,0,9999,3
1746582066669,DSC 297,001,958000,Mazumdar; Arya,9998,0,9999,1
1746582066669,DSC 297,002,959862,Wang; Yusu,9998,0,9999,1
1746582067695,EAP 100,A00,905686,Staff,9778,0,9999,221
1746582068724,ECE 45,A01,892618,Staff,0,0,65,65
1746582070781,ECE 111,A01,892719,Staff,6,0,65,59
1746582071805,ECE 197,001,957920,Mercier; Patrick Philip,9991,0,9999,8
1746582072829,ECON 178,A01,907814,Zhu; Ying,26,0,35,9
1746582073855,EDS 115,A00,895312,Staff,35,0,45,10
1746582074882,EDS 117,A01,895337,Staff,23,0,30,7
1746582075907,EDS 125,A00,895341,Jones; Gabrielle Anastasia,36,0,45,9
1746582076936,EDS 128A,A01,895459,Fargason; Sharon Gayle,44,0,45,1
1746582077964,EDS 128B,A01,895543,Pappas; Elizabeth,44,0,45,1
1746582078990,EDS 139,A00,897203,Pappas; Elizabeth,44,0,45,1
1746582078990,EDS 139,B00,897209,Fargason; Sharon Gayle,41,0,45,4
1746582080014,EDS 201,A00,895545,Staff,22,0,45,23
1746582081041,EDS 203,A01,895581,Halter; Christopher P.,22,0,45,23
1746582082069,EDS 204R,A01,895625,Heinzman; Erica M.,39,0,45,6
1746582082069,EDS 204R,B01,895693,Halter; Christopher P.,10,0,45,35
1746582083097,EDS 206R,A00,895694,Fargason; Sharon Gayle,1,0,30,29
1746582083097,EDS 206R,B00,895695,Choi; Bailey Miyeon,16,0,30,14
1746582084127,EDS 250,A00,895697,Hemans; Patricia Ann Benitez,22,0,45,23
1746582085154,EDS 281,A00,895701,Meyerott; Theresa Ann,1,0,15,14
1746582086182,EDS 284,A00,895736,Meyerott; Theresa Ann,1,0,15,14
1746582087208,EDS 286,A00,897210,Fine; Sarah,0,0,15,15
1746582088231,EDS 289C,A01,895770,Daly; Alan J.,1,0,15,14
1746582089257,EDS 290,A00,897211,Hofstetter; Carolyn,0,0,15,15
1746582090282,LIGM 5A,A00,896162,Fischer-Grunski; Eva K,12,0,20,8
1746582091308,LIGM 5B,A00,896260,Fischer-Grunski; Eva K,17,0,20,3
1746582092336,LIGM 5C,A00,896308,Fischer-Grunski; Eva K,18,0,20,2
1746582093362,LIIT 5AS,A00,896313,Carnelos; Chiara,18,0,20,2
1746582094385,LIIT 5BS,A00,896416,Carnelos; Chiara,20,0,20,0
1746582095415,LIIT 5CS,A00,896564,Carnelos; Chiara,20,0,20,0
1746582096444,LISP 5A,A00,896588,Munoz Sanchez; Alicia,2,0,20,18
1746582097473,LISP 5B,A00,896653,Munoz Sanchez; Alicia,7,0,20,13
1746582098503,LISP 5C,A00,896655,Munoz Sanchez; Alicia,0,1,20,20
1746582099528,MAE 197,001,957918,Kleissl; Jan,9996,0,9999,3
1746582099528,MAE 197,002,959806,Boechler; Nicholas Sebastia,9998,0,9999,1
1746582099528,MAE 197,003,959852,Mullin; Jennifer S,9998,0,9999,1
1746582100554,MATH 2,A01,957937,Staff,33,0,35,2
1746582101578,MATH 197,001,957876,Kedlaya; Kiran S.,9993,0,9999,6
1746582102603,MCWP 40,A00,892729,Duru; Nur,10,0,20,10
1746582102603,MCWP 40,B00,893304,Montejo; Carolina,14,0,20,6
1746582103629,MCWP 40R,A00,893757,Redela; Pamela Morgan,0,5,20,20
1746582104657,MCWP 50,A00,893758,Morshed; Michael James,0,0,20,20
1746582104657,MCWP 50,B00,893761,Bartulis; Jason Michael,17,0,20,3
1746582105684,MCWP 50R,A00,893766,Compas; Sean Matthew,0,1,20,20
1746582105684,MCWP 50R,B00,893769,Carter; Jennifer A,0,1,20,20
1746582105684,MCWP 50R,C00,893771,Krone; Jarret,0,3,20,20
1746582105684,MCWP 50R,D00,893772,Miller; Elizabeth Deen,0,0,20,20
1746582105684,MCWP 50R,E00,893775,Carter; Andrea L,0,1,20,20
1746582106714,MMW 11R,A01,892721,Herbst; Matthew,14,0,30,16
1746582106714,MMW 11R,A02,892722,Herbst; Matthew,0,0,0,3
1746582107744,MMW 12R,A01,892724,Herbst; Matthew,0,11,16,16
1746582107744,MMW 12R,A02,892725,Herbst; Matthew,0,10,16,16
1746582108770,MMW 13R,A01,892727,Staff,0,4,16,16
1746582108770,MMW 13R,A02,892728,Staff,0,4,16,16
1746582108770,MMW 13R,A03,958032,Staff,0,4,16,16
1746582108770,MMW 13R,A04,958033,Staff,0,4,16,16
1746582108770,MMW 13R,A05,958034,Staff,0,4,16,16
1746582109799,SIO 295LS,A00,894015,Staff,5,0,25,20
1746582110828,SIO 295S,A00,894020,Staff,5,0,25,20
1746582111857,SIOC 290S,B01,958918,Merrifield; Mark A,14,0,30,16
1746582112882,SIOC 291S,B01,958922,Gabriel; Corey John,14,0,30,16
1746582113908,SOCI 117,A01,895339,Staff,3,0,5,2
1746582114933,WES 237B,A00,894149,Staff,11,0,20,9
1746582116999,AESE 279B,A00,891859,Staff,13,0,35,22
1746582118024,AIP 197,001,891854,Vespa; Emanuel Ignacio,9999,0,9999,0
1746582119049,ANTH 289S,A00,891856,Gagneux; Pascal,12,0,12,0
1746582120078,BENG 196,001,957946,Engler; Adam J.,9996,0,9999,3
1746582121103,BISP 197,001,959851,Wilhelm; James E.,9998,0,9999,1
1746582122132,CAT 124RS,A01,956906,Staff,6,0,25,19
1746582123158,CAT 125RS,A01,922013,Staff,6,0,25,19
1746582124186,CLRE 250,A00,891860,Morris; Sheldon,9995,0,9999,4
1746582126237,CLRE 251R,A00,907817,Mehta; Ravindra L.,9994,0,9999,5
1746582127266,CLRE 252,A00,891864,Cuomo; Raphael Eduardo,9993,0,9999,6
1746582128290,CLRE 253,A00,891867,Vaida; Florin,9994,0,9999,5
1746582128290,CLRE 253,B00,907819,Staff,9999,0,9999,0
1746582129320,CLRE 259,A00,891868,Patel; Hemal,9998,0,9999,1
1746582130348,CLRE 260,A00,891872,Cuomo; Raphael Eduardo,9999,0,9999,0
1746582131376,CLRE 297,001,891888,Cuomo; Raphael Eduardo,9999,0,9999,0
1746582132415,CSE 191,A00,958773,Minnes Kemp; Mor Mia,9995,0,9999,4
1746582133440,CSE 197,001,959846,Minnes Kemp; Mor Mia,9990,0,9999,9
1746582134471,CSS 201S,A01,892054,Mignozzetti; Umberto,25,0,30,5
1746582135501,CSS 202S,A01,892056,Mignozzetti; Umberto,25,0,30,5
1746582136528,DSC 197,001,956898,Eldridge; Justin Matthew,9996,0,9999,3
1746582137556,DSC 297,001,958000,Mazumdar; Arya,9998,0,9999,1
1746582137556,DSC 297,002,959862,Wang; Yusu,9998,0,9999,1
1746582138583,EAP 100,A00,905686,Staff,9778,0,9999,221
1746582139614,ECE 45,A01,892618,Staff,0,0,65,65
1746582141672,ECE 111,A01,892719,Staff,6,0,65,59
1746582142701,ECE 197,001,957920,Mercier; Patrick Philip,9991,0,9999,8
1746582143730,ECON 178,A01,907814,Zhu; Ying,26,0,35,9
1746582144755,EDS 115,A00,895312,Staff,35,0,45,10
1746582145780,EDS 117,A01,895337,Staff,23,0,30,7
1746582146806,EDS 125,A00,895341,Jones; Gabrielle Anastasia,36,0,45,9
1746582147831,EDS 128A,A01,895459,Fargason; Sharon Gayle,44,0,45,1
1746582148856,EDS 128B,A01,895543,Pappas; Elizabeth,44,0,45,1
1746582149880,EDS 139,A00,897203,Pappas; Elizabeth,44,0,45,1
1746582149880,EDS 139,B00,897209,Fargason; Sharon Gayle,41,0,45,4
1746582150906,EDS 201,A00,895545,Staff,22,0,45,23
1746582151932,EDS 203,A01,895581,Halter; Christopher P.,22,0,45,23
1746582152958,EDS 204R,A01,895625,Heinzman; Erica M.,39,0,45,6
1746582152958,EDS 204R,B01,895693,Halter; Christopher P.,10,0,45,35
1746582153986,EDS 206R,A00,895694,Fargason; Sharon Gayle,1,0,30,29
1746582153986,EDS 206R,B00,895695,Choi; Bailey Miyeon,16,0,30,14
1746582155014,EDS 250,A00,895697,Hemans; Patricia Ann Benitez,22,0,45,23
1746582156041,EDS 281,A00,895701,Meyerott; Theresa Ann,1,0,15,14
1746582157065,EDS 284,A00,895736,Meyerott; Theresa Ann,1,0,15,14
1746582158089,EDS 286,A00,897210,Fine; Sarah,0,0,15,15
1746582159116,EDS 289C,A01,895770,Daly; Alan J.,1,0,15,14
1746582160142,EDS 290,A00,897211,Hofstetter; Carolyn,0,0,15,15
1746582161169,LIGM 5A,A00,896162,Fischer-Grunski; Eva K,12,0,20,8
1746582162198,LIGM 5B,A00,896260,Fischer-Grunski; Eva K,17,0,20,3
1746582163230,LIGM 5C,A00,896308,Fischer-Grunski; Eva K,18,0,20,2
1746582164261,LIIT 5AS,A00,896313,Carnelos; Chiara,18,0,20,2
1746582165289,LIIT 5BS,A00,896416,Carnelos; Chiara,20,0,20,0
1746582166316,LIIT 5CS,A00,896564,Carnelos; Chiara,20,0,20,0
1746582167342,LISP 5A,A00,896588,Munoz Sanchez; Alicia,2,0,20,18
1746582168373,LISP 5B,A00,896653,Munoz Sanchez; Alicia,7,0,20,13
1746582169400,LISP 5C,A00,896655,Munoz Sanchez; Alicia,0,1,20,20
1746582170427,MAE 197,001,957918,Kleissl; Jan,9996,0,9999,3
1746582170427,MAE 197,002,959806,Boechler; Nicholas Sebastia,9998,0,9999,1
1746582170427,MAE 197,003,959852,Mullin; Jennifer S,9998,0,9999,1
1746582171451,MATH 2,A01,957937,Staff,33,0,35,2
1746582172479,MATH 197,001,957876,Kedlaya; Kiran S.,9993,0,9999,6
1746582173503,MCWP 40,A00,892729,Duru; Nur,10,0,20,10
1746582173503,MCWP 40,B00,893304,Montejo; Carolina,14,0,20,6
1746582174530,MCWP 40R,A00,893757,Redela; Pamela Morgan,0,5,20,20
1746582175558,MCWP 50,A00,893758,Morshed; Michael James,0,0,20,20
1746582175558,MCWP 50,B00,893761,Bartulis; Jason Michael,17,0,20,3
1746582176583,MCWP 50R,A00,893766,Compas; Sean Matthew,0,1,20,20
1746582176583,MCWP 50R,B00,893769,Carter; Jennifer A,0,1,20,20
1746582176583,MCWP 50R,C00,893771,Krone; Jarret,0,3,20,20
1746582176583,MCWP 50R,D00,893772,Miller; Elizabeth Deen,0,0,20,20
1746582176583,MCWP 50R,E00,893775,Carter; Andrea L,0,1,20,20
1746582177607,MMW 11R,A01,892721,Herbst; Matthew,14,0,30,16
1746582177607,MMW 11R,A02,892722,Herbst; Matthew,0,0,0,3
1746582178632,MMW 12R,A01,892724,Herbst; Matthew,0,11,16,16
1746582178632,MMW 12R,A02,892725,Herbst; Matthew,0,10,16,16
1746582179661,MMW 13R,A01,892727,Staff,0,4,16,16
1746582179661,MMW 13R,A02,892728,Staff,0,4,16,16
1746582179661,MMW 13R,A03,958032,Staff,0,4,16,16
1746582179661,MMW 13R,A04,958033,Staff,0,4,16,16
1746582179661,MMW 13R,A05,958034,Staff,0,4,16,16
1746582180686,SIO 295LS,A00,894015,Staff,5,0,25,20
1746582181712,SIO 295S,A00,894020,Staff,5,0,25,20
1746582182742,SIOC 290S,B01,958918,Merrifield; Mark A,14,0,30,16
1746582183770,SIOC 291S,B01,958922,Gabriel; Corey John,14,0,30,16
1746582184794,SOCI 117,A01,895339,Staff,3,0,5,2
1746582185819,WES 237B,A00,894149,Staff,11,0,20,9
1746582187883,AESE 279B,A00,891859,Staff,13,0,35,22
1746582188911,AIP 197,001,891854,Vespa; Emanuel Ignacio,9999,0,9999,0
1746582189935,ANTH 289S,A00,891856,Gagneux; Pascal,12,0,12,0
1746582190962,BENG 196,001,957946,Engler; Adam J.,9996,0,9999,3
1746582191990,BISP 197,001,959851,Wilhelm; James E.,9998,0,9999,1
1746582193017,CAT 124RS,A01,956906,Staff,6,0,25,19
1746582194043,CAT 125RS,A01,922013,Staff,6,0,25,19
1746582195074,CLRE 250,A00,891860,Morris; Sheldon,9995,0,9999,4
1746582197127,CLRE 251R,A00,907817,Mehta; Ravindra L.,9994,0,9999,5
1746582198215,CLRE 252,A00,891864,Cuomo; Raphael Eduardo,9993,0,9999,6
1746582199240,CLRE 253,A00,891867,Vaida; Florin,9994,0,9999,5
1746582199240,CLRE 253,B00,907819,Staff,9999,0,9999,0
1746582200268,CLRE 259,A00,891868,Patel; Hemal,9998,0,9999,1
1746582201293,CLRE 260,A00,891872,Cuomo; Raphael Eduardo,9999,0,9999,0
1746582202316,CLRE 297,001,891888,Cuomo; Raphael Eduardo,9999,0,9999,0
1746582203340,CSE 191,A00,958773,Minnes Kemp; Mor Mia,9995,0,9999,4
1746582204369,CSE 197,001,959846,Minnes Kemp; Mor Mia,9990,0,9999,9
1746582205393,CSS 201S,A01,892054,Mignozzetti; Umberto,25,0,30,5
1746582206425,CSS 202S,A01,892056,Mignozzetti; Umberto,25,0,30,5
1746582207450,DSC 197,001,956898,Eldridge; Justin Matthew,9996,0,9999,3
1746582208474,DSC 297,001,958000,Mazumdar; Arya,9998,0,9999,1
1746582208474,DSC 297,002,959862,Wang; Yusu,9998,0,9999,1
1746582209500,EAP 100,A00,905686,Staff,9778,0,9999,221
1746582210525,ECE 45,A01,892618,Staff,0,0,65,65
1746582212584,ECE 111,A01,892719,Staff,6,0,65,59
1746582213609,ECE 197,001,957920,Mercier; Patrick Philip,9991,0,9999,8
1746582214638,ECON 178,A01,907814,Zhu; Ying,26,0,35,9
1746582215663,EDS 115,A00,895312,Staff,35,0,45,10
1746582216691,EDS 117,A01,895337,Staff,23,0,30,7
1746582217717,EDS 125,A00,895341,Jones; Gabrielle Anastasia,36,0,45,9
1746582218743,EDS 128A,A01,895459,Fargason; Sharon Gayle,44,0,45,1
1746582219772,EDS 128B,A01,895543,Pappas; Elizabeth,44,0,45,1
1746582220800,EDS 139,A00,897203,Pappas; Elizabeth,44,0,45,1
1746582220800,EDS 139,B00,897209,Fargason; Sharon Gayle,41,0,45,4
1746582221825,EDS 201,A00,895545,Staff,22,0,45,23
1746582222855,EDS 203,A01,895581,Halter; Christopher P.,22,0,45,23
1746582223880,EDS 204R,A01,895625,Heinzman; Erica M.,39,0,45,6
1746582223880,EDS 204R,B01,895693,Halter; Christopher P.,10,0,45,35
1746582224903,EDS 206R,A00,895694,Fargason; Sharon Gayle,1,0,30,29
1746582224903,EDS 206R,B00,895695,Choi; Bailey Miyeon,16,0,30,14
1746582225928,EDS 250,A00,895697,Hemans; Patricia Ann Benitez,22,0,45,23
1746582226957,EDS 281,A00,895701,Meyerott; Theresa Ann,1,0,15,14
1746582227982,EDS 284,A00,895736,Meyerott; Theresa Ann,1,0,15,14
1746582229013,EDS 286,A00,897210,Fine; Sarah,0,0,15,15
1746582230039,EDS 289C,A01,895770,Daly; Alan J.,1,0,15,14
1746582231066,EDS 290,A00,897211,Hofstetter; Carolyn,0,0,15,15
1746582232092,LIGM 5A,A00,896162,Fischer-Grunski; Eva K,12,0,20,8
1746582233121,LIGM 5B,A00,896260,Fischer-Grunski; Eva K,17,0,20,3
1746582234145,LIGM 5C,A00,896308,Fischer-Grunski; Eva K,18,0,20,2
1746582235170,LIIT 5AS,A00,896313,Carnelos; Chiara,18,0,20,2
1746582236200,LIIT 5BS,A00,896416,Carnelos; Chiara,20,0,20,0
1746582237225,LIIT 5CS,A00,896564,Carnelos; Chiara,20,0,20,0
1746582238250,LISP 5A,A00,896588,Munoz Sanchez; Alicia,2,0,20,18
1746582239274,LISP 5B,A00,896653,Munoz Sanchez; Alicia,7,0,20,13
1746582240303,LISP 5C,A00,896655,Munoz Sanchez; Alicia,0,1,20,20
1746582241328,MAE 197,001,957918,Kleissl; Jan,9996,0,9999,3
1746582241328,MAE 197,002,959806,Boechler; Nicholas Sebastia,9998,0,9999,1
1746582241328,MAE 197,003,959852,Mullin; Jennifer S,9998,0,9999,1
1746582242352,MATH 2,A01,957937,Staff,33,0,35,2
1746582243381,MATH 197,001,957876,Kedlaya; Kiran S.,9993,0,9999,6
1746582244407,MCWP 40,A00,892729,Duru; Nur,10,0,20,10
1746582244407,MCWP 40,B00,893304,Montejo; Carolina,14,0,20,6
1746582245437,MCWP 40R,A00,893757,Redela; Pamela Morgan,0,5,20,20
1746582246462,MCWP 50,A00,893758,Morshed; Michael James,0,0,20,20
1746582246462,MCWP 50,B00,893761,Bartulis; Jason Michael,17,0,20,3
1746582247487,MCWP 50R,A00,893766,Compas; Sean Matthew,0,1,20,20
1746582247487,MCWP 50R,B00,893769,Carter; Jennifer A,0,1,20,20
1746582247487,MCWP 50R,C00,893771,Krone; Jarret,0,3,20,20
1746582247487,MCWP 50R,D00,893772,Miller; Elizabeth Deen,0,0,20,20
1746582247487,MCWP 50R,E00,893775,Carter; Andrea L,0,1,20,20
1746582248513,MMW 11R,A01,892721,Herbst; Matthew,14,0,30,16
1746582248513,MMW 11R,A02,892722,Herbst; Matthew,0,0,0,3
1746582249540,MMW 12R,A01,892724,Herbst; Matthew,0,11,16,16
1746582249540,MMW 12R,A02,892725,Herbst; Matthew,0,10,16,16
1746582250567,MMW 13R,A01,892727,Staff,0,4,16,16
1746582250567,MMW 13R,A02,892728,Staff,0,4,16,16
1746582250567,MMW 13R,A03,958032,Staff,0,4,16,16
1746582250567,MMW 13R,A04,958033,Staff,0,4,16,16
1746582250567,MMW 13R,A05,958034,Staff,0,4,16,16
1746582251594,SIO 295LS,A00,894015,Staff,5,0,25,20
1746582252620,SIO 295S,A00,894020,Staff,5,0,25,20
1746582253648,SIOC 290S,B01,958918,Merrifield; Mark A,14,0,30,16
1746582254674,SIOC 291S,B01,958922,Gabriel; Corey John,14,0,30,16
1746582255699,SOCI 117,A01,895339,Staff,3,0,5,2
1746582256727,WES 237B,A00,894149,Staff,11,0,20,9
1746582258782,AESE 279B,A00,891859,Staff,13,0,35,22
1746582259808,AIP 197,001,891854,Vespa; Emanuel Ignacio,9999,0,9999,0
1746582260832,ANTH 289S,A00,891856,Gagneux; Pascal,12,0,12,0
1746582261857,BENG 196,001,957946,Engler; Adam J.,9996,0,9999,3
1746582262886,BISP 197,001,959851,Wilhelm; James E.,9998,0,9999,1
1746582263914,CAT 124RS,A01,956906,Staff,6,0,25,19
1746582264940,CAT 125RS,A01,922013,Staff,6,0,25,19
1746582265968,CLRE 250,A00,891860,Morris; Sheldon,9995,0,9999,4
1746582268019,CLRE 251R,A00,907817,Mehta; Ravindra L.,9994,0,9999,5
1746582269047,CLRE 252,A00,891864,Cuomo; Raphael Eduardo,9993,0,9999,6
1746582270072,CLRE 253,A00,891867,Vaida; Florin,9994,0,9999,5
1746582270072,CLRE 253,B00,907819,Staff,9999,0,9999,0
1746582271101,CLRE 259,A00,891868,Patel; Hemal,9998,0,9999,1
1746582272146,CLRE 260,A00,891872,Cuomo; Raphael Eduardo,9999,0,9999,0
1746582273173,CLRE 297,001,891888,Cuomo; Raphael Eduardo,9999,0,9999,0
1746582274198,CSE 191,A00,958773,Minnes Kemp; Mor Mia,9995,0,9999,4
1746582275222,CSE 197,001,959846,Minnes Kemp; Mor Mia,9990,0,9999,9
1746582276248,CSS 201S,A01,892054,Mignozzetti; Umberto,25,0,30,5
1746582277279,CSS 202S,A01,892056,Mignozzetti; Umberto,25,0,30,5
1746582278306,DSC 197,001,956898,Eldridge; Justin Matthew,9996,0,9999,3
1746582279336,DSC 297,001,958000,Mazumdar; Arya,9998,0,9999,1
1746582279336,DSC 297,002,959862,Wang; Yusu,9998,0,9999,1
1746582280363,EAP 100,A00,905686,Staff,9778,0,9999,221
1746582281389,ECE 45,A01,892618,Staff,0,0,65,65
1746582283451,ECE 111,A01,892719,Staff,6,0,65,59
1746582284478,ECE 197,001,957920,Mercier; Patrick Philip,9991,0,9999,8
1746582285504,ECON 178,A01,907814,Zhu; Ying,26,0,35,9
1746582286532,EDS 115,A00,895312,Staff,35,0,45,10
1746582287558,EDS 117,A01,895337,Staff,23,0,30,7
1746582288585,EDS 125,A00,895341,Jones; Gabrielle Anastasia,36,0,45,9
1746582289614,EDS 128A,A01,895459,Fargason; Sharon Gayle,44,0,45,1
1746582290640,EDS 128B,A01,895543,Pappas; Elizabeth,44,0,45,1
1746582291667,EDS 139,A00,897203,Pappas; Elizabeth,44,0,45,1
1746582291667,EDS 139,B00,897209,Fargason; Sharon Gayle,41,0,45,4
1746582292693,EDS 201,A00,895545,Staff,22,0,45,23
1746582293720,EDS 203,A01,895581,Halter; Christopher P.,22,0,45,23
1746582294748,EDS 204R,A01,895625,Heinzman; Erica M.,39,0,45,6
1746582294748,EDS 204R,B01,895693,Halter; Christopher P.,10,0,45,35
1746582295777,EDS 206R,A00,895694,Fargason; Sharon Gayle,1,0,30,29
1746582295777,EDS 206R,B00,895695,Choi; Bailey Miyeon,16,0,30,14
1746582296804,EDS 250,A00,895697,Hemans; Patricia Ann Benitez,22,0,45,23
1746582297834,EDS 281,A00,895701,Meyerott; Theresa Ann,1,0,15,14
1746582298864,EDS 284,A00,895736,Meyerott; Theresa Ann,1,0,15,14
1746582299887,EDS 286,A00,897210,Fine; Sarah,0,0,15,15
1746582300916,EDS 289C,A01,895770,Daly; Alan J.,1,0,15,14
1746582301946,EDS 290,A00,897211,Hofstetter; Carolyn,0,0,15,15
1746582302976,LIGM 5A,A00,896162,Fischer-Grunski; Eva K,12,0,20,8
1746582304001,LIGM 5B,A00,896260,Fischer-Grunski; Eva K,17,0,20,3
1746582305026,LIGM 5C,A00,896308,Fischer-Grunski; Eva K,18,0,20,2
1746582306054,LIIT 5AS,A00,896313,Carnelos; Chiara,18,0,20,2
1746582307080,LIIT 5BS,A00,896416,Carnelos; Chiara,20,0,20,0
1746582308110,LIIT 5CS,A00,896564,Carnelos; Chiara,20,0,20,0
1746582309137,LISP 5A,A00,896588,Munoz Sanchez; Alicia,2,0,20,18
1746582310162,LISP 5B,A00,896653,Munoz Sanchez; Alicia,7,0,20,13
1746582311188,LISP 5C,A00,896655,Munoz Sanchez; Alicia,0,1,20,20
1746582312216,MAE 197,001,957918,Kleissl; Jan,9996,0,9999,3
1746582312216,MAE 197,002,959806,Boechler; Nicholas Sebastia,9998,0,9999,1
1746582312216,MAE 197,003,959852,Mullin; Jennifer S,9998,0,9999,1
1746582313240,MATH 2,A01,957937,Staff,33,0,35,2
1746582314267,MATH 197,001,957876,Kedlaya; Kiran S.,9993,0,9999,6
1746582315293,MCWP 40,A00,892729,Duru; Nur,10,0,20,10
1746582315293,MCWP 40,B00,893304,Montejo; Carolina,14,0,20,6
1746582316321,MCWP 40R,A00,893757,Redela; Pamela Morgan,0,5,20,20
1746582317372,MCWP 50,A00,893758,Morshed; Michael James,0,0,20,20
1746582317372,MCWP 50,B00,893761,Bartulis; Jason Michael,17,0,20,3
1746582318401,MCWP 50R,A00,893766,Compas; Sean Matthew,0,1,20,20
1746582318401,MCWP 50R,B00,893769,Carter; Jennifer A,0,1,20,20
1746582318401,MCWP 50R,C00,893771,Krone; Jarret,0,3,20,20
1746582318401,MCWP 50R,D00,893772,Miller; Elizabeth Deen,0,0,20,20
1746582318401,MCWP 50R,E00,893775,Carter; Andrea L,0,1,20,20
1746582319427,MMW 11R,A01,892721,Herbst; Matthew,14,0,30,16
1746582319427,MMW 11R,A02,892722,Herbst; Matthew,0,0,0,3
1746582320455,MMW 12R,A01,892724,Herbst; Matthew,0,11,16,16
1746582320455,MMW 12R,A02,892725,Herbst; Matthew,0,10,16,16
1746582321484,MMW 13R,A01,892727,Staff,0,4,16,16
1746582321484,MMW 13R,A02,892728,Staff,0,4,16,16
1746582321484,MMW 13R,A03,958032,Staff,0,4,16,16
1746582321484,MMW 13R,A04,958033,Staff,0,4,16,16
1746582321484,MMW 13R,A05,958034,Staff,0,4,16,16
1746582322507,SIO 295LS,A00,894015,Staff,5,0,25,20
1746582323538,SIO 295S,A00,894020,Staff,5,0,25,20
1746582324563,SIOC 290S,B01,958918,Merrifield; Mark A,14,0,30,16
1746582325589,SIOC 291S,B01,958922,Gabriel; Corey John,14,0,30,16
1746582326617,SOCI 117,A01,895339,Staff,3,0,5,2
1746582327641,WES 237B,A00,894149,Staff,11,0,20,9
1746582329698,AESE 279B,A00,891859,Staff,13,0,35,22
1746582330726,AIP 197,001,891854,Vespa; Emanuel Ignacio,9999,0,9999,0
1746582331787,ANTH 289S,A00,891856,Gagneux; Pascal,12,0,12,0
1746582332812,BENG 196,001,957946,Engler; Adam J.,9996,0,9999,3
1746582333836,BISP 197,001,959851,Wilhelm; James E.,9998,0,9999,1
1746582334863,CAT 124RS,A01,956906,Staff,6,0,25,19
1746582335890,CAT 125RS,A01,922013,Staff,6,0,25,19
1746582336915,CLRE 250,A00,891860,Morris; Sheldon,9995,0,9999,4
1746582338968,CLRE 251R,A00,907817,Mehta; Ravindra L.,9994,0,9999,5
1746582339994,CLRE 252,A00,891864,Cuomo; Raphael Eduardo,9993,0,9999,6
1746582341040,CLRE 253,A00,891867,Vaida; Florin,9994,0,9999,5
1746582341040,CLRE 253,B00,907819,Staff,9999,0,9999,0
1746582342065,CLRE 259,A00,891868,Patel; Hemal,9998,0,9999,1
1746582343090,CLRE 260,A00,891872,Cuomo; Raphael Eduardo,9999,0,9999,0
1746582344114,CLRE 297,001,891888,Cuomo; Raphael Eduardo,9999,0,9999,0
1746582345140,CSE 191,A00,958773,Minnes Kemp; Mor Mia,9995,0,9999,4
1746582346163,CSE 197,001,959846,Minnes Kemp; Mor Mia,9990,0,9999,9
1746582347191,CSS 201S,A01,892054,Mignozzetti; Umberto,25,0,30,5
1746582348218,CSS 202S,A01,892056,Mignozzetti; Umberto,25,0,30,5
1746582349243,DSC 197,001,956898,Eldridge; Justin Matthew,9996,0,9999,3
1746582350267,DSC 297,001,958000,Mazumdar; Arya,9998,0,9999,1
1746582350267,DSC 297,002,959862,Wang; Yusu,9998,0,9999,1
1746582351294,EAP 100,A00,905686,Staff,9778,0,9999,221
1746582352319,ECE 45,A01,892618,Staff,0,0,65,65
1746582354369,ECE 111,A01,892719,Staff,6,0,65,59
1746582355393,ECE 197,001,957920,Mercier; Patrick Philip,9991,0,9999,8
1746582356422,ECON 178,A01,907814,Zhu; Ying,26,0,35,9
1746582357448,EDS 115,A00,895312,Staff,35,0,45,10
1746582358473,EDS 117,A01,895337,Staff,23,0,30,7
1746582359498,EDS 125,A00,895341,Jones; Gabrielle Anastasia,36,0,45,9
1746582360527,EDS 128A,A01,895459,Fargason; Sharon Gayle,44,0,45,1
1746582361552,EDS 128B,A01,895543,Pappas; Elizabeth,44,0,45,1
1746582362576,EDS 139,A00,897203,Pappas; Elizabeth,44,0,45,1
1746582362576,EDS 139,B00,897209,Fargason; Sharon Gayle,41,0,45,4
1746582363603,EDS 201,A00,895545,Staff,22,0,45,23
1746582364629,EDS 203,A01,895581,Halter; Christopher P.,22,0,45,23
1746582365654,EDS 204R,A01,895625,Heinzman; Erica M.,39,0,45,6
1746582365654,EDS 204R,B01,895693,Halter; Christopher P.,10,0,45,35
1746582366682,EDS 206R,A00,895694,Fargason; Sharon Gayle,1,0,30,29
1746582366682,EDS 206R,B00,895695,Choi; Bailey Miyeon,16,0,30,14
1746582367706,EDS 250,A00,895697,Hemans; Patricia Ann Benitez,22,0,45,23
1746582368731,EDS 281,A00,895701,Meyerott; Theresa Ann,1,0,15,14
1746582369758,EDS 284,A00,895736,Meyerott; Theresa Ann,1,0,15,14
1746582370783,EDS 286,A00,897210,Fine; Sarah,0,0,15,15
1746582371808,EDS 289C,A01,895770,Daly; Alan J.,1,0,15,14
1746582372833,EDS 290,A00,897211,Hofstetter; Carolyn,0,0,15,15
1746582373860,LIGM 5A,A00,896162,Fischer-Grunski; Eva K,12,0,20,8
1746582374884,LIGM 5B,A00,896260,Fischer-Grunski; Eva K,17,0,20,3
1746582375910,LIGM 5C,A00,896308,Fischer-Grunski; Eva K,18,0,20,2
1746582376939,LIIT 5AS,A00,896313,Carnelos; Chiara,18,0,20,2
1746582377968,LIIT 5BS,A00,896416,Carnelos; Chiara,20,0,20,0
1746582378992,LIIT 5CS,A00,896564,Carnelos; Chiara,20,0,20,0
1746582380016,LISP 5A,A00,896588,Munoz Sanchez; Alicia,2,0,20,18
1746582381042,LISP 5B,A00,896653,Munoz Sanchez; Alicia,7,0,20,13
1746582382069,LISP 5C,A00,896655,Munoz Sanchez; Alicia,0,1,20,20
1746582383097,MAE 197,001,957918,Kleissl; Jan,9996,0,9999,3
1746582383097,MAE 197,002,959806,Boechler; Nicholas Sebastia,9998,0,9999,1
1746582383097,MAE 197,003,959852,Mullin; Jennifer S,9998,0,9999,1
1746582384127,MATH 2,A01,957937,Staff,33,0,35,2
1746582385151,MATH 197,001,957876,Kedlaya; Kiran S.,9993,0,9999,6
1746582386177,MCWP 40,A00,892729,Duru; Nur,10,0,20,10
1746582386177,MCWP 40,B00,893304,Montejo; Carolina,14,0,20,6
1746582387202,MCWP 40R,A00,893757,Redela; Pamela Morgan,0,5,20,20
1746582388227,MCWP 50,A00,893758,Morshed; Michael James,0,0,20,20
1746582388227,MCWP 50,B00,893761,Bartulis; Jason Michael,17,0,20,3
1746582389252,MCWP 50R,A00,893766,Compas; Sean Matthew,0,1,20,20
1746582389252,MCWP 50R,B00,893769,Carter; Jennifer A,0,1,20,20
1746582389252,MCWP 50R,C00,893771,Krone; Jarret,0,3,20,20
1746582389252,MCWP 50R,D00,893772,Miller; Elizabeth Deen,0,0,20,20
1746582389252,MCWP 50R,E00,893775,Carter; Andrea L,0,1,20,20
1746582390278,MMW 11R,A01,892721,Herbst; Matthew,14,0,30,16
1746582390278,MMW 11R,A02,892722,Herbst; Matthew,0,0,0,3
1746582391346,MMW 12R,A01,892724,Herbst; Matthew,0,11,16,16
1746582391346,MMW 12R,A02,892725,Herbst; Matthew,0,10,16,16
1746582392375,MMW 13R,A01,892727,Staff,0,4,16,16
1746582392375,MMW 13R,A02,892728,Staff,0,4,16,16
1746582392375,MMW 13R,A03,958032,Staff,0,4,16,16
1746582392375,MMW 13R,A04,958033,Staff,0,4,16,16
1746582392375,MMW 13R,A05,958034,Staff,0,4,16,16
1746582393401,SIO 295LS,A00,894015,Staff,5,0,25,20
1746582394426,SIO 295S,A00,894020,Staff,5,0,25,20
1746582395453,SIOC 290S,B01,958918,Merrifield; Mark A,14,0,30,16
1746582396479,SIOC 291S,B01,958922,Gabriel; Corey John,14,0,30,16
1746582397508,SOCI 117,A01,895339,Staff,3,0,5,2
1746582398536,WES 237B,A00,894149,Staff,11,0,20,9
1746582400600,AESE 279B,A00,891859,Staff,13,0,35,22
1746582401625,AIP 197,001,891854,Vespa; Emanuel Ignacio,9999,0,9999,0
1746582402653,ANTH 289S,A00,891856,Gagneux; Pascal,12,0,12,0
1746582403683,BENG 196,001,957946,Engler; Adam J.,9996,0,9999,3
1746582404707,BISP 197,001,959851,Wilhelm; James E.,9998,0,9999,1
1746582405734,CAT 124RS,A01,956906,Staff,6,0,25,19
1746582406761,CAT 125RS,A01,922013,Staff,6,0,25,19
1746582407791,CLRE 250,A00,891860,Morris; Sheldon,9995,0,9999,4
1746582409843,CLRE 251R,A00,907817,Mehta; Ravindra L.,9994,0,9999,5
1746582410872,CLRE 252,A00,891864,Cuomo; Raphael Eduardo,9993,0,9999,6
1746582411899,CLRE 253,A00,891867,Vaida; Florin,9994,0,9999,5
1746582411899,CLRE 253,B00,907819,Staff,9999,0,9999,0
1746582412924,CLRE 259,A00,891868,Patel; Hemal,9998,0,9999,1
1746582413952,CLRE 260,A00,891872,Cuomo; Raphael Eduardo,9999,0,9999,0
1746582414979,CLRE 297,001,891888,Cuomo; Raphael Eduardo,9999,0,9999,0
1746582416003,CSE 191,A00,958773,Minnes Kemp; Mor Mia,9995,0,9999,4
1746582417031,CSE 197,001,959846,Minnes Kemp; Mor Mia,9990,0,9999,9
1746582418059,CSS 201S,A01,892054,Mignozzetti; Umberto,25,0,30,5
1746582419088,CSS 202S,A01,892056,Mignozzetti; Umberto,25,0,30,5
1746582420115,DSC 197,001,956898,Eldridge; Justin Matthew,9996,0,9999,3
1746582421141,DSC 297,001,958000,Mazumdar; Arya,9998,0,9999,1
1746582421141,DSC 297,002,959862,Wang; Yusu,9998,0,9999,1
1746582422166,EAP 100,A00,905686,Staff,9778,0,9999,221
1746582423194,ECE 45,A01,892618,Staff,0,0,65,65
1746582425250,ECE 111,A01,892719,Staff,6,0,65,59
1746582426275,ECE 197,001,957920,Mercier; Patrick Philip,9991,0,9999,8
1746582427303,ECON 178,A01,907814,Zhu; Ying,26,0,35,9
1746582428328,EDS 115,A00,895312,Staff,35,0,45,10
1746582429354,EDS 117,A01,895337,Staff,23,0,30,7
1746582430378,EDS 125,A00,895341,Jones; Gabrielle Anastasia,36,0,45,9
1746582431404,EDS 128A,A01,895459,Fargason; Sharon Gayle,44,0,45,1
1746582432428,EDS 128B,A01,895543,Pappas; Elizabeth,44,0,45,1
1746582433456,EDS 139,A00,897203,Pappas; Elizabeth,44,0,45,1
1746582433456,EDS 139,B00,897209,Fargason; Sharon Gayle,41,0,45,4
1746582434484,EDS 201,A00,895545,Staff,22,0,45,23
1746582435508,EDS 203,A01,895581,Halter; Christopher P.,22,0,45,23
1746582436536,EDS 204R,A01,895625,Heinzman; Erica M.,39,0,45,6
1746582436536,EDS 204R,B01,895693,Halter; Christopher P.,10,0,45,35
1746582437561,EDS 206R,A00,895694,Fargason; Sharon Gayle,1,0,30,29
1746582437561,EDS 206R,B00,895695,Choi; Bailey Miyeon,16,0,30,14
1746582438589,EDS 250,A00,895697,Hemans; Patricia Ann Benitez,22,0,45,23
1746582439615,EDS 281,A00,895701,Meyerott; Theresa Ann,1,0,15,14
1746582440640,EDS 284,A00,895736,Meyerott; Theresa Ann,1,0,15,14
1746582441666,EDS 286,A00,897210,Fine; Sarah,0,0,15,15
1746582442694,EDS 289C,A01,895770,Daly; Alan J.,1,0,15,14
1746582443721,EDS 290,A00,897211,Hofstetter; Carolyn,0,0,15,15
1746582444746,LIGM 5A,A00,896162,Fischer-Grunski; Eva K,12,0,20,8
1746582445772,LIGM 5B,A00,896260,Fischer-Grunski; Eva K,17,0,20,3
1746582446798,LIGM 5C,A00,896308,Fischer-Grunski; Eva K,18,0,20,2
1746582447824,LIIT 5AS,A00,896313,Carnelos; Chiara,18,0,20,2
1746582448849,LIIT 5BS,A00,896416,Carnelos; Chiara,20,0,20,0
1746582449874,LIIT 5CS,A00,896564,Carnelos; Chiara,20,0,20,0
1746582450899,LISP 5A,A00,896588,Munoz Sanchez; Alicia,2,0,20,18
1746582451929,LISP 5B,A00,896653,Munoz Sanchez; Alicia,7,0,20,13
1746582452958,LISP 5C,A00,896655,Munoz Sanchez; Alicia,0,1,20,20
1746582453982,MAE 197,001,957918,Kleissl; Jan,9996,0,9999,3
1746582453982,MAE 197,002,959806,Boechler; Nicholas Sebastia,9998,0,9999,1
1746582453982,MAE 197,003,959852,Mullin; Jennifer S,9998,0,9999,1
1746582455007,MATH 2,A01,957937,Staff,33,0,35,2
1746582456030,MATH 197,001,957876,Kedlaya; Kiran S.,9993,0,9999,6
1746582457060,MCWP 40,A00,892729,Duru; Nur,10,0,20,10
1746582457060,MCWP 40,B00,893304,Montejo; Carolina,14,0,20,6
1746582458084,MCWP 40R,A00,893757,Redela; Pamela Morgan,0,5,20,20
1746582459109,MCWP 50,A00,893758,Morshed; Michael James,0,0,20,20
1746582459109,MCWP 50,B00,893761,Bartulis; Jason Michael,17,0,20,3
1746582460138,MCWP 50R,A00,893766,Compas; Sean Matthew,0,1,20,20
1746582460138,MCWP 50R,B00,893769,Carter; Jennifer A,0,1,20,20
1746582460138,MCWP 50R,C00,893771,Krone; Jarret,0,3,20,20
1746582460138,MCWP 50R,D00,893772,Miller; Elizabeth Deen,0,0,20,20
1746582460138,MCWP 50R,E00,893775,Carter; Andrea L,0,1,20,20
1746582461163,MMW 11R,A01,892721,Herbst; Matthew,14,0,30,16
1746582461163,MMW 11R,A02,892722,Herbst; Matthew,0,0,0,3
1746582462189,MMW 12R,A01,892724,Herbst; Matthew,0,11,16,16
1746582462189,MMW 12R,A02,892725,Herbst; Matthew,0,10,16,16
1746582463220,MMW 13R,A01,892727,Staff,0,4,16,16
1746582463220,MMW 13R,A02,892728,Staff,0,4,16,16
1746582463220,MMW 13R,A03,958032,Staff,0,4,16,16
1746582463220,MMW 13R,A04,958033,Staff,0,4,16,16
1746582463220,MMW 13R,A05,958034,Staff,0,4,16,16
1746582464246,SIO 295LS,A00,894015,Staff,5,0,25,20
1746582465273,SIO 295S,A00,894020,Staff,5,0,25,20
1746582466298,SIOC 290S,B01,958918,Merrifield; Mark A,14,0,30,16
1746582467323,SIOC 291S,B01,958922,Gabriel; Corey John,14,0,30,16
1746582468349,SOCI 117,A01,895339,Staff,3,0,5,2
1746582469374,WES 237B,A00,894149,Staff,11,0,20,9
1746582471443,AESE 279B,A00,891859,Staff,13,0,35,22
1746582472472,AIP 197,001,891854,Vespa; Emanuel Ignacio,9999,0,9999,0
1746582473496,ANTH 289S,A00,891856,Gagneux; Pascal,12,0,12,0
1746582474520,BENG 196,001,957946,Engler; Adam J.,9996,0,9999,3
1746582475545,BISP 197,001,959851,Wilhelm; James E.,9998,0,9999,1
1746582476573,CAT 124RS,A01,956906,Staff,6,0,25,19
1746582477599,CAT 125RS,A01,922013,Staff,6,0,25,19
1746582478628,CLRE 250,A00,891860,Morris; Sheldon,9995,0,9999,4
1746582480682,CLRE 251R,A00,907817,Mehta; Ravindra L.,9994,0,9999,5
1746582481707,CLRE 252,A00,891864,Cuomo; Raphael Eduardo,9993,0,9999,6
1746582482735,CLRE 253,A00,891867,Vaida; Florin,9994,0,9999,5
1746582482735,CLRE 253,B00,907819,Staff,9999,0,9999,0
1746582483762,CLRE 259,A00,891868,Patel; Hemal,9998,0,9999,1
1746582484788,CLRE 260,A00,891872,Cuomo; Raphael Eduardo,9999,0,9999,0
1746582485816,CLRE 297,001,891888,Cuomo; Raphael Eduardo,9999,0,9999,0
1746582486847,CSE 191,A00,958773,Minnes Kemp; Mor Mia,9995,0,9999,4
1746582487871,CSE 197,001,959846,Minnes Kemp; Mor Mia,9990,0,9999,9
1746582488900,CSS 201S,A01,892054,Mignozzetti; Umberto,25,0,30,5
1746582489926,CSS 202S,A01,892056,Mignozzetti; Umberto,25,0,30,5
1746582490954,DSC 197,001,956898,Eldridge; Justin Matthew,9996,0,9999,3
1746582491979,DSC 297,001,958000,Mazumdar; Arya,9998,0,9999,1
1746582491979,DSC 297,002,959862,Wang; Yusu,9998,0,9999,1
1746582493002,EAP 100,A00,905686,Staff,9778,0,9999,221
1746582494032,ECE 45,A01,892618,Staff,0,0,65,65
1746582496142,ECE 111,A01,892719,Staff,6,0,65,59
1746582497172,ECE 197,001,957920,Mercier; Patrick Philip,9991,0,9999,8
1746582498198,ECON 178,A01,907814,Zhu; Ying,26,0,35,9
1746582499225,EDS 115,A00,895312,Staff,35,0,45,10
1746582500249,EDS 117,A01,895337,Staff,23,0,30,7
1746582501274,EDS 125,A00,895341,Jones; Gabrielle Anastasia,36,0,45,9
1746582502298,EDS 128A,A01,895459,Fargason; Sharon Gayle,44,0,45,1
1746582503324,EDS 128B,A01,895543,Pappas; Elizabeth,44,0,45,1
1746582504351,EDS 139,A00,897203,Pappas; Elizabeth,44,0,45,1
1746582504351,EDS 139,B00,897209,Fargason; Sharon Gayle,41,0,45,4
1746582505380,EDS 201,A00,895545,Staff,22,0,45,23
1746582506404,EDS 203,A01,895581,Halter; Christopher P.,22,0,45,23
1746582507438,EDS 204R,A01,895625,Heinzman; Erica M.,39,0,45,6
1746582507438,EDS 204R,B01,895693,Halter; Christopher P.,10,0,45,35
1746582508464,EDS 206R,A00,895694,Fargason; Sharon Gayle,1,0,30,29
1746582508464,EDS 206R,B00,895695,Choi; Bailey Miyeon,16,0,30,14
1746582509494,EDS 250,A00,895697,Hemans; Patricia Ann Benitez,22,0,45,23
1746582510518,EDS 281,A00,895701,Meyerott; Theresa Ann,1,0,15,14
1746582511547,EDS 284,A00,895736,Meyerott; Theresa Ann,1,0,15,14
1746582512573,EDS 286,A00,897210,Fine; Sarah,0,0,15,15
1746582513598,EDS 289C,A01,895770,Daly; Alan J.,1,0,15,14
1746582514625,EDS 290,A00,897211,Hofstetter; Carolyn,0,0,15,15
1746582515653,LIGM 5A,A00,896162,Fischer-Grunski; Eva K,12,0,20,8
1746582516683,LIGM 5B,A00,896260,Fischer-Grunski; Eva K,17,0,20,3
1746582517709,LIGM 5C,A00,896308,Fischer-Grunski; Eva K,18,0,20,2
1746582518737,LIIT 5AS,A00,896313,Carnelos; Chiara,18,0,20,2
1746582519762,LIIT 5BS,A00,896416,Carnelos; Chiara,20,0,20,0
1746582520786,LIIT 5CS,A00,896564,Carnelos; Chiara,20,0,20,0
1746582521816,LISP 5A,A00,896588,Munoz Sanchez; Alicia,2,0,20,18
1746582522842,LISP 5B,A00,896653,Munoz Sanchez; Alicia,7,0,20,13
1746582523868,LISP 5C,A00,896655,Munoz Sanchez; Alicia,0,1,20,20
1746582524896,MAE 197,001,957918,Kleissl; Jan,9996,0,9999,3
1746582524896,MAE 197,002,959806,Boechler; Nicholas Sebastia,9998,0,9999,1
1746582524896,MAE 197,003,959852,Mullin; Jennifer S,9998,0,9999,1
1746582525922,MATH 2,A01,957937,Staff,33,0,35,2
1746582526948,MATH 197,001,957876,Kedlaya; Kiran S.,9993,0,9999,6
1746582527972,MCWP 40,A00,892729,Duru; Nur,10,0,20,10
1746582527972,MCWP 40,B00,893304,Montejo; Carolina,14,0,20,6
1746582529000,MCWP 40R,A00,893757,Redela; Pamela Morgan,0,5,20,20
1746582530026,MCWP 50,A00,893758,Morshed; Michael James,0,0,20,20
1746582530026,MCWP 50,B00,893761,Bartulis; Jason Michael,17,0,20,3
1746582531053,MCWP 50R,A00,893766,Compas; Sean Matthew,0,1,20,20
1746582531053,MCWP 50R,B00,893769,Carter; Jennifer A,0,1,20,20
1746582531053,MCWP 50R,C00,893771,Krone; Jarret,0,3,20,20
1746582531053,MCWP 50R,D00,893772,Miller; Elizabeth Deen,0,0,20,20
1746582531053,MCWP 50R,E00,893775,Carter; Andrea L,0,1,20,20
1746582532083,MMW 11R,A01,892721,Herbst; Matthew,14,0,30,16
1746582532083,MMW 11R,A02,892722,Herbst; Matthew,0,0,0,3
1746582533110,MMW 12R,A01,892724,Herbst; Matthew,0,11,16,16
1746582533110,MMW 12R,A02,892725,Herbst; Matthew,0,10,16,16
1746582534135,MMW 13R,A01,892727,Staff,0,4,16,16
1746582534135,MMW 13R,A02,892728,Staff,0,4,16,16
1746582534135,MMW 13R,A03,958032,Staff,0,4,16,16
1746582534135,MMW 13R,A04,958033,Staff,0,4,16,16
1746582534135,MMW 13R,A05,958034,Staff,0,4,16,16
1746582535161,SIO 295LS,A00,894015,Staff,5,0,25,20
1746582536189,SIO 295S,A00,894020,Staff,5,0,25,20
1746582537218,SIOC 290S,B01,958918,Merrifield; Mark A,14,0,30,16
1746582538244,SIOC 291S,B01,958922,Gabriel; Corey John,14,0,30,16
1746582539270,SOCI 117,A01,895339,Staff,3,0,5,2
1746582540295,WES 237B,A00,894149,Staff,11,0,20,9
1746582542355,AESE 279B,A00,891859,Staff,13,0,35,22
1746582543382,AIP 197,001,891854,Vespa; Emanuel Ignacio,9999,0,9999,0
1746582544407,ANTH 289S,A00,891856,Gagneux; Pascal,12,0,12,0
1746582545436,BENG 196,001,957946,Engler; Adam J.,9996,0,9999,3
1746582546463,BISP 197,001,959851,Wilhelm; James E.,9998,0,9999,1
1746582547489,CAT 124RS,A01,956906,Staff,6,0,25,19
1746582548518,CAT 125RS,A01,922013,Staff,6,0,25,19
1746582549542,CLRE 250,A00,891860,Morris; Sheldon,9995,0,9999,4
1746582551592,CLRE 251R,A00,907817,Mehta; Ravindra L.,9994,0,9999,5
1746582552617,CLRE 252,A00,891864,Cuomo; Raphael Eduardo,9993,0,9999,6
1746582553642,CLRE 253,A00,891867,Vaida; Florin,9994,0,9999,5
1746582553642,CLRE 253,B00,907819,Staff,9999,0,9999,0
1746582554666,CLRE 259,A00,891868,Patel; Hemal,9998,0,9999,1
1746582555691,CLRE 260,A00,891872,Cuomo; Raphael Eduardo,9999,0,9999,0
1746582556716,CLRE 297,001,891888,Cuomo; Raphael Eduardo,9999,0,9999,0
1746582557744,CSE 191,A00,958773,Minnes Kemp; Mor Mia,9995,0,9999,4
1746582558769,CSE 197,001,959846,Minnes Kemp; Mor Mia,9990,0,9999,9
1746582559800,CSS 201S,A01,892054,Mignozzetti; Umberto,25,0,30,5
1746582560830,CSS 202S,A01,892056,Mignozzetti; Umberto,25,0,30,5
1746582561853,DSC 197,001,956898,Eldridge; Justin Matthew,9996,0,9999,3
1746582562878,DSC 297,001,958000,Mazumdar; Arya,9998,0,9999,1
1746582562878,DSC 297,002,959862,Wang; Yusu,9998,0,9999,1
1746582563904,EAP 100,A00,905686,Staff,9778,0,9999,221
1746582564930,ECE 45,A01,892618,Staff,0,0,65,65
1746582566980,ECE 111,A01,892719,Staff,6,0,65,59
1746582568004,ECE 197,001,957920,Mercier; Patrick Philip,9991,0,9999,8
1746582569029,ECON 178,A01,907814,Zhu; Ying,26,0,35,9
1746582570052,EDS 115,A00,895312,Staff,35,0,45,10
1746582571077,EDS 117,A01,895337,Staff,23,0,30,7
1746582572103,EDS 125,A00,895341,Jones; Gabrielle Anastasia,36,0,45,9
1746582573127,EDS 128A,A01,895459,Fargason; Sharon Gayle,44,0,45,1
1746582574156,EDS 128B,A01,895543,Pappas; Elizabeth,44,0,45,1
1746582575181,EDS 139,A00,897203,Pappas; Elizabeth,44,0,45,1
1746582575181,EDS 139,B00,897209,Fargason; Sharon Gayle,41,0,45,4
1746582576209,EDS 201,A00,895545,Staff,22,0,45,23
1746582577234,EDS 203,A01,895581,Halter; Christopher P.,22,0,45,23
1746582578262,EDS 204R,A01,895625,Heinzman; Erica M.,39,0,45,6
1746582578262,EDS 204R,B01,895693,Halter; Christopher P.,10,0,45,35
1746582579286,EDS 206R,A00,895694,Fargason; Sharon Gayle,1,0,30,29
1746582579286,EDS 206R,B00,895695,Choi; Bailey Miyeon,16,0,30,14
1746582580351,EDS 250,A00,895697,Hemans; Patricia Ann Benitez,22,0,45,23
1746582581376,EDS 281,A00,895701,Meyerott; Theresa Ann,1,0,15,14
1746582582404,EDS 284,A00,895736,Meyerott; Theresa Ann,1,0,15,14
1746582583430,EDS 286,A00,897210,Fine; Sarah,0,0,15,15
1746582584456,EDS 289C,A01,895770,Daly; Alan J.,1,0,15,14
1746582585483,EDS 290,A00,897211,Hofstetter; Carolyn,0,0,15,15
1746582586513,LIGM 5A,A00,896162,Fischer-Grunski; Eva K,12,0,20,8
1746582587539,LIGM 5B,A00,896260,Fischer-Grunski; Eva K,17,0,20,3
1746582588566,LIGM 5C,A00,896308,Fischer-Grunski; Eva K,18,0,20,2
1746582589594,LIIT 5AS,A00,896313,Carnelos; Chiara,18,0,20,2
1746582590618,LIIT 5BS,A00,896416,Carnelos; Chiara,20,0,20,0
1746582591642,LIIT 5CS,A00,896564,Carnelos; Chiara,20,0,20,0
1746582592670,LISP 5A,A00,896588,Munoz Sanchez; Alicia,2,0,20,18
1746582593713,LISP 5B,A00,896653,Munoz Sanchez; Alicia,7,0,20,13
1746582594743,LISP 5C,A00,896655,Munoz Sanchez; Alicia,0,1,20,20
1746582595769,MAE 197,001,957918,Kleissl; Jan,9996,0,9999,3
1746582595769,MAE 197,002,959806,Boechler; Nicholas Sebastia,9998,0,9999,1
1746582595769,MAE 197,003,959852,Mullin; Jennifer S,9998,0,9999,1
1746582596796,MATH 2,A01,957937,Staff,33,0,35,2
1746582597821,MATH 197,001,957876,Kedlaya; Kiran S.,9993,0,9999,6
1746582598850,MCWP 40,A00,892729,Duru; Nur,10,0,20,10
1746582598850,MCWP 40,B00,893304,Montejo; Carolina,14,0,20,6
1746582599880,MCWP 40R,A00,893757,Redela; Pamela Morgan,0,5,20,20
1746582600907,MCWP 50,A00,893758,Morshed; Michael James,0,0,20,20
1746582600907,MCWP 50,B00,893761,Bartulis; Jason Michael,17,0,20,3
1746582601932,MCWP 50R,A00,893766,Compas; Sean Matthew,0,1,20,20
1746582601932,MCWP 50R,B00,893769,Carter; Jennifer A,0,1,20,20
1746582601932,MCWP 50R,C00,893771,Krone; Jarret,0,3,20,20
1746582601932,MCWP 50R,D00,893772,Miller; Elizabeth Deen,0,0,20,20
1746582601932,MCWP 50R,E00,893775,Carter; Andrea L,0,1,20,20
1746582602958,MMW 11R,A01,892721,Herbst; Matthew,14,0,30,16
1746582602958,MMW 11R,A02,892722,Herbst; Matthew,0,0,0,3
1746582603984,MMW 12R,A01,892724,Herbst; Matthew,0,11,16,16
1746582603984,MMW 12R,A02,892725,Herbst; Matthew,0,10,16,16
1746582605012,MMW 13R,A01,892727,Staff,0,4,16,16
1746582605012,MMW 13R,A02,892728,Staff,0,4,16,16
1746582605012,MMW 13R,A03,958032,Staff,0,4,16,16
1746582605012,MMW 13R,A04,958033,Staff,0,4,16,16
1746582605012,MMW 13R,A05,958034,Staff,0,4,16,16
1746582606036,SIO 295LS,A00,894015,Staff,5,0,25,20
1746582607061,SIO 295S,A00,894020,Staff,5,0,25,20
1746582608089,SIOC 290S,B01,958918,Merrifield; Mark A,14,0,30,16
1746582609114,SIOC 291S,B01,958922,Gabriel; Corey John,14,0,30,16
1746582610142,SOCI 117,A01,895339,Staff,3,0,5,2
1746582611167,WES 237B,A00,894149,Staff,11,0,20,9
1746582613235,AESE 279B,A00,891859,Staff,13,0,35,22
1746582614263,AIP 197,001,891854,Vespa; Emanuel Ignacio,9999,0,9999,0
1746582615292,ANTH 289S,A00,891856,Gagneux; Pascal,12,0,12,0
1746582616316,BENG 196,001,957946,Engler; Adam J.,9996,0,9999,3
1746582617340,BISP 197,001,959851,Wilhelm; James E.,9998,0,9999,1
1746582618368,CAT 124RS,A01,956906,Staff,6,0,25,19
1746582619391,CAT 125RS,A01,922013,Staff,6,0,25,19
1746582620416,CLRE 250,A00,891860,Morris; Sheldon,9995,0,9999,4
1746582622465,CLRE 251R,A00,907817,Mehta; Ravindra L.,9994,0,9999,5
1746582623490,CLRE 252,A00,891864,Cuomo; Raphael Eduardo,9993,0,9999,6
1746582624517,CLRE 253,A00,891867,Vaida; Florin,9994,0,9999,5
1746582624517,CLRE 253,B00,907819,Staff,9999,0,9999,0
1746582625541,CLRE 259,A00,891868,Patel; Hemal,9998,0,9999,1
1746582626564,CLRE 260,A00,891872,Cuomo; Raphael Eduardo,9999,0,9999,0
1746582627591,CLRE 297,001,891888,Cuomo; Raphael Eduardo,9999,0,9999,0
1746582628617,CSE 191,A00,958773,Minnes Kemp; Mor Mia,9995,0,9999,4
1746582629643,CSE 197,001,959846,Minnes Kemp; Mor Mia,9990,0,9999,9
1746582630671,CSS 201S,A01,892054,Mignozzetti; Umberto,25,0,30,5
1746582631697,CSS 202S,A01,892056,Mignozzetti; Umberto,25,0,30,5
1746582632729,DSC 197,001,956898,Eldridge; Justin Matthew,9996,0,9999,3
1746582633756,DSC 297,001,958000,Mazumdar; Arya,9998,0,9999,1
1746582633756,DSC 297,002,959862,Wang; Yusu,9998,0,9999,1
1746582634782,EAP 100,A00,905686,Staff,9778,0,9999,221
1746582635808,ECE 45,A01,892618,Staff,0,0,65,65
1746582637858,ECE 111,A01,892719,Staff,6,0,65,59
1746582638883,ECE 197,001,957920,Mercier; Patrick Philip,9991,0,9999,8
1746582639907,ECON 178,A01,907814,Zhu; Ying,26,0,35,9
1746582640935,EDS 115,A00,895312,Staff,35,0,45,10
1746582641962,EDS 117,A01,895337,Staff,23,0,30,7
1746582642989,EDS 125,A00,895341,Jones; Gabrielle Anastasia,36,0,45,9
1746582644016,EDS 128A,A01,895459,Fargason; Sharon Gayle,44,0,45,1
1746582645041,EDS 128B,A01,895543,Pappas; Elizabeth,44,0,45,1
1746582646068,EDS 139,A00,897203,Pappas; Elizabeth,44,0,45,1
1746582646068,EDS 139,B00,897209,Fargason; Sharon Gayle,41,0,45,4
1746582647092,EDS 201,A00,895545,Staff,22,0,45,23
1746582648117,EDS 203,A01,895581,Halter; Christopher P.,22,0,45,23
1746582649163,EDS 204R,A01,895625,Heinzman; Erica M.,39,0,45,6
1746582649163,EDS 204R,B01,895693,Halter; Christopher P.,10,0,45,35
1746582650189,EDS 206R,A00,895694,Fargason; Sharon Gayle,1,0,30,29
1746582650189,EDS 206R,B00,895695,Choi; Bailey Miyeon,16,0,30,14
1746582651214,EDS 250,A00,895697,Hemans; Patricia Ann Benitez,22,0,45,23
1746582652237,EDS 281,A00,895701,Meyerott; Theresa Ann,1,0,15,14
1746582653261,EDS 284,A00,895736,Meyerott; Theresa Ann,1,0,15,14
1746582654288,EDS 286,A00,897210,Fine; Sarah,0,0,15,15
1746582655313,EDS 289C,A01,895770,Daly; Alan J.,1,0,15,14
1746582656338,EDS 290,A00,897211,Hofstetter; Carolyn,0,0,15,15
1746582657362,LIGM 5A,A00,896162,Fischer-Grunski; Eva K,12,0,20,8
1746582658386,LIGM 5B,A00,896260,Fischer-Grunski; Eva K,17,0,20,3
1746582659411,LIGM 5C,A00,896308,Fischer-Grunski; Eva K,18,0,20,2
1746582660436,LIIT 5AS,A00,896313,Carnelos; Chiara,18,0,20,2
1746582661462,LIIT 5BS,A00,896416,Carnelos; Chiara,20,0,20,0
1746582662488,LIIT 5CS,A00,896564,Carnelos; Chiara,20,0,20,0
1746582663512,LISP 5A,A00,896588,Munoz Sanchez; Alicia,2,0,20,18
1746582664537,LISP 5B,A00,896653,Munoz Sanchez; Alicia,7,0,20,13
1746582665564,LISP 5C,A00,896655,Munoz Sanchez; Alicia,0,1,20,20
1746582666590,MAE 197,001,957918,Kleissl; Jan,9996,0,9999,3
1746582666590,MAE 197,002,959806,Boechler; Nicholas Sebastia,9998,0,9999,1
1746582666590,MAE 197,003,959852,Mullin; Jennifer S,9998,0,9999,1
1746582667615,MATH 2,A01,957937,Staff,33,0,35,2
1746582668640,MATH 197,001,957876,Kedlaya; Kiran S.,9993,0,9999,6
1746582669666,MCWP 40,A00,892729,Duru; Nur,10,0,20,10
1746582669666,MCWP 40,B00,893304,Montejo; Carolina,14,0,20,6
1746582670690,MCWP 40R,A00,893757,Redela; Pamela Morgan,0,5,20,20
1746582671715,MCWP 50,A00,893758,Morshed; Michael James,0,0,20,20
1746582671715,MCWP 50,B00,893761,Bartulis; Jason Michael,17,0,20,3
1746582672742,MCWP 50R,A00,893766,Compas; Sean Matthew,0,1,20,20
1746582672742,MCWP 50R,B00,893769,Carter; Jennifer A,0,1,20,20
1746582672742,MCWP 50R,C00,893771,Krone; Jarret,0,3,20,20
1746582672742,MCWP 50R,D00,893772,Miller; Elizabeth Deen,0,0,20,20
1746582672742,MCWP 50R,E00,893775,Carter; Andrea L,0,1,20,20
1746582673767,MMW 11R,A01,892721,Herbst; Matthew,14,0,30,16
1746582673767,MMW 11R,A02,892722,Herbst; Matthew,0,0,0,3
1746582674793,MMW 12R,A01,892724,Herbst; Matthew,0,11,16,16
1746582674793,MMW 12R,A02,892725,Herbst; Matthew,0,10,16,16
1746582675819,MMW 13R,A01,892727,Staff,0,4,16,16
1746582675819,MMW 13R,A02,892728,Staff,0,4,16,16
1746582675819,MMW 13R,A03,958032,Staff,0,4,16,16
1746582675819,MMW 13R,A04,958033,Staff,0,4,16,16
1746582675819,MMW 13R,A05,958034,Staff,0,4,16,16
1746582676842,SIO 295LS,A00,894015,Staff,5,0,25,20
1746582677868,SIO 295S,A00,894020,Staff,5,0,25,20
1746582678894,SIOC 290S,B01,958918,Merrifield; Mark A,14,0,30,16
1746582679920,SIOC 291S,B01,958922,Gabriel; Corey John,14,0,30,16
1746582680945,SOCI 117,A01,895339,Staff,3,0,5,2
1746582681971,WES 237B,A00,894149,Staff,11,0,20,9
1746582684037,AESE 279B,A00,891859,Staff,13,0,35,22
1746582685063,AIP 197,001,891854,Vespa; Emanuel Ignacio,9999,0,9999,0
1746582686088,ANTH 289S,A00,891856,Gagneux; Pascal,12,0,12,0
1746582687114,BENG 196,001,957946,Engler; Adam J.,9996,0,9999,3
1746582688139,BISP 197,001,959851,Wilhelm; James E.,9998,0,9999,1
1746582689165,CAT 124RS,A01,956906,Staff,6,0,25,19
1746582690191,CAT 125RS,A01,922013,Staff,6,0,25,19
1746582691216,CLRE 250,A00,891860,Morris; Sheldon,9995,0,9999,4
1746582693265,CLRE 251R,A00,907817,Mehta; Ravindra L.,9994,0,9999,5
1746582694292,CLRE 252,A00,891864,Cuomo; Raphael Eduardo,9993,0,9999,6
1746582695320,CLRE 253,A00,891867,Vaida; Florin,9994,0,9999,5
1746582695320,CLRE 253,B00,907819,Staff,9999,0,9999,0
1746582696349,CLRE 259,A00,891868,Patel; Hemal,9998,0,9999,1
1746582697372,CLRE 260,A00,891872,Cuomo; Raphael Eduardo,9999,0,9999,0
1746582698399,CLRE 297,001,891888,Cuomo; Raphael Eduardo,9999,0,9999,0
1746582699426,CSE 191,A00,958773,Minnes Kemp; Mor Mia,9995,0,9999,4
1746582700452,CSE 197,001,959846,Minnes Kemp; Mor Mia,9990,0,9999,9
1746582701479,CSS 201S,A01,892054,Mignozzetti; Umberto,25,0,30,5
1746582702504,CSS 202S,A01,892056,Mignozzetti; Umberto,25,0,30,5
1746582703529,DSC 197,001,956898,Eldridge; Justin Matthew,9996,0,9999,3
1746582704556,DSC 297,001,958000,Mazumdar; Arya,9998,0,9999,1
1746582704556,DSC 297,002,959862,Wang; Yusu,9998,0,9999,1
1746582705581,EAP 100,A00,905686,Staff,9778,0,9999,221
1746582706605,ECE 45,A01,892618,Staff,0,0,65,65
1746582708656,ECE 111,A01,892719,Staff,6,0,65,59
1746582709680,ECE 197,001,957920,Mercier; Patrick Philip,9991,0,9999,8
1746582710706,ECON 178,A01,907814,Zhu; Ying,26,0,35,9
1746582711729,EDS 115,A00,895312,Staff,35,0,45,10
1746582712757,EDS 117,A01,895337,Staff,23,0,30,7
1746582713784,EDS 125,A00,895341,Jones; Gabrielle Anastasia,36,0,45,9
1746582714810,EDS 128A,A01,895459,Fargason; Sharon Gayle,44,0,45,1
1746582715834,EDS 128B,A01,895543,Pappas; Elizabeth,44,0,45,1
1746582716859,EDS 139,A00,897203,Pappas; Elizabeth,44,0,45,1
1746582716859,EDS 139,B00,897209,Fargason; Sharon Gayle,41,0,45,4
1746582717887,EDS 201,A00,895545,Staff,22,0,45,23
1746582718914,EDS 203,A01,895581,Halter; Christopher P.,22,0,45,23
1746582719940,EDS 204R,A01,895625,Heinzman; Erica M.,39,0,45,6
1746582719940,EDS 204R,B01,895693,Halter; Christopher P.,10,0,45,35
1746582720965,EDS 206R,A00,895694,Fargason; Sharon Gayle,1,0,30,29
1746582720965,EDS 206R,B00,895695,Choi; Bailey Miyeon,16,0,30,14
1746582721991,EDS 250,A00,895697,Hemans; Patricia Ann Benitez,22,0,45,23
1746582723015,EDS 281,A00,895701,Meyerott; Theresa Ann,1,0,15,14
1746582724040,EDS 284,A00,895736,Meyerott; Theresa Ann,1,0,15,14
1746582725066,EDS 286,A00,897210,Fine; Sarah,0,0,15,15
1746582726090,EDS 289C,A01,895770,Daly; Alan J.,1,0,15,14
1746582727119,EDS 290,A00,897211,Hofstetter; Carolyn,0,0,15,15
1746582728146,LIGM 5A,A00,896162,Fischer-Grunski; Eva K,12,0,20,8
1746582729170,LIGM 5B,A00,896260,Fischer-Grunski; Eva K,17,0,20,3
1746582730198,LIGM 5C,A00,896308,Fischer-Grunski; Eva K,18,0,20,2
1746582731225,LIIT 5AS,A00,896313,Carnelos; Chiara,18,0,20,2
1746582732250,LIIT 5BS,A00,896416,Carnelos; Chiara,20,0,20,0
1746582733274,LIIT 5CS,A00,896564,Carnelos; Chiara,20,0,20,0
1746582734303,LISP 5A,A00,896588,Munoz Sanchez; Alicia,2,0,20,18
1746582735329,LISP 5B,A00,896653,Munoz Sanchez; Alicia,7,0,20,13
1746582736354,LISP 5C,A00,896655,Munoz Sanchez; Alicia,0,1,20,20
1746582737381,MAE 197,001,957918,Kleissl; Jan,9996,0,9999,3
1746582737381,MAE 197,002,959806,Boechler; Nicholas Sebastia,9998,0,9999,1
1746582737381,MAE 197,003,959852,Mullin; Jennifer S,9998,0,9999,1
1746582738409,MATH 2,A01,957937,Staff,33,0,35,2
1746582739435,MATH 197,001,957876,Kedlaya; Kiran S.,9993,0,9999,6
1746582740460,MCWP 40,A00,892729,Duru; Nur,10,0,20,10
1746582740460,MCWP 40,B00,893304,Montejo; Carolina,14,0,20,6
1746582741485,MCWP 40R,A00,893757,Redela; Pamela Morgan,0,5,20,20
1746582742514,MCWP 50,A00,893758,Morshed; Michael James,0,0,20,20
1746582742514,MCWP 50,B00,893761,Bartulis; Jason Michael,17,0,20,3
1746582743543,MCWP 50R,A00,893766,Compas; Sean Matthew,0,1,20,20
1746582743543,MCWP 50R,B00,893769,Carter; Jennifer A,0,1,20,20
1746582743543,MCWP 50R,C00,893771,Krone; Jarret,0,3,20,20
1746582743543,MCWP 50R,D00,893772,Miller; Elizabeth Deen,0,0,20,20
1746582743543,MCWP 50R,E00,893775,Carter; Andrea L,0,1,20,20
1746582744572,MMW 11R,A01,892721,Herbst; Matthew,14,0,30,16
1746582744572,MMW 11R,A02,892722,Herbst; Matthew,0,0,0,3
1746582745600,MMW 12R,A01,892724,Herbst; Matthew,0,11,16,16
1746582745600,MMW 12R,A02,892725,Herbst; Matthew,0,10,16,16
1746582746624,MMW 13R,A01,892727,Staff,0,4,16,16
1746582746624,MMW 13R,A02,892728,Staff,0,4,16,16
1746582746624,MMW 13R,A03,958032,Staff,0,4,16,16
1746582746624,MMW 13R,A04,958033,Staff,0,4,16,16
1746582746624,MMW 13R,A05,958034,Staff,0,4,16,16
1746582747653,SIO 295LS,A00,894015,Staff,5,0,25,20
1746582748680,SIO 295S,A00,894020,Staff,5,0,25,20
1746582749710,SIOC 290S,B01,958918,Merrifield; Mark A,14,0,30,16
1746582750734,SIOC 291S,B01,958922,Gabriel; Corey John,14,0,30,16
1746582751758,SOCI 117,A01,895339,Staff,3,0,5,2
1746582752784,WES 237B,A00,894149,Staff,11,0,20,9
1746582754843,AESE 279B,A00,891859,Staff,13,0,35,22
1746582755870,AIP 197,001,891854,Vespa; Emanuel Ignacio,9999,0,9999,0
1746582756896,ANTH 289S,A00,891856,Gagneux; Pascal,12,0,12,0
1746582757923,BENG 196,001,957946,Engler; Adam J.,9996,0,9999,3
1746582758992,BISP 197,001,959851,Wilhelm; James E.,9998,0,9999,1
1746582760017,CAT 124RS,A01,956906,Staff,6,0,25,19
1746582761044,CAT 125RS,A01,922013,Staff,6,0,25,19
1746582762071,CLRE 250,A00,891860,Morris; Sheldon,9995,0,9999,4
1746582764123,CLRE 251R,A00,907817,Mehta; Ravindra L.,9994,0,9999,5
1746582765147,CLRE 252,A00,891864,Cuomo; Raphael Eduardo,9993,0,9999,6
1746582766173,CLRE 253,A00,891867,Vaida; Florin,9994,0,9999,5
1746582766173,CLRE 253,B00,907819,Staff,9999,0,9999,0
1746582767198,CLRE 259,A00,891868,Patel; Hemal,9998,0,9999,1
1746582768225,CLRE 260,A00,891872,Cuomo; Raphael Eduardo,9999,0,9999,0
1746582769249,CLRE 297,001,891888,Cuomo; Raphael Eduardo,9999,0,9999,0
1746582770277,CSE 191,A00,958773,Minnes Kemp; Mor Mia,9995,0,9999,4
1746582771303,CSE 197,001,959846,Minnes Kemp; Mor Mia,9990,0,9999,9
1746582772327,CSS 201S,A01,892054,Mignozzetti; Umberto,25,0,30,5
1746582773356,CSS 202S,A01,892056,Mignozzetti; Umberto,25,0,30,5
1746582774383,DSC 197,001,956898,Eldridge; Justin Matthew,9996,0,9999,3
1746582775408,DSC 297,001,958000,Mazumdar; Arya,9998,0,9999,1
1746582775408,DSC 297,002,959862,Wang; Yusu,9998,0,9999,1
1746582776437,EAP 100,A00,905686,Staff,9778,0,9999,221
1746582777466,ECE 45,A01,892618,Staff,0,0,65,65
1746582779519,ECE 111,A01,892719,Staff,6,0,65,59
1746582780544,ECE 197,001,957920,Mercier; Patrick Philip,9991,0,9999,8
1746582781570,ECON 178,A01,907814,Zhu; Ying,26,0,35,9
1746582782595,EDS 115,A00,895312,Staff,35,0,45,10
1746582783619,EDS 117,A01,895337,Staff,23,0,30,7
1746582784646,EDS 125,A00,895341,Jones; Gabrielle Anastasia,36,0,45,9
1746582785671,EDS 128A,A01,895459,Fargason; Sharon Gayle,44,0,45,1
1746582786696,EDS 128B,A01,895543,Pappas; Elizabeth,44,0,45,1
1746582787722,EDS 139,A00,897203,Pappas; Elizabeth,44,0,45,1
1746582787722,EDS 139,B00,897209,Fargason; Sharon Gayle,41,0,45,4
1746582788746,EDS 201,A00,895545,Staff,22,0,45,23
1746582789773,EDS 203,A01,895581,Halter; Christopher P.,22,0,45,23
1746582790799,EDS 204R,A01,895625,Heinzman; Erica M.,39,0,45,6
1746582790799,EDS 204R,B01,895693,Halter; Christopher P.,10,0,45,35
1746582791823,EDS 206R,A00,895694,Fargason; Sharon Gayle,1,0,30,29
1746582791823,EDS 206R,B00,895695,Choi; Bailey Miyeon,16,0,30,14
1746582792848,EDS 250,A00,895697,Hemans; Patricia Ann Benitez,22,0,45,23
1746582793877,EDS 281,A00,895701,Meyerott; Theresa Ann,1,0,15,14
1746582794905,EDS 284,A00,895736,Meyerott; Theresa Ann,1,0,15,14
1746582795929,EDS 286,A00,897210,Fine; Sarah,0,0,15,15
1746582796957,EDS 289C,A01,895770,Daly; Alan J.,1,0,15,14
1746582797983,EDS 290,A00,897211,Hofstetter; Carolyn,0,0,15,15
1746582799012,LIGM 5A,A00,896162,Fischer-Grunski; Eva K,12,0,20,8
1746582800038,LIGM 5B,A00,896260,Fischer-Grunski; Eva K,17,0,20,3
1746582801063,LIGM 5C,A00,896308,Fischer-Grunski; Eva K,18,0,20,2
1746582802092,LIIT 5AS,A00,896313,Carnelos; Chiara,18,0,20,2
1746582803119,LIIT 5BS,A00,896416,Carnelos; Chiara,20,0,20,0
1746582804144,LIIT 5CS,A00,896564,Carnelos; Chiara,20,0,20,0
1746582805168,LISP 5A,A00,896588,Munoz Sanchez; Alicia,2,0,20,18
1746582806194,LISP 5B,A00,896653,Munoz Sanchez; Alicia,7,0,20,13
1746582807220,LISP 5C,A00,896655,Munoz Sanchez; Alicia,0,1,20,20
1746582808246,MAE 197,001,957918,Kleissl; Jan,9996,0,9999,3
1746582808246,MAE 197,002,959806,Boechler; Nicholas Sebastia,9998,0,9999,1
1746582808246,MAE 197,003,959852,Mullin; Jennifer S,9998,0,9999,1
1746582809272,MATH 2,A01,957937,Staff,33,0,35,2
1746582810296,MATH 197,001,957876,Kedlaya; Kiran S.,9993,0,9999,6
1746582811322,MCWP 40,A00,892729,Duru; Nur,10,0,20,10
1746582811322,MCWP 40,B00,893304,Montejo; Carolina,14,0,20,6
1746582812350,MCWP 40R,A00,893757,Redela; Pamela Morgan,0,5,20,20
1746582813380,MCWP 50,A00,893758,Morshed; Michael James,0,0,20,20
1746582813380,MCWP 50,B00,893761,Bartulis; Jason Michael,17,0,20,3
1746582814404,MCWP 50R,A00,893766,Compas; Sean Matthew,0,1,20,20
1746582814404,MCWP 50R,B00,893769,Carter; Jennifer A,0,1,20,20
1746582814404,MCWP 50R,C00,893771,Krone; Jarret,0,3,20,20
1746582814404,MCWP 50R,D00,893772,Miller; Elizabeth Deen,0,0,20,20
1746582814404,MCWP 50R,E00,893775,Carter; Andrea L,0,1,20,20
1746582815432,MMW 11R,A01,892721,Herbst; Matthew,14,0,30,16
1746582815432,MMW 11R,A02,892722,Herbst; Matthew,0,0,0,3
1746582816460,MMW 12R,A01,892724,Herbst; Matthew,0,11,16,16
1746582816460,MMW 12R,A02,892725,Herbst; Matthew,0,10,16,16
1746582817487,MMW 13R,A01,892727,Staff,0,4,16,16
1746582817487,MMW 13R,A02,892728,Staff,0,4,16,16
1746582817487,MMW 13R,A03,958032,Staff,0,4,16,16
1746582817487,MMW 13R,A04,958033,Staff,0,4,16,16
1746582817487,MMW 13R,A05,958034,Staff,0,4,16,16
1746582818514,SIO 295LS,A00,894015,Staff,5,0,25,20
1746582819541,SIO 295S,A00,894020,Staff,5,0,25,20
1746582820569,SIOC 290S,B01,958918,Merrifield; Mark A,14,0,30,16
1746582821599,SIOC 291S,B01,958922,Gabriel; Corey John,14,0,30,16
1746582822624,SOCI 117,A01,895339,Staff,3,0,5,2
1746582823650,WES 237B,A00,894149,Staff,11,0,20,9
1746582825707,AESE 279B,A00,891859,Staff,13,0,35,22
1746582826734,AIP 197,001,891854,Vespa; Emanuel Ignacio,9999,0,9999,0
1746582827761,ANTH 289S,A00,891856,Gagneux; Pascal,12,0,12,0
1746582828787,BENG 196,001,957946,Engler; Adam J.,9996,0,9999,3
1746582829816,BISP 197,001,959851,Wilhelm; James E.,9998,0,9999,1
1746582830841,CAT 124RS,A01,956906,Staff,6,0,25,19
1746582831867,CAT 125RS,A01,922013,Staff,6,0,25,19
1746582832893,CLRE 250,A00,891860,Morris; Sheldon,9995,0,9999,4
1746582834948,CLRE 251R,A00,907817,Mehta; Ravindra L.,9994,0,9999,5
1746582835973,CLRE 252,A00,891864,Cuomo; Raphael Eduardo,9993,0,9999,6
1746582836997,CLRE 253,A00,891867,Vaida; Florin,9994,0,9999,5
1746582836997,CLRE 253,B00,907819,Staff,9999,0,9999,0
1746582838022,CLRE 259,A00,891868,Patel; Hemal,9998,0,9999,1
1746582839050,CLRE 260,A00,891872,Cuomo; Raphael Eduardo,9999,0,9999,0
1746582840075,CLRE 297,001,891888,Cuomo; Raphael Eduardo,9999,0,9999,0
1746582841100,CSE 191,A00,958773,Minnes Kemp; Mor Mia,9995,0,9999,4
1746582842128,CSE 197,001,959846,Minnes Kemp; Mor Mia,9990,0,9999,9
1746582843154,CSS 201S,A01,892054,Mignozzetti; Umberto,25,0,30,5
1746582844178,CSS 202S,A01,892056,Mignozzetti; Umberto,25,0,30,5
1746582845203,DSC 197,001,956898,Eldridge; Justin Matthew,9996,0,9999,3
1746582846256,DSC 297,001,958000,Mazumdar; Arya,9998,0,9999,1
1746582846256,DSC 297,002,959862,Wang; Yusu,9998,0,9999,1
1746582847279,EAP 100,A00,905686,Staff,9778,0,9999,221
1746582848305,ECE 45,A01,892618,Staff,0,0,65,65
1746582850358,ECE 111,A01,892719,Staff,6,0,65,59
1746582851383,ECE 197,001,957920,Mercier; Patrick Philip,9991,0,9999,8
1746582852426,ECON 178,A01,907814,Zhu; Ying,26,0,35,9
1746582853451,EDS 115,A00,895312,Staff,35,0,45,10
1746582854479,EDS 117,A01,895337,Staff,23,0,30,7
1746582855504,EDS 125,A00,895341,Jones; Gabrielle Anastasia,36,0,45,9
1746582856529,EDS 128A,A01,895459,Fargason; Sharon Gayle,44,0,45,1
1746582857558,EDS 128B,A01,895543,Pappas; Elizabeth,44,0,45,1
1746582858582,EDS 139,A00,897203,Pappas; Elizabeth,44,0,45,1
1746582858582,EDS 139,B00,897209,Fargason; Sharon Gayle,41,0,45,4
1746582859609,EDS 201,A00,895545,Staff,22,0,45,23
1746582860637,EDS 203,A01,895581,Halter; Christopher P.,22,0,45,23
1746582861662,EDS 204R,A01,895625,Heinzman; Erica M.,39,0,45,6
1746582861662,EDS 204R,B01,895693,Halter; Christopher P.,10,0,45,35
1746582862726,EDS 206R,A00,895694,Fargason; Sharon Gayle,1,0,30,29
1746582862726,EDS 206R,B00,895695,Choi; Bailey Miyeon,16,0,30,14
1746582863750,EDS 250,A00,895697,Hemans; Patricia Ann Benitez,22,0,45,23
1746582864779,EDS 281,A00,895701,Meyerott; Theresa Ann,1,0,15,14
1746582865804,EDS 284,A00,895736,Meyerott; Theresa Ann,1,0,15,14
1746582866828,EDS 286,A00,897210,Fine; Sarah,0,0,15,15
1746582867854,EDS 289C,A01,895770,Daly; Alan J.,1,0,15,14
1746582868881,EDS 290,A00,897211,Hofstetter; Carolyn,0,0,15,15
1746582869911,LIGM 5A,A00,896162,Fischer-Grunski; Eva K,12,0,20,8
1746582870938,LIGM 5B,A00,896260,Fischer-Grunski; Eva K,17,0,20,3
1746582871967,LIGM 5C,A00,896308,Fischer-Grunski; Eva K,18,0,20,2
1746582872993,LIIT 5AS,A00,896313,Carnelos; Chiara,18,0,20,2
1746582874023,LIIT 5BS,A00,896416,Carnelos; Chiara,20,0,20,0
1746582875054,LIIT 5CS,A00,896564,Carnelos; Chiara,20,0,20,0
1746582876079,LISP 5A,A00,896588,Munoz Sanchez; Alicia,2,0,20,18
1746582877105,LISP 5B,A00,896653,Munoz Sanchez; Alicia,7,0,20,13
1746582878130,LISP 5C,A00,896655,Munoz Sanchez; Alicia,0,1,20,20
1746582879156,MAE 197,001,957918,Kleissl; Jan,9996,0,9999,3
1746582879156,MAE 197,002,959806,Boechler; Nicholas Sebastia,9998,0,9999,1
1746582879156,MAE 197,003,959852,Mullin; Jennifer S,9998,0,9999,1
1746582880181,MATH 2,A01,957937,Staff,33,0,35,2
1746582881207,MATH 197,001,957876,Kedlaya; Kiran S.,9993,0,9999,6
1746582882250,MCWP 40,A00,892729,Duru; Nur,10,0,20,10
1746582882250,MCWP 40,B00,893304,Montejo; Carolina,14,0,20,6
1746582883279,MCWP 40R,A00,893757,Redela; Pamela Morgan,0,5,20,20
1746582884305,MCWP 50,A00,893758,Morshed; Michael James,0,0,20,20
1746582884305,MCWP 50,B00,893761,Bartulis; Jason Michael,17,0,20,3
1746582885330,MCWP 50R,A00,893766,Compas; Sean Matthew,0,1,20,20
1746582885330,MCWP 50R,B00,893769,Carter; Jennifer A,0,1,20,20
1746582885330,MCWP 50R,C00,893771,Krone; Jarret,0,3,20,20
1746582885330,MCWP 50R,D00,893772,Miller; Elizabeth Deen,0,0,20,20
1746582885330,MCWP 50R,E00,893775,Carter; Andrea L,0,1,20,20
1746582886357,MMW 11R,A01,892721,Herbst; Matthew,14,0,30,16
1746582886357,MMW 11R,A02,892722,Herbst; Matthew,0,0,0,3
1746582887385,MMW 12R,A01,892724,Herbst; Matthew,0,11,16,16
1746582887385,MMW 12R,A02,892725,Herbst; Matthew,0,10,16,16
1746582888414,MMW 13R,A01,892727,Staff,0,4,16,16
1746582888414,MMW 13R,A02,892728,Staff,0,4,16,16
1746582888414,MMW 13R,A03,958032,Staff,0,4,16,16
1746582888414,MMW 13R,A04,958033,Staff,0,4,16,16
1746582888414,MMW 13R,A05,958034,Staff,0,4,16,16
1746582889440,SIO 295LS,A00,894015,Staff,5,0,25,20
1746582890469,SIO 295S,A00,894020,Staff,5,0,25,20
1746582891494,SIOC 290S,B01,958918,Merrifield; Mark A,14,0,30,16
1746582892519,SIOC 291S,B01,958922,Gabriel; Corey John,14,0,30,16
1746582893544,SOCI 117,A01,895339,Staff,3,0,5,2
1746582894570,WES 237B,A00,894149,Staff,11,0,20,9
1746582896628,AESE 279B,A00,891859,Staff,13,0,35,22
1746582897654,AIP 197,001,891854,Vespa; Emanuel Ignacio,9999,0,9999,0
1746582898680,ANTH 289S,A00,891856,Gagneux; Pascal,12,0,12,0
1746582899705,BENG 196,001,957946,Engler; Adam J.,9996,0,9999,3
1746582900730,BISP 197,001,959851,Wilhelm; James E.,9998,0,9999,1
1746582901759,CAT 124RS,A01,956906,Staff,6,0,25,19
1746582902784,CAT 125RS,A01,922013,Staff,6,0,25,19
1746582903809,CLRE 250,A00,891860,Morris; Sheldon,9995,0,9999,4
1746582905861,CLRE 251R,A00,907817,Mehta; Ravindra L.,9994,0,9999,5
1746582906886,CLRE 252,A00,891864,Cuomo; Raphael Eduardo,9993,0,9999,6
1746582907913,CLRE 253,A00,891867,Vaida; Florin,9994,0,9999,5
1746582907913,CLRE 253,B00,907819,Staff,9999,0,9999,0
1746582908938,CLRE 259,A00,891868,Patel; Hemal,9998,0,9999,1
1746582909965,CLRE 260,A00,891872,Cuomo; Raphael Eduardo,9999,0,9999,0
1746582910995,CLRE 297,001,891888,Cuomo; Raphael Eduardo,9999,0,9999,0
1746582912024,CSE 191,A00,958773,Minnes Kemp; Mor Mia,9995,0,9999,4
1746582913049,CSE 197,001,959846,Minnes Kemp; Mor Mia,9990,0,9999,9
1746582914074,CSS 201S,A01,892054,Mignozzetti; Umberto,25,0,30,5
1746582915100,CSS 202S,A01,892056,Mignozzetti; Umberto,25,0,30,5
1746582916125,DSC 197,001,956898,Eldridge; Justin Matthew,9996,0,9999,3
1746582917152,DSC 297,001,958000,Mazumdar; Arya,9998,0,9999,1
1746582917152,DSC 297,002,959862,Wang; Yusu,9998,0,9999,1
1746582918176,EAP 100,A00,905686,Staff,9778,0,9999,221
1746582919203,ECE 45,A01,892618,Staff,0,0,65,65
1746582921258,ECE 111,A01,892719,Staff,6,0,65,59
1746582922286,ECE 197,001,957920,Mercier; Patrick Philip,9991,0,9999,8
1746582923314,ECON 178,A01,907814,Zhu; Ying,26,0,35,9
1746582924343,EDS 115,A00,895312,Staff,35,0,45,10
1746582925371,EDS 117,A01,895337,Staff,23,0,30,7
1746582926401,EDS 125,A00,895341,Jones; Gabrielle Anastasia,36,0,45,9
1746582927430,EDS 128A,A01,895459,Fargason; Sharon Gayle,44,0,45,1
1746582928455,EDS 128B,A01,895543,Pappas; Elizabeth,44,0,45,1
1746582929480,EDS 139,A00,897203,Pappas; Elizabeth,44,0,45,1
1746582929480,EDS 139,B00,897209,Fargason; Sharon Gayle,41,0,45,4
1746582930508,EDS 201,A00,895545,Staff,22,0,45,23
1746582931533,EDS 203,A01,895581,Halter; Christopher P.,22,0,45,23
1746582932563,EDS 204R,A01,895625,Heinzman; Erica M.,39,0,45,6
1746582932563,EDS 204R,B01,895693,Halter; Christopher P.,10,0,45,35
1746582933591,EDS 206R,A00,895694,Fargason; Sharon Gayle,1,0,30,29
1746582933591,EDS 206R,B00,895695,Choi; Bailey Miyeon,16,0,30,14
1746582934616,EDS 250,A00,895697,Hemans; Patricia Ann Benitez,22,0,45,23
1746582935642,EDS 281,A00,895701,Meyerott; Theresa Ann,1,0,15,14
1746582936671,EDS 284,A00,895736,Meyerott; Theresa Ann,1,0,15,14
1746582937699,EDS 286,A00,897210,Fine; Sarah,0,0,15,15
1746582938726,EDS 289C,A01,895770,Daly; Alan J.,1,0,15,14
1746582939753,EDS 290,A00,897211,Hofstetter; Carolyn,0,0,15,15
1746582940778,LIGM 5A,A00,896162,Fischer-Grunski; Eva K,12,0,20,8
1746582941804,LIGM 5B,A00,896260,Fischer-Grunski; Eva K,17,0,20,3
1746582942830,LIGM 5C,A00,896308,Fischer-Grunski; Eva K,18,0,20,2
1746582943857,LIIT 5AS,A00,896313,Carnelos; Chiara,18,0,20,2
1746582944887,LIIT 5BS,A00,896416,Carnelos; Chiara,20,0,20,0
1746582945912,LIIT 5CS,A00,896564,Carnelos; Chiara,20,0,20,0
1746582946944,LISP 5A,A00,896588,Munoz Sanchez; Alicia,2,0,20,18
1746582947969,LISP 5B,A00,896653,Munoz Sanchez; Alicia,7,0,20,13
1746582948995,LISP 5C,A00,896655,Munoz Sanchez; Alicia,0,1,20,20
1746582950024,MAE 197,001,957918,Kleissl; Jan,9996,0,9999,3
1746582950024,MAE 197,002,959806,Boechler; Nicholas Sebastia,9998,0,9999,1
1746582950024,MAE 197,003,959852,Mullin; Jennifer S,9998,0,9999,1
1746582951049,MATH 2,A01,957937,Staff,33,0,35,2
1746582952075,MATH 197,001,957876,Kedlaya; Kiran S.,9993,0,9999,6
1746582953101,MCWP 40,A00,892729,Duru; Nur,10,0,20,10
1746582953101,MCWP 40,B00,893304,Montejo; Carolina,14,0,20,6
1746582954141,MCWP 40R,A00,893757,Redela; Pamela Morgan,0,5,20,20
1746582955166,MCWP 50,A00,893758,Morshed; Michael James,0,0,20,20
1746582955166,MCWP 50,B00,893761,Bartulis; Jason Michael,17,0,20,3
1746582956191,MCWP 50R,A00,893766,Compas; Sean Matthew,0,1,20,20
1746582956191,MCWP 50R,B00,893769,Carter; Jennifer A,0,1,20,20
1746582956191,MCWP 50R,C00,893771,Krone; Jarret,0,3,20,20
1746582956191,MCWP 50R,D00,893772,Miller; Elizabeth Deen,0,0,20,20
1746582956191,MCWP 50R,E00,893775,Carter; Andrea L,0,1,20,20
1746582957223,MMW 11R,A01,892721,Herbst; Matthew,14,0,30,16
1746582957223,MMW 11R,A02,892722,Herbst; Matthew,0,0,0,3
1746582958249,MMW 12R,A01,892724,Herbst; Matthew,0,11,16,16
1746582958249,MMW 12R,A02,892725,Herbst; Matthew,0,10,16,16
1746582959279,MMW 13R,A01,892727,Staff,0,4,16,16
1746582959279,MMW 13R,A02,892728,Staff,0,4,16,16
1746582959279,MMW 13R,A03,958032,Staff,0,4,16,16
1746582959279,MMW 13R,A04,958033,Staff,0,4,16,16
1746582959279,MMW 13R,A05,958034,Staff,0,4,16,16
1746582960308,SIO 295LS,A00,894015,Staff,5,0,25,20
1746582961336,SIO 295S,A00,894020,Staff,5,0,25,20
1746582962363,SIOC 290S,B01,958918,Merrifield; Mark A,14,0,30,16
1746582963388,SIOC 291S,B01,958922,Gabriel; Corey John,14,0,30,16
1746582964415,SOCI 117,A01,895339,Staff,3,0,5,2
1746582965442,WES 237B,A00,894149,Staff,11,0,20,9
1746582967549,AESE 279B,A00,891859,Staff,13,0,35,22
1746582968574,AIP 197,001,891854,Vespa; Emanuel Ignacio,9999,0,9999,0
1746582969599,ANTH 289S,A00,891856,Gagneux; Pascal,12,0,12,0
1746582970625,BENG 196,001,957946,Engler; Adam J.,9996,0,9999,3
1746582971649,BISP 197,001,959851,Wilhelm; James E.,9998,0,9999,1
1746582972676,CAT 124RS,A01,956906,Staff,6,0,25,19
1746582973703,CAT 125RS,A01,922013,Staff,6,0,25,19
1746582974729,CLRE 250,A00,891860,Morris; Sheldon,9995,0,9999,4
1746582976780,CLRE 251R,A00,907817,Mehta; Ravindra L.,9994,0,9999,5
1746582977805,CLRE 252,A00,891864,Cuomo; Raphael Eduardo,9993,0,9999,6
1746582978835,CLRE 253,A00,891867,Vaida; Florin,9994,0,9999,5
1746582978835,CLRE 253,B00,907819,Staff,9999,0,9999,0
1746582979862,CLRE 259,A00,891868,Patel; Hemal,9998,0,9999,1
1746582980891,CLRE 260,A00,891872,Cuomo; Raphael Eduardo,9999,0,9999,0
1746582981918,CLRE 297,001,891888,Cuomo; Raphael Eduardo,9999,0,9999,0
1746582982945,CSE 191,A00,958773,Minnes Kemp; Mor Mia,9995,0,9999,4
1746582983971,CSE 197,001,959846,Minnes Kemp; Mor Mia,9990,0,9999,9
1746582984997,CSS 201S,A01,892054,Mignozzetti; Umberto,25,0,30,5
1746582986022,CSS 202S,A01,892056,Mignozzetti; Umberto,25,0,30,5
1746582987048,DSC 197,001,956898,Eldridge; Justin Matthew,9996,0,9999,3
1746582988075,DSC 297,001,958000,Mazumdar; Arya,9998,0,9999,1
1746582988075,DSC 297,002,959862,Wang; Yusu,9998,0,9999,1
1746582989104,EAP 100,A00,905686,Staff,9778,0,9999,221
1746582990135,ECE 45,A01,892618,Staff,0,0,65,65
1746582992188,ECE 111,A01,892719,Staff,6,0,65,59
1746582993213,ECE 197,001,957920,Mercier; Patrick Philip,9991,0,9999,8
1746582994237,ECON 178,A01,907814,Zhu; Ying,26,0,35,9
1746582995263,EDS 115,A00,895312,Staff,35,0,45,10
1746582996287,EDS 117,A01,895337,Staff,23,0,30,7
1746582997311,EDS 125,A00,895341,Jones; Gabrielle Anastasia,36,0,45,9
1746582998336,EDS 128A,A01,895459,Fargason; Sharon Gayle,44,0,45,1
1746582999364,EDS 128B,A01,895543,Pappas; Elizabeth,44,0,45,1
1746583000392,EDS 139,A00,897203,Pappas; Elizabeth,44,0,45,1
1746583000392,EDS 139,B00,897209,Fargason; Sharon Gayle,41,0,45,4
1746583001421,EDS 201,A00,895545,Staff,22,0,45,23
1746583002449,EDS 203,A01,895581,Halter; Christopher P.,22,0,45,23
1746583003473,EDS 204R,A01,895625,Heinzman; Erica M.,39,0,45,6
1746583003473,EDS 204R,B01,895693,Halter; Christopher P.,10,0,45,35
1746583004503,EDS 206R,A00,895694,Fargason; Sharon Gayle,1,0,30,29
1746583004503,EDS 206R,B00,895695,Choi; Bailey Miyeon,16,0,30,14
1746583005528,EDS 250,A00,895697,Hemans; Patricia Ann Benitez,22,0,45,23
1746583006554,EDS 281,A00,895701,Meyerott; Theresa Ann,1,0,15,14
1746583007578,EDS 284,A00,895736,Meyerott; Theresa Ann,1,0,15,14
1746583008603,EDS 286,A00,897210,Fine; Sarah,0,0,15,15
1746583009631,EDS 289C,A01,895770,Daly; Alan J.,1,0,15,14
1746583010658,EDS 290,A00,897211,Hofstetter; Carolyn,0,0,15,15
1746583011682,LIGM 5A,A00,896162,Fischer-Grunski; Eva K,12,0,20,8
1746583012712,LIGM 5B,A00,896260,Fischer-Grunski; Eva K,17,0,20,3
1746583013736,LIGM 5C,A00,896308,Fischer-Grunski; Eva K,18,0,20,2
1746583014765,LIIT 5AS,A00,896313,Carnelos; Chiara,18,0,20,2
1746583015793,LIIT 5BS,A00,896416,Carnelos; Chiara,20,0,20,0
1746583016819,LIIT 5CS,A00,896564,Carnelos; Chiara,20,0,20,0
1746583017844,LISP 5A,A00,896588,Munoz Sanchez; Alicia,2,0,20,18
1746583018869,LISP 5B,A00,896653,Munoz Sanchez; Alicia,7,0,20,13
1746583019895,LISP 5C,A00,896655,Munoz Sanchez; Alicia,0,1,20,20
1746583020918,MAE 197,001,957918,Kleissl; Jan,9996,0,9999,3
1746583020918,MAE 197,002,959806,Boechler; Nicholas Sebastia,9998,0,9999,1
1746583020918,MAE 197,003,959852,Mullin; Jennifer S,9998,0,9999,1
1746583021943,MATH 2,A01,957937,Staff,33,0,35,2
1746583022969,MATH 197,001,957876,Kedlaya; Kiran S.,9993,0,9999,6
1746583023994,MCWP 40,A00,892729,Duru; Nur,10,0,20,10
1746583023994,MCWP 40,B00,893304,Montejo; Carolina,14,0,20,6
1746583025020,MCWP 40R,A00,893757,Redela; Pamela Morgan,0,5,20,20
1746583026045,MCWP 50,A00,893758,Morshed; Michael James,0,0,20,20
1746583026045,MCWP 50,B00,893761,Bartulis; Jason Michael,17,0,20,3
1746583027070,MCWP 50R,A00,893766,Compas; Sean Matthew,0,1,20,20
1746583027070,MCWP 50R,B00,893769,Carter; Jennifer A,0,1,20,20
1746583027070,MCWP 50R,C00,893771,Krone; Jarret,0,3,20,20
1746583027070,MCWP 50R,D00,893772,Miller; Elizabeth Deen,0,0,20,20
1746583027070,MCWP 50R,E00,893775,Carter; Andrea L,0,1,20,20
1746583028097,MMW 11R,A01,892721,Herbst; Matthew,14,0,30,16
1746583028097,MMW 11R,A02,892722,Herbst; Matthew,0,0,0,3
1746583029121,MMW 12R,A01,892724,Herbst; Matthew,0,11,16,16
1746583029121,MMW 12R,A02,892725,Herbst; Matthew,0,10,16,16
1746583030146,MMW 13R,A01,892727,Staff,0,4,16,16
1746583030146,MMW 13R,A02,892728,Staff,0,4,16,16
1746583030146,MMW 13R,A03,958032,Staff,0,4,16,16
1746583030146,MMW 13R,A04,958033,Staff,0,4,16,16
1746583030146,MMW 13R,A05,958034,Staff,0,4,16,16
1746583031171,SIO 295LS,A00,894015,Staff,5,0,25,20
1746583032198,SIO 295S,A00,894020,Staff,5,0,25,20
1746583033226,SIOC 290S,B01,958918,Merrifield; Mark A,14,0,30,16
1746583034252,SIOC 291S,B01,958922,Gabriel; Corey John,14,0,30,16
1746583035281,SOCI 117,A01,895339,Staff,3,0,5,2
1746583036307,WES 237B,A00,894149,Staff,11,0,20,9
1746583038374,AESE 279B,A00,891859,Staff,13,0,35,22
1746583039398,AIP 197,001,891854,Vespa; Emanuel Ignacio,9999,0,9999,0
1746583040423,ANTH 289S,A00,891856,Gagneux; Pascal,12,0,12,0
1746583041448,BENG 196,001,957946,Engler; Adam J.,9996,0,9999,3
1746583042475,BISP 197,001,959851,Wilhelm; James E.,9998,0,9999,1
1746583043504,CAT 124RS,A01,956906,Staff,6,0,25,19
1746583044531,CAT 125RS,A01,922013,Staff,6,0,25,19
1746583045557,CLRE 250,A00,891860,Morris; Sheldon,9995,0,9999,4
1746583047608,CLRE 251R,A00,907817,Mehta; Ravindra L.,9994,0,9999,5
1746583048637,CLRE 252,A00,891864,Cuomo; Raphael Eduardo,9993,0,9999,6
1746583049661,CLRE 253,A00,891867,Vaida; Florin,9994,0,9999,5
1746583049661,CLRE 253,B00,907819,Staff,9999,0,9999,0
1746583050686,CLRE 259,A00,891868,Patel; Hemal,9998,0,9999,1
1746583051713,CLRE 260,A00,891872,Cuomo; Raphael Eduardo,9999,0,9999,0
1746583052740,CLRE 297,001,891888,Cuomo; Raphael Eduardo,9999,0,9999,0
1746583053768,CSE 191,A00,958773,Minnes Kemp; Mor Mia,9995,0,9999,4
1746583054793,CSE 197,001,959846,Minnes Kemp; Mor Mia,9990,0,9999,9
1746583055817,CSS 201S,A01,892054,Mignozzetti; Umberto,25,0,30,5
1746583056843,CSS 202S,A01,892056,Mignozzetti; Umberto,25,0,30,5
1746583057867,DSC 197,001,956898,Eldridge; Justin Matthew,9996,0,9999,3
1746583058895,DSC 297,001,958000,Mazumdar; Arya,9998,0,9999,1
1746583058895,DSC 297,002,959862,Wang; Yusu,9998,0,9999,1
1746583059919,EAP 100,A00,905686,Staff,9778,0,9999,221
1746583060948,ECE 45,A01,892618,Staff,0,0,65,65
1746583063004,ECE 111,A01,892719,Staff,6,0,65,59
1746583064032,ECE 197,001,957920,Mercier; Patrick Philip,9991,0,9999,8
1746583065058,ECON 178,A01,907814,Zhu; Ying,26,0,35,9
1746583066086,EDS 115,A00,895312,Staff,35,0,45,10
1746583067115,EDS 117,A01,895337,Staff,23,0,30,7
1746583068141,EDS 125,A00,895341,Jones; Gabrielle Anastasia,36,0,45,9
1746583069170,EDS 128A,A01,895459,Fargason; Sharon Gayle,44,0,45,1
1746583070196,EDS 128B,A01,895543,Pappas; Elizabeth,44,0,45,1
1746583071222,EDS 139,A00,897203,Pappas; Elizabeth,44,0,45,1
1746583071222,EDS 139,B00,897209,Fargason; Sharon Gayle,41,0,45,4
1746583072246,EDS 201,A00,895545,Staff,22,0,45,23
1746583073276,EDS 203,A01,895581,Halter; Christopher P.,22,0,45,23
1746583074303,EDS 204R,A01,895625,Heinzman; Erica M.,39,0,45,6
1746583074303,EDS 204R,B01,895693,Halter; Christopher P.,10,0,45,35
1746583075330,EDS 206R,A00,895694,Fargason; Sharon Gayle,1,0,30,29
1746583075330,EDS 206R,B00,895695,Choi; Bailey Miyeon,16,0,30,14
1746583076355,EDS 250,A00,895697,Hemans; Patricia Ann Benitez,22,0,45,23
1746583077384,EDS 281,A00,895701,Meyerott; Theresa Ann,1,0,15,14
1746583078409,EDS 284,A00,895736,Meyerott; Theresa Ann,1,0,15,14
1746583079434,EDS 286,A00,897210,Fine; Sarah,0,0,15,15
1746583080463,EDS 289C,A01,895770,Daly; Alan J.,1,0,15,14
1746583081486,EDS 290,A00,897211,Hofstetter; Carolyn,0,0,15,15
1746583082510,LIGM 5A,A00,896162,Fischer-Grunski; Eva K,12,0,20,8
1746583083596,LIGM 5B,A00,896260,Fischer-Grunski; Eva K,17,0,20,3
1746583084625,LIGM 5C,A00,896308,Fischer-Grunski; Eva K,18,0,20,2
1746583085649,LIIT 5AS,A00,896313,Carnelos; Chiara,18,0,20,2
1746583086678,LIIT 5BS,A00,896416,Carnelos; Chiara,20,0,20,0
1746583087707,LIIT 5CS,A00,896564,Carnelos; Chiara,20,0,20,0
1746583088734,LISP 5A,A00,896588,Munoz Sanchez; Alicia,2,0,20,18
1746583089763,LISP 5B,A00,896653,Munoz Sanchez; Alicia,7,0,20,13
1746583090793,LISP 5C,A00,896655,Munoz Sanchez; Alicia,0,1,20,20
1746583091819,MAE 197,001,957918,Kleissl; Jan,9996,0,9999,3
1746583091819,MAE 197,002,959806,Boechler; Nicholas Sebastia,9998,0,9999,1
1746583091819,MAE 197,003,959852,Mullin; Jennifer S,9998,0,9999,1
1746583092847,MATH 2,A01,957937,Staff,33,0,35,2
1746583093874,MATH 197,001,957876,Kedlaya; Kiran S.,9993,0,9999,6
1746583094899,MCWP 40,A00,892729,Duru; Nur,10,0,20,10
1746583094899,MCWP 40,B00,893304,Montejo; Carolina,14,0,20,6
1746583095926,MCWP 40R,A00,893757,Redela; Pamela Morgan,0,5,20,20
1746583096950,MCWP 50,A00,893758,Morshed; Michael James,0,0,20,20
1746583096950,MCWP 50,B00,893761,Bartulis; Jason Michael,17,0,20,3
1746583097979,MCWP 50R,A00,893766,Compas; Sean Matthew,0,1,20,20
1746583097979,MCWP 50R,B00,893769,Carter; Jennifer A,0,1,20,20
1746583097979,MCWP 50R,C00,893771,Krone; Jarret,0,3,20,20
1746583097979,MCWP 50R,D00,893772,Miller; Elizabeth Deen,0,0,20,20
1746583097979,MCWP 50R,E00,893775,Carter; Andrea L,0,1,20,20
1746583099007,MMW 11R,A01,892721,Herbst; Matthew,14,0,30,16
1746583099007,MMW 11R,A02,892722,Herbst; Matthew,0,0,0,3
1746583100032,MMW 12R,A01,892724,Herbst; Matthew,0,11,16,16
1746583100032,MMW 12R,A02,892725,Herbst; Matthew,0,10,16,16
1746583101062,MMW 13R,A01,892727,Staff,0,4,16,16
1746583101062,MMW 13R,A02,892728,Staff,0,4,16,16
1746583101062,MMW 13R,A03,958032,Staff,0,4,16,16
1746583101062,MMW 13R,A04,958033,Staff,0,4,16,16
1746583101062,MMW 13R,A05,958034,Staff,0,4,16,16
1746583102087,SIO 295LS,A00,894015,Staff,5,0,25,20
1746583103113,SIO 295S,A00,894020,Staff,5,0,25,20
1746583104139,SIOC 290S,B01,958918,Merrifield; Mark A,14,0,30,16
1746583105168,SIOC 291S,B01,958922,Gabriel; Corey John,14,0,30,16
1746583106194,SOCI 117,A01,895339,Staff,3,0,5,2
1746583107222,WES 237B,A00,894149,Staff,11,0,20,9
1746583109276,AESE 279B,A00,891859,Staff,13,0,35,22
1746583110302,AIP 197,001,891854,Vespa; Emanuel Ignacio,9999,0,9999,0
1746583111326,ANTH 289S,A00,891856,Gagneux; Pascal,12,0,12,0
1746583112351,BENG 196,001,957946,Engler; Adam J.,9996,0,9999,3
1746583113376,BISP 197,001,959851,Wilhelm; James E.,9998,0,9999,1
1746583114400,CAT 124RS,A01,956906,Staff,6,0,25,19
1746583115427,CAT 125RS,A01,922013,Staff,6,0,25,19
1746583116452,CLRE 250,A00,891860,Morris; Sheldon,9995,0,9999,4
1746583118500,CLRE 251R,A00,907817,Mehta; Ravindra L.,9994,0,9999,5
1746583119528,CLRE 252,A00,891864,Cuomo; Raphael Eduardo,9993,0,9999,6
1746583120553,CLRE 253,A00,891867,Vaida; Florin,9994,0,9999,5
1746583120553,CLRE 253,B00,907819,Staff,9999,0,9999,0
1746583121578,CLRE 259,A00,891868,Patel; Hemal,9998,0,9999,1
1746583122602,CLRE 260,A00,891872,Cuomo; Raphael Eduardo,9999,0,9999,0
1746583123627,CLRE 297,001,891888,Cuomo; Raphael Eduardo,9999,0,9999,0
1746583124655,CSE 191,A00,958773,Minnes Kemp; Mor Mia,9995,0,9999,4
1746583125685,CSE 197,001,959846,Minnes Kemp; Mor Mia,9990,0,9999,9
1746583126714,CSS 201S,A01,892054,Mignozzetti; Umberto,25,0,30,5
1746583127742,CSS 202S,A01,892056,Mignozzetti; Umberto,25,0,30,5
1746583128766,DSC 197,001,956898,Eldridge; Justin Matthew,9996,0,9999,3
1746583129795,DSC 297,001,958000,Mazumdar; Arya,9998,0,9999,1
1746583129795,DSC 297,002,959862,Wang; Yusu,9998,0,9999,1
1746583130824,EAP 100,A00,905686,Staff,9778,0,9999,221
1746583131850,ECE 45,A01,892618,Staff,0,0,65,65
1746583133903,ECE 111,A01,892719,Staff,6,0,65,59
1746583134928,ECE 197,001,957920,Mercier; Patrick Philip,9991,0,9999,8
1746583135954,ECON 178,A01,907814,Zhu; Ying,26,0,35,9
1746583136981,EDS 115,A00,895312,Staff,35,0,45,10
1746583138005,EDS 117,A01,895337,Staff,23,0,30,7
1746583139032,EDS 125,A00,895341,Jones; Gabrielle Anastasia,36,0,45,9
1746583140060,EDS 128A,A01,895459,Fargason; Sharon Gayle,44,0,45,1
1746583141087,EDS 128B,A01,895543,Pappas; Elizabeth,44,0,45,1
1746583142114,EDS 139,A00,897203,Pappas; Elizabeth,44,0,45,1
1746583142114,EDS 139,B00,897209,Fargason; Sharon Gayle,41,0,45,4
1746583143139,EDS 201,A00,895545,Staff,22,0,45,23
1746583144167,EDS 203,A01,895581,Halter; Christopher P.,22,0,45,23
1746583145192,EDS 204R,A01,895625,Heinzman; Erica M.,39,0,45,6
1746583145192,EDS 204R,B01,895693,Halter; Christopher P.,10,0,45,35
1746583146218,EDS 206R,A00,895694,Fargason; Sharon Gayle,1,0,30,29
1746583146218,EDS 206R,B00,895695,Choi; Bailey Miyeon,16,0,30,14
1746583147244,EDS 250,A00,895697,Hemans; Patricia Ann Benitez,22,0,45,23
1746583148269,EDS 281,A00,895701,Meyerott; Theresa Ann,1,0,15,14
1746583149295,EDS 284,A00,895736,Meyerott; Theresa Ann,1,0,15,14
1746583150324,EDS 286,A00,897210,Fine; Sarah,0,0,15,15
1746583151350,EDS 289C,A01,895770,Daly; Alan J.,1,0,15,14
1746583152378,EDS 290,A00,897211,Hofstetter; Carolyn,0,0,15,15
1746583153404,LIGM 5A,A00,896162,Fischer-Grunski; Eva K,12,0,20,8
1746583154433,LIGM 5B,A00,896260,Fischer-Grunski; Eva K,17,0,20,3
1746583155463,LIGM 5C,A00,896308,Fischer-Grunski; Eva K,18,0,20,2
1746583156488,LIIT 5AS,A00,896313,Carnelos; Chiara,18,0,20,2
1746583157516,LIIT 5BS,A00,896416,Carnelos; Chiara,20,0,20,0
1746583158546,LIIT 5CS,A00,896564,Carnelos; Chiara,20,0,20,0
1746583159572,LISP 5A,A00,896588,Munoz Sanchez; Alicia,2,0,20,18
1746583160601,LISP 5B,A00,896653,Munoz Sanchez; Alicia,7,0,20,13
1746583161630,LISP 5C,A00,896655,Munoz Sanchez; Alicia,0,1,20,20
1746583162657,MAE 197,001,957918,Kleissl; Jan,9996,0,9999,3
1746583162657,MAE 197,002,959806,Boechler; Nicholas Sebastia,9998,0,9999,1
1746583162657,MAE 197,003,959852,Mullin; Jennifer S,9998,0,9999,1
1746583163683,MATH 2,A01,957937,Staff,33,0,35,2
1746583164712,MATH 197,001,957876,Kedlaya; Kiran S.,9993,0,9999,6
1746583165736,MCWP 40,A00,892729,Duru; Nur,10,0,20,10
1746583165736,MCWP 40,B00,893304,Montejo; Carolina,14,0,20,6
1746583166764,MCWP 40R,A00,893757,Redela; Pamela Morgan,0,5,20,20
1746583167788,MCWP 50,A00,893758,Morshed; Michael James,0,0,20,20
1746583167788,MCWP 50,B00,893761,Bartulis; Jason Michael,17,0,20,3
1746583168816,MCWP 50R,A00,893766,Compas; Sean Matthew,0,1,20,20
1746583168816,MCWP 50R,B00,893769,Carter; Jennifer A,0,1,20,20
1746583168816,MCWP 50R,C00,893771,Krone; Jarret,0,3,20,20
1746583168816,MCWP 50R,D00,893772,Miller; Elizabeth Deen,0,0,20,20
1746583168816,MCWP 50R,E00,893775,Carter; Andrea L,0,1,20,20
1746583169841,MMW 11R,A01,892721,Herbst; Matthew,14,0,30,16
1746583169841,MMW 11R,A02,892722,Herbst; Matthew,0,0,0,3
1746583170866,MMW 12R,A01,892724,Herbst; Matthew,0,11,16,16
1746583170866,MMW 12R,A02,892725,Herbst; Matthew,0,10,16,16
1746583171892,MMW 13R,A01,892727,Staff,0,4,16,16
1746583171892,MMW 13R,A02,892728,Staff,0,4,16,16
1746583171892,MMW 13R,A03,958032,Staff,0,4,16,16
1746583171892,MMW 13R,A04,958033,Staff,0,4,16,16
1746583171892,MMW 13R,A05,958034,Staff,0,4,16,16
1746583172919,SIO 295LS,A00,894015,Staff,5,0,25,20
1746583173946,SIO 295S,A00,894020,Staff,5,0,25,20
1746583174979,SIOC 290S,B01,958918,Merrifield; Mark A,14,0,30,16
1746583176008,SIOC 291S,B01,958922,Gabriel; Corey John,14,0,30,16
1746583177037,SOCI 117,A01,895339,Staff,3,0,5,2
1746583178062,WES 237B,A00,894149,Staff,11,0,20,9
1746583180125,AESE 279B,A00,891859,Staff,13,0,35,22
1746583181150,AIP 197,001,891854,Vespa; Emanuel Ignacio,9999,0,9999,0
1746583182179,ANTH 289S,A00,891856,Gagneux; Pascal,12,0,12,0
1746583183207,BENG 196,001,957946,Engler; Adam J.,9996,0,9999,3
1746583184233,BISP 197,001,959851,Wilhelm; James E.,9998,0,9999,1
1746583185258,CAT 124RS,A01,956906,Staff,6,0,25,19
1746583186283,CAT 125RS,A01,922013,Staff,6,0,25,19
1746583187349,CLRE 250,A00,891860,Morris; Sheldon,9995,0,9999,4
1746583189397,CLRE 251R,A00,907817,Mehta; Ravindra L.,9994,0,9999,5
1746583190423,CLRE 252,A00,891864,Cuomo; Raphael Eduardo,9993,0,9999,6
1746583191447,CLRE 253,A00,891867,Vaida; Florin,9994,0,9999,5
1746583191447,CLRE 253,B00,907819,Staff,9999,0,9999,0
1746583192474,CLRE 259,A00,891868,Patel; Hemal,9998,0,9999,1
1746583193499,CLRE 260,A00,891872,Cuomo; Raphael Eduardo,9999,0,9999,0
1746583194526,CLRE 297,001,891888,Cuomo; Raphael Eduardo,9999,0,9999,0
1746583195551,CSE 191,A00,958773,Minnes Kemp; Mor Mia,9995,0,9999,4
1746583196578,CSE 197,001,959846,Minnes Kemp; Mor Mia,9990,0,9999,9
1746583197605,CSS 201S,A01,892054,Mignozzetti; Umberto,25,0,30,5
1746583198634,CSS 202S,A01,892056,Mignozzetti; Umberto,25,0,30,5
1746583199662,DSC 197,001,956898,Eldridge; Justin Matthew,9996,0,9999,3
1746583200690,DSC 297,001,958000,Mazumdar; Arya,9998,0,9999,1
1746583200690,DSC 297,002,959862,Wang; Yusu,9998,0,9999,1
1746583201734,EAP 100,A00,905686,Staff,9778,0,9999,221
1746583202760,ECE 45,A01,892618,Staff,0,0,65,65
1746583204813,ECE 111,A01,892719,Staff,6,0,65,59
1746583205838,ECE 197,001,957920,Mercier; Patrick Philip,9991,0,9999,8
1746583206868,ECON 178,A01,907814,Zhu; Ying,26,0,35,9
1746583207893,EDS 115,A00,895312,Staff,35,0,45,10
1746583208919,EDS 117,A01,895337,Staff,23,0,30,7
1746583209944,EDS 125,A00,895341,Jones; Gabrielle Anastasia,36,0,45,9
1746583210969,EDS 128A,A01,895459,Fargason; Sharon Gayle,44,0,45,1
1746583211995,EDS 128B,A01,895543,Pappas; Elizabeth,44,0,45,1
1746583213020,EDS 139,A00,897203,Pappas; Elizabeth,44,0,45,1
1746583213020,EDS 139,B00,897209,Fargason; Sharon Gayle,41,0,45,4
1746583214047,EDS 201,A00,895545,Staff,22,0,45,23
1746583215070,EDS 203,A01,895581,Halter; Christopher P.,22,0,45,23
1746583216095,EDS 204R,A01,895625,Heinzman; Erica M.,39,0,45,6
1746583216095,EDS 204R,B01,895693,Halter; Christopher P.,10,0,45,35
1746583217123,EDS 206R,A00,895694,Fargason; Sharon Gayle,1,0,30,29
1746583217123,EDS 206R,B00,895695,Choi; Bailey Miyeon,16,0,30,14
1746583218149,EDS 250,A00,895697,Hemans; Patricia Ann Benitez,22,0,45,23
1746583219175,EDS 281,A00,895701,Meyerott; Theresa Ann,1,0,15,14
1746583220202,EDS 284,A00,895736,Meyerott; Theresa Ann,1,0,15,14
1746583221230,EDS 286,A00,897210,Fine; Sarah,0,0,15,15
1746583222255,EDS 289C,A01,895770,Daly; Alan J.,1,0,15,14
1746583223280,EDS 290,A00,897211,Hofstetter; Carolyn,0,0,15,15
1746583224309,LIGM 5A,A00,896162,Fischer-Grunski; Eva K,12,0,20,8
1746583225338,LIGM 5B,A00,896260,Fischer-Grunski; Eva K,17,0,20,3
1746583226365,LIGM 5C,A00,896308,Fischer-Grunski; Eva K,18,0,20,2
1746583227393,LIIT 5AS,A00,896313,Carnelos; Chiara,18,0,20,2
1746583228419,LIIT 5BS,A00,896416,Carnelos; Chiara,20,0,20,0
1746583229445,LIIT 5CS,A00,896564,Carnelos; Chiara,20,0,20,0
1746583230469,LISP 5A,A00,896588,Munoz Sanchez; Alicia,2,0,20,18
1746583231492,LISP 5B,A00,896653,Munoz Sanchez; Alicia,7,0,20,13
1746583232518,LISP 5C,A00,896655,Munoz Sanchez; Alicia,0,1,20,20
1746583233545,MAE 197,001,957918,Kleissl; Jan,9996,0,9999,3
1746583233545,MAE 197,002,959806,Boechler; Nicholas Sebastia,9998,0,9999,1
1746583233545,MAE 197,003,959852,Mullin; Jennifer S,9998,0,9999,1
1746583234572,MATH 2,A01,957937,Staff,33,0,35,2
1746583235596,MATH 197,001,957876,Kedlaya; Kiran S.,9993,0,9999,6
1746583236621,MCWP 40,A00,892729,Duru; Nur,10,0,20,10
1746583236621,MCWP 40,B00,893304,Montejo; Carolina,14,0,20,6
1746583237662,MCWP 40R,A00,893757,Redela; Pamela Morgan,0,5,20,20
1746583238690,MCWP 50,A00,893758,Morshed; Michael James,0,0,20,20
1746583238690,MCWP 50,B00,893761,Bartulis; Jason Michael,17,0,20,3
1746583239715,MCWP 50R,A00,893766,Compas; Sean Matthew,0,1,20,20
1746583239715,MCWP 50R,B00,893769,Carter; Jennifer A,0,1,20,20
1746583239715,MCWP 50R,C00,893771,Krone; Jarret,0,3,20,20
1746583239715,MCWP 50R,D00,893772,Miller; Elizabeth Deen,0,0,20,20
1746583239715,MCWP 50R,E00,893775,Carter; Andrea L,0,1,20,20
1746583240739,MMW 11R,A01,892721,Herbst; Matthew,14,0,30,16
1746583240739,MMW 11R,A02,892722,Herbst; Matthew,0,0,0,3
1746583241764,MMW 12R,A01,892724,Herbst; Matthew,0,11,16,16
1746583241764,MMW 12R,A02,892725,Herbst; Matthew,0,10,16,16
1746583242790,MMW 13R,A01,892727,Staff,0,4,16,16
1746583242790,MMW 13R,A02,892728,Staff,0,4,16,16
1746583242790,MMW 13R,A03,958032,Staff,0,4,16,16
1746583242790,MMW 13R,A04,958033,Staff,0,4,16,16
1746583242790,MMW 13R,A05,958034,Staff,0,4,16,16
1746583243814,SIO 295LS,A00,894015,Staff,5,0,25,20
1746583244841,SIO 295S,A00,894020,Staff,5,0,25,20
1746583245864,SIOC 290S,B01,958918,Merrifield; Mark A,14,0,30,16
1746583246894,SIOC 291S,B01,958922,Gabriel; Corey John,14,0,30,16
1746583247920,SOCI 117,A01,895339,Staff,3,0,5,2
1746583248947,WES 237B,A00,894149,Staff,11,0,20,9
1746583251008,AESE 279B,A00,891859,Staff,13,0,35,22
1746583252037,AIP 197,001,891854,Vespa; Emanuel Ignacio,9999,0,9999,0
1746583253064,ANTH 289S,A00,891856,Gagneux; Pascal,12,0,12,0
1746583254090,BENG 196,001,957946,Engler; Adam J.,9996,0,9999,3
1746583255115,BISP 197,001,959851,Wilhelm; James E.,9998,0,9999,1
1746583256142,CAT 124RS,A01,956906,Staff,6,0,25,19
1746583257165,CAT 125RS,A01,922013,Staff,6,0,25,19
1746583258194,CLRE 250,A00,891860,Morris; Sheldon,9995,0,9999,4
1746583260261,CLRE 251R,A00,907817,Mehta; Ravindra L.,9994,0,9999,5
1746583261287,CLRE 252,A00,891864,Cuomo; Raphael Eduardo,9993,0,9999,6
1746583262314,CLRE 253,A00,891867,Vaida; Florin,9994,0,9999,5
1746583262314,CLRE 253,B00,907819,Staff,9999,0,9999,0
1746583263339,CLRE 259,A00,891868,Patel; Hemal,9998,0,9999,1
1746583264362,CLRE 260,A00,891872,Cuomo; Raphael Eduardo,9999,0,9999,0
1746583265392,CLRE 297,001,891888,Cuomo; Raphael Eduardo,9999,0,9999,0
1746583266425,CSE 191,A00,958773,Minnes Kemp; Mor Mia,9995,0,9999,4
1746583267449,CSE 197,001,959846,Minnes Kemp; Mor Mia,9990,0,9999,9
1746583268478,CSS 201S,A01,892054,Mignozzetti; Umberto,25,0,30,5
1746583269507,CSS 202S,A01,892056,Mignozzetti; Umberto,25,0,30,5
1746583270558,DSC 197,001,956898,Eldridge; Justin Matthew,9996,0,9999,3
1746583271586,DSC 297,001,958000,Mazumdar; Arya,9998,0,9999,1
1746583271586,DSC 297,002,959862,Wang; Yusu,9998,0,9999,1
1746583272625,EAP 100,A00,905686,Staff,9778,0,9999,221
1746583273653,ECE 45,A01,892618,Staff,0,0,65,65
1746583275707,ECE 111,A01,892719,Staff,6,0,65,59
1746583276736,ECE 197,001,957920,Mercier; Patrick Philip,9991,0,9999,8
1746583277764,ECON 178,A01,907814,Zhu; Ying,26,0,35,9
1746583278789,EDS 115,A00,895312,Staff,35,0,45,10
1746583279816,EDS 117,A01,895337,Staff,23,0,30,7
1746583280842,EDS 125,A00,895341,Jones; Gabrielle Anastasia,36,0,45,9
1746583281869,EDS 128A,A01,895459,Fargason; Sharon Gayle,44,0,45,1
1746583282894,EDS 128B,A01,895543,Pappas; Elizabeth,44,0,45,1
1746583283923,EDS 139,A00,897203,Pappas; Elizabeth,44,0,45,1
1746583283923,EDS 139,B00,897209,Fargason; Sharon Gayle,41,0,45,4
1746583284951,EDS 201,A00,895545,Staff,22,0,45,23
1746583285976,EDS 203,A01,895581,Halter; Christopher P.,22,0,45,23
1746583287005,EDS 204R,A01,895625,Heinzman; Erica M.,39,0,45,6
1746583287005,EDS 204R,B01,895693,Halter; Christopher P.,10,0,45,35
1746583288034,EDS 206R,A00,895694,Fargason; Sharon Gayle,1,0,30,29
1746583288034,EDS 206R,B00,895695,Choi; Bailey Miyeon,16,0,30,14
1746583289061,EDS 250,A00,895697,Hemans; Patricia Ann Benitez,22,0,45,23
1746583290088,EDS 281,A00,895701,Meyerott; Theresa Ann,1,0,15,14
1746583291154,EDS 284,A00,895736,Meyerott; Theresa Ann,1,0,15,14
1746583292181,EDS 286,A00,897210,Fine; Sarah,0,0,15,15
1746583293212,EDS 289C,A01,895770,Daly; Alan J.,1,0,15,14
1746583294238,EDS 290,A00,897211,Hofstetter; Carolyn,0,0,15,15
1746583295268,LIGM 5A,A00,896162,Fischer-Grunski; Eva K,12,0,20,8
1746583296294,LIGM 5B,A00,896260,Fischer-Grunski; Eva K,17,0,20,3
1746583297323,LIGM 5C,A00,896308,Fischer-Grunski; Eva K,18,0,20,2
1746583298353,LIIT 5AS,A00,896313,Carnelos; Chiara,18,0,20,2
1746583299382,LIIT 5BS,A00,896416,Carnelos; Chiara,20,0,20,0
1746583300411,LIIT 5CS,A00,896564,Carnelos; Chiara,20,0,20,0
1746583301439,LISP 5A,A00,896588,Munoz Sanchez; Alicia,2,0,20,18
1746583302465,LISP 5B,A00,896653,Munoz Sanchez; Alicia,7,0,20,13
1746583303494,LISP 5C,A00,896655,Munoz Sanchez; Alicia,0,1,20,20
1746583304519,MAE 197,001,957918,Kleissl; Jan,9996,0,9999,3
1746583304519,MAE 197,002,959806,Boechler; Nicholas Sebastia,9998,0,9999,1
1746583304519,MAE 197,003,959852,Mullin; Jennifer S,9998,0,9999,1
1746583305547,MATH 2,A01,957937,Staff,33,0,35,2
1746583306572,MATH 197,001,957876,Kedlaya; Kiran S.,9993,0,9999,6
1746583307599,MCWP 40,A00,892729,Duru; Nur,10,0,20,10
1746583307599,MCWP 40,B00,893304,Montejo; Carolina,14,0,20,6
1746583308628,MCWP 40R,A00,893757,Redela; Pamela Morgan,0,5,20,20
1746583309653,MCWP 50,A00,893758,Morshed; Michael James,0,0,20,20
1746583309653,MCWP 50,B00,893761,Bartulis; Jason Michael,17,0,20,3
1746583310681,MCWP 50R,A00,893766,Compas; Sean Matthew,0,1,20,20
1746583310681,MCWP 50R,B00,893769,Carter; Jennifer A,0,1,20,20
1746583310681,MCWP 50R,C00,893771,Krone; Jarret,0,3,20,20
1746583310681,MCWP 50R,D00,893772,Miller; Elizabeth Deen,0,0,20,20
1746583310681,MCWP 50R,E00,893775,Carter; Andrea L,0,1,20,20
1746583311707,MMW 11R,A01,892721,Herbst; Matthew,14,0,30,16
1746583311707,MMW 11R,A02,892722,Herbst; Matthew,0,0,0,3
1746583312734,MMW 12R,A01,892724,Herbst; Matthew,0,11,16,16
1746583312734,MMW 12R,A02,892725,Herbst; Matthew,0,10,16,16
1746583313759,MMW 13R,A01,892727,Staff,0,4,16,16
1746583313759,MMW 13R,A02,892728,Staff,0,4,16,16
1746583313759,MMW 13R,A03,958032,Staff,0,4,16,16
1746583313759,MMW 13R,A04,958033,Staff,0,4,16,16
1746583313759,MMW 13R,A05,958034,Staff,0,4,16,16
1746583314783,SIO 295LS,A00,894015,Staff,5,0,25,20
1746583315810,SIO 295S,A00,894020,Staff,5,0,25,20
1746583316835,SIOC 290S,B01,958918,Merrifield; Mark A,14,0,30,16
1746583317862,SIOC 291S,B01,958922,Gabriel; Corey John,14,0,30,16
1746583318889,SOCI 117,A01,895339,Staff,3,0,5,2
1746583319916,WES 237B,A00,894149,Staff,11,0,20,9
1746583321982,AESE 279B,A00,891859,Staff,13,0,35,22
1746583323009,AIP 197,001,891854,Vespa; Emanuel Ignacio,9999,0,9999,0
1746583324038,ANTH 289S,A00,891856,Gagneux; Pascal,12,0,12,0
1746583325064,BENG 196,001,957946,Engler; Adam J.,9996,0,9999,3
1746583326090,BISP 197,001,959851,Wilhelm; James E.,9998,0,9999,1
1746583327118,CAT 124RS,A01,956906,Staff,6,0,25,19
1746583328146,CAT 125RS,A01,922013,Staff,6,0,25,19
1746583329171,CLRE 250,A00,891860,Morris; Sheldon,9995,0,9999,4
1746583331222,CLRE 251R,A00,907817,Mehta; Ravindra L.,9994,0,9999,5
1746583332247,CLRE 252,A00,891864,Cuomo; Raphael Eduardo,9993,0,9999,6
1746583333272,CLRE 253,A00,891867,Vaida; Florin,9994,0,9999,5
1746583333272,CLRE 253,B00,907819,Staff,9999,0,9999,0
1746583334299,CLRE 259,A00,891868,Patel; Hemal,9998,0,9999,1
1746583335325,CLRE 260,A00,891872,Cuomo; Raphael Eduardo,9999,0,9999,0
1746583336350,CLRE 297,001,891888,Cuomo; Raphael Eduardo,9999,0,9999,0
1746583337376,CSE 191,A00,958773,Minnes Kemp; Mor Mia,9995,0,9999,4
1746583338404,CSE 197,001,959846,Minnes Kemp; Mor Mia,9990,0,9999,9
1746583339429,CSS 201S,A01,892054,Mignozzetti; Umberto,25,0,30,5
1746583340458,CSS 202S,A01,892056,Mignozzetti; Umberto,25,0,30,5
1746583341482,DSC 197,001,956898,Eldridge; Justin Matthew,9996,0,9999,3
1746583342508,DSC 297,001,958000,Mazumdar; Arya,9998,0,9999,1
1746583342508,DSC 297,002,959862,Wang; Yusu,9998,0,9999,1
1746583343533,EAP 100,A00,905686,Staff,9778,0,9999,221
1746583344557,ECE 45,A01,892618,Staff,0,0,65,65
1746583346614,ECE 111,A01,892719,Staff,6,0,65,59
1746583347641,ECE 197,001,957920,Mercier; Patrick Philip,9991,0,9999,8
1746583348675,ECON 178,A01,907814,Zhu; Ying,26,0,35,9
1746583349701,EDS 115,A00,895312,Staff,35,0,45,10
1746583350731,EDS 117,A01,895337,Staff,23,0,30,7
1746583351760,EDS 125,A00,895341,Jones; Gabrielle Anastasia,36,0,45,9
1746583352784,EDS 128A,A01,895459,Fargason; Sharon Gayle,44,0,45,1
1746583353810,EDS 128B,A01,895543,Pappas; Elizabeth,44,0,45,1
1746583354838,EDS 139,A00,897203,Pappas; Elizabeth,44,0,45,1
1746583354838,EDS 139,B00,897209,Fargason; Sharon Gayle,41,0,45,4
1746583355863,EDS 201,A00,895545,Staff,22,0,45,23
1746583356887,EDS 203,A01,895581,Halter; Christopher P.,22,0,45,23
1746583357913,EDS 204R,A01,895625,Heinzman; Erica M.,39,0,45,6
1746583357913,EDS 204R,B01,895693,Halter; Christopher P.,10,0,45,35
1746583358939,EDS 206R,A00,895694,Fargason; Sharon Gayle,1,0,30,29
1746583358939,EDS 206R,B00,895695,Choi; Bailey Miyeon,16,0,30,14
1746583359964,EDS 250,A00,895697,Hemans; Patricia Ann Benitez,22,0,45,23
1746583360989,EDS 281,A00,895701,Meyerott; Theresa Ann,1,0,15,14
1746583362017,EDS 284,A00,895736,Meyerott; Theresa Ann,1,0,15,14
1746583363043,EDS 286,A00,897210,Fine; Sarah,0,0,15,15
1746583364067,EDS 289C,A01,895770,Daly; Alan J.,1,0,15,14
1746583365093,EDS 290,A00,897211,Hofstetter; Carolyn,0,0,15,15
1746583366119,LIGM 5A,A00,896162,Fischer-Grunski; Eva K,12,0,20,8
1746583367143,LIGM 5B,A00,896260,Fischer-Grunski; Eva K,17,0,20,3
1746583368173,LIGM 5C,A00,896308,Fischer-Grunski; Eva K,18,0,20,2
1746583369198,LIIT 5AS,A00,896313,Carnelos; Chiara,18,0,20,2
1746583370224,LIIT 5BS,A00,896416,Carnelos; Chiara,20,0,20,0
1746583371250,LIIT 5CS,A00,896564,Carnelos; Chiara,20,0,20,0
1746583372278,LISP 5A,A00,896588,Munoz Sanchez; Alicia,2,0,20,18
1746583373303,LISP 5B,A00,896653,Munoz Sanchez; Alicia,7,0,20,13
1746583374332,LISP 5C,A00,896655,Munoz Sanchez; Alicia,0,1,20,20
1746583375360,MAE 197,001,957918,Kleissl; Jan,9996,0,9999,3
1746583375360,MAE 197,002,959806,Boechler; Nicholas Sebastia,9998,0,9999,1
1746583375360,MAE 197,003,959852,Mullin; Jennifer S,9998,0,9999,1
1746583376388,MATH 2,A01,957937,Staff,33,0,35,2
1746583377415,MATH 197,001,957876,Kedlaya; Kiran S.,9993,0,9999,6
1746583378444,MCWP 40,A00,892729,Duru; Nur,10,0,20,10
1746583378444,MCWP 40,B00,893304,Montejo; Carolina,14,0,20,6
1746583379468,MCWP 40R,A00,893757,Redela; Pamela Morgan,0,5,20,20
1746583380497,MCWP 50,A00,893758,Morshed; Michael James,0,0,20,20
1746583380497,MCWP 50,B00,893761,Bartulis; Jason Michael,17,0,20,3
1746583381525,MCWP 50R,A00,893766,Compas; Sean Matthew,0,1,20,20
1746583381525,MCWP 50R,B00,893769,Carter; Jennifer A,0,1,20,20
1746583381525,MCWP 50R,C00,893771,Krone; Jarret,0,3,20,20
1746583381525,MCWP 50R,D00,893772,Miller; Elizabeth Deen,0,0,20,20
1746583381525,MCWP 50R,E00,893775,Carter; Andrea L,0,1,20,20
1746583382553,MMW 11R,A01,892721,Herbst; Matthew,14,0,30,16
1746583382553,MMW 11R,A02,892722,Herbst; Matthew,0,0,0,3
1746583383579,MMW 12R,A01,892724,Herbst; Matthew,0,11,16,16
1746583383579,MMW 12R,A02,892725,Herbst; Matthew,0,10,16,16
1746583384605,MMW 13R,A01,892727,Staff,0,4,16,16
1746583384605,MMW 13R,A02,892728,Staff,0,4,16,16
1746583384605,MMW 13R,A03,958032,Staff,0,4,16,16
1746583384605,MMW 13R,A04,958033,Staff,0,4,16,16
1746583384605,MMW 13R,A05,958034,Staff,0,4,16,16
1746583385633,SIO 295LS,A00,894015,Staff,5,0,25,20
1746583386659,SIO 295S,A00,894020,Staff,5,0,25,20
1746583387688,SIOC 290S,B01,958918,Merrifield; Mark A,14,0,30,16
1746583388713,SIOC 291S,B01,958922,Gabriel; Corey John,14,0,30,16
1746583389740,SOCI 117,A01,895339,Staff,3,0,5,2
1746583390765,WES 237B,A00,894149,Staff,11,0,20,9
1746583392816,AESE 279B,A00,891859,Staff,13,0,35,22
1746583393841,AIP 197,001,891854,Vespa; Emanuel Ignacio,9999,0,9999,0
1746583394905,ANTH 289S,A00,891856,Gagneux; Pascal,12,0,12,0
1746583395934,BENG 196,001,957946,Engler; Adam J.,9996,0,9999,3
1746583396960,BISP 197,001,959851,Wilhelm; James E.,9998,0,9999,1
1746583397985,CAT 124RS,A01,956906,Staff,6,0,25,19
1746583399013,CAT 125RS,A01,922013,Staff,6,0,25,19
1746583400043,CLRE 250,A00,891860,Morris; Sheldon,9995,0,9999,4
1746583402099,CLRE 251R,A00,907817,Mehta; Ravindra L.,9994,0,9999,5
1746583403124,CLRE 252,A00,891864,Cuomo; Raphael Eduardo,9993,0,9999,6
1746583404154,CLRE 253,A00,891867,Vaida; Florin,9994,0,9999,5
1746583404154,CLRE 253,B00,907819,Staff,9999,0,9999,0
1746583405181,CLRE 259,A00,891868,Patel; Hemal,9998,0,9999,1
1746583406205,CLRE 260,A00,891872,Cuomo; Raphael Eduardo,9999,0,9999,0
1746583407234,CLRE 297,001,891888,Cuomo; Raphael Eduardo,9999,0,9999,0
1746583408258,CSE 191,A00,958773,Minnes Kemp; Mor Mia,9995,0,9999,4
1746583409287,CSE 197,001,959846,Minnes Kemp; Mor Mia,9990,0,9999,9
1746583410316,CSS 201S,A01,892054,Mignozzetti; Umberto,25,0,30,5
1746583411345,CSS 202S,A01,892056,Mignozzetti; Umberto,25,0,30,5
1746583412373,DSC 197,001,956898,Eldridge; Justin Matthew,9996,0,9999,3
1746583413398,DSC 297,001,958000,Mazumdar; Arya,9998,0,9999,1
1746583413398,DSC 297,002,959862,Wang; Yusu,9998,0,9999,1
1746583414423,EAP 100,A00,905686,Staff,9778,0,9999,221
1746583415449,ECE 45,A01,892618,Staff,0,0,65,65
1746583417506,ECE 111,A01,892719,Staff,6,0,65,59
1746583418532,ECE 197,001,957920,Mercier; Patrick Philip,9991,0,9999,8
1746583419562,ECON 178,A01,907814,Zhu; Ying,26,0,35,9
1746583420588,EDS 115,A00,895312,Staff,35,0,45,10
1746583421617,EDS 117,A01,895337,Staff,23,0,30,7
1746583422645,EDS 125,A00,895341,Jones; Gabrielle Anastasia,36,0,45,9
1746583423675,EDS 128A,A01,895459,Fargason; Sharon Gayle,44,0,45,1
1746583424700,EDS 128B,A01,895543,Pappas; Elizabeth,44,0,45,1
1746583425727,EDS 139,A00,897203,Pappas; Elizabeth,44,0,45,1
1746583425727,EDS 139,B00,897209,Fargason; Sharon Gayle,41,0,45,4
1746583426756,EDS 201,A00,895545,Staff,22,0,45,23
1746583427783,EDS 203,A01,895581,Halter; Christopher P.,22,0,45,23
1746583428812,EDS 204R,A01,895625,Heinzman; Erica M.,39,0,45,6
1746583428812,EDS 204R,B01,895693,Halter; Christopher P.,10,0,45,35
1746583429840,EDS 206R,A00,895694,Fargason; Sharon Gayle,1,0,30,29
1746583429840,EDS 206R,B00,895695,Choi; Bailey Miyeon,16,0,30,14
1746583430867,EDS 250,A00,895697,Hemans; Patricia Ann Benitez,22,0,45,23
1746583431896,EDS 281,A00,895701,Meyerott; Theresa Ann,1,0,15,14
1746583432921,EDS 284,A00,895736,Meyerott; Theresa Ann,1,0,15,14
1746583433950,EDS 286,A00,897210,Fine; Sarah,0,0,15,15
1746583434975,EDS 289C,A01,895770,Daly; Alan J.,1,0,15,14
1746583436000,EDS 290,A00,897211,Hofstetter; Carolyn,0,0,15,15
1746583437026,LIGM 5A,A00,896162,Fischer-Grunski; Eva K,12,0,20,8
1746583438052,LIGM 5B,A00,896260,Fischer-Grunski; Eva K,17,0,20,3
1746583439077,LIGM 5C,A00,896308,Fischer-Grunski; Eva K,18,0,20,2
1746583440101,LIIT 5AS,A00,896313,Carnelos; Chiara,18,0,20,2
1746583441127,LIIT 5BS,A00,896416,Carnelos; Chiara,20,0,20,0
1746583442157,LIIT 5CS,A00,896564,Carnelos; Chiara,20,0,20,0
1746583443186,LISP 5A,A00,896588,Munoz Sanchez; Alicia,2,0,20,18
1746583444213,LISP 5B,A00,896653,Munoz Sanchez; Alicia,7,0,20,13
1746583445239,LISP 5C,A00,896655,Munoz Sanchez; Alicia,0,1,20,20
1746583446266,MAE 197,001,957918,Kleissl; Jan,9996,0,9999,3
1746583446266,MAE 197,002,959806,Boechler; Nicholas Sebastia,9998,0,9999,1
1746583446266,MAE 197,003,959852,Mullin; Jennifer S,9998,0,9999,1
1746583447290,MATH 2,A01,957937,Staff,33,0,35,2
1746583448318,MATH 197,001,957876,Kedlaya; Kiran S.,9993,0,9999,6
1746583449343,MCWP 40,A00,892729,Duru; Nur,10,0,20,10
1746583449343,MCWP 40,B00,893304,Montejo; Carolina,14,0,20,6
1746583450366,MCWP 40R,A00,893757,Redela; Pamela Morgan,0,5,20,20
1746583451395,MCWP 50,A00,893758,Morshed; Michael James,0,0,20,20
1746583451395,MCWP 50,B00,893761,Bartulis; Jason Michael,17,0,20,3
1746583452423,MCWP 50R,A00,893766,Compas; Sean Matthew,0,1,20,20
1746583452423,MCWP 50R,B00,893769,Carter; Jennifer A,0,1,20,20
1746583452423,MCWP 50R,C00,893771,Krone; Jarret,0,3,20,20
1746583452423,MCWP 50R,D00,893772,Miller; Elizabeth Deen,0,0,20,20
1746583452423,MCWP 50R,E00,893775,Carter; Andrea L,0,1,20,20
1746583453449,MMW 11R,A01,892721,Herbst; Matthew,14,0,30,16
1746583453449,MMW 11R,A02,892722,Herbst; Matthew,0,0,0,3
1746583454475,MMW 12R,A01,892724,Herbst; Matthew,0,11,16,16
1746583454475,MMW 12R,A02,892725,Herbst; Matthew,0,10,16,16
1746583455499,MMW 13R,A01,892727,Staff,0,4,16,16
1746583455499,MMW 13R,A02,892728,Staff,0,4,16,16
1746583455499,MMW 13R,A03,958032,Staff,0,4,16,16
1746583455499,MMW 13R,A04,958033,Staff,0,4,16,16
1746583455499,MMW 13R,A05,958034,Staff,0,4,16,16
1746583456527,SIO 295LS,A00,894015,Staff,5,0,25,20
1746583457556,SIO 295S,A00,894020,Staff,5,0,25,20
1746583458585,SIOC 290S,B01,958918,Merrifield; Mark A,14,0,30,16
1746583459610,SIOC 291S,B01,958922,Gabriel; Corey John,14,0,30,16
1746583460635,SOCI 117,A01,895339,Staff,3,0,5,2
1746583461660,WES 237B,A00,894149,Staff,11,0,20,9
1746583463729,AESE 279B,A00,891859,Staff,13,0,35,22
1746583464763,AIP 197,001,891854,Vespa; Emanuel Ignacio,9999,0,9999,0
1746583465791,ANTH 289S,A00,891856,Gagneux; Pascal,12,0,12,0
1746583466817,BENG 196,001,957946,Engler; Adam J.,9996,0,9999,3
1746583467843,BISP 197,001,959851,Wilhelm; James E.,9998,0,9999,1
1746583468869,CAT 124RS,A01,956906,Staff,6,0,25,19
1746583469894,CAT 125RS,A01,922013,Staff,6,0,25,19
1746583470919,CLRE 250,A00,891860,Morris; Sheldon,9995,0,9999,4
1746583472970,CLRE 251R,A00,907817,Mehta; Ravindra L.,9994,0,9999,5
1746583473992,CLRE 252,A00,891864,Cuomo; Raphael Eduardo,9993,0,9999,6
1746583475021,CLRE 253,A00,891867,Vaida; Florin,9994,0,9999,5
1746583475021,CLRE 253,B00,907819,Staff,9999,0,9999,0
1746583476049,CLRE 259,A00,891868,Patel; Hemal,9998,0,9999,1
1746583477074,CLRE 260,A00,891872,Cuomo; Raphael Eduardo,9999,0,9999,0
1746583478099,CLRE 297,001,891888,Cuomo; Raphael Eduardo,9999,0,9999,0
1746583479126,CSE 191,A00,958773,Minnes Kemp; Mor Mia,9995,0,9999,4
1746583480150,CSE 197,001,959846,Minnes Kemp; Mor Mia,9990,0,9999,9
1746583481175,CSS 201S,A01,892054,Mignozzetti; Umberto,25,0,30,5
1746583482203,CSS 202S,A01,892056,Mignozzetti; Umberto,25,0,30,5
1746583483229,DSC 197,001,956898,Eldridge; Justin Matthew,9996,0,9999,3
1746583484254,DSC 297,001,958000,Mazumdar; Arya,9998,0,9999,1
1746583484254,DSC 297,002,959862,Wang; Yusu,9998,0,9999,1
1746583485279,EAP 100,A00,905686,Staff,9778,0,9999,221
1746583486305,ECE 45,A01,892618,Staff,0,0,65,65
1746583488359,ECE 111,A01,892719,Staff,6,0,65,59
1746583489382,ECE 197,001,957920,Mercier; Patrick Philip,9991,0,9999,8
1746583490413,ECON 178,A01,907814,Zhu; Ying,26,0,35,9
1746583491441,EDS 115,A00,895312,Staff,35,0,45,10
1746583492466,EDS 117,A01,895337,Staff,23,0,30,7
1746583493491,EDS 125,A00,895341,Jones; Gabrielle Anastasia,36,0,45,9
1746583494520,EDS 128A,A01,895459,Fargason; Sharon Gayle,44,0,45,1
1746583495546,EDS 128B,A01,895543,Pappas; Elizabeth,44,0,45,1
1746583496571,EDS 139,A00,897203,Pappas; Elizabeth,44,0,45,1
1746583496571,EDS 139,B00,897209,Fargason; Sharon Gayle,41,0,45,4
1746583497600,EDS 201,A00,895545,Staff,22,0,45,23
1746583498626,EDS 203,A01,895581,Halter; Christopher P.,22,0,45,23
1746583499655,EDS 204R,A01,895625,Heinzman; Erica M.,39,0,45,6
1746583499655,EDS 204R,B01,895693,Halter; Christopher P.,10,0,45,35
1746583500679,EDS 206R,A00,895694,Fargason; Sharon Gayle,1,0,30,29
1746583500679,EDS 206R,B00,895695,Choi; Bailey Miyeon,16,0,30,14
1746583501707,EDS 250,A00,895697,Hemans; Patricia Ann Benitez,22,0,45,23
1746583502733,EDS 281,A00,895701,Meyerott; Theresa Ann,1,0,15,14
1746583503763,EDS 284,A00,895736,Meyerott; Theresa Ann,1,0,15,14
1746583504788,EDS 286,A00,897210,Fine; Sarah,0,0,15,15
1746583505816,EDS 289C,A01,895770,Daly; Alan J.,1,0,15,14
1746583506841,EDS 290,A00,897211,Hofstetter; Carolyn,0,0,15,15
1746583507870,LIGM 5A,A00,896162,Fischer-Grunski; Eva K,12,0,20,8
1746583508901,LIGM 5B,A00,896260,Fischer-Grunski; Eva K,17,0,20,3
1746583509931,LIGM 5C,A00,896308,Fischer-Grunski; Eva K,18,0,20,2
1746583510956,LIIT 5AS,A00,896313,Carnelos; Chiara,18,0,20,2
1746583511984,LIIT 5BS,A00,896416,Carnelos; Chiara,20,0,20,0
1746583513014,LIIT 5CS,A00,896564,Carnelos; Chiara,20,0,20,0
1746583514045,LISP 5A,A00,896588,Munoz Sanchez; Alicia,2,0,20,18
1746583515076,LISP 5B,A00,896653,Munoz Sanchez; Alicia,7,0,20,13
1746583516105,LISP 5C,A00,896655,Munoz Sanchez; Alicia,0,1,20,20
1746583517135,MAE 197,001,957918,Kleissl; Jan,9996,0,9999,3
1746583517135,MAE 197,002,959806,Boechler; Nicholas Sebastia,9998,0,9999,1
1746583517135,MAE 197,003,959852,Mullin; Jennifer S,9998,0,9999,1
1746583518159,MATH 2,A01,957937,Staff,33,0,35,2
1746583519185,MATH 197,001,957876,Kedlaya; Kiran S.,9993,0,9999,6
1746583520215,MCWP 40,A00,892729,Duru; Nur,10,0,20,10
1746583520215,MCWP 40,B00,893304,Montejo; Carolina,14,0,20,6
1746583521242,MCWP 40R,A00,893757,Redela; Pamela Morgan,0,5,20,20
1746583522266,MCWP 50,A00,893758,Morshed; Michael James,0,0,20,20
1746583522266,MCWP 50,B00,893761,Bartulis; Jason Michael,17,0,20,3
1746583523295,MCWP 50R,A00,893766,Compas; Sean Matthew,0,1,20,20
1746583523295,MCWP 50R,B00,893769,Carter; Jennifer A,0,1,20,20
1746583523295,MCWP 50R,C00,893771,Krone; Jarret,0,3,20,20
1746583523295,MCWP 50R,D00,893772,Miller; Elizabeth Deen,0,0,20,20
1746583523295,MCWP 50R,E00,893775,Carter; Andrea L,0,1,20,20
1746583524320,MMW 11R,A01,892721,Herbst; Matthew,14,0,30,16
1746583524320,MMW 11R,A02,892722,Herbst; Matthew,0,0,0,3
1746583525348,MMW 12R,A01,892724,Herbst; Matthew,0,11,16,16
1746583525348,MMW 12R,A02,892725,Herbst; Matthew,0,10,16,16
1746583526374,MMW 13R,A01,892727,Staff,0,4,16,16
1746583526374,MMW 13R,A02,892728,Staff,0,4,16,16
1746583526374,MMW 13R,A03,958032,Staff,0,4,16,16
1746583526374,MMW 13R,A04,958033,Staff,0,4,16,16
1746583526374,MMW 13R,A05,958034,Staff,0,4,16,16
1746583527403,SIO 295LS,A00,894015,Staff,5,0,25,20
1746583528429,SIO 295S,A00,894020,Staff,5,0,25,20
1746583529459,SIOC 290S,B01,958918,Merrifield; Mark A,14,0,30,16
1746583530484,SIOC 291S,B01,958922,Gabriel; Corey John,14,0,30,16
1746583531511,SOCI 117,A01,895339,Staff,3,0,5,2
1746583532537,WES 237B,A00,894149,Staff,11,0,20,9
1746583534599,AESE 279B,A00,891859,Staff,13,0,35,22
1746583535624,AIP 197,001,891854,Vespa; Emanuel Ignacio,9999,0,9999,0
1746583536653,ANTH 289S,A00,891856,Gagneux; Pascal,12,0,12,0
1746583537677,BENG 196,001,957946,Engler; Adam J.,9996,0,9999,3
1746583538702,BISP 197,001,959851,Wilhelm; James E.,9998,0,9999,1
1746583539728,CAT 124RS,A01,956906,Staff,6,0,25,19
1746583540757,CAT 125RS,A01,922013,Staff,6,0,25,19
1746583541782,CLRE 250,A00,891860,Morris; Sheldon,9995,0,9999,4
1746583543836,CLRE 251R,A00,907817,Mehta; Ravindra L.,9994,0,9999,5
1746583544863,CLRE 252,A00,891864,Cuomo; Raphael Eduardo,9993,0,9999,6
1746583545889,CLRE 253,A00,891867,Vaida; Florin,9994,0,9999,5
1746583545889,CLRE 253,B00,907819,Staff,9999,0,9999,0
1746583546915,CLRE 259,A00,891868,Patel; Hemal,9998,0,9999,1
1746583547942,CLRE 260,A00,891872,Cuomo; Raphael Eduardo,9999,0,9999,0
1746583548970,CLRE 297,001,891888,Cuomo; Raphael Eduardo,9999,0,9999,0
1746583549996,CSE 191,A00,958773,Minnes Kemp; Mor Mia,9995,0,9999,4
1746583551021,CSE 197,001,959846,Minnes Kemp; Mor Mia,9990,0,9999,9
1746583552053,CSS 201S,A01,892054,Mignozzetti; Umberto,25,0,30,5
1746583553079,CSS 202S,A01,892056,Mignozzetti; Umberto,25,0,30,5
1746583554106,DSC 197,001,956898,Eldridge; Justin Matthew,9996,0,9999,3
1746583555130,DSC 297,001,958000,Mazumdar; Arya,9998,0,9999,1
1746583555130,DSC 297,002,959862,Wang; Yusu,9998,0,9999,1
1746583556158,EAP 100,A00,905686,Staff,9778,0,9999,221
1746583557186,ECE 45,A01,892618,Staff,0,0,65,65
1746583559239,ECE 111,A01,892719,Staff,6,0,65,59
1746583560264,ECE 197,001,957920,Mercier; Patrick Philip,9991,0,9999,8
1746583561291,ECON 178,A01,907814,Zhu; Ying,26,0,35,9
1746583562316,EDS 115,A00,895312,Staff,35,0,45,10
1746583563342,EDS 117,A01,895337,Staff,23,0,30,7
1746583564367,EDS 125,A00,895341,Jones; Gabrielle Anastasia,36,0,45,9
1746583565393,EDS 128A,A01,895459,Fargason; Sharon Gayle,44,0,45,1
1746583566419,EDS 128B,A01,895543,Pappas; Elizabeth,44,0,45,1
1746583567444,EDS 139,A00,897203,Pappas; Elizabeth,44,0,45,1
1746583567444,EDS 139,B00,897209,Fargason; Sharon Gayle,41,0,45,4
1746583568469,EDS 201,A00,895545,Staff,22,0,45,23
1746583569495,EDS 203,A01,895581,Halter; Christopher P.,22,0,45,23
1746583570520,EDS 204R,A01,895625,Heinzman; Erica M.,39,0,45,6
1746583570520,EDS 204R,B01,895693,Halter; Christopher P.,10,0,45,35
1746583571549,EDS 206R,A00,895694,Fargason; Sharon Gayle,1,0,30,29
1746583571549,EDS 206R,B00,895695,Choi; Bailey Miyeon,16,0,30,14
1746583572574,EDS 250,A00,895697,Hemans; Patricia Ann Benitez,22,0,45,23
1746583573600,EDS 281,A00,895701,Meyerott; Theresa Ann,1,0,15,14
1746583574625,EDS 284,A00,895736,Meyerott; Theresa Ann,1,0,15,14
1746583575650,EDS 286,A00,897210,Fine; Sarah,0,0,15,15
1746583576678,EDS 289C,A01,895770,Daly; Alan J.,1,0,15,14
1746583577705,EDS 290,A00,897211,Hofstetter; Carolyn,0,0,15,15
1746583578731,LIGM 5A,A00,896162,Fischer-Grunski; Eva K,12,0,20,8
1746583579757,LIGM 5B,A00,896260,Fischer-Grunski; Eva K,17,0,20,3
1746583580786,LIGM 5C,A00,896308,Fischer-Grunski; Eva K,18,0,20,2
1746583581815,LIIT 5AS,A00,896313,Carnelos; Chiara,18,0,20,2
1746583582843,LIIT 5BS,A00,896416,Carnelos; Chiara,20,0,20,0
1746583583869,LIIT 5CS,A00,896564,Carnelos; Chiara,20,0,20,0
1746583584898,LISP 5A,A00,896588,Munoz Sanchez; Alicia,2,0,20,18
1746583585965,LISP 5B,A00,896653,Munoz Sanchez; Alicia,7,0,20,13
1746583586994,LISP 5C,A00,896655,Munoz Sanchez; Alicia,0,1,20,20
1746583588023,MAE 197,001,957918,Kleissl; Jan,9996,0,9999,3
1746583588023,MAE 197,002,959806,Boechler; Nicholas Sebastia,9998,0,9999,1
1746583588023,MAE 197,003,959852,Mullin; Jennifer S,9998,0,9999,1
1746583589053,MATH 2,A01,957937,Staff,33,0,35,2
1746583590079,MATH 197,001,957876,Kedlaya; Kiran S.,9993,0,9999,6
1746583591107,MCWP 40,A00,892729,Duru; Nur,10,0,20,10
1746583591107,MCWP 40,B00,893304,Montejo; Carolina,14,0,20,6
1746583592132,MCWP 40R,A00,893757,Redela; Pamela Morgan,0,5,20,20
1746583593162,MCWP 50,A00,893758,Morshed; Michael James,0,0,20,20
1746583593162,MCWP 50,B00,893761,Bartulis; Jason Michael,17,0,20,3
1746583594190,MCWP 50R,A00,893766,Compas; Sean Matthew,0,1,20,20
1746583594190,MCWP 50R,B00,893769,Carter; Jennifer A,0,1,20,20
1746583594190,MCWP 50R,C00,893771,Krone; Jarret,0,3,20,20
1746583594190,MCWP 50R,D00,893772,Miller; Elizabeth Deen,0,0,20,20
1746583594190,MCWP 50R,E00,893775,Carter; Andrea L,0,1,20,20
1746583595217,MMW 11R,A01,892721,Herbst; Matthew,14,0,30,16
1746583595217,MMW 11R,A02,892722,Herbst; Matthew,0,0,0,3
1746583596247,MMW 12R,A01,892724,Herbst; Matthew,0,11,16,16
1746583596247,MMW 12R,A02,892725,Herbst; Matthew,0,10,16,16
1746583597276,MMW 13R,A01,892727,Staff,0,4,16,16
1746583597276,MMW 13R,A02,892728,Staff,0,4,16,16
1746583597276,MMW 13R,A03,958032,Staff,0,4,16,16
1746583597276,MMW 13R,A04,958033,Staff,0,4,16,16
1746583597276,MMW 13R,A05,958034,Staff,0,4,16,16
1746583598303,SIO 295LS,A00,894015,Staff,5,0,25,20
1746583599333,SIO 295S,A00,894020,Staff,5,0,25,20
1746583600359,SIOC 290S,B01,958918,Merrifield; Mark A,14,0,30,16
1746583601384,SIOC 291S,B01,958922,Gabriel; Corey John,14,0,30,16
1746583602410,SOCI 117,A01,895339,Staff,3,0,5,2
1746583603437,WES 237B,A00,894149,Staff,11,0,20,9
1746583605496,AESE 279B,A00,891859,Staff,13,0,35,22
1746583606525,AIP 197,001,891854,Vespa; Emanuel Ignacio,9999,0,9999,0
1746583607558,ANTH 289S,A00,891856,Gagneux; Pascal,12,0,12,0
1746583608583,BENG 196,001,957946,Engler; Adam J.,9996,0,9999,3
1746583609608,BISP 197,001,959851,Wilhelm; James E.,9998,0,9999,1
1746583610634,CAT 124RS,A01,956906,Staff,6,0,25,19
1746583611659,CAT 125RS,A01,922013,Staff,6,0,25,19
1746583612685,CLRE 250,A00,891860,Morris; Sheldon,9995,0,9999,4
1746583614741,CLRE 251R,A00,907817,Mehta; Ravindra L.,9994,0,9999,5
1746583615771,CLRE 252,A00,891864,Cuomo; Raphael Eduardo,9993,0,9999,6
1746583616794,CLRE 253,A00,891867,Vaida; Florin,9994,0,9999,5
1746583616794,CLRE 253,B00,907819,Staff,9999,0,9999,0
1746583617822,CLRE 259,A00,891868,Patel; Hemal,9998,0,9999,1
1746583618853,CLRE 260,A00,891872,Cuomo; Raphael Eduardo,9999,0,9999,0
1746583619883,CLRE 297,001,891888,Cuomo; Raphael Eduardo,9999,0,9999,0
1746583620908,CSE 191,A00,958773,Minnes Kemp; Mor Mia,9995,0,9999,4
1746583621932,CSE 197,001,959846,Minnes Kemp; Mor Mia,9990,0,9999,9
1746583622957,CSS 201S,A01,892054,Mignozzetti; Umberto,25,0,30,5
1746583623984,CSS 202S,A01,892056,Mignozzetti; Umberto,25,0,30,5
1746583625008,DSC 197,001,956898,Eldridge; Justin Matthew,9996,0,9999,3
1746583626036,DSC 297,001,958000,Mazumdar; Arya,9998,0,9999,1
1746583626036,DSC 297,002,959862,Wang; Yusu,9998,0,9999,1
1746583627060,EAP 100,A00,905686,Staff,9778,0,9999,221
1746583628091,ECE 45,A01,892618,Staff,0,0,65,65
1746583630145,ECE 111,A01,892719,Staff,6,0,65,59
1746583631172,ECE 197,001,957920,Mercier; Patrick Philip,9991,0,9999,8
1746583632197,ECON 178,A01,907814,Zhu; Ying,26,0,35,9
1746583633224,EDS 115,A00,895312,Staff,35,0,45,10
1746583634250,EDS 117,A01,895337,Staff,23,0,30,7
1746583635280,EDS 125,A00,895341,Jones; Gabrielle Anastasia,36,0,45,9
1746583636305,EDS 128A,A01,895459,Fargason; Sharon Gayle,44,0,45,1
1746583637334,EDS 128B,A01,895543,Pappas; Elizabeth,44,0,45,1
1746583638360,EDS 139,A00,897203,Pappas; Elizabeth,44,0,45,1
1746583638360,EDS 139,B00,897209,Fargason; Sharon Gayle,41,0,45,4
1746583639386,EDS 201,A00,895545,Staff,22,0,45,23
1746583640412,EDS 203,A01,895581,Halter; Christopher P.,22,0,45,23
1746583641438,EDS 204R,A01,895625,Heinzman; Erica M.,39,0,45,6
1746583641438,EDS 204R,B01,895693,Halter; Christopher P.,10,0,45,35
1746583642465,EDS 206R,A00,895694,Fargason; Sharon Gayle,1,0,30,29
1746583642465,EDS 206R,B00,895695,Choi; Bailey Miyeon,16,0,30,14
1746583643491,EDS 250,A00,895697,Hemans; Patricia Ann Benitez,22,0,45,23
1746583644520,EDS 281,A00,895701,Meyerott; Theresa Ann,1,0,15,14
1746583645546,EDS 284,A00,895736,Meyerott; Theresa Ann,1,0,15,14
1746583646572,EDS 286,A00,897210,Fine; Sarah,0,0,15,15
1746583647596,EDS 289C,A01,895770,Daly; Alan J.,1,0,15,14
1746583648621,EDS 290,A00,897211,Hofstetter; Carolyn,0,0,15,15
1746583649647,LIGM 5A,A00,896162,Fischer-Grunski; Eva K,12,0,20,8
1746583650674,LIGM 5B,A00,896260,Fischer-Grunski; Eva K,17,0,20,3
1746583651701,LIGM 5C,A00,896308,Fischer-Grunski; Eva K,18,0,20,2
1746583652729,LIIT 5AS,A00,896313,Carnelos; Chiara,18,0,20,2
1746583653753,LIIT 5BS,A00,896416,Carnelos; Chiara,20,0,20,0
1746583654780,LIIT 5CS,A00,896564,Carnelos; Chiara,20,0,20,0
1746583655804,LISP 5A,A00,896588,Munoz Sanchez; Alicia,2,0,20,18
1746583656831,LISP 5B,A00,896653,Munoz Sanchez; Alicia,7,0,20,13
1746583657909,LISP 5C,A00,896655,Munoz Sanchez; Alicia,0,1,20,20
1746583658934,MAE 197,001,957918,Kleissl; Jan,9996,0,9999,3
1746583658934,MAE 197,002,959806,Boechler; Nicholas Sebastia,9998,0,9999,1
1746583658934,MAE 197,003,959852,Mullin; Jennifer S,9998,0,9999,1
1746583659961,MATH 2,A01,957937,Staff,33,0,35,2
1746583660987,MATH 197,001,957876,Kedlaya; Kiran S.,9993,0,9999,6
1746583662012,MCWP 40,A00,892729,Duru; Nur,10,0,20,10
1746583662012,MCWP 40,B00,893304,Montejo; Carolina,14,0,20,6
1746583663037,MCWP 40R,A00,893757,Redela; Pamela Morgan,0,5,20,20
1746583664064,MCWP 50,A00,893758,Morshed; Michael James,0,0,20,20
1746583664064,MCWP 50,B00,893761,Bartulis; Jason Michael,17,0,20,3
1746583665094,MCWP 50R,A00,893766,Compas; Sean Matthew,0,1,20,20
1746583665094,MCWP 50R,B00,893769,Carter; Jennifer A,0,1,20,20
1746583665094,MCWP 50R,C00,893771,Krone; Jarret,0,3,20,20
1746583665094,MCWP 50R,D00,893772,Miller; Elizabeth Deen,0,0,20,20
1746583665094,MCWP 50R,E00,893775,Carter; Andrea L,0,1,20,20
1746583666122,MMW 11R,A01,892721,Herbst; Matthew,14,0,30,16
1746583666122,MMW 11R,A02,892722,Herbst; Matthew,0,0,0,3
1746583667146,MMW 12R,A01,892724,Herbst; Matthew,0,11,16,16
1746583667146,MMW 12R,A02,892725,Herbst; Matthew,0,10,16,16
1746583668173,MMW 13R,A01,892727,Staff,0,4,16,16
1746583668173,MMW 13R,A02,892728,Staff,0,4,16,16
1746583668173,MMW 13R,A03,958032,Staff,0,4,16,16
1746583668173,MMW 13R,A04,958033,Staff,0,4,16,16
1746583668173,MMW 13R,A05,958034,Staff,0,4,16,16
1746583669201,SIO 295LS,A00,894015,Staff,5,0,25,20
1746583670230,SIO 295S,A00,894020,Staff,5,0,25,20
1746583671256,SIOC 290S,B01,958918,Merrifield; Mark A,14,0,30,16
1746583672282,SIOC 291S,B01,958922,Gabriel; Corey John,14,0,30,16
1746583673308,SOCI 117,A01,895339,Staff,3,0,5,2
1746583674332,WES 237B,A00,894149,Staff,11,0,20,9
1746583676393,AESE 279B,A00,891859,Staff,13,0,35,22
1746583677421,AIP 197,001,891854,Vespa; Emanuel Ignacio,9999,0,9999,0
1746583678447,ANTH 289S,A00,891856,Gagneux; Pascal,12,0,12,0
1746583679473,BENG 196,001,957946,Engler; Adam J.,9996,0,9999,3
1746583680499,BISP 197,001,959851,Wilhelm; James E.,9998,0,9999,1
1746583681526,CAT 124RS,A01,956906,Staff,6,0,25,19
1746583682554,CAT 125RS,A01,922013,Staff,6,0,25,19
1746583683578,CLRE 250,A00,891860,Morris; Sheldon,9995,0,9999,4
1746583685636,CLRE 251R,A00,907817,Mehta; Ravindra L.,9994,0,9999,5
1746583686662,CLRE 252,A00,891864,Cuomo; Raphael Eduardo,9993,0,9999,6
1746583687690,CLRE 253,A00,891867,Vaida; Florin,9994,0,9999,5
1746583687690,CLRE 253,B00,907819,Staff,9999,0,9999,0
1746583688716,CLRE 259,A00,891868,Patel; Hemal,9998,0,9999,1
1746583689782,CLRE 260,A00,891872,Cuomo; Raphael Eduardo,9999,0,9999,0
1746583690809,CLRE 297,001,891888,Cuomo; Raphael Eduardo,9999,0,9999,0
1746583691835,CSE 191,A00,958773,Minnes Kemp; Mor Mia,9995,0,9999,4
1746583692862,CSE 197,001,959846,Minnes Kemp; Mor Mia,9990,0,9999,9
1746583693889,CSS 201S,A01,892054,Mignozzetti; Umberto,25,0,30,5
1746583694914,CSS 202S,A01,892056,Mignozzetti; Umberto,25,0,30,5
1746583695939,DSC 197,001,956898,Eldridge; Justin Matthew,9996,0,9999,3
1746583696966,DSC 297,001,958000,Mazumdar; Arya,9998,0,9999,1
1746583696966,DSC 297,002,959862,Wang; Yusu,9998,0,9999,1
1746583697991,EAP 100,A00,905686,Staff,9778,0,9999,221
1746583699018,ECE 45,A01,892618,Staff,0,0,65,65
1746583701068,ECE 111,A01,892719,Staff,6,0,65,59
1746583702093,ECE 197,001,957920,Mercier; Patrick Philip,9991,0,9999,8
1746583703121,ECON 178,A01,907814,Zhu; Ying,26,0,35,9
1746583704145,EDS 115,A00,895312,Staff,35,0,45,10
1746583705171,EDS 117,A01,895337,Staff,23,0,30,7
1746583706200,EDS 125,A00,895341,Jones; Gabrielle Anastasia,36,0,45,9
1746583707226,EDS 128A,A01,895459,Fargason; Sharon Gayle,44,0,45,1
1746583708251,EDS 128B,A01,895543,Pappas; Elizabeth,44,0,45,1
1746583709275,EDS 139,A00,897203,Pappas; Elizabeth,44,0,45,1
1746583709275,EDS 139,B00,897209,Fargason; Sharon Gayle,41,0,45,4
1746583710304,EDS 201,A00,895545,Staff,22,0,45,23
1746583711327,EDS 203,A01,895581,Halter; Christopher P.,22,0,45,23
1746583712352,EDS 204R,A01,895625,Heinzman; Erica M.,39,0,45,6
1746583712352,EDS 204R,B01,895693,Halter; Christopher P.,10,0,45,35
1746583713377,EDS 206R,A00,895694,Fargason; Sharon Gayle,1,0,30,29
1746583713377,EDS 206R,B00,895695,Choi; Bailey Miyeon,16,0,30,14
1746583714401,EDS 250,A00,895697,Hemans; Patricia Ann Benitez,22,0,45,23
1746583715429,EDS 281,A00,895701,Meyerott; Theresa Ann,1,0,15,14
1746583716455,EDS 284,A00,895736,Meyerott; Theresa Ann,1,0,15,14
1746583717481,EDS 286,A00,897210,Fine; Sarah,0,0,15,15
1746583718510,EDS 289C,A01,895770,Daly; Alan J.,1,0,15,14
1746583719537,EDS 290,A00,897211,Hofstetter; Carolyn,0,0,15,15
1746583720562,LIGM 5A,A00,896162,Fischer-Grunski; Eva K,12,0,20,8
1746583721586,LIGM 5B,A00,896260,Fischer-Grunski; Eva K,17,0,20,3
1746583722611,LIGM 5C,A00,896308,Fischer-Grunski; Eva K,18,0,20,2
1746583723637,LIIT 5AS,A00,896313,Carnelos; Chiara,18,0,20,2
1746583724665,LIIT 5BS,A00,896416,Carnelos; Chiara,20,0,20,0
1746583725690,LIIT 5CS,A00,896564,Carnelos; Chiara,20,0,20,0
1746583726717,LISP 5A,A00,896588,Munoz Sanchez; Alicia,2,0,20,18
1746583727746,LISP 5B,A00,896653,Munoz Sanchez; Alicia,7,0,20,13
1746583728776,LISP 5C,A00,896655,Munoz Sanchez; Alicia,0,1,20,20
1746583729805,MAE 197,001,957918,Kleissl; Jan,9996,0,9999,3
1746583729805,MAE 197,002,959806,Boechler; Nicholas Sebastia,9998,0,9999,1
1746583729805,MAE 197,003,959852,Mullin; Jennifer S,9998,0,9999,1
1746583730832,MATH 2,A01,957937,Staff,33,0,35,2
1746583731862,MATH 197,001,957876,Kedlaya; Kiran S.,9993,0,9999,6
1746583732886,MCWP 40,A00,892729,Duru; Nur,10,0,20,10
1746583732886,MCWP 40,B00,893304,Montejo; Carolina,14,0,20,6
1746583733911,MCWP 40R,A00,893757,Redela; Pamela Morgan,0,5,20,20
1746583734940,MCWP 50,A00,893758,Morshed; Michael James,0,0,20,20
1746583734940,MCWP 50,B00,893761,Bartulis; Jason Michael,17,0,20,3
1746583735970,MCWP 50R,A00,893766,Compas; Sean Matthew,0,1,20,20
1746583735970,MCWP 50R,B00,893769,Carter; Jennifer A,0,1,20,20
1746583735970,MCWP 50R,C00,893771,Krone; Jarret,0,3,20,20
1746583735970,MCWP 50R,D00,893772,Miller; Elizabeth Deen,0,0,20,20
1746583735970,MCWP 50R,E00,893775,Carter; Andrea L,0,1,20,20
1746583736998,MMW 11R,A01,892721,Herbst; Matthew,14,0,30,16
1746583736998,MMW 11R,A02,892722,Herbst; Matthew,0,0,0,3
1746583738025,MMW 12R,A01,892724,Herbst; Matthew,0,11,16,16
1746583738025,MMW 12R,A02,892725,Herbst; Matthew,0,10,16,16
1746583739051,MMW 13R,A01,892727,Staff,0,4,16,16
1746583739051,MMW 13R,A02,892728,Staff,0,4,16,16
1746583739051,MMW 13R,A03,958032,Staff,0,4,16,16
1746583739051,MMW 13R,A04,958033,Staff,0,4,16,16
1746583739051,MMW 13R,A05,958034,Staff,0,4,16,16
1746583740078,SIO 295LS,A00,894015,Staff,5,0,25,20
1746583741105,SIO 295S,A00,894020,Staff,5,0,25,20
1746583742137,SIOC 290S,B01,958918,Merrifield; Mark A,14,0,30,16
1746583743163,SIOC 291S,B01,958922,Gabriel; Corey John,14,0,30,16
1746583744189,SOCI 117,A01,895339,Staff,3,0,5,2
1746583745217,WES 237B,A00,894149,Staff,11,0,20,9
1746583747280,AESE 279B,A00,891859,Staff,13,0,35,22
1746583748308,AIP 197,001,891854,Vespa; Emanuel Ignacio,9999,0,9999,0
1746583749334,ANTH 289S,A00,891856,Gagneux; Pascal,12,0,12,0
1746583750358,BENG 196,001,957946,Engler; Adam J.,9996,0,9999,3
1746583751383,BISP 197,001,959851,Wilhelm; James E.,9998,0,9999,1
1746583752411,CAT 124RS,A01,956906,Staff,6,0,25,19
1746583753435,CAT 125RS,A01,922013,Staff,6,0,25,19
1746583754461,CLRE 250,A00,891860,Morris; Sheldon,9995,0,9999,4
1746583756518,CLRE 251R,A00,907817,Mehta; Ravindra L.,9994,0,9999,5
1746583757542,CLRE 252,A00,891864,Cuomo; Raphael Eduardo,9993,0,9999,6
1746583758569,CLRE 253,A00,891867,Vaida; Florin,9994,0,9999,5
1746583758569,CLRE 253,B00,907819,Staff,9999,0,9999,0
1746583759599,CLRE 259,A00,891868,Patel; Hemal,9998,0,9999,1
1746583760628,CLRE 260,A00,891872,Cuomo; Raphael Eduardo,9999,0,9999,0
1746583761652,CLRE 297,001,891888,Cuomo; Raphael Eduardo,9999,0,9999,0
1746583762681,CSE 191,A00,958773,Minnes Kemp; Mor Mia,9995,0,9999,4
1746583763706,CSE 197,001,959846,Minnes Kemp; Mor Mia,9990,0,9999,9
1746583764732,CSS 201S,A01,892054,Mignozzetti; Umberto,25,0,30,5
1746583765761,CSS 202S,A01,892056,Mignozzetti; Umberto,25,0,30,5
1746583766787,DSC 197,001,956898,Eldridge; Justin Matthew,9996,0,9999,3
1746583767811,DSC 297,001,958000,Mazumdar; Arya,9998,0,9999,1
1746583767811,DSC 297,002,959862,Wang; Yusu,9998,0,9999,1
1746583768841,EAP 100,A00,905686,Staff,9778,0,9999,221
1746583769872,ECE 45,A01,892618,Staff,0,0,65,65
1746583771927,ECE 111,A01,892719,Staff,6,0,65,59
1746583772963,ECE 197,001,957920,Mercier; Patrick Philip,9991,0,9999,8
1746583773992,ECON 178,A01,907814,Zhu; Ying,26,0,35,9
1746583775017,EDS 115,A00,895312,Staff,35,0,45,10
1746583776044,EDS 117,A01,895337,Staff,23,0,30,7
1746583777068,EDS 125,A00,895341,Jones; Gabrielle Anastasia,36,0,45,9
1746583778094,EDS 128A,A01,895459,Fargason; Sharon Gayle,44,0,45,1
1746583779123,EDS 128B,A01,895543,Pappas; Elizabeth,44,0,45,1
1746583780154,EDS 139,A00,897203,Pappas; Elizabeth,44,0,45,1
1746583780154,EDS 139,B00,897209,Fargason; Sharon Gayle,41,0,45,4
1746583781183,EDS 201,A00,895545,Staff,22,0,45,23
1746583782208,EDS 203,A01,895581,Halter; Christopher P.,22,0,45,23
1746583783232,EDS 204R,A01,895625,Heinzman; Erica M.,39,0,45,6
1746583783232,EDS 204R,B01,895693,Halter; Christopher P.,10,0,45,35
1746583784261,EDS 206R,A00,895694,Fargason; Sharon Gayle,1,0,30,29
1746583784261,EDS 206R,B00,895695,Choi; Bailey Miyeon,16,0,30,14
1746583785287,EDS 250,A00,895697,Hemans; Patricia Ann Benitez,22,0,45,23
1746583786311,EDS 281,A00,895701,Meyerott; Theresa Ann,1,0,15,14
1746583787339,EDS 284,A00,895736,Meyerott; Theresa Ann,1,0,15,14
1746583788365,EDS 286,A00,897210,Fine; Sarah,0,0,15,15
1746583789390,EDS 289C,A01,895770,Daly; Alan J.,1,0,15,14
1746583790415,EDS 290,A00,897211,Hofstetter; Carolyn,0,0,15,15
1746583791443,LIGM 5A,A00,896162,Fischer-Grunski; Eva K,12,0,20,8
1746583792473,LIGM 5B,A00,896260,Fischer-Grunski; Eva K,17,0,20,3
1746583793537,LIGM 5C,A00,896308,Fischer-Grunski; Eva K,18,0,20,2
1746583794583,LIIT 5AS,A00,896313,Carnelos; Chiara,18,0,20,2
1746583795610,LIIT 5BS,A00,896416,Carnelos; Chiara,20,0,20,0
1746583796637,LIIT 5CS,A00,896564,Carnelos; Chiara,20,0,20,0
1746583797667,LISP 5A,A00,896588,Munoz Sanchez; Alicia,2,0,20,18
1746583798693,LISP 5B,A00,896653,Munoz Sanchez; Alicia,7,0,20,13
1746583799722,LISP 5C,A00,896655,Munoz Sanchez; Alicia,0,1,20,20
1746583800752,MAE 197,001,957918,Kleissl; Jan,9996,0,9999,3
1746583800752,MAE 197,002,959806,Boechler; Nicholas Sebastia,9998,0,9999,1
1746583800752,MAE 197,003,959852,Mullin; Jennifer S,9998,0,9999,1
1746583801778,MATH 2,A01,957937,Staff,33,0,35,2
1746583802804,MATH 197,001,957876,Kedlaya; Kiran S.,9993,0,9999,6
1746583803829,MCWP 40,A00,892729,Duru; Nur,10,0,20,10
1746583803829,MCWP 40,B00,893304,Montejo; Carolina,14,0,20,6
1746583804857,MCWP 40R,A00,893757,Redela; Pamela Morgan,0,5,20,20
1746583805883,MCWP 50,A00,893758,Morshed; Michael James,0,0,20,20
1746583805883,MCWP 50,B00,893761,Bartulis; Jason Michael,17,0,20,3
1746583806908,MCWP 50R,A00,893766,Compas; Sean Matthew,0,1,20,20
1746583806908,MCWP 50R,B00,893769,Carter; Jennifer A,0,1,20,20
1746583806908,MCWP 50R,C00,893771,Krone; Jarret,0,3,20,20
1746583806908,MCWP 50R,D00,893772,Miller; Elizabeth Deen,0,0,20,20
1746583806908,MCWP 50R,E00,893775,Carter; Andrea L,0,1,20,20
1746583807938,MMW 11R,A01,892721,Herbst; Matthew,14,0,30,16
1746583807938,MMW 11R,A02,892722,Herbst; Matthew,0,0,0,3
1746583808966,MMW 12R,A01,892724,Herbst; Matthew,0,11,16,16
1746583808966,MMW 12R,A02,892725,Herbst; Matthew,0,10,16,16
1746583809995,MMW 13R,A01,892727,Staff,0,4,16,16
1746583809995,MMW 13R,A02,892728,Staff,0,4,16,16
1746583809995,MMW 13R,A03,958032,Staff,0,4,16,16
1746583809995,MMW 13R,A04,958033,Staff,0,4,16,16
1746583809995,MMW 13R,A05,958034,Staff,0,4,16,16
1746583811024,SIO 295LS,A00,894015,Staff,5,0,25,20
1746583812049,SIO 295S,A00,894020,Staff,5,0,25,20
1746583813077,SIOC 290S,B01,958918,Merrifield; Mark A,14,0,30,16
1746583814107,SIOC 291S,B01,958922,Gabriel; Corey John,14,0,30,16
1746583815136,SOCI 117,A01,895339,Staff,3,0,5,2
1746583816160,WES 237B,A00,894149,Staff,11,0,20,9
1746583818223,AESE 279B,A00,891859,Staff,13,0,35,22
1746583819248,AIP 197,001,891854,Vespa; Emanuel Ignacio,9999,0,9999,0
1746583820277,ANTH 289S,A00,891856,Gagneux; Pascal,12,0,12,0
1746583821305,BENG 196,001,957946,Engler; Adam J.,9996,0,9999,3
1746583822329,BISP 197,001,959851,Wilhelm; James E.,9998,0,9999,1
1746583823353,CAT 124RS,A01,956906,Staff,6,0,25,19
1746583824382,CAT 125RS,A01,922013,Staff,6,0,25,19
1746583825407,CLRE 250,A00,891860,Morris; Sheldon,9995,0,9999,4
1746583827461,CLRE 251R,A00,907817,Mehta; Ravindra L.,9994,0,9999,5
1746583828487,CLRE 252,A00,891864,Cuomo; Raphael Eduardo,9993,0,9999,6
1746583829513,CLRE 253,A00,891867,Vaida; Florin,9994,0,9999,5
1746583829513,CLRE 253,B00,907819,Staff,9999,0,9999,0
1746583830541,CLRE 259,A00,891868,Patel; Hemal,9998,0,9999,1
1746583831566,CLRE 260,A00,891872,Cuomo; Raphael Eduardo,9999,0,9999,0
1746583832594,CLRE 297,001,891888,Cuomo; Raphael Eduardo,9999,0,9999,0
1746583833622,CSE 191,A00,958773,Minnes Kemp; Mor Mia,9995,0,9999,4
1746583834646,CSE 197,001,959846,Minnes Kemp; Mor Mia,9990,0,9999,9
1746583835670,CSS 201S,A01,892054,Mignozzetti; Umberto,25,0,30,5
1746583836697,CSS 202S,A01,892056,Mignozzetti; Umberto,25,0,30,5
1746583837726,DSC 197,001,956898,Eldridge; Justin Matthew,9996,0,9999,3
1746583838751,DSC 297,001,958000,Mazumdar; Arya,9998,0,9999,1
1746583838751,DSC 297,002,959862,Wang; Yusu,9998,0,9999,1
1746583839780,EAP 100,A00,905686,Staff,9778,0,9999,221
1746583840805,ECE 45,A01,892618,Staff,0,0,65,65
1746583842858,ECE 111,A01,892719,Staff,6,0,65,59
1746583843883,ECE 197,001,957920,Mercier; Patrick Philip,9991,0,9999,8
1746583844913,ECON 178,A01,907814,Zhu; Ying,26,0,35,9
1746583845938,EDS 115,A00,895312,Staff,35,0,45,10
1746583846963,EDS 117,A01,895337,Staff,23,0,30,7
1746583847986,EDS 125,A00,895341,Jones; Gabrielle Anastasia,36,0,45,9
1746583849012,EDS 128A,A01,895459,Fargason; Sharon Gayle,44,0,45,1
1746583850037,EDS 128B,A01,895543,Pappas; Elizabeth,44,0,45,1
1746583851063,EDS 139,A00,897203,Pappas; Elizabeth,44,0,45,1
1746583851063,EDS 139,B00,897209,Fargason; Sharon Gayle,41,0,45,4
1746583852091,EDS 201,A00,895545,Staff,22,0,45,23
1746583853116,EDS 203,A01,895581,Halter; Christopher P.,22,0,45,23
1746583854144,EDS 204R,A01,895625,Heinzman; Erica M.,39,0,45,6
1746583854144,EDS 204R,B01,895693,Halter; Christopher P.,10,0,45,35
1746583855176,EDS 206R,A00,895694,Fargason; Sharon Gayle,1,0,30,29
1746583855176,EDS 206R,B00,895695,Choi; Bailey Miyeon,16,0,30,14
1746583856200,EDS 250,A00,895697,Hemans; Patricia Ann Benitez,22,0,45,23
1746583857228,EDS 281,A00,895701,Meyerott; Theresa Ann,1,0,15,14
1746583858258,EDS 284,A00,895736,Meyerott; Theresa Ann,1,0,15,14
1746583859288,EDS 286,A00,897210,Fine; Sarah,0,0,15,15
1746583860312,EDS 289C,A01,895770,Daly; Alan J.,1,0,15,14
1746583861338,EDS 290,A00,897211,Hofstetter; Carolyn,0,0,15,15
1746583862367,LIGM 5A,A00,896162,Fischer-Grunski; Eva K,12,0,20,8
1746583863393,LIGM 5B,A00,896260,Fischer-Grunski; Eva K,17,0,20,3
1746583864420,LIGM 5C,A00,896308,Fischer-Grunski; Eva K,18,0,20,2
1746583865453,LIIT 5AS,A00,896313,Carnelos; Chiara,18,0,20,2
1746583866479,LIIT 5BS,A00,896416,Carnelos; Chiara,20,0,20,0
1746583867509,LIIT 5CS,A00,896564,Carnelos; Chiara,20,0,20,0
1746583868537,LISP 5A,A00,896588,Munoz Sanchez; Alicia,2,0,20,18
1746583869563,LISP 5B,A00,896653,Munoz Sanchez; Alicia,7,0,20,13
1746583870588,LISP 5C,A00,896655,Munoz Sanchez; Alicia,0,1,20,20
1746583871617,MAE 197,001,957918,Kleissl; Jan,9996,0,9999,3
1746583871617,MAE 197,002,959806,Boechler; Nicholas Sebastia,9998,0,9999,1
1746583871617,MAE 197,003,959852,Mullin; Jennifer S,9998,0,9999,1
1746583872644,MATH 2,A01,957937,Staff,33,0,35,2
1746583873670,MATH 197,001,957876,Kedlaya; Kiran S.,9993,0,9999,6
1746583874695,MCWP 40,A00,892729,Duru; Nur,10,0,20,10
1746583874695,MCWP 40,B00,893304,Montejo; Carolina,14,0,20,6
1746583875723,MCWP 40R,A00,893757,Redela; Pamela Morgan,0,5,20,20
1746583876747,MCWP 50,A00,893758,Morshed; Michael James,0,0,20,20
1746583876747,MCWP 50,B00,893761,Bartulis; Jason Michael,17,0,20,3
1746583877778,MCWP 50R,A00,893766,Compas; Sean Matthew,0,1,20,20
1746583877778,MCWP 50R,B00,893769,Carter; Jennifer A,0,1,20,20
1746583877778,MCWP 50R,C00,893771,Krone; Jarret,0,3,20,20
1746583877778,MCWP 50R,D00,893772,Miller; Elizabeth Deen,0,0,20,20
1746583877778,MCWP 50R,E00,893775,Carter; Andrea L,0,1,20,20
1746583878803,MMW 11R,A01,892721,Herbst; Matthew,14,0,30,16
1746583878803,MMW 11R,A02,892722,Herbst; Matthew,0,0,0,3
1746583879831,MMW 12R,A01,892724,Herbst; Matthew,0,11,16,16
1746583879831,MMW 12R,A02,892725,Herbst; Matthew,0,10,16,16
1746583880856,MMW 13R,A01,892727,Staff,0,4,16,16
1746583880856,MMW 13R,A02,892728,Staff,0,4,16,16
1746583880856,MMW 13R,A03,958032,Staff,0,4,16,16
1746583880856,MMW 13R,A04,958033,Staff,0,4,16,16
1746583880856,MMW 13R,A05,958034,Staff,0,4,16,16
1746583881882,SIO 295LS,A00,894015,Staff,5,0,25,20
1746583882910,SIO 295S,A00,894020,Staff,5,0,25,20
1746583883939,SIOC 290S,B01,958918,Merrifield; Mark A,14,0,30,16
1746583884966,SIOC 291S,B01,958922,Gabriel; Corey John,14,0,30,16
1746583885996,SOCI 117,A01,895339,Staff,3,0,5,2
1746583887022,WES 237B,A00,894149,Staff,11,0,20,9
1746583889082,AESE 279B,A00,891859,Staff,13,0,35,22
1746583890108,AIP 197,001,891854,Vespa; Emanuel Ignacio,9999,0,9999,0
1746583891134,ANTH 289S,A00,891856,Gagneux; Pascal,12,0,12,0
1746583892163,BENG 196,001,957946,Engler; Adam J.,9996,0,9999,3
1746583893188,BISP 197,001,959851,Wilhelm; James E.,9998,0,9999,1
1746583894214,CAT 124RS,A01,956906,Staff,6,0,25,19
1746583895239,CAT 125RS,A01,922013,Staff,6,0,25,19
1746583896267,CLRE 250,A00,891860,Morris; Sheldon,9995,0,9999,4
1746583898355,CLRE 251R,A00,907817,Mehta; Ravindra L.,9994,0,9999,5
1746583899386,CLRE 252,A00,891864,Cuomo; Raphael Eduardo,9993,0,9999,6
1746583900411,CLRE 253,A00,891867,Vaida; Florin,9994,0,9999,5
1746583900411,CLRE 253,B00,907819,Staff,9999,0,9999,0
1746583901441,CLRE 259,A00,891868,Patel; Hemal,9998,0,9999,1
1746583902469,CLRE 260,A00,891872,Cuomo; Raphael Eduardo,9999,0,9999,0
1746583903496,CLRE 297,001,891888,Cuomo; Raphael Eduardo,9999,0,9999,0
1746583904522,CSE 191,A00,958773,Minnes Kemp; Mor Mia,9995,0,9999,4
1746583905551,CSE 197,001,959846,Minnes Kemp; Mor Mia,9990,0,9999,9
1746583906575,CSS 201S,A01,892054,Mignozzetti; Umberto,25,0,30,5
1746583907602,CSS 202S,A01,892056,Mignozzetti; Umberto,25,0,30,5
1746583908627,DSC 197,001,956898,Eldridge; Justin Matthew,9996,0,9999,3
1746583909653,DSC 297,001,958000,Mazumdar; Arya,9998,0,9999,1
1746583909653,DSC 297,002,959862,Wang; Yusu,9998,0,9999,1
1746583910678,EAP 100,A00,905686,Staff,9778,0,9999,221
1746583911706,ECE 45,A01,892618,Staff,0,0,65,65
1746583913762,ECE 111,A01,892719,Staff,6,0,65,59
1746583914789,ECE 197,001,957920,Mercier; Patrick Philip,9991,0,9999,8
1746583915821,ECON 178,A01,907814,Zhu; Ying,26,0,35,9
1746583916850,EDS 115,A00,895312,Staff,35,0,45,10
1746583917875,EDS 117,A01,895337,Staff,23,0,30,7
1746583918902,EDS 125,A00,895341,Jones; Gabrielle Anastasia,36,0,45,9
1746583919929,EDS 128A,A01,895459,Fargason; Sharon Gayle,44,0,45,1
1746583920955,EDS 128B,A01,895543,Pappas; Elizabeth,44,0,45,1
1746583921985,EDS 139,A00,897203,Pappas; Elizabeth,44,0,45,1
1746583921985,EDS 139,B00,897209,Fargason; Sharon Gayle,41,0,45,4
1746583923010,EDS 201,A00,895545,Staff,22,0,45,23
1746583924035,EDS 203,A01,895581,Halter; Christopher P.,22,0,45,23
1746583925066,EDS 204R,A01,895625,Heinzman; Erica M.,39,0,45,6
1746583925066,EDS 204R,B01,895693,Halter; Christopher P.,10,0,45,35
1746583926090,EDS 206R,A00,895694,Fargason; Sharon Gayle,1,0,30,29
1746583926090,EDS 206R,B00,895695,Choi; Bailey Miyeon,16,0,30,14
1746583927119,EDS 250,A00,895697,Hemans; Patricia Ann Benitez,22,0,45,23
1746583928146,EDS 281,A00,895701,Meyerott; Theresa Ann,1,0,15,14
1746583929175,EDS 284,A00,895736,Meyerott; Theresa Ann,1,0,15,14
1746583930204,EDS 286,A00,897210,Fine; Sarah,0,0,15,15
1746583931229,EDS 289C,A01,895770,Daly; Alan J.,1,0,15,14
1746583932254,EDS 290,A00,897211,Hofstetter; Carolyn,0,0,15,15
1746583933280,LIGM 5A,A00,896162,Fischer-Grunski; Eva K,12,0,20,8
1746583934309,LIGM 5B,A00,896260,Fischer-Grunski; Eva K,17,0,20,3
1746583935339,LIGM 5C,A00,896308,Fischer-Grunski; Eva K,18,0,20,2
1746583936368,LIIT 5AS,A00,896313,Carnelos; Chiara,18,0,20,2
1746583937393,LIIT 5BS,A00,896416,Carnelos; Chiara,20,0,20,0
1746583938418,LIIT 5CS,A00,896564,Carnelos; Chiara,20,0,20,0
1746583939443,LISP 5A,A00,896588,Munoz Sanchez; Alicia,2,0,20,18
1746583940471,LISP 5B,A00,896653,Munoz Sanchez; Alicia,7,0,20,13
1746583941497,LISP 5C,A00,896655,Munoz Sanchez; Alicia,0,1,20,20
1746583942523,MAE 197,001,957918,Kleissl; Jan,9996,0,9999,3
1746583942523,MAE 197,002,959806,Boechler; Nicholas Sebastia,9998,0,9999,1
1746583942523,MAE 197,003,959852,Mullin; Jennifer S,9998,0,9999,1
1746583943552,MATH 2,A01,957937,Staff,33,0,35,2
1746583944578,MATH 197,001,957876,Kedlaya; Kiran S.,9993,0,9999,6
1746583945607,MCWP 40,A00,892729,Duru; Nur,10,0,20,10
1746583945607,MCWP 40,B00,893304,Montejo; Carolina,14,0,20,6
1746583946636,MCWP 40R,A00,893757,Redela; Pamela Morgan,0,5,20,20
1746583947662,MCWP 50,A00,893758,Morshed; Michael James,0,0,20,20
1746583947662,MCWP 50,B00,893761,Bartulis; Jason Michael,17,0,20,3
1746583948687,MCWP 50R,A00,893766,Compas; Sean Matthew,0,1,20,20
1746583948687,MCWP 50R,B00,893769,Carter; Jennifer A,0,1,20,20
1746583948687,MCWP 50R,C00,893771,Krone; Jarret,0,3,20,20
1746583948687,MCWP 50R,D00,893772,Miller; Elizabeth Deen,0,0,20,20
1746583948687,MCWP 50R,E00,893775,Carter; Andrea L,0,1,20,20
1746583949715,MMW 11R,A01,892721,Herbst; Matthew,14,0,30,16
1746583949715,MMW 11R,A02,892722,Herbst; Matthew,0,0,0,3
1746583950743,MMW 12R,A01,892724,Herbst; Matthew,0,11,16,16
1746583950743,MMW 12R,A02,892725,Herbst; Matthew,0,10,16,16
1746583951771,MMW 13R,A01,892727,Staff,0,4,16,16
1746583951771,MMW 13R,A02,892728,Staff,0,4,16,16
1746583951771,MMW 13R,A03,958032,Staff,0,4,16,16
1746583951771,MMW 13R,A04,958033,Staff,0,4,16,16
1746583951771,MMW 13R,A05,958034,Staff,0,4,16,16
1746583952797,SIO 295LS,A00,894015,Staff,5,0,25,20
1746583953825,SIO 295S,A00,894020,Staff,5,0,25,20
1746583954854,SIOC 290S,B01,958918,Merrifield; Mark A,14,0,30,16
1746583955879,SIOC 291S,B01,958922,Gabriel; Corey John,14,0,30,16
1746583956909,SOCI 117,A01,895339,Staff,3,0,5,2
1746583957937,WES 237B,A00,894149,Staff,11,0,20,9
1746583960003,AESE 279B,A00,891859,Staff,13,0,35,22
1746583961032,AIP 197,001,891854,Vespa; Emanuel Ignacio,9999,0,9999,0
1746583962057,ANTH 289S,A00,891856,Gagneux; Pascal,12,0,12,0
1746583963086,BENG 196,001,957946,Engler; Adam J.,9996,0,9999,3
1746583964113,BISP 197,001,959851,Wilhelm; James E.,9998,0,9999,1
1746583965140,CAT 124RS,A01,956906,Staff,6,0,25,19
1746583966167,CAT 125RS,A01,922013,Staff,6,0,25,19
1746583967193,CLRE 250,A00,891860,Morris; Sheldon,9995,0,9999,4
1746583969247,CLRE 251R,A00,907817,Mehta; Ravindra L.,9994,0,9999,5
1746583970278,CLRE 252,A00,891864,Cuomo; Raphael Eduardo,9993,0,9999,6
1746583971304,CLRE 253,A00,891867,Vaida; Florin,9994,0,9999,5
1746583971304,CLRE 253,B00,907819,Staff,9999,0,9999,0
1746583972330,CLRE 259,A00,891868,Patel; Hemal,9998,0,9999,1
1746583973357,CLRE 260,A00,891872,Cuomo; Raphael Eduardo,9999,0,9999,0
1746583974384,CLRE 297,001,891888,Cuomo; Raphael Eduardo,9999,0,9999,0
1746583975411,CSE 191,A00,958773,Minnes Kemp; Mor Mia,9995,0,9999,4
1746583976440,CSE 197,001,959846,Minnes Kemp; Mor Mia,9990,0,9999,9
1746583977471,CSS 201S,A01,892054,Mignozzetti; Umberto,25,0,30,5
1746583978498,CSS 202S,A01,892056,Mignozzetti; Umberto,25,0,30,5
1746583979524,DSC 197,001,956898,Eldridge; Justin Matthew,9996,0,9999,3
1746583980554,DSC 297,001,958000,Mazumdar; Arya,9998,0,9999,1
1746583980554,DSC 297,002,959862,Wang; Yusu,9998,0,9999,1
1746583981580,EAP 100,A00,905686,Staff,9778,0,9999,221
1746583982608,ECE 45,A01,892618,Staff,0,0,65,65
1746583984661,ECE 111,A01,892719,Staff,6,0,65,59
1746583985686,ECE 197,001,957920,Mercier; Patrick Philip,9991,0,9999,8
1746583986713,ECON 178,A01,907814,Zhu; Ying,26,0,35,9
1746583987738,EDS 115,A00,895312,Staff,35,0,45,10
1746583988763,EDS 117,A01,895337,Staff,23,0,30,7
1746583989794,EDS 125,A00,895341,Jones; Gabrielle Anastasia,36,0,45,9
1746583990822,EDS 128A,A01,895459,Fargason; Sharon Gayle,44,0,45,1
1746583991849,EDS 128B,A01,895543,Pappas; Elizabeth,44,0,45,1
1746583992874,EDS 139,A00,897203,Pappas; Elizabeth,44,0,45,1
1746583992874,EDS 139,B00,897209,Fargason; Sharon Gayle,41,0,45,4
1746583993901,EDS 201,A00,895545,Staff,22,0,45,23
1746583994926,EDS 203,A01,895581,Halter; Christopher P.,22,0,45,23
1746583995951,EDS 204R,A01,895625,Heinzman; Erica M.,39,0,45,6
1746583995951,EDS 204R,B01,895693,Halter; Christopher P.,10,0,45,35
1746583996977,EDS 206R,A00,895694,Fargason; Sharon Gayle,1,0,30,29
1746583996977,EDS 206R,B00,895695,Choi; Bailey Miyeon,16,0,30,14
1746583998006,EDS 250,A00,895697,Hemans; Patricia Ann Benitez,22,0,45,23
1746583999032,EDS 281,A00,895701,Meyerott; Theresa Ann,1,0,15,14
1746584000062,EDS 284,A00,895736,Meyerott; Theresa Ann,1,0,15,14
1746584001126,EDS 286,A00,897210,Fine; Sarah,0,0,15,15
1746584002151,EDS 289C,A01,895770,Daly; Alan J.,1,0,15,14
1746584003176,EDS 290,A00,897211,Hofstetter; Carolyn,0,0,15,15
1746584004202,LIGM 5A,A00,896162,Fischer-Grunski; Eva K,12,0,20,8
1746584005232,LIGM 5B,A00,896260,Fischer-Grunski; Eva K,17,0,20,3
1746584006262,LIGM 5C,A00,896308,Fischer-Grunski; Eva K,18,0,20,2
1746584007293,LIIT 5AS,A00,896313,Carnelos; Chiara,18,0,20,2
1746584008318,LIIT 5BS,A00,896416,Carnelos; Chiara,20,0,20,0
1746584009343,LIIT 5CS,A00,896564,Carnelos; Chiara,20,0,20,0
1746584010369,LISP 5A,A00,896588,Munoz Sanchez; Alicia,2,0,20,18
1746584011397,LISP 5B,A00,896653,Munoz Sanchez; Alicia,7,0,20,13
1746584012428,LISP 5C,A00,896655,Munoz Sanchez; Alicia,0,1,20,20
1746584013456,MAE 197,001,957918,Kleissl; Jan,9996,0,9999,3
1746584013456,MAE 197,002,959806,Boechler; Nicholas Sebastia,9998,0,9999,1
1746584013456,MAE 197,003,959852,Mullin; Jennifer S,9998,0,9999,1
1746584014485,MATH 2,A01,957937,Staff,33,0,35,2
1746584015508,MATH 197,001,957876,Kedlaya; Kiran S.,9993,0,9999,6
1746584016538,MCWP 40,A00,892729,Duru; Nur,10,0,20,10
1746584016538,MCWP 40,B00,893304,Montejo; Carolina,14,0,20,6
1746584017563,MCWP 40R,A00,893757,Redela; Pamela Morgan,0,5,20,20
1746584018593,MCWP 50,A00,893758,Morshed; Michael James,0,0,20,20
1746584018593,MCWP 50,B00,893761,Bartulis; Jason Michael,17,0,20,3
1746584019623,MCWP 50R,A00,893766,Compas; Sean Matthew,0,1,20,20
1746584019623,MCWP 50R,B00,893769,Carter; Jennifer A,0,1,20,20
1746584019623,MCWP 50R,C00,893771,Krone; Jarret,0,3,20,20
1746584019623,MCWP 50R,D00,893772,Miller; Elizabeth Deen,0,0,20,20
1746584019623,MCWP 50R,E00,893775,Carter; Andrea L,0,1,20,20
1746584020650,MMW 11R,A01,892721,Herbst; Matthew,14,0,30,16
1746584020650,MMW 11R,A02,892722,Herbst; Matthew,0,0,0,3
1746584021674,MMW 12R,A01,892724,Herbst; Matthew,0,11,16,16
1746584021674,MMW 12R,A02,892725,Herbst; Matthew,0,10,16,16
1746584022701,MMW 13R,A01,892727,Staff,0,4,16,16
1746584022701,MMW 13R,A02,892728,Staff,0,4,16,16
1746584022701,MMW 13R,A03,958032,Staff,0,4,16,16
1746584022701,MMW 13R,A04,958033,Staff,0,4,16,16
1746584022701,MMW 13R,A05,958034,Staff,0,4,16,16
1746584023726,SIO 295LS,A00,894015,Staff,5,0,25,20
1746584024750,SIO 295S,A00,894020,Staff,5,0,25,20
1746584025782,SIOC 290S,B01,958918,Merrifield; Mark A,14,0,30,16
1746584026813,SIOC 291S,B01,958922,Gabriel; Corey John,14,0,30,16
1746584027838,SOCI 117,A01,895339,Staff,3,0,5,2
1746584028865,WES 237B,A00,894149,Staff,11,0,20,9
1746584030931,AESE 279B,A00,891859,Staff,13,0,35,22
1746584031956,AIP 197,001,891854,Vespa; Emanuel Ignacio,9999,0,9999,0
1746584032982,ANTH 289S,A00,891856,Gagneux; Pascal,12,0,12,0
1746584034007,BENG 196,001,957946,Engler; Adam J.,9996,0,9999,3
1746584035033,BISP 197,001,959851,Wilhelm; James E.,9998,0,9999,1
1746584036059,CAT 124RS,A01,956906,Staff,6,0,25,19
1746584037085,CAT 125RS,A01,922013,Staff,6,0,25,19
1746584038110,CLRE 250,A00,891860,Morris; Sheldon,9995,0,9999,4
1746584040160,CLRE 251R,A00,907817,Mehta; Ravindra L.,9994,0,9999,5
1746584041188,CLRE 252,A00,891864,Cuomo; Raphael Eduardo,9993,0,9999,6
1746584042215,CLRE 253,A00,891867,Vaida; Florin,9994,0,9999,5
1746584042215,CLRE 253,B00,907819,Staff,9999,0,9999,0
1746584043240,CLRE 259,A00,891868,Patel; Hemal,9998,0,9999,1
1746584044263,CLRE 260,A00,891872,Cuomo; Raphael Eduardo,9999,0,9999,0
1746584045290,CLRE 297,001,891888,Cuomo; Raphael Eduardo,9999,0,9999,0
1746584046317,CSE 191,A00,958773,Minnes Kemp; Mor Mia,9995,0,9999,4
1746584047342,CSE 197,001,959846,Minnes Kemp; Mor Mia,9990,0,9999,9
1746584048366,CSS 201S,A01,892054,Mignozzetti; Umberto,25,0,30,5
1746584049392,CSS 202S,A01,892056,Mignozzetti; Umberto,25,0,30,5
1746584050417,DSC 197,001,956898,Eldridge; Justin Matthew,9996,0,9999,3
1746584051445,DSC 297,001,958000,Mazumdar; Arya,9998,0,9999,1
1746584051445,DSC 297,002,959862,Wang; Yusu,9998,0,9999,1
1746584052472,EAP 100,A00,905686,Staff,9778,0,9999,221
1746584053501,ECE 45,A01,892618,Staff,0,0,65,65
1746584055556,ECE 111,A01,892719,Staff,6,0,65,59
1746584056582,ECE 197,001,957920,Mercier; Patrick Philip,9991,0,9999,8
1746584057612,ECON 178,A01,907814,Zhu; Ying,26,0,35,9
1746584058637,EDS 115,A00,895312,Staff,35,0,45,10
1746584059662,EDS 117,A01,895337,Staff,23,0,30,7
1746584060692,EDS 125,A00,895341,Jones; Gabrielle Anastasia,36,0,45,9
1746584061722,EDS 128A,A01,895459,Fargason; Sharon Gayle,44,0,45,1
1746584062748,EDS 128B,A01,895543,Pappas; Elizabeth,44,0,45,1
1746584063776,EDS 139,A00,897203,Pappas; Elizabeth,44,0,45,1
1746584063776,EDS 139,B00,897209,Fargason; Sharon Gayle,41,0,45,4
1746584064801,EDS 201,A00,895545,Staff,22,0,45,23
1746584065831,EDS 203,A01,895581,Halter; Christopher P.,22,0,45,23
1746584066858,EDS 204R,A01,895625,Heinzman; Erica M.,39,0,45,6
1746584066858,EDS 204R,B01,895693,Halter; Christopher P.,10,0,45,35
1746584067887,EDS 206R,A00,895694,Fargason; Sharon Gayle,1,0,30,29
1746584067887,EDS 206R,B00,895695,Choi; Bailey Miyeon,16,0,30,14
1746584068911,EDS 250,A00,895697,Hemans; Patricia Ann Benitez,22,0,45,23
1746584069934,EDS 281,A00,895701,Meyerott; Theresa Ann,1,0,15,14
1746584070964,EDS 284,A00,895736,Meyerott; Theresa Ann,1,0,15,14
1746584071989,EDS 286,A00,897210,Fine; Sarah,0,0,15,15
1746584073016,EDS 289C,A01,895770,Daly; Alan J.,1,0,15,14
1746584074041,EDS 290,A00,897211,Hofstetter; Carolyn,0,0,15,15
1746584075073,LIGM 5A,A00,896162,Fischer-Grunski; Eva K,12,0,20,8
1746584076098,LIGM 5B,A00,896260,Fischer-Grunski; Eva K,17,0,20,3
1746584077127,LIGM 5C,A00,896308,Fischer-Grunski; Eva K,18,0,20,2
1746584078152,LIIT 5AS,A00,896313,Carnelos; Chiara,18,0,20,2
1746584079180,LIIT 5BS,A00,896416,Carnelos; Chiara,20,0,20,0
1746584080209,LIIT 5CS,A00,896564,Carnelos; Chiara,20,0,20,0
1746584081235,LISP 5A,A00,896588,Munoz Sanchez; Alicia,2,0,20,18
1746584082262,LISP 5B,A00,896653,Munoz Sanchez; Alicia,7,0,20,13
1746584083287,LISP 5C,A00,896655,Munoz Sanchez; Alicia,0,1,20,20
1746584084316,MAE 197,001,957918,Kleissl; Jan,9996,0,9999,3
1746584084316,MAE 197,002,959806,Boechler; Nicholas Sebastia,9998,0,9999,1
1746584084316,MAE 197,003,959852,Mullin; Jennifer S,9998,0,9999,1
1746584085349,MATH 2,A01,957937,Staff,33,0,35,2
1746584086373,MATH 197,001,957876,Kedlaya; Kiran S.,9993,0,9999,6
1746584087398,MCWP 40,A00,892729,Duru; Nur,10,0,20,10
1746584087398,MCWP 40,B00,893304,Montejo; Carolina,14,0,20,6
1746584088425,MCWP 40R,A00,893757,Redela; Pamela Morgan,0,5,20,20
1746584089454,MCWP 50,A00,893758,Morshed; Michael James,0,0,20,20
1746584089454,MCWP 50,B00,893761,Bartulis; Jason Michael,17,0,20,3
1746584090484,MCWP 50R,A00,893766,Compas; Sean Matthew,0,1,20,20
1746584090484,MCWP 50R,B00,893769,Carter; Jennifer A,0,1,20,20
1746584090484,MCWP 50R,C00,893771,Krone; Jarret,0,3,20,20
1746584090484,MCWP 50R,D00,893772,Miller; Elizabeth Deen,0,0,20,20
1746584090484,MCWP 50R,E00,893775,Carter; Andrea L,0,1,20,20
1746584091509,MMW 11R,A01,892721,Herbst; Matthew,14,0,30,16
1746584091509,MMW 11R,A02,892722,Herbst; Matthew,0,0,0,3
1746584092538,MMW 12R,A01,892724,Herbst; Matthew,0,11,16,16
1746584092538,MMW 12R,A02,892725,Herbst; Matthew,0,10,16,16
1746584093567,MMW 13R,A01,892727,Staff,0,4,16,16
1746584093567,MMW 13R,A02,892728,Staff,0,4,16,16
1746584093567,MMW 13R,A03,958032,Staff,0,4,16,16
1746584093567,MMW 13R,A04,958033,Staff,0,4,16,16
1746584093567,MMW 13R,A05,958034,Staff,0,4,16,16
1746584094595,SIO 295LS,A00,894015,Staff,5,0,25,20
1746584095620,SIO 295S,A00,894020,Staff,5,0,25,20
1746584096650,SIOC 290S,B01,958918,Merrifield; Mark A,14,0,30,16
1746584097676,SIOC 291S,B01,958922,Gabriel; Corey John,14,0,30,16
1746584098703,SOCI 117,A01,895339,Staff,3,0,5,2
1746584099729,WES 237B,A00,894149,Staff,11,0,20,9
1746584101799,AESE 279B,A00,891859,Staff,13,0,35,22
1746584102829,AIP 197,001,891854,Vespa; Emanuel Ignacio,9999,0,9999,0
1746584103857,ANTH 289S,A00,891856,Gagneux; Pascal,12,0,12,0
1746584104882,BENG 196,001,957946,Engler; Adam J.,9996,0,9999,3
1746584105907,BISP 197,001,959851,Wilhelm; James E.,9998,0,9999,1
1746584106932,CAT 124RS,A01,956906,Staff,6,0,25,19
1746584107960,CAT 125RS,A01,922013,Staff,6,0,25,19
1746584108984,CLRE 250,A00,891860,Morris; Sheldon,9995,0,9999,4
1746584111044,CLRE 251R,A00,907817,Mehta; Ravindra L.,9994,0,9999,5
1746584112073,CLRE 252,A00,891864,Cuomo; Raphael Eduardo,9993,0,9999,6
1746584113100,CLRE 253,A00,891867,Vaida; Florin,9994,0,9999,5
1746584113100,CLRE 253,B00,907819,Staff,9999,0,9999,0
1746584114131,CLRE 259,A00,891868,Patel; Hemal,9998,0,9999,1
1746584115157,CLRE 260,A00,891872,Cuomo; Raphael Eduardo,9999,0,9999,0
1746584116184,CLRE 297,001,891888,Cuomo; Raphael Eduardo,9999,0,9999,0
1746584117209,CSE 191,A00,958773,Minnes Kemp; Mor Mia,9995,0,9999,4
1746584118238,CSE 197,001,959846,Minnes Kemp; Mor Mia,9990,0,9999,9
1746584119266,CSS 201S,A01,892054,Mignozzetti; Umberto,25,0,30,5
1746584120293,CSS 202S,A01,892056,Mignozzetti; Umberto,25,0,30,5
1746584121322,DSC 197,001,956898,Eldridge; Justin Matthew,9996,0,9999,3
1746584122346,DSC 297,001,958000,Mazumdar; Arya,9998,0,9999,1
1746584122346,DSC 297,002,959862,Wang; Yusu,9998,0,9999,1
1746584123372,EAP 100,A00,905686,Staff,9778,0,9999,221
1746584124398,ECE 45,A01,892618,Staff,0,0,65,65
1746584126448,ECE 111,A01,892719,Staff,6,0,65,59
1746584127474,ECE 197,001,957920,Mercier; Patrick Philip,9991,0,9999,8
1746584128499,ECON 178,A01,907814,Zhu; Ying,26,0,35,9
1746584129529,EDS 115,A00,895312,Staff,35,0,45,10
1746584130558,EDS 117,A01,895337,Staff,23,0,30,7
1746584131583,EDS 125,A00,895341,Jones; Gabrielle Anastasia,36,0,45,9
1746584132609,EDS 128A,A01,895459,Fargason; Sharon Gayle,44,0,45,1
1746584133635,EDS 128B,A01,895543,Pappas; Elizabeth,44,0,45,1
1746584134662,EDS 139,A00,897203,Pappas; Elizabeth,44,0,45,1
1746584134662,EDS 139,B00,897209,Fargason; Sharon Gayle,41,0,45,4
1746584135688,EDS 201,A00,895545,Staff,22,0,45,23
1746584136713,EDS 203,A01,895581,Halter; Christopher P.,22,0,45,23
1746584137739,EDS 204R,A01,895625,Heinzman; Erica M.,39,0,45,6
1746584137739,EDS 204R,B01,895693,Halter; Christopher P.,10,0,45,35
1746584138768,EDS 206R,A00,895694,Fargason; Sharon Gayle,1,0,30,29
1746584138768,EDS 206R,B00,895695,Choi; Bailey Miyeon,16,0,30,14
1746584139795,EDS 250,A00,895697,Hemans; Patricia Ann Benitez,22,0,45,23
1746584140821,EDS 281,A00,895701,Meyerott; Theresa Ann,1,0,15,14
1746584141851,EDS 284,A00,895736,Meyerott; Theresa Ann,1,0,15,14
1746584142878,EDS 286,A00,897210,Fine; Sarah,0,0,15,15
1746584143906,EDS 289C,A01,895770,Daly; Alan J.,1,0,15,14
1746584144937,EDS 290,A00,897211,Hofstetter; Carolyn,0,0,15,15
1746584145962,LIGM 5A,A00,896162,Fischer-Grunski; Eva K,12,0,20,8
1746584146989,LIGM 5B,A00,896260,Fischer-Grunski; Eva K,17,0,20,3
1746584148020,LIGM 5C,A00,896308,Fischer-Grunski; Eva K,18,0,20,2
1746584149049,LIIT 5AS,A00,896313,Carnelos; Chiara,18,0,20,2
1746584150075,LIIT 5BS,A00,896416,Carnelos; Chiara,20,0,20,0
1746584151100,LIIT 5CS,A00,896564,Carnelos; Chiara,20,0,20,0
1746584152126,LISP 5A,A00,896588,Munoz Sanchez; Alicia,2,0,20,18
1746584153154,LISP 5B,A00,896653,Munoz Sanchez; Alicia,7,0,20,13
1746584154182,LISP 5C,A00,896655,Munoz Sanchez; Alicia,0,1,20,20
1746584155208,MAE 197,001,957918,Kleissl; Jan,9996,0,9999,3
1746584155208,MAE 197,002,959806,Boechler; Nicholas Sebastia,9998,0,9999,1
1746584155208,MAE 197,003,959852,Mullin; Jennifer S,9998,0,9999,1
1746584156233,MATH 2,A01,957937,Staff,33,0,35,2
1746584157262,MATH 197,001,957876,Kedlaya; Kiran S.,9993,0,9999,6
1746584158287,MCWP 40,A00,892729,Duru; Nur,10,0,20,10
1746584158287,MCWP 40,B00,893304,Montejo; Carolina,14,0,20,6
1746584159311,MCWP 40R,A00,893757,Redela; Pamela Morgan,0,5,20,20
1746584160341,MCWP 50,A00,893758,Morshed; Michael James,0,0,20,20
1746584160341,MCWP 50,B00,893761,Bartulis; Jason Michael,17,0,20,3
1746584161366,MCWP 50R,A00,893766,Compas; Sean Matthew,0,1,20,20
1746584161366,MCWP 50R,B00,893769,Carter; Jennifer A,0,1,20,20
1746584161366,MCWP 50R,C00,893771,Krone; Jarret,0,3,20,20
1746584161366,MCWP 50R,D00,893772,Miller; Elizabeth Deen,0,0,20,20
1746584161366,MCWP 50R,E00,893775,Carter; Andrea L,0,1,20,20
1746584162391,MMW 11R,A01,892721,Herbst; Matthew,14,0,30,16
1746584162391,MMW 11R,A02,892722,Herbst; Matthew,0,0,0,3
1746584163415,MMW 12R,A01,892724,Herbst; Matthew,0,11,16,16
1746584163415,MMW 12R,A02,892725,Herbst; Matthew,0,10,16,16
1746584164440,MMW 13R,A01,892727,Staff,0,4,16,16
1746584164440,MMW 13R,A02,892728,Staff,0,4,16,16
1746584164440,MMW 13R,A03,958032,Staff,0,4,16,16
1746584164440,MMW 13R,A04,958033,Staff,0,4,16,16
1746584164440,MMW 13R,A05,958034,Staff,0,4,16,16
1746584165468,SIO 295LS,A00,894015,Staff,5,0,25,20
1746584166496,SIO 295S,A00,894020,Staff,5,0,25,20
1746584167526,SIOC 290S,B01,958918,Merrifield; Mark A,14,0,30,16
1746584168553,SIOC 291S,B01,958922,Gabriel; Corey John,14,0,30,16
1746584169580,SOCI 117,A01,895339,Staff,3,0,5,2
1746584170606,WES 237B,A00,894149,Staff,11,0,20,9
1746584172674,AESE 279B,A00,891859,Staff,13,0,35,22
1746584173699,AIP 197,001,891854,Vespa; Emanuel Ignacio,9999,0,9999,0
1746584174723,ANTH 289S,A00,891856,Gagneux; Pascal,12,0,12,0
1746584175751,BENG 196,001,957946,Engler; Adam J.,9996,0,9999,3
1746584176777,BISP 197,001,959851,Wilhelm; James E.,9998,0,9999,1
1746584177867,CAT 124RS,A01,956906,Staff,6,0,25,19
1746584178894,CAT 125RS,A01,922013,Staff,6,0,25,19
1746584179922,CLRE 250,A00,891860,Morris; Sheldon,9995,0,9999,4
1746584181975,CLRE 251R,A00,907817,Mehta; Ravindra L.,9994,0,9999,5
1746584183004,CLRE 252,A00,891864,Cuomo; Raphael Eduardo,9993,0,9999,6
1746584184029,CLRE 253,A00,891867,Vaida; Florin,9994,0,9999,5
1746584184029,CLRE 253,B00,907819,Staff,9999,0,9999,0
1746584185060,CLRE 259,A00,891868,Patel; Hemal,9998,0,9999,1
1746584186085,CLRE 260,A00,891872,Cuomo; Raphael Eduardo,9999,0,9999,0
1746584187113,CLRE 297,001,891888,Cuomo; Raphael Eduardo,9999,0,9999,0
1746584188141,CSE 191,A00,958773,Minnes Kemp; Mor Mia,9995,0,9999,4
1746584189170,CSE 197,001,959846,Minnes Kemp; Mor Mia,9990,0,9999,9
1746584190197,CSS 201S,A01,892054,Mignozzetti; Umberto,25,0,30,5
1746584191226,CSS 202S,A01,892056,Mignozzetti; Umberto,25,0,30,5
1746584192254,DSC 197,001,956898,Eldridge; Justin Matthew,9996,0,9999,3
1746584193279,DSC 297,001,958000,Mazumdar; Arya,9998,0,9999,1
1746584193279,DSC 297,002,959862,Wang; Yusu,9998,0,9999,1
1746584194304,EAP 100,A00,905686,Staff,9778,0,9999,221
1746584195329,ECE 45,A01,892618,Staff,0,0,65,65
1746584197383,ECE 111,A01,892719,Staff,6,0,65,59
1746584198411,ECE 197,001,957920,Mercier; Patrick Philip,9991,0,9999,8
1746584199438,ECON 178,A01,907814,Zhu; Ying,26,0,35,9
1746584200464,EDS 115,A00,895312,Staff,35,0,45,10
1746584201494,EDS 117,A01,895337,Staff,23,0,30,7
1746584202522,EDS 125,A00,895341,Jones; Gabrielle Anastasia,36,0,45,9
1746584203548,EDS 128A,A01,895459,Fargason; Sharon Gayle,44,0,45,1
1746584204574,EDS 128B,A01,895543,Pappas; Elizabeth,44,0,45,1
1746584205602,EDS 139,A00,897203,Pappas; Elizabeth,44,0,45,1
1746584205602,EDS 139,B00,897209,Fargason; Sharon Gayle,41,0,45,4
1746584206628,EDS 201,A00,895545,Staff,22,0,45,23
1746584207660,EDS 203,A01,895581,Halter; Christopher P.,22,0,45,23
1746584208688,EDS 204R,A01,895625,Heinzman; Erica M.,39,0,45,6
1746584208688,EDS 204R,B01,895693,Halter; Christopher P.,10,0,45,35
1746584209718,EDS 206R,A00,895694,Fargason; Sharon Gayle,1,0,30,29
1746584209718,EDS 206R,B00,895695,Choi; Bailey Miyeon,16,0,30,14
1746584210741,EDS 250,A00,895697,Hemans; Patricia Ann Benitez,22,0,45,23
1746584211771,EDS 281,A00,895701,Meyerott; Theresa Ann,1,0,15,14
1746584212798,EDS 284,A00,895736,Meyerott; Theresa Ann,1,0,15,14
1746584213828,EDS 286,A00,897210,Fine; Sarah,0,0,15,15
1746584214853,EDS 289C,A01,895770,Daly; Alan J.,1,0,15,14
1746584215878,EDS 290,A00,897211,Hofstetter; Carolyn,0,0,15,15
1746584216904,LIGM 5A,A00,896162,Fischer-Grunski; Eva K,12,0,20,8
1746584217933,LIGM 5B,A00,896260,Fischer-Grunski; Eva K,17,0,20,3
1746584218958,LIGM 5C,A00,896308,Fischer-Grunski; Eva K,18,0,20,2
1746584219984,LIIT 5AS,A00,896313,Carnelos; Chiara,18,0,20,2
1746584221009,LIIT 5BS,A00,896416,Carnelos; Chiara,20,0,20,0
1746584222038,LIIT 5CS,A00,896564,Carnelos; Chiara,20,0,20,0
1746584223068,LISP 5A,A00,896588,Munoz Sanchez; Alicia,2,0,20,18
1746584224098,LISP 5B,A00,896653,Munoz Sanchez; Alicia,7,0,20,13
1746584225128,LISP 5C,A00,896655,Munoz Sanchez; Alicia,0,1,20,20
1746584226156,MAE 197,001,957918,Kleissl; Jan,9996,0,9999,3
1746584226156,MAE 197,002,959806,Boechler; Nicholas Sebastia,9998,0,9999,1
1746584226156,MAE 197,003,959852,Mullin; Jennifer S,9998,0,9999,1
1746584227185,MATH 2,A01,957937,Staff,33,0,35,2
1746584228211,MATH 197,001,957876,Kedlaya; Kiran S.,9993,0,9999,6
1746584229240,MCWP 40,A00,892729,Duru; Nur,10,0,20,10
1746584229240,MCWP 40,B00,893304,Montejo; Carolina,14,0,20,6
1746584230265,MCWP 40R,A00,893757,Redela; Pamela Morgan,0,5,20,20
1746584231291,MCWP 50,A00,893758,Morshed; Michael James,0,0,20,20
1746584231291,MCWP 50,B00,893761,Bartulis; Jason Michael,17,0,20,3
1746584232317,MCWP 50R,A00,893766,Compas; Sean Matthew,0,1,20,20
1746584232317,MCWP 50R,B00,893769,Carter; Jennifer A,0,1,20,20
1746584232317,MCWP 50R,C00,893771,Krone; Jarret,0,3,20,20
1746584232317,MCWP 50R,D00,893772,Miller; Elizabeth Deen,0,0,20,20
1746584232317,MCWP 50R,E00,893775,Carter; Andrea L,0,1,20,20
1746584233341,MMW 11R,A01,892721,Herbst; Matthew,14,0,30,16
1746584233341,MMW 11R,A02,892722,Herbst; Matthew,0,0,0,3
1746584234366,MMW 12R,A01,892724,Herbst; Matthew,0,11,16,16
1746584234366,MMW 12R,A02,892725,Herbst; Matthew,0,10,16,16
1746584235392,MMW 13R,A01,892727,Staff,0,4,16,16
1746584235392,MMW 13R,A02,892728,Staff,0,4,16,16
1746584235392,MMW 13R,A03,958032,Staff,0,4,16,16
1746584235392,MMW 13R,A04,958033,Staff,0,4,16,16
1746584235392,MMW 13R,A05,958034,Staff,0,4,16,16
1746584236417,SIO 295LS,A00,894015,Staff,5,0,25,20
1746584237442,SIO 295S,A00,894020,Staff,5,0,25,20
1746584238470,SIOC 290S,B01,958918,Merrifield; Mark A,14,0,30,16
1746584239498,SIOC 291S,B01,958922,Gabriel; Corey John,14,0,30,16
1746584240523,SOCI 117,A01,895339,Staff,3,0,5,2
1746584241549,WES 237B,A00,894149,Staff,11,0,20,9
1746584243619,AESE 279B,A00,891859,Staff,13,0,35,22
1746584244644,AIP 197,001,891854,Vespa; Emanuel Ignacio,9999,0,9999,0
1746584245671,ANTH 289S,A00,891856,Gagneux; Pascal,12,0,12,0
1746584246698,BENG 196,001,957946,Engler; Adam J.,9996,0,9999,3
1746584247723,BISP 197,001,959851,Wilhelm; James E.,9998,0,9999,1
1746584248747,CAT 124RS,A01,956906,Staff,6,0,25,19
1746584249771,CAT 125RS,A01,922013,Staff,6,0,25,19
1746584250797,CLRE 250,A00,891860,Morris; Sheldon,9995,0,9999,4
1746584252854,CLRE 251R,A00,907817,Mehta; Ravindra L.,9994,0,9999,5
1746584253879,CLRE 252,A00,891864,Cuomo; Raphael Eduardo,9993,0,9999,6
1746584254908,CLRE 253,A00,891867,Vaida; Florin,9994,0,9999,5
1746584254908,CLRE 253,B00,907819,Staff,9999,0,9999,0
1746584255937,CLRE 259,A00,891868,Patel; Hemal,9998,0,9999,1
1746584256965,CLRE 260,A00,891872,Cuomo; Raphael Eduardo,9999,0,9999,0
1746584257993,CLRE 297,001,891888,Cuomo; Raphael Eduardo,9999,0,9999,0
1746584259019,CSE 191,A00,958773,Minnes Kemp; Mor Mia,9995,0,9999,4
1746584260048,CSE 197,001,959846,Minnes Kemp; Mor Mia,9990,0,9999,9
1746584261076,CSS 201S,A01,892054,Mignozzetti; Umberto,25,0,30,5
1746584262105,CSS 202S,A01,892056,Mignozzetti; Umberto,25,0,30,5
1746584263132,DSC 197,001,956898,Eldridge; Justin Matthew,9996,0,9999,3
1746584264157,DSC 297,001,958000,Mazumdar; Arya,9998,0,9999,1
1746584264157,DSC 297,002,959862,Wang; Yusu,9998,0,9999,1
1746584265185,EAP 100,A00,905686,Staff,9778,0,9999,221
1746584266212,ECE 45,A01,892618,Staff,0,0,65,65
1746584268269,ECE 111,A01,892719,Staff,6,0,65,59
1746584269293,ECE 197,001,957920,Mercier; Patrick Philip,9991,0,9999,8
1746584270318,ECON 178,A01,907814,Zhu; Ying,26,0,35,9
1746584271346,EDS 115,A00,895312,Staff,35,0,45,10
1746584272376,EDS 117,A01,895337,Staff,23,0,30,7
1746584273404,EDS 125,A00,895341,Jones; Gabrielle Anastasia,36,0,45,9
1746584274433,EDS 128A,A01,895459,Fargason; Sharon Gayle,44,0,45,1
1746584275462,EDS 128B,A01,895543,Pappas; Elizabeth,44,0,45,1
1746584276490,EDS 139,A00,897203,Pappas; Elizabeth,44,0,45,1
1746584276490,EDS 139,B00,897209,Fargason; Sharon Gayle,41,0,45,4
1746584277518,EDS 201,A00,895545,Staff,22,0,45,23
1746584278547,EDS 203,A01,895581,Halter; Christopher P.,22,0,45,23
1746584279570,EDS 204R,A01,895625,Heinzman; Erica M.,39,0,45,6
1746584279570,EDS 204R,B01,895693,Halter; Christopher P.,10,0,45,35
1746584280596,EDS 206R,A00,895694,Fargason; Sharon Gayle,1,0,30,29
1746584280596,EDS 206R,B00,895695,Choi; Bailey Miyeon,16,0,30,14
1746584281620,EDS 250,A00,895697,Hemans; Patricia Ann Benitez,22,0,45,23
1746584282650,EDS 281,A00,895701,Meyerott; Theresa Ann,1,0,15,14
1746584283679,EDS 284,A00,895736,Meyerott; Theresa Ann,1,0,15,14
1746584284703,EDS 286,A00,897210,Fine; Sarah,0,0,15,15
1746584285729,EDS 289C,A01,895770,Daly; Alan J.,1,0,15,14
1746584286756,EDS 290,A00,897211,Hofstetter; Carolyn,0,0,15,15
1746584287787,LIGM 5A,A00,896162,Fischer-Grunski; Eva K,12,0,20,8
1746584288813,LIGM 5B,A00,896260,Fischer-Grunski; Eva K,17,0,20,3
1746584289844,LIGM 5C,A00,896308,Fischer-Grunski; Eva K,18,0,20,2
1746584290870,LIIT 5AS,A00,896313,Carnelos; Chiara,18,0,20,2
1746584291897,LIIT 5BS,A00,896416,Carnelos; Chiara,20,0,20,0
1746584292922,LIIT 5CS,A00,896564,Carnelos; Chiara,20,0,20,0
1746584293952,LISP 5A,A00,896588,Munoz Sanchez; Alicia,2,0,20,18
1746584294977,LISP 5B,A00,896653,Munoz Sanchez; Alicia,7,0,20,13
1746584296003,LISP 5C,A00,896655,Munoz Sanchez; Alicia,0,1,20,20
1746584297032,MAE 197,001,957918,Kleissl; Jan,9996,0,9999,3
1746584297032,MAE 197,002,959806,Boechler; Nicholas Sebastia,9998,0,9999,1
1746584297032,MAE 197,003,959852,Mullin; Jennifer S,9998,0,9999,1
1746584298060,MATH 2,A01,957937,Staff,33,0,35,2
1746584299086,MATH 197,001,957876,Kedlaya; Kiran S.,9993,0,9999,6
1746584300111,MCWP 40,A00,892729,Duru; Nur,10,0,20,10
1746584300111,MCWP 40,B00,893304,Montejo; Carolina,14,0,20,6
1746584301137,MCWP 40R,A00,893757,Redela; Pamela Morgan,0,5,20,20
1746584302162,MCWP 50,A00,893758,Morshed; Michael James,0,0,20,20
1746584302162,MCWP 50,B00,893761,Bartulis; Jason Michael,17,0,20,3
1746584303189,MCWP 50R,A00,893766,Compas; Sean Matthew,0,1,20,20
1746584303189,MCWP 50R,B00,893769,Carter; Jennifer A,0,1,20,20
1746584303189,MCWP 50R,C00,893771,Krone; Jarret,0,3,20,20
1746584303189,MCWP 50R,D00,893772,Miller; Elizabeth Deen,0,0,20,20
1746584303189,MCWP 50R,E00,893775,Carter; Andrea L,0,1,20,20
1746584304218,MMW 11R,A01,892721,Herbst; Matthew,14,0,30,16
1746584304218,MMW 11R,A02,892722,Herbst; Matthew,0,0,0,3
1746584305243,MMW 12R,A01,892724,Herbst; Matthew,0,11,16,16
1746584305243,MMW 12R,A02,892725,Herbst; Matthew,0,10,16,16
1746584306272,MMW 13R,A01,892727,Staff,0,4,16,16
1746584306272,MMW 13R,A02,892728,Staff,0,4,16,16
1746584306272,MMW 13R,A03,958032,Staff,0,4,16,16
1746584306272,MMW 13R,A04,958033,Staff,0,4,16,16
1746584306272,MMW 13R,A05,958034,Staff,0,4,16,16
1746584307296,SIO 295LS,A00,894015,Staff,5,0,25,20
1746584308325,SIO 295S,A00,894020,Staff,5,0,25,20
1746584309350,SIOC 290S,B01,958918,Merrifield; Mark A,14,0,30,16
1746584310377,SIOC 291S,B01,958922,Gabriel; Corey John,14,0,30,16
1746584311402,SOCI 117,A01,895339,Staff,3,0,5,2
1746584312427,WES 237B,A00,894149,Staff,11,0,20,9
1746584314494,AESE 279B,A00,891859,Staff,13,0,35,22
1746584315519,AIP 197,001,891854,Vespa; Emanuel Ignacio,9999,0,9999,0
1746584316547,ANTH 289S,A00,891856,Gagneux; Pascal,12,0,12,0
1746584317577,BENG 196,001,957946,Engler; Adam J.,9996,0,9999,3
1746584318603,BISP 197,001,959851,Wilhelm; James E.,9998,0,9999,1
1746584319629,CAT 124RS,A01,956906,Staff,6,0,25,19
1746584320654,CAT 125RS,A01,922013,Staff,6,0,25,19
1746584321680,CLRE 250,A00,891860,Morris; Sheldon,9995,0,9999,4
1746584323734,CLRE 251R,A00,907817,Mehta; Ravindra L.,9994,0,9999,5
1746584324758,CLRE 252,A00,891864,Cuomo; Raphael Eduardo,9993,0,9999,6
1746584325785,CLRE 253,A00,891867,Vaida; Florin,9994,0,9999,5
1746584325785,CLRE 253,B00,907819,Staff,9999,0,9999,0
1746584326810,CLRE 259,A00,891868,Patel; Hemal,9998,0,9999,1
1746584327838,CLRE 260,A00,891872,Cuomo; Raphael Eduardo,9999,0,9999,0
1746584328866,CLRE 297,001,891888,Cuomo; Raphael Eduardo,9999,0,9999,0
1746584329893,CSE 191,A00,958773,Minnes Kemp; Mor Mia,9995,0,9999,4
1746584330922,CSE 197,001,959846,Minnes Kemp; Mor Mia,9990,0,9999,9
1746584331951,CSS 201S,A01,892054,Mignozzetti; Umberto,25,0,30,5
1746584332979,CSS 202S,A01,892056,Mignozzetti; Umberto,25,0,30,5
1746584334003,DSC 197,001,956898,Eldridge; Justin Matthew,9996,0,9999,3
1746584335029,DSC 297,001,958000,Mazumdar; Arya,9998,0,9999,1
1746584335029,DSC 297,002,959862,Wang; Yusu,9998,0,9999,1
1746584336053,EAP 100,A00,905686,Staff,9778,0,9999,221
1746584337078,ECE 45,A01,892618,Staff,0,0,65,65
1746584339131,ECE 111,A01,892719,Staff,6,0,65,59
1746584340158,ECE 197,001,957920,Mercier; Patrick Philip,9991,0,9999,8
1746584341183,ECON 178,A01,907814,Zhu; Ying,26,0,35,9
1746584342213,EDS 115,A00,895312,Staff,35,0,45,10
1746584343242,EDS 117,A01,895337,Staff,23,0,30,7
1746584344267,EDS 125,A00,895341,Jones; Gabrielle Anastasia,36,0,45,9
1746584345297,EDS 128A,A01,895459,Fargason; Sharon Gayle,44,0,45,1
1746584346325,EDS 128B,A01,895543,Pappas; Elizabeth,44,0,45,1
1746584347349,EDS 139,A00,897203,Pappas; Elizabeth,44,0,45,1
1746584347349,EDS 139,B00,897209,Fargason; Sharon Gayle,41,0,45,4
1746584348377,EDS 201,A00,895545,Staff,22,0,45,23
1746584349401,EDS 203,A01,895581,Halter; Christopher P.,22,0,45,23
1746584350431,EDS 204R,A01,895625,Heinzman; Erica M.,39,0,45,6
1746584350431,EDS 204R,B01,895693,Halter; Christopher P.,10,0,45,35
1746584351458,EDS 206R,A00,895694,Fargason; Sharon Gayle,1,0,30,29
1746584351458,EDS 206R,B00,895695,Choi; Bailey Miyeon,16,0,30,14
1746584352486,EDS 250,A00,895697,Hemans; Patricia Ann Benitez,22,0,45,23
1746584353512,EDS 281,A00,895701,Meyerott; Theresa Ann,1,0,15,14
1746584354541,EDS 284,A00,895736,Meyerott; Theresa Ann,1,0,15,14
1746584355567,EDS 286,A00,897210,Fine; Sarah,0,0,15,15
1746584356593,EDS 289C,A01,895770,Daly; Alan J.,1,0,15,14
1746584357617,EDS 290,A00,897211,Hofstetter; Carolyn,0,0,15,15
1746584358643,LIGM 5A,A00,896162,Fischer-Grunski; Eva K,12,0,20,8
1746584359667,LIGM 5B,A00,896260,Fischer-Grunski; Eva K,17,0,20,3
1746584360692,LIGM 5C,A00,896308,Fischer-Grunski; Eva K,18,0,20,2
1746584361717,LIIT 5AS,A00,896313,Carnelos; Chiara,18,0,20,2
1746584362747,LIIT 5BS,A00,896416,Carnelos; Chiara,20,0,20,0
1746584363775,LIIT 5CS,A00,896564,Carnelos; Chiara,20,0,20,0
1746584364802,LISP 5A,A00,896588,Munoz Sanchez; Alicia,2,0,20,18
1746584365825,LISP 5B,A00,896653,Munoz Sanchez; Alicia,7,0,20,13
1746584366873,LISP 5C,A00,896655,Munoz Sanchez; Alicia,0,1,20,20
1746584367902,MAE 197,001,957918,Kleissl; Jan,9996,0,9999,3
1746584367902,MAE 197,002,959806,Boechler; Nicholas Sebastia,9998,0,9999,1
1746584367902,MAE 197,003,959852,Mullin; Jennifer S,9998,0,9999,1
1746584368929,MATH 2,A01,957937,Staff,33,0,35,2
1746584369954,MATH 197,001,957876,Kedlaya; Kiran S.,9993,0,9999,6
1746584370979,MCWP 40,A00,892729,Duru; Nur,10,0,20,10
1746584370979,MCWP 40,B00,893304,Montejo; Carolina,14,0,20,6
1746584372004,MCWP 40R,A00,893757,Redela; Pamela Morgan,0,5,20,20
1746584373030,MCWP 50,A00,893758,Morshed; Michael James,0,0,20,20
1746584373030,MCWP 50,B00,893761,Bartulis; Jason Michael,17,0,20,3
1746584374059,MCWP 50R,A00,893766,Compas; Sean Matthew,0,1,20,20
1746584374059,MCWP 50R,B00,893769,Carter; Jennifer A,0,1,20,20
1746584374059,MCWP 50R,C00,893771,Krone; Jarret,0,3,20,20
1746584374059,MCWP 50R,D00,893772,Miller; Elizabeth Deen,0,0,20,20
1746584374059,MCWP 50R,E00,893775,Carter; Andrea L,0,1,20,20
1746584375086,MMW 11R,A01,892721,Herbst; Matthew,14,0,30,16
1746584375086,MMW 11R,A02,892722,Herbst; Matthew,0,0,0,3
1746584376118,MMW 12R,A01,892724,Herbst; Matthew,0,11,16,16
1746584376118,MMW 12R,A02,892725,Herbst; Matthew,0,10,16,16
1746584377144,MMW 13R,A01,892727,Staff,0,4,16,16
1746584377144,MMW 13R,A02,892728,Staff,0,4,16,16
1746584377144,MMW 13R,A03,958032,Staff,0,4,16,16
1746584377144,MMW 13R,A04,958033,Staff,0,4,16,16
1746584377144,MMW 13R,A05,958034,Staff,0,4,16,16
1746584378169,SIO 295LS,A00,894015,Staff,5,0,25,20
1746584379195,SIO 295S,A00,894020,Staff,5,0,25,20
1746584380219,SIOC 290S,B01,958918,Merrifield; Mark A,14,0,30,16
1746584381248,SIOC 291S,B01,958922,Gabriel; Corey John,14,0,30,16
1746584382276,SOCI 117,A01,895339,Staff,3,0,5,2
1746584383301,WES 237B,A00,894149,Staff,11,0,20,9
1746584385370,AESE 279B,A00,891859,Staff,13,0,35,22
1746584386394,AIP 197,001,891854,Vespa; Emanuel Ignacio,9999,0,9999,0
1746584387418,ANTH 289S,A00,891856,Gagneux; Pascal,12,0,12,0
1746584388443,BENG 196,001,957946,Engler; Adam J.,9996,0,9999,3
1746584389470,BISP 197,001,959851,Wilhelm; James E.,9998,0,9999,1
1746584390493,CAT 124RS,A01,956906,Staff,6,0,25,19
1746584391519,CAT 125RS,A01,922013,Staff,6,0,25,19
1746584392543,CLRE 250,A00,891860,Morris; Sheldon,9995,0,9999,4
1746584394595,CLRE 251R,A00,907817,Mehta; Ravindra L.,9994,0,9999,5
1746584395620,CLRE 252,A00,891864,Cuomo; Raphael Eduardo,9993,0,9999,6
1746584396653,CLRE 253,A00,891867,Vaida; Florin,9994,0,9999,5
1746584396653,CLRE 253,B00,907819,Staff,9999,0,9999,0
1746584397678,CLRE 259,A00,891868,Patel; Hemal,9998,0,9999,1
1746584398706,CLRE 260,A00,891872,Cuomo; Raphael Eduardo,9999,0,9999,0
1746584399734,CLRE 297,001,891888,Cuomo; Raphael Eduardo,9999,0,9999,0
1746584400759,CSE 191,A00,958773,Minnes Kemp; Mor Mia,9995,0,9999,4
1746584401787,CSE 197,001,959846,Minnes Kemp; Mor Mia,9990,0,9999,9
1746584402817,CSS 201S,A01,892054,Mignozzetti; Umberto,25,0,30,5
1746584403846,CSS 202S,A01,892056,Mignozzetti; Umberto,25,0,30,5
1746584404870,DSC 197,001,956898,Eldridge; Justin Matthew,9996,0,9999,3
1746584405898,DSC 297,001,958000,Mazumdar; Arya,9998,0,9999,1
1746584405898,DSC 297,002,959862,Wang; Yusu,9998,0,9999,1
1746584406925,EAP 100,A00,905686,Staff,9778,0,9999,221
1746584407956,ECE 45,A01,892618,Staff,0,0,65,65
1746584410007,ECE 111,A01,892719,Staff,6,0,65,59
1746584411034,ECE 197,001,957920,Mercier; Patrick Philip,9991,0,9999,8
1746584412059,ECON 178,A01,907814,Zhu; Ying,26,0,35,9
1746584413086,EDS 115,A00,895312,Staff,35,0,45,10
1746584414111,EDS 117,A01,895337,Staff,23,0,30,7
1746584415140,EDS 125,A00,895341,Jones; Gabrielle Anastasia,36,0,45,9
1746584416170,EDS 128A,A01,895459,Fargason; Sharon Gayle,44,0,45,1
1746584417198,EDS 128B,A01,895543,Pappas; Elizabeth,44,0,45,1
1746584418225,EDS 139,A00,897203,Pappas; Elizabeth,44,0,45,1
1746584418225,EDS 139,B00,897209,Fargason; Sharon Gayle,41,0,45,4
1746584419251,EDS 201,A00,895545,Staff,22,0,45,23
1746584420276,EDS 203,A01,895581,Halter; Christopher P.,22,0,45,23
1746584421301,EDS 204R,A01,895625,Heinzman; Erica M.,39,0,45,6
1746584421301,EDS 204R,B01,895693,Halter; Christopher P.,10,0,45,35
1746584422325,EDS 206R,A00,895694,Fargason; Sharon Gayle,1,0,30,29
1746584422325,EDS 206R,B00,895695,Choi; Bailey Miyeon,16,0,30,14
1746584423349,EDS 250,A00,895697,Hemans; Patricia Ann Benitez,22,0,45,23
1746584424372,EDS 281,A00,895701,Meyerott; Theresa Ann,1,0,15,14
1746584425396,EDS 284,A00,895736,Meyerott; Theresa Ann,1,0,15,14
1746584426423,EDS 286,A00,897210,Fine; Sarah,0,0,15,15
1746584427449,EDS 289C,A01,895770,Daly; Alan J.,1,0,15,14
1746584428475,EDS 290,A00,897211,Hofstetter; Carolyn,0,0,15,15
1746584429516,LIGM 5A,A00,896162,Fischer-Grunski; Eva K,12,0,20,8
1746584430542,LIGM 5B,A00,896260,Fischer-Grunski; Eva K,17,0,20,3
1746584431568,LIGM 5C,A00,896308,Fischer-Grunski; Eva K,18,0,20,2
1746584432593,LIIT 5AS,A00,896313,Carnelos; Chiara,18,0,20,2
1746584433618,LIIT 5BS,A00,896416,Carnelos; Chiara,20,0,20,0
1746584434644,LIIT 5CS,A00,896564,Carnelos; Chiara,20,0,20,0
1746584435673,LISP 5A,A00,896588,Munoz Sanchez; Alicia,2,0,20,18
1746584436698,LISP 5B,A00,896653,Munoz Sanchez; Alicia,7,0,20,13
1746584437725,LISP 5C,A00,896655,Munoz Sanchez; Alicia,0,1,20,20
1746584438751,MAE 197,001,957918,Kleissl; Jan,9996,0,9999,3
1746584438751,MAE 197,002,959806,Boechler; Nicholas Sebastia,9998,0,9999,1
1746584438751,MAE 197,003,959852,Mullin; Jennifer S,9998,0,9999,1
1746584439775,MATH 2,A01,957937,Staff,33,0,35,2
1746584440803,MATH 197,001,957876,Kedlaya; Kiran S.,9993,0,9999,6
1746584441827,MCWP 40,A00,892729,Duru; Nur,10,0,20,10
1746584441827,MCWP 40,B00,893304,Montejo; Carolina,14,0,20,6
1746584442853,MCWP 40R,A00,893757,Redela; Pamela Morgan,0,5,20,20
1746584443881,MCWP 50,A00,893758,Morshed; Michael James,0,0,20,20
1746584443881,MCWP 50,B00,893761,Bartulis; Jason Michael,17,0,20,3
1746584444910,MCWP 50R,A00,893766,Compas; Sean Matthew,0,1,20,20
1746584444910,MCWP 50R,B00,893769,Carter; Jennifer A,0,1,20,20
1746584444910,MCWP 50R,C00,893771,Krone; Jarret,0,3,20,20
1746584444910,MCWP 50R,D00,893772,Miller; Elizabeth Deen,0,0,20,20
1746584444910,MCWP 50R,E00,893775,Carter; Andrea L,0,1,20,20
1746584445935,MMW 11R,A01,892721,Herbst; Matthew,14,0,30,16
1746584445935,MMW 11R,A02,892722,Herbst; Matthew,0,0,0,3
1746584446959,MMW 12R,A01,892724,Herbst; Matthew,0,11,16,16
1746584446959,MMW 12R,A02,892725,Herbst; Matthew,0,10,16,16
1746584447985,MMW 13R,A01,892727,Staff,0,4,16,16
1746584447985,MMW 13R,A02,892728,Staff,0,4,16,16
1746584447985,MMW 13R,A03,958032,Staff,0,4,16,16
1746584447985,MMW 13R,A04,958033,Staff,0,4,16,16
1746584447985,MMW 13R,A05,958034,Staff,0,4,16,16
1746584449011,SIO 295LS,A00,894015,Staff,5,0,25,20
1746584450036,SIO 295S,A00,894020,Staff,5,0,25,20
1746584451062,SIOC 290S,B01,958918,Merrifield; Mark A,14,0,30,16
1746584452090,SIOC 291S,B01,958922,Gabriel; Corey John,14,0,30,16
1746584453115,SOCI 117,A01,895339,Staff,3,0,5,2
1746584454142,WES 237B,A00,894149,Staff,11,0,20,9
1746584456202,AESE 279B,A00,891859,Staff,13,0,35,22
1746584457227,AIP 197,001,891854,Vespa; Emanuel Ignacio,9999,0,9999,0
1746584458251,ANTH 289S,A00,891856,Gagneux; Pascal,12,0,12,0
1746584459278,BENG 196,001,957946,Engler; Adam J.,9996,0,9999,3
1746584460303,BISP 197,001,959851,Wilhelm; James E.,9998,0,9999,1
1746584461352,CAT 124RS,A01,956906,Staff,6,0,25,19
1746584462378,CAT 125RS,A01,922013,Staff,6,0,25,19
1746584463402,CLRE 250,A00,891860,Morris; Sheldon,9995,0,9999,4
1746584465451,CLRE 251R,A00,907817,Mehta; Ravindra L.,9994,0,9999,5
1746584466482,CLRE 252,A00,891864,Cuomo; Raphael Eduardo,9993,0,9999,6
1746584467509,CLRE 253,A00,891867,Vaida; Florin,9994,0,9999,5
1746584467509,CLRE 253,B00,907819,Staff,9999,0,9999,0
1746584468537,CLRE 259,A00,891868,Patel; Hemal,9998,0,9999,1
1746584469564,CLRE 260,A00,891872,Cuomo; Raphael Eduardo,9999,0,9999,0
1746584470589,CLRE 297,001,891888,Cuomo; Raphael Eduardo,9999,0,9999,0
1746584471613,CSE 191,A00,958773,Minnes Kemp; Mor Mia,9995,0,9999,4
1746584472645,CSE 197,001,959846,Minnes Kemp; Mor Mia,9990,0,9999,9
1746584473670,CSS 201S,A01,892054,Mignozzetti; Umberto,25,0,30,5
1746584474695,CSS 202S,A01,892056,Mignozzetti; Umberto,25,0,30,5
1746584475719,DSC 197,001,956898,Eldridge; Justin Matthew,9996,0,9999,3
1746584476746,DSC 297,001,958000,Mazumdar; Arya,9998,0,9999,1
1746584476746,DSC 297,002,959862,Wang; Yusu,9998,0,9999,1
1746584477772,EAP 100,A00,905686,Staff,9778,0,9999,221
1746584478802,ECE 45,A01,892618,Staff,0,0,65,65
1746584480902,ECE 111,A01,892719,Staff,6,0,65,59
1746584481931,ECE 197,001,957920,Mercier; Patrick Philip,9991,0,9999,8
1746584482962,ECON 178,A01,907814,Zhu; Ying,26,0,35,9
1746584483986,EDS 115,A00,895312,Staff,35,0,45,10
1746584485015,EDS 117,A01,895337,Staff,23,0,30,7
1746584486043,EDS 125,A00,895341,Jones; Gabrielle Anastasia,36,0,45,9
1746584487071,EDS 128A,A01,895459,Fargason; Sharon Gayle,44,0,45,1
1746584488098,EDS 128B,A01,895543,Pappas; Elizabeth,44,0,45,1
1746584489129,EDS 139,A00,897203,Pappas; Elizabeth,44,0,45,1
1746584489129,EDS 139,B00,897209,Fargason; Sharon Gayle,41,0,45,4
1746584490157,EDS 201,A00,895545,Staff,22,0,45,23
1746584491182,EDS 203,A01,895581,Halter; Christopher P.,22,0,45,23
1746584492208,EDS 204R,A01,895625,Heinzman; Erica M.,39,0,45,6
1746584492208,EDS 204R,B01,895693,Halter; Christopher P.,10,0,45,35
1746584493233,EDS 206R,A00,895694,Fargason; Sharon Gayle,1,0,30,29
1746584493233,EDS 206R,B00,895695,Choi; Bailey Miyeon,16,0,30,14
1746584494258,EDS 250,A00,895697,Hemans; Patricia Ann Benitez,22,0,45,23
1746584495285,EDS 281,A00,895701,Meyerott; Theresa Ann,1,0,15,14
1746584496311,EDS 284,A00,895736,Meyerott; Theresa Ann,1,0,15,14
1746584497336,EDS 286,A00,897210,Fine; Sarah,0,0,15,15
1746584498361,EDS 289C,A01,895770,Daly; Alan J.,1,0,15,14
1746584499389,EDS 290,A00,897211,Hofstetter; Carolyn,0,0,15,15
1746584500412,LIGM 5A,A00,896162,Fischer-Grunski; Eva K,12,0,20,8
1746584501437,LIGM 5B,A00,896260,Fischer-Grunski; Eva K,17,0,20,3
1746584502461,LIGM 5C,A00,896308,Fischer-Grunski; Eva K,18,0,20,2
1746584503487,LIIT 5AS,A00,896313,Carnelos; Chiara,18,0,20,2
1746584504512,LIIT 5BS,A00,896416,Carnelos; Chiara,20,0,20,0
1746584505536,LIIT 5CS,A00,896564,Carnelos; Chiara,20,0,20,0
1746584506560,LISP 5A,A00,896588,Munoz Sanchez; Alicia,2,0,20,18
1746584507585,LISP 5B,A00,896653,Munoz Sanchez; Alicia,7,0,20,13
1746584508609,LISP 5C,A00,896655,Munoz Sanchez; Alicia,0,1,20,20
1746584509633,MAE 197,001,957918,Kleissl; Jan,9996,0,9999,3
1746584509633,MAE 197,002,959806,Boechler; Nicholas Sebastia,9998,0,9999,1
1746584509633,MAE 197,003,959852,Mullin; Jennifer S,9998,0,9999,1
1746584510659,MATH 2,A01,957937,Staff,33,0,35,2
1746584511684,MATH 197,001,957876,Kedlaya; Kiran S.,9993,0,9999,6
1746584512749,MCWP 40,A00,892729,Duru; Nur,10,0,20,10
1746584512749,MCWP 40,B00,893304,Montejo; Carolina,14,0,20,6
1746584513772,MCWP 40R,A00,893757,Redela; Pamela Morgan,0,5,20,20
1746584514795,MCWP 50,A00,893758,Morshed; Michael James,0,0,20,20
1746584514795,MCWP 50,B00,893761,Bartulis; Jason Michael,17,0,20,3
1746584515822,MCWP 50R,A00,893766,Compas; Sean Matthew,0,1,20,20
1746584515822,MCWP 50R,B00,893769,Carter; Jennifer A,0,1,20,20
1746584515822,MCWP 50R,C00,893771,Krone; Jarret,0,3,20,20
1746584515822,MCWP 50R,D00,893772,Miller; Elizabeth Deen,0,0,20,20
1746584515822,MCWP 50R,E00,893775,Carter; Andrea L,0,1,20,20
1746584516846,MMW 11R,A01,892721,Herbst; Matthew,14,0,30,16
1746584516846,MMW 11R,A02,892722,Herbst; Matthew,0,0,0,3
1746584517875,MMW 12R,A01,892724,Herbst; Matthew,0,11,16,16
1746584517875,MMW 12R,A02,892725,Herbst; Matthew,0,10,16,16
1746584518901,MMW 13R,A01,892727,Staff,0,4,16,16
1746584518901,MMW 13R,A02,892728,Staff,0,4,16,16
1746584518901,MMW 13R,A03,958032,Staff,0,4,16,16
1746584518901,MMW 13R,A04,958033,Staff,0,4,16,16
1746584518901,MMW 13R,A05,958034,Staff,0,4,16,16
1746584519927,SIO 295LS,A00,894015,Staff,5,0,25,20
1746584520955,SIO 295S,A00,894020,Staff,5,0,25,20
1746584521981,SIOC 290S,B01,958918,Merrifield; Mark A,14,0,30,16
1746584523008,SIOC 291S,B01,958922,Gabriel; Corey John,14,0,30,16
1746584524036,SOCI 117,A01,895339,Staff,3,0,5,2
1746584525061,WES 237B,A00,894149,Staff,11,0,20,9
1746584527125,AESE 279B,A00,891859,Staff,13,0,35,22
1746584528154,AIP 197,001,891854,Vespa; Emanuel Ignacio,9999,0,9999,0
1746584529182,ANTH 289S,A00,891856,Gagneux; Pascal,12,0,12,0
1746584530207,BENG 196,001,957946,Engler; Adam J.,9996,0,9999,3
1746584531234,BISP 197,001,959851,Wilhelm; James E.,9998,0,9999,1
1746584532260,CAT 124RS,A01,956906,Staff,6,0,25,19
1746584533285,CAT 125RS,A01,922013,Staff,6,0,25,19
1746584534310,CLRE 250,A00,891860,Morris; Sheldon,9995,0,9999,4
1746584536360,CLRE 251R,A00,907817,Mehta; Ravindra L.,9994,0,9999,5
1746584537390,CLRE 252,A00,891864,Cuomo; Raphael Eduardo,9993,0,9999,6
1746584538416,CLRE 253,A00,891867,Vaida; Florin,9994,0,9999,5
1746584538416,CLRE 253,B00,907819,Staff,9999,0,9999,0
1746584539442,CLRE 259,A00,891868,Patel; Hemal,9998,0,9999,1
1746584540469,CLRE 260,A00,891872,Cuomo; Raphael Eduardo,9999,0,9999,0
1746584541495,CLRE 297,001,891888,Cuomo; Raphael Eduardo,9999,0,9999,0
1746584542521,CSE 191,A00,958773,Minnes Kemp; Mor Mia,9995,0,9999,4
1746584543549,CSE 197,001,959846,Minnes Kemp; Mor Mia,9990,0,9999,9
1746584544575,CSS 201S,A01,892054,Mignozzetti; Umberto,25,0,30,5
1746584545606,CSS 202S,A01,892056,Mignozzetti; Umberto,25,0,30,5
1746584546632,DSC 197,001,956898,Eldridge; Justin Matthew,9996,0,9999,3
1746584547661,DSC 297,001,958000,Mazumdar; Arya,9998,0,9999,1
1746584547661,DSC 297,002,959862,Wang; Yusu,9998,0,9999,1
1746584548689,EAP 100,A00,905686,Staff,9778,0,9999,221
1746584549717,ECE 45,A01,892618,Staff,0,0,65,65
1746584551771,ECE 111,A01,892719,Staff,6,0,65,59
1746584552798,ECE 197,001,957920,Mercier; Patrick Philip,9991,0,9999,8
1746584553824,ECON 178,A01,907814,Zhu; Ying,26,0,35,9
1746584554851,EDS 115,A00,895312,Staff,35,0,45,10
1746584555875,EDS 117,A01,895337,Staff,23,0,30,7
1746584556904,EDS 125,A00,895341,Jones; Gabrielle Anastasia,36,0,45,9
1746584557932,EDS 128A,A01,895459,Fargason; Sharon Gayle,44,0,45,1
1746584558960,EDS 128B,A01,895543,Pappas; Elizabeth,44,0,45,1
1746584559985,EDS 139,A00,897203,Pappas; Elizabeth,44,0,45,1
1746584559985,EDS 139,B00,897209,Fargason; Sharon Gayle,41,0,45,4
1746584561014,EDS 201,A00,895545,Staff,22,0,45,23
1746584562039,EDS 203,A01,895581,Halter; Christopher P.,22,0,45,23
1746584563066,EDS 204R,A01,895625,Heinzman; Erica M.,39,0,45,6
1746584563066,EDS 204R,B01,895693,Halter; Christopher P.,10,0,45,35
1746584564094,EDS 206R,A00,895694,Fargason; Sharon Gayle,1,0,30,29
1746584564094,EDS 206R,B00,895695,Choi; Bailey Miyeon,16,0,30,14
1746584565122,EDS 250,A00,895697,Hemans; Patricia Ann Benitez,22,0,45,23
1746584566147,EDS 281,A00,895701,Meyerott; Theresa Ann,1,0,15,14
1746584567172,EDS 284,A00,895736,Meyerott; Theresa Ann,1,0,15,14
1746584568198,EDS 286,A00,897210,Fine; Sarah,0,0,15,15
1746584569225,EDS 289C,A01,895770,Daly; Alan J.,1,0,15,14
1746584570254,EDS 290,A00,897211,Hofstetter; Carolyn,0,0,15,15
1746584571279,LIGM 5A,A00,896162,Fischer-Grunski; Eva K,12,0,20,8
1746584572309,LIGM 5B,A00,896260,Fischer-Grunski; Eva K,17,0,20,3
1746584573338,LIGM 5C,A00,896308,Fischer-Grunski; Eva K,18,0,20,2
1746584574363,LIIT 5AS,A00,896313,Carnelos; Chiara,18,0,20,2
1746584575387,LIIT 5BS,A00,896416,Carnelos; Chiara,20,0,20,0
1746584576413,LIIT 5CS,A00,896564,Carnelos; Chiara,20,0,20,0
1746584577439,LISP 5A,A00,896588,Munoz Sanchez; Alicia,2,0,20,18
1746584578464,LISP 5B,A00,896653,Munoz Sanchez; Alicia,7,0,20,13
1746584579492,LISP 5C,A00,896655,Munoz Sanchez; Alicia,0,1,20,20
1746584580521,MAE 197,001,957918,Kleissl; Jan,9996,0,9999,3
1746584580521,MAE 197,002,959806,Boechler; Nicholas Sebastia,9998,0,9999,1
1746584580521,MAE 197,003,959852,Mullin; Jennifer S,9998,0,9999,1
1746584581549,MATH 2,A01,957937,Staff,33,0,35,2
1746584582575,MATH 197,001,957876,Kedlaya; Kiran S.,9993,0,9999,6
1746584583604,MCWP 40,A00,892729,Duru; Nur,10,0,20,10
1746584583604,MCWP 40,B00,893304,Montejo; Carolina,14,0,20,6
1746584584629,MCWP 40R,A00,893757,Redela; Pamela Morgan,0,5,20,20
1746584585659,MCWP 50,A00,893758,Morshed; Michael James,0,0,20,20
1746584585659,MCWP 50,B00,893761,Bartulis; Jason Michael,17,0,20,3
1746584586689,MCWP 50R,A00,893766,Compas; Sean Matthew,0,1,20,20
1746584586689,MCWP 50R,B00,893769,Carter; Jennifer A,0,1,20,20
1746584586689,MCWP 50R,C00,893771,Krone; Jarret,0,3,20,20
1746584586689,MCWP 50R,D00,893772,Miller; Elizabeth Deen,0,0,20,20
1746584586689,MCWP 50R,E00,893775,Carter; Andrea L,0,1,20,20
1746584587713,MMW 11R,A01,892721,Herbst; Matthew,14,0,30,16
1746584587713,MMW 11R,A02,892722,Herbst; Matthew,0,0,0,3
1746584588742,MMW 12R,A01,892724,Herbst; Matthew,0,11,16,16
1746584588742,MMW 12R,A02,892725,Herbst; Matthew,0,10,16,16
1746584589768,MMW 13R,A01,892727,Staff,0,4,16,16
1746584589768,MMW 13R,A02,892728,Staff,0,4,16,16
1746584589768,MMW 13R,A03,958032,Staff,0,4,16,16
1746584589768,MMW 13R,A04,958033,Staff,0,4,16,16
1746584589768,MMW 13R,A05,958034,Staff,0,4,16,16
1746584590796,SIO 295LS,A00,894015,Staff,5,0,25,20
1746584591825,SIO 295S,A00,894020,Staff,5,0,25,20
1746584592850,SIOC 290S,B01,958918,Merrifield; Mark A,14,0,30,16
1746584593879,SIOC 291S,B01,958922,Gabriel; Corey John,14,0,30,16
1746584594909,SOCI 117,A01,895339,Staff,3,0,5,2
1746584595935,WES 237B,A00,894149,Staff,11,0,20,9
1746584598003,AESE 279B,A00,891859,Staff,13,0,35,22
1746584599027,AIP 197,001,891854,Vespa; Emanuel Ignacio,9999,0,9999,0
1746584600054,ANTH 289S,A00,891856,Gagneux; Pascal,12,0,12,0
1746584601082,BENG 196,001,957946,Engler; Adam J.,9996,0,9999,3
1746584602107,BISP 197,001,959851,Wilhelm; James E.,9998,0,9999,1
1746584603134,CAT 124RS,A01,956906,Staff,6,0,25,19
1746584604159,CAT 125RS,A01,922013,Staff,6,0,25,19
1746584605184,CLRE 250,A00,891860,Morris; Sheldon,9995,0,9999,4
1746584607244,CLRE 251R,A00,907817,Mehta; Ravindra L.,9994,0,9999,5
1746584608271,CLRE 252,A00,891864,Cuomo; Raphael Eduardo,9993,0,9999,6
1746584609296,CLRE 253,A00,891867,Vaida; Florin,9994,0,9999,5
1746584609296,CLRE 253,B00,907819,Staff,9999,0,9999,0
1746584610323,CLRE 259,A00,891868,Patel; Hemal,9998,0,9999,1
1746584611348,CLRE 260,A00,891872,Cuomo; Raphael Eduardo,9999,0,9999,0
1746584612378,CLRE 297,001,891888,Cuomo; Raphael Eduardo,9999,0,9999,0
1746584613404,CSE 191,A00,958773,Minnes Kemp; Mor Mia,9995,0,9999,4
1746584614427,CSE 197,001,959846,Minnes Kemp; Mor Mia,9990,0,9999,9
1746584615454,CSS 201S,A01,892054,Mignozzetti; Umberto,25,0,30,5
1746584616480,CSS 202S,A01,892056,Mignozzetti; Umberto,25,0,30,5
1746584617511,DSC 197,001,956898,Eldridge; Justin Matthew,9996,0,9999,3
1746584618540,DSC 297,001,958000,Mazumdar; Arya,9998,0,9999,1
1746584618540,DSC 297,002,959862,Wang; Yusu,9998,0,9999,1
1746584619564,EAP 100,A00,905686,Staff,9778,0,9999,221
1746584620592,ECE 45,A01,892618,Staff,0,0,65,65
1746584622646,ECE 111,A01,892719,Staff,6,0,65,59
1746584623673,ECE 197,001,957920,Mercier; Patrick Philip,9991,0,9999,8
1746584624698,ECON 178,A01,907814,Zhu; Ying,26,0,35,9
1746584625724,EDS 115,A00,895312,Staff,35,0,45,10
1746584626752,EDS 117,A01,895337,Staff,23,0,30,7
1746584627781,EDS 125,A00,895341,Jones; Gabrielle Anastasia,36,0,45,9
1746584628810,EDS 128A,A01,895459,Fargason; Sharon Gayle,44,0,45,1
1746584629835,EDS 128B,A01,895543,Pappas; Elizabeth,44,0,45,1
1746584630864,EDS 139,A00,897203,Pappas; Elizabeth,44,0,45,1
1746584630864,EDS 139,B00,897209,Fargason; Sharon Gayle,41,0,45,4
1746584631890,EDS 201,A00,895545,Staff,22,0,45,23
1746584632915,EDS 203,A01,895581,Halter; Christopher P.,22,0,45,23
1746584633945,EDS 204R,A01,895625,Heinzman; Erica M.,39,0,45,6
1746584633945,EDS 204R,B01,895693,Halter; Christopher P.,10,0,45,35
1746584634971,EDS 206R,A00,895694,Fargason; Sharon Gayle,1,0,30,29
1746584634971,EDS 206R,B00,895695,Choi; Bailey Miyeon,16,0,30,14
1746584636000,EDS 250,A00,895697,Hemans; Patricia Ann Benitez,22,0,45,23
1746584637026,EDS 281,A00,895701,Meyerott; Theresa Ann,1,0,15,14
1746584638055,EDS 284,A00,895736,Meyerott; Theresa Ann,1,0,15,14
1746584639080,EDS 286,A00,897210,Fine; Sarah,0,0,15,15
1746584640109,EDS 289C,A01,895770,Daly; Alan J.,1,0,15,14
1746584641137,EDS 290,A00,897211,Hofstetter; Carolyn,0,0,15,15
1746584642164,LIGM 5A,A00,896162,Fischer-Grunski; Eva K,12,0,20,8
1746584643191,LIGM 5B,A00,896260,Fischer-Grunski; Eva K,17,0,20,3
1746584644215,LIGM 5C,A00,896308,Fischer-Grunski; Eva K,18,0,20,2
1746584645241,LIIT 5AS,A00,896313,Carnelos; Chiara,18,0,20,2
1746584646268,LIIT 5BS,A00,896416,Carnelos; Chiara,20,0,20,0
1746584647295,LIIT 5CS,A00,896564,Carnelos; Chiara,20,0,20,0
1746584648325,LISP 5A,A00,896588,Munoz Sanchez; Alicia,2,0,20,18
1746584649351,LISP 5B,A00,896653,Munoz Sanchez; Alicia,7,0,20,13
1746584650376,LISP 5C,A00,896655,Munoz Sanchez; Alicia,0,1,20,20
1746584651401,MAE 197,001,957918,Kleissl; Jan,9996,0,9999,3
1746584651401,MAE 197,002,959806,Boechler; Nicholas Sebastia,9998,0,9999,1
1746584651401,MAE 197,003,959852,Mullin; Jennifer S,9998,0,9999,1
1746584652428,MATH 2,A01,957937,Staff,33,0,35,2
1746584653455,MATH 197,001,957876,Kedlaya; Kiran S.,9993,0,9999,6
1746584654483,MCWP 40,A00,892729,Duru; Nur,10,0,20,10
1746584654483,MCWP 40,B00,893304,Montejo; Carolina,14,0,20,6
1746584655509,MCWP 40R,A00,893757,Redela; Pamela Morgan,0,5,20,20
1746584656535,MCWP 50,A00,893758,Morshed; Michael James,0,0,20,20
1746584656535,MCWP 50,B00,893761,Bartulis; Jason Michael,17,0,20,3
1746584657562,MCWP 50R,A00,893766,Compas; Sean Matthew,0,1,20,20
1746584657562,MCWP 50R,B00,893769,Carter; Jennifer A,0,1,20,20
1746584657562,MCWP 50R,C00,893771,Krone; Jarret,0,3,20,20
1746584657562,MCWP 50R,D00,893772,Miller; Elizabeth Deen,0,0,20,20
1746584657562,MCWP 50R,E00,893775,Carter; Andrea L,0,1,20,20
1746584658588,MMW 11R,A01,892721,Herbst; Matthew,14,0,30,16
1746584658588,MMW 11R,A02,892722,Herbst; Matthew,0,0,0,3
1746584659618,MMW 12R,A01,892724,Herbst; Matthew,0,11,16,16
1746584659618,MMW 12R,A02,892725,Herbst; Matthew,0,10,16,16
1746584660645,MMW 13R,A01,892727,Staff,0,4,16,16
1746584660645,MMW 13R,A02,892728,Staff,0,4,16,16
1746584660645,MMW 13R,A03,958032,Staff,0,4,16,16
1746584660645,MMW 13R,A04,958033,Staff,0,4,16,16
1746584660645,MMW 13R,A05,958034,Staff,0,4,16,16
1746584661670,SIO 295LS,A00,894015,Staff,5,0,25,20
1746584662699,SIO 295S,A00,894020,Staff,5,0,25,20
1746584663751,SIOC 290S,B01,958918,Merrifield; Mark A,14,0,30,16
1746584664780,SIOC 291S,B01,958922,Gabriel; Corey John,14,0,30,16
1746584665807,SOCI 117,A01,895339,Staff,3,0,5,2
1746584666835,WES 237B,A00,894149,Staff,11,0,20,9
1746584668893,AESE 279B,A00,891859,Staff,13,0,35,22
1746584669917,AIP 197,001,891854,Vespa; Emanuel Ignacio,9999,0,9999,0
1746584670941,ANTH 289S,A00,891856,Gagneux; Pascal,12,0,12,0
1746584671967,BENG 196,001,957946,Engler; Adam J.,9996,0,9999,3
1746584672991,BISP 197,001,959851,Wilhelm; James E.,9998,0,9999,1
1746584674015,CAT 124RS,A01,956906,Staff,6,0,25,19
1746584675040,CAT 125RS,A01,922013,Staff,6,0,25,19
1746584676065,CLRE 250,A00,891860,Morris; Sheldon,9995,0,9999,4
1746584678118,CLRE 251R,A00,907817,Mehta; Ravindra L.,9994,0,9999,5
1746584679143,CLRE 252,A00,891864,Cuomo; Raphael Eduardo,9993,0,9999,6
1746584680175,CLRE 253,A00,891867,Vaida; Florin,9994,0,9999,5
1746584680175,CLRE 253,B00,907819,Staff,9999,0,9999,0
1746584681199,CLRE 259,A00,891868,Patel; Hemal,9998,0,9999,1
1746584682227,CLRE 260,A00,891872,Cuomo; Raphael Eduardo,9999,0,9999,0
1746584683254,CLRE 297,001,891888,Cuomo; Raphael Eduardo,9999,0,9999,0
1746584684281,CSE 191,A00,958773,Minnes Kemp; Mor Mia,9995,0,9999,4
1746584685305,CSE 197,001,959846,Minnes Kemp; Mor Mia,9990,0,9999,9
1746584686330,CSS 201S,A01,892054,Mignozzetti; Umberto,25,0,30,5
1746584687359,CSS 202S,A01,892056,Mignozzetti; Umberto,25,0,30,5
1746584688386,DSC 197,001,956898,Eldridge; Justin Matthew,9996,0,9999,3
1746584689410,DSC 297,001,958000,Mazumdar; Arya,9998,0,9999,1
1746584689410,DSC 297,002,959862,Wang; Yusu,9998,0,9999,1
1746584690435,EAP 100,A00,905686,Staff,9778,0,9999,221
1746584691461,ECE 45,A01,892618,Staff,0,0,65,65
1746584693508,ECE 111,A01,892719,Staff,6,0,65,59
1746584694533,ECE 197,001,957920,Mercier; Patrick Philip,9991,0,9999,8
1746584695564,ECON 178,A01,907814,Zhu; Ying,26,0,35,9
1746584696588,EDS 115,A00,895312,Staff,35,0,45,10
1746584697618,EDS 117,A01,895337,Staff,23,0,30,7
1746584698641,EDS 125,A00,895341,Jones; Gabrielle Anastasia,36,0,45,9
1746584699665,EDS 128A,A01,895459,Fargason; Sharon Gayle,44,0,45,1
1746584700697,EDS 128B,A01,895543,Pappas; Elizabeth,44,0,45,1
1746584701724,EDS 139,A00,897203,Pappas; Elizabeth,44,0,45,1
1746584701724,EDS 139,B00,897209,Fargason; Sharon Gayle,41,0,45,4
1746584702751,EDS 201,A00,895545,Staff,22,0,45,23
1746584703776,EDS 203,A01,895581,Halter; Christopher P.,22,0,45,23
1746584704806,EDS 204R,A01,895625,Heinzman; Erica M.,39,0,45,6
1746584704806,EDS 204R,B01,895693,Halter; Christopher P.,10,0,45,35
1746584705835,EDS 206R,A00,895694,Fargason; Sharon Gayle,1,0,30,29
1746584705835,EDS 206R,B00,895695,Choi; Bailey Miyeon,16,0,30,14
1746584706859,EDS 250,A00,895697,Hemans; Patricia Ann Benitez,22,0,45,23
1746584707888,EDS 281,A00,895701,Meyerott; Theresa Ann,1,0,15,14
1746584708917,EDS 284,A00,895736,Meyerott; Theresa Ann,1,0,15,14
1746584709943,EDS 286,A00,897210,Fine; Sarah,0,0,15,15
1746584710972,EDS 289C,A01,895770,Daly; Alan J.,1,0,15,14
1746584711996,EDS 290,A00,897211,Hofstetter; Carolyn,0,0,15,15
1746584713028,LIGM 5A,A00,896162,Fischer-Grunski; Eva K,12,0,20,8
1746584714181,LIGM 5B,A00,896260,Fischer-Grunski; Eva K,17,0,20,3
1746584715204,LIGM 5C,A00,896308,Fischer-Grunski; Eva K,18,0,20,2
1746584716300,LIIT 5AS,A00,896313,Carnelos; Chiara,18,0,20,2
1746584717330,LIIT 5BS,A00,896416,Carnelos; Chiara,20,0,20,0
1746584718361,LIIT 5CS,A00,896564,Carnelos; Chiara,20,0,20,0
1746584719385,LISP 5A,A00,896588,Munoz Sanchez; Alicia,2,0,20,18
1746584720413,LISP 5B,A00,896653,Munoz Sanchez; Alicia,7,0,20,13
1746584721437,LISP 5C,A00,896655,Munoz Sanchez; Alicia,0,1,20,20
1746584722461,MAE 197,001,957918,Kleissl; Jan,9996,0,9999,3
1746584722461,MAE 197,002,959806,Boechler; Nicholas Sebastia,9998,0,9999,1
1746584722461,MAE 197,003,959852,Mullin; Jennifer S,9998,0,9999,1
1746584723491,MATH 2,A01,957937,Staff,33,0,35,2
1746584724518,MATH 197,001,957876,Kedlaya; Kiran S.,9993,0,9999,6
1746584725546,MCWP 40,A00,892729,Duru; Nur,10,0,20,10
1746584725546,MCWP 40,B00,893304,Montejo; Carolina,14,0,20,6
1746584726570,MCWP 40R,A00,893757,Redela; Pamela Morgan,0,5,20,20
1746584727598,MCWP 50,A00,893758,Morshed; Michael James,0,0,20,20
1746584727598,MCWP 50,B00,893761,Bartulis; Jason Michael,17,0,20,3
1746584728624,MCWP 50R,A00,893766,Compas; Sean Matthew,0,1,20,20
1746584728624,MCWP 50R,B00,893769,Carter; Jennifer A,0,1,20,20
1746584728624,MCWP 50R,C00,893771,Krone; Jarret,0,3,20,20
1746584728624,MCWP 50R,D00,893772,Miller; Elizabeth Deen,0,0,20,20
1746584728624,MCWP 50R,E00,893775,Carter; Andrea L,0,1,20,20
1746584729648,MMW 11R,A01,892721,Herbst; Matthew,14,0,30,16
1746584729648,MMW 11R,A02,892722,Herbst; Matthew,0,0,0,3
1746584730673,MMW 12R,A01,892724,Herbst; Matthew,0,11,16,16
1746584730673,MMW 12R,A02,892725,Herbst; Matthew,0,10,16,16
1746584731703,MMW 13R,A01,892727,Staff,0,4,16,16
1746584731703,MMW 13R,A02,892728,Staff,0,4,16,16
1746584731703,MMW 13R,A03,958032,Staff,0,4,16,16
1746584731703,MMW 13R,A04,958033,Staff,0,4,16,16
1746584731703,MMW 13R,A05,958034,Staff,0,4,16,16
1746584732727,SIO 295LS,A00,894015,Staff,5,0,25,20
1746584733755,SIO 295S,A00,894020,Staff,5,0,25,20
1746584734786,SIOC 290S,B01,958918,Merrifield; Mark A,14,0,30,16
1746584735818,SIOC 291S,B01,958922,Gabriel; Corey John,14,0,30,16
1746584736845,SOCI 117,A01,895339,Staff,3,0,5,2
1746584737868,WES 237B,A00,894149,Staff,11,0,20,9
1746584739927,AESE 279B,A00,891859,Staff,13,0,35,22
1746584740951,AIP 197,001,891854,Vespa; Emanuel Ignacio,9999,0,9999,0
1746584741976,ANTH 289S,A00,891856,Gagneux; Pascal,12,0,12,0
1746584743002,BENG 196,001,957946,Engler; Adam J.,9996,0,9999,3
1746584744027,BISP 197,001,959851,Wilhelm; James E.,9998,0,9999,1
1746584745053,CAT 124RS,A01,956906,Staff,6,0,25,19
1746584746080,CAT 125RS,A01,922013,Staff,6,0,25,19
1746584747109,CLRE 250,A00,891860,Morris; Sheldon,9995,0,9999,4
1746584749161,CLRE 251R,A00,907817,Mehta; Ravindra L.,9994,0,9999,5
1746584750189,CLRE 252,A00,891864,Cuomo; Raphael Eduardo,9993,0,9999,6
1746584751215,CLRE 253,A00,891867,Vaida; Florin,9994,0,9999,5
1746584751215,CLRE 253,B00,907819,Staff,9999,0,9999,0
1746584752238,CLRE 259,A00,891868,Patel; Hemal,9998,0,9999,1
1746584753265,CLRE 260,A00,891872,Cuomo; Raphael Eduardo,9999,0,9999,0
1746584754289,CLRE 297,001,891888,Cuomo; Raphael Eduardo,9999,0,9999,0
1746584755316,CSE 191,A00,958773,Minnes Kemp; Mor Mia,9995,0,9999,4
1746584756345,CSE 197,001,959846,Minnes Kemp; Mor Mia,9990,0,9999,9
1746584757375,CSS 201S,A01,892054,Mignozzetti; Umberto,25,0,30,5
1746584758400,CSS 202S,A01,892056,Mignozzetti; Umberto,25,0,30,5
1746584759426,DSC 197,001,956898,Eldridge; Justin Matthew,9996,0,9999,3
1746584760451,DSC 297,001,958000,Mazumdar; Arya,9998,0,9999,1
1746584760451,DSC 297,002,959862,Wang; Yusu,9998,0,9999,1
1746584761478,EAP 100,A00,905686,Staff,9778,0,9999,221
1746584762504,ECE 45,A01,892618,Staff,0,0,65,65
1746584764553,ECE 111,A01,892719,Staff,6,0,65,59
1746584765583,ECE 197,001,957920,Mercier; Patrick Philip,9991,0,9999,8
1746584766609,ECON 178,A01,907814,Zhu; Ying,26,0,35,9
1746584767633,EDS 115,A00,895312,Staff,35,0,45,10
1746584768662,EDS 117,A01,895337,Staff,23,0,30,7
1746584769686,EDS 125,A00,895341,Jones; Gabrielle Anastasia,36,0,45,9
1746584770711,EDS 128A,A01,895459,Fargason; Sharon Gayle,44,0,45,1
1746584771740,EDS 128B,A01,895543,Pappas; Elizabeth,44,0,45,1
1746584772769,EDS 139,A00,897203,Pappas; Elizabeth,44,0,45,1
1746584772769,EDS 139,B00,897209,Fargason; Sharon Gayle,41,0,45,4
1746584773797,EDS 201,A00,895545,Staff,22,0,45,23
1746584774826,EDS 203,A01,895581,Halter; Christopher P.,22,0,45,23
1746584775850,EDS 204R,A01,895625,Heinzman; Erica M.,39,0,45,6
1746584775850,EDS 204R,B01,895693,Halter; Christopher P.,10,0,45,35
1746584776876,EDS 206R,A00,895694,Fargason; Sharon Gayle,1,0,30,29
1746584776876,EDS 206R,B00,895695,Choi; Bailey Miyeon,16,0,30,14
1746584777903,EDS 250,A00,895697,Hemans; Patricia Ann Benitez,22,0,45,23
1746584778932,EDS 281,A00,895701,Meyerott; Theresa Ann,1,0,15,14
1746584779960,EDS 284,A00,895736,Meyerott; Theresa Ann,1,0,15,14
1746584780986,EDS 286,A00,897210,Fine; Sarah,0,0,15,15
1746584782016,EDS 289C,A01,895770,Daly; Alan J.,1,0,15,14
1746584783044,EDS 290,A00,897211,Hofstetter; Carolyn,0,0,15,15
1746584784072,LIGM 5A,A00,896162,Fischer-Grunski; Eva K,12,0,20,8
1746584785099,LIGM 5B,A00,896260,Fischer-Grunski; Eva K,17,0,20,3
1746584786124,LIGM 5C,A00,896308,Fischer-Grunski; Eva K,18,0,20,2
1746584787150,LIIT 5AS,A00,896313,Carnelos; Chiara,18,0,20,2
1746584788183,LIIT 5BS,A00,896416,Carnelos; Chiara,20,0,20,0
1746584789212,LIIT 5CS,A00,896564,Carnelos; Chiara,20,0,20,0
1746584790238,LISP 5A,A00,896588,Munoz Sanchez; Alicia,2,0,20,18
1746584791265,LISP 5B,A00,896653,Munoz Sanchez; Alicia,7,0,20,13
1746584792290,LISP 5C,A00,896655,Munoz Sanchez; Alicia,0,1,20,20
1746584793314,MAE 197,001,957918,Kleissl; Jan,9996,0,9999,3
1746584793314,MAE 197,002,959806,Boechler; Nicholas Sebastia,9998,0,9999,1
1746584793314,MAE 197,003,959852,Mullin; Jennifer S,9998,0,9999,1
1746584794342,MATH 2,A01,957937,Staff,33,0,35,2
1746584795369,MATH 197,001,957876,Kedlaya; Kiran S.,9993,0,9999,6
1746584796400,MCWP 40,A00,892729,Duru; Nur,10,0,20,10
1746584796400,MCWP 40,B00,893304,Montejo; Carolina,14,0,20,6
1746584797429,MCWP 40R,A00,893757,Redela; Pamela Morgan,0,5,20,20
1746584798454,MCWP 50,A00,893758,Morshed; Michael James,0,0,20,20
1746584798454,MCWP 50,B00,893761,Bartulis; Jason Michael,17,0,20,3
1746584799485,MCWP 50R,A00,893766,Compas; Sean Matthew,0,1,20,20
1746584799485,MCWP 50R,B00,893769,Carter; Jennifer A,0,1,20,20
1746584799485,MCWP 50R,C00,893771,Krone; Jarret,0,3,20,20
1746584799485,MCWP 50R,D00,893772,Miller; Elizabeth Deen,0,0,20,20
1746584799485,MCWP 50R,E00,893775,Carter; Andrea L,0,1,20,20
1746584800513,MMW 11R,A01,892721,Herbst; Matthew,14,0,30,16
1746584800513,MMW 11R,A02,892722,Herbst; Matthew,0,0,0,3
1746584801538,MMW 12R,A01,892724,Herbst; Matthew,0,11,16,16
1746584801538,MMW 12R,A02,892725,Herbst; Matthew,0,10,16,16
1746584802564,MMW 13R,A01,892727,Staff,0,4,16,16
1746584802564,MMW 13R,A02,892728,Staff,0,4,16,16
1746584802564,MMW 13R,A03,958032,Staff,0,4,16,16
1746584802564,MMW 13R,A04,958033,Staff,0,4,16,16
1746584802564,MMW 13R,A05,958034,Staff,0,4,16,16
1746584803592,SIO 295LS,A00,894015,Staff,5,0,25,20
1746584804619,SIO 295S,A00,894020,Staff,5,0,25,20
1746584805646,SIOC 290S,B01,958918,Merrifield; Mark A,14,0,30,16
1746584806675,SIOC 291S,B01,958922,Gabriel; Corey John,14,0,30,16
1746584807702,SOCI 117,A01,895339,Staff,3,0,5,2
1746584808729,WES 237B,A00,894149,Staff,11,0,20,9
1746584810795,AESE 279B,A00,891859,Staff,13,0,35,22
1746584811821,AIP 197,001,891854,Vespa; Emanuel Ignacio,9999,0,9999,0
1746584812849,ANTH 289S,A00,891856,Gagneux; Pascal,12,0,12,0
1746584813877,BENG 196,001,957946,Engler; Adam J.,9996,0,9999,3
1746584814903,BISP 197,001,959851,Wilhelm; James E.,9998,0,9999,1
1746584815931,CAT 124RS,A01,956906,Staff,6,0,25,19
1746584816957,CAT 125RS,A01,922013,Staff,6,0,25,19
1746584817981,CLRE 250,A00,891860,Morris; Sheldon,9995,0,9999,4
1746584820039,CLRE 251R,A00,907817,Mehta; Ravindra L.,9994,0,9999,5
1746584821067,CLRE 252,A00,891864,Cuomo; Raphael Eduardo,9993,0,9999,6
1746584822092,CLRE 253,A00,891867,Vaida; Florin,9994,0,9999,5
1746584822092,CLRE 253,B00,907819,Staff,9999,0,9999,0
1746584823116,CLRE 259,A00,891868,Patel; Hemal,9998,0,9999,1
1746584824141,CLRE 260,A00,891872,Cuomo; Raphael Eduardo,9999,0,9999,0
1746584825167,CLRE 297,001,891888,Cuomo; Raphael Eduardo,9999,0,9999,0
1746584826195,CSE 191,A00,958773,Minnes Kemp; Mor Mia,9995,0,9999,4
1746584827218,CSE 197,001,959846,Minnes Kemp; Mor Mia,9990,0,9999,9
1746584828247,CSS 201S,A01,892054,Mignozzetti; Umberto,25,0,30,5
1746584829273,CSS 202S,A01,892056,Mignozzetti; Umberto,25,0,30,5
1746584830301,DSC 197,001,956898,Eldridge; Justin Matthew,9996,0,9999,3
1746584831325,DSC 297,001,958000,Mazumdar; Arya,9998,0,9999,1
1746584831325,DSC 297,002,959862,Wang; Yusu,9998,0,9999,1
1746584832351,EAP 100,A00,905686,Staff,9778,0,9999,221
1746584833383,ECE 45,A01,892618,Staff,0,0,65,65
1746584835431,ECE 111,A01,892719,Staff,6,0,65,59
1746584836457,ECE 197,001,957920,Mercier; Patrick Philip,9991,0,9999,8
1746584837484,ECON 178,A01,907814,Zhu; Ying,26,0,35,9
1746584838508,EDS 115,A00,895312,Staff,35,0,45,10
1746584839532,EDS 117,A01,895337,Staff,23,0,30,7
1746584840558,EDS 125,A00,895341,Jones; Gabrielle Anastasia,36,0,45,9
1746584841583,EDS 128A,A01,895459,Fargason; Sharon Gayle,44,0,45,1
1746584842610,EDS 128B,A01,895543,Pappas; Elizabeth,44,0,45,1
1746584843635,EDS 139,A00,897203,Pappas; Elizabeth,44,0,45,1
1746584843635,EDS 139,B00,897209,Fargason; Sharon Gayle,41,0,45,4
1746584844660,EDS 201,A00,895545,Staff,22,0,45,23
1746584845688,EDS 203,A01,895581,Halter; Christopher P.,22,0,45,23
1746584846713,EDS 204R,A01,895625,Heinzman; Erica M.,39,0,45,6
1746584846713,EDS 204R,B01,895693,Halter; Christopher P.,10,0,45,35
1746584847737,EDS 206R,A00,895694,Fargason; Sharon Gayle,1,0,30,29
1746584847737,EDS 206R,B00,895695,Choi; Bailey Miyeon,16,0,30,14
1746584848760,EDS 250,A00,895697,Hemans; Patricia Ann Benitez,22,0,45,23
1746584849785,EDS 281,A00,895701,Meyerott; Theresa Ann,1,0,15,14
1746584850812,EDS 284,A00,895736,Meyerott; Theresa Ann,1,0,15,14
1746584851836,EDS 286,A00,897210,Fine; Sarah,0,0,15,15
1746584852866,EDS 289C,A01,895770,Daly; Alan J.,1,0,15,14
1746584853890,EDS 290,A00,897211,Hofstetter; Carolyn,0,0,15,15
1746584854920,LIGM 5A,A00,896162,Fischer-Grunski; Eva K,12,0,20,8
1746584855944,LIGM 5B,A00,896260,Fischer-Grunski; Eva K,17,0,20,3
1746584856968,LIGM 5C,A00,896308,Fischer-Grunski; Eva K,18,0,20,2
1746584857994,LIIT 5AS,A00,896313,Carnelos; Chiara,18,0,20,2
1746584859019,LIIT 5BS,A00,896416,Carnelos; Chiara,20,0,20,0
1746584860047,LIIT 5CS,A00,896564,Carnelos; Chiara,20,0,20,0
1746584861073,LISP 5A,A00,896588,Munoz Sanchez; Alicia,2,0,20,18
1746584862101,LISP 5B,A00,896653,Munoz Sanchez; Alicia,7,0,20,13
1746584863130,LISP 5C,A00,896655,Munoz Sanchez; Alicia,0,1,20,20
1746584864156,MAE 197,001,957918,Kleissl; Jan,9996,0,9999,3
1746584864156,MAE 197,002,959806,Boechler; Nicholas Sebastia,9998,0,9999,1
1746584864156,MAE 197,003,959852,Mullin; Jennifer S,9998,0,9999,1
1746584865185,MATH 2,A01,957937,Staff,33,0,35,2
1746584866211,MATH 197,001,957876,Kedlaya; Kiran S.,9993,0,9999,6
1746584867237,MCWP 40,A00,892729,Duru; Nur,10,0,20,10
1746584867237,MCWP 40,B00,893304,Montejo; Carolina,14,0,20,6
1746584868264,MCWP 40R,A00,893757,Redela; Pamela Morgan,0,5,20,20
1746584869293,MCWP 50,A00,893758,Morshed; Michael James,0,0,20,20
1746584869293,MCWP 50,B00,893761,Bartulis; Jason Michael,17,0,20,3
1746584870318,MCWP 50R,A00,893766,Compas; Sean Matthew,0,1,20,20
1746584870318,MCWP 50R,B00,893769,Carter; Jennifer A,0,1,20,20
1746584870318,MCWP 50R,C00,893771,Krone; Jarret,0,3,20,20
1746584870318,MCWP 50R,D00,893772,Miller; Elizabeth Deen,0,0,20,20
1746584870318,MCWP 50R,E00,893775,Carter; Andrea L,0,1,20,20
1746584871343,MMW 11R,A01,892721,Herbst; Matthew,14,0,30,16
1746584871343,MMW 11R,A02,892722,Herbst; Matthew,0,0,0,3
1746584872369,MMW 12R,A01,892724,Herbst; Matthew,0,11,16,16
1746584872369,MMW 12R,A02,892725,Herbst; Matthew,0,10,16,16
1746584873395,MMW 13R,A01,892727,Staff,0,4,16,16
1746584873395,MMW 13R,A02,892728,Staff,0,4,16,16
1746584873395,MMW 13R,A03,958032,Staff,0,4,16,16
1746584873395,MMW 13R,A04,958033,Staff,0,4,16,16
1746584873395,MMW 13R,A05,958034,Staff,0,4,16,16
1746584874420,SIO 295LS,A00,894015,Staff,5,0,25,20
1746584875444,SIO 295S,A00,894020,Staff,5,0,25,20
1746584876472,SIOC 290S,B01,958918,Merrifield; Mark A,14,0,30,16
1746584877504,SIOC 291S,B01,958922,Gabriel; Corey John,14,0,30,16
1746584878530,SOCI 117,A01,895339,Staff,3,0,5,2
1746584879554,WES 237B,A00,894149,Staff,11,0,20,9
1746584881611,AESE 279B,A00,891859,Staff,13,0,35,22
1746584882640,AIP 197,001,891854,Vespa; Emanuel Ignacio,9999,0,9999,0
1746584883668,ANTH 289S,A00,891856,Gagneux; Pascal,12,0,12,0
1746584884695,BENG 196,001,957946,Engler; Adam J.,9996,0,9999,3
1746584885722,BISP 197,001,959851,Wilhelm; James E.,9998,0,9999,1
1746584886749,CAT 124RS,A01,956906,Staff,6,0,25,19
1746584887773,CAT 125RS,A01,922013,Staff,6,0,25,19
1746584888797,CLRE 250,A00,891860,Morris; Sheldon,9995,0,9999,4
1746584890865,CLRE 251R,A00,907817,Mehta; Ravindra L.,9994,0,9999,5
1746584891890,CLRE 252,A00,891864,Cuomo; Raphael Eduardo,9993,0,9999,6
1746584892920,CLRE 253,A00,891867,Vaida; Florin,9994,0,9999,5
1746584892920,CLRE 253,B00,907819,Staff,9999,0,9999,0
1746584893946,CLRE 259,A00,891868,Patel; Hemal,9998,0,9999,1
1746584894977,CLRE 260,A00,891872,Cuomo; Raphael Eduardo,9999,0,9999,0
1746584896002,CLRE 297,001,891888,Cuomo; Raphael Eduardo,9999,0,9999,0
1746584897027,CSE 191,A00,958773,Minnes Kemp; Mor Mia,9995,0,9999,4
1746584898055,CSE 197,001,959846,Minnes Kemp; Mor Mia,9990,0,9999,9
1746584899080,CSS 201S,A01,892054,Mignozzetti; Umberto,25,0,30,5
1746584900104,CSS 202S,A01,892056,Mignozzetti; Umberto,25,0,30,5
1746584901129,DSC 197,001,956898,Eldridge; Justin Matthew,9996,0,9999,3
1746584902178,DSC 297,001,958000,Mazumdar; Arya,9998,0,9999,1
1746584902178,DSC 297,002,959862,Wang; Yusu,9998,0,9999,1
1746584903203,EAP 100,A00,905686,Staff,9778,0,9999,221
1746584904229,ECE 45,A01,892618,Staff,0,0,65,65
1746584906280,ECE 111,A01,892719,Staff,6,0,65,59
1746584907306,ECE 197,001,957920,Mercier; Patrick Philip,9991,0,9999,8
1746584908339,ECON 178,A01,907814,Zhu; Ying,26,0,35,9
1746584909364,EDS 115,A00,895312,Staff,35,0,45,10
1746584910388,EDS 117,A01,895337,Staff,23,0,30,7
1746584911412,EDS 125,A00,895341,Jones; Gabrielle Anastasia,36,0,45,9
1746584912435,EDS 128A,A01,895459,Fargason; Sharon Gayle,44,0,45,1
1746584913462,EDS 128B,A01,895543,Pappas; Elizabeth,44,0,45,1
1746584914490,EDS 139,A00,897203,Pappas; Elizabeth,44,0,45,1
1746584914490,EDS 139,B00,897209,Fargason; Sharon Gayle,41,0,45,4
1746584915514,EDS 201,A00,895545,Staff,22,0,45,23
1746584916541,EDS 203,A01,895581,Halter; Christopher P.,22,0,45,23
1746584917565,EDS 204R,A01,895625,Heinzman; Erica M.,39,0,45,6
1746584917565,EDS 204R,B01,895693,Halter; Christopher P.,10,0,45,35
1746584918593,EDS 206R,A00,895694,Fargason; Sharon Gayle,1,0,30,29
1746584918593,EDS 206R,B00,895695,Choi; Bailey Miyeon,16,0,30,14
1746584919621,EDS 250,A00,895697,Hemans; Patricia Ann Benitez,22,0,45,23
1746584920646,EDS 281,A00,895701,Meyerott; Theresa Ann,1,0,15,14
1746584921671,EDS 284,A00,895736,Meyerott; Theresa Ann,1,0,15,14
1746584922699,EDS 286,A00,897210,Fine; Sarah,0,0,15,15
1746584923729,EDS 289C,A01,895770,Daly; Alan J.,1,0,15,14
1746584924754,EDS 290,A00,897211,Hofstetter; Carolyn,0,0,15,15
1746584925778,LIGM 5A,A00,896162,Fischer-Grunski; Eva K,12,0,20,8
1746584926801,LIGM 5B,A00,896260,Fischer-Grunski; Eva K,17,0,20,3
1746584927826,LIGM 5C,A00,896308,Fischer-Grunski; Eva K,18,0,20,2
1746584928853,LIIT 5AS,A00,896313,Carnelos; Chiara,18,0,20,2
1746584929877,LIIT 5BS,A00,896416,Carnelos; Chiara,20,0,20,0
1746584930907,LIIT 5CS,A00,896564,Carnelos; Chiara,20,0,20,0
1746584931935,LISP 5A,A00,896588,Munoz Sanchez; Alicia,2,0,20,18
1746584932959,LISP 5B,A00,896653,Munoz Sanchez; Alicia,7,0,20,13
1746584933988,LISP 5C,A00,896655,Munoz Sanchez; Alicia,0,1,20,20
1746584935016,MAE 197,001,957918,Kleissl; Jan,9996,0,9999,3
1746584935016,MAE 197,002,959806,Boechler; Nicholas Sebastia,9998,0,9999,1
1746584935016,MAE 197,003,959852,Mullin; Jennifer S,9998,0,9999,1
1746584936040,MATH 2,A01,957937,Staff,33,0,35,2
1746584937068,MATH 197,001,957876,Kedlaya; Kiran S.,9993,0,9999,6
1746584938098,MCWP 40,A00,892729,Duru; Nur,10,0,20,10
1746584938098,MCWP 40,B00,893304,Montejo; Carolina,14,0,20,6
1746584939123,MCWP 40R,A00,893757,Redela; Pamela Morgan,0,5,20,20
1746584940148,MCWP 50,A00,893758,Morshed; Michael James,0,0,20,20
1746584940148,MCWP 50,B00,893761,Bartulis; Jason Michael,17,0,20,3
1746584941180,MCWP 50R,A00,893766,Compas; Sean Matthew,0,1,20,20
1746584941180,MCWP 50R,B00,893769,Carter; Jennifer A,0,1,20,20
1746584941180,MCWP 50R,C00,893771,Krone; Jarret,0,3,20,20
1746584941180,MCWP 50R,D00,893772,Miller; Elizabeth Deen,0,0,20,20
1746584941180,MCWP 50R,E00,893775,Carter; Andrea L,0,1,20,20
1746584942205,MMW 11R,A01,892721,Herbst; Matthew,14,0,30,16
1746584942205,MMW 11R,A02,892722,Herbst; Matthew,0,0,0,3
1746584943229,MMW 12R,A01,892724,Herbst; Matthew,0,11,16,16
1746584943229,MMW 12R,A02,892725,Herbst; Matthew,0,10,16,16
1746584944254,MMW 13R,A01,892727,Staff,0,4,16,16
1746584944254,MMW 13R,A02,892728,Staff,0,4,16,16
1746584944254,MMW 13R,A03,958032,Staff,0,4,16,16
1746584944254,MMW 13R,A04,958033,Staff,0,4,16,16
1746584944254,MMW 13R,A05,958034,Staff,0,4,16,16
1746584945278,SIO 295LS,A00,894015,Staff,5,0,25,20
1746584946304,SIO 295S,A00,894020,Staff,5,0,25,20
1746584947340,SIOC 290S,B01,958918,Merrifield; Mark A,14,0,30,16
1746584948369,SIOC 291S,B01,958922,Gabriel; Corey John,14,0,30,16
1746584949393,SOCI 117,A01,895339,Staff,3,0,5,2
1746584950416,WES 237B,A00,894149,Staff,11,0,20,9
1746584952473,AESE 279B,A00,891859,Staff,13,0,35,22
1746584953500,AIP 197,001,891854,Vespa; Emanuel Ignacio,9999,0,9999,0
1746584954527,ANTH 289S,A00,891856,Gagneux; Pascal,12,0,12,0
1746584955555,BENG 196,001,957946,Engler; Adam J.,9996,0,9999,3
1746584956581,BISP 197,001,959851,Wilhelm; James E.,9998,0,9999,1
1746584957607,CAT 124RS,A01,956906,Staff,6,0,25,19
1746584958634,CAT 125RS,A01,922013,Staff,6,0,25,19
1746584959668,CLRE 250,A00,891860,Morris; Sheldon,9995,0,9999,4
1746584961718,CLRE 251R,A00,907817,Mehta; Ravindra L.,9994,0,9999,5
1746584962744,CLRE 252,A00,891864,Cuomo; Raphael Eduardo,9993,0,9999,6
1746584963768,CLRE 253,A00,891867,Vaida; Florin,9994,0,9999,5
1746584963768,CLRE 253,B00,907819,Staff,9999,0,9999,0
1746584964858,CLRE 259,A00,891868,Patel; Hemal,9998,0,9999,1
1746584965883,CLRE 260,A00,891872,Cuomo; Raphael Eduardo,9999,0,9999,0
1746584966912,CLRE 297,001,891888,Cuomo; Raphael Eduardo,9999,0,9999,0
1746584967941,CSE 191,A00,958773,Minnes Kemp; Mor Mia,9995,0,9999,4
1746584968967,CSE 197,001,959846,Minnes Kemp; Mor Mia,9990,0,9999,9
1746584969993,CSS 201S,A01,892054,Mignozzetti; Umberto,25,0,30,5
1746584971020,CSS 202S,A01,892056,Mignozzetti; Umberto,25,0,30,5
1746584972047,DSC 197,001,956898,Eldridge; Justin Matthew,9996,0,9999,3
1746584973074,DSC 297,001,958000,Mazumdar; Arya,9998,0,9999,1
1746584973074,DSC 297,002,959862,Wang; Yusu,9998,0,9999,1
1746584974101,EAP 100,A00,905686,Staff,9778,0,9999,221
1746584975130,ECE 45,A01,892618,Staff,0,0,65,65
1746584977181,ECE 111,A01,892719,Staff,6,0,65,59
1746584978207,ECE 197,001,957920,Mercier; Patrick Philip,9991,0,9999,8
1746584979236,ECON 178,A01,907814,Zhu; Ying,26,0,35,9
1746584980262,EDS 115,A00,895312,Staff,35,0,45,10
1746584981289,EDS 117,A01,895337,Staff,23,0,30,7
1746584982316,EDS 125,A00,895341,Jones; Gabrielle Anastasia,36,0,45,9
1746584983340,EDS 128A,A01,895459,Fargason; Sharon Gayle,44,0,45,1
1746584984367,EDS 128B,A01,895543,Pappas; Elizabeth,44,0,45,1
1746584985395,EDS 139,A00,897203,Pappas; Elizabeth,44,0,45,1
1746584985395,EDS 139,B00,897209,Fargason; Sharon Gayle,41,0,45,4
1746584986418,EDS 201,A00,895545,Staff,22,0,45,23
1746584987445,EDS 203,A01,895581,Halter; Christopher P.,22,0,45,23
1746584988475,EDS 204R,A01,895625,Heinzman; Erica M.,39,0,45,6
1746584988475,EDS 204R,B01,895693,Halter; Christopher P.,10,0,45,35
1746584989503,EDS 206R,A00,895694,Fargason; Sharon Gayle,1,0,30,29
1746584989503,EDS 206R,B00,895695,Choi; Bailey Miyeon,16,0,30,14
1746584990532,EDS 250,A00,895697,Hemans; Patricia Ann Benitez,22,0,45,23
1746584991558,EDS 281,A00,895701,Meyerott; Theresa Ann,1,0,15,14
1746584992582,EDS 284,A00,895736,Meyerott; Theresa Ann,1,0,15,14
1746584993614,EDS 286,A00,897210,Fine; Sarah,0,0,15,15
1746584994640,EDS 289C,A01,895770,Daly; Alan J.,1,0,15,14
1746584995665,EDS 290,A00,897211,Hofstetter; Carolyn,0,0,15,15
1746584996691,LIGM 5A,A00,896162,Fischer-Grunski; Eva K,12,0,20,8
1746584997721,LIGM 5B,A00,896260,Fischer-Grunski; Eva K,17,0,20,3
1746584998750,LIGM 5C,A00,896308,Fischer-Grunski; Eva K,18,0,20,2
1746584999777,LIIT 5AS,A00,896313,Carnelos; Chiara,18,0,20,2
1746585000801,LIIT 5BS,A00,896416,Carnelos; Chiara,20,0,20,0
1746585001827,LIIT 5CS,A00,896564,Carnelos; Chiara,20,0,20,0
1746585002851,LISP 5A,A00,896588,Munoz Sanchez; Alicia,2,0,20,18
1746585003884,LISP 5B,A00,896653,Munoz Sanchez; Alicia,7,0,20,13
1746585004914,LISP 5C,A00,896655,Munoz Sanchez; Alicia,0,1,20,20
1746585005939,MAE 197,001,957918,Kleissl; Jan,9996,0,9999,3
1746585005939,MAE 197,002,959806,Boechler; Nicholas Sebastia,9998,0,9999,1
1746585005939,MAE 197,003,959852,Mullin; Jennifer S,9998,0,9999,1
1746585006963,MATH 2,A01,957937,Staff,33,0,35,2
1746585007990,MATH 197,001,957876,Kedlaya; Kiran S.,9993,0,9999,6
1746585009021,MCWP 40,A00,892729,Duru; Nur,10,0,20,10
1746585009021,MCWP 40,B00,893304,Montejo; Carolina,14,0,20,6
1746585010051,MCWP 40R,A00,893757,Redela; Pamela Morgan,0,5,20,20
1746585011077,MCWP 50,A00,893758,Morshed; Michael James,0,0,20,20
1746585011077,MCWP 50,B00,893761,Bartulis; Jason Michael,17,0,20,3
1746585012105,MCWP 50R,A00,893766,Compas; Sean Matthew,0,1,20,20
1746585012105,MCWP 50R,B00,893769,Carter; Jennifer A,0,1,20,20
1746585012105,MCWP 50R,C00,893771,Krone; Jarret,0,3,20,20
1746585012105,MCWP 50R,D00,893772,Miller; Elizabeth Deen,0,0,20,20
1746585012105,MCWP 50R,E00,893775,Carter; Andrea L,0,1,20,20
1746585013134,MMW 11R,A01,892721,Herbst; Matthew,14,0,30,16
1746585013134,MMW 11R,A02,892722,Herbst; Matthew,0,0,0,3
1746585014161,MMW 12R,A01,892724,Herbst; Matthew,0,11,16,16
1746585014161,MMW 12R,A02,892725,Herbst; Matthew,0,10,16,16
1746585015187,MMW 13R,A01,892727,Staff,0,4,16,16
1746585015187,MMW 13R,A02,892728,Staff,0,4,16,16
1746585015187,MMW 13R,A03,958032,Staff,0,4,16,16
1746585015187,MMW 13R,A04,958033,Staff,0,4,16,16
1746585015187,MMW 13R,A05,958034,Staff,0,4,16,16
1746585016215,SIO 295LS,A00,894015,Staff,5,0,25,20
1746585017239,SIO 295S,A00,894020,Staff,5,0,25,20
1746585018268,SIOC 290S,B01,958918,Merrifield; Mark A,14,0,30,16
1746585019296,SIOC 291S,B01,958922,Gabriel; Corey John,14,0,30,16
1746585020322,SOCI 117,A01,895339,Staff,3,0,5,2
1746585021352,WES 237B,A00,894149,Staff,11,0,20,9
1746585023408,AESE 279B,A00,891859,Staff,13,0,35,22
1746585024433,AIP 197,001,891854,Vespa; Emanuel Ignacio,9999,0,9999,0
1746585025458,ANTH 289S,A00,891856,Gagneux; Pascal,12,0,12,0
1746585026486,BENG 196,001,957946,Engler; Adam J.,9996,0,9999,3
1746585027512,BISP 197,001,959851,Wilhelm; James E.,9998,0,9999,1
1746585028539,CAT 124RS,A01,956906,Staff,6,0,25,19
1746585029564,CAT 125RS,A01,922013,Staff,6,0,25,19
1746585030593,CLRE 250,A00,891860,Morris; Sheldon,9995,0,9999,4
1746585032643,CLRE 251R,A00,907817,Mehta; Ravindra L.,9994,0,9999,5
1746585033671,CLRE 252,A00,891864,Cuomo; Raphael Eduardo,9993,0,9999,6
1746585034696,CLRE 253,A00,891867,Vaida; Florin,9994,0,9999,5
1746585034696,CLRE 253,B00,907819,Staff,9999,0,9999,0
1746585035725,CLRE 259,A00,891868,Patel; Hemal,9998,0,9999,1
1746585036750,CLRE 260,A00,891872,Cuomo; Raphael Eduardo,9999,0,9999,0
1746585037779,CLRE 297,001,891888,Cuomo; Raphael Eduardo,9999,0,9999,0
1746585038806,CSE 191,A00,958773,Minnes Kemp; Mor Mia,9995,0,9999,4
1746585039834,CSE 197,001,959846,Minnes Kemp; Mor Mia,9990,0,9999,9
1746585040860,CSS 201S,A01,892054,Mignozzetti; Umberto,25,0,30,5
1746585041890,CSS 202S,A01,892056,Mignozzetti; Umberto,25,0,30,5
1746585042916,DSC 197,001,956898,Eldridge; Justin Matthew,9996,0,9999,3
1746585043939,DSC 297,001,958000,Mazumdar; Arya,9998,0,9999,1
1746585043939,DSC 297,002,959862,Wang; Yusu,9998,0,9999,1
1746585044968,EAP 100,A00,905686,Staff,9778,0,9999,221
1746585045999,ECE 45,A01,892618,Staff,0,0,65,65
1746585048049,ECE 111,A01,892719,Staff,6,0,65,59
1746585049076,ECE 197,001,957920,Mercier; Patrick Philip,9991,0,9999,8
1746585050103,ECON 178,A01,907814,Zhu; Ying,26,0,35,9
1746585051129,EDS 115,A00,895312,Staff,35,0,45,10
1746585052157,EDS 117,A01,895337,Staff,23,0,30,7
1746585053185,EDS 125,A00,895341,Jones; Gabrielle Anastasia,36,0,45,9
1746585054215,EDS 128A,A01,895459,Fargason; Sharon Gayle,44,0,45,1
1746585055244,EDS 128B,A01,895543,Pappas; Elizabeth,44,0,45,1
1746585056270,EDS 139,A00,897203,Pappas; Elizabeth,44,0,45,1
1746585056270,EDS 139,B00,897209,Fargason; Sharon Gayle,41,0,45,4
1746585057299,EDS 201,A00,895545,Staff,22,0,45,23
1746585058324,EDS 203,A01,895581,Halter; Christopher P.,22,0,45,23
1746585059351,EDS 204R,A01,895625,Heinzman; Erica M.,39,0,45,6
1746585059351,EDS 204R,B01,895693,Halter; Christopher P.,10,0,45,35
1746585060382,EDS 206R,A00,895694,Fargason; Sharon Gayle,1,0,30,29
1746585060382,EDS 206R,B00,895695,Choi; Bailey Miyeon,16,0,30,14
1746585061410,EDS 250,A00,895697,Hemans; Patricia Ann Benitez,22,0,45,23
1746585062440,EDS 281,A00,895701,Meyerott; Theresa Ann,1,0,15,14
1746585063464,EDS 284,A00,895736,Meyerott; Theresa Ann,1,0,15,14
1746585064491,EDS 286,A00,897210,Fine; Sarah,0,0,15,15
1746585065518,EDS 289C,A01,895770,Daly; Alan J.,1,0,15,14
1746585066543,EDS 290,A00,897211,Hofstetter; Carolyn,0,0,15,15
1746585067568,LIGM 5A,A00,896162,Fischer-Grunski; Eva K,12,0,20,8
1746585068592,LIGM 5B,A00,896260,Fischer-Grunski; Eva K,17,0,20,3
1746585069618,LIGM 5C,A00,896308,Fischer-Grunski; Eva K,18,0,20,2
1746585070648,LIIT 5AS,A00,896313,Carnelos; Chiara,18,0,20,2
1746585071677,LIIT 5BS,A00,896416,Carnelos; Chiara,20,0,20,0
1746585072701,LIIT 5CS,A00,896564,Carnelos; Chiara,20,0,20,0
1746585073727,LISP 5A,A00,896588,Munoz Sanchez; Alicia,2,0,20,18
1746585074754,LISP 5B,A00,896653,Munoz Sanchez; Alicia,7,0,20,13
1746585075778,LISP 5C,A00,896655,Munoz Sanchez; Alicia,0,1,20,20
1746585076809,MAE 197,001,957918,Kleissl; Jan,9996,0,9999,3
1746585076809,MAE 197,002,959806,Boechler; Nicholas Sebastia,9998,0,9999,1
1746585076809,MAE 197,003,959852,Mullin; Jennifer S,9998,0,9999,1
1746585077837,MATH 2,A01,957937,Staff,33,0,35,2
1746585078862,MATH 197,001,957876,Kedlaya; Kiran S.,9993,0,9999,6
1746585079887,MCWP 40,A00,892729,Duru; Nur,10,0,20,10
1746585079887,MCWP 40,B00,893304,Montejo; Carolina,14,0,20,6
1746585080913,MCWP 40R,A00,893757,Redela; Pamela Morgan,0,5,20,20
1746585081940,MCWP 50,A00,893758,Morshed; Michael James,0,0,20,20
1746585081940,MCWP 50,B00,893761,Bartulis; Jason Michael,17,0,20,3
1746585082966,MCWP 50R,A00,893766,Compas; Sean Matthew,0,1,20,20
1746585082966,MCWP 50R,B00,893769,Carter; Jennifer A,0,1,20,20
1746585082966,MCWP 50R,C00,893771,Krone; Jarret,0,3,20,20
1746585082966,MCWP 50R,D00,893772,Miller; Elizabeth Deen,0,0,20,20
1746585082966,MCWP 50R,E00,893775,Carter; Andrea L,0,1,20,20
1746585083993,MMW 11R,A01,892721,Herbst; Matthew,14,0,30,16
1746585083993,MMW 11R,A02,892722,Herbst; Matthew,0,0,0,3
1746585085022,MMW 12R,A01,892724,Herbst; Matthew,0,11,16,16
1746585085022,MMW 12R,A02,892725,Herbst; Matthew,0,10,16,16
1746585086061,MMW 13R,A01,892727,Staff,0,4,16,16
1746585086061,MMW 13R,A02,892728,Staff,0,4,16,16
1746585086061,MMW 13R,A03,958032,Staff,0,4,16,16
1746585086061,MMW 13R,A04,958033,Staff,0,4,16,16
1746585086061,MMW 13R,A05,958034,Staff,0,4,16,16
1746585087091,SIO 295LS,A00,894015,Staff,5,0,25,20
1746585088117,SIO 295S,A00,894020,Staff,5,0,25,20
1746585089143,SIOC 290S,B01,958918,Merrifield; Mark A,14,0,30,16
1746585090174,SIOC 291S,B01,958922,Gabriel; Corey John,14,0,30,16
1746585091199,SOCI 117,A01,895339,Staff,3,0,5,2
1746585092224,WES 237B,A00,894149,Staff,11,0,20,9
1746585094294,AESE 279B,A00,891859,Staff,13,0,35,22
1746585095318,AIP 197,001,891854,Vespa; Emanuel Ignacio,9999,0,9999,0
1746585096345,ANTH 289S,A00,891856,Gagneux; Pascal,12,0,12,0
1746585097370,BENG 196,001,957946,Engler; Adam J.,9996,0,9999,3
1746585098397,BISP 197,001,959851,Wilhelm; James E.,9998,0,9999,1
1746585099424,CAT 124RS,A01,956906,Staff,6,0,25,19
1746585100452,CAT 125RS,A01,922013,Staff,6,0,25,19
1746585101480,CLRE 250,A00,891860,Morris; Sheldon,9995,0,9999,4
1746585103532,CLRE 251R,A00,907817,Mehta; Ravindra L.,9994,0,9999,5
1746585104556,CLRE 252,A00,891864,Cuomo; Raphael Eduardo,9993,0,9999,6
1746585105581,CLRE 253,A00,891867,Vaida; Florin,9994,0,9999,5
1746585105581,CLRE 253,B00,907819,Staff,9999,0,9999,0
1746585106606,CLRE 259,A00,891868,Patel; Hemal,9998,0,9999,1
1746585107635,CLRE 260,A00,891872,Cuomo; Raphael Eduardo,9999,0,9999,0
1746585108663,CLRE 297,001,891888,Cuomo; Raphael Eduardo,9999,0,9999,0
1746585109689,CSE 191,A00,958773,Minnes Kemp; Mor Mia,9995,0,9999,4
1746585110720,CSE 197,001,959846,Minnes Kemp; Mor Mia,9990,0,9999,9
1746585111745,CSS 201S,A01,892054,Mignozzetti; Umberto,25,0,30,5
1746585112769,CSS 202S,A01,892056,Mignozzetti; Umberto,25,0,30,5
1746585113799,DSC 197,001,956898,Eldridge; Justin Matthew,9996,0,9999,3
1746585114827,DSC 297,001,958000,Mazumdar; Arya,9998,0,9999,1
1746585114827,DSC 297,002,959862,Wang; Yusu,9998,0,9999,1
1746585115854,EAP 100,A00,905686,Staff,9778,0,9999,221
1746585116884,ECE 45,A01,892618,Staff,0,0,65,65
1746585118937,ECE 111,A01,892719,Staff,6,0,65,59
1746585119962,ECE 197,001,957920,Mercier; Patrick Philip,9991,0,9999,8
1746585120992,ECON 178,A01,907814,Zhu; Ying,26,0,35,9
1746585122019,EDS 115,A00,895312,Staff,35,0,45,10
1746585123045,EDS 117,A01,895337,Staff,23,0,30,7
1746585124074,EDS 125,A00,895341,Jones; Gabrielle Anastasia,36,0,45,9
1746585125103,EDS 128A,A01,895459,Fargason; Sharon Gayle,44,0,45,1
1746585126132,EDS 128B,A01,895543,Pappas; Elizabeth,44,0,45,1
1746585127157,EDS 139,A00,897203,Pappas; Elizabeth,44,0,45,1
1746585127157,EDS 139,B00,897209,Fargason; Sharon Gayle,41,0,45,4
1746585128184,EDS 201,A00,895545,Staff,22,0,45,23
1746585129209,EDS 203,A01,895581,Halter; Christopher P.,22,0,45,23
1746585130236,EDS 204R,A01,895625,Heinzman; Erica M.,39,0,45,6
1746585130236,EDS 204R,B01,895693,Halter; Christopher P.,10,0,45,35
1746585131265,EDS 206R,A00,895694,Fargason; Sharon Gayle,1,0,30,29
1746585131265,EDS 206R,B00,895695,Choi; Bailey Miyeon,16,0,30,14
1746585132291,EDS 250,A00,895697,Hemans; Patricia Ann Benitez,22,0,45,23
1746585133318,EDS 281,A00,895701,Meyerott; Theresa Ann,1,0,15,14
1746585134343,EDS 284,A00,895736,Meyerott; Theresa Ann,1,0,15,14
1746585135369,EDS 286,A00,897210,Fine; Sarah,0,0,15,15
1746585136395,EDS 289C,A01,895770,Daly; Alan J.,1,0,15,14
1746585137421,EDS 290,A00,897211,Hofstetter; Carolyn,0,0,15,15
1746585138449,LIGM 5A,A00,896162,Fischer-Grunski; Eva K,12,0,20,8
1746585139474,LIGM 5B,A00,896260,Fischer-Grunski; Eva K,17,0,20,3
1746585140503,LIGM 5C,A00,896308,Fischer-Grunski; Eva K,18,0,20,2
1746585141531,LIIT 5AS,A00,896313,Carnelos; Chiara,18,0,20,2
1746585142562,LIIT 5BS,A00,896416,Carnelos; Chiara,20,0,20,0
1746585143590,LIIT 5CS,A00,896564,Carnelos; Chiara,20,0,20,0
1746585144615,LISP 5A,A00,896588,Munoz Sanchez; Alicia,2,0,20,18
1746585145640,LISP 5B,A00,896653,Munoz Sanchez; Alicia,7,0,20,13
1746585146666,LISP 5C,A00,896655,Munoz Sanchez; Alicia,0,1,20,20
1746585147693,MAE 197,001,957918,Kleissl; Jan,9996,0,9999,3
1746585147693,MAE 197,002,959806,Boechler; Nicholas Sebastia,9998,0,9999,1
1746585147693,MAE 197,003,959852,Mullin; Jennifer S,9998,0,9999,1
1746585148717,MATH 2,A01,957937,Staff,33,0,35,2
1746585149742,MATH 197,001,957876,Kedlaya; Kiran S.,9993,0,9999,6
1746585150771,MCWP 40,A00,892729,Duru; Nur,10,0,20,10
1746585150771,MCWP 40,B00,893304,Montejo; Carolina,14,0,20,6
1746585151799,MCWP 40R,A00,893757,Redela; Pamela Morgan,0,5,20,20
1746585152822,MCWP 50,A00,893758,Morshed; Michael James,0,0,20,20
1746585152822,MCWP 50,B00,893761,Bartulis; Jason Michael,17,0,20,3
1746585153849,MCWP 50R,A00,893766,Compas; Sean Matthew,0,1,20,20
1746585153849,MCWP 50R,B00,893769,Carter; Jennifer A,0,1,20,20
1746585153849,MCWP 50R,C00,893771,Krone; Jarret,0,3,20,20
1746585153849,MCWP 50R,D00,893772,Miller; Elizabeth Deen,0,0,20,20
1746585153849,MCWP 50R,E00,893775,Carter; Andrea L,0,1,20,20
1746585154875,MMW 11R,A01,892721,Herbst; Matthew,14,0,30,16
1746585154875,MMW 11R,A02,892722,Herbst; Matthew,0,0,0,3
1746585155900,MMW 12R,A01,892724,Herbst; Matthew,0,11,16,16
1746585155900,MMW 12R,A02,892725,Herbst; Matthew,0,10,16,16
1746585156926,MMW 13R,A01,892727,Staff,0,4,16,16
1746585156926,MMW 13R,A02,892728,Staff,0,4,16,16
1746585156926,MMW 13R,A03,958032,Staff,0,4,16,16
1746585156926,MMW 13R,A04,958033,Staff,0,4,16,16
1746585156926,MMW 13R,A05,958034,Staff,0,4,16,16
1746585157953,SIO 295LS,A00,894015,Staff,5,0,25,20
1746585158980,SIO 295S,A00,894020,Staff,5,0,25,20
1746585160013,SIOC 290S,B01,958918,Merrifield; Mark A,14,0,30,16
1746585161046,SIOC 291S,B01,958922,Gabriel; Corey John,14,0,30,16
1746585162072,SOCI 117,A01,895339,Staff,3,0,5,2
1746585163099,WES 237B,A00,894149,Staff,11,0,20,9
1746585165182,AESE 279B,A00,891859,Staff,13,0,35,22
1746585166209,AIP 197,001,891854,Vespa; Emanuel Ignacio,9999,0,9999,0
1746585167234,ANTH 289S,A00,891856,Gagneux; Pascal,12,0,12,0
1746585168260,BENG 196,001,957946,Engler; Adam J.,9996,0,9999,3
1746585169290,BISP 197,001,959851,Wilhelm; James E.,9998,0,9999,1
1746585170315,CAT 124RS,A01,956906,Staff,6,0,25,19
1746585171340,CAT 125RS,A01,922013,Staff,6,0,25,19
1746585172369,CLRE 250,A00,891860,Morris; Sheldon,9995,0,9999,4
1746585174423,CLRE 251R,A00,907817,Mehta; Ravindra L.,9994,0,9999,5
1746585175453,CLRE 252,A00,891864,Cuomo; Raphael Eduardo,9993,0,9999,6
1746585176479,CLRE 253,A00,891867,Vaida; Florin,9994,0,9999,5
1746585176479,CLRE 253,B00,907819,Staff,9999,0,9999,0
1746585177509,CLRE 259,A00,891868,Patel; Hemal,9998,0,9999,1
1746585178535,CLRE 260,A00,891872,Cuomo; Raphael Eduardo,9999,0,9999,0
1746585179562,CLRE 297,001,891888,Cuomo; Raphael Eduardo,9999,0,9999,0
1746585180586,CSE 191,A00,958773,Minnes Kemp; Mor Mia,9995,0,9999,4
1746585181612,CSE 197,001,959846,Minnes Kemp; Mor Mia,9990,0,9999,9
1746585182639,CSS 201S,A01,892054,Mignozzetti; Umberto,25,0,30,5
1746585183669,CSS 202S,A01,892056,Mignozzetti; Umberto,25,0,30,5
1746585184695,DSC 197,001,956898,Eldridge; Justin Matthew,9996,0,9999,3
1746585185719,DSC 297,001,958000,Mazumdar; Arya,9998,0,9999,1
1746585185719,DSC 297,002,959862,Wang; Yusu,9998,0,9999,1
1746585186745,EAP 100,A00,905686,Staff,9778,0,9999,221
1746585187771,ECE 45,A01,892618,Staff,0,0,65,65
1746585189828,ECE 111,A01,892719,Staff,6,0,65,59
1746585190853,ECE 197,001,957920,Mercier; Patrick Philip,9991,0,9999,8
1746585191880,ECON 178,A01,907814,Zhu; Ying,26,0,35,9
1746585192904,EDS 115,A00,895312,Staff,35,0,45,10
1746585193929,EDS 117,A01,895337,Staff,23,0,30,7
1746585194960,EDS 125,A00,895341,Jones; Gabrielle Anastasia,36,0,45,9
1746585195989,EDS 128A,A01,895459,Fargason; Sharon Gayle,44,0,45,1
1746585197017,EDS 128B,A01,895543,Pappas; Elizabeth,44,0,45,1
1746585198043,EDS 139,A00,897203,Pappas; Elizabeth,44,0,45,1
1746585198043,EDS 139,B00,897209,Fargason; Sharon Gayle,41,0,45,4
1746585199072,EDS 201,A00,895545,Staff,22,0,45,23
1746585200099,EDS 203,A01,895581,Halter; Christopher P.,22,0,45,23
1746585201125,EDS 204R,A01,895625,Heinzman; Erica M.,39,0,45,6
1746585201125,EDS 204R,B01,895693,Halter; Christopher P.,10,0,45,35
1746585202151,EDS 206R,A00,895694,Fargason; Sharon Gayle,1,0,30,29
1746585202151,EDS 206R,B00,895695,Choi; Bailey Miyeon,16,0,30,14
1746585203178,EDS 250,A00,895697,Hemans; Patricia Ann Benitez,22,0,45,23
1746585204203,EDS 281,A00,895701,Meyerott; Theresa Ann,1,0,15,14
1746585205229,EDS 284,A00,895736,Meyerott; Theresa Ann,1,0,15,14
1746585206257,EDS 286,A00,897210,Fine; Sarah,0,0,15,15
1746585207282,EDS 289C,A01,895770,Daly; Alan J.,1,0,15,14
1746585208314,EDS 290,A00,897211,Hofstetter; Carolyn,0,0,15,15
1746585209339,LIGM 5A,A00,896162,Fischer-Grunski; Eva K,12,0,20,8
1746585210365,LIGM 5B,A00,896260,Fischer-Grunski; Eva K,17,0,20,3
1746585211392,LIGM 5C,A00,896308,Fischer-Grunski; Eva K,18,0,20,2
1746585212419,LIIT 5AS,A00,896313,Carnelos; Chiara,18,0,20,2
1746585213447,LIIT 5BS,A00,896416,Carnelos; Chiara,20,0,20,0
1746585214472,LIIT 5CS,A00,896564,Carnelos; Chiara,20,0,20,0
1746585215499,LISP 5A,A00,896588,Munoz Sanchez; Alicia,2,0,20,18
1746585216530,LISP 5B,A00,896653,Munoz Sanchez; Alicia,7,0,20,13
1746585217555,LISP 5C,A00,896655,Munoz Sanchez; Alicia,0,1,20,20
1746585218585,MAE 197,001,957918,Kleissl; Jan,9996,0,9999,3
1746585218585,MAE 197,002,959806,Boechler; Nicholas Sebastia,9998,0,9999,1
1746585218585,MAE 197,003,959852,Mullin; Jennifer S,9998,0,9999,1
1746585219610,MATH 2,A01,957937,Staff,33,0,35,2
1746585220636,MATH 197,001,957876,Kedlaya; Kiran S.,9993,0,9999,6
1746585221664,MCWP 40,A00,892729,Duru; Nur,10,0,20,10
1746585221664,MCWP 40,B00,893304,Montejo; Carolina,14,0,20,6
1746585222690,MCWP 40R,A00,893757,Redela; Pamela Morgan,0,5,20,20
1746585223716,MCWP 50,A00,893758,Morshed; Michael James,0,0,20,20
1746585223716,MCWP 50,B00,893761,Bartulis; Jason Michael,17,0,20,3
1746585224745,MCWP 50R,A00,893766,Compas; Sean Matthew,0,1,20,20
1746585224745,MCWP 50R,B00,893769,Carter; Jennifer A,0,1,20,20
1746585224745,MCWP 50R,C00,893771,Krone; Jarret,0,3,20,20
1746585224745,MCWP 50R,D00,893772,Miller; Elizabeth Deen,0,0,20,20
1746585224745,MCWP 50R,E00,893775,Carter; Andrea L,0,1,20,20
1746585225771,MMW 11R,A01,892721,Herbst; Matthew,14,0,30,16
1746585225771,MMW 11R,A02,892722,Herbst; Matthew,0,0,0,3
1746585226798,MMW 12R,A01,892724,Herbst; Matthew,0,11,16,16
1746585226798,MMW 12R,A02,892725,Herbst; Matthew,0,10,16,16
1746585227823,MMW 13R,A01,892727,Staff,0,4,16,16
1746585227823,MMW 13R,A02,892728,Staff,0,4,16,16
1746585227823,MMW 13R,A03,958032,Staff,0,4,16,16
1746585227823,MMW 13R,A04,958033,Staff,0,4,16,16
1746585227823,MMW 13R,A05,958034,Staff,0,4,16,16
1746585228848,SIO 295LS,A00,894015,Staff,5,0,25,20
1746585229875,SIO 295S,A00,894020,Staff,5,0,25,20
1746585230901,SIOC 290S,B01,958918,Merrifield; Mark A,14,0,30,16
1746585231931,SIOC 291S,B01,958922,Gabriel; Corey John,14,0,30,16
1746585232958,SOCI 117,A01,895339,Staff,3,0,5,2
1746585233987,WES 237B,A00,894149,Staff,11,0,20,9
1746585236051,AESE 279B,A00,891859,Staff,13,0,35,22
1746585237078,AIP 197,001,891854,Vespa; Emanuel Ignacio,9999,0,9999,0
1746585238108,ANTH 289S,A00,891856,Gagneux; Pascal,12,0,12,0
1746585239135,BENG 196,001,957946,Engler; Adam J.,9996,0,9999,3
1746585240160,BISP 197,001,959851,Wilhelm; James E.,9998,0,9999,1
1746585241185,CAT 124RS,A01,956906,Staff,6,0,25,19
1746585242212,CAT 125RS,A01,922013,Staff,6,0,25,19
1746585243239,CLRE 250,A00,891860,Morris; Sheldon,9995,0,9999,4
1746585245293,CLRE 251R,A00,907817,Mehta; Ravindra L.,9994,0,9999,5
1746585246320,CLRE 252,A00,891864,Cuomo; Raphael Eduardo,9993,0,9999,6
1746585247347,CLRE 253,A00,891867,Vaida; Florin,9994,0,9999,5
1746585247347,CLRE 253,B00,907819,Staff,9999,0,9999,0
1746585248373,CLRE 259,A00,891868,Patel; Hemal,9998,0,9999,1
1746585249399,CLRE 260,A00,891872,Cuomo; Raphael Eduardo,9999,0,9999,0
1746585250427,CLRE 297,001,891888,Cuomo; Raphael Eduardo,9999,0,9999,0
1746585251453,CSE 191,A00,958773,Minnes Kemp; Mor Mia,9995,0,9999,4
1746585252481,CSE 197,001,959846,Minnes Kemp; Mor Mia,9990,0,9999,9
1746585253526,CSS 201S,A01,892054,Mignozzetti; Umberto,25,0,30,5
1746585254556,CSS 202S,A01,892056,Mignozzetti; Umberto,25,0,30,5
1746585255582,DSC 197,001,956898,Eldridge; Justin Matthew,9996,0,9999,3
1746585256609,DSC 297,001,958000,Mazumdar; Arya,9998,0,9999,1
1746585256609,DSC 297,002,959862,Wang; Yusu,9998,0,9999,1
1746585257637,EAP 100,A00,905686,Staff,9778,0,9999,221
1746585258666,ECE 45,A01,892618,Staff,0,0,65,65
1746585260720,ECE 111,A01,892719,Staff,6,0,65,59
1746585261747,ECE 197,001,957920,Mercier; Patrick Philip,9991,0,9999,8
1746585262771,ECON 178,A01,907814,Zhu; Ying,26,0,35,9
1746585263798,EDS 115,A00,895312,Staff,35,0,45,10
1746585264824,EDS 117,A01,895337,Staff,23,0,30,7
1746585265853,EDS 125,A00,895341,Jones; Gabrielle Anastasia,36,0,45,9
1746585266880,EDS 128A,A01,895459,Fargason; Sharon Gayle,44,0,45,1
1746585267909,EDS 128B,A01,895543,Pappas; Elizabeth,44,0,45,1
1746585268935,EDS 139,A00,897203,Pappas; Elizabeth,44,0,45,1
1746585268935,EDS 139,B00,897209,Fargason; Sharon Gayle,41,0,45,4
1746585269963,EDS 201,A00,895545,Staff,22,0,45,23
1746585270992,EDS 203,A01,895581,Halter; Christopher P.,22,0,45,23
1746585272017,EDS 204R,A01,895625,Heinzman; Erica M.,39,0,45,6
1746585272017,EDS 204R,B01,895693,Halter; Christopher P.,10,0,45,35
1746585273045,EDS 206R,A00,895694,Fargason; Sharon Gayle,1,0,30,29
1746585273045,EDS 206R,B00,895695,Choi; Bailey Miyeon,16,0,30,14
1746585274072,EDS 250,A00,895697,Hemans; Patricia Ann Benitez,22,0,45,23
1746585275097,EDS 281,A00,895701,Meyerott; Theresa Ann,1,0,15,14
1746585276122,EDS 284,A00,895736,Meyerott; Theresa Ann,1,0,15,14
1746585277145,EDS 286,A00,897210,Fine; Sarah,0,0,15,15
1746585278170,EDS 289C,A01,895770,Daly; Alan J.,1,0,15,14
1746585279194,EDS 290,A00,897211,Hofstetter; Carolyn,0,0,15,15
1746585280218,LIGM 5A,A00,896162,Fischer-Grunski; Eva K,12,0,20,8
1746585281245,LIGM 5B,A00,896260,Fischer-Grunski; Eva K,17,0,20,3
1746585282274,LIGM 5C,A00,896308,Fischer-Grunski; Eva K,18,0,20,2
1746585283300,LIIT 5AS,A00,896313,Carnelos; Chiara,18,0,20,2
1746585284326,LIIT 5BS,A00,896416,Carnelos; Chiara,20,0,20,0
1746585285352,LIIT 5CS,A00,896564,Carnelos; Chiara,20,0,20,0
1746585286375,LISP 5A,A00,896588,Munoz Sanchez; Alicia,2,0,20,18
1746585287401,LISP 5B,A00,896653,Munoz Sanchez; Alicia,7,0,20,13
1746585288427,LISP 5C,A00,896655,Munoz Sanchez; Alicia,0,1,20,20
1746585289451,MAE 197,001,957918,Kleissl; Jan,9996,0,9999,3
1746585289451,MAE 197,002,959806,Boechler; Nicholas Sebastia,9998,0,9999,1
1746585289451,MAE 197,003,959852,Mullin; Jennifer S,9998,0,9999,1
1746585290478,MATH 2,A01,957937,Staff,33,0,35,2
1746585291505,MATH 197,001,957876,Kedlaya; Kiran S.,9993,0,9999,6
1746585292529,MCWP 40,A00,892729,Duru; Nur,10,0,20,10
1746585292529,MCWP 40,B00,893304,Montejo; Carolina,14,0,20,6
1746585293559,MCWP 40R,A00,893757,Redela; Pamela Morgan,0,5,20,20
1746585294586,MCWP 50,A00,893758,Morshed; Michael James,0,0,20,20
1746585294586,MCWP 50,B00,893761,Bartulis; Jason Michael,17,0,20,3
1746585295612,MCWP 50R,A00,893766,Compas; Sean Matthew,0,1,20,20
1746585295612,MCWP 50R,B00,893769,Carter; Jennifer A,0,1,20,20
1746585295612,MCWP 50R,C00,893771,Krone; Jarret,0,3,20,20
1746585295612,MCWP 50R,D00,893772,Miller; Elizabeth Deen,0,0,20,20
1746585295612,MCWP 50R,E00,893775,Carter; Andrea L,0,1,20,20
1746585296637,MMW 11R,A01,892721,Herbst; Matthew,14,0,30,16
1746585296637,MMW 11R,A02,892722,Herbst; Matthew,0,0,0,3
1746585297667,MMW 12R,A01,892724,Herbst; Matthew,0,11,16,16
1746585297667,MMW 12R,A02,892725,Herbst; Matthew,0,10,16,16
1746585298694,MMW 13R,A01,892727,Staff,0,4,16,16
1746585298694,MMW 13R,A02,892728,Staff,0,4,16,16
1746585298694,MMW 13R,A03,958032,Staff,0,4,16,16
1746585298694,MMW 13R,A04,958033,Staff,0,4,16,16
1746585298694,MMW 13R,A05,958034,Staff,0,4,16,16
1746585299720,SIO 295LS,A00,894015,Staff,5,0,25,20
1746585300750,SIO 295S,A00,894020,Staff,5,0,25,20
1746585301777,SIOC 290S,B01,958918,Merrifield; Mark A,14,0,30,16
1746585302804,SIOC 291S,B01,958922,Gabriel; Corey John,14,0,30,16
1746585303832,SOCI 117,A01,895339,Staff,3,0,5,2
1746585304862,WES 237B,A00,894149,Staff,11,0,20,9
1746585306916,AESE 279B,A00,891859,Staff,13,0,35,22
1746585307946,AIP 197,001,891854,Vespa; Emanuel Ignacio,9999,0,9999,0
1746585308971,ANTH 289S,A00,891856,Gagneux; Pascal,12,0,12,0
1746585310000,BENG 196,001,957946,Engler; Adam J.,9996,0,9999,3
1746585311024,BISP 197,001,959851,Wilhelm; James E.,9998,0,9999,1
1746585312049,CAT 124RS,A01,956906,Staff,6,0,25,19
1746585313079,CAT 125RS,A01,922013,Staff,6,0,25,19
1746585314106,CLRE 250,A00,891860,Morris; Sheldon,9995,0,9999,4
1746585316163,CLRE 251R,A00,907817,Mehta; Ravindra L.,9994,0,9999,5
1746585317192,CLRE 252,A00,891864,Cuomo; Raphael Eduardo,9993,0,9999,6
1746585318220,CLRE 253,A00,891867,Vaida; Florin,9994,0,9999,5
1746585318220,CLRE 253,B00,907819,Staff,9999,0,9999,0
1746585319246,CLRE 259,A00,891868,Patel; Hemal,9998,0,9999,1
1746585320271,CLRE 260,A00,891872,Cuomo; Raphael Eduardo,9999,0,9999,0
1746585321295,CLRE 297,001,891888,Cuomo; Raphael Eduardo,9999,0,9999,0
1746585322320,CSE 191,A00,958773,Minnes Kemp; Mor Mia,9995,0,9999,4
1746585323348,CSE 197,001,959846,Minnes Kemp; Mor Mia,9990,0,9999,9
1746585324379,CSS 201S,A01,892054,Mignozzetti; Umberto,25,0,30,5
1746585325404,CSS 202S,A01,892056,Mignozzetti; Umberto,25,0,30,5
1746585326433,DSC 197,001,956898,Eldridge; Justin Matthew,9996,0,9999,3
1746585327462,DSC 297,001,958000,Mazumdar; Arya,9998,0,9999,1
1746585327462,DSC 297,002,959862,Wang; Yusu,9998,0,9999,1
1746585328487,EAP 100,A00,905686,Staff,9778,0,9999,221
1746585329515,ECE 45,A01,892618,Staff,0,0,65,65
1746585331567,ECE 111,A01,892719,Staff,6,0,65,59
1746585332593,ECE 197,001,957920,Mercier; Patrick Philip,9991,0,9999,8
1746585333619,ECON 178,A01,907814,Zhu; Ying,26,0,35,9
1746585334650,EDS 115,A00,895312,Staff,35,0,45,10
1746585335677,EDS 117,A01,895337,Staff,23,0,30,7
1746585336708,EDS 125,A00,895341,Jones; Gabrielle Anastasia,36,0,45,9
1746585337736,EDS 128A,A01,895459,Fargason; Sharon Gayle,44,0,45,1
1746585338766,EDS 128B,A01,895543,Pappas; Elizabeth,44,0,45,1
1746585339794,EDS 139,A00,897203,Pappas; Elizabeth,44,0,45,1
1746585339794,EDS 139,B00,897209,Fargason; Sharon Gayle,41,0,45,4
1746585340820,EDS 201,A00,895545,Staff,22,0,45,23
1746585341847,EDS 203,A01,895581,Halter; Christopher P.,22,0,45,23
1746585342874,EDS 204R,A01,895625,Heinzman; Erica M.,39,0,45,6
1746585342874,EDS 204R,B01,895693,Halter; Christopher P.,10,0,45,35
1746585343898,EDS 206R,A00,895694,Fargason; Sharon Gayle,1,0,30,29
1746585343898,EDS 206R,B00,895695,Choi; Bailey Miyeon,16,0,30,14
1746585344927,EDS 250,A00,895697,Hemans; Patricia Ann Benitez,22,0,45,23
1746585345952,EDS 281,A00,895701,Meyerott; Theresa Ann,1,0,15,14
1746585346978,EDS 284,A00,895736,Meyerott; Theresa Ann,1,0,15,14
1746585348003,EDS 286,A00,897210,Fine; Sarah,0,0,15,15
1746585349028,EDS 289C,A01,895770,Daly; Alan J.,1,0,15,14
1746585350054,EDS 290,A00,897211,Hofstetter; Carolyn,0,0,15,15
1746585351083,LIGM 5A,A00,896162,Fischer-Grunski; Eva K,12,0,20,8
1746585352111,LIGM 5B,A00,896260,Fischer-Grunski; Eva K,17,0,20,3
1746585353138,LIGM 5C,A00,896308,Fischer-Grunski; Eva K,18,0,20,2
1746585354163,LIIT 5AS,A00,896313,Carnelos; Chiara,18,0,20,2
1746585355191,LIIT 5BS,A00,896416,Carnelos; Chiara,20,0,20,0
1746585356219,LIIT 5CS,A00,896564,Carnelos; Chiara,20,0,20,0
1746585357246,LISP 5A,A00,896588,Munoz Sanchez; Alicia,2,0,20,18
1746585358271,LISP 5B,A00,896653,Munoz Sanchez; Alicia,7,0,20,13
1746585359296,LISP 5C,A00,896655,Munoz Sanchez; Alicia,0,1,20,20
1746585360320,MAE 197,001,957918,Kleissl; Jan,9996,0,9999,3
1746585360320,MAE 197,002,959806,Boechler; Nicholas Sebastia,9998,0,9999,1
1746585360320,MAE 197,003,959852,Mullin; Jennifer S,9998,0,9999,1
1746585361349,MATH 2,A01,957937,Staff,33,0,35,2
1746585362378,MATH 197,001,957876,Kedlaya; Kiran S.,9993,0,9999,6
1746585363405,MCWP 40,A00,892729,Duru; Nur,10,0,20,10
1746585363405,MCWP 40,B00,893304,Montejo; Carolina,14,0,20,6
1746585364431,MCWP 40R,A00,893757,Redela; Pamela Morgan,0,5,20,20
1746585365460,MCWP 50,A00,893758,Morshed; Michael James,0,0,20,20
1746585365460,MCWP 50,B00,893761,Bartulis; Jason Michael,17,0,20,3
1746585366486,MCWP 50R,A00,893766,Compas; Sean Matthew,0,1,20,20
1746585366486,MCWP 50R,B00,893769,Carter; Jennifer A,0,1,20,20
1746585366486,MCWP 50R,C00,893771,Krone; Jarret,0,3,20,20
1746585366486,MCWP 50R,D00,893772,Miller; Elizabeth Deen,0,0,20,20
1746585366486,MCWP 50R,E00,893775,Carter; Andrea L,0,1,20,20
1746585367513,MMW 11R,A01,892721,Herbst; Matthew,14,0,30,16
1746585367513,MMW 11R,A02,892722,Herbst; Matthew,0,0,0,3
1746585368543,MMW 12R,A01,892724,Herbst; Matthew,0,11,16,16
1746585368543,MMW 12R,A02,892725,Herbst; Matthew,0,10,16,16
1746585369569,MMW 13R,A01,892727,Staff,0,4,16,16
1746585369569,MMW 13R,A02,892728,Staff,0,4,16,16
1746585369569,MMW 13R,A03,958032,Staff,0,4,16,16
1746585369569,MMW 13R,A04,958033,Staff,0,4,16,16
1746585369569,MMW 13R,A05,958034,Staff,0,4,16,16
1746585370600,SIO 295LS,A00,894015,Staff,5,0,25,20
1746585371625,SIO 295S,A00,894020,Staff,5,0,25,20
1746585372656,SIOC 290S,B01,958918,Merrifield; Mark A,14,0,30,16
1746585373684,SIOC 291S,B01,958922,Gabriel; Corey John,14,0,30,16
1746585374712,SOCI 117,A01,895339,Staff,3,0,5,2
1746585375737,WES 237B,A00,894149,Staff,11,0,20,9
1746585377886,AESE 279B,A00,891859,Staff,13,0,35,22
1746585378930,AIP 197,001,891854,Vespa; Emanuel Ignacio,9999,0,9999,0
1746585380082,ANTH 289S,A00,891856,Gagneux; Pascal,12,0,12,0
1746585381106,BENG 196,001,957946,Engler; Adam J.,9996,0,9999,3
1746585382132,BISP 197,001,959851,Wilhelm; James E.,9998,0,9999,1
1746585383155,CAT 124RS,A01,956906,Staff,6,0,25,19
1746585384179,CAT 125RS,A01,922013,Staff,6,0,25,19
1746585385207,CLRE 250,A00,891860,Morris; Sheldon,9995,0,9999,4
1746585387257,CLRE 251R,A00,907817,Mehta; Ravindra L.,9994,0,9999,5
1746585388284,CLRE 252,A00,891864,Cuomo; Raphael Eduardo,9993,0,9999,6
1746585389309,CLRE 253,A00,891867,Vaida; Florin,9994,0,9999,5
1746585389309,CLRE 253,B00,907819,Staff,9999,0,9999,0
1746585390331,CLRE 259,A00,891868,Patel; Hemal,9998,0,9999,1
1746585391356,CLRE 260,A00,891872,Cuomo; Raphael Eduardo,9999,0,9999,0
1746585392382,CLRE 297,001,891888,Cuomo; Raphael Eduardo,9999,0,9999,0
1746585393411,CSE 191,A00,958773,Minnes Kemp; Mor Mia,9995,0,9999,4
1746585394434,CSE 197,001,959846,Minnes Kemp; Mor Mia,9990,0,9999,9
1746585395460,CSS 201S,A01,892054,Mignozzetti; Umberto,25,0,30,5
1746585396489,CSS 202S,A01,892056,Mignozzetti; Umberto,25,0,30,5
1746585397516,DSC 197,001,956898,Eldridge; Justin Matthew,9996,0,9999,3
1746585398543,DSC 297,001,958000,Mazumdar; Arya,9998,0,9999,1
1746585398543,DSC 297,002,959862,Wang; Yusu,9998,0,9999,1
1746585399571,EAP 100,A00,905686,Staff,9778,0,9999,221
1746585400624,ECE 45,A01,892618,Staff,0,0,65,65
1746585402674,ECE 111,A01,892719,Staff,6,0,65,59
1746585403700,ECE 197,001,957920,Mercier; Patrick Philip,9991,0,9999,8
1746585404723,ECON 178,A01,907814,Zhu; Ying,26,0,35,9
1746585405748,EDS 115,A00,895312,Staff,35,0,45,10
1746585406775,EDS 117,A01,895337,Staff,23,0,30,7
1746585407802,EDS 125,A00,895341,Jones; Gabrielle Anastasia,36,0,45,9
1746585408830,EDS 128A,A01,895459,Fargason; Sharon Gayle,44,0,45,1
1746585409855,EDS 128B,A01,895543,Pappas; Elizabeth,44,0,45,1
1746585410877,EDS 139,A00,897203,Pappas; Elizabeth,44,0,45,1
1746585410877,EDS 139,B00,897209,Fargason; Sharon Gayle,41,0,45,4
1746585411901,EDS 201,A00,895545,Staff,22,0,45,23
1746585412941,EDS 203,A01,895581,Halter; Christopher P.,22,0,45,23
1746585413966,EDS 204R,A01,895625,Heinzman; Erica M.,39,0,45,6
1746585413966,EDS 204R,B01,895693,Halter; Christopher P.,10,0,45,35
1746585414993,EDS 206R,A00,895694,Fargason; Sharon Gayle,1,0,30,29
1746585414993,EDS 206R,B00,895695,Choi; Bailey Miyeon,16,0,30,14
1746585416020,EDS 250,A00,895697,Hemans; Patricia Ann Benitez,22,0,45,23
1746585417044,EDS 281,A00,895701,Meyerott; Theresa Ann,1,0,15,14
1746585418069,EDS 284,A00,895736,Meyerott; Theresa Ann,1,0,15,14
1746585419095,EDS 286,A00,897210,Fine; Sarah,0,0,15,15
1746585420128,EDS 289C,A01,895770,Daly; Alan J.,1,0,15,14
1746585421152,EDS 290,A00,897211,Hofstetter; Carolyn,0,0,15,15
1746585422179,LIGM 5A,A00,896162,Fischer-Grunski; Eva K,12,0,20,8
1746585423203,LIGM 5B,A00,896260,Fischer-Grunski; Eva K,17,0,20,3
1746585424227,LIGM 5C,A00,896308,Fischer-Grunski; Eva K,18,0,20,2
1746585425251,LIIT 5AS,A00,896313,Carnelos; Chiara,18,0,20,2
1746585426276,LIIT 5BS,A00,896416,Carnelos; Chiara,20,0,20,0
1746585427303,LIIT 5CS,A00,896564,Carnelos; Chiara,20,0,20,0
1746585428326,LISP 5A,A00,896588,Munoz Sanchez; Alicia,2,0,20,18
1746585429349,LISP 5B,A00,896653,Munoz Sanchez; Alicia,7,0,20,13
1746585430379,LISP 5C,A00,896655,Munoz Sanchez; Alicia,0,1,20,20
1746585431408,MAE 197,001,957918,Kleissl; Jan,9996,0,9999,3
1746585431408,MAE 197,002,959806,Boechler; Nicholas Sebastia,9998,0,9999,1
1746585431408,MAE 197,003,959852,Mullin; Jennifer S,9998,0,9999,1
1746585432436,MATH 2,A01,957937,Staff,33,0,35,2
1746585433463,MATH 197,001,957876,Kedlaya; Kiran S.,9993,0,9999,6
1746585434489,MCWP 40,A00,892729,Duru; Nur,10,0,20,10
1746585434489,MCWP 40,B00,893304,Montejo; Carolina,14,0,20,6
1746585435515,MCWP 40R,A00,893757,Redela; Pamela Morgan,0,5,20,20
1746585436544,MCWP 50,A00,893758,Morshed; Michael James,0,0,20,20
1746585436544,MCWP 50,B00,893761,Bartulis; Jason Michael,17,0,20,3
1746585437569,MCWP 50R,A00,893766,Compas; Sean Matthew,0,1,20,20
1746585437569,MCWP 50R,B00,893769,Carter; Jennifer A,0,1,20,20
1746585437569,MCWP 50R,C00,893771,Krone; Jarret,0,3,20,20
1746585437569,MCWP 50R,D00,893772,Miller; Elizabeth Deen,0,0,20,20
1746585437569,MCWP 50R,E00,893775,Carter; Andrea L,0,1,20,20
1746585438593,MMW 11R,A01,892721,Herbst; Matthew,14,0,30,16
1746585438593,MMW 11R,A02,892722,Herbst; Matthew,0,0,0,3
1746585439624,MMW 12R,A01,892724,Herbst; Matthew,0,11,16,16
1746585439624,MMW 12R,A02,892725,Herbst; Matthew,0,10,16,16
1746585440648,MMW 13R,A01,892727,Staff,0,4,16,16
1746585440648,MMW 13R,A02,892728,Staff,0,4,16,16
1746585440648,MMW 13R,A03,958032,Staff,0,4,16,16
1746585440648,MMW 13R,A04,958033,Staff,0,4,16,16
1746585440648,MMW 13R,A05,958034,Staff,0,4,16,16
1746585441674,SIO 295LS,A00,894015,Staff,5,0,25,20
1746585442705,SIO 295S,A00,894020,Staff,5,0,25,20
1746585443731,SIOC 290S,B01,958918,Merrifield; Mark A,14,0,30,16
1746585444759,SIOC 291S,B01,958922,Gabriel; Corey John,14,0,30,16
1746585445789,SOCI 117,A01,895339,Staff,3,0,5,2
1746585446816,WES 237B,A00,894149,Staff,11,0,20,9
1746585448875,AESE 279B,A00,891859,Staff,13,0,35,22
1746585449899,AIP 197,001,891854,Vespa; Emanuel Ignacio,9999,0,9999,0
1746585450923,ANTH 289S,A00,891856,Gagneux; Pascal,12,0,12,0
1746585451952,BENG 196,001,957946,Engler; Adam J.,9996,0,9999,3
1746585452976,BISP 197,001,959851,Wilhelm; James E.,9998,0,9999,1
1746585454004,CAT 124RS,A01,956906,Staff,6,0,25,19
1746585455029,CAT 125RS,A01,922013,Staff,6,0,25,19
1746585456053,CLRE 250,A00,891860,Morris; Sheldon,9995,0,9999,4
1746585458102,CLRE 251R,A00,907817,Mehta; Ravindra L.,9994,0,9999,5
1746585459128,CLRE 252,A00,891864,Cuomo; Raphael Eduardo,9993,0,9999,6
1746585460158,CLRE 253,A00,891867,Vaida; Florin,9994,0,9999,5
1746585460158,CLRE 253,B00,907819,Staff,9999,0,9999,0
1746585461184,CLRE 259,A00,891868,Patel; Hemal,9998,0,9999,1
1746585462210,CLRE 260,A00,891872,Cuomo; Raphael Eduardo,9999,0,9999,0
1746585463235,CLRE 297,001,891888,Cuomo; Raphael Eduardo,9999,0,9999,0
1746585464260,CSE 191,A00,958773,Minnes Kemp; Mor Mia,9995,0,9999,4
1746585465286,CSE 197,001,959846,Minnes Kemp; Mor Mia,9990,0,9999,9
1746585466315,CSS 201S,A01,892054,Mignozzetti; Umberto,25,0,30,5
1746585467345,CSS 202S,A01,892056,Mignozzetti; Umberto,25,0,30,5
1746585468371,DSC 197,001,956898,Eldridge; Justin Matthew,9996,0,9999,3
1746585469396,DSC 297,001,958000,Mazumdar; Arya,9998,0,9999,1
1746585469396,DSC 297,002,959862,Wang; Yusu,9998,0,9999,1
1746585470422,EAP 100,A00,905686,Staff,9778,0,9999,221
1746585471451,ECE 45,A01,892618,Staff,0,0,65,65
1746585473503,ECE 111,A01,892719,Staff,6,0,65,59
1746585474528,ECE 197,001,957920,Mercier; Patrick Philip,9991,0,9999,8
1746585475554,ECON 178,A01,907814,Zhu; Ying,26,0,35,9
1746585476581,EDS 115,A00,895312,Staff,35,0,45,10
1746585477608,EDS 117,A01,895337,Staff,23,0,30,7
1746585478634,EDS 125,A00,895341,Jones; Gabrielle Anastasia,36,0,45,9
1746585479658,EDS 128A,A01,895459,Fargason; Sharon Gayle,44,0,45,1
1746585480687,EDS 128B,A01,895543,Pappas; Elizabeth,44,0,45,1
1746585481712,EDS 139,A00,897203,Pappas; Elizabeth,44,0,45,1
1746585481712,EDS 139,B00,897209,Fargason; Sharon Gayle,41,0,45,4
1746585482740,EDS 201,A00,895545,Staff,22,0,45,23
1746585483768,EDS 203,A01,895581,Halter; Christopher P.,22,0,45,23
1746585484795,EDS 204R,A01,895625,Heinzman; Erica M.,39,0,45,6
1746585484795,EDS 204R,B01,895693,Halter; Christopher P.,10,0,45,35
1746585485824,EDS 206R,A00,895694,Fargason; Sharon Gayle,1,0,30,29
1746585485824,EDS 206R,B00,895695,Choi; Bailey Miyeon,16,0,30,14
1746585486849,EDS 250,A00,895697,Hemans; Patricia Ann Benitez,22,0,45,23
1746585487876,EDS 281,A00,895701,Meyerott; Theresa Ann,1,0,15,14
1746585488901,EDS 284,A00,895736,Meyerott; Theresa Ann,1,0,15,14
1746585489929,EDS 286,A00,897210,Fine; Sarah,0,0,15,15
1746585490954,EDS 289C,A01,895770,Daly; Alan J.,1,0,15,14
1746585491981,EDS 290,A00,897211,Hofstetter; Carolyn,0,0,15,15
1746585493008,LIGM 5A,A00,896162,Fischer-Grunski; Eva K,12,0,20,8
1746585494033,LIGM 5B,A00,896260,Fischer-Grunski; Eva K,17,0,20,3
1746585495059,LIGM 5C,A00,896308,Fischer-Grunski; Eva K,18,0,20,2
1746585496084,LIIT 5AS,A00,896313,Carnelos; Chiara,18,0,20,2
1746585497110,LIIT 5BS,A00,896416,Carnelos; Chiara,20,0,20,0
1746585498139,LIIT 5CS,A00,896564,Carnelos; Chiara,20,0,20,0
1746585499168,LISP 5A,A00,896588,Munoz Sanchez; Alicia,2,0,20,18
1746585500196,LISP 5B,A00,896653,Munoz Sanchez; Alicia,7,0,20,13
1746585501222,LISP 5C,A00,896655,Munoz Sanchez; Alicia,0,1,20,20
1746585502250,MAE 197,001,957918,Kleissl; Jan,9996,0,9999,3
1746585502250,MAE 197,002,959806,Boechler; Nicholas Sebastia,9998,0,9999,1
1746585502250,MAE 197,003,959852,Mullin; Jennifer S,9998,0,9999,1
1746585503275,MATH 2,A01,957937,Staff,33,0,35,2
1746585504302,MATH 197,001,957876,Kedlaya; Kiran S.,9993,0,9999,6
1746585505327,MCWP 40,A00,892729,Duru; Nur,10,0,20,10
1746585505327,MCWP 40,B00,893304,Montejo; Carolina,14,0,20,6
1746585506354,MCWP 40R,A00,893757,Redela; Pamela Morgan,0,5,20,20
1746585507380,MCWP 50,A00,893758,Morshed; Michael James,0,0,20,20
1746585507380,MCWP 50,B00,893761,Bartulis; Jason Michael,17,0,20,3
1746585508408,MCWP 50R,A00,893766,Compas; Sean Matthew,0,1,20,20
1746585508408,MCWP 50R,B00,893769,Carter; Jennifer A,0,1,20,20
1746585508408,MCWP 50R,C00,893771,Krone; Jarret,0,3,20,20
1746585508408,MCWP 50R,D00,893772,Miller; Elizabeth Deen,0,0,20,20
1746585508408,MCWP 50R,E00,893775,Carter; Andrea L,0,1,20,20
1746585509433,MMW 11R,A01,892721,Herbst; Matthew,14,0,30,16
1746585509433,MMW 11R,A02,892722,Herbst; Matthew,0,0,0,3
1746585510459,MMW 12R,A01,892724,Herbst; Matthew,0,11,16,16
1746585510459,MMW 12R,A02,892725,Herbst; Matthew,0,10,16,16
1746585511488,MMW 13R,A01,892727,Staff,0,4,16,16
1746585511488,MMW 13R,A02,892728,Staff,0,4,16,16
1746585511488,MMW 13R,A03,958032,Staff,0,4,16,16
1746585511488,MMW 13R,A04,958033,Staff,0,4,16,16
1746585511488,MMW 13R,A05,958034,Staff,0,4,16,16
1746585512515,SIO 295LS,A00,894015,Staff,5,0,25,20
1746585513541,SIO 295S,A00,894020,Staff,5,0,25,20
1746585514567,SIOC 290S,B01,958918,Merrifield; Mark A,14,0,30,16
1746585515598,SIOC 291S,B01,958922,Gabriel; Corey John,14,0,30,16
1746585516624,SOCI 117,A01,895339,Staff,3,0,5,2
1746585517651,WES 237B,A00,894149,Staff,11,0,20,9
1746585519715,AESE 279B,A00,891859,Staff,13,0,35,22
1746585520739,AIP 197,001,891854,Vespa; Emanuel Ignacio,9999,0,9999,0
1746585521768,ANTH 289S,A00,891856,Gagneux; Pascal,12,0,12,0
1746585522792,BENG 196,001,957946,Engler; Adam J.,9996,0,9999,3
1746585523819,BISP 197,001,959851,Wilhelm; James E.,9998,0,9999,1
1746585524842,CAT 124RS,A01,956906,Staff,6,0,25,19
1746585525866,CAT 125RS,A01,922013,Staff,6,0,25,19
1746585526893,CLRE 250,A00,891860,Morris; Sheldon,9995,0,9999,4
1746585528948,CLRE 251R,A00,907817,Mehta; Ravindra L.,9994,0,9999,5
1746585529973,CLRE 252,A00,891864,Cuomo; Raphael Eduardo,9993,0,9999,6
1746585530998,CLRE 253,A00,891867,Vaida; Florin,9994,0,9999,5
1746585530998,CLRE 253,B00,907819,Staff,9999,0,9999,0
1746585532026,CLRE 259,A00,891868,Patel; Hemal,9998,0,9999,1
1746585533054,CLRE 260,A00,891872,Cuomo; Raphael Eduardo,9999,0,9999,0
1746585534082,CLRE 297,001,891888,Cuomo; Raphael Eduardo,9999,0,9999,0
1746585535111,CSE 191,A00,958773,Minnes Kemp; Mor Mia,9995,0,9999,4
1746585536139,CSE 197,001,959846,Minnes Kemp; Mor Mia,9990,0,9999,9
1746585537169,CSS 201S,A01,892054,Mignozzetti; Umberto,25,0,30,5
1746585538197,CSS 202S,A01,892056,Mignozzetti; Umberto,25,0,30,5
1746585539222,DSC 197,001,956898,Eldridge; Justin Matthew,9996,0,9999,3
1746585540249,DSC 297,001,958000,Mazumdar; Arya,9998,0,9999,1
1746585540249,DSC 297,002,959862,Wang; Yusu,9998,0,9999,1
1746585541282,EAP 100,A00,905686,Staff,9778,0,9999,221
1746585542307,ECE 45,A01,892618,Staff,0,0,65,65
1746585544361,ECE 111,A01,892719,Staff,6,0,65,59
1746585545390,ECE 197,001,957920,Mercier; Patrick Philip,9991,0,9999,8
1746585546416,ECON 178,A01,907814,Zhu; Ying,26,0,35,9
1746585547440,EDS 115,A00,895312,Staff,35,0,45,10
1746585548465,EDS 117,A01,895337,Staff,23,0,30,7
1746585549490,EDS 125,A00,895341,Jones; Gabrielle Anastasia,36,0,45,9
1746585550516,EDS 128A,A01,895459,Fargason; Sharon Gayle,44,0,45,1
1746585551542,EDS 128B,A01,895543,Pappas; Elizabeth,44,0,45,1
1746585552567,EDS 139,A00,897203,Pappas; Elizabeth,44,0,45,1
1746585552567,EDS 139,B00,897209,Fargason; Sharon Gayle,41,0,45,4
1746585553594,EDS 201,A00,895545,Staff,22,0,45,23
1746585554621,EDS 203,A01,895581,Halter; Christopher P.,22,0,45,23
1746585555646,EDS 204R,A01,895625,Heinzman; Erica M.,39,0,45,6
1746585555646,EDS 204R,B01,895693,Halter; Christopher P.,10,0,45,35
1746585556672,EDS 206R,A00,895694,Fargason; Sharon Gayle,1,0,30,29
1746585556672,EDS 206R,B00,895695,Choi; Bailey Miyeon,16,0,30,14
1746585557698,EDS 250,A00,895697,Hemans; Patricia Ann Benitez,22,0,45,23
1746585558724,EDS 281,A00,895701,Meyerott; Theresa Ann,1,0,15,14
1746585559752,EDS 284,A00,895736,Meyerott; Theresa Ann,1,0,15,14
1746585560782,EDS 286,A00,897210,Fine; Sarah,0,0,15,15
1746585561808,EDS 289C,A01,895770,Daly; Alan J.,1,0,15,14
1746585562832,EDS 290,A00,897211,Hofstetter; Carolyn,0,0,15,15
1746585563858,LIGM 5A,A00,896162,Fischer-Grunski; Eva K,12,0,20,8
1746585564885,LIGM 5B,A00,896260,Fischer-Grunski; Eva K,17,0,20,3
1746585565912,LIGM 5C,A00,896308,Fischer-Grunski; Eva K,18,0,20,2
1746585566940,LIIT 5AS,A00,896313,Carnelos; Chiara,18,0,20,2
1746585567966,LIIT 5BS,A00,896416,Carnelos; Chiara,20,0,20,0
1746585568991,LIIT 5CS,A00,896564,Carnelos; Chiara,20,0,20,0
1746585570022,LISP 5A,A00,896588,Munoz Sanchez; Alicia,2,0,20,18
1746585571048,LISP 5B,A00,896653,Munoz Sanchez; Alicia,7,0,20,13
1746585572076,LISP 5C,A00,896655,Munoz Sanchez; Alicia,0,1,20,20
1746585573102,MAE 197,001,957918,Kleissl; Jan,9996,0,9999,3
1746585573102,MAE 197,002,959806,Boechler; Nicholas Sebastia,9998,0,9999,1
1746585573102,MAE 197,003,959852,Mullin; Jennifer S,9998,0,9999,1
1746585574131,MATH 2,A01,957937,Staff,33,0,35,2
1746585575162,MATH 197,001,957876,Kedlaya; Kiran S.,9993,0,9999,6
1746585576189,MCWP 40,A00,892729,Duru; Nur,10,0,20,10
1746585576189,MCWP 40,B00,893304,Montejo; Carolina,14,0,20,6
1746585577215,MCWP 40R,A00,893757,Redela; Pamela Morgan,0,5,20,20
1746585578242,MCWP 50,A00,893758,Morshed; Michael James,0,0,20,20
1746585578242,MCWP 50,B00,893761,Bartulis; Jason Michael,17,0,20,3
1746585579267,MCWP 50R,A00,893766,Compas; Sean Matthew,0,1,20,20
1746585579267,MCWP 50R,B00,893769,Carter; Jennifer A,0,1,20,20
1746585579267,MCWP 50R,C00,893771,Krone; Jarret,0,3,20,20
1746585579267,MCWP 50R,D00,893772,Miller; Elizabeth Deen,0,0,20,20
1746585579267,MCWP 50R,E00,893775,Carter; Andrea L,0,1,20,20
1746585580296,MMW 11R,A01,892721,Herbst; Matthew,14,0,30,16
1746585580296,MMW 11R,A02,892722,Herbst; Matthew,0,0,0,3
1746585581326,MMW 12R,A01,892724,Herbst; Matthew,0,11,16,16
1746585581326,MMW 12R,A02,892725,Herbst; Matthew,0,10,16,16
1746585582352,MMW 13R,A01,892727,Staff,0,4,16,16
1746585582352,MMW 13R,A02,892728,Staff,0,4,16,16
1746585582352,MMW 13R,A03,958032,Staff,0,4,16,16
1746585582352,MMW 13R,A04,958033,Staff,0,4,16,16
1746585582352,MMW 13R,A05,958034,Staff,0,4,16,16
1746585583381,SIO 295LS,A00,894015,Staff,5,0,25,20
1746585584406,SIO 295S,A00,894020,Staff,5,0,25,20
1746585585432,SIOC 290S,B01,958918,Merrifield; Mark A,14,0,30,16
1746585586462,SIOC 291S,B01,958922,Gabriel; Corey John,14,0,30,16
1746585587487,SOCI 117,A01,895339,Staff,3,0,5,2
1746585588514,WES 237B,A00,894149,Staff,11,0,20,9
1746585590593,AESE 279B,A00,891859,Staff,13,0,35,22
1746585591618,AIP 197,001,891854,Vespa; Emanuel Ignacio,9999,0,9999,0
1746585592644,ANTH 289S,A00,891856,Gagneux; Pascal,12,0,12,0
1746585593671,BENG 196,001,957946,Engler; Adam J.,9996,0,9999,3
1746585594698,BISP 197,001,959851,Wilhelm; James E.,9998,0,9999,1
1746585595727,CAT 124RS,A01,956906,Staff,6,0,25,19
1746585596751,CAT 125RS,A01,922013,Staff,6,0,25,19
1746585597776,CLRE 250,A00,891860,Morris; Sheldon,9995,0,9999,4
1746585599831,CLRE 251R,A00,907817,Mehta; Ravindra L.,9994,0,9999,5
1746585600857,CLRE 252,A00,891864,Cuomo; Raphael Eduardo,9993,0,9999,6
1746585601884,CLRE 253,A00,891867,Vaida; Florin,9994,0,9999,5
1746585601884,CLRE 253,B00,907819,Staff,9999,0,9999,0
1746585602914,CLRE 259,A00,891868,Patel; Hemal,9998,0,9999,1
1746585603942,CLRE 260,A00,891872,Cuomo; Raphael Eduardo,9999,0,9999,0
1746585604969,CLRE 297,001,891888,Cuomo; Raphael Eduardo,9999,0,9999,0
1746585605994,CSE 191,A00,958773,Minnes Kemp; Mor Mia,9995,0,9999,4
1746585607019,CSE 197,001,959846,Minnes Kemp; Mor Mia,9990,0,9999,9
1746585608044,CSS 201S,A01,892054,Mignozzetti; Umberto,25,0,30,5
1746585609068,CSS 202S,A01,892056,Mignozzetti; Umberto,25,0,30,5
1746585610094,DSC 197,001,956898,Eldridge; Justin Matthew,9996,0,9999,3
1746585611122,DSC 297,001,958000,Mazumdar; Arya,9998,0,9999,1
1746585611122,DSC 297,002,959862,Wang; Yusu,9998,0,9999,1
1746585612152,EAP 100,A00,905686,Staff,9778,0,9999,221
1746585613182,ECE 45,A01,892618,Staff,0,0,65,65
1746585615236,ECE 111,A01,892719,Staff,6,0,65,59
1746585616262,ECE 197,001,957920,Mercier; Patrick Philip,9991,0,9999,8
1746585617289,ECON 178,A01,907814,Zhu; Ying,26,0,35,9
1746585618317,EDS 115,A00,895312,Staff,35,0,45,10
1746585619345,EDS 117,A01,895337,Staff,23,0,30,7
1746585620375,EDS 125,A00,895341,Jones; Gabrielle Anastasia,36,0,45,9
1746585621402,EDS 128A,A01,895459,Fargason; Sharon Gayle,44,0,45,1
1746585622431,EDS 128B,A01,895543,Pappas; Elizabeth,44,0,45,1
1746585623457,EDS 139,A00,897203,Pappas; Elizabeth,44,0,45,1
1746585623457,EDS 139,B00,897209,Fargason; Sharon Gayle,41,0,45,4
1746585624484,EDS 201,A00,895545,Staff,22,0,45,23
1746585625513,EDS 203,A01,895581,Halter; Christopher P.,22,0,45,23
1746585626538,EDS 204R,A01,895625,Heinzman; Erica M.,39,0,45,6
1746585626538,EDS 204R,B01,895693,Halter; Christopher P.,10,0,45,35
1746585627563,EDS 206R,A00,895694,Fargason; Sharon Gayle,1,0,30,29
1746585627563,EDS 206R,B00,895695,Choi; Bailey Miyeon,16,0,30,14
1746585628588,EDS 250,A00,895697,Hemans; Patricia Ann Benitez,22,0,45,23
1746585629617,EDS 281,A00,895701,Meyerott; Theresa Ann,1,0,15,14
1746585630643,EDS 284,A00,895736,Meyerott; Theresa Ann,1,0,15,14
1746585631669,EDS 286,A00,897210,Fine; Sarah,0,0,15,15
1746585632697,EDS 289C,A01,895770,Daly; Alan J.,1,0,15,14
1746585633725,EDS 290,A00,897211,Hofstetter; Carolyn,0,0,15,15
1746585634753,LIGM 5A,A00,896162,Fischer-Grunski; Eva K,12,0,20,8
1746585635779,LIGM 5B,A00,896260,Fischer-Grunski; Eva K,17,0,20,3
1746585636803,LIGM 5C,A00,896308,Fischer-Grunski; Eva K,18,0,20,2
1746585637833,LIIT 5AS,A00,896313,Carnelos; Chiara,18,0,20,2
1746585638863,LIIT 5BS,A00,896416,Carnelos; Chiara,20,0,20,0
1746585639890,LIIT 5CS,A00,896564,Carnelos; Chiara,20,0,20,0
1746585640915,LISP 5A,A00,896588,Munoz Sanchez; Alicia,2,0,20,18
1746585641945,LISP 5B,A00,896653,Munoz Sanchez; Alicia,7,0,20,13
1746585642970,LISP 5C,A00,896655,Munoz Sanchez; Alicia,0,1,20,20
1746585643998,MAE 197,001,957918,Kleissl; Jan,9996,0,9999,3
1746585643998,MAE 197,002,959806,Boechler; Nicholas Sebastia,9998,0,9999,1
1746585643998,MAE 197,003,959852,Mullin; Jennifer S,9998,0,9999,1
1746585645026,MATH 2,A01,957937,Staff,33,0,35,2
1746585646053,MATH 197,001,957876,Kedlaya; Kiran S.,9993,0,9999,6
1746585647080,MCWP 40,A00,892729,Duru; Nur,10,0,20,10
1746585647080,MCWP 40,B00,893304,Montejo; Carolina,14,0,20,6
1746585648105,MCWP 40R,A00,893757,Redela; Pamela Morgan,0,5,20,20
1746585649135,MCWP 50,A00,893758,Morshed; Michael James,0,0,20,20
1746585649135,MCWP 50,B00,893761,Bartulis; Jason Michael,17,0,20,3
1746585650161,MCWP 50R,A00,893766,Compas; Sean Matthew,0,1,20,20
1746585650161,MCWP 50R,B00,893769,Carter; Jennifer A,0,1,20,20
1746585650161,MCWP 50R,C00,893771,Krone; Jarret,0,3,20,20
1746585650161,MCWP 50R,D00,893772,Miller; Elizabeth Deen,0,0,20,20
1746585650161,MCWP 50R,E00,893775,Carter; Andrea L,0,1,20,20
1746585651188,MMW 11R,A01,892721,Herbst; Matthew,14,0,30,16
1746585651188,MMW 11R,A02,892722,Herbst; Matthew,0,0,0,3
1746585652213,MMW 12R,A01,892724,Herbst; Matthew,0,11,16,16
1746585652213,MMW 12R,A02,892725,Herbst; Matthew,0,10,16,16
1746585653242,MMW 13R,A01,892727,Staff,0,4,16,16
1746585653242,MMW 13R,A02,892728,Staff,0,4,16,16
1746585653242,MMW 13R,A03,958032,Staff,0,4,16,16
1746585653242,MMW 13R,A04,958033,Staff,0,4,16,16
1746585653242,MMW 13R,A05,958034,Staff,0,4,16,16
1746585654267,SIO 295LS,A00,894015,Staff,5,0,25,20
1746585655296,SIO 295S,A00,894020,Staff,5,0,25,20
1746585656323,SIOC 290S,B01,958918,Merrifield; Mark A,14,0,30,16
1746585657350,SIOC 291S,B01,958922,Gabriel; Corey John,14,0,30,16
1746585658374,SOCI 117,A01,895339,Staff,3,0,5,2
1746585659401,WES 237B,A00,894149,Staff,11,0,20,9
1746585661474,AESE 279B,A00,891859,Staff,13,0,35,22
1746585662501,AIP 197,001,891854,Vespa; Emanuel Ignacio,9999,0,9999,0
1746585663525,ANTH 289S,A00,891856,Gagneux; Pascal,12,0,12,0
1746585664553,BENG 196,001,957946,Engler; Adam J.,9996,0,9999,3
1746585665581,BISP 197,001,959851,Wilhelm; James E.,9998,0,9999,1
1746585666605,CAT 124RS,A01,956906,Staff,6,0,25,19
1746585667631,CAT 125RS,A01,922013,Staff,6,0,25,19
1746585668658,CLRE 250,A00,891860,Morris; Sheldon,9995,0,9999,4
1746585670711,CLRE 251R,A00,907817,Mehta; Ravindra L.,9994,0,9999,5
1746585671739,CLRE 252,A00,891864,Cuomo; Raphael Eduardo,9993,0,9999,6
1746585672769,CLRE 253,A00,891867,Vaida; Florin,9994,0,9999,5
1746585672769,CLRE 253,B00,907819,Staff,9999,0,9999,0
1746585673795,CLRE 259,A00,891868,Patel; Hemal,9998,0,9999,1
1746585674823,CLRE 260,A00,891872,Cuomo; Raphael Eduardo,9999,0,9999,0
1746585675850,CLRE 297,001,891888,Cuomo; Raphael Eduardo,9999,0,9999,0
1746585676877,CSE 191,A00,958773,Minnes Kemp; Mor Mia,9995,0,9999,4
1746585677904,CSE 197,001,959846,Minnes Kemp; Mor Mia,9990,0,9999,9
1746585678933,CSS 201S,A01,892054,Mignozzetti; Umberto,25,0,30,5
1746585679962,CSS 202S,A01,892056,Mignozzetti; Umberto,25,0,30,5
1746585680988,DSC 197,001,956898,Eldridge; Justin Matthew,9996,0,9999,3
1746585682012,DSC 297,001,958000,Mazumdar; Arya,9998,0,9999,1
1746585682012,DSC 297,002,959862,Wang; Yusu,9998,0,9999,1
1746585683039,EAP 100,A00,905686,Staff,9778,0,9999,221
1746585684068,ECE 45,A01,892618,Staff,0,0,65,65
1746585686120,ECE 111,A01,892719,Staff,6,0,65,59
1746585687145,ECE 197,001,957920,Mercier; Patrick Philip,9991,0,9999,8
1746585688175,ECON 178,A01,907814,Zhu; Ying,26,0,35,9
1746585689202,EDS 115,A00,895312,Staff,35,0,45,10
1746585690226,EDS 117,A01,895337,Staff,23,0,30,7
1746585691250,EDS 125,A00,895341,Jones; Gabrielle Anastasia,36,0,45,9
1746585692279,EDS 128A,A01,895459,Fargason; Sharon Gayle,44,0,45,1
1746585693303,EDS 128B,A01,895543,Pappas; Elizabeth,44,0,45,1
1746585694329,EDS 139,A00,897203,Pappas; Elizabeth,44,0,45,1
1746585694329,EDS 139,B00,897209,Fargason; Sharon Gayle,41,0,45,4
1746585695358,EDS 201,A00,895545,Staff,22,0,45,23
1746585696384,EDS 203,A01,895581,Halter; Christopher P.,22,0,45,23
1746585697410,EDS 204R,A01,895625,Heinzman; Erica M.,39,0,45,6
1746585697410,EDS 204R,B01,895693,Halter; Christopher P.,10,0,45,35
1746585698439,EDS 206R,A00,895694,Fargason; Sharon Gayle,1,0,30,29
1746585698439,EDS 206R,B00,895695,Choi; Bailey Miyeon,16,0,30,14
1746585699468,EDS 250,A00,895697,Hemans; Patricia Ann Benitez,22,0,45,23
1746585700495,EDS 281,A00,895701,Meyerott; Theresa Ann,1,0,15,14
1746585701523,EDS 284,A00,895736,Meyerott; Theresa Ann,1,0,15,14
1746585702549,EDS 286,A00,897210,Fine; Sarah,0,0,15,15
1746585703578,EDS 289C,A01,895770,Daly; Alan J.,1,0,15,14
1746585704604,EDS 290,A00,897211,Hofstetter; Carolyn,0,0,15,15
1746585705632,LIGM 5A,A00,896162,Fischer-Grunski; Eva K,12,0,20,8
1746585706657,LIGM 5B,A00,896260,Fischer-Grunski; Eva K,17,0,20,3
1746585707683,LIGM 5C,A00,896308,Fischer-Grunski; Eva K,18,0,20,2
1746585708713,LIIT 5AS,A00,896313,Carnelos; Chiara,18,0,20,2
1746585709741,LIIT 5BS,A00,896416,Carnelos; Chiara,20,0,20,0
1746585710769,LIIT 5CS,A00,896564,Carnelos; Chiara,20,0,20,0
1746585711795,LISP 5A,A00,896588,Munoz Sanchez; Alicia,2,0,20,18
1746585712822,LISP 5B,A00,896653,Munoz Sanchez; Alicia,7,0,20,13
1746585713852,LISP 5C,A00,896655,Munoz Sanchez; Alicia,0,1,20,20
1746585714875,MAE 197,001,957918,Kleissl; Jan,9996,0,9999,3
1746585714875,MAE 197,002,959806,Boechler; Nicholas Sebastia,9998,0,9999,1
1746585714875,MAE 197,003,959852,Mullin; Jennifer S,9998,0,9999,1
1746585715899,MATH 2,A01,957937,Staff,33,0,35,2
1746585716922,MATH 197,001,957876,Kedlaya; Kiran S.,9993,0,9999,6
1746585717950,MCWP 40,A00,892729,Duru; Nur,10,0,20,10
1746585717950,MCWP 40,B00,893304,Montejo; Carolina,14,0,20,6
1746585718979,MCWP 40R,A00,893757,Redela; Pamela Morgan,0,5,20,20
1746585720005,MCWP 50,A00,893758,Morshed; Michael James,0,0,20,20
1746585720005,MCWP 50,B00,893761,Bartulis; Jason Michael,17,0,20,3
1746585721036,MCWP 50R,A00,893766,Compas; Sean Matthew,0,1,20,20
1746585721036,MCWP 50R,B00,893769,Carter; Jennifer A,0,1,20,20
1746585721036,MCWP 50R,C00,893771,Krone; Jarret,0,3,20,20
1746585721036,MCWP 50R,D00,893772,Miller; Elizabeth Deen,0,0,20,20
1746585721036,MCWP 50R,E00,893775,Carter; Andrea L,0,1,20,20
1746585722061,MMW 11R,A01,892721,Herbst; Matthew,14,0,30,16
1746585722061,MMW 11R,A02,892722,Herbst; Matthew,0,0,0,3
1746585723087,MMW 12R,A01,892724,Herbst; Matthew,0,11,16,16
1746585723087,MMW 12R,A02,892725,Herbst; Matthew,0,10,16,16
1746585724117,MMW 13R,A01,892727,Staff,0,4,16,16
1746585724117,MMW 13R,A02,892728,Staff,0,4,16,16
1746585724117,MMW 13R,A03,958032,Staff,0,4,16,16
1746585724117,MMW 13R,A04,958033,Staff,0,4,16,16
1746585724117,MMW 13R,A05,958034,Staff,0,4,16,16
1746585725141,SIO 295LS,A00,894015,Staff,5,0,25,20
1746585726171,SIO 295S,A00,894020,Staff,5,0,25,20
1746585727198,SIOC 290S,B01,958918,Merrifield; Mark A,14,0,30,16
1746585728229,SIOC 291S,B01,958922,Gabriel; Corey John,14,0,30,16
1746585729256,SOCI 117,A01,895339,Staff,3,0,5,2
1746585730282,WES 237B,A00,894149,Staff,11,0,20,9
1746585732346,AESE 279B,A00,891859,Staff,13,0,35,22
1746585733372,AIP 197,001,891854,Vespa; Emanuel Ignacio,9999,0,9999,0
1746585734395,ANTH 289S,A00,891856,Gagneux; Pascal,12,0,12,0
1746585735420,BENG 196,001,957946,Engler; Adam J.,9996,0,9999,3
1746585736448,BISP 197,001,959851,Wilhelm; James E.,9998,0,9999,1
1746585737478,CAT 124RS,A01,956906,Staff,6,0,25,19
1746585738502,CAT 125RS,A01,922013,Staff,6,0,25,19
1746585739528,CLRE 250,A00,891860,Morris; Sheldon,9995,0,9999,4
1746585741584,CLRE 251R,A00,907817,Mehta; Ravindra L.,9994,0,9999,5
1746585742611,CLRE 252,A00,891864,Cuomo; Raphael Eduardo,9993,0,9999,6
1746585743637,CLRE 253,A00,891867,Vaida; Florin,9994,0,9999,5
1746585743637,CLRE 253,B00,907819,Staff,9999,0,9999,0
1746585744664,CLRE 259,A00,891868,Patel; Hemal,9998,0,9999,1
1746585745694,CLRE 260,A00,891872,Cuomo; Raphael Eduardo,9999,0,9999,0
1746585746721,CLRE 297,001,891888,Cuomo; Raphael Eduardo,9999,0,9999,0
1746585747750,CSE 191,A00,958773,Minnes Kemp; Mor Mia,9995,0,9999,4
1746585748777,CSE 197,001,959846,Minnes Kemp; Mor Mia,9990,0,9999,9
1746585749803,CSS 201S,A01,892054,Mignozzetti; Umberto,25,0,30,5
1746585750827,CSS 202S,A01,892056,Mignozzetti; Umberto,25,0,30,5
1746585751854,DSC 197,001,956898,Eldridge; Justin Matthew,9996,0,9999,3
1746585752878,DSC 297,001,958000,Mazumdar; Arya,9998,0,9999,1
1746585752878,DSC 297,002,959862,Wang; Yusu,9998,0,9999,1
1746585753905,EAP 100,A00,905686,Staff,9778,0,9999,221
1746585754931,ECE 45,A01,892618,Staff,0,0,65,65
1746585756984,ECE 111,A01,892719,Staff,6,0,65,59
1746585758011,ECE 197,001,957920,Mercier; Patrick Philip,9991,0,9999,8
1746585759042,ECON 178,A01,907814,Zhu; Ying,26,0,35,9
1746585760073,EDS 115,A00,895312,Staff,35,0,45,10
1746585761101,EDS 117,A01,895337,Staff,23,0,30,7
1746585762128,EDS 125,A00,895341,Jones; Gabrielle Anastasia,36,0,45,9
1746585763155,EDS 128A,A01,895459,Fargason; Sharon Gayle,44,0,45,1
1746585764182,EDS 128B,A01,895543,Pappas; Elizabeth,44,0,45,1
1746585765208,EDS 139,A00,897203,Pappas; Elizabeth,44,0,45,1
1746585765208,EDS 139,B00,897209,Fargason; Sharon Gayle,41,0,45,4
1746585766239,EDS 201,A00,895545,Staff,22,0,45,23
1746585767267,EDS 203,A01,895581,Halter; Christopher P.,22,0,45,23
1746585768296,EDS 204R,A01,895625,Heinzman; Erica M.,39,0,45,6
1746585768296,EDS 204R,B01,895693,Halter; Christopher P.,10,0,45,35
1746585769320,EDS 206R,A00,895694,Fargason; Sharon Gayle,1,0,30,29
1746585769320,EDS 206R,B00,895695,Choi; Bailey Miyeon,16,0,30,14
1746585770352,EDS 250,A00,895697,Hemans; Patricia Ann Benitez,22,0,45,23
1746585771382,EDS 281,A00,895701,Meyerott; Theresa Ann,1,0,15,14
1746585772409,EDS 284,A00,895736,Meyerott; Theresa Ann,1,0,15,14
1746585773434,EDS 286,A00,897210,Fine; Sarah,0,0,15,15
1746585774462,EDS 289C,A01,895770,Daly; Alan J.,1,0,15,14
1746585775488,EDS 290,A00,897211,Hofstetter; Carolyn,0,0,15,15
1746585776513,LIGM 5A,A00,896162,Fischer-Grunski; Eva K,12,0,20,8
1746585777539,LIGM 5B,A00,896260,Fischer-Grunski; Eva K,17,0,20,3
1746585778568,LIGM 5C,A00,896308,Fischer-Grunski; Eva K,18,0,20,2
1746585779595,LIIT 5AS,A00,896313,Carnelos; Chiara,18,0,20,2
1746585780620,LIIT 5BS,A00,896416,Carnelos; Chiara,20,0,20,0
1746585781646,LIIT 5CS,A00,896564,Carnelos; Chiara,20,0,20,0
1746585782678,LISP 5A,A00,896588,Munoz Sanchez; Alicia,2,0,20,18
1746585783707,LISP 5B,A00,896653,Munoz Sanchez; Alicia,7,0,20,13
1746585784736,LISP 5C,A00,896655,Munoz Sanchez; Alicia,0,1,20,20
1746585785761,MAE 197,001,957918,Kleissl; Jan,9996,0,9999,3
1746585785761,MAE 197,002,959806,Boechler; Nicholas Sebastia,9998,0,9999,1
1746585785761,MAE 197,003,959852,Mullin; Jennifer S,9998,0,9999,1
1746585786786,MATH 2,A01,957937,Staff,33,0,35,2
1746585787812,MATH 197,001,957876,Kedlaya; Kiran S.,9993,0,9999,6
1746585788843,MCWP 40,A00,892729,Duru; Nur,10,0,20,10
1746585788843,MCWP 40,B00,893304,Montejo; Carolina,14,0,20,6
1746585789867,MCWP 40R,A00,893757,Redela; Pamela Morgan,0,5,20,20
1746585790897,MCWP 50,A00,893758,Morshed; Michael James,0,0,20,20
1746585790897,MCWP 50,B00,893761,Bartulis; Jason Michael,17,0,20,3
1746585791932,MCWP 50R,A00,893766,Compas; Sean Matthew,0,1,20,20
1746585791932,MCWP 50R,B00,893769,Carter; Jennifer A,0,1,20,20
1746585791932,MCWP 50R,C00,893771,Krone; Jarret,0,3,20,20
1746585791932,MCWP 50R,D00,893772,Miller; Elizabeth Deen,0,0,20,20
1746585791932,MCWP 50R,E00,893775,Carter; Andrea L,0,1,20,20
1746585792964,MMW 11R,A01,892721,Herbst; Matthew,14,0,30,16
1746585792964,MMW 11R,A02,892722,Herbst; Matthew,0,0,0,3
1746585793992,MMW 12R,A01,892724,Herbst; Matthew,0,11,16,16
1746585793992,MMW 12R,A02,892725,Herbst; Matthew,0,10,16,16
1746585795018,MMW 13R,A01,892727,Staff,0,4,16,16
1746585795018,MMW 13R,A02,892728,Staff,0,4,16,16
1746585795018,MMW 13R,A03,958032,Staff,0,4,16,16
1746585795018,MMW 13R,A04,958033,Staff,0,4,16,16
1746585795018,MMW 13R,A05,958034,Staff,0,4,16,16
1746585796046,SIO 295LS,A00,894015,Staff,5,0,25,20
1746585797074,SIO 295S,A00,894020,Staff,5,0,25,20
1746585798100,SIOC 290S,B01,958918,Merrifield; Mark A,14,0,30,16
1746585799132,SIOC 291S,B01,958922,Gabriel; Corey John,14,0,30,16
1746585800158,SOCI 117,A01,895339,Staff,3,0,5,2
1746585801186,WES 237B,A00,894149,Staff,11,0,20,9
1746585803265,AESE 279B,A00,891859,Staff,13,0,35,22
1746585804290,AIP 197,001,891854,Vespa; Emanuel Ignacio,9999,0,9999,0
1746585805315,ANTH 289S,A00,891856,Gagneux; Pascal,12,0,12,0
1746585806339,BENG 196,001,957946,Engler; Adam J.,9996,0,9999,3
1746585807366,BISP 197,001,959851,Wilhelm; James E.,9998,0,9999,1
1746585808393,CAT 124RS,A01,956906,Staff,6,0,25,19
1746585809421,CAT 125RS,A01,922013,Staff,6,0,25,19
1746585810446,CLRE 250,A00,891860,Morris; Sheldon,9995,0,9999,4
1746585812506,CLRE 251R,A00,907817,Mehta; Ravindra L.,9994,0,9999,5
1746585813531,CLRE 252,A00,891864,Cuomo; Raphael Eduardo,9993,0,9999,6
1746585814560,CLRE 253,A00,891867,Vaida; Florin,9994,0,9999,5
1746585814560,CLRE 253,B00,907819,Staff,9999,0,9999,0
1746585815588,CLRE 259,A00,891868,Patel; Hemal,9998,0,9999,1
1746585816614,CLRE 260,A00,891872,Cuomo; Raphael Eduardo,9999,0,9999,0
1746585817640,CLRE 297,001,891888,Cuomo; Raphael Eduardo,9999,0,9999,0
1746585818668,CSE 191,A00,958773,Minnes Kemp; Mor Mia,9995,0,9999,4
1746585819698,CSE 197,001,959846,Minnes Kemp; Mor Mia,9990,0,9999,9
1746585820730,CSS 201S,A01,892054,Mignozzetti; Umberto,25,0,30,5
1746585821756,CSS 202S,A01,892056,Mignozzetti; Umberto,25,0,30,5
1746585822787,DSC 197,001,956898,Eldridge; Justin Matthew,9996,0,9999,3
1746585823812,DSC 297,001,958000,Mazumdar; Arya,9998,0,9999,1
1746585823812,DSC 297,002,959862,Wang; Yusu,9998,0,9999,1
1746585824841,EAP 100,A00,905686,Staff,9778,0,9999,221
1746585825873,ECE 45,A01,892618,Staff,0,0,65,65
1746585827929,ECE 111,A01,892719,Staff,6,0,65,59
1746585828956,ECE 197,001,957920,Mercier; Patrick Philip,9991,0,9999,8
1746585829983,ECON 178,A01,907814,Zhu; Ying,26,0,35,9
1746585831008,EDS 115,A00,895312,Staff,35,0,45,10
1746585832034,EDS 117,A01,895337,Staff,23,0,30,7
1746585833061,EDS 125,A00,895341,Jones; Gabrielle Anastasia,36,0,45,9
1746585834089,EDS 128A,A01,895459,Fargason; Sharon Gayle,44,0,45,1
1746585835120,EDS 128B,A01,895543,Pappas; Elizabeth,44,0,45,1
1746585836148,EDS 139,A00,897203,Pappas; Elizabeth,44,0,45,1
1746585836148,EDS 139,B00,897209,Fargason; Sharon Gayle,41,0,45,4
1746585837172,EDS 201,A00,895545,Staff,22,0,45,23
1746585838201,EDS 203,A01,895581,Halter; Christopher P.,22,0,45,23
1746585839228,EDS 204R,A01,895625,Heinzman; Erica M.,39,0,45,6
1746585839228,EDS 204R,B01,895693,Halter; Christopher P.,10,0,45,35
1746585840257,EDS 206R,A00,895694,Fargason; Sharon Gayle,1,0,30,29
1746585840257,EDS 206R,B00,895695,Choi; Bailey Miyeon,16,0,30,14
1746585841288,EDS 250,A00,895697,Hemans; Patricia Ann Benitez,22,0,45,23
1746585842317,EDS 281,A00,895701,Meyerott; Theresa Ann,1,0,15,14
1746585843342,EDS 284,A00,895736,Meyerott; Theresa Ann,1,0,15,14
1746585844369,EDS 286,A00,897210,Fine; Sarah,0,0,15,15
1746585845393,EDS 289C,A01,895770,Daly; Alan J.,1,0,15,14
1746585846421,EDS 290,A00,897211,Hofstetter; Carolyn,0,0,15,15
1746585847445,LIGM 5A,A00,896162,Fischer-Grunski; Eva K,12,0,20,8
1746585848470,LIGM 5B,A00,896260,Fischer-Grunski; Eva K,17,0,20,3
1746585849498,LIGM 5C,A00,896308,Fischer-Grunski; Eva K,18,0,20,2
1746585850525,LIIT 5AS,A00,896313,Carnelos; Chiara,18,0,20,2
1746585851553,LIIT 5BS,A00,896416,Carnelos; Chiara,20,0,20,0
1746585852578,LIIT 5CS,A00,896564,Carnelos; Chiara,20,0,20,0
1746585853604,LISP 5A,A00,896588,Munoz Sanchez; Alicia,2,0,20,18
1746585854632,LISP 5B,A00,896653,Munoz Sanchez; Alicia,7,0,20,13
1746585855657,LISP 5C,A00,896655,Munoz Sanchez; Alicia,0,1,20,20
1746585856683,MAE 197,001,957918,Kleissl; Jan,9996,0,9999,3
1746585856683,MAE 197,002,959806,Boechler; Nicholas Sebastia,9998,0,9999,1
1746585856683,MAE 197,003,959852,Mullin; Jennifer S,9998,0,9999,1
1746585857710,MATH 2,A01,957937,Staff,33,0,35,2
1746585858738,MATH 197,001,957876,Kedlaya; Kiran S.,9993,0,9999,6
1746585859766,MCWP 40,A00,892729,Duru; Nur,10,0,20,10
1746585859766,MCWP 40,B00,893304,Montejo; Carolina,14,0,20,6
1746585860792,MCWP 40R,A00,893757,Redela; Pamela Morgan,0,5,20,20
1746585861820,MCWP 50,A00,893758,Morshed; Michael James,0,0,20,20
1746585861820,MCWP 50,B00,893761,Bartulis; Jason Michael,17,0,20,3
1746585862849,MCWP 50R,A00,893766,Compas; Sean Matthew,0,1,20,20
1746585862849,MCWP 50R,B00,893769,Carter; Jennifer A,0,1,20,20
1746585862849,MCWP 50R,C00,893771,Krone; Jarret,0,3,20,20
1746585862849,MCWP 50R,D00,893772,Miller; Elizabeth Deen,0,0,20,20
1746585862849,MCWP 50R,E00,893775,Carter; Andrea L,0,1,20,20
1746585863880,MMW 11R,A01,892721,Herbst; Matthew,14,0,30,16
1746585863880,MMW 11R,A02,892722,Herbst; Matthew,0,0,0,3
1746585864907,MMW 12R,A01,892724,Herbst; Matthew,0,11,16,16
1746585864907,MMW 12R,A02,892725,Herbst; Matthew,0,10,16,16
1746585865934,MMW 13R,A01,892727,Staff,0,4,16,16
1746585865934,MMW 13R,A02,892728,Staff,0,4,16,16
1746585865934,MMW 13R,A03,958032,Staff,0,4,16,16
1746585865934,MMW 13R,A04,958033,Staff,0,4,16,16
1746585865934,MMW 13R,A05,958034,Staff,0,4,16,16
1746585866963,SIO 295LS,A00,894015,Staff,5,0,25,20
1746585867989,SIO 295S,A00,894020,Staff,5,0,25,20
1746585869015,SIOC 290S,B01,958918,Merrifield; Mark A,14,0,30,16
1746585870047,SIOC 291S,B01,958922,Gabriel; Corey John,14,0,30,16
1746585871075,SOCI 117,A01,895339,Staff,3,0,5,2
1746585872103,WES 237B,A00,894149,Staff,11,0,20,9
1746585874169,AESE 279B,A00,891859,Staff,13,0,35,22
1746585875196,AIP 197,001,891854,Vespa; Emanuel Ignacio,9999,0,9999,0
1746585876225,ANTH 289S,A00,891856,Gagneux; Pascal,12,0,12,0
1746585877250,BENG 196,001,957946,Engler; Adam J.,9996,0,9999,3
1746585878281,BISP 197,001,959851,Wilhelm; James E.,9998,0,9999,1
1746585879311,CAT 124RS,A01,956906,Staff,6,0,25,19
1746585880337,CAT 125RS,A01,922013,Staff,6,0,25,19
1746585881363,CLRE 250,A00,891860,Morris; Sheldon,9995,0,9999,4
1746585883417,CLRE 251R,A00,907817,Mehta; Ravindra L.,9994,0,9999,5
1746585884445,CLRE 252,A00,891864,Cuomo; Raphael Eduardo,9993,0,9999,6
1746585885471,CLRE 253,A00,891867,Vaida; Florin,9994,0,9999,5
1746585885471,CLRE 253,B00,907819,Staff,9999,0,9999,0
1746585886496,CLRE 259,A00,891868,Patel; Hemal,9998,0,9999,1
1746585887521,CLRE 260,A00,891872,Cuomo; Raphael Eduardo,9999,0,9999,0
1746585888549,CLRE 297,001,891888,Cuomo; Raphael Eduardo,9999,0,9999,0
1746585889576,CSE 191,A00,958773,Minnes Kemp; Mor Mia,9995,0,9999,4
1746585890606,CSE 197,001,959846,Minnes Kemp; Mor Mia,9990,0,9999,9
1746585891632,CSS 201S,A01,892054,Mignozzetti; Umberto,25,0,30,5
1746585892663,CSS 202S,A01,892056,Mignozzetti; Umberto,25,0,30,5
1746585893688,DSC 197,001,956898,Eldridge; Justin Matthew,9996,0,9999,3
1746585894761,DSC 297,001,958000,Mazumdar; Arya,9998,0,9999,1
1746585894761,DSC 297,002,959862,Wang; Yusu,9998,0,9999,1
1746585895854,EAP 100,A00,905686,Staff,9778,0,9999,221
1746585896882,ECE 45,A01,892618,Staff,0,0,65,65
1746585898936,ECE 111,A01,892719,Staff,6,0,65,59
1746585899963,ECE 197,001,957920,Mercier; Patrick Philip,9991,0,9999,8
1746585900989,ECON 178,A01,907814,Zhu; Ying,26,0,35,9
1746585902017,EDS 115,A00,895312,Staff,35,0,45,10
1746585903042,EDS 117,A01,895337,Staff,23,0,30,7
1746585904073,EDS 125,A00,895341,Jones; Gabrielle Anastasia,36,0,45,9
1746585905105,EDS 128A,A01,895459,Fargason; Sharon Gayle,44,0,45,1
1746585906132,EDS 128B,A01,895543,Pappas; Elizabeth,44,0,45,1
1746585907159,EDS 139,A00,897203,Pappas; Elizabeth,44,0,45,1
1746585907159,EDS 139,B00,897209,Fargason; Sharon Gayle,41,0,45,4
1746585908185,EDS 201,A00,895545,Staff,22,0,45,23
1746585909211,EDS 203,A01,895581,Halter; Christopher P.,22,0,45,23
1746585910241,EDS 204R,A01,895625,Heinzman; Erica M.,39,0,45,6
1746585910241,EDS 204R,B01,895693,Halter; Christopher P.,10,0,45,35
1746585911268,EDS 206R,A00,895694,Fargason; Sharon Gayle,1,0,30,29
1746585911268,EDS 206R,B00,895695,Choi; Bailey Miyeon,16,0,30,14
1746585912294,EDS 250,A00,895697,Hemans; Patricia Ann Benitez,22,0,45,23
1746585913320,EDS 281,A00,895701,Meyerott; Theresa Ann,1,0,15,14
1746585914345,EDS 284,A00,895736,Meyerott; Theresa Ann,1,0,15,14
1746585915375,EDS 286,A00,897210,Fine; Sarah,0,0,15,15
1746585916401,EDS 289C,A01,895770,Daly; Alan J.,1,0,15,14
1746585917425,EDS 290,A00,897211,Hofstetter; Carolyn,0,0,15,15
1746585918451,LIGM 5A,A00,896162,Fischer-Grunski; Eva K,12,0,20,8
1746585919480,LIGM 5B,A00,896260,Fischer-Grunski; Eva K,17,0,20,3
1746585920510,LIGM 5C,A00,896308,Fischer-Grunski; Eva K,18,0,20,2
1746585921537,LIIT 5AS,A00,896313,Carnelos; Chiara,18,0,20,2
1746585922562,LIIT 5BS,A00,896416,Carnelos; Chiara,20,0,20,0
1746585923587,LIIT 5CS,A00,896564,Carnelos; Chiara,20,0,20,0
1746585924617,LISP 5A,A00,896588,Munoz Sanchez; Alicia,2,0,20,18
1746585925647,LISP 5B,A00,896653,Munoz Sanchez; Alicia,7,0,20,13
1746585926675,LISP 5C,A00,896655,Munoz Sanchez; Alicia,0,1,20,20
1746585927704,MAE 197,001,957918,Kleissl; Jan,9996,0,9999,3
1746585927704,MAE 197,002,959806,Boechler; Nicholas Sebastia,9998,0,9999,1
1746585927704,MAE 197,003,959852,Mullin; Jennifer S,9998,0,9999,1
1746585928729,MATH 2,A01,957937,Staff,33,0,35,2
1746585929757,MATH 197,001,957876,Kedlaya; Kiran S.,9993,0,9999,6
1746585930783,MCWP 40,A00,892729,Duru; Nur,10,0,20,10
1746585930783,MCWP 40,B00,893304,Montejo; Carolina,14,0,20,6
1746585931808,MCWP 40R,A00,893757,Redela; Pamela Morgan,0,5,20,20
1746585932836,MCWP 50,A00,893758,Morshed; Michael James,0,0,20,20
1746585932836,MCWP 50,B00,893761,Bartulis; Jason Michael,17,0,20,3
1746585933860,MCWP 50R,A00,893766,Compas; Sean Matthew,0,1,20,20
1746585933860,MCWP 50R,B00,893769,Carter; Jennifer A,0,1,20,20
1746585933860,MCWP 50R,C00,893771,Krone; Jarret,0,3,20,20
1746585933860,MCWP 50R,D00,893772,Miller; Elizabeth Deen,0,0,20,20
1746585933860,MCWP 50R,E00,893775,Carter; Andrea L,0,1,20,20
1746585934887,MMW 11R,A01,892721,Herbst; Matthew,14,0,30,16
1746585934887,MMW 11R,A02,892722,Herbst; Matthew,0,0,0,3
1746585935912,MMW 12R,A01,892724,Herbst; Matthew,0,11,16,16
1746585935912,MMW 12R,A02,892725,Herbst; Matthew,0,10,16,16
1746585936940,MMW 13R,A01,892727,Staff,0,4,16,16
1746585936940,MMW 13R,A02,892728,Staff,0,4,16,16
1746585936940,MMW 13R,A03,958032,Staff,0,4,16,16
1746585936940,MMW 13R,A04,958033,Staff,0,4,16,16
1746585936940,MMW 13R,A05,958034,Staff,0,4,16,16
1746585937965,SIO 295LS,A00,894015,Staff,5,0,25,20
1746585938993,SIO 295S,A00,894020,Staff,5,0,25,20
1746585940019,SIOC 290S,B01,958918,Merrifield; Mark A,14,0,30,16
1746585941052,SIOC 291S,B01,958922,Gabriel; Corey John,14,0,30,16
1746585942082,SOCI 117,A01,895339,Staff,3,0,5,2
1746585943110,WES 237B,A00,894149,Staff,11,0,20,9
1746585945171,AESE 279B,A00,891859,Staff,13,0,35,22
1746585946194,AIP 197,001,891854,Vespa; Emanuel Ignacio,9999,0,9999,0
1746585947219,ANTH 289S,A00,891856,Gagneux; Pascal,12,0,12,0
1746585948243,BENG 196,001,957946,Engler; Adam J.,9996,0,9999,3
1746585949282,BISP 197,001,959851,Wilhelm; James E.,9998,0,9999,1
1746585950307,CAT 124RS,A01,956906,Staff,6,0,25,19
1746585951332,CAT 125RS,A01,922013,Staff,6,0,25,19
1746585952357,CLRE 250,A00,891860,Morris; Sheldon,9995,0,9999,4
1746585954404,CLRE 251R,A00,907817,Mehta; Ravindra L.,9994,0,9999,5
1746585955427,CLRE 252,A00,891864,Cuomo; Raphael Eduardo,9993,0,9999,6
1746585956456,CLRE 253,A00,891867,Vaida; Florin,9994,0,9999,5
1746585956456,CLRE 253,B00,907819,Staff,9999,0,9999,0
1746585957481,CLRE 259,A00,891868,Patel; Hemal,9998,0,9999,1
1746585958506,CLRE 260,A00,891872,Cuomo; Raphael Eduardo,9999,0,9999,0
1746585959532,CLRE 297,001,891888,Cuomo; Raphael Eduardo,9999,0,9999,0
1746585960557,CSE 191,A00,958773,Minnes Kemp; Mor Mia,9995,0,9999,4
1746585961583,CSE 197,001,959846,Minnes Kemp; Mor Mia,9990,0,9999,9
1746585962613,CSS 201S,A01,892054,Mignozzetti; Umberto,25,0,30,5
1746585963637,CSS 202S,A01,892056,Mignozzetti; Umberto,25,0,30,5
1746585964666,DSC 197,001,956898,Eldridge; Justin Matthew,9996,0,9999,3
1746585965697,DSC 297,001,958000,Mazumdar; Arya,9998,0,9999,1
1746585965697,DSC 297,002,959862,Wang; Yusu,9998,0,9999,1
1746585966721,EAP 100,A00,905686,Staff,9778,0,9999,221
1746585967747,ECE 45,A01,892618,Staff,0,0,65,65
1746585969804,ECE 111,A01,892719,Staff,6,0,65,59
1746585970830,ECE 197,001,957920,Mercier; Patrick Philip,9991,0,9999,8
1746585971857,ECON 178,A01,907814,Zhu; Ying,26,0,35,9
1746585972882,EDS 115,A00,895312,Staff,35,0,45,10
1746585973907,EDS 117,A01,895337,Staff,23,0,30,7
1746585974934,EDS 125,A00,895341,Jones; Gabrielle Anastasia,36,0,45,9
1746585975961,EDS 128A,A01,895459,Fargason; Sharon Gayle,44,0,45,1
1746585976988,EDS 128B,A01,895543,Pappas; Elizabeth,44,0,45,1
1746585978028,EDS 139,A00,897203,Pappas; Elizabeth,44,0,45,1
1746585978028,EDS 139,B00,897209,Fargason; Sharon Gayle,41,0,45,4
1746585979054,EDS 201,A00,895545,Staff,22,0,45,23
1746585980081,EDS 203,A01,895581,Halter; Christopher P.,22,0,45,23
1746585981105,EDS 204R,A01,895625,Heinzman; Erica M.,39,0,45,6
1746585981105,EDS 204R,B01,895693,Halter; Christopher P.,10,0,45,35
1746585982131,EDS 206R,A00,895694,Fargason; Sharon Gayle,1,0,30,29
1746585982131,EDS 206R,B00,895695,Choi; Bailey Miyeon,16,0,30,14
1746585983158,EDS 250,A00,895697,Hemans; Patricia Ann Benitez,22,0,45,23
1746585984185,EDS 281,A00,895701,Meyerott; Theresa Ann,1,0,15,14
1746585985212,EDS 284,A00,895736,Meyerott; Theresa Ann,1,0,15,14
1746585986237,EDS 286,A00,897210,Fine; Sarah,0,0,15,15
1746585987265,EDS 289C,A01,895770,Daly; Alan J.,1,0,15,14
1746585988294,EDS 290,A00,897211,Hofstetter; Carolyn,0,0,15,15
1746585989321,LIGM 5A,A00,896162,Fischer-Grunski; Eva K,12,0,20,8
1746585990349,LIGM 5B,A00,896260,Fischer-Grunski; Eva K,17,0,20,3
1746585991373,LIGM 5C,A00,896308,Fischer-Grunski; Eva K,18,0,20,2
1746585992411,LIIT 5AS,A00,896313,Carnelos; Chiara,18,0,20,2
1746585993439,LIIT 5BS,A00,896416,Carnelos; Chiara,20,0,20,0
1746585994467,LIIT 5CS,A00,896564,Carnelos; Chiara,20,0,20,0
1746585995492,LISP 5A,A00,896588,Munoz Sanchez; Alicia,2,0,20,18
1746585996519,LISP 5B,A00,896653,Munoz Sanchez; Alicia,7,0,20,13
1746585997549,LISP 5C,A00,896655,Munoz Sanchez; Alicia,0,1,20,20
1746585998575,MAE 197,001,957918,Kleissl; Jan,9996,0,9999,3
1746585998575,MAE 197,002,959806,Boechler; Nicholas Sebastia,9998,0,9999,1
1746585998575,MAE 197,003,959852,Mullin; Jennifer S,9998,0,9999,1
1746585999599,MATH 2,A01,957937,Staff,33,0,35,2
1746586000625,MATH 197,001,957876,Kedlaya; Kiran S.,9993,0,9999,6
1746586001651,MCWP 40,A00,892729,Duru; Nur,10,0,20,10
1746586001651,MCWP 40,B00,893304,Montejo; Carolina,14,0,20,6
1746586002676,MCWP 40R,A00,893757,Redela; Pamela Morgan,0,5,20,20
1746586003703,MCWP 50,A00,893758,Morshed; Michael James,0,0,20,20
1746586003703,MCWP 50,B00,893761,Bartulis; Jason Michael,17,0,20,3
1746586004733,MCWP 50R,A00,893766,Compas; Sean Matthew,0,1,20,20
1746586004733,MCWP 50R,B00,893769,Carter; Jennifer A,0,1,20,20
1746586004733,MCWP 50R,C00,893771,Krone; Jarret,0,3,20,20
1746586004733,MCWP 50R,D00,893772,Miller; Elizabeth Deen,0,0,20,20
1746586004733,MCWP 50R,E00,893775,Carter; Andrea L,0,1,20,20
1746586005760,MMW 11R,A01,892721,Herbst; Matthew,14,0,30,16
1746586005760,MMW 11R,A02,892722,Herbst; Matthew,0,0,0,3
1746586006785,MMW 12R,A01,892724,Herbst; Matthew,0,11,16,16
1746586006785,MMW 12R,A02,892725,Herbst; Matthew,0,10,16,16
1746586007814,MMW 13R,A01,892727,Staff,0,4,16,16
1746586007814,MMW 13R,A02,892728,Staff,0,4,16,16
1746586007814,MMW 13R,A03,958032,Staff,0,4,16,16
1746586007814,MMW 13R,A04,958033,Staff,0,4,16,16
1746586007814,MMW 13R,A05,958034,Staff,0,4,16,16
1746586008843,SIO 295LS,A00,894015,Staff,5,0,25,20
1746586009871,SIO 295S,A00,894020,Staff,5,0,25,20
1746586010901,SIOC 290S,B01,958918,Merrifield; Mark A,14,0,30,16
1746586011927,SIOC 291S,B01,958922,Gabriel; Corey John,14,0,30,16
1746586012953,SOCI 117,A01,895339,Staff,3,0,5,2
1746586013979,WES 237B,A00,894149,Staff,11,0,20,9
1746586016045,AESE 279B,A00,891859,Staff,13,0,35,22
1746586017072,AIP 197,001,891854,Vespa; Emanuel Ignacio,9999,0,9999,0
1746586018098,ANTH 289S,A00,891856,Gagneux; Pascal,12,0,12,0
1746586019125,BENG 196,001,957946,Engler; Adam J.,9996,0,9999,3
1746586020156,BISP 197,001,959851,Wilhelm; James E.,9998,0,9999,1
1746586021184,CAT 124RS,A01,956906,Staff,6,0,25,19
1746586022210,CAT 125RS,A01,922013,Staff,6,0,25,19
1746586023239,CLRE 250,A00,891860,Morris; Sheldon,9995,0,9999,4
1746586025290,CLRE 251R,A00,907817,Mehta; Ravindra L.,9994,0,9999,5
1746586026316,CLRE 252,A00,891864,Cuomo; Raphael Eduardo,9993,0,9999,6
1746586027342,CLRE 253,A00,891867,Vaida; Florin,9994,0,9999,5
1746586027342,CLRE 253,B00,907819,Staff,9999,0,9999,0
1746586028366,CLRE 259,A00,891868,Patel; Hemal,9998,0,9999,1
1746586029394,CLRE 260,A00,891872,Cuomo; Raphael Eduardo,9999,0,9999,0
1746586030419,CLRE 297,001,891888,Cuomo; Raphael Eduardo,9999,0,9999,0
1746586031446,CSE 191,A00,958773,Minnes Kemp; Mor Mia,9995,0,9999,4
1746586032476,CSE 197,001,959846,Minnes Kemp; Mor Mia,9990,0,9999,9
1746586033506,CSS 201S,A01,892054,Mignozzetti; Umberto,25,0,30,5
1746586034535,CSS 202S,A01,892056,Mignozzetti; Umberto,25,0,30,5
1746586035563,DSC 197,001,956898,Eldridge; Justin Matthew,9996,0,9999,3
1746586036591,DSC 297,001,958000,Mazumdar; Arya,9998,0,9999,1
1746586036591,DSC 297,002,959862,Wang; Yusu,9998,0,9999,1
1746586037616,EAP 100,A00,905686,Staff,9778,0,9999,221
1746586038644,ECE 45,A01,892618,Staff,0,0,65,65
1746586040699,ECE 111,A01,892719,Staff,6,0,65,59
1746586041725,ECE 197,001,957920,Mercier; Patrick Philip,9991,0,9999,8
1746586042752,ECON 178,A01,907814,Zhu; Ying,26,0,35,9
1746586043778,EDS 115,A00,895312,Staff,35,0,45,10
1746586044806,EDS 117,A01,895337,Staff,23,0,30,7
1746586045831,EDS 125,A00,895341,Jones; Gabrielle Anastasia,36,0,45,9
1746586046860,EDS 128A,A01,895459,Fargason; Sharon Gayle,44,0,45,1
1746586047885,EDS 128B,A01,895543,Pappas; Elizabeth,44,0,45,1
1746586048910,EDS 139,A00,897203,Pappas; Elizabeth,44,0,45,1
1746586048910,EDS 139,B00,897209,Fargason; Sharon Gayle,41,0,45,4
1746586049940,EDS 201,A00,895545,Staff,22,0,45,23
1746586050966,EDS 203,A01,895581,Halter; Christopher P.,22,0,45,23
1746586051992,EDS 204R,A01,895625,Heinzman; Erica M.,39,0,45,6
1746586051992,EDS 204R,B01,895693,Halter; Christopher P.,10,0,45,35
1746586053017,EDS 206R,A00,895694,Fargason; Sharon Gayle,1,0,30,29
1746586053017,EDS 206R,B00,895695,Choi; Bailey Miyeon,16,0,30,14
1746586054043,EDS 250,A00,895697,Hemans; Patricia Ann Benitez,22,0,45,23
1746586055074,EDS 281,A00,895701,Meyerott; Theresa Ann,1,0,15,14
1746586056101,EDS 284,A00,895736,Meyerott; Theresa Ann,1,0,15,14
1746586057127,EDS 286,A00,897210,Fine; Sarah,0,0,15,15
1746586058155,EDS 289C,A01,895770,Daly; Alan J.,1,0,15,14
1746586059183,EDS 290,A00,897211,Hofstetter; Carolyn,0,0,15,15
1746586060209,LIGM 5A,A00,896162,Fischer-Grunski; Eva K,12,0,20,8
1746586061235,LIGM 5B,A00,896260,Fischer-Grunski; Eva K,17,0,20,3
1746586062264,LIGM 5C,A00,896308,Fischer-Grunski; Eva K,18,0,20,2
1746586063290,LIIT 5AS,A00,896313,Carnelos; Chiara,18,0,20,2
1746586064315,LIIT 5BS,A00,896416,Carnelos; Chiara,20,0,20,0
1746586065341,LIIT 5CS,A00,896564,Carnelos; Chiara,20,0,20,0
1746586066366,LISP 5A,A00,896588,Munoz Sanchez; Alicia,2,0,20,18
1746586067393,LISP 5B,A00,896653,Munoz Sanchez; Alicia,7,0,20,13
1746586068419,LISP 5C,A00,896655,Munoz Sanchez; Alicia,0,1,20,20
1746586069444,MAE 197,001,957918,Kleissl; Jan,9996,0,9999,3
1746586069444,MAE 197,002,959806,Boechler; Nicholas Sebastia,9998,0,9999,1
1746586069444,MAE 197,003,959852,Mullin; Jennifer S,9998,0,9999,1
1746586070474,MATH 2,A01,957937,Staff,33,0,35,2
1746586071500,MATH 197,001,957876,Kedlaya; Kiran S.,9993,0,9999,6
1746586072526,MCWP 40,A00,892729,Duru; Nur,10,0,20,10
1746586072526,MCWP 40,B00,893304,Montejo; Carolina,14,0,20,6
1746586073557,MCWP 40R,A00,893757,Redela; Pamela Morgan,0,5,20,20
1746586074582,MCWP 50,A00,893758,Morshed; Michael James,0,0,20,20
1746586074582,MCWP 50,B00,893761,Bartulis; Jason Michael,17,0,20,3
1746586075615,MCWP 50R,A00,893766,Compas; Sean Matthew,0,1,20,20
1746586075615,MCWP 50R,B00,893769,Carter; Jennifer A,0,1,20,20
1746586075615,MCWP 50R,C00,893771,Krone; Jarret,0,3,20,20
1746586075615,MCWP 50R,D00,893772,Miller; Elizabeth Deen,0,0,20,20
1746586075615,MCWP 50R,E00,893775,Carter; Andrea L,0,1,20,20
1746586076643,MMW 11R,A01,892721,Herbst; Matthew,14,0,30,16
1746586076643,MMW 11R,A02,892722,Herbst; Matthew,0,0,0,3
1746586077670,MMW 12R,A01,892724,Herbst; Matthew,0,11,16,16
1746586077670,MMW 12R,A02,892725,Herbst; Matthew,0,10,16,16
1746586078695,MMW 13R,A01,892727,Staff,0,4,16,16
1746586078695,MMW 13R,A02,892728,Staff,0,4,16,16
1746586078695,MMW 13R,A03,958032,Staff,0,4,16,16
1746586078695,MMW 13R,A04,958033,Staff,0,4,16,16
1746586078695,MMW 13R,A05,958034,Staff,0,4,16,16
1746586079720,SIO 295LS,A00,894015,Staff,5,0,25,20
1746586080746,SIO 295S,A00,894020,Staff,5,0,25,20
1746586081772,SIOC 290S,B01,958918,Merrifield; Mark A,14,0,30,16
1746586082797,SIOC 291S,B01,958922,Gabriel; Corey John,14,0,30,16
1746586083824,SOCI 117,A01,895339,Staff,3,0,5,2
1746586084855,WES 237B,A00,894149,Staff,11,0,20,9
1746586086926,AESE 279B,A00,891859,Staff,13,0,35,22
1746586087956,AIP 197,001,891854,Vespa; Emanuel Ignacio,9999,0,9999,0
1746586088982,ANTH 289S,A00,891856,Gagneux; Pascal,12,0,12,0
1746586090008,BENG 196,001,957946,Engler; Adam J.,9996,0,9999,3
1746586091033,BISP 197,001,959851,Wilhelm; James E.,9998,0,9999,1
1746586092062,CAT 124RS,A01,956906,Staff,6,0,25,19
1746586093091,CAT 125RS,A01,922013,Staff,6,0,25,19
1746586094116,CLRE 250,A00,891860,Morris; Sheldon,9995,0,9999,4
1746586096195,CLRE 251R,A00,907817,Mehta; Ravindra L.,9994,0,9999,5
1746586097219,CLRE 252,A00,891864,Cuomo; Raphael Eduardo,9993,0,9999,6
1746586098247,CLRE 253,A00,891867,Vaida; Florin,9994,0,9999,5
1746586098247,CLRE 253,B00,907819,Staff,9999,0,9999,0
1746586099273,CLRE 259,A00,891868,Patel; Hemal,9998,0,9999,1
1746586100301,CLRE 260,A00,891872,Cuomo; Raphael Eduardo,9999,0,9999,0
1746586101328,CLRE 297,001,891888,Cuomo; Raphael Eduardo,9999,0,9999,0
1746586102356,CSE 191,A00,958773,Minnes Kemp; Mor Mia,9995,0,9999,4
1746586103385,CSE 197,001,959846,Minnes Kemp; Mor Mia,9990,0,9999,9
1746586104415,CSS 201S,A01,892054,Mignozzetti; Umberto,25,0,30,5
1746586105441,CSS 202S,A01,892056,Mignozzetti; Umberto,25,0,30,5
1746586106466,DSC 197,001,956898,Eldridge; Justin Matthew,9996,0,9999,3
1746586107491,DSC 297,001,958000,Mazumdar; Arya,9998,0,9999,1
1746586107491,DSC 297,002,959862,Wang; Yusu,9998,0,9999,1
1746586108516,EAP 100,A00,905686,Staff,9778,0,9999,221
1746586109547,ECE 45,A01,892618,Staff,0,0,65,65
1746586111606,ECE 111,A01,892719,Staff,6,0,65,59
1746586112632,ECE 197,001,957920,Mercier; Patrick Philip,9991,0,9999,8
1746586113660,ECON 178,A01,907814,Zhu; Ying,26,0,35,9
1746586114685,EDS 115,A00,895312,Staff,35,0,45,10
1746586115713,EDS 117,A01,895337,Staff,23,0,30,7
1746586116738,EDS 125,A00,895341,Jones; Gabrielle Anastasia,36,0,45,9
1746586117765,EDS 128A,A01,895459,Fargason; Sharon Gayle,44,0,45,1
1746586118790,EDS 128B,A01,895543,Pappas; Elizabeth,44,0,45,1
1746586119819,EDS 139,A00,897203,Pappas; Elizabeth,44,0,45,1
1746586119819,EDS 139,B00,897209,Fargason; Sharon Gayle,41,0,45,4
1746586120847,EDS 201,A00,895545,Staff,22,0,45,23
1746586121872,EDS 203,A01,895581,Halter; Christopher P.,22,0,45,23
1746586122900,EDS 204R,A01,895625,Heinzman; Erica M.,39,0,45,6
1746586122900,EDS 204R,B01,895693,Halter; Christopher P.,10,0,45,35
1746586123928,EDS 206R,A00,895694,Fargason; Sharon Gayle,1,0,30,29
1746586123928,EDS 206R,B00,895695,Choi; Bailey Miyeon,16,0,30,14
1746586124953,EDS 250,A00,895697,Hemans; Patricia Ann Benitez,22,0,45,23
1746586125977,EDS 281,A00,895701,Meyerott; Theresa Ann,1,0,15,14
1746586127003,EDS 284,A00,895736,Meyerott; Theresa Ann,1,0,15,14
1746586128027,EDS 286,A00,897210,Fine; Sarah,0,0,15,15
1746586129052,EDS 289C,A01,895770,Daly; Alan J.,1,0,15,14
1746586130081,EDS 290,A00,897211,Hofstetter; Carolyn,0,0,15,15
1746586131107,LIGM 5A,A00,896162,Fischer-Grunski; Eva K,12,0,20,8
1746586132135,LIGM 5B,A00,896260,Fischer-Grunski; Eva K,17,0,20,3
1746586133160,LIGM 5C,A00,896308,Fischer-Grunski; Eva K,18,0,20,2
1746586134186,LIIT 5AS,A00,896313,Carnelos; Chiara,18,0,20,2
1746586135213,LIIT 5BS,A00,896416,Carnelos; Chiara,20,0,20,0
1746586136237,LIIT 5CS,A00,896564,Carnelos; Chiara,20,0,20,0
1746586137267,LISP 5A,A00,896588,Munoz Sanchez; Alicia,2,0,20,18
1746586138293,LISP 5B,A00,896653,Munoz Sanchez; Alicia,7,0,20,13
1746586139318,LISP 5C,A00,896655,Munoz Sanchez; Alicia,0,1,20,20
1746586140345,MAE 197,001,957918,Kleissl; Jan,9996,0,9999,3
1746586140345,MAE 197,002,959806,Boechler; Nicholas Sebastia,9998,0,9999,1
1746586140345,MAE 197,003,959852,Mullin; Jennifer S,9998,0,9999,1
1746586141370,MATH 2,A01,957937,Staff,33,0,35,2
1746586142396,MATH 197,001,957876,Kedlaya; Kiran S.,9993,0,9999,6
1746586143421,MCWP 40,A00,892729,Duru; Nur,10,0,20,10
1746586143421,MCWP 40,B00,893304,Montejo; Carolina,14,0,20,6
1746586144447,MCWP 40R,A00,893757,Redela; Pamela Morgan,0,5,20,20
1746586145471,MCWP 50,A00,893758,Morshed; Michael James,0,0,20,20
1746586145471,MCWP 50,B00,893761,Bartulis; Jason Michael,17,0,20,3
1746586146498,MCWP 50R,A00,893766,Compas; Sean Matthew,0,1,20,20
1746586146498,MCWP 50R,B00,893769,Carter; Jennifer A,0,1,20,20
1746586146498,MCWP 50R,C00,893771,Krone; Jarret,0,3,20,20
1746586146498,MCWP 50R,D00,893772,Miller; Elizabeth Deen,0,0,20,20
1746586146498,MCWP 50R,E00,893775,Carter; Andrea L,0,1,20,20
1746586147525,MMW 11R,A01,892721,Herbst; Matthew,14,0,30,16
1746586147525,MMW 11R,A02,892722,Herbst; Matthew,0,0,0,3
1746586148551,MMW 12R,A01,892724,Herbst; Matthew,0,11,16,16
1746586148551,MMW 12R,A02,892725,Herbst; Matthew,0,10,16,16
1746586149578,MMW 13R,A01,892727,Staff,0,4,16,16
1746586149578,MMW 13R,A02,892728,Staff,0,4,16,16
1746586149578,MMW 13R,A03,958032,Staff,0,4,16,16
1746586149578,MMW 13R,A04,958033,Staff,0,4,16,16
1746586149578,MMW 13R,A05,958034,Staff,0,4,16,16
1746586150604,SIO 295LS,A00,894015,Staff,5,0,25,20
1746586151632,SIO 295S,A00,894020,Staff,5,0,25,20
1746586152661,SIOC 290S,B01,958918,Merrifield; Mark A,14,0,30,16
1746586153689,SIOC 291S,B01,958922,Gabriel; Corey John,14,0,30,16
1746586154717,SOCI 117,A01,895339,Staff,3,0,5,2
1746586155743,WES 237B,A00,894149,Staff,11,0,20,9
1746586157807,AESE 279B,A00,891859,Staff,13,0,35,22
1746586158835,AIP 197,001,891854,Vespa; Emanuel Ignacio,9999,0,9999,0
1746586159864,ANTH 289S,A00,891856,Gagneux; Pascal,12,0,12,0
1746586160892,BENG 196,001,957946,Engler; Adam J.,9996,0,9999,3
1746586161920,BISP 197,001,959851,Wilhelm; James E.,9998,0,9999,1
1746586162947,CAT 124RS,A01,956906,Staff,6,0,25,19
1746586163974,CAT 125RS,A01,922013,Staff,6,0,25,19
1746586165003,CLRE 250,A00,891860,Morris; Sheldon,9995,0,9999,4
1746586167058,CLRE 251R,A00,907817,Mehta; Ravindra L.,9994,0,9999,5
1746586168085,CLRE 252,A00,891864,Cuomo; Raphael Eduardo,9993,0,9999,6
1746586169113,CLRE 253,A00,891867,Vaida; Florin,9994,0,9999,5
1746586169113,CLRE 253,B00,907819,Staff,9999,0,9999,0
1746586170139,CLRE 259,A00,891868,Patel; Hemal,9998,0,9999,1
1746586171163,CLRE 260,A00,891872,Cuomo; Raphael Eduardo,9999,0,9999,0
1746586172193,CLRE 297,001,891888,Cuomo; Raphael Eduardo,9999,0,9999,0
1746586173221,CSE 191,A00,958773,Minnes Kemp; Mor Mia,9995,0,9999,4
1746586174247,CSE 197,001,959846,Minnes Kemp; Mor Mia,9990,0,9999,9
1746586175278,CSS 201S,A01,892054,Mignozzetti; Umberto,25,0,30,5
1746586176302,CSS 202S,A01,892056,Mignozzetti; Umberto,25,0,30,5
1746586177330,DSC 197,001,956898,Eldridge; Justin Matthew,9996,0,9999,3
1746586178358,DSC 297,001,958000,Mazumdar; Arya,9998,0,9999,1
1746586178358,DSC 297,002,959862,Wang; Yusu,9998,0,9999,1
1746586179386,EAP 100,A00,905686,Staff,9778,0,9999,221
1746586180410,ECE 45,A01,892618,Staff,0,0,65,65
1746586182462,ECE 111,A01,892719,Staff,6,0,65,59
1746586183487,ECE 197,001,957920,Mercier; Patrick Philip,9991,0,9999,8
1746586184516,ECON 178,A01,907814,Zhu; Ying,26,0,35,9
1746586185545,EDS 115,A00,895312,Staff,35,0,45,10
1746586186573,EDS 117,A01,895337,Staff,23,0,30,7
1746586187599,EDS 125,A00,895341,Jones; Gabrielle Anastasia,36,0,45,9
1746586188623,EDS 128A,A01,895459,Fargason; Sharon Gayle,44,0,45,1
1746586189653,EDS 128B,A01,895543,Pappas; Elizabeth,44,0,45,1
1746586190678,EDS 139,A00,897203,Pappas; Elizabeth,44,0,45,1
1746586190678,EDS 139,B00,897209,Fargason; Sharon Gayle,41,0,45,4
1746586191704,EDS 201,A00,895545,Staff,22,0,45,23
1746586192729,EDS 203,A01,895581,Halter; Christopher P.,22,0,45,23
1746586193754,EDS 204R,A01,895625,Heinzman; Erica M.,39,0,45,6
1746586193754,EDS 204R,B01,895693,Halter; Christopher P.,10,0,45,35
1746586194778,EDS 206R,A00,895694,Fargason; Sharon Gayle,1,0,30,29
1746586194778,EDS 206R,B00,895695,Choi; Bailey Miyeon,16,0,30,14
1746586195808,EDS 250,A00,895697,Hemans; Patricia Ann Benitez,22,0,45,23
1746586196833,EDS 281,A00,895701,Meyerott; Theresa Ann,1,0,15,14
1746586197860,EDS 284,A00,895736,Meyerott; Theresa Ann,1,0,15,14
1746586198886,EDS 286,A00,897210,Fine; Sarah,0,0,15,15
1746586199913,EDS 289C,A01,895770,Daly; Alan J.,1,0,15,14
1746586200938,EDS 290,A00,897211,Hofstetter; Carolyn,0,0,15,15
1746586201965,LIGM 5A,A00,896162,Fischer-Grunski; Eva K,12,0,20,8
1746586202991,LIGM 5B,A00,896260,Fischer-Grunski; Eva K,17,0,20,3
1746586204016,LIGM 5C,A00,896308,Fischer-Grunski; Eva K,18,0,20,2
1746586205052,LIIT 5AS,A00,896313,Carnelos; Chiara,18,0,20,2
1746586206082,LIIT 5BS,A00,896416,Carnelos; Chiara,20,0,20,0
1746586207106,LIIT 5CS,A00,896564,Carnelos; Chiara,20,0,20,0
1746586208137,LISP 5A,A00,896588,Munoz Sanchez; Alicia,2,0,20,18
1746586209163,LISP 5B,A00,896653,Munoz Sanchez; Alicia,7,0,20,13
1746586210187,LISP 5C,A00,896655,Munoz Sanchez; Alicia,0,1,20,20
1746586211216,MAE 197,001,957918,Kleissl; Jan,9996,0,9999,3
1746586211216,MAE 197,002,959806,Boechler; Nicholas Sebastia,9998,0,9999,1
1746586211216,MAE 197,003,959852,Mullin; Jennifer S,9998,0,9999,1
1746586212244,MATH 2,A01,957937,Staff,33,0,35,2
1746586213268,MATH 197,001,957876,Kedlaya; Kiran S.,9993,0,9999,6
1746586214298,MCWP 40,A00,892729,Duru; Nur,10,0,20,10
1746586214298,MCWP 40,B00,893304,Montejo; Carolina,14,0,20,6
1746586215323,MCWP 40R,A00,893757,Redela; Pamela Morgan,0,5,20,20
1746586216350,MCWP 50,A00,893758,Morshed; Michael James,0,0,20,20
1746586216350,MCWP 50,B00,893761,Bartulis; Jason Michael,17,0,20,3
1746586217380,MCWP 50R,A00,893766,Compas; Sean Matthew,0,1,20,20
1746586217380,MCWP 50R,B00,893769,Carter; Jennifer A,0,1,20,20
1746586217380,MCWP 50R,C00,893771,Krone; Jarret,0,3,20,20
1746586217380,MCWP 50R,D00,893772,Miller; Elizabeth Deen,0,0,20,20
1746586217380,MCWP 50R,E00,893775,Carter; Andrea L,0,1,20,20
1746586218406,MMW 11R,A01,892721,Herbst; Matthew,14,0,30,16
1746586218406,MMW 11R,A02,892722,Herbst; Matthew,0,0,0,3
1746586219432,MMW 12R,A01,892724,Herbst; Matthew,0,11,16,16
1746586219432,MMW 12R,A02,892725,Herbst; Matthew,0,10,16,16
1746586220459,MMW 13R,A01,892727,Staff,0,4,16,16
1746586220459,MMW 13R,A02,892728,Staff,0,4,16,16
1746586220459,MMW 13R,A03,958032,Staff,0,4,16,16
1746586220459,MMW 13R,A04,958033,Staff,0,4,16,16
1746586220459,MMW 13R,A05,958034,Staff,0,4,16,16
1746586221484,SIO 295LS,A00,894015,Staff,5,0,25,20
1746586222510,SIO 295S,A00,894020,Staff,5,0,25,20
1746586223537,SIOC 290S,B01,958918,Merrifield; Mark A,14,0,30,16
1746586224563,SIOC 291S,B01,958922,Gabriel; Corey John,14,0,30,16
1746586225592,SOCI 117,A01,895339,Staff,3,0,5,2
1746586226618,WES 237B,A00,894149,Staff,11,0,20,9
1746586228687,AESE 279B,A00,891859,Staff,13,0,35,22
1746586229712,AIP 197,001,891854,Vespa; Emanuel Ignacio,9999,0,9999,0
1746586230947,ANTH 289S,A00,891856,Gagneux; Pascal,12,0,12,0
1746586231973,BENG 196,001,957946,Engler; Adam J.,9996,0,9999,3
1746586233001,BISP 197,001,959851,Wilhelm; James E.,9998,0,9999,1
1746586234027,CAT 124RS,A01,956906,Staff,6,0,25,19
1746586235052,CAT 125RS,A01,922013,Staff,6,0,25,19
1746586236078,CLRE 250,A00,891860,Morris; Sheldon,9995,0,9999,4
1746586238132,CLRE 251R,A00,907817,Mehta; Ravindra L.,9994,0,9999,5
1746586239159,CLRE 252,A00,891864,Cuomo; Raphael Eduardo,9993,0,9999,6
1746586240185,CLRE 253,A00,891867,Vaida; Florin,9994,0,9999,5
1746586240185,CLRE 253,B00,907819,Staff,9999,0,9999,0
1746586241210,CLRE 259,A00,891868,Patel; Hemal,9998,0,9999,1
1746586242236,CLRE 260,A00,891872,Cuomo; Raphael Eduardo,9999,0,9999,0
1746586243261,CLRE 297,001,891888,Cuomo; Raphael Eduardo,9999,0,9999,0
1746586244285,CSE 191,A00,958773,Minnes Kemp; Mor Mia,9995,0,9999,4
1746586245314,CSE 197,001,959846,Minnes Kemp; Mor Mia,9990,0,9999,9
1746586246340,CSS 201S,A01,892054,Mignozzetti; Umberto,25,0,30,5
1746586247366,CSS 202S,A01,892056,Mignozzetti; Umberto,25,0,30,5
1746586248391,DSC 197,001,956898,Eldridge; Justin Matthew,9996,0,9999,3
1746586249419,DSC 297,001,958000,Mazumdar; Arya,9998,0,9999,1
1746586249419,DSC 297,002,959862,Wang; Yusu,9998,0,9999,1
1746586250444,EAP 100,A00,905686,Staff,9778,0,9999,221
1746586251472,ECE 45,A01,892618,Staff,0,0,65,65
1746586253523,ECE 111,A01,892719,Staff,6,0,65,59
1746586254551,ECE 197,001,957920,Mercier; Patrick Philip,9991,0,9999,8
1746586255577,ECON 178,A01,907814,Zhu; Ying,26,0,35,9
1746586256603,EDS 115,A00,895312,Staff,35,0,45,10
1746586257629,EDS 117,A01,895337,Staff,23,0,30,7
1746586258658,EDS 125,A00,895341,Jones; Gabrielle Anastasia,36,0,45,9
1746586259682,EDS 128A,A01,895459,Fargason; Sharon Gayle,44,0,45,1
1746586260712,EDS 128B,A01,895543,Pappas; Elizabeth,44,0,45,1
1746586261741,EDS 139,A00,897203,Pappas; Elizabeth,44,0,45,1
1746586261741,EDS 139,B00,897209,Fargason; Sharon Gayle,41,0,45,4
1746586262768,EDS 201,A00,895545,Staff,22,0,45,23
1746586263794,EDS 203,A01,895581,Halter; Christopher P.,22,0,45,23
1746586264819,EDS 204R,A01,895625,Heinzman; Erica M.,39,0,45,6
1746586264819,EDS 204R,B01,895693,Halter; Christopher P.,10,0,45,35
1746586265844,EDS 206R,A00,895694,Fargason; Sharon Gayle,1,0,30,29
1746586265844,EDS 206R,B00,895695,Choi; Bailey Miyeon,16,0,30,14
1746586266874,EDS 250,A00,895697,Hemans; Patricia Ann Benitez,22,0,45,23
1746586267900,EDS 281,A00,895701,Meyerott; Theresa Ann,1,0,15,14
1746586268925,EDS 284,A00,895736,Meyerott; Theresa Ann,1,0,15,14
1746586269950,EDS 286,A00,897210,Fine; Sarah,0,0,15,15
1746586270975,EDS 289C,A01,895770,Daly; Alan J.,1,0,15,14
1746586272001,EDS 290,A00,897211,Hofstetter; Carolyn,0,0,15,15
1746586273025,LIGM 5A,A00,896162,Fischer-Grunski; Eva K,12,0,20,8
1746586274053,LIGM 5B,A00,896260,Fischer-Grunski; Eva K,17,0,20,3
1746586275081,LIGM 5C,A00,896308,Fischer-Grunski; Eva K,18,0,20,2
1746586276107,LIIT 5AS,A00,896313,Carnelos; Chiara,18,0,20,2
1746586277134,LIIT 5BS,A00,896416,Carnelos; Chiara,20,0,20,0
1746586278159,LIIT 5CS,A00,896564,Carnelos; Chiara,20,0,20,0
1746586279189,LISP 5A,A00,896588,Munoz Sanchez; Alicia,2,0,20,18
1746586280215,LISP 5B,A00,896653,Munoz Sanchez; Alicia,7,0,20,13
1746586281241,LISP 5C,A00,896655,Munoz Sanchez; Alicia,0,1,20,20
1746586282266,MAE 197,001,957918,Kleissl; Jan,9996,0,9999,3
1746586282266,MAE 197,002,959806,Boechler; Nicholas Sebastia,9998,0,9999,1
1746586282266,MAE 197,003,959852,Mullin; Jennifer S,9998,0,9999,1
1746586283290,MATH 2,A01,957937,Staff,33,0,35,2
1746586284316,MATH 197,001,957876,Kedlaya; Kiran S.,9993,0,9999,6
1746586285340,MCWP 40,A00,892729,Duru; Nur,10,0,20,10
1746586285340,MCWP 40,B00,893304,Montejo; Carolina,14,0,20,6
1746586286365,MCWP 40R,A00,893757,Redela; Pamela Morgan,0,5,20,20
1746586287389,MCWP 50,A00,893758,Morshed; Michael James,0,0,20,20
1746586287389,MCWP 50,B00,893761,Bartulis; Jason Michael,17,0,20,3
1746586288416,MCWP 50R,A00,893766,Compas; Sean Matthew,0,1,20,20
1746586288416,MCWP 50R,B00,893769,Carter; Jennifer A,0,1,20,20
1746586288416,MCWP 50R,C00,893771,Krone; Jarret,0,3,20,20
1746586288416,MCWP 50R,D00,893772,Miller; Elizabeth Deen,0,0,20,20
1746586288416,MCWP 50R,E00,893775,Carter; Andrea L,0,1,20,20
1746586289442,MMW 11R,A01,892721,Herbst; Matthew,14,0,30,16
1746586289442,MMW 11R,A02,892722,Herbst; Matthew,0,0,0,3
1746586290470,MMW 12R,A01,892724,Herbst; Matthew,0,11,16,16
1746586290470,MMW 12R,A02,892725,Herbst; Matthew,0,10,16,16
1746586291495,MMW 13R,A01,892727,Staff,0,4,16,16
1746586291495,MMW 13R,A02,892728,Staff,0,4,16,16
1746586291495,MMW 13R,A03,958032,Staff,0,4,16,16
1746586291495,MMW 13R,A04,958033,Staff,0,4,16,16
1746586291495,MMW 13R,A05,958034,Staff,0,4,16,16
1746586292524,SIO 295LS,A00,894015,Staff,5,0,25,20
1746586293548,SIO 295S,A00,894020,Staff,5,0,25,20
1746586294576,SIOC 290S,B01,958918,Merrifield; Mark A,14,0,30,16
1746586295606,SIOC 291S,B01,958922,Gabriel; Corey John,14,0,30,16
1746586296634,SOCI 117,A01,895339,Staff,3,0,5,2
1746586297657,WES 237B,A00,894149,Staff,11,0,20,9
1746586299724,AESE 279B,A00,891859,Staff,13,0,35,22
1746586300750,AIP 197,001,891854,Vespa; Emanuel Ignacio,9999,0,9999,0
1746586301775,ANTH 289S,A00,891856,Gagneux; Pascal,12,0,12,0
1746586302801,BENG 196,001,957946,Engler; Adam J.,9996,0,9999,3
1746586303830,BISP 197,001,959851,Wilhelm; James E.,9998,0,9999,1
1746586304855,CAT 124RS,A01,956906,Staff,6,0,25,19
1746586305885,CAT 125RS,A01,922013,Staff,6,0,25,19
1746586306910,CLRE 250,A00,891860,Morris; Sheldon,9995,0,9999,4
1746586308964,CLRE 251R,A00,907817,Mehta; Ravindra L.,9994,0,9999,5
1746586309993,CLRE 252,A00,891864,Cuomo; Raphael Eduardo,9993,0,9999,6
1746586311019,CLRE 253,A00,891867,Vaida; Florin,9994,0,9999,5
1746586311019,CLRE 253,B00,907819,Staff,9999,0,9999,0
1746586312045,CLRE 259,A00,891868,Patel; Hemal,9998,0,9999,1
1746586313069,CLRE 260,A00,891872,Cuomo; Raphael Eduardo,9999,0,9999,0
1746586314094,CLRE 297,001,891888,Cuomo; Raphael Eduardo,9999,0,9999,0
1746586315120,CSE 191,A00,958773,Minnes Kemp; Mor Mia,9995,0,9999,4
1746586316145,CSE 197,001,959846,Minnes Kemp; Mor Mia,9990,0,9999,9
1746586317172,CSS 201S,A01,892054,Mignozzetti; Umberto,25,0,30,5
1746586318197,CSS 202S,A01,892056,Mignozzetti; Umberto,25,0,30,5
1746586319223,DSC 197,001,956898,Eldridge; Justin Matthew,9996,0,9999,3
1746586320249,DSC 297,001,958000,Mazumdar; Arya,9998,0,9999,1
1746586320249,DSC 297,002,959862,Wang; Yusu,9998,0,9999,1
1746586321274,EAP 100,A00,905686,Staff,9778,0,9999,221
1746586322299,ECE 45,A01,892618,Staff,0,0,65,65
1746586324349,ECE 111,A01,892719,Staff,6,0,65,59
1746586325387,ECE 197,001,957920,Mercier; Patrick Philip,9991,0,9999,8
1746586326417,ECON 178,A01,907814,Zhu; Ying,26,0,35,9
1746586327447,EDS 115,A00,895312,Staff,35,0,45,10
1746586328471,EDS 117,A01,895337,Staff,23,0,30,7
1746586329495,EDS 125,A00,895341,Jones; Gabrielle Anastasia,36,0,45,9
1746586330527,EDS 128A,A01,895459,Fargason; Sharon Gayle,44,0,45,1
1746586331554,EDS 128B,A01,895543,Pappas; Elizabeth,44,0,45,1
1746586332579,EDS 139,A00,897203,Pappas; Elizabeth,44,0,45,1
1746586332579,EDS 139,B00,897209,Fargason; Sharon Gayle,41,0,45,4
1746586333606,EDS 201,A00,895545,Staff,22,0,45,23
1746586334634,EDS 203,A01,895581,Halter; Christopher P.,22,0,45,23
1746586335658,EDS 204R,A01,895625,Heinzman; Erica M.,39,0,45,6
1746586335658,EDS 204R,B01,895693,Halter; Christopher P.,10,0,45,35
1746586336686,EDS 206R,A00,895694,Fargason; Sharon Gayle,1,0,30,29
1746586336686,EDS 206R,B00,895695,Choi; Bailey Miyeon,16,0,30,14
1746586337711,EDS 250,A00,895697,Hemans; Patricia Ann Benitez,22,0,45,23
1746586338737,EDS 281,A00,895701,Meyerott; Theresa Ann,1,0,15,14
1746586339763,EDS 284,A00,895736,Meyerott; Theresa Ann,1,0,15,14
1746586340788,EDS 286,A00,897210,Fine; Sarah,0,0,15,15
1746586341814,EDS 289C,A01,895770,Daly; Alan J.,1,0,15,14
1746586342838,EDS 290,A00,897211,Hofstetter; Carolyn,0,0,15,15
1746586343868,LIGM 5A,A00,896162,Fischer-Grunski; Eva K,12,0,20,8
1746586344894,LIGM 5B,A00,896260,Fischer-Grunski; Eva K,17,0,20,3
1746586345920,LIGM 5C,A00,896308,Fischer-Grunski; Eva K,18,0,20,2
1746586346949,LIIT 5AS,A00,896313,Carnelos; Chiara,18,0,20,2
1746586347976,LIIT 5BS,A00,896416,Carnelos; Chiara,20,0,20,0
1746586349002,LIIT 5CS,A00,896564,Carnelos; Chiara,20,0,20,0
1746586350026,LISP 5A,A00,896588,Munoz Sanchez; Alicia,2,0,20,18
1746586351051,LISP 5B,A00,896653,Munoz Sanchez; Alicia,7,0,20,13
1746586352077,LISP 5C,A00,896655,Munoz Sanchez; Alicia,0,1,20,20
1746586353101,MAE 197,001,957918,Kleissl; Jan,9996,0,9999,3
1746586353101,MAE 197,002,959806,Boechler; Nicholas Sebastia,9998,0,9999,1
1746586353101,MAE 197,003,959852,Mullin; Jennifer S,9998,0,9999,1
1746586354126,MATH 2,A01,957937,Staff,33,0,35,2
1746586355150,MATH 197,001,957876,Kedlaya; Kiran S.,9993,0,9999,6
1746586356176,MCWP 40,A00,892729,Duru; Nur,10,0,20,10
1746586356176,MCWP 40,B00,893304,Montejo; Carolina,14,0,20,6
1746586357201,MCWP 40R,A00,893757,Redela; Pamela Morgan,0,5,20,20
1746586358226,MCWP 50,A00,893758,Morshed; Michael James,0,0,20,20
1746586358226,MCWP 50,B00,893761,Bartulis; Jason Michael,17,0,20,3
1746586359256,MCWP 50R,A00,893766,Compas; Sean Matthew,0,1,20,20
1746586359256,MCWP 50R,B00,893769,Carter; Jennifer A,0,1,20,20
1746586359256,MCWP 50R,C00,893771,Krone; Jarret,0,3,20,20
1746586359256,MCWP 50R,D00,893772,Miller; Elizabeth Deen,0,0,20,20
1746586359256,MCWP 50R,E00,893775,Carter; Andrea L,0,1,20,20
1746586360281,MMW 11R,A01,892721,Herbst; Matthew,14,0,30,16
1746586360281,MMW 11R,A02,892722,Herbst; Matthew,0,0,0,3
1746586361309,MMW 12R,A01,892724,Herbst; Matthew,0,11,16,16
1746586361309,MMW 12R,A02,892725,Herbst; Matthew,0,10,16,16
1746586362335,MMW 13R,A01,892727,Staff,0,4,16,16
1746586362335,MMW 13R,A02,892728,Staff,0,4,16,16
1746586362335,MMW 13R,A03,958032,Staff,0,4,16,16
1746586362335,MMW 13R,A04,958033,Staff,0,4,16,16
1746586362335,MMW 13R,A05,958034,Staff,0,4,16,16
1746586363359,SIO 295LS,A00,894015,Staff,5,0,25,20
1746586364393,SIO 295S,A00,894020,Staff,5,0,25,20
1746586365418,SIOC 290S,B01,958918,Merrifield; Mark A,14,0,30,16
1746586366442,SIOC 291S,B01,958922,Gabriel; Corey John,14,0,30,16
1746586367473,SOCI 117,A01,895339,Staff,3,0,5,2
1746586368501,WES 237B,A00,894149,Staff,11,0,20,9
1746586370558,AESE 279B,A00,891859,Staff,13,0,35,22
1746586371583,AIP 197,001,891854,Vespa; Emanuel Ignacio,9999,0,9999,0
1746586372609,ANTH 289S,A00,891856,Gagneux; Pascal,12,0,12,0
1746586373641,BENG 196,001,957946,Engler; Adam J.,9996,0,9999,3
1746586374665,BISP 197,001,959851,Wilhelm; James E.,9998,0,9999,1
1746586375694,CAT 124RS,A01,956906,Staff,6,0,25,19
1746586376719,CAT 125RS,A01,922013,Staff,6,0,25,19
1746586377745,CLRE 250,A00,891860,Morris; Sheldon,9995,0,9999,4
1746586379794,CLRE 251R,A00,907817,Mehta; Ravindra L.,9994,0,9999,5
1746586380821,CLRE 252,A00,891864,Cuomo; Raphael Eduardo,9993,0,9999,6
1746586381849,CLRE 253,A00,891867,Vaida; Florin,9994,0,9999,5
1746586381849,CLRE 253,B00,907819,Staff,9999,0,9999,0
1746586382878,CLRE 259,A00,891868,Patel; Hemal,9998,0,9999,1
1746586383904,CLRE 260,A00,891872,Cuomo; Raphael Eduardo,9999,0,9999,0
1746586384930,CLRE 297,001,891888,Cuomo; Raphael Eduardo,9999,0,9999,0
1746586385956,CSE 191,A00,958773,Minnes Kemp; Mor Mia,9995,0,9999,4
1746586386981,CSE 197,001,959846,Minnes Kemp; Mor Mia,9990,0,9999,9
1746586388006,CSS 201S,A01,892054,Mignozzetti; Umberto,25,0,30,5
1746586389035,CSS 202S,A01,892056,Mignozzetti; Umberto,25,0,30,5
1746586390061,DSC 197,001,956898,Eldridge; Justin Matthew,9996,0,9999,3
1746586391085,DSC 297,001,958000,Mazumdar; Arya,9998,0,9999,1
1746586391085,DSC 297,002,959862,Wang; Yusu,9998,0,9999,1
1746586392110,EAP 100,A00,905686,Staff,9778,0,9999,221
1746586393137,ECE 45,A01,892618,Staff,0,0,65,65
1746586395188,ECE 111,A01,892719,Staff,6,0,65,59
1746586396214,ECE 197,001,957920,Mercier; Patrick Philip,9991,0,9999,8
1746586397241,ECON 178,A01,907814,Zhu; Ying,26,0,35,9
1746586398269,EDS 115,A00,895312,Staff,35,0,45,10
1746586399293,EDS 117,A01,895337,Staff,23,0,30,7
1746586400322,EDS 125,A00,895341,Jones; Gabrielle Anastasia,36,0,45,9
1746586401347,EDS 128A,A01,895459,Fargason; Sharon Gayle,44,0,45,1
1746586402372,EDS 128B,A01,895543,Pappas; Elizabeth,44,0,45,1
1746586403400,EDS 139,A00,897203,Pappas; Elizabeth,44,0,45,1
1746586403400,EDS 139,B00,897209,Fargason; Sharon Gayle,41,0,45,4
1746586404427,EDS 201,A00,895545,Staff,22,0,45,23
1746586405451,EDS 203,A01,895581,Halter; Christopher P.,22,0,45,23
1746586406475,EDS 204R,A01,895625,Heinzman; Erica M.,39,0,45,6
1746586406475,EDS 204R,B01,895693,Halter; Christopher P.,10,0,45,35
1746586407500,EDS 206R,A00,895694,Fargason; Sharon Gayle,1,0,30,29
1746586407500,EDS 206R,B00,895695,Choi; Bailey Miyeon,16,0,30,14
1746586408527,EDS 250,A00,895697,Hemans; Patricia Ann Benitez,22,0,45,23
1746586409551,EDS 281,A00,895701,Meyerott; Theresa Ann,1,0,15,14
1746586410575,EDS 284,A00,895736,Meyerott; Theresa Ann,1,0,15,14
1746586411601,EDS 286,A00,897210,Fine; Sarah,0,0,15,15
1746586412626,EDS 289C,A01,895770,Daly; Alan J.,1,0,15,14
1746586413655,EDS 290,A00,897211,Hofstetter; Carolyn,0,0,15,15
1746586414680,LIGM 5A,A00,896162,Fischer-Grunski; Eva K,12,0,20,8
1746586415708,LIGM 5B,A00,896260,Fischer-Grunski; Eva K,17,0,20,3
1746586416746,LIGM 5C,A00,896308,Fischer-Grunski; Eva K,18,0,20,2
1746586417776,LIIT 5AS,A00,896313,Carnelos; Chiara,18,0,20,2
1746586418803,LIIT 5BS,A00,896416,Carnelos; Chiara,20,0,20,0
1746586419850,LIIT 5CS,A00,896564,Carnelos; Chiara,20,0,20,0
1746586420878,LISP 5A,A00,896588,Munoz Sanchez; Alicia,2,0,20,18
1746586421907,LISP 5B,A00,896653,Munoz Sanchez; Alicia,7,0,20,13
1746586422933,LISP 5C,A00,896655,Munoz Sanchez; Alicia,0,1,20,20
1746586423957,MAE 197,001,957918,Kleissl; Jan,9996,0,9999,3
1746586423957,MAE 197,002,959806,Boechler; Nicholas Sebastia,9998,0,9999,1
1746586423957,MAE 197,003,959852,Mullin; Jennifer S,9998,0,9999,1
1746586424982,MATH 2,A01,957937,Staff,33,0,35,2
1746586426007,MATH 197,001,957876,Kedlaya; Kiran S.,9993,0,9999,6
1746586427032,MCWP 40,A00,892729,Duru; Nur,10,0,20,10
1746586427032,MCWP 40,B00,893304,Montejo; Carolina,14,0,20,6
1746586428057,MCWP 40R,A00,893757,Redela; Pamela Morgan,0,5,20,20
1746586429082,MCWP 50,A00,893758,Morshed; Michael James,0,0,20,20
1746586429082,MCWP 50,B00,893761,Bartulis; Jason Michael,17,0,20,3
1746586430111,MCWP 50R,A00,893766,Compas; Sean Matthew,0,1,20,20
1746586430111,MCWP 50R,B00,893769,Carter; Jennifer A,0,1,20,20
1746586430111,MCWP 50R,C00,893771,Krone; Jarret,0,3,20,20
1746586430111,MCWP 50R,D00,893772,Miller; Elizabeth Deen,0,0,20,20
1746586430111,MCWP 50R,E00,893775,Carter; Andrea L,0,1,20,20
1746586431139,MMW 11R,A01,892721,Herbst; Matthew,14,0,30,16
1746586431139,MMW 11R,A02,892722,Herbst; Matthew,0,0,0,3
1746586432164,MMW 12R,A01,892724,Herbst; Matthew,0,11,16,16
1746586432164,MMW 12R,A02,892725,Herbst; Matthew,0,10,16,16
1746586433191,MMW 13R,A01,892727,Staff,0,4,16,16
1746586433191,MMW 13R,A02,892728,Staff,0,4,16,16
1746586433191,MMW 13R,A03,958032,Staff,0,4,16,16
1746586433191,MMW 13R,A04,958033,Staff,0,4,16,16
1746586433191,MMW 13R,A05,958034,Staff,0,4,16,16
1746586434216,SIO 295LS,A00,894015,Staff,5,0,25,20
1746586435241,SIO 295S,A00,894020,Staff,5,0,25,20
1746586436264,SIOC 290S,B01,958918,Merrifield; Mark A,14,0,30,16
1746586437290,SIOC 291S,B01,958922,Gabriel; Corey John,14,0,30,16
1746586438314,SOCI 117,A01,895339,Staff,3,0,5,2
1746586439341,WES 237B,A00,894149,Staff,11,0,20,9
1746586441397,AESE 279B,A00,891859,Staff,13,0,35,22
1746586442433,AIP 197,001,891854,Vespa; Emanuel Ignacio,9999,0,9999,0
1746586443459,ANTH 289S,A00,891856,Gagneux; Pascal,12,0,12,0
1746586444482,BENG 196,001,957946,Engler; Adam J.,9996,0,9999,3
1746586445511,BISP 197,001,959851,Wilhelm; James E.,9998,0,9999,1
1746586446540,CAT 124RS,A01,956906,Staff,6,0,25,19
1746586447566,CAT 125RS,A01,922013,Staff,6,0,25,19
1746586448592,CLRE 250,A00,891860,Morris; Sheldon,9995,0,9999,4
1746586450644,CLRE 251R,A00,907817,Mehta; Ravindra L.,9994,0,9999,5
1746586451671,CLRE 252,A00,891864,Cuomo; Raphael Eduardo,9993,0,9999,6
1746586452697,CLRE 253,A00,891867,Vaida; Florin,9994,0,9999,5
1746586452697,CLRE 253,B00,907819,Staff,9999,0,9999,0
1746586453723,CLRE 259,A00,891868,Patel; Hemal,9998,0,9999,1
1746586454747,CLRE 260,A00,891872,Cuomo; Raphael Eduardo,9999,0,9999,0
1746586455775,CLRE 297,001,891888,Cuomo; Raphael Eduardo,9999,0,9999,0
1746586456801,CSE 191,A00,958773,Minnes Kemp; Mor Mia,9995,0,9999,4
1746586457828,CSE 197,001,959846,Minnes Kemp; Mor Mia,9990,0,9999,9
1746586458856,CSS 201S,A01,892054,Mignozzetti; Umberto,25,0,30,5
1746586459890,CSS 202S,A01,892056,Mignozzetti; Umberto,25,0,30,5
1746586460913,DSC 197,001,956898,Eldridge; Justin Matthew,9996,0,9999,3
1746586461941,DSC 297,001,958000,Mazumdar; Arya,9998,0,9999,1
1746586461941,DSC 297,002,959862,Wang; Yusu,9998,0,9999,1
1746586462968,EAP 100,A00,905686,Staff,9778,0,9999,221
1746586463998,ECE 45,A01,892618,Staff,0,0,65,65
1746586466050,ECE 111,A01,892719,Staff,6,0,65,59
1746586467079,ECE 197,001,957920,Mercier; Patrick Philip,9991,0,9999,8
1746586468104,ECON 178,A01,907814,Zhu; Ying,26,0,35,9
1746586469130,EDS 115,A00,895312,Staff,35,0,45,10
1746586470162,EDS 117,A01,895337,Staff,23,0,30,7
1746586471188,EDS 125,A00,895341,Jones; Gabrielle Anastasia,36,0,45,9
1746586472214,EDS 128A,A01,895459,Fargason; Sharon Gayle,44,0,45,1
1746586473240,EDS 128B,A01,895543,Pappas; Elizabeth,44,0,45,1
1746586474265,EDS 139,A00,897203,Pappas; Elizabeth,44,0,45,1
1746586474265,EDS 139,B00,897209,Fargason; Sharon Gayle,41,0,45,4
1746586475289,EDS 201,A00,895545,Staff,22,0,45,23
1746586476318,EDS 203,A01,895581,Halter; Christopher P.,22,0,45,23
1746586477346,EDS 204R,A01,895625,Heinzman; Erica M.,39,0,45,6
1746586477346,EDS 204R,B01,895693,Halter; Christopher P.,10,0,45,35
1746586478373,EDS 206R,A00,895694,Fargason; Sharon Gayle,1,0,30,29
1746586478373,EDS 206R,B00,895695,Choi; Bailey Miyeon,16,0,30,14
1746586479401,EDS 250,A00,895697,Hemans; Patricia Ann Benitez,22,0,45,23
1746586480426,EDS 281,A00,895701,Meyerott; Theresa Ann,1,0,15,14
1746586481450,EDS 284,A00,895736,Meyerott; Theresa Ann,1,0,15,14
1746586482478,EDS 286,A00,897210,Fine; Sarah,0,0,15,15
1746586483504,EDS 289C,A01,895770,Daly; Alan J.,1,0,15,14
1746586484531,EDS 290,A00,897211,Hofstetter; Carolyn,0,0,15,15
1746586485560,LIGM 5A,A00,896162,Fischer-Grunski; Eva K,12,0,20,8
1746586486587,LIGM 5B,A00,896260,Fischer-Grunski; Eva K,17,0,20,3
1746586487613,LIGM 5C,A00,896308,Fischer-Grunski; Eva K,18,0,20,2
1746586488640,LIIT 5AS,A00,896313,Carnelos; Chiara,18,0,20,2
1746586489669,LIIT 5BS,A00,896416,Carnelos; Chiara,20,0,20,0
1746586490694,LIIT 5CS,A00,896564,Carnelos; Chiara,20,0,20,0
1746586491722,LISP 5A,A00,896588,Munoz Sanchez; Alicia,2,0,20,18
1746586492748,LISP 5B,A00,896653,Munoz Sanchez; Alicia,7,0,20,13
1746586493777,LISP 5C,A00,896655,Munoz Sanchez; Alicia,0,1,20,20
1746586494802,MAE 197,001,957918,Kleissl; Jan,9996,0,9999,3
1746586494802,MAE 197,002,959806,Boechler; Nicholas Sebastia,9998,0,9999,1
1746586494802,MAE 197,003,959852,Mullin; Jennifer S,9998,0,9999,1
1746586495829,MATH 2,A01,957937,Staff,33,0,35,2
1746586496854,MATH 197,001,957876,Kedlaya; Kiran S.,9993,0,9999,6
1746586497880,MCWP 40,A00,892729,Duru; Nur,10,0,20,10
1746586497880,MCWP 40,B00,893304,Montejo; Carolina,14,0,20,6
1746586498906,MCWP 40R,A00,893757,Redela; Pamela Morgan,0,5,20,20
1746586499932,MCWP 50,A00,893758,Morshed; Michael James,0,0,20,20
1746586499932,MCWP 50,B00,893761,Bartulis; Jason Michael,17,0,20,3
1746586500958,MCWP 50R,A00,893766,Compas; Sean Matthew,0,1,20,20
1746586500958,MCWP 50R,B00,893769,Carter; Jennifer A,0,1,20,20
1746586500958,MCWP 50R,C00,893771,Krone; Jarret,0,3,20,20
1746586500958,MCWP 50R,D00,893772,Miller; Elizabeth Deen,0,0,20,20
1746586500958,MCWP 50R,E00,893775,Carter; Andrea L,0,1,20,20
1746586501996,MMW 11R,A01,892721,Herbst; Matthew,14,0,30,16
1746586501996,MMW 11R,A02,892722,Herbst; Matthew,0,0,0,3
1746586503027,MMW 12R,A01,892724,Herbst; Matthew,0,11,16,16
1746586503027,MMW 12R,A02,892725,Herbst; Matthew,0,10,16,16
1746586504057,MMW 13R,A01,892727,Staff,0,4,16,16
1746586504057,MMW 13R,A02,892728,Staff,0,4,16,16
1746586504057,MMW 13R,A03,958032,Staff,0,4,16,16
1746586504057,MMW 13R,A04,958033,Staff,0,4,16,16
1746586504057,MMW 13R,A05,958034,Staff,0,4,16,16
1746586505084,SIO 295LS,A00,894015,Staff,5,0,25,20
1746586506110,SIO 295S,A00,894020,Staff,5,0,25,20
1746586507137,SIOC 290S,B01,958918,Merrifield; Mark A,14,0,30,16
1746586508167,SIOC 291S,B01,958922,Gabriel; Corey John,14,0,30,16
1746586509206,SOCI 117,A01,895339,Staff,3,0,5,2
1746586510233,WES 237B,A00,894149,Staff,11,0,20,9
1746586512288,AESE 279B,A00,891859,Staff,13,0,35,22
1746586513313,AIP 197,001,891854,Vespa; Emanuel Ignacio,9999,0,9999,0
1746586514339,ANTH 289S,A00,891856,Gagneux; Pascal,12,0,12,0
1746586515363,BENG 196,001,957946,Engler; Adam J.,9996,0,9999,3
1746586516388,BISP 197,001,959851,Wilhelm; James E.,9998,0,9999,1
1746586517413,CAT 124RS,A01,956906,Staff,6,0,25,19
1746586518439,CAT 125RS,A01,922013,Staff,6,0,25,19
1746586519467,CLRE 250,A00,891860,Morris; Sheldon,9995,0,9999,4
1746586521520,CLRE 251R,A00,907817,Mehta; Ravindra L.,9994,0,9999,5
1746586522545,CLRE 252,A00,891864,Cuomo; Raphael Eduardo,9993,0,9999,6
1746586523571,CLRE 253,A00,891867,Vaida; Florin,9994,0,9999,5
1746586523571,CLRE 253,B00,907819,Staff,9999,0,9999,0
1746586524600,CLRE 259,A00,891868,Patel; Hemal,9998,0,9999,1
1746586525628,CLRE 260,A00,891872,Cuomo; Raphael Eduardo,9999,0,9999,0
1746586526659,CLRE 297,001,891888,Cuomo; Raphael Eduardo,9999,0,9999,0
1746586527684,CSE 191,A00,958773,Minnes Kemp; Mor Mia,9995,0,9999,4
1746586528710,CSE 197,001,959846,Minnes Kemp; Mor Mia,9990,0,9999,9
1746586529740,CSS 201S,A01,892054,Mignozzetti; Umberto,25,0,30,5
1746586530767,CSS 202S,A01,892056,Mignozzetti; Umberto,25,0,30,5
1746586531791,DSC 197,001,956898,Eldridge; Justin Matthew,9996,0,9999,3
1746586532816,DSC 297,001,958000,Mazumdar; Arya,9998,0,9999,1
1746586532816,DSC 297,002,959862,Wang; Yusu,9998,0,9999,1
1746586533843,EAP 100,A00,905686,Staff,9778,0,9999,221
1746586534867,ECE 45,A01,892618,Staff,0,0,65,65
1746586536921,ECE 111,A01,892719,Staff,6,0,65,59
1746586537948,ECE 197,001,957920,Mercier; Patrick Philip,9991,0,9999,8
1746586538974,ECON 178,A01,907814,Zhu; Ying,26,0,35,9
1746586540000,EDS 115,A00,895312,Staff,35,0,45,10
1746586541026,EDS 117,A01,895337,Staff,23,0,30,7
1746586542053,EDS 125,A00,895341,Jones; Gabrielle Anastasia,36,0,45,9
1746586543083,EDS 128A,A01,895459,Fargason; Sharon Gayle,44,0,45,1
1746586544111,EDS 128B,A01,895543,Pappas; Elizabeth,44,0,45,1
1746586545140,EDS 139,A00,897203,Pappas; Elizabeth,44,0,45,1
1746586545140,EDS 139,B00,897209,Fargason; Sharon Gayle,41,0,45,4
1746586546167,EDS 201,A00,895545,Staff,22,0,45,23
1746586547195,EDS 203,A01,895581,Halter; Christopher P.,22,0,45,23
1746586548220,EDS 204R,A01,895625,Heinzman; Erica M.,39,0,45,6
1746586548220,EDS 204R,B01,895693,Halter; Christopher P.,10,0,45,35
1746586549246,EDS 206R,A00,895694,Fargason; Sharon Gayle,1,0,30,29
1746586549246,EDS 206R,B00,895695,Choi; Bailey Miyeon,16,0,30,14
1746586550271,EDS 250,A00,895697,Hemans; Patricia Ann Benitez,22,0,45,23
1746586551297,EDS 281,A00,895701,Meyerott; Theresa Ann,1,0,15,14
1746586552324,EDS 284,A00,895736,Meyerott; Theresa Ann,1,0,15,14
1746586553349,EDS 286,A00,897210,Fine; Sarah,0,0,15,15
1746586554374,EDS 289C,A01,895770,Daly; Alan J.,1,0,15,14
1746586555398,EDS 290,A00,897211,Hofstetter; Carolyn,0,0,15,15
1746586556424,LIGM 5A,A00,896162,Fischer-Grunski; Eva K,12,0,20,8
1746586557454,LIGM 5B,A00,896260,Fischer-Grunski; Eva K,17,0,20,3
1746586558479,LIGM 5C,A00,896308,Fischer-Grunski; Eva K,18,0,20,2
1746586559507,LIIT 5AS,A00,896313,Carnelos; Chiara,18,0,20,2
1746586560532,LIIT 5BS,A00,896416,Carnelos; Chiara,20,0,20,0
1746586561561,LIIT 5CS,A00,896564,Carnelos; Chiara,20,0,20,0
1746586562590,LISP 5A,A00,896588,Munoz Sanchez; Alicia,2,0,20,18
1746586563617,LISP 5B,A00,896653,Munoz Sanchez; Alicia,7,0,20,13
1746586564642,LISP 5C,A00,896655,Munoz Sanchez; Alicia,0,1,20,20
1746586565670,MAE 197,001,957918,Kleissl; Jan,9996,0,9999,3
1746586565670,MAE 197,002,959806,Boechler; Nicholas Sebastia,9998,0,9999,1
1746586565670,MAE 197,003,959852,Mullin; Jennifer S,9998,0,9999,1
1746586566696,MATH 2,A01,957937,Staff,33,0,35,2
1746586567722,MATH 197,001,957876,Kedlaya; Kiran S.,9993,0,9999,6
1746586568750,MCWP 40,A00,892729,Duru; Nur,10,0,20,10
1746586568750,MCWP 40,B00,893304,Montejo; Carolina,14,0,20,6
1746586569775,MCWP 40R,A00,893757,Redela; Pamela Morgan,0,5,20,20
1746586570803,MCWP 50,A00,893758,Morshed; Michael James,0,0,20,20
1746586570803,MCWP 50,B00,893761,Bartulis; Jason Michael,17,0,20,3
1746586571828,MCWP 50R,A00,893766,Compas; Sean Matthew,0,1,20,20
1746586571828,MCWP 50R,B00,893769,Carter; Jennifer A,0,1,20,20
1746586571828,MCWP 50R,C00,893771,Krone; Jarret,0,3,20,20
1746586571828,MCWP 50R,D00,893772,Miller; Elizabeth Deen,0,0,20,20
1746586571828,MCWP 50R,E00,893775,Carter; Andrea L,0,1,20,20
1746586572856,MMW 11R,A01,892721,Herbst; Matthew,14,0,30,16
1746586572856,MMW 11R,A02,892722,Herbst; Matthew,0,0,0,3
1746586573881,MMW 12R,A01,892724,Herbst; Matthew,0,11,16,16
1746586573881,MMW 12R,A02,892725,Herbst; Matthew,0,10,16,16
1746586574908,MMW 13R,A01,892727,Staff,0,4,16,16
1746586574908,MMW 13R,A02,892728,Staff,0,4,16,16
1746586574908,MMW 13R,A03,958032,Staff,0,4,16,16
1746586574908,MMW 13R,A04,958033,Staff,0,4,16,16
1746586574908,MMW 13R,A05,958034,Staff,0,4,16,16
1746586575937,SIO 295LS,A00,894015,Staff,5,0,25,20
1746586576963,SIO 295S,A00,894020,Staff,5,0,25,20
1746586577987,SIOC 290S,B01,958918,Merrifield; Mark A,14,0,30,16
1746586579018,SIOC 291S,B01,958922,Gabriel; Corey John,14,0,30,16
1746586580043,SOCI 117,A01,895339,Staff,3,0,5,2
1746586581069,WES 237B,A00,894149,Staff,11,0,20,9
1746586583143,AESE 279B,A00,891859,Staff,13,0,35,22
1746586584171,AIP 197,001,891854,Vespa; Emanuel Ignacio,9999,0,9999,0
1746586585199,ANTH 289S,A00,891856,Gagneux; Pascal,12,0,12,0
1746586586224,BENG 196,001,957946,Engler; Adam J.,9996,0,9999,3
1746586587250,BISP 197,001,959851,Wilhelm; James E.,9998,0,9999,1
1746586588274,CAT 124RS,A01,956906,Staff,6,0,25,19
1746586589300,CAT 125RS,A01,922013,Staff,6,0,25,19
1746586590325,CLRE 250,A00,891860,Morris; Sheldon,9995,0,9999,4
1746586592375,CLRE 251R,A00,907817,Mehta; Ravindra L.,9994,0,9999,5
1746586593400,CLRE 252,A00,891864,Cuomo; Raphael Eduardo,9993,0,9999,6
1746586594427,CLRE 253,A00,891867,Vaida; Florin,9994,0,9999,5
1746586594427,CLRE 253,B00,907819,Staff,9999,0,9999,0
1746586595451,CLRE 259,A00,891868,Patel; Hemal,9998,0,9999,1
1746586596480,CLRE 260,A00,891872,Cuomo; Raphael Eduardo,9999,0,9999,0
1746586597507,CLRE 297,001,891888,Cuomo; Raphael Eduardo,9999,0,9999,0
1746586598532,CSE 191,A00,958773,Minnes Kemp; Mor Mia,9995,0,9999,4
1746586599558,CSE 197,001,959846,Minnes Kemp; Mor Mia,9990,0,9999,9
1746586600584,CSS 201S,A01,892054,Mignozzetti; Umberto,25,0,30,5
1746586601609,CSS 202S,A01,892056,Mignozzetti; Umberto,25,0,30,5
1746586602638,DSC 197,001,956898,Eldridge; Justin Matthew,9996,0,9999,3
1746586603662,DSC 297,001,958000,Mazumdar; Arya,9998,0,9999,1
1746586603662,DSC 297,002,959862,Wang; Yusu,9998,0,9999,1
1746586604688,EAP 100,A00,905686,Staff,9778,0,9999,221
1746586605718,ECE 45,A01,892618,Staff,0,0,65,65
1746586607770,ECE 111,A01,892719,Staff,6,0,65,59
1746586608798,ECE 197,001,957920,Mercier; Patrick Philip,9991,0,9999,8
1746586609823,ECON 178,A01,907814,Zhu; Ying,26,0,35,9
1746586610849,EDS 115,A00,895312,Staff,35,0,45,10
1746586611876,EDS 117,A01,895337,Staff,23,0,30,7
1746586612901,EDS 125,A00,895341,Jones; Gabrielle Anastasia,36,0,45,9
1746586613927,EDS 128A,A01,895459,Fargason; Sharon Gayle,44,0,45,1
1746586614953,EDS 128B,A01,895543,Pappas; Elizabeth,44,0,45,1
1746586615984,EDS 139,A00,897203,Pappas; Elizabeth,44,0,45,1
1746586615984,EDS 139,B00,897209,Fargason; Sharon Gayle,41,0,45,4
1746586617013,EDS 201,A00,895545,Staff,22,0,45,23
1746586618038,EDS 203,A01,895581,Halter; Christopher P.,22,0,45,23
1746586619063,EDS 204R,A01,895625,Heinzman; Erica M.,39,0,45,6
1746586619063,EDS 204R,B01,895693,Halter; Christopher P.,10,0,45,35
1746586620090,EDS 206R,A00,895694,Fargason; Sharon Gayle,1,0,30,29
1746586620090,EDS 206R,B00,895695,Choi; Bailey Miyeon,16,0,30,14
1746586621118,EDS 250,A00,895697,Hemans; Patricia Ann Benitez,22,0,45,23
1746586622143,EDS 281,A00,895701,Meyerott; Theresa Ann,1,0,15,14
1746586623167,EDS 284,A00,895736,Meyerott; Theresa Ann,1,0,15,14
1746586624230,EDS 286,A00,897210,Fine; Sarah,0,0,15,15
1746586625256,EDS 289C,A01,895770,Daly; Alan J.,1,0,15,14
1746586626280,EDS 290,A00,897211,Hofstetter; Carolyn,0,0,15,15
1746586627309,LIGM 5A,A00,896162,Fischer-Grunski; Eva K,12,0,20,8
1746586628338,LIGM 5B,A00,896260,Fischer-Grunski; Eva K,17,0,20,3
1746586629363,LIGM 5C,A00,896308,Fischer-Grunski; Eva K,18,0,20,2
1746586630389,LIIT 5AS,A00,896313,Carnelos; Chiara,18,0,20,2
1746586631417,LIIT 5BS,A00,896416,Carnelos; Chiara,20,0,20,0
1746586632442,LIIT 5CS,A00,896564,Carnelos; Chiara,20,0,20,0
1746586633467,LISP 5A,A00,896588,Munoz Sanchez; Alicia,2,0,20,18
1746586634496,LISP 5B,A00,896653,Munoz Sanchez; Alicia,7,0,20,13
1746586635522,LISP 5C,A00,896655,Munoz Sanchez; Alicia,0,1,20,20
1746586636550,MAE 197,001,957918,Kleissl; Jan,9996,0,9999,3
1746586636550,MAE 197,002,959806,Boechler; Nicholas Sebastia,9998,0,9999,1
1746586636550,MAE 197,003,959852,Mullin; Jennifer S,9998,0,9999,1
1746586637576,MATH 2,A01,957937,Staff,33,0,35,2
1746586638600,MATH 197,001,957876,Kedlaya; Kiran S.,9993,0,9999,6
1746586639627,MCWP 40,A00,892729,Duru; Nur,10,0,20,10
1746586639627,MCWP 40,B00,893304,Montejo; Carolina,14,0,20,6
1746586640651,MCWP 40R,A00,893757,Redela; Pamela Morgan,0,5,20,20
1746586641679,MCWP 50,A00,893758,Morshed; Michael James,0,0,20,20
1746586641679,MCWP 50,B00,893761,Bartulis; Jason Michael,17,0,20,3
1746586642705,MCWP 50R,A00,893766,Compas; Sean Matthew,0,1,20,20
1746586642705,MCWP 50R,B00,893769,Carter; Jennifer A,0,1,20,20
1746586642705,MCWP 50R,C00,893771,Krone; Jarret,0,3,20,20
1746586642705,MCWP 50R,D00,893772,Miller; Elizabeth Deen,0,0,20,20
1746586642705,MCWP 50R,E00,893775,Carter; Andrea L,0,1,20,20
1746586643730,MMW 11R,A01,892721,Herbst; Matthew,14,0,30,16
1746586643730,MMW 11R,A02,892722,Herbst; Matthew,0,0,0,3
1746586644755,MMW 12R,A01,892724,Herbst; Matthew,0,11,16,16
1746586644755,MMW 12R,A02,892725,Herbst; Matthew,0,10,16,16
1746586645782,MMW 13R,A01,892727,Staff,0,4,16,16
1746586645782,MMW 13R,A02,892728,Staff,0,4,16,16
1746586645782,MMW 13R,A03,958032,Staff,0,4,16,16
1746586645782,MMW 13R,A04,958033,Staff,0,4,16,16
1746586645782,MMW 13R,A05,958034,Staff,0,4,16,16
1746586646811,SIO 295LS,A00,894015,Staff,5,0,25,20
1746586647839,SIO 295S,A00,894020,Staff,5,0,25,20
1746586648865,SIOC 290S,B01,958918,Merrifield; Mark A,14,0,30,16
1746586649890,SIOC 291S,B01,958922,Gabriel; Corey John,14,0,30,16
1746586650914,SOCI 117,A01,895339,Staff,3,0,5,2
1746586651939,WES 237B,A00,894149,Staff,11,0,20,9
1746586654003,AESE 279B,A00,891859,Staff,13,0,35,22
1746586655029,AIP 197,001,891854,Vespa; Emanuel Ignacio,9999,0,9999,0
1746586656055,ANTH 289S,A00,891856,Gagneux; Pascal,12,0,12,0
1746586657083,BENG 196,001,957946,Engler; Adam J.,9996,0,9999,3
1746586658109,BISP 197,001,959851,Wilhelm; James E.,9998,0,9999,1
1746586659135,CAT 124RS,A01,956906,Staff,6,0,25,19
1746586660161,CAT 125RS,A01,922013,Staff,6,0,25,19
1746586661186,CLRE 250,A00,891860,Morris; Sheldon,9995,0,9999,4
1746586663239,CLRE 251R,A00,907817,Mehta; Ravindra L.,9994,0,9999,5
1746586664264,CLRE 252,A00,891864,Cuomo; Raphael Eduardo,9993,0,9999,6
1746586665289,CLRE 253,A00,891867,Vaida; Florin,9994,0,9999,5
1746586665289,CLRE 253,B00,907819,Staff,9999,0,9999,0
1746586666313,CLRE 259,A00,891868,Patel; Hemal,9998,0,9999,1
1746586667340,CLRE 260,A00,891872,Cuomo; Raphael Eduardo,9999,0,9999,0
1746586668364,CLRE 297,001,891888,Cuomo; Raphael Eduardo,9999,0,9999,0
1746586669390,CSE 191,A00,958773,Minnes Kemp; Mor Mia,9995,0,9999,4
1746586670416,CSE 197,001,959846,Minnes Kemp; Mor Mia,9990,0,9999,9
1746586671447,CSS 201S,A01,892054,Mignozzetti; Umberto,25,0,30,5
1746586672475,CSS 202S,A01,892056,Mignozzetti; Umberto,25,0,30,5
1746586673505,DSC 197,001,956898,Eldridge; Justin Matthew,9996,0,9999,3
1746586674533,DSC 297,001,958000,Mazumdar; Arya,9998,0,9999,1
1746586674533,DSC 297,002,959862,Wang; Yusu,9998,0,9999,1
1746586675560,EAP 100,A00,905686,Staff,9778,0,9999,221
1746586676593,ECE 45,A01,892618,Staff,0,0,65,65
1746586678645,ECE 111,A01,892719,Staff,6,0,65,59
1746586679670,ECE 197,001,957920,Mercier; Patrick Philip,9991,0,9999,8
1746586680701,ECON 178,A01,907814,Zhu; Ying,26,0,35,9
1746586681726,EDS 115,A00,895312,Staff,35,0,45,10
1746586682753,EDS 117,A01,895337,Staff,23,0,30,7
1746586683780,EDS 125,A00,895341,Jones; Gabrielle Anastasia,36,0,45,9
1746586684807,EDS 128A,A01,895459,Fargason; Sharon Gayle,44,0,45,1
1746586685836,EDS 128B,A01,895543,Pappas; Elizabeth,44,0,45,1
1746586686863,EDS 139,A00,897203,Pappas; Elizabeth,44,0,45,1
1746586686863,EDS 139,B00,897209,Fargason; Sharon Gayle,41,0,45,4
1746586687890,EDS 201,A00,895545,Staff,22,0,45,23
1746586688915,EDS 203,A01,895581,Halter; Christopher P.,22,0,45,23
1746586689943,EDS 204R,A01,895625,Heinzman; Erica M.,39,0,45,6
1746586689943,EDS 204R,B01,895693,Halter; Christopher P.,10,0,45,35
1746586690973,EDS 206R,A00,895694,Fargason; Sharon Gayle,1,0,30,29
1746586690973,EDS 206R,B00,895695,Choi; Bailey Miyeon,16,0,30,14
1746586692001,EDS 250,A00,895697,Hemans; Patricia Ann Benitez,22,0,45,23
1746586693026,EDS 281,A00,895701,Meyerott; Theresa Ann,1,0,15,14
1746586694053,EDS 284,A00,895736,Meyerott; Theresa Ann,1,0,15,14
1746586695082,EDS 286,A00,897210,Fine; Sarah,0,0,15,15
1746586696107,EDS 289C,A01,895770,Daly; Alan J.,1,0,15,14
1746586697135,EDS 290,A00,897211,Hofstetter; Carolyn,0,0,15,15
1746586698161,LIGM 5A,A00,896162,Fischer-Grunski; Eva K,12,0,20,8
1746586699186,LIGM 5B,A00,896260,Fischer-Grunski; Eva K,17,0,20,3
1746586700213,LIGM 5C,A00,896308,Fischer-Grunski; Eva K,18,0,20,2
1746586701240,LIIT 5AS,A00,896313,Carnelos; Chiara,18,0,20,2
1746586702265,LIIT 5BS,A00,896416,Carnelos; Chiara,20,0,20,0
1746586703294,LIIT 5CS,A00,896564,Carnelos; Chiara,20,0,20,0
1746586704323,LISP 5A,A00,896588,Munoz Sanchez; Alicia,2,0,20,18
1746586705348,LISP 5B,A00,896653,Munoz Sanchez; Alicia,7,0,20,13
1746586706377,LISP 5C,A00,896655,Munoz Sanchez; Alicia,0,1,20,20
1746586707403,MAE 197,001,957918,Kleissl; Jan,9996,0,9999,3
1746586707403,MAE 197,002,959806,Boechler; Nicholas Sebastia,9998,0,9999,1
1746586707403,MAE 197,003,959852,Mullin; Jennifer S,9998,0,9999,1
1746586708431,MATH 2,A01,957937,Staff,33,0,35,2
1746586709456,MATH 197,001,957876,Kedlaya; Kiran S.,9993,0,9999,6
1746586710483,MCWP 40,A00,892729,Duru; Nur,10,0,20,10
1746586710483,MCWP 40,B00,893304,Montejo; Carolina,14,0,20,6
1746586711510,MCWP 40R,A00,893757,Redela; Pamela Morgan,0,5,20,20
1746586712538,MCWP 50,A00,893758,Morshed; Michael James,0,0,20,20
1746586712538,MCWP 50,B00,893761,Bartulis; Jason Michael,17,0,20,3
1746586713564,MCWP 50R,A00,893766,Compas; Sean Matthew,0,1,20,20
1746586713564,MCWP 50R,B00,893769,Carter; Jennifer A,0,1,20,20
1746586713564,MCWP 50R,C00,893771,Krone; Jarret,0,3,20,20
1746586713564,MCWP 50R,D00,893772,Miller; Elizabeth Deen,0,0,20,20
1746586713564,MCWP 50R,E00,893775,Carter; Andrea L,0,1,20,20
1746586714592,MMW 11R,A01,892721,Herbst; Matthew,14,0,30,16
1746586714592,MMW 11R,A02,892722,Herbst; Matthew,0,0,0,3
1746586715621,MMW 12R,A01,892724,Herbst; Matthew,0,11,16,16
1746586715621,MMW 12R,A02,892725,Herbst; Matthew,0,10,16,16
1746586716650,MMW 13R,A01,892727,Staff,0,4,16,16
1746586716650,MMW 13R,A02,892728,Staff,0,4,16,16
1746586716650,MMW 13R,A03,958032,Staff,0,4,16,16
1746586716650,MMW 13R,A04,958033,Staff,0,4,16,16
1746586716650,MMW 13R,A05,958034,Staff,0,4,16,16
1746586717676,SIO 295LS,A00,894015,Staff,5,0,25,20
1746586718702,SIO 295S,A00,894020,Staff,5,0,25,20
1746586719731,SIOC 290S,B01,958918,Merrifield; Mark A,14,0,30,16
1746586720763,SIOC 291S,B01,958922,Gabriel; Corey John,14,0,30,16
1746586721789,SOCI 117,A01,895339,Staff,3,0,5,2
1746586722817,WES 237B,A00,894149,Staff,11,0,20,9
1746586724883,AESE 279B,A00,891859,Staff,13,0,35,22
1746586725911,AIP 197,001,891854,Vespa; Emanuel Ignacio,9999,0,9999,0
1746586726939,ANTH 289S,A00,891856,Gagneux; Pascal,12,0,12,0
1746586727963,BENG 196,001,957946,Engler; Adam J.,9996,0,9999,3
1746586728988,BISP 197,001,959851,Wilhelm; James E.,9998,0,9999,1
1746586730018,CAT 124RS,A01,956906,Staff,6,0,25,19
1746586731045,CAT 125RS,A01,922013,Staff,6,0,25,19
1746586732074,CLRE 250,A00,891860,Morris; Sheldon,9995,0,9999,4
1746586734125,CLRE 251R,A00,907817,Mehta; Ravindra L.,9994,0,9999,5
1746586735151,CLRE 252,A00,891864,Cuomo; Raphael Eduardo,9993,0,9999,6
1746586736175,CLRE 253,A00,891867,Vaida; Florin,9994,0,9999,5
1746586736175,CLRE 253,B00,907819,Staff,9999,0,9999,0
1746586737204,CLRE 259,A00,891868,Patel; Hemal,9998,0,9999,1
1746586738230,CLRE 260,A00,891872,Cuomo; Raphael Eduardo,9999,0,9999,0
1746586739256,CLRE 297,001,891888,Cuomo; Raphael Eduardo,9999,0,9999,0
1746586740281,CSE 191,A00,958773,Minnes Kemp; Mor Mia,9995,0,9999,4
1746586741306,CSE 197,001,959846,Minnes Kemp; Mor Mia,9990,0,9999,9
1746586742333,CSS 201S,A01,892054,Mignozzetti; Umberto,25,0,30,5
1746586743361,CSS 202S,A01,892056,Mignozzetti; Umberto,25,0,30,5
1746586744388,DSC 197,001,956898,Eldridge; Justin Matthew,9996,0,9999,3
1746586745418,DSC 297,001,958000,Mazumdar; Arya,9998,0,9999,1
1746586745418,DSC 297,002,959862,Wang; Yusu,9998,0,9999,1
1746586746444,EAP 100,A00,905686,Staff,9778,0,9999,221
1746586747473,ECE 45,A01,892618,Staff,0,0,65,65
1746586749525,ECE 111,A01,892719,Staff,6,0,65,59
1746586750551,ECE 197,001,957920,Mercier; Patrick Philip,9991,0,9999,8
1746586751582,ECON 178,A01,907814,Zhu; Ying,26,0,35,9
1746586752607,EDS 115,A00,895312,Staff,35,0,45,10
1746586753631,EDS 117,A01,895337,Staff,23,0,30,7
1746586754654,EDS 125,A00,895341,Jones; Gabrielle Anastasia,36,0,45,9
1746586755683,EDS 128A,A01,895459,Fargason; Sharon Gayle,44,0,45,1
1746586756709,EDS 128B,A01,895543,Pappas; Elizabeth,44,0,45,1
1746586757736,EDS 139,A00,897203,Pappas; Elizabeth,44,0,45,1
1746586757736,EDS 139,B00,897209,Fargason; Sharon Gayle,41,0,45,4
1746586758766,EDS 201,A00,895545,Staff,22,0,45,23
1746586759792,EDS 203,A01,895581,Halter; Christopher P.,22,0,45,23
1746586760820,EDS 204R,A01,895625,Heinzman; Erica M.,39,0,45,6
1746586760820,EDS 204R,B01,895693,Halter; Christopher P.,10,0,45,35
1746586761848,EDS 206R,A00,895694,Fargason; Sharon Gayle,1,0,30,29
1746586761848,EDS 206R,B00,895695,Choi; Bailey Miyeon,16,0,30,14
1746586762873,EDS 250,A00,895697,Hemans; Patricia Ann Benitez,22,0,45,23
1746586763897,EDS 281,A00,895701,Meyerott; Theresa Ann,1,0,15,14
1746586764922,EDS 284,A00,895736,Meyerott; Theresa Ann,1,0,15,14
1746586765950,EDS 286,A00,897210,Fine; Sarah,0,0,15,15
1746586766976,EDS 289C,A01,895770,Daly; Alan J.,1,0,15,14
1746586768001,EDS 290,A00,897211,Hofstetter; Carolyn,0,0,15,15
1746586769026,LIGM 5A,A00,896162,Fischer-Grunski; Eva K,12,0,20,8
1746586770052,LIGM 5B,A00,896260,Fischer-Grunski; Eva K,17,0,20,3
1746586771080,LIGM 5C,A00,896308,Fischer-Grunski; Eva K,18,0,20,2
1746586772110,LIIT 5AS,A00,896313,Carnelos; Chiara,18,0,20,2
1746586773134,LIIT 5BS,A00,896416,Carnelos; Chiara,20,0,20,0
1746586774161,LIIT 5CS,A00,896564,Carnelos; Chiara,20,0,20,0
1746586775186,LISP 5A,A00,896588,Munoz Sanchez; Alicia,2,0,20,18
1746586776212,LISP 5B,A00,896653,Munoz Sanchez; Alicia,7,0,20,13
1746586777243,LISP 5C,A00,896655,Munoz Sanchez; Alicia,0,1,20,20
1746586778274,MAE 197,001,957918,Kleissl; Jan,9996,0,9999,3
1746586778274,MAE 197,002,959806,Boechler; Nicholas Sebastia,9998,0,9999,1
1746586778274,MAE 197,003,959852,Mullin; Jennifer S,9998,0,9999,1
1746586779301,MATH 2,A01,957937,Staff,33,0,35,2
1746586780329,MATH 197,001,957876,Kedlaya; Kiran S.,9993,0,9999,6
1746586781354,MCWP 40,A00,892729,Duru; Nur,10,0,20,10
1746586781354,MCWP 40,B00,893304,Montejo; Carolina,14,0,20,6
1746586782382,MCWP 40R,A00,893757,Redela; Pamela Morgan,0,5,20,20
1746586783411,MCWP 50,A00,893758,Morshed; Michael James,0,0,20,20
1746586783411,MCWP 50,B00,893761,Bartulis; Jason Michael,17,0,20,3
1746586784436,MCWP 50R,A00,893766,Compas; Sean Matthew,0,1,20,20
1746586784436,MCWP 50R,B00,893769,Carter; Jennifer A,0,1,20,20
1746586784436,MCWP 50R,C00,893771,Krone; Jarret,0,3,20,20
1746586784436,MCWP 50R,D00,893772,Miller; Elizabeth Deen,0,0,20,20
1746586784436,MCWP 50R,E00,893775,Carter; Andrea L,0,1,20,20
1746586785461,MMW 11R,A01,892721,Herbst; Matthew,14,0,30,16
1746586785461,MMW 11R,A02,892722,Herbst; Matthew,0,0,0,3
1746586786487,MMW 12R,A01,892724,Herbst; Matthew,0,11,16,16
1746586786487,MMW 12R,A02,892725,Herbst; Matthew,0,10,16,16
1746586787516,MMW 13R,A01,892727,Staff,0,4,16,16
1746586787516,MMW 13R,A02,892728,Staff,0,4,16,16
1746586787516,MMW 13R,A03,958032,Staff,0,4,16,16
1746586787516,MMW 13R,A04,958033,Staff,0,4,16,16
1746586787516,MMW 13R,A05,958034,Staff,0,4,16,16
1746586788545,SIO 295LS,A00,894015,Staff,5,0,25,20
1746586789570,SIO 295S,A00,894020,Staff,5,0,25,20
1746586790594,SIOC 290S,B01,958918,Merrifield; Mark A,14,0,30,16
1746586791623,SIOC 291S,B01,958922,Gabriel; Corey John,14,0,30,16
1746586804057,SOCI 117,A01,895339,Staff,3,0,5,2
1746586805082,WES 237B,A00,894149,Staff,11,0,20,9
1746586807156,AESE 279B,A00,891859,Staff,13,0,35,22
1746586808180,AIP 197,001,891854,Vespa; Emanuel Ignacio,9999,0,9999,0
1746586809205,ANTH 289S,A00,891856,Gagneux; Pascal,12,0,12,0
1746586810229,BENG 196,001,957946,Engler; Adam J.,9996,0,9999,3
1746586811255,BISP 197,001,959851,Wilhelm; James E.,9998,0,9999,1
1746586812282,CAT 124RS,A01,956906,Staff,6,0,25,19
1746586813307,CAT 125RS,A01,922013,Staff,6,0,25,19
1746586814333,CLRE 250,A00,891860,Morris; Sheldon,9995,0,9999,4
1746586816389,CLRE 251R,A00,907817,Mehta; Ravindra L.,9994,0,9999,5
1746586817416,CLRE 252,A00,891864,Cuomo; Raphael Eduardo,9993,0,9999,6
1746586818442,CLRE 253,A00,891867,Vaida; Florin,9994,0,9999,5
1746586818442,CLRE 253,B00,907819,Staff,9999,0,9999,0
1746586819470,CLRE 259,A00,891868,Patel; Hemal,9998,0,9999,1
1746586820499,CLRE 260,A00,891872,Cuomo; Raphael Eduardo,9999,0,9999,0
1746586821526,CLRE 297,001,891888,Cuomo; Raphael Eduardo,9999,0,9999,0
1746586822554,CSE 191,A00,958773,Minnes Kemp; Mor Mia,9995,0,9999,4
1746586823582,CSE 197,001,959846,Minnes Kemp; Mor Mia,9990,0,9999,9
1746586824607,CSS 201S,A01,892054,Mignozzetti; Umberto,25,0,30,5
1746586825636,CSS 202S,A01,892056,Mignozzetti; Umberto,25,0,30,5
1746586826664,DSC 197,001,956898,Eldridge; Justin Matthew,9996,0,9999,3
1746586827690,DSC 297,001,958000,Mazumdar; Arya,9998,0,9999,1
1746586827690,DSC 297,002,959862,Wang; Yusu,9998,0,9999,1
1746586828718,EAP 100,A00,905686,Staff,9778,0,9999,221
1746586829747,ECE 45,A01,892618,Staff,0,0,65,65
1746586832024,ECE 111,A01,892719,Staff,6,0,65,59
1746586833052,ECE 197,001,957920,Mercier; Patrick Philip,9991,0,9999,8
1746586834078,ECON 178,A01,907814,Zhu; Ying,26,0,35,9
1746586835103,EDS 115,A00,895312,Staff,35,0,45,10
1746586836127,EDS 117,A01,895337,Staff,23,0,30,7
1746586837156,EDS 125,A00,895341,Jones; Gabrielle Anastasia,36,0,45,9
1746586838180,EDS 128A,A01,895459,Fargason; Sharon Gayle,44,0,45,1
1746586839207,EDS 128B,A01,895543,Pappas; Elizabeth,44,0,45,1
1746586840232,EDS 139,A00,897203,Pappas; Elizabeth,44,0,45,1
1746586840232,EDS 139,B00,897209,Fargason; Sharon Gayle,41,0,45,4
1746586841263,EDS 201,A00,895545,Staff,22,0,45,23
1746586842288,EDS 203,A01,895581,Halter; Christopher P.,22,0,45,23
1746586843317,EDS 204R,A01,895625,Heinzman; Erica M.,39,0,45,6
1746586843317,EDS 204R,B01,895693,Halter; Christopher P.,10,0,45,35
1746586844347,EDS 206R,A00,895694,Fargason; Sharon Gayle,1,0,30,29
1746586844347,EDS 206R,B00,895695,Choi; Bailey Miyeon,16,0,30,14
1746586845374,EDS 250,A00,895697,Hemans; Patricia Ann Benitez,22,0,45,23
1746586846402,EDS 281,A00,895701,Meyerott; Theresa Ann,1,0,15,14
1746586847432,EDS 284,A00,895736,Meyerott; Theresa Ann,1,0,15,14
1746586848461,EDS 286,A00,897210,Fine; Sarah,0,0,15,15
1746586849490,EDS 289C,A01,895770,Daly; Alan J.,1,0,15,14
1746586850515,EDS 290,A00,897211,Hofstetter; Carolyn,0,0,15,15
1746586851540,LIGM 5A,A00,896162,Fischer-Grunski; Eva K,12,0,20,8
1746586852573,LIGM 5B,A00,896260,Fischer-Grunski; Eva K,17,0,20,3
1746586853599,LIGM 5C,A00,896308,Fischer-Grunski; Eva K,18,0,20,2
1746586854630,LIIT 5AS,A00,896313,Carnelos; Chiara,18,0,20,2
1746586855654,LIIT 5BS,A00,896416,Carnelos; Chiara,20,0,20,0
1746586856677,LIIT 5CS,A00,896564,Carnelos; Chiara,20,0,20,0
1746586857703,LISP 5A,A00,896588,Munoz Sanchez; Alicia,2,0,20,18
1746586858732,LISP 5B,A00,896653,Munoz Sanchez; Alicia,7,0,20,13
1746586859765,LISP 5C,A00,896655,Munoz Sanchez; Alicia,0,1,20,20
1746586860792,MAE 197,001,957918,Kleissl; Jan,9996,0,9999,3
1746586860792,MAE 197,002,959806,Boechler; Nicholas Sebastia,9998,0,9999,1
1746586860792,MAE 197,003,959852,Mullin; Jennifer S,9998,0,9999,1
1746586861819,MATH 2,A01,957937,Staff,33,0,35,2
1746586862848,MATH 197,001,957876,Kedlaya; Kiran S.,9993,0,9999,6
1746586863873,MCWP 40,A00,892729,Duru; Nur,10,0,20,10
1746586863873,MCWP 40,B00,893304,Montejo; Carolina,14,0,20,6
1746586864899,MCWP 40R,A00,893757,Redela; Pamela Morgan,0,5,20,20
1746586865928,MCWP 50,A00,893758,Morshed; Michael James,0,0,20,20
1746586865928,MCWP 50,B00,893761,Bartulis; Jason Michael,17,0,20,3
1746586866954,MCWP 50R,A00,893766,Compas; Sean Matthew,0,1,20,20
1746586866954,MCWP 50R,B00,893769,Carter; Jennifer A,0,1,20,20
1746586866954,MCWP 50R,C00,893771,Krone; Jarret,0,3,20,20
1746586866954,MCWP 50R,D00,893772,Miller; Elizabeth Deen,0,0,20,20
1746586866954,MCWP 50R,E00,893775,Carter; Andrea L,0,1,20,20
1746586867982,MMW 11R,A01,892721,Herbst; Matthew,14,0,30,16
1746586867982,MMW 11R,A02,892722,Herbst; Matthew,0,0,0,3
1746586869011,MMW 12R,A01,892724,Herbst; Matthew,0,11,16,16
1746586869011,MMW 12R,A02,892725,Herbst; Matthew,0,10,16,16
1746586870036,MMW 13R,A01,892727,Staff,0,4,16,16
1746586870036,MMW 13R,A02,892728,Staff,0,4,16,16
1746586870036,MMW 13R,A03,958032,Staff,0,4,16,16
1746586870036,MMW 13R,A04,958033,Staff,0,4,16,16
1746586870036,MMW 13R,A05,958034,Staff,0,4,16,16
1746586871060,SIO 295LS,A00,894015,Staff,5,0,25,20
1746586872086,SIO 295S,A00,894020,Staff,5,0,25,20
1746586873112,SIOC 290S,B01,958918,Merrifield; Mark A,14,0,30,16
1746586874144,SIOC 291S,B01,958922,Gabriel; Corey John,14,0,30,16
1746586875173,SOCI 117,A01,895339,Staff,3,0,5,2
1746586876196,WES 237B,A00,894149,Staff,11,0,20,9
1746586878254,AESE 279B,A00,891859,Staff,13,0,35,22
1746586879278,AIP 197,001,891854,Vespa; Emanuel Ignacio,9999,0,9999,0
1746586880309,ANTH 289S,A00,891856,Gagneux; Pascal,12,0,12,0
1746586881335,BENG 196,001,957946,Engler; Adam J.,9996,0,9999,3
1746586882361,BISP 197,001,959851,Wilhelm; James E.,9998,0,9999,1
1746586883398,CAT 124RS,A01,956906,Staff,6,0,25,19
1746586884422,CAT 125RS,A01,922013,Staff,6,0,25,19
1746586885446,CLRE 250,A00,891860,Morris; Sheldon,9995,0,9999,4
1746586887500,CLRE 251R,A00,907817,Mehta; Ravindra L.,9994,0,9999,5
1746586888529,CLRE 252,A00,891864,Cuomo; Raphael Eduardo,9993,0,9999,6
1746586889558,CLRE 253,A00,891867,Vaida; Florin,9994,0,9999,5
1746586889558,CLRE 253,B00,907819,Staff,9999,0,9999,0
1746586890610,CLRE 259,A00,891868,Patel; Hemal,9998,0,9999,1
1746586891635,CLRE 260,A00,891872,Cuomo; Raphael Eduardo,9999,0,9999,0
1746586892661,CLRE 297,001,891888,Cuomo; Raphael Eduardo,9999,0,9999,0
1746586893686,CSE 191,A00,958773,Minnes Kemp; Mor Mia,9995,0,9999,4
1746586894710,CSE 197,001,959846,Minnes Kemp; Mor Mia,9990,0,9999,9
1746586895735,CSS 201S,A01,892054,Mignozzetti; Umberto,25,0,30,5
1746586896761,CSS 202S,A01,892056,Mignozzetti; Umberto,25,0,30,5
1746586897786,DSC 197,001,956898,Eldridge; Justin Matthew,9996,0,9999,3
1746586898814,DSC 297,001,958000,Mazumdar; Arya,9998,0,9999,1
1746586898814,DSC 297,002,959862,Wang; Yusu,9998,0,9999,1
1746586899839,EAP 100,A00,905686,Staff,9778,0,9999,221
1746586900884,ECE 45,A01,892618,Staff,0,0,65,65
1746586902940,ECE 111,A01,892719,Staff,6,0,65,59
1746586903966,ECE 197,001,957920,Mercier; Patrick Philip,9991,0,9999,8
1746586905013,ECON 178,A01,907814,Zhu; Ying,26,0,35,9
1746586906040,EDS 115,A00,895312,Staff,35,0,45,10
1746586907069,EDS 117,A01,895337,Staff,23,0,30,7
1746586908094,EDS 125,A00,895341,Jones; Gabrielle Anastasia,36,0,45,9
1746586909117,EDS 128A,A01,895459,Fargason; Sharon Gayle,44,0,45,1
1746586910143,EDS 128B,A01,895543,Pappas; Elizabeth,44,0,45,1
1746586911168,EDS 139,A00,897203,Pappas; Elizabeth,44,0,45,1
1746586911168,EDS 139,B00,897209,Fargason; Sharon Gayle,41,0,45,4
1746586912198,EDS 201,A00,895545,Staff,22,0,45,23
1746586913227,EDS 203,A01,895581,Halter; Christopher P.,22,0,45,23
1746586914252,EDS 204R,A01,895625,Heinzman; Erica M.,39,0,45,6
1746586914252,EDS 204R,B01,895693,Halter; Christopher P.,10,0,45,35
1746586915335,EDS 206R,A00,895694,Fargason; Sharon Gayle,1,0,30,29
1746586915335,EDS 206R,B00,895695,Choi; Bailey Miyeon,16,0,30,14
1746586916366,EDS 250,A00,895697,Hemans; Patricia Ann Benitez,22,0,45,23
1746586917390,EDS 281,A00,895701,Meyerott; Theresa Ann,1,0,15,14
1746586918416,EDS 284,A00,895736,Meyerott; Theresa Ann,1,0,15,14
1746586919441,EDS 286,A00,897210,Fine; Sarah,0,0,15,15
1746586920468,EDS 289C,A01,895770,Daly; Alan J.,1,0,15,14
1746586921497,EDS 290,A00,897211,Hofstetter; Carolyn,0,0,15,15
1746586922528,LIGM 5A,A00,896162,Fischer-Grunski; Eva K,12,0,20,8
1746586923555,LIGM 5B,A00,896260,Fischer-Grunski; Eva K,17,0,20,3
1746586924579,LIGM 5C,A00,896308,Fischer-Grunski; Eva K,18,0,20,2
1746586925611,LIIT 5AS,A00,896313,Carnelos; Chiara,18,0,20,2
1746586926641,LIIT 5BS,A00,896416,Carnelos; Chiara,20,0,20,0
1746586927667,LIIT 5CS,A00,896564,Carnelos; Chiara,20,0,20,0
1746586928697,LISP 5A,A00,896588,Munoz Sanchez; Alicia,2,0,20,18
1746586929723,LISP 5B,A00,896653,Munoz Sanchez; Alicia,7,0,20,13
1746586930749,LISP 5C,A00,896655,Munoz Sanchez; Alicia,0,1,20,20
1746586931779,MAE 197,001,957918,Kleissl; Jan,9996,0,9999,3
1746586931779,MAE 197,002,959806,Boechler; Nicholas Sebastia,9998,0,9999,1
1746586931779,MAE 197,003,959852,Mullin; Jennifer S,9998,0,9999,1
1746586932807,MATH 2,A01,957937,Staff,33,0,35,2
1746586933836,MATH 197,001,957876,Kedlaya; Kiran S.,9993,0,9999,6
1746586934861,MCWP 40,A00,892729,Duru; Nur,10,0,20,10
1746586934861,MCWP 40,B00,893304,Montejo; Carolina,14,0,20,6
1746586935888,MCWP 40R,A00,893757,Redela; Pamela Morgan,0,5,20,20
1746586936913,MCWP 50,A00,893758,Morshed; Michael James,0,0,20,20
1746586936913,MCWP 50,B00,893761,Bartulis; Jason Michael,17,0,20,3
1746586937941,MCWP 50R,A00,893766,Compas; Sean Matthew,0,1,20,20
1746586937941,MCWP 50R,B00,893769,Carter; Jennifer A,0,1,20,20
1746586937941,MCWP 50R,C00,893771,Krone; Jarret,0,3,20,20
1746586937941,MCWP 50R,D00,893772,Miller; Elizabeth Deen,0,0,20,20
1746586937941,MCWP 50R,E00,893775,Carter; Andrea L,0,1,20,20
1746586938967,MMW 11R,A01,892721,Herbst; Matthew,14,0,30,16
1746586938967,MMW 11R,A02,892722,Herbst; Matthew,0,0,0,3
1746586939992,MMW 12R,A01,892724,Herbst; Matthew,0,11,16,16
1746586939992,MMW 12R,A02,892725,Herbst; Matthew,0,10,16,16
1746586941019,MMW 13R,A01,892727,Staff,0,4,16,16
1746586941019,MMW 13R,A02,892728,Staff,0,4,16,16
1746586941019,MMW 13R,A03,958032,Staff,0,4,16,16
1746586941019,MMW 13R,A04,958033,Staff,0,4,16,16
1746586941019,MMW 13R,A05,958034,Staff,0,4,16,16
1746586942046,SIO 295LS,A00,894015,Staff,5,0,25,20
1746586943072,SIO 295S,A00,894020,Staff,5,0,25,20
1746586944102,SIOC 290S,B01,958918,Merrifield; Mark A,14,0,30,16
1746586945132,SIOC 291S,B01,958922,Gabriel; Corey John,14,0,30,16
1746586946159,SOCI 117,A01,895339,Staff,3,0,5,2
1746586947188,WES 237B,A00,894149,Staff,11,0,20,9
1746586949242,AESE 279B,A00,891859,Staff,13,0,35,22
1746586950267,AIP 197,001,891854,Vespa; Emanuel Ignacio,9999,0,9999,0
1746586951292,ANTH 289S,A00,891856,Gagneux; Pascal,12,0,12,0
1746586952316,BENG 196,001,957946,Engler; Adam J.,9996,0,9999,3
1746586953340,BISP 197,001,959851,Wilhelm; James E.,9998,0,9999,1
1746586954419,CAT 124RS,A01,956906,Staff,6,0,25,19
1746586955444,CAT 125RS,A01,922013,Staff,6,0,25,19
1746586956469,CLRE 250,A00,891860,Morris; Sheldon,9995,0,9999,4
1746586958524,CLRE 251R,A00,907817,Mehta; Ravindra L.,9994,0,9999,5
1746586959548,CLRE 252,A00,891864,Cuomo; Raphael Eduardo,9993,0,9999,6
1746586960574,CLRE 253,A00,891867,Vaida; Florin,9994,0,9999,5
1746586960574,CLRE 253,B00,907819,Staff,9999,0,9999,0
1746586961598,CLRE 259,A00,891868,Patel; Hemal,9998,0,9999,1
1746586962629,CLRE 260,A00,891872,Cuomo; Raphael Eduardo,9999,0,9999,0
1746586963654,CLRE 297,001,891888,Cuomo; Raphael Eduardo,9999,0,9999,0
1746586964682,CSE 191,A00,958773,Minnes Kemp; Mor Mia,9995,0,9999,4
1746586965711,CSE 197,001,959846,Minnes Kemp; Mor Mia,9990,0,9999,9
1746586966737,CSS 201S,A01,892054,Mignozzetti; Umberto,25,0,30,5
1746586967762,CSS 202S,A01,892056,Mignozzetti; Umberto,25,0,30,5
1746586968787,DSC 197,001,956898,Eldridge; Justin Matthew,9996,0,9999,3
1746586969817,DSC 297,001,958000,Mazumdar; Arya,9998,0,9999,1
1746586969817,DSC 297,002,959862,Wang; Yusu,9998,0,9999,1
1746586970842,EAP 100,A00,905686,Staff,9778,0,9999,221
1746586971867,ECE 45,A01,892618,Staff,0,0,65,65
1746586973918,ECE 111,A01,892719,Staff,6,0,65,59
1746586974945,ECE 197,001,957920,Mercier; Patrick Philip,9991,0,9999,8
1746586975971,ECON 178,A01,907814,Zhu; Ying,26,0,35,9
1746586976998,EDS 115,A00,895312,Staff,35,0,45,10
1746586978027,EDS 117,A01,895337,Staff,23,0,30,7
1746586979056,EDS 125,A00,895341,Jones; Gabrielle Anastasia,36,0,45,9
1746586980082,EDS 128A,A01,895459,Fargason; Sharon Gayle,44,0,45,1
1746586981106,EDS 128B,A01,895543,Pappas; Elizabeth,44,0,45,1
1746586982131,EDS 139,A00,897203,Pappas; Elizabeth,44,0,45,1
1746586982131,EDS 139,B00,897209,Fargason; Sharon Gayle,41,0,45,4
1746586983156,EDS 201,A00,895545,Staff,22,0,45,23
1746586984180,EDS 203,A01,895581,Halter; Christopher P.,22,0,45,23
1746586985207,EDS 204R,A01,895625,Heinzman; Erica M.,39,0,45,6
1746586985207,EDS 204R,B01,895693,Halter; Christopher P.,10,0,45,35
1746586986235,EDS 206R,A00,895694,Fargason; Sharon Gayle,1,0,30,29
1746586986235,EDS 206R,B00,895695,Choi; Bailey Miyeon,16,0,30,14
1746586987258,EDS 250,A00,895697,Hemans; Patricia Ann Benitez,22,0,45,23
1746586988283,EDS 281,A00,895701,Meyerott; Theresa Ann,1,0,15,14
1746586989307,EDS 284,A00,895736,Meyerott; Theresa Ann,1,0,15,14
1746586990333,EDS 286,A00,897210,Fine; Sarah,0,0,15,15
1746586991359,EDS 289C,A01,895770,Daly; Alan J.,1,0,15,14
1746586992384,EDS 290,A00,897211,Hofstetter; Carolyn,0,0,15,15
1746586993409,LIGM 5A,A00,896162,Fischer-Grunski; Eva K,12,0,20,8
1746586994435,LIGM 5B,A00,896260,Fischer-Grunski; Eva K,17,0,20,3
1746586995460,LIGM 5C,A00,896308,Fischer-Grunski; Eva K,18,0,20,2
1746586996484,LIIT 5AS,A00,896313,Carnelos; Chiara,18,0,20,2
1746586997511,LIIT 5BS,A00,896416,Carnelos; Chiara,20,0,20,0
1746586998538,LIIT 5CS,A00,896564,Carnelos; Chiara,20,0,20,0
1746586999568,LISP 5A,A00,896588,Munoz Sanchez; Alicia,2,0,20,18
1746587000598,LISP 5B,A00,896653,Munoz Sanchez; Alicia,7,0,20,13
1746587001624,LISP 5C,A00,896655,Munoz Sanchez; Alicia,0,1,20,20
1746587002651,MAE 197,001,957918,Kleissl; Jan,9996,0,9999,3
1746587002651,MAE 197,002,959806,Boechler; Nicholas Sebastia,9998,0,9999,1
1746587002651,MAE 197,003,959852,Mullin; Jennifer S,9998,0,9999,1
1746587003680,MATH 2,A01,957937,Staff,33,0,35,2
1746587004707,MATH 197,001,957876,Kedlaya; Kiran S.,9993,0,9999,6
1746587005733,MCWP 40,A00,892729,Duru; Nur,10,0,20,10
1746587005733,MCWP 40,B00,893304,Montejo; Carolina,14,0,20,6
1746587006758,MCWP 40R,A00,893757,Redela; Pamela Morgan,0,5,20,20
1746587007783,MCWP 50,A00,893758,Morshed; Michael James,0,0,20,20
1746587007783,MCWP 50,B00,893761,Bartulis; Jason Michael,17,0,20,3
1746587008810,MCWP 50R,A00,893766,Compas; Sean Matthew,0,1,20,20
1746587008810,MCWP 50R,B00,893769,Carter; Jennifer A,0,1,20,20
1746587008810,MCWP 50R,C00,893771,Krone; Jarret,0,3,20,20
1746587008810,MCWP 50R,D00,893772,Miller; Elizabeth Deen,0,0,20,20
1746587008810,MCWP 50R,E00,893775,Carter; Andrea L,0,1,20,20
1746587009835,MMW 11R,A01,892721,Herbst; Matthew,14,0,30,16
1746587009835,MMW 11R,A02,892722,Herbst; Matthew,0,0,0,3
1746587010864,MMW 12R,A01,892724,Herbst; Matthew,0,11,16,16
1746587010864,MMW 12R,A02,892725,Herbst; Matthew,0,10,16,16
1746587011892,MMW 13R,A01,892727,Staff,0,4,16,16
1746587011892,MMW 13R,A02,892728,Staff,0,4,16,16
1746587011892,MMW 13R,A03,958032,Staff,0,4,16,16
1746587011892,MMW 13R,A04,958033,Staff,0,4,16,16
1746587011892,MMW 13R,A05,958034,Staff,0,4,16,16
1746587012916,SIO 295LS,A00,894015,Staff,5,0,25,20
1746587013941,SIO 295S,A00,894020,Staff,5,0,25,20
1746587014972,SIOC 290S,B01,958918,Merrifield; Mark A,14,0,30,16
1746587016001,SIOC 291S,B01,958922,Gabriel; Corey John,14,0,30,16
1746587017025,SOCI 117,A01,895339,Staff,3,0,5,2
1746587018052,WES 237B,A00,894149,Staff,11,0,20,9
1746587020115,AESE 279B,A00,891859,Staff,13,0,35,22
1746587021139,AIP 197,001,891854,Vespa; Emanuel Ignacio,9999,0,9999,0
1746587022167,ANTH 289S,A00,891856,Gagneux; Pascal,12,0,12,0
1746587023193,BENG 196,001,957946,Engler; Adam J.,9996,0,9999,3
1746587024218,BISP 197,001,959851,Wilhelm; James E.,9998,0,9999,1
1746587025242,CAT 124RS,A01,956906,Staff,6,0,25,19
1746587026265,CAT 125RS,A01,922013,Staff,6,0,25,19
1746587027290,CLRE 250,A00,891860,Morris; Sheldon,9995,0,9999,4
1746587029342,CLRE 251R,A00,907817,Mehta; Ravindra L.,9994,0,9999,5
1746587030367,CLRE 252,A00,891864,Cuomo; Raphael Eduardo,9993,0,9999,6
1746587031398,CLRE 253,A00,891867,Vaida; Florin,9994,0,9999,5
1746587031398,CLRE 253,B00,907819,Staff,9999,0,9999,0
1746587032425,CLRE 259,A00,891868,Patel; Hemal,9998,0,9999,1
1746587033449,CLRE 260,A00,891872,Cuomo; Raphael Eduardo,9999,0,9999,0
1746587034474,CLRE 297,001,891888,Cuomo; Raphael Eduardo,9999,0,9999,0
1746587035498,CSE 191,A00,958773,Minnes Kemp; Mor Mia,9995,0,9999,4
1746587036526,CSE 197,001,959846,Minnes Kemp; Mor Mia,9990,0,9999,9
1746587037550,CSS 201S,A01,892054,Mignozzetti; Umberto,25,0,30,5
1746587038577,CSS 202S,A01,892056,Mignozzetti; Umberto,25,0,30,5
1746587039603,DSC 197,001,956898,Eldridge; Justin Matthew,9996,0,9999,3
1746587040627,DSC 297,001,958000,Mazumdar; Arya,9998,0,9999,1
1746587040627,DSC 297,002,959862,Wang; Yusu,9998,0,9999,1
1746587041654,EAP 100,A00,905686,Staff,9778,0,9999,221
1746587042679,ECE 45,A01,892618,Staff,0,0,65,65
1746587044732,ECE 111,A01,892719,Staff,6,0,65,59
1746587045760,ECE 197,001,957920,Mercier; Patrick Philip,9991,0,9999,8
1746587046789,ECON 178,A01,907814,Zhu; Ying,26,0,35,9
1746587047814,EDS 115,A00,895312,Staff,35,0,45,10
1746587048838,EDS 117,A01,895337,Staff,23,0,30,7
1746587049862,EDS 125,A00,895341,Jones; Gabrielle Anastasia,36,0,45,9
1746587050889,EDS 128A,A01,895459,Fargason; Sharon Gayle,44,0,45,1
1746587051916,EDS 128B,A01,895543,Pappas; Elizabeth,44,0,45,1
1746587052944,EDS 139,A00,897203,Pappas; Elizabeth,44,0,45,1
1746587052944,EDS 139,B00,897209,Fargason; Sharon Gayle,41,0,45,4
1746587053968,EDS 201,A00,895545,Staff,22,0,45,23
1746587054997,EDS 203,A01,895581,Halter; Christopher P.,22,0,45,23
1746587056026,EDS 204R,A01,895625,Heinzman; Erica M.,39,0,45,6
1746587056026,EDS 204R,B01,895693,Halter; Christopher P.,10,0,45,35
1746587057050,EDS 206R,A00,895694,Fargason; Sharon Gayle,1,0,30,29
1746587057050,EDS 206R,B00,895695,Choi; Bailey Miyeon,16,0,30,14
1746587058074,EDS 250,A00,895697,Hemans; Patricia Ann Benitez,22,0,45,23
1746587059101,EDS 281,A00,895701,Meyerott; Theresa Ann,1,0,15,14
1746587060127,EDS 284,A00,895736,Meyerott; Theresa Ann,1,0,15,14
1746587061156,EDS 286,A00,897210,Fine; Sarah,0,0,15,15
1746587062183,EDS 289C,A01,895770,Daly; Alan J.,1,0,15,14
1746587063209,EDS 290,A00,897211,Hofstetter; Carolyn,0,0,15,15
1746587064232,LIGM 5A,A00,896162,Fischer-Grunski; Eva K,12,0,20,8
1746587065262,LIGM 5B,A00,896260,Fischer-Grunski; Eva K,17,0,20,3
1746587066292,LIGM 5C,A00,896308,Fischer-Grunski; Eva K,18,0,20,2
1746587067318,LIIT 5AS,A00,896313,Carnelos; Chiara,18,0,20,2
1746587068349,LIIT 5BS,A00,896416,Carnelos; Chiara,20,0,20,0
1746587069378,LIIT 5CS,A00,896564,Carnelos; Chiara,20,0,20,0
1746587070403,LISP 5A,A00,896588,Munoz Sanchez; Alicia,2,0,20,18
1746587071428,LISP 5B,A00,896653,Munoz Sanchez; Alicia,7,0,20,13
1746587072455,LISP 5C,A00,896655,Munoz Sanchez; Alicia,0,1,20,20
1746587073484,MAE 197,001,957918,Kleissl; Jan,9996,0,9999,3
1746587073484,MAE 197,002,959806,Boechler; Nicholas Sebastia,9998,0,9999,1
1746587073484,MAE 197,003,959852,Mullin; Jennifer S,9998,0,9999,1
1746587074508,MATH 2,A01,957937,Staff,33,0,35,2
1746587075535,MATH 197,001,957876,Kedlaya; Kiran S.,9993,0,9999,6
1746587076563,MCWP 40,A00,892729,Duru; Nur,10,0,20,10
1746587076563,MCWP 40,B00,893304,Montejo; Carolina,14,0,20,6
1746587077592,MCWP 40R,A00,893757,Redela; Pamela Morgan,0,5,20,20
1746587078617,MCWP 50,A00,893758,Morshed; Michael James,0,0,20,20
1746587078617,MCWP 50,B00,893761,Bartulis; Jason Michael,17,0,20,3
1746587079647,MCWP 50R,A00,893766,Compas; Sean Matthew,0,1,20,20
1746587079647,MCWP 50R,B00,893769,Carter; Jennifer A,0,1,20,20
1746587079647,MCWP 50R,C00,893771,Krone; Jarret,0,3,20,20
1746587079647,MCWP 50R,D00,893772,Miller; Elizabeth Deen,0,0,20,20
1746587079647,MCWP 50R,E00,893775,Carter; Andrea L,0,1,20,20
1746587080676,MMW 11R,A01,892721,Herbst; Matthew,14,0,30,16
1746587080676,MMW 11R,A02,892722,Herbst; Matthew,0,0,0,3
1746587081700,MMW 12R,A01,892724,Herbst; Matthew,0,11,16,16
1746587081700,MMW 12R,A02,892725,Herbst; Matthew,0,10,16,16
1746587082726,MMW 13R,A01,892727,Staff,0,4,16,16
1746587082726,MMW 13R,A02,892728,Staff,0,4,16,16
1746587082726,MMW 13R,A03,958032,Staff,0,4,16,16
1746587082726,MMW 13R,A04,958033,Staff,0,4,16,16
1746587082726,MMW 13R,A05,958034,Staff,0,4,16,16
1746587083750,SIO 295LS,A00,894015,Staff,5,0,25,20
1746587084781,SIO 295S,A00,894020,Staff,5,0,25,20
1746587085808,SIOC 290S,B01,958918,Merrifield; Mark A,14,0,30,16
1746587086837,SIOC 291S,B01,958922,Gabriel; Corey John,14,0,30,16
1746587087862,SOCI 117,A01,895339,Staff,3,0,5,2
1746587088886,WES 237B,A00,894149,Staff,11,0,20,9
1746587090956,AESE 279B,A00,891859,Staff,13,0,35,22
1746587091980,AIP 197,001,891854,Vespa; Emanuel Ignacio,9999,0,9999,0
1746587093005,ANTH 289S,A00,891856,Gagneux; Pascal,12,0,12,0
1746587094031,BENG 196,001,957946,Engler; Adam J.,9996,0,9999,3
1746587095057,BISP 197,001,959851,Wilhelm; James E.,9998,0,9999,1
1746587096086,CAT 124RS,A01,956906,Staff,6,0,25,19
1746587097112,CAT 125RS,A01,922013,Staff,6,0,25,19
1746587098138,CLRE 250,A00,891860,Morris; Sheldon,9995,0,9999,4
1746587100189,CLRE 251R,A00,907817,Mehta; Ravindra L.,9994,0,9999,5
1746587101213,CLRE 252,A00,891864,Cuomo; Raphael Eduardo,9993,0,9999,6
1746587102243,CLRE 253,A00,891867,Vaida; Florin,9994,0,9999,5
1746587102243,CLRE 253,B00,907819,Staff,9999,0,9999,0
1746587103271,CLRE 259,A00,891868,Patel; Hemal,9998,0,9999,1
1746587104299,CLRE 260,A00,891872,Cuomo; Raphael Eduardo,9999,0,9999,0
1746587105323,CLRE 297,001,891888,Cuomo; Raphael Eduardo,9999,0,9999,0
1746587106348,CSE 191,A00,958773,Minnes Kemp; Mor Mia,9995,0,9999,4
1746587107378,CSE 197,001,959846,Minnes Kemp; Mor Mia,9990,0,9999,9
1746587108404,CSS 201S,A01,892054,Mignozzetti; Umberto,25,0,30,5
1746587109435,CSS 202S,A01,892056,Mignozzetti; Umberto,25,0,30,5
1746587110459,DSC 197,001,956898,Eldridge; Justin Matthew,9996,0,9999,3
1746587111487,DSC 297,001,958000,Mazumdar; Arya,9998,0,9999,1
1746587111487,DSC 297,002,959862,Wang; Yusu,9998,0,9999,1
1746587112516,EAP 100,A00,905686,Staff,9778,0,9999,221
1746587113545,ECE 45,A01,892618,Staff,0,0,65,65
1746587115603,ECE 111,A01,892719,Staff,6,0,65,59
1746587116628,ECE 197,001,957920,Mercier; Patrick Philip,9991,0,9999,8
1746587117655,ECON 178,A01,907814,Zhu; Ying,26,0,35,9
1746587118680,EDS 115,A00,895312,Staff,35,0,45,10
1746587119704,EDS 117,A01,895337,Staff,23,0,30,7
1746587120734,EDS 125,A00,895341,Jones; Gabrielle Anastasia,36,0,45,9
1746587121764,EDS 128A,A01,895459,Fargason; Sharon Gayle,44,0,45,1
1746587122794,EDS 128B,A01,895543,Pappas; Elizabeth,44,0,45,1
1746587123818,EDS 139,A00,897203,Pappas; Elizabeth,44,0,45,1
1746587123818,EDS 139,B00,897209,Fargason; Sharon Gayle,41,0,45,4
1746587124846,EDS 201,A00,895545,Staff,22,0,45,23
1746587125874,EDS 203,A01,895581,Halter; Christopher P.,22,0,45,23
1746587126902,EDS 204R,A01,895625,Heinzman; Erica M.,39,0,45,6
1746587126902,EDS 204R,B01,895693,Halter; Christopher P.,10,0,45,35
1746587127928,EDS 206R,A00,895694,Fargason; Sharon Gayle,1,0,30,29
1746587127928,EDS 206R,B00,895695,Choi; Bailey Miyeon,16,0,30,14
1746587128952,EDS 250,A00,895697,Hemans; Patricia Ann Benitez,22,0,45,23
1746587129985,EDS 281,A00,895701,Meyerott; Theresa Ann,1,0,15,14
1746587131012,EDS 284,A00,895736,Meyerott; Theresa Ann,1,0,15,14
1746587132037,EDS 286,A00,897210,Fine; Sarah,0,0,15,15
1746587133067,EDS 289C,A01,895770,Daly; Alan J.,1,0,15,14
1746587134093,EDS 290,A00,897211,Hofstetter; Carolyn,0,0,15,15
1746587135120,LIGM 5A,A00,896162,Fischer-Grunski; Eva K,12,0,20,8
1746587136147,LIGM 5B,A00,896260,Fischer-Grunski; Eva K,17,0,20,3
1746587137178,LIGM 5C,A00,896308,Fischer-Grunski; Eva K,18,0,20,2
1746587138204,LIIT 5AS,A00,896313,Carnelos; Chiara,18,0,20,2
1746587139229,LIIT 5BS,A00,896416,Carnelos; Chiara,20,0,20,0
1746587140257,LIIT 5CS,A00,896564,Carnelos; Chiara,20,0,20,0
1746587141288,LISP 5A,A00,896588,Munoz Sanchez; Alicia,2,0,20,18
1746587142318,LISP 5B,A00,896653,Munoz Sanchez; Alicia,7,0,20,13
1746587143346,LISP 5C,A00,896655,Munoz Sanchez; Alicia,0,1,20,20
1746587144371,MAE 197,001,957918,Kleissl; Jan,9996,0,9999,3
1746587144371,MAE 197,002,959806,Boechler; Nicholas Sebastia,9998,0,9999,1
1746587144371,MAE 197,003,959852,Mullin; Jennifer S,9998,0,9999,1
1746587145398,MATH 2,A01,957937,Staff,33,0,35,2
1746587146423,MATH 197,001,957876,Kedlaya; Kiran S.,9993,0,9999,6
1746587147451,MCWP 40,A00,892729,Duru; Nur,10,0,20,10
1746587147451,MCWP 40,B00,893304,Montejo; Carolina,14,0,20,6
1746587148476,MCWP 40R,A00,893757,Redela; Pamela Morgan,0,5,20,20
1746587149500,MCWP 50,A00,893758,Morshed; Michael James,0,0,20,20
1746587149500,MCWP 50,B00,893761,Bartulis; Jason Michael,17,0,20,3
1746587150525,MCWP 50R,A00,893766,Compas; Sean Matthew,0,1,20,20
1746587150525,MCWP 50R,B00,893769,Carter; Jennifer A,0,1,20,20
1746587150525,MCWP 50R,C00,893771,Krone; Jarret,0,3,20,20
1746587150525,MCWP 50R,D00,893772,Miller; Elizabeth Deen,0,0,20,20
1746587150525,MCWP 50R,E00,893775,Carter; Andrea L,0,1,20,20
1746587151554,MMW 11R,A01,892721,Herbst; Matthew,14,0,30,16
1746587151554,MMW 11R,A02,892722,Herbst; Matthew,0,0,0,3
1746587152583,MMW 12R,A01,892724,Herbst; Matthew,0,11,16,16
1746587152583,MMW 12R,A02,892725,Herbst; Matthew,0,10,16,16
1746587153610,MMW 13R,A01,892727,Staff,0,4,16,16
1746587153610,MMW 13R,A02,892728,Staff,0,4,16,16
1746587153610,MMW 13R,A03,958032,Staff,0,4,16,16
1746587153610,MMW 13R,A04,958033,Staff,0,4,16,16
1746587153610,MMW 13R,A05,958034,Staff,0,4,16,16
1746587154638,SIO 295LS,A00,894015,Staff,5,0,25,20
1746587155661,SIO 295S,A00,894020,Staff,5,0,25,20
1746587156690,SIOC 290S,B01,958918,Merrifield; Mark A,14,0,30,16
1746587157713,SIOC 291S,B01,958922,Gabriel; Corey John,14,0,30,16
1746587158742,SOCI 117,A01,895339,Staff,3,0,5,2
1746587159767,WES 237B,A00,894149,Staff,11,0,20,9
1746587161844,AESE 279B,A00,891859,Staff,13,0,35,22
1746587162868,AIP 197,001,891854,Vespa; Emanuel Ignacio,9999,0,9999,0
1746587163892,ANTH 289S,A00,891856,Gagneux; Pascal,12,0,12,0
1746587164920,BENG 196,001,957946,Engler; Adam J.,9996,0,9999,3
1746587165944,BISP 197,001,959851,Wilhelm; James E.,9998,0,9999,1
1746587166972,CAT 124RS,A01,956906,Staff,6,0,25,19
1746587167995,CAT 125RS,A01,922013,Staff,6,0,25,19
1746587169021,CLRE 250,A00,891860,Morris; Sheldon,9995,0,9999,4
1746587171072,CLRE 251R,A00,907817,Mehta; Ravindra L.,9994,0,9999,5
1746587172100,CLRE 252,A00,891864,Cuomo; Raphael Eduardo,9993,0,9999,6
1746587173127,CLRE 253,A00,891867,Vaida; Florin,9994,0,9999,5
1746587173127,CLRE 253,B00,907819,Staff,9999,0,9999,0
1746587174155,CLRE 259,A00,891868,Patel; Hemal,9998,0,9999,1
1746587175180,CLRE 260,A00,891872,Cuomo; Raphael Eduardo,9999,0,9999,0
1746587176208,CLRE 297,001,891888,Cuomo; Raphael Eduardo,9999,0,9999,0
1746587177233,CSE 191,A00,958773,Minnes Kemp; Mor Mia,9995,0,9999,4
1746587178259,CSE 197,001,959846,Minnes Kemp; Mor Mia,9990,0,9999,9
1746587179286,CSS 201S,A01,892054,Mignozzetti; Umberto,25,0,30,5
1746587180311,CSS 202S,A01,892056,Mignozzetti; Umberto,25,0,30,5
1746587181337,DSC 197,001,956898,Eldridge; Justin Matthew,9996,0,9999,3
1746587182361,DSC 297,001,958000,Mazumdar; Arya,9998,0,9999,1
1746587182361,DSC 297,002,959862,Wang; Yusu,9998,0,9999,1
1746587183386,EAP 100,A00,905686,Staff,9778,0,9999,221
1746587184416,ECE 45,A01,892618,Staff,0,0,65,65
1746587186465,ECE 111,A01,892719,Staff,6,0,65,59
1746587187492,ECE 197,001,957920,Mercier; Patrick Philip,9991,0,9999,8
1746587188516,ECON 178,A01,907814,Zhu; Ying,26,0,35,9
1746587189545,EDS 115,A00,895312,Staff,35,0,45,10
1746587190574,EDS 117,A01,895337,Staff,23,0,30,7
1746587191601,EDS 125,A00,895341,Jones; Gabrielle Anastasia,36,0,45,9
1746587192632,EDS 128A,A01,895459,Fargason; Sharon Gayle,44,0,45,1
1746587193658,EDS 128B,A01,895543,Pappas; Elizabeth,44,0,45,1
1746587194684,EDS 139,A00,897203,Pappas; Elizabeth,44,0,45,1
1746587194684,EDS 139,B00,897209,Fargason; Sharon Gayle,41,0,45,4
1746587195711,EDS 201,A00,895545,Staff,22,0,45,23
1746587196740,EDS 203,A01,895581,Halter; Christopher P.,22,0,45,23
1746587197765,EDS 204R,A01,895625,Heinzman; Erica M.,39,0,45,6
1746587197765,EDS 204R,B01,895693,Halter; Christopher P.,10,0,45,35
1746587198794,EDS 206R,A00,895694,Fargason; Sharon Gayle,1,0,30,29
1746587198794,EDS 206R,B00,895695,Choi; Bailey Miyeon,16,0,30,14
1746587199819,EDS 250,A00,895697,Hemans; Patricia Ann Benitez,22,0,45,23
1746587200848,EDS 281,A00,895701,Meyerott; Theresa Ann,1,0,15,14
1746587201876,EDS 284,A00,895736,Meyerott; Theresa Ann,1,0,15,14
1746587202904,EDS 286,A00,897210,Fine; Sarah,0,0,15,15
1746587203930,EDS 289C,A01,895770,Daly; Alan J.,1,0,15,14
1746587204959,EDS 290,A00,897211,Hofstetter; Carolyn,0,0,15,15
1746587205987,LIGM 5A,A00,896162,Fischer-Grunski; Eva K,12,0,20,8
1746587207019,LIGM 5B,A00,896260,Fischer-Grunski; Eva K,17,0,20,3
1746587208048,LIGM 5C,A00,896308,Fischer-Grunski; Eva K,18,0,20,2
1746587209073,LIIT 5AS,A00,896313,Carnelos; Chiara,18,0,20,2
1746587210099,LIIT 5BS,A00,896416,Carnelos; Chiara,20,0,20,0
1746587211128,LIIT 5CS,A00,896564,Carnelos; Chiara,20,0,20,0
1746587212158,LISP 5A,A00,896588,Munoz Sanchez; Alicia,2,0,20,18
1746587213183,LISP 5B,A00,896653,Munoz Sanchez; Alicia,7,0,20,13
1746587214209,LISP 5C,A00,896655,Munoz Sanchez; Alicia,0,1,20,20
1746587215235,MAE 197,001,957918,Kleissl; Jan,9996,0,9999,3
1746587215235,MAE 197,002,959806,Boechler; Nicholas Sebastia,9998,0,9999,1
1746587215235,MAE 197,003,959852,Mullin; Jennifer S,9998,0,9999,1
1746587216264,MATH 2,A01,957937,Staff,33,0,35,2
1746587217289,MATH 197,001,957876,Kedlaya; Kiran S.,9993,0,9999,6
1746587218326,MCWP 40,A00,892729,Duru; Nur,10,0,20,10
1746587218326,MCWP 40,B00,893304,Montejo; Carolina,14,0,20,6
1746587219356,MCWP 40R,A00,893757,Redela; Pamela Morgan,0,5,20,20
1746587220400,MCWP 50,A00,893758,Morshed; Michael James,0,0,20,20
1746587220400,MCWP 50,B00,893761,Bartulis; Jason Michael,17,0,20,3
1746587221429,MCWP 50R,A00,893766,Compas; Sean Matthew,0,1,20,20
1746587221429,MCWP 50R,B00,893769,Carter; Jennifer A,0,1,20,20
1746587221429,MCWP 50R,C00,893771,Krone; Jarret,0,3,20,20
1746587221429,MCWP 50R,D00,893772,Miller; Elizabeth Deen,0,0,20,20
1746587221429,MCWP 50R,E00,893775,Carter; Andrea L,0,1,20,20
1746587222456,MMW 11R,A01,892721,Herbst; Matthew,14,0,30,16
1746587222456,MMW 11R,A02,892722,Herbst; Matthew,0,0,0,3
1746587223485,MMW 12R,A01,892724,Herbst; Matthew,0,11,16,16
1746587223485,MMW 12R,A02,892725,Herbst; Matthew,0,10,16,16
1746587224510,MMW 13R,A01,892727,Staff,0,4,16,16
1746587224510,MMW 13R,A02,892728,Staff,0,4,16,16
1746587224510,MMW 13R,A03,958032,Staff,0,4,16,16
1746587224510,MMW 13R,A04,958033,Staff,0,4,16,16
1746587224510,MMW 13R,A05,958034,Staff,0,4,16,16
1746587225536,SIO 295LS,A00,894015,Staff,5,0,25,20
1746587226561,SIO 295S,A00,894020,Staff,5,0,25,20
1746587227587,SIOC 290S,B01,958918,Merrifield; Mark A,14,0,30,16
1746587228617,SIOC 291S,B01,958922,Gabriel; Corey John,14,0,30,16
1746587229644,SOCI 117,A01,895339,Staff,3,0,5,2
1746587230674,WES 237B,A00,894149,Staff,11,0,20,9
1746587232734,AESE 279B,A00,891859,Staff,13,0,35,22
1746587233758,AIP 197,001,891854,Vespa; Emanuel Ignacio,9999,0,9999,0
1746587234786,ANTH 289S,A00,891856,Gagneux; Pascal,12,0,12,0
1746587235811,BENG 196,001,957946,Engler; Adam J.,9996,0,9999,3
1746587236836,BISP 197,001,959851,Wilhelm; James E.,9998,0,9999,1
1746587237860,CAT 124RS,A01,956906,Staff,6,0,25,19
1746587238888,CAT 125RS,A01,922013,Staff,6,0,25,19
1746587239915,CLRE 250,A00,891860,Morris; Sheldon,9995,0,9999,4
1746587241972,CLRE 251R,A00,907817,Mehta; Ravindra L.,9994,0,9999,5
1746587242996,CLRE 252,A00,891864,Cuomo; Raphael Eduardo,9993,0,9999,6
1746587244023,CLRE 253,A00,891867,Vaida; Florin,9994,0,9999,5
1746587244023,CLRE 253,B00,907819,Staff,9999,0,9999,0
1746587245050,CLRE 259,A00,891868,Patel; Hemal,9998,0,9999,1
1746587246074,CLRE 260,A00,891872,Cuomo; Raphael Eduardo,9999,0,9999,0
1746587247101,CLRE 297,001,891888,Cuomo; Raphael Eduardo,9999,0,9999,0
1746587248128,CSE 191,A00,958773,Minnes Kemp; Mor Mia,9995,0,9999,4
1746587249155,CSE 197,001,959846,Minnes Kemp; Mor Mia,9990,0,9999,9
1746587250186,CSS 201S,A01,892054,Mignozzetti; Umberto,25,0,30,5
1746587251211,CSS 202S,A01,892056,Mignozzetti; Umberto,25,0,30,5
1746587252239,DSC 197,001,956898,Eldridge; Justin Matthew,9996,0,9999,3
1746587253264,DSC 297,001,958000,Mazumdar; Arya,9998,0,9999,1
1746587253264,DSC 297,002,959862,Wang; Yusu,9998,0,9999,1
1746587254289,EAP 100,A00,905686,Staff,9778,0,9999,221
1746587255318,ECE 45,A01,892618,Staff,0,0,65,65
1746587257367,ECE 111,A01,892719,Staff,6,0,65,59
1746587258393,ECE 197,001,957920,Mercier; Patrick Philip,9991,0,9999,8
1746587259424,ECON 178,A01,907814,Zhu; Ying,26,0,35,9
1746587260450,EDS 115,A00,895312,Staff,35,0,45,10
1746587261477,EDS 117,A01,895337,Staff,23,0,30,7
1746587262501,EDS 125,A00,895341,Jones; Gabrielle Anastasia,36,0,45,9
1746587263526,EDS 128A,A01,895459,Fargason; Sharon Gayle,44,0,45,1
1746587264551,EDS 128B,A01,895543,Pappas; Elizabeth,44,0,45,1
1746587265576,EDS 139,A00,897203,Pappas; Elizabeth,44,0,45,1
1746587265576,EDS 139,B00,897209,Fargason; Sharon Gayle,41,0,45,4
1746587266606,EDS 201,A00,895545,Staff,22,0,45,23
1746587267635,EDS 203,A01,895581,Halter; Christopher P.,22,0,45,23
1746587268663,EDS 204R,A01,895625,Heinzman; Erica M.,39,0,45,6
1746587268663,EDS 204R,B01,895693,Halter; Christopher P.,10,0,45,35
1746587269690,EDS 206R,A00,895694,Fargason; Sharon Gayle,1,0,30,29
1746587269690,EDS 206R,B00,895695,Choi; Bailey Miyeon,16,0,30,14
1746587270715,EDS 250,A00,895697,Hemans; Patricia Ann Benitez,22,0,45,23
1746587271742,EDS 281,A00,895701,Meyerott; Theresa Ann,1,0,15,14
1746587272766,EDS 284,A00,895736,Meyerott; Theresa Ann,1,0,15,14
1746587273796,EDS 286,A00,897210,Fine; Sarah,0,0,15,15
1746587274820,EDS 289C,A01,895770,Daly; Alan J.,1,0,15,14
1746587275871,EDS 290,A00,897211,Hofstetter; Carolyn,0,0,15,15
1746587276901,LIGM 5A,A00,896162,Fischer-Grunski; Eva K,12,0,20,8
1746587277932,LIGM 5B,A00,896260,Fischer-Grunski; Eva K,17,0,20,3
1746587278956,LIGM 5C,A00,896308,Fischer-Grunski; Eva K,18,0,20,2
1746587279989,LIIT 5AS,A00,896313,Carnelos; Chiara,18,0,20,2
1746587281019,LIIT 5BS,A00,896416,Carnelos; Chiara,20,0,20,0
1746587282049,LIIT 5CS,A00,896564,Carnelos; Chiara,20,0,20,0
1746587283073,LISP 5A,A00,896588,Munoz Sanchez; Alicia,2,0,20,18
1746587284098,LISP 5B,A00,896653,Munoz Sanchez; Alicia,7,0,20,13
1746587285127,LISP 5C,A00,896655,Munoz Sanchez; Alicia,0,1,20,20
1746587286152,MAE 197,001,957918,Kleissl; Jan,9996,0,9999,3
1746587286152,MAE 197,002,959806,Boechler; Nicholas Sebastia,9998,0,9999,1
1746587286152,MAE 197,003,959852,Mullin; Jennifer S,9998,0,9999,1
1746587287203,MATH 2,A01,957937,Staff,33,0,35,2
1746587288228,MATH 197,001,957876,Kedlaya; Kiran S.,9993,0,9999,6
1746587289258,MCWP 40,A00,892729,Duru; Nur,10,0,20,10
1746587289258,MCWP 40,B00,893304,Montejo; Carolina,14,0,20,6
1746587290289,MCWP 40R,A00,893757,Redela; Pamela Morgan,0,5,20,20
1746587291318,MCWP 50,A00,893758,Morshed; Michael James,0,0,20,20
1746587291318,MCWP 50,B00,893761,Bartulis; Jason Michael,17,0,20,3
1746587292347,MCWP 50R,A00,893766,Compas; Sean Matthew,0,1,20,20
1746587292347,MCWP 50R,B00,893769,Carter; Jennifer A,0,1,20,20
1746587292347,MCWP 50R,C00,893771,Krone; Jarret,0,3,20,20
1746587292347,MCWP 50R,D00,893772,Miller; Elizabeth Deen,0,0,20,20
1746587292347,MCWP 50R,E00,893775,Carter; Andrea L,0,1,20,20
1746587293373,MMW 11R,A01,892721,Herbst; Matthew,14,0,30,16
1746587293373,MMW 11R,A02,892722,Herbst; Matthew,0,0,0,3
1746587294402,MMW 12R,A01,892724,Herbst; Matthew,0,11,16,16
1746587294402,MMW 12R,A02,892725,Herbst; Matthew,0,10,16,16
1746587295429,MMW 13R,A01,892727,Staff,0,4,16,16
1746587295429,MMW 13R,A02,892728,Staff,0,4,16,16
1746587295429,MMW 13R,A03,958032,Staff,0,4,16,16
1746587295429,MMW 13R,A04,958033,Staff,0,4,16,16
1746587295429,MMW 13R,A05,958034,Staff,0,4,16,16
1746587296455,SIO 295LS,A00,894015,Staff,5,0,25,20
1746587297484,SIO 295S,A00,894020,Staff,5,0,25,20
1746587298509,SIOC 290S,B01,958918,Merrifield; Mark A,14,0,30,16
1746587299535,SIOC 291S,B01,958922,Gabriel; Corey John,14,0,30,16
1746587300560,SOCI 117,A01,895339,Staff,3,0,5,2
1746587301620,WES 237B,A00,894149,Staff,11,0,20,9
1746587303680,AESE 279B,A00,891859,Staff,13,0,35,22
1746587304707,AIP 197,001,891854,Vespa; Emanuel Ignacio,9999,0,9999,0
1746587305736,ANTH 289S,A00,891856,Gagneux; Pascal,12,0,12,0
1746587306764,BENG 196,001,957946,Engler; Adam J.,9996,0,9999,3
1746587307791,BISP 197,001,959851,Wilhelm; James E.,9998,0,9999,1
1746587308818,CAT 124RS,A01,956906,Staff,6,0,25,19
1746587309848,CAT 125RS,A01,922013,Staff,6,0,25,19
1746587310876,CLRE 250,A00,891860,Morris; Sheldon,9995,0,9999,4
1746587312929,CLRE 251R,A00,907817,Mehta; Ravindra L.,9994,0,9999,5
1746587313955,CLRE 252,A00,891864,Cuomo; Raphael Eduardo,9993,0,9999,6
1746587314982,CLRE 253,A00,891867,Vaida; Florin,9994,0,9999,5
1746587314982,CLRE 253,B00,907819,Staff,9999,0,9999,0
1746587316008,CLRE 259,A00,891868,Patel; Hemal,9998,0,9999,1
1746587317034,CLRE 260,A00,891872,Cuomo; Raphael Eduardo,9999,0,9999,0
1746587318063,CLRE 297,001,891888,Cuomo; Raphael Eduardo,9999,0,9999,0
1746587319089,CSE 191,A00,958773,Minnes Kemp; Mor Mia,9995,0,9999,4
1746587320121,CSE 197,001,959846,Minnes Kemp; Mor Mia,9990,0,9999,9
1746587321170,CSS 201S,A01,892054,Mignozzetti; Umberto,25,0,30,5
1746587322199,CSS 202S,A01,892056,Mignozzetti; Umberto,25,0,30,5
1746587323226,DSC 197,001,956898,Eldridge; Justin Matthew,9996,0,9999,3
1746587324251,DSC 297,001,958000,Mazumdar; Arya,9998,0,9999,1
1746587324251,DSC 297,002,959862,Wang; Yusu,9998,0,9999,1
1746587325280,EAP 100,A00,905686,Staff,9778,0,9999,221
1746587326304,ECE 45,A01,892618,Staff,0,0,65,65
1746587328357,ECE 111,A01,892719,Staff,6,0,65,59
1746587329380,ECE 197,001,957920,Mercier; Patrick Philip,9991,0,9999,8
1746587330413,ECON 178,A01,907814,Zhu; Ying,26,0,35,9
1746587331440,EDS 115,A00,895312,Staff,35,0,45,10
1746587332469,EDS 117,A01,895337,Staff,23,0,30,7
1746587333495,EDS 125,A00,895341,Jones; Gabrielle Anastasia,36,0,45,9
1746587334520,EDS 128A,A01,895459,Fargason; Sharon Gayle,44,0,45,1
1746587335548,EDS 128B,A01,895543,Pappas; Elizabeth,44,0,45,1
1746587336577,EDS 139,A00,897203,Pappas; Elizabeth,44,0,45,1
1746587336577,EDS 139,B00,897209,Fargason; Sharon Gayle,41,0,45,4
1746587337601,EDS 201,A00,895545,Staff,22,0,45,23
1746587338630,EDS 203,A01,895581,Halter; Christopher P.,22,0,45,23
1746587339659,EDS 204R,A01,895625,Heinzman; Erica M.,39,0,45,6
1746587339659,EDS 204R,B01,895693,Halter; Christopher P.,10,0,45,35
1746587340687,EDS 206R,A00,895694,Fargason; Sharon Gayle,1,0,30,29
1746587340687,EDS 206R,B00,895695,Choi; Bailey Miyeon,16,0,30,14
1746587341711,EDS 250,A00,895697,Hemans; Patricia Ann Benitez,22,0,45,23
1746587342735,EDS 281,A00,895701,Meyerott; Theresa Ann,1,0,15,14
1746587343759,EDS 284,A00,895736,Meyerott; Theresa Ann,1,0,15,14
1746587344785,EDS 286,A00,897210,Fine; Sarah,0,0,15,15
1746587345810,EDS 289C,A01,895770,Daly; Alan J.,1,0,15,14
1746587346833,EDS 290,A00,897211,Hofstetter; Carolyn,0,0,15,15
1746587347861,LIGM 5A,A00,896162,Fischer-Grunski; Eva K,12,0,20,8
1746587348892,LIGM 5B,A00,896260,Fischer-Grunski; Eva K,17,0,20,3
1746587349920,LIGM 5C,A00,896308,Fischer-Grunski; Eva K,18,0,20,2
1746587350949,LIIT 5AS,A00,896313,Carnelos; Chiara,18,0,20,2
1746587351973,LIIT 5BS,A00,896416,Carnelos; Chiara,20,0,20,0
1746587353000,LIIT 5CS,A00,896564,Carnelos; Chiara,20,0,20,0
1746587354031,LISP 5A,A00,896588,Munoz Sanchez; Alicia,2,0,20,18
1746587355054,LISP 5B,A00,896653,Munoz Sanchez; Alicia,7,0,20,13
1746587356079,LISP 5C,A00,896655,Munoz Sanchez; Alicia,0,1,20,20
1746587357103,MAE 197,001,957918,Kleissl; Jan,9996,0,9999,3
1746587357103,MAE 197,002,959806,Boechler; Nicholas Sebastia,9998,0,9999,1
1746587357103,MAE 197,003,959852,Mullin; Jennifer S,9998,0,9999,1
1746587358130,MATH 2,A01,957937,Staff,33,0,35,2
1746587359155,MATH 197,001,957876,Kedlaya; Kiran S.,9993,0,9999,6
1746587360181,MCWP 40,A00,892729,Duru; Nur,10,0,20,10
1746587360181,MCWP 40,B00,893304,Montejo; Carolina,14,0,20,6
1746587361208,MCWP 40R,A00,893757,Redela; Pamela Morgan,0,5,20,20
1746587362233,MCWP 50,A00,893758,Morshed; Michael James,0,0,20,20
1746587362233,MCWP 50,B00,893761,Bartulis; Jason Michael,17,0,20,3
1746587363261,MCWP 50R,A00,893766,Compas; Sean Matthew,0,1,20,20
1746587363261,MCWP 50R,B00,893769,Carter; Jennifer A,0,1,20,20
1746587363261,MCWP 50R,C00,893771,Krone; Jarret,0,3,20,20
1746587363261,MCWP 50R,D00,893772,Miller; Elizabeth Deen,0,0,20,20
1746587363261,MCWP 50R,E00,893775,Carter; Andrea L,0,1,20,20
1746587364289,MMW 11R,A01,892721,Herbst; Matthew,14,0,30,16
1746587364289,MMW 11R,A02,892722,Herbst; Matthew,0,0,0,3
1746587365315,MMW 12R,A01,892724,Herbst; Matthew,0,11,16,16
1746587365315,MMW 12R,A02,892725,Herbst; Matthew,0,10,16,16
1746587366343,MMW 13R,A01,892727,Staff,0,4,16,16
1746587366343,MMW 13R,A02,892728,Staff,0,4,16,16
1746587366343,MMW 13R,A03,958032,Staff,0,4,16,16
1746587366343,MMW 13R,A04,958033,Staff,0,4,16,16
1746587366343,MMW 13R,A05,958034,Staff,0,4,16,16
1746587367374,SIO 295LS,A00,894015,Staff,5,0,25,20
1746587368398,SIO 295S,A00,894020,Staff,5,0,25,20
1746587369424,SIOC 290S,B01,958918,Merrifield; Mark A,14,0,30,16
1746587370450,SIOC 291S,B01,958922,Gabriel; Corey John,14,0,30,16
1746587371476,SOCI 117,A01,895339,Staff,3,0,5,2
1746587372501,WES 237B,A00,894149,Staff,11,0,20,9
1746587374570,AESE 279B,A00,891859,Staff,13,0,35,22
1746587375599,AIP 197,001,891854,Vespa; Emanuel Ignacio,9999,0,9999,0
1746587376626,ANTH 289S,A00,891856,Gagneux; Pascal,12,0,12,0
1746587377649,BENG 196,001,957946,Engler; Adam J.,9996,0,9999,3
1746587378677,BISP 197,001,959851,Wilhelm; James E.,9998,0,9999,1
1746587379703,CAT 124RS,A01,956906,Staff,6,0,25,19
1746587380731,CAT 125RS,A01,922013,Staff,6,0,25,19
1746587381760,CLRE 250,A00,891860,Morris; Sheldon,9995,0,9999,4
1746587383811,CLRE 251R,A00,907817,Mehta; Ravindra L.,9994,0,9999,5
1746587384836,CLRE 252,A00,891864,Cuomo; Raphael Eduardo,9993,0,9999,6
1746587385861,CLRE 253,A00,891867,Vaida; Florin,9994,0,9999,5
1746587385861,CLRE 253,B00,907819,Staff,9999,0,9999,0
1746587386885,CLRE 259,A00,891868,Patel; Hemal,9998,0,9999,1
1746587387911,CLRE 260,A00,891872,Cuomo; Raphael Eduardo,9999,0,9999,0
1746587388939,CLRE 297,001,891888,Cuomo; Raphael Eduardo,9999,0,9999,0
1746587389968,CSE 191,A00,958773,Minnes Kemp; Mor Mia,9995,0,9999,4
1746587390992,CSE 197,001,959846,Minnes Kemp; Mor Mia,9990,0,9999,9
1746587392023,CSS 201S,A01,892054,Mignozzetti; Umberto,25,0,30,5
1746587393052,CSS 202S,A01,892056,Mignozzetti; Umberto,25,0,30,5
1746587394079,DSC 197,001,956898,Eldridge; Justin Matthew,9996,0,9999,3
1746587395105,DSC 297,001,958000,Mazumdar; Arya,9998,0,9999,1
1746587395105,DSC 297,002,959862,Wang; Yusu,9998,0,9999,1
1746587396133,EAP 100,A00,905686,Staff,9778,0,9999,221
1746587397159,ECE 45,A01,892618,Staff,0,0,65,65
1746587399214,ECE 111,A01,892719,Staff,6,0,65,59
1746587400244,ECE 197,001,957920,Mercier; Patrick Philip,9991,0,9999,8
1746587401273,ECON 178,A01,907814,Zhu; Ying,26,0,35,9
1746587402298,EDS 115,A00,895312,Staff,35,0,45,10
1746587403326,EDS 117,A01,895337,Staff,23,0,30,7
1746587404354,EDS 125,A00,895341,Jones; Gabrielle Anastasia,36,0,45,9
1746587405381,EDS 128A,A01,895459,Fargason; Sharon Gayle,44,0,45,1
1746587406404,EDS 128B,A01,895543,Pappas; Elizabeth,44,0,45,1
1746587407427,EDS 139,A00,897203,Pappas; Elizabeth,44,0,45,1
1746587407427,EDS 139,B00,897209,Fargason; Sharon Gayle,41,0,45,4
1746587408452,EDS 201,A00,895545,Staff,22,0,45,23
1746587409482,EDS 203,A01,895581,Halter; Christopher P.,22,0,45,23
1746587410507,EDS 204R,A01,895625,Heinzman; Erica M.,39,0,45,6
1746587410507,EDS 204R,B01,895693,Halter; Christopher P.,10,0,45,35
1746587411532,EDS 206R,A00,895694,Fargason; Sharon Gayle,1,0,30,29
1746587411532,EDS 206R,B00,895695,Choi; Bailey Miyeon,16,0,30,14
1746587412562,EDS 250,A00,895697,Hemans; Patricia Ann Benitez,22,0,45,23
1746587413589,EDS 281,A00,895701,Meyerott; Theresa Ann,1,0,15,14
1746587414616,EDS 284,A00,895736,Meyerott; Theresa Ann,1,0,15,14
1746587415641,EDS 286,A00,897210,Fine; Sarah,0,0,15,15
1746587416668,EDS 289C,A01,895770,Daly; Alan J.,1,0,15,14
1746587417692,EDS 290,A00,897211,Hofstetter; Carolyn,0,0,15,15
1746587418719,LIGM 5A,A00,896162,Fischer-Grunski; Eva K,12,0,20,8
1746587419744,LIGM 5B,A00,896260,Fischer-Grunski; Eva K,17,0,20,3
1746587420772,LIGM 5C,A00,896308,Fischer-Grunski; Eva K,18,0,20,2
1746587421797,LIIT 5AS,A00,896313,Carnelos; Chiara,18,0,20,2
1746587422825,LIIT 5BS,A00,896416,Carnelos; Chiara,20,0,20,0
1746587423850,LIIT 5CS,A00,896564,Carnelos; Chiara,20,0,20,0
1746587424877,LISP 5A,A00,896588,Munoz Sanchez; Alicia,2,0,20,18
1746587425905,LISP 5B,A00,896653,Munoz Sanchez; Alicia,7,0,20,13
1746587426930,LISP 5C,A00,896655,Munoz Sanchez; Alicia,0,1,20,20
1746587427960,MAE 197,001,957918,Kleissl; Jan,9996,0,9999,3
1746587427960,MAE 197,002,959806,Boechler; Nicholas Sebastia,9998,0,9999,1
1746587427960,MAE 197,003,959852,Mullin; Jennifer S,9998,0,9999,1
1746587428985,MATH 2,A01,957937,Staff,33,0,35,2
1746587430012,MATH 197,001,957876,Kedlaya; Kiran S.,9993,0,9999,6
1746587431038,MCWP 40,A00,892729,Duru; Nur,10,0,20,10
1746587431038,MCWP 40,B00,893304,Montejo; Carolina,14,0,20,6
1746587432070,MCWP 40R,A00,893757,Redela; Pamela Morgan,0,5,20,20
1746587433096,MCWP 50,A00,893758,Morshed; Michael James,0,0,20,20
1746587433096,MCWP 50,B00,893761,Bartulis; Jason Michael,17,0,20,3
1746587434121,MCWP 50R,A00,893766,Compas; Sean Matthew,0,1,20,20
1746587434121,MCWP 50R,B00,893769,Carter; Jennifer A,0,1,20,20
1746587434121,MCWP 50R,C00,893771,Krone; Jarret,0,3,20,20
1746587434121,MCWP 50R,D00,893772,Miller; Elizabeth Deen,0,0,20,20
1746587434121,MCWP 50R,E00,893775,Carter; Andrea L,0,1,20,20
1746587435147,MMW 11R,A01,892721,Herbst; Matthew,14,0,30,16
1746587435147,MMW 11R,A02,892722,Herbst; Matthew,0,0,0,3
1746587436178,MMW 12R,A01,892724,Herbst; Matthew,0,11,16,16
1746587436178,MMW 12R,A02,892725,Herbst; Matthew,0,10,16,16
1746587437204,MMW 13R,A01,892727,Staff,0,4,16,16
1746587437204,MMW 13R,A02,892728,Staff,0,4,16,16
1746587437204,MMW 13R,A03,958032,Staff,0,4,16,16
1746587437204,MMW 13R,A04,958033,Staff,0,4,16,16
1746587437204,MMW 13R,A05,958034,Staff,0,4,16,16
1746587438230,SIO 295LS,A00,894015,Staff,5,0,25,20
1746587439256,SIO 295S,A00,894020,Staff,5,0,25,20
1746587440283,SIOC 290S,B01,958918,Merrifield; Mark A,14,0,30,16
1746587441308,SIOC 291S,B01,958922,Gabriel; Corey John,14,0,30,16
1746587442338,SOCI 117,A01,895339,Staff,3,0,5,2
1746587443364,WES 237B,A00,894149,Staff,11,0,20,9
1746587445426,AESE 279B,A00,891859,Staff,13,0,35,22
1746587446454,AIP 197,001,891854,Vespa; Emanuel Ignacio,9999,0,9999,0
1746587447488,ANTH 289S,A00,891856,Gagneux; Pascal,12,0,12,0
1746587448514,BENG 196,001,957946,Engler; Adam J.,9996,0,9999,3
1746587449539,BISP 197,001,959851,Wilhelm; James E.,9998,0,9999,1
1746587450565,CAT 124RS,A01,956906,Staff,6,0,25,19
1746587451592,CAT 125RS,A01,922013,Staff,6,0,25,19
1746587452617,CLRE 250,A00,891860,Morris; Sheldon,9995,0,9999,4
1746587454675,CLRE 251R,A00,907817,Mehta; Ravindra L.,9994,0,9999,5
1746587455702,CLRE 252,A00,891864,Cuomo; Raphael Eduardo,9993,0,9999,6
1746587456732,CLRE 253,A00,891867,Vaida; Florin,9994,0,9999,5
1746587456732,CLRE 253,B00,907819,Staff,9999,0,9999,0
1746587457759,CLRE 259,A00,891868,Patel; Hemal,9998,0,9999,1
1746587458783,CLRE 260,A00,891872,Cuomo; Raphael Eduardo,9999,0,9999,0
1746587459809,CLRE 297,001,891888,Cuomo; Raphael Eduardo,9999,0,9999,0
1746587460835,CSE 191,A00,958773,Minnes Kemp; Mor Mia,9995,0,9999,4
1746587461861,CSE 197,001,959846,Minnes Kemp; Mor Mia,9990,0,9999,9
1746587462887,CSS 201S,A01,892054,Mignozzetti; Umberto,25,0,30,5
1746587463914,CSS 202S,A01,892056,Mignozzetti; Umberto,25,0,30,5
1746587464941,DSC 197,001,956898,Eldridge; Justin Matthew,9996,0,9999,3
1746587465965,DSC 297,001,958000,Mazumdar; Arya,9998,0,9999,1
1746587465965,DSC 297,002,959862,Wang; Yusu,9998,0,9999,1
1746587466993,EAP 100,A00,905686,Staff,9778,0,9999,221
1746587468024,ECE 45,A01,892618,Staff,0,0,65,65
1746587470083,ECE 111,A01,892719,Staff,6,0,65,59
1746587471110,ECE 197,001,957920,Mercier; Patrick Philip,9991,0,9999,8
1746587472140,ECON 178,A01,907814,Zhu; Ying,26,0,35,9
1746587473169,EDS 115,A00,895312,Staff,35,0,45,10
1746587474198,EDS 117,A01,895337,Staff,23,0,30,7
1746587475224,EDS 125,A00,895341,Jones; Gabrielle Anastasia,36,0,45,9
1746587476251,EDS 128A,A01,895459,Fargason; Sharon Gayle,44,0,45,1
1746587477280,EDS 128B,A01,895543,Pappas; Elizabeth,44,0,45,1
1746587478310,EDS 139,A00,897203,Pappas; Elizabeth,44,0,45,1
1746587478310,EDS 139,B00,897209,Fargason; Sharon Gayle,41,0,45,4
1746587479338,EDS 201,A00,895545,Staff,22,0,45,23
1746587480362,EDS 203,A01,895581,Halter; Christopher P.,22,0,45,23
1746587481388,EDS 204R,A01,895625,Heinzman; Erica M.,39,0,45,6
1746587481388,EDS 204R,B01,895693,Halter; Christopher P.,10,0,45,35
1746587482422,EDS 206R,A00,895694,Fargason; Sharon Gayle,1,0,30,29
1746587482422,EDS 206R,B00,895695,Choi; Bailey Miyeon,16,0,30,14
1746587483447,EDS 250,A00,895697,Hemans; Patricia Ann Benitez,22,0,45,23
1746587484479,EDS 281,A00,895701,Meyerott; Theresa Ann,1,0,15,14
1746587485504,EDS 284,A00,895736,Meyerott; Theresa Ann,1,0,15,14
1746587486532,EDS 286,A00,897210,Fine; Sarah,0,0,15,15
1746587487557,EDS 289C,A01,895770,Daly; Alan J.,1,0,15,14
1746587488584,EDS 290,A00,897211,Hofstetter; Carolyn,0,0,15,15
1746587489615,LIGM 5A,A00,896162,Fischer-Grunski; Eva K,12,0,20,8
1746587490642,LIGM 5B,A00,896260,Fischer-Grunski; Eva K,17,0,20,3
1746587491670,LIGM 5C,A00,896308,Fischer-Grunski; Eva K,18,0,20,2
1746587492695,LIIT 5AS,A00,896313,Carnelos; Chiara,18,0,20,2
1746587493721,LIIT 5BS,A00,896416,Carnelos; Chiara,20,0,20,0
1746587494750,LIIT 5CS,A00,896564,Carnelos; Chiara,20,0,20,0
1746587495775,LISP 5A,A00,896588,Munoz Sanchez; Alicia,2,0,20,18
1746587496804,LISP 5B,A00,896653,Munoz Sanchez; Alicia,7,0,20,13
1746587497831,LISP 5C,A00,896655,Munoz Sanchez; Alicia,0,1,20,20
1746587498858,MAE 197,001,957918,Kleissl; Jan,9996,0,9999,3
1746587498858,MAE 197,002,959806,Boechler; Nicholas Sebastia,9998,0,9999,1
1746587498858,MAE 197,003,959852,Mullin; Jennifer S,9998,0,9999,1
1746587499884,MATH 2,A01,957937,Staff,33,0,35,2
1746587500910,MATH 197,001,957876,Kedlaya; Kiran S.,9993,0,9999,6
1746587501936,MCWP 40,A00,892729,Duru; Nur,10,0,20,10
1746587501936,MCWP 40,B00,893304,Montejo; Carolina,14,0,20,6
1746587502966,MCWP 40R,A00,893757,Redela; Pamela Morgan,0,5,20,20
1746587503992,MCWP 50,A00,893758,Morshed; Michael James,0,0,20,20
1746587503992,MCWP 50,B00,893761,Bartulis; Jason Michael,17,0,20,3
1746587505025,MCWP 50R,A00,893766,Compas; Sean Matthew,0,1,20,20
1746587505025,MCWP 50R,B00,893769,Carter; Jennifer A,0,1,20,20
1746587505025,MCWP 50R,C00,893771,Krone; Jarret,0,3,20,20
1746587505025,MCWP 50R,D00,893772,Miller; Elizabeth Deen,0,0,20,20
1746587505025,MCWP 50R,E00,893775,Carter; Andrea L,0,1,20,20
1746587506058,MMW 11R,A01,892721,Herbst; Matthew,14,0,30,16
1746587506058,MMW 11R,A02,892722,Herbst; Matthew,0,0,0,3
1746587507083,MMW 12R,A01,892724,Herbst; Matthew,0,11,16,16
1746587507083,MMW 12R,A02,892725,Herbst; Matthew,0,10,16,16
1746587508109,MMW 13R,A01,892727,Staff,0,4,16,16
1746587508109,MMW 13R,A02,892728,Staff,0,4,16,16
1746587508109,MMW 13R,A03,958032,Staff,0,4,16,16
1746587508109,MMW 13R,A04,958033,Staff,0,4,16,16
1746587508109,MMW 13R,A05,958034,Staff,0,4,16,16
1746587509138,SIO 295LS,A00,894015,Staff,5,0,25,20
1746587510168,SIO 295S,A00,894020,Staff,5,0,25,20
1746587511193,SIOC 290S,B01,958918,Merrifield; Mark A,14,0,30,16
1746587512224,SIOC 291S,B01,958922,Gabriel; Corey John,14,0,30,16
1746587513251,SOCI 117,A01,895339,Staff,3,0,5,2
1746587514276,WES 237B,A00,894149,Staff,11,0,20,9
1746587516341,AESE 279B,A00,891859,Staff,13,0,35,22
1746587517370,AIP 197,001,891854,Vespa; Emanuel Ignacio,9999,0,9999,0
1746587518395,ANTH 289S,A00,891856,Gagneux; Pascal,12,0,12,0
1746587519420,BENG 196,001,957946,Engler; Adam J.,9996,0,9999,3
1746587520450,BISP 197,001,959851,Wilhelm; James E.,9998,0,9999,1
1746587521475,CAT 124RS,A01,956906,Staff,6,0,25,19
1746587522505,CAT 125RS,A01,922013,Staff,6,0,25,19
1746587523530,CLRE 250,A00,891860,Morris; Sheldon,9995,0,9999,4
1746587525593,CLRE 251R,A00,907817,Mehta; Ravindra L.,9994,0,9999,5
1746587526624,CLRE 252,A00,891864,Cuomo; Raphael Eduardo,9993,0,9999,6
1746587527654,CLRE 253,A00,891867,Vaida; Florin,9994,0,9999,5
1746587527654,CLRE 253,B00,907819,Staff,9999,0,9999,0
1746587528681,CLRE 259,A00,891868,Patel; Hemal,9998,0,9999,1
1746587529707,CLRE 260,A00,891872,Cuomo; Raphael Eduardo,9999,0,9999,0
1746587530734,CLRE 297,001,891888,Cuomo; Raphael Eduardo,9999,0,9999,0
1746587531760,CSE 191,A00,958773,Minnes Kemp; Mor Mia,9995,0,9999,4
1746587532789,CSE 197,001,959846,Minnes Kemp; Mor Mia,9990,0,9999,9
1746587533820,CSS 201S,A01,892054,Mignozzetti; Umberto,25,0,30,5
1746587534849,CSS 202S,A01,892056,Mignozzetti; Umberto,25,0,30,5
1746587535878,DSC 197,001,956898,Eldridge; Justin Matthew,9996,0,9999,3
1746587536908,DSC 297,001,958000,Mazumdar; Arya,9998,0,9999,1
1746587536908,DSC 297,002,959862,Wang; Yusu,9998,0,9999,1
1746587537937,EAP 100,A00,905686,Staff,9778,0,9999,221
1746587538964,ECE 45,A01,892618,Staff,0,0,65,65
1746587541016,ECE 111,A01,892719,Staff,6,0,65,59
1746587542046,ECE 197,001,957920,Mercier; Patrick Philip,9991,0,9999,8
1746587543076,ECON 178,A01,907814,Zhu; Ying,26,0,35,9
1746587544106,EDS 115,A00,895312,Staff,35,0,45,10
1746587545131,EDS 117,A01,895337,Staff,23,0,30,7
1746587546160,EDS 125,A00,895341,Jones; Gabrielle Anastasia,36,0,45,9
1746587547190,EDS 128A,A01,895459,Fargason; Sharon Gayle,44,0,45,1
1746587548222,EDS 128B,A01,895543,Pappas; Elizabeth,44,0,45,1
1746587549247,EDS 139,A00,897203,Pappas; Elizabeth,44,0,45,1
1746587549247,EDS 139,B00,897209,Fargason; Sharon Gayle,41,0,45,4
1746587550276,EDS 201,A00,895545,Staff,22,0,45,23
1746587551301,EDS 203,A01,895581,Halter; Christopher P.,22,0,45,23
1746587552326,EDS 204R,A01,895625,Heinzman; Erica M.,39,0,45,6
1746587552326,EDS 204R,B01,895693,Halter; Christopher P.,10,0,45,35
1746587553352,EDS 206R,A00,895694,Fargason; Sharon Gayle,1,0,30,29
1746587553352,EDS 206R,B00,895695,Choi; Bailey Miyeon,16,0,30,14
1746587554377,EDS 250,A00,895697,Hemans; Patricia Ann Benitez,22,0,45,23
1746587555401,EDS 281,A00,895701,Meyerott; Theresa Ann,1,0,15,14
1746587556432,EDS 284,A00,895736,Meyerott; Theresa Ann,1,0,15,14
1746587557460,EDS 286,A00,897210,Fine; Sarah,0,0,15,15
1746587558486,EDS 289C,A01,895770,Daly; Alan J.,1,0,15,14
1746587559513,EDS 290,A00,897211,Hofstetter; Carolyn,0,0,15,15
1746587560539,LIGM 5A,A00,896162,Fischer-Grunski; Eva K,12,0,20,8
1746587561564,LIGM 5B,A00,896260,Fischer-Grunski; Eva K,17,0,20,3
1746587562593,LIGM 5C,A00,896308,Fischer-Grunski; Eva K,18,0,20,2
1746587563620,LIIT 5AS,A00,896313,Carnelos; Chiara,18,0,20,2
1746587564650,LIIT 5BS,A00,896416,Carnelos; Chiara,20,0,20,0
1746587565674,LIIT 5CS,A00,896564,Carnelos; Chiara,20,0,20,0
1746587566699,LISP 5A,A00,896588,Munoz Sanchez; Alicia,2,0,20,18
1746587567724,LISP 5B,A00,896653,Munoz Sanchez; Alicia,7,0,20,13
1746587568753,LISP 5C,A00,896655,Munoz Sanchez; Alicia,0,1,20,20
1746587569782,MAE 197,001,957918,Kleissl; Jan,9996,0,9999,3
1746587569782,MAE 197,002,959806,Boechler; Nicholas Sebastia,9998,0,9999,1
1746587569782,MAE 197,003,959852,Mullin; Jennifer S,9998,0,9999,1
1746587570808,MATH 2,A01,957937,Staff,33,0,35,2
1746587571834,MATH 197,001,957876,Kedlaya; Kiran S.,9993,0,9999,6
1746587572859,MCWP 40,A00,892729,Duru; Nur,10,0,20,10
1746587572859,MCWP 40,B00,893304,Montejo; Carolina,14,0,20,6
1746587573887,MCWP 40R,A00,893757,Redela; Pamela Morgan,0,5,20,20
1746587574914,MCWP 50,A00,893758,Morshed; Michael James,0,0,20,20
1746587574914,MCWP 50,B00,893761,Bartulis; Jason Michael,17,0,20,3
1746587575944,MCWP 50R,A00,893766,Compas; Sean Matthew,0,1,20,20
1746587575944,MCWP 50R,B00,893769,Carter; Jennifer A,0,1,20,20
1746587575944,MCWP 50R,C00,893771,Krone; Jarret,0,3,20,20
1746587575944,MCWP 50R,D00,893772,Miller; Elizabeth Deen,0,0,20,20
1746587575944,MCWP 50R,E00,893775,Carter; Andrea L,0,1,20,20
1746587576970,MMW 11R,A01,892721,Herbst; Matthew,14,0,30,16
1746587576970,MMW 11R,A02,892722,Herbst; Matthew,0,0,0,3
1746587577995,MMW 12R,A01,892724,Herbst; Matthew,0,11,16,16
1746587577995,MMW 12R,A02,892725,Herbst; Matthew,0,10,16,16
1746587579023,MMW 13R,A01,892727,Staff,0,4,16,16
1746587579023,MMW 13R,A02,892728,Staff,0,4,16,16
1746587579023,MMW 13R,A03,958032,Staff,0,4,16,16
1746587579023,MMW 13R,A04,958033,Staff,0,4,16,16
1746587579023,MMW 13R,A05,958034,Staff,0,4,16,16
1746587580048,SIO 295LS,A00,894015,Staff,5,0,25,20
1746587581072,SIO 295S,A00,894020,Staff,5,0,25,20
1746587582109,SIOC 290S,B01,958918,Merrifield; Mark A,14,0,30,16
1746587583135,SIOC 291S,B01,958922,Gabriel; Corey John,14,0,30,16
1746587584172,SOCI 117,A01,895339,Staff,3,0,5,2
1746587585198,WES 237B,A00,894149,Staff,11,0,20,9
1746587587265,AESE 279B,A00,891859,Staff,13,0,35,22
1746587588290,AIP 197,001,891854,Vespa; Emanuel Ignacio,9999,0,9999,0
1746587589319,ANTH 289S,A00,891856,Gagneux; Pascal,12,0,12,0
1746587590348,BENG 196,001,957946,Engler; Adam J.,9996,0,9999,3
1746587591377,BISP 197,001,959851,Wilhelm; James E.,9998,0,9999,1
1746587592407,CAT 124RS,A01,956906,Staff,6,0,25,19
1746587593431,CAT 125RS,A01,922013,Staff,6,0,25,19
1746587594460,CLRE 250,A00,891860,Morris; Sheldon,9995,0,9999,4
1746587596519,CLRE 251R,A00,907817,Mehta; Ravindra L.,9994,0,9999,5
1746587597544,CLRE 252,A00,891864,Cuomo; Raphael Eduardo,9993,0,9999,6
1746587598571,CLRE 253,A00,891867,Vaida; Florin,9994,0,9999,5
1746587598571,CLRE 253,B00,907819,Staff,9999,0,9999,0
1746587599596,CLRE 259,A00,891868,Patel; Hemal,9998,0,9999,1
1746587600623,CLRE 260,A00,891872,Cuomo; Raphael Eduardo,9999,0,9999,0
1746587601648,CLRE 297,001,891888,Cuomo; Raphael Eduardo,9999,0,9999,0
1746587602673,CSE 191,A00,958773,Minnes Kemp; Mor Mia,9995,0,9999,4
1746587603700,CSE 197,001,959846,Minnes Kemp; Mor Mia,9990,0,9999,9
1746587604728,CSS 201S,A01,892054,Mignozzetti; Umberto,25,0,30,5
1746587605757,CSS 202S,A01,892056,Mignozzetti; Umberto,25,0,30,5
1746587606783,DSC 197,001,956898,Eldridge; Justin Matthew,9996,0,9999,3
1746587607808,DSC 297,001,958000,Mazumdar; Arya,9998,0,9999,1
1746587607808,DSC 297,002,959862,Wang; Yusu,9998,0,9999,1
1746587608838,EAP 100,A00,905686,Staff,9778,0,9999,221
1746587609866,ECE 45,A01,892618,Staff,0,0,65,65
1746587611922,ECE 111,A01,892719,Staff,6,0,65,59
1746587612950,ECE 197,001,957920,Mercier; Patrick Philip,9991,0,9999,8
1746587613979,ECON 178,A01,907814,Zhu; Ying,26,0,35,9
1746587615005,EDS 115,A00,895312,Staff,35,0,45,10
1746587616030,EDS 117,A01,895337,Staff,23,0,30,7
1746587617056,EDS 125,A00,895341,Jones; Gabrielle Anastasia,36,0,45,9
1746587618084,EDS 128A,A01,895459,Fargason; Sharon Gayle,44,0,45,1
1746587619110,EDS 128B,A01,895543,Pappas; Elizabeth,44,0,45,1
1746587620137,EDS 139,A00,897203,Pappas; Elizabeth,44,0,45,1
1746587620137,EDS 139,B00,897209,Fargason; Sharon Gayle,41,0,45,4
1746587621165,EDS 201,A00,895545,Staff,22,0,45,23
1746587622192,EDS 203,A01,895581,Halter; Christopher P.,22,0,45,23
1746587623218,EDS 204R,A01,895625,Heinzman; Erica M.,39,0,45,6
1746587623218,EDS 204R,B01,895693,Halter; Christopher P.,10,0,45,35
1746587624243,EDS 206R,A00,895694,Fargason; Sharon Gayle,1,0,30,29
1746587624243,EDS 206R,B00,895695,Choi; Bailey Miyeon,16,0,30,14
1746587625268,EDS 250,A00,895697,Hemans; Patricia Ann Benitez,22,0,45,23
1746587626294,EDS 281,A00,895701,Meyerott; Theresa Ann,1,0,15,14
1746587627322,EDS 284,A00,895736,Meyerott; Theresa Ann,1,0,15,14
1746587628347,EDS 286,A00,897210,Fine; Sarah,0,0,15,15
1746587629372,EDS 289C,A01,895770,Daly; Alan J.,1,0,15,14
1746587630398,EDS 290,A00,897211,Hofstetter; Carolyn,0,0,15,15
1746587631423,LIGM 5A,A00,896162,Fischer-Grunski; Eva K,12,0,20,8
1746587632451,LIGM 5B,A00,896260,Fischer-Grunski; Eva K,17,0,20,3
1746587633477,LIGM 5C,A00,896308,Fischer-Grunski; Eva K,18,0,20,2
1746587634501,LIIT 5AS,A00,896313,Carnelos; Chiara,18,0,20,2
1746587635528,LIIT 5BS,A00,896416,Carnelos; Chiara,20,0,20,0
1746587636557,LIIT 5CS,A00,896564,Carnelos; Chiara,20,0,20,0
1746587637587,LISP 5A,A00,896588,Munoz Sanchez; Alicia,2,0,20,18
1746587638612,LISP 5B,A00,896653,Munoz Sanchez; Alicia,7,0,20,13
1746587639638,LISP 5C,A00,896655,Munoz Sanchez; Alicia,0,1,20,20
1746587640666,MAE 197,001,957918,Kleissl; Jan,9996,0,9999,3
1746587640666,MAE 197,002,959806,Boechler; Nicholas Sebastia,9998,0,9999,1
1746587640666,MAE 197,003,959852,Mullin; Jennifer S,9998,0,9999,1
1746587641691,MATH 2,A01,957937,Staff,33,0,35,2
1746587642720,MATH 197,001,957876,Kedlaya; Kiran S.,9993,0,9999,6
1746587643750,MCWP 40,A00,892729,Duru; Nur,10,0,20,10
1746587643750,MCWP 40,B00,893304,Montejo; Carolina,14,0,20,6
1746587644776,MCWP 40R,A00,893757,Redela; Pamela Morgan,0,5,20,20
1746587645802,MCWP 50,A00,893758,Morshed; Michael James,0,0,20,20
1746587645802,MCWP 50,B00,893761,Bartulis; Jason Michael,17,0,20,3
1746587646834,MCWP 50R,A00,893766,Compas; Sean Matthew,0,1,20,20
1746587646834,MCWP 50R,B00,893769,Carter; Jennifer A,0,1,20,20
1746587646834,MCWP 50R,C00,893771,Krone; Jarret,0,3,20,20
1746587646834,MCWP 50R,D00,893772,Miller; Elizabeth Deen,0,0,20,20
1746587646834,MCWP 50R,E00,893775,Carter; Andrea L,0,1,20,20
1746587647860,MMW 11R,A01,892721,Herbst; Matthew,14,0,30,16
1746587647860,MMW 11R,A02,892722,Herbst; Matthew,0,0,0,3
1746587648891,MMW 12R,A01,892724,Herbst; Matthew,0,11,16,16
1746587648891,MMW 12R,A02,892725,Herbst; Matthew,0,10,16,16
1746587649919,MMW 13R,A01,892727,Staff,0,4,16,16
1746587649919,MMW 13R,A02,892728,Staff,0,4,16,16
1746587649919,MMW 13R,A03,958032,Staff,0,4,16,16
1746587649919,MMW 13R,A04,958033,Staff,0,4,16,16
1746587649919,MMW 13R,A05,958034,Staff,0,4,16,16
1746587650945,SIO 295LS,A00,894015,Staff,5,0,25,20
1746587651970,SIO 295S,A00,894020,Staff,5,0,25,20
1746587653002,SIOC 290S,B01,958918,Merrifield; Mark A,14,0,30,16
1746587654029,SIOC 291S,B01,958922,Gabriel; Corey John,14,0,30,16
1746587655054,SOCI 117,A01,895339,Staff,3,0,5,2
1746587656084,WES 237B,A00,894149,Staff,11,0,20,9
1746587658161,AESE 279B,A00,891859,Staff,13,0,35,22
1746587659185,AIP 197,001,891854,Vespa; Emanuel Ignacio,9999,0,9999,0
1746587660212,ANTH 289S,A00,891856,Gagneux; Pascal,12,0,12,0
1746587661238,BENG 196,001,957946,Engler; Adam J.,9996,0,9999,3
1746587662262,BISP 197,001,959851,Wilhelm; James E.,9998,0,9999,1
1746587663290,CAT 124RS,A01,956906,Staff,6,0,25,19
1746587664318,CAT 125RS,A01,922013,Staff,6,0,25,19
1746587665346,CLRE 250,A00,891860,Morris; Sheldon,9995,0,9999,4
1746587667401,CLRE 251R,A00,907817,Mehta; Ravindra L.,9994,0,9999,5
1746587668430,CLRE 252,A00,891864,Cuomo; Raphael Eduardo,9993,0,9999,6
1746587669456,CLRE 253,A00,891867,Vaida; Florin,9994,0,9999,5
1746587669456,CLRE 253,B00,907819,Staff,9999,0,9999,0
1746587670481,CLRE 259,A00,891868,Patel; Hemal,9998,0,9999,1
1746587671508,CLRE 260,A00,891872,Cuomo; Raphael Eduardo,9999,0,9999,0
1746587672533,CLRE 297,001,891888,Cuomo; Raphael Eduardo,9999,0,9999,0
1746587673559,CSE 191,A00,958773,Minnes Kemp; Mor Mia,9995,0,9999,4
1746587674583,CSE 197,001,959846,Minnes Kemp; Mor Mia,9990,0,9999,9
1746587675615,CSS 201S,A01,892054,Mignozzetti; Umberto,25,0,30,5
1746587676642,CSS 202S,A01,892056,Mignozzetti; Umberto,25,0,30,5
1746587677670,DSC 197,001,956898,Eldridge; Justin Matthew,9996,0,9999,3
1746587678699,DSC 297,001,958000,Mazumdar; Arya,9998,0,9999,1
1746587678699,DSC 297,002,959862,Wang; Yusu,9998,0,9999,1
1746587679728,EAP 100,A00,905686,Staff,9778,0,9999,221
1746587680756,ECE 45,A01,892618,Staff,0,0,65,65
1746587682812,ECE 111,A01,892719,Staff,6,0,65,59
1746587683846,ECE 197,001,957920,Mercier; Patrick Philip,9991,0,9999,8
1746587684877,ECON 178,A01,907814,Zhu; Ying,26,0,35,9
1746587685903,EDS 115,A00,895312,Staff,35,0,45,10
1746587686933,EDS 117,A01,895337,Staff,23,0,30,7
1746587687963,EDS 125,A00,895341,Jones; Gabrielle Anastasia,36,0,45,9
1746587688989,EDS 128A,A01,895459,Fargason; Sharon Gayle,44,0,45,1
1746587690015,EDS 128B,A01,895543,Pappas; Elizabeth,44,0,45,1
1746587691042,EDS 139,A00,897203,Pappas; Elizabeth,44,0,45,1
1746587691042,EDS 139,B00,897209,Fargason; Sharon Gayle,41,0,45,4
1746587692071,EDS 201,A00,895545,Staff,22,0,45,23
1746587693101,EDS 203,A01,895581,Halter; Christopher P.,22,0,45,23
1746587694131,EDS 204R,A01,895625,Heinzman; Erica M.,39,0,45,6
1746587694131,EDS 204R,B01,895693,Halter; Christopher P.,10,0,45,35
1746587695157,EDS 206R,A00,895694,Fargason; Sharon Gayle,1,0,30,29
1746587695157,EDS 206R,B00,895695,Choi; Bailey Miyeon,16,0,30,14
1746587696182,EDS 250,A00,895697,Hemans; Patricia Ann Benitez,22,0,45,23
1746587697208,EDS 281,A00,895701,Meyerott; Theresa Ann,1,0,15,14
1746587698235,EDS 284,A00,895736,Meyerott; Theresa Ann,1,0,15,14
1746587699263,EDS 286,A00,897210,Fine; Sarah,0,0,15,15
1746587700288,EDS 289C,A01,895770,Daly; Alan J.,1,0,15,14
1746587701313,EDS 290,A00,897211,Hofstetter; Carolyn,0,0,15,15
1746587702340,LIGM 5A,A00,896162,Fischer-Grunski; Eva K,12,0,20,8
1746587703364,LIGM 5B,A00,896260,Fischer-Grunski; Eva K,17,0,20,3
1746587704389,LIGM 5C,A00,896308,Fischer-Grunski; Eva K,18,0,20,2
1746587705414,LIIT 5AS,A00,896313,Carnelos; Chiara,18,0,20,2
1746587706440,LIIT 5BS,A00,896416,Carnelos; Chiara,20,0,20,0
1746587707467,LIIT 5CS,A00,896564,Carnelos; Chiara,20,0,20,0
1746587708496,LISP 5A,A00,896588,Munoz Sanchez; Alicia,2,0,20,18
1746587709522,LISP 5B,A00,896653,Munoz Sanchez; Alicia,7,0,20,13
1746587710551,LISP 5C,A00,896655,Munoz Sanchez; Alicia,0,1,20,20
1746587711581,MAE 197,001,957918,Kleissl; Jan,9996,0,9999,3
1746587711581,MAE 197,002,959806,Boechler; Nicholas Sebastia,9998,0,9999,1
1746587711581,MAE 197,003,959852,Mullin; Jennifer S,9998,0,9999,1
1746587712608,MATH 2,A01,957937,Staff,33,0,35,2
1746587713633,MATH 197,001,957876,Kedlaya; Kiran S.,9993,0,9999,6
1746587714658,MCWP 40,A00,892729,Duru; Nur,10,0,20,10
1746587714658,MCWP 40,B00,893304,Montejo; Carolina,14,0,20,6
1746587715683,MCWP 40R,A00,893757,Redela; Pamela Morgan,0,5,20,20
1746587716714,MCWP 50,A00,893758,Morshed; Michael James,0,0,20,20
1746587716714,MCWP 50,B00,893761,Bartulis; Jason Michael,17,0,20,3
1746587717745,MCWP 50R,A00,893766,Compas; Sean Matthew,0,1,20,20
1746587717745,MCWP 50R,B00,893769,Carter; Jennifer A,0,1,20,20
1746587717745,MCWP 50R,C00,893771,Krone; Jarret,0,3,20,20
1746587717745,MCWP 50R,D00,893772,Miller; Elizabeth Deen,0,0,20,20
1746587717745,MCWP 50R,E00,893775,Carter; Andrea L,0,1,20,20
1746587718771,MMW 11R,A01,892721,Herbst; Matthew,14,0,30,16
1746587718771,MMW 11R,A02,892722,Herbst; Matthew,0,0,0,3
1746587719801,MMW 12R,A01,892724,Herbst; Matthew,0,11,16,16
1746587719801,MMW 12R,A02,892725,Herbst; Matthew,0,10,16,16
1746587720830,MMW 13R,A01,892727,Staff,0,4,16,16
1746587720830,MMW 13R,A02,892728,Staff,0,4,16,16
1746587720830,MMW 13R,A03,958032,Staff,0,4,16,16
1746587720830,MMW 13R,A04,958033,Staff,0,4,16,16
1746587720830,MMW 13R,A05,958034,Staff,0,4,16,16
1746587721856,SIO 295LS,A00,894015,Staff,5,0,25,20
1746587722884,SIO 295S,A00,894020,Staff,5,0,25,20
1746587723909,SIOC 290S,B01,958918,Merrifield; Mark A,14,0,30,16
1746587724942,SIOC 291S,B01,958922,Gabriel; Corey John,14,0,30,16
1746587725971,SOCI 117,A01,895339,Staff,3,0,5,2
1746587727000,WES 237B,A00,894149,Staff,11,0,20,9
1746587729063,AESE 279B,A00,891859,Staff,13,0,35,22
1746587730090,AIP 197,001,891854,Vespa; Emanuel Ignacio,9999,0,9999,0
1746587731116,ANTH 289S,A00,891856,Gagneux; Pascal,12,0,12,0
1746587732144,BENG 196,001,957946,Engler; Adam J.,9996,0,9999,3
1746587733173,BISP 197,001,959851,Wilhelm; James E.,9998,0,9999,1
1746587734200,CAT 124RS,A01,956906,Staff,6,0,25,19
1746587735230,CAT 125RS,A01,922013,Staff,6,0,25,19
1746587736260,CLRE 250,A00,891860,Morris; Sheldon,9995,0,9999,4
1746587738317,CLRE 251R,A00,907817,Mehta; Ravindra L.,9994,0,9999,5
1746587739348,CLRE 252,A00,891864,Cuomo; Raphael Eduardo,9993,0,9999,6
1746587740372,CLRE 253,A00,891867,Vaida; Florin,9994,0,9999,5
1746587740372,CLRE 253,B00,907819,Staff,9999,0,9999,0
1746587741402,CLRE 259,A00,891868,Patel; Hemal,9998,0,9999,1
1746587742427,CLRE 260,A00,891872,Cuomo; Raphael Eduardo,9999,0,9999,0
1746587743454,CLRE 297,001,891888,Cuomo; Raphael Eduardo,9999,0,9999,0
1746587744484,CSE 191,A00,958773,Minnes Kemp; Mor Mia,9995,0,9999,4
1746587745512,CSE 197,001,959846,Minnes Kemp; Mor Mia,9990,0,9999,9
1746587746540,CSS 201S,A01,892054,Mignozzetti; Umberto,25,0,30,5
1746587747568,CSS 202S,A01,892056,Mignozzetti; Umberto,25,0,30,5
1746587748594,DSC 197,001,956898,Eldridge; Justin Matthew,9996,0,9999,3
1746587749622,DSC 297,001,958000,Mazumdar; Arya,9998,0,9999,1
1746587749622,DSC 297,002,959862,Wang; Yusu,9998,0,9999,1
1746587750648,EAP 100,A00,905686,Staff,9778,0,9999,221
1746587751674,ECE 45,A01,892618,Staff,0,0,65,65
1746587753725,ECE 111,A01,892719,Staff,6,0,65,59
1746587754754,ECE 197,001,957920,Mercier; Patrick Philip,9991,0,9999,8
1746587755781,ECON 178,A01,907814,Zhu; Ying,26,0,35,9
1746587756809,EDS 115,A00,895312,Staff,35,0,45,10
1746587757834,EDS 117,A01,895337,Staff,23,0,30,7
1746587758860,EDS 125,A00,895341,Jones; Gabrielle Anastasia,36,0,45,9
1746587759890,EDS 128A,A01,895459,Fargason; Sharon Gayle,44,0,45,1
1746587760919,EDS 128B,A01,895543,Pappas; Elizabeth,44,0,45,1
1746587761946,EDS 139,A00,897203,Pappas; Elizabeth,44,0,45,1
1746587761946,EDS 139,B00,897209,Fargason; Sharon Gayle,41,0,45,4
1746587762972,EDS 201,A00,895545,Staff,22,0,45,23
1746587763998,EDS 203,A01,895581,Halter; Christopher P.,22,0,45,23
1746587765029,EDS 204R,A01,895625,Heinzman; Erica M.,39,0,45,6
1746587765029,EDS 204R,B01,895693,Halter; Christopher P.,10,0,45,35
1746587766059,EDS 206R,A00,895694,Fargason; Sharon Gayle,1,0,30,29
1746587766059,EDS 206R,B00,895695,Choi; Bailey Miyeon,16,0,30,14
1746587767086,EDS 250,A00,895697,Hemans; Patricia Ann Benitez,22,0,45,23
1746587768111,EDS 281,A00,895701,Meyerott; Theresa Ann,1,0,15,14
1746587769140,EDS 284,A00,895736,Meyerott; Theresa Ann,1,0,15,14
1746587770166,EDS 286,A00,897210,Fine; Sarah,0,0,15,15
1746587771195,EDS 289C,A01,895770,Daly; Alan J.,1,0,15,14
1746587772221,EDS 290,A00,897211,Hofstetter; Carolyn,0,0,15,15
1746587773247,LIGM 5A,A00,896162,Fischer-Grunski; Eva K,12,0,20,8
1746587774271,LIGM 5B,A00,896260,Fischer-Grunski; Eva K,17,0,20,3
1746587775302,LIGM 5C,A00,896308,Fischer-Grunski; Eva K,18,0,20,2
1746587776332,LIIT 5AS,A00,896313,Carnelos; Chiara,18,0,20,2
1746587777357,LIIT 5BS,A00,896416,Carnelos; Chiara,20,0,20,0
1746587778383,LIIT 5CS,A00,896564,Carnelos; Chiara,20,0,20,0
1746587779409,LISP 5A,A00,896588,Munoz Sanchez; Alicia,2,0,20,18
1746587780436,LISP 5B,A00,896653,Munoz Sanchez; Alicia,7,0,20,13
1746587781461,LISP 5C,A00,896655,Munoz Sanchez; Alicia,0,1,20,20
1746587782491,MAE 197,001,957918,Kleissl; Jan,9996,0,9999,3
1746587782491,MAE 197,002,959806,Boechler; Nicholas Sebastia,9998,0,9999,1
1746587782491,MAE 197,003,959852,Mullin; Jennifer S,9998,0,9999,1
1746587783521,MATH 2,A01,957937,Staff,33,0,35,2
1746587784550,MATH 197,001,957876,Kedlaya; Kiran S.,9993,0,9999,6
1746587785583,MCWP 40,A00,892729,Duru; Nur,10,0,20,10
1746587785583,MCWP 40,B00,893304,Montejo; Carolina,14,0,20,6
1746587786610,MCWP 40R,A00,893757,Redela; Pamela Morgan,0,5,20,20
1746587787637,MCWP 50,A00,893758,Morshed; Michael James,0,0,20,20
1746587787637,MCWP 50,B00,893761,Bartulis; Jason Michael,17,0,20,3
1746587788664,MCWP 50R,A00,893766,Compas; Sean Matthew,0,1,20,20
1746587788664,MCWP 50R,B00,893769,Carter; Jennifer A,0,1,20,20
1746587788664,MCWP 50R,C00,893771,Krone; Jarret,0,3,20,20
1746587788664,MCWP 50R,D00,893772,Miller; Elizabeth Deen,0,0,20,20
1746587788664,MCWP 50R,E00,893775,Carter; Andrea L,0,1,20,20
1746587789694,MMW 11R,A01,892721,Herbst; Matthew,14,0,30,16
1746587789694,MMW 11R,A02,892722,Herbst; Matthew,0,0,0,3
1746587790725,MMW 12R,A01,892724,Herbst; Matthew,0,11,16,16
1746587790725,MMW 12R,A02,892725,Herbst; Matthew,0,10,16,16
1746587791752,MMW 13R,A01,892727,Staff,0,4,16,16
1746587791752,MMW 13R,A02,892728,Staff,0,4,16,16
1746587791752,MMW 13R,A03,958032,Staff,0,4,16,16
1746587791752,MMW 13R,A04,958033,Staff,0,4,16,16
1746587791752,MMW 13R,A05,958034,Staff,0,4,16,16
1746587792778,SIO 295LS,A00,894015,Staff,5,0,25,20
1746587793804,SIO 295S,A00,894020,Staff,5,0,25,20
1746587794836,SIOC 290S,B01,958918,Merrifield; Mark A,14,0,30,16
1746587795863,SIOC 291S,B01,958922,Gabriel; Corey John,14,0,30,16
1746587796889,SOCI 117,A01,895339,Staff,3,0,5,2
1746587797914,WES 237B,A00,894149,Staff,11,0,20,9
1746587799976,AESE 279B,A00,891859,Staff,13,0,35,22
1746587801002,AIP 197,001,891854,Vespa; Emanuel Ignacio,9999,0,9999,0
1746587802028,ANTH 289S,A00,891856,Gagneux; Pascal,12,0,12,0
1746587803058,BENG 196,001,957946,Engler; Adam J.,9996,0,9999,3
1746587804086,BISP 197,001,959851,Wilhelm; James E.,9998,0,9999,1
1746587805111,CAT 124RS,A01,956906,Staff,6,0,25,19
1746587806141,CAT 125RS,A01,922013,Staff,6,0,25,19
1746587807168,CLRE 250,A00,891860,Morris; Sheldon,9995,0,9999,4
1746587809218,CLRE 251R,A00,907817,Mehta; Ravindra L.,9994,0,9999,5
1746587810247,CLRE 252,A00,891864,Cuomo; Raphael Eduardo,9993,0,9999,6
1746587811277,CLRE 253,A00,891867,Vaida; Florin,9994,0,9999,5
1746587811277,CLRE 253,B00,907819,Staff,9999,0,9999,0
1746587812306,CLRE 259,A00,891868,Patel; Hemal,9998,0,9999,1
1746587813332,CLRE 260,A00,891872,Cuomo; Raphael Eduardo,9999,0,9999,0
1746587814359,CLRE 297,001,891888,Cuomo; Raphael Eduardo,9999,0,9999,0
1746587815383,CSE 191,A00,958773,Minnes Kemp; Mor Mia,9995,0,9999,4
1746587816407,CSE 197,001,959846,Minnes Kemp; Mor Mia,9990,0,9999,9
1746587817438,CSS 201S,A01,892054,Mignozzetti; Umberto,25,0,30,5
1746587818461,CSS 202S,A01,892056,Mignozzetti; Umberto,25,0,30,5
1746587819487,DSC 197,001,956898,Eldridge; Justin Matthew,9996,0,9999,3
1746587820511,DSC 297,001,958000,Mazumdar; Arya,9998,0,9999,1
1746587820511,DSC 297,002,959862,Wang; Yusu,9998,0,9999,1
1746587821536,EAP 100,A00,905686,Staff,9778,0,9999,221
1746587822562,ECE 45,A01,892618,Staff,0,0,65,65
1746587824615,ECE 111,A01,892719,Staff,6,0,65,59
1746587825644,ECE 197,001,957920,Mercier; Patrick Philip,9991,0,9999,8
1746587826669,ECON 178,A01,907814,Zhu; Ying,26,0,35,9
1746587827697,EDS 115,A00,895312,Staff,35,0,45,10
1746587828723,EDS 117,A01,895337,Staff,23,0,30,7
1746587829749,EDS 125,A00,895341,Jones; Gabrielle Anastasia,36,0,45,9
1746587830773,EDS 128A,A01,895459,Fargason; Sharon Gayle,44,0,45,1
1746587831799,EDS 128B,A01,895543,Pappas; Elizabeth,44,0,45,1
1746587832825,EDS 139,A00,897203,Pappas; Elizabeth,44,0,45,1
1746587832825,EDS 139,B00,897209,Fargason; Sharon Gayle,41,0,45,4
1746587833855,EDS 201,A00,895545,Staff,22,0,45,23
1746587834883,EDS 203,A01,895581,Halter; Christopher P.,22,0,45,23
1746587835913,EDS 204R,A01,895625,Heinzman; Erica M.,39,0,45,6
1746587835913,EDS 204R,B01,895693,Halter; Christopher P.,10,0,45,35
1746587836938,EDS 206R,A00,895694,Fargason; Sharon Gayle,1,0,30,29
1746587836938,EDS 206R,B00,895695,Choi; Bailey Miyeon,16,0,30,14
1746587837965,EDS 250,A00,895697,Hemans; Patricia Ann Benitez,22,0,45,23
1746587838993,EDS 281,A00,895701,Meyerott; Theresa Ann,1,0,15,14
1746587840022,EDS 284,A00,895736,Meyerott; Theresa Ann,1,0,15,14
1746587841047,EDS 286,A00,897210,Fine; Sarah,0,0,15,15
1746587842075,EDS 289C,A01,895770,Daly; Alan J.,1,0,15,14
1746587843101,EDS 290,A00,897211,Hofstetter; Carolyn,0,0,15,15
1746587844126,LIGM 5A,A00,896162,Fischer-Grunski; Eva K,12,0,20,8
1746587845155,LIGM 5B,A00,896260,Fischer-Grunski; Eva K,17,0,20,3
1746587846180,LIGM 5C,A00,896308,Fischer-Grunski; Eva K,18,0,20,2
1746587847208,LIIT 5AS,A00,896313,Carnelos; Chiara,18,0,20,2
1746587848234,LIIT 5BS,A00,896416,Carnelos; Chiara,20,0,20,0
1746587849258,LIIT 5CS,A00,896564,Carnelos; Chiara,20,0,20,0
1746587850283,LISP 5A,A00,896588,Munoz Sanchez; Alicia,2,0,20,18
1746587851311,LISP 5B,A00,896653,Munoz Sanchez; Alicia,7,0,20,13
1746587852336,LISP 5C,A00,896655,Munoz Sanchez; Alicia,0,1,20,20
1746587853366,MAE 197,001,957918,Kleissl; Jan,9996,0,9999,3
1746587853366,MAE 197,002,959806,Boechler; Nicholas Sebastia,9998,0,9999,1
1746587853366,MAE 197,003,959852,Mullin; Jennifer S,9998,0,9999,1
1746587854391,MATH 2,A01,957937,Staff,33,0,35,2
1746587855416,MATH 197,001,957876,Kedlaya; Kiran S.,9993,0,9999,6
1746587856440,MCWP 40,A00,892729,Duru; Nur,10,0,20,10
1746587856440,MCWP 40,B00,893304,Montejo; Carolina,14,0,20,6
1746587857466,MCWP 40R,A00,893757,Redela; Pamela Morgan,0,5,20,20
1746587858491,MCWP 50,A00,893758,Morshed; Michael James,0,0,20,20
1746587858491,MCWP 50,B00,893761,Bartulis; Jason Michael,17,0,20,3
1746587859517,MCWP 50R,A00,893766,Compas; Sean Matthew,0,1,20,20
1746587859517,MCWP 50R,B00,893769,Carter; Jennifer A,0,1,20,20
1746587859517,MCWP 50R,C00,893771,Krone; Jarret,0,3,20,20
1746587859517,MCWP 50R,D00,893772,Miller; Elizabeth Deen,0,0,20,20
1746587859517,MCWP 50R,E00,893775,Carter; Andrea L,0,1,20,20
1746587860541,MMW 11R,A01,892721,Herbst; Matthew,14,0,30,16
1746587860541,MMW 11R,A02,892722,Herbst; Matthew,0,0,0,3
1746587861566,MMW 12R,A01,892724,Herbst; Matthew,0,11,16,16
1746587861566,MMW 12R,A02,892725,Herbst; Matthew,0,10,16,16
1746587862590,MMW 13R,A01,892727,Staff,0,4,16,16
1746587862590,MMW 13R,A02,892728,Staff,0,4,16,16
1746587862590,MMW 13R,A03,958032,Staff,0,4,16,16
1746587862590,MMW 13R,A04,958033,Staff,0,4,16,16
1746587862590,MMW 13R,A05,958034,Staff,0,4,16,16
1746587863622,SIO 295LS,A00,894015,Staff,5,0,25,20
1746587864648,SIO 295S,A00,894020,Staff,5,0,25,20
1746587865681,SIOC 290S,B01,958918,Merrifield; Mark A,14,0,30,16
1746587866707,SIOC 291S,B01,958922,Gabriel; Corey John,14,0,30,16
1746587867735,SOCI 117,A01,895339,Staff,3,0,5,2
1746587868762,WES 237B,A00,894149,Staff,11,0,20,9
1746587870823,AESE 279B,A00,891859,Staff,13,0,35,22
1746587871850,AIP 197,001,891854,Vespa; Emanuel Ignacio,9999,0,9999,0
1746587872878,ANTH 289S,A00,891856,Gagneux; Pascal,12,0,12,0
1746587873903,BENG 196,001,957946,Engler; Adam J.,9996,0,9999,3
1746587874932,BISP 197,001,959851,Wilhelm; James E.,9998,0,9999,1
1746587875956,CAT 124RS,A01,956906,Staff,6,0,25,19
1746587876984,CAT 125RS,A01,922013,Staff,6,0,25,19
1746587878010,CLRE 250,A00,891860,Morris; Sheldon,9995,0,9999,4
1746587880064,CLRE 251R,A00,907817,Mehta; Ravindra L.,9994,0,9999,5
1746587881090,CLRE 252,A00,891864,Cuomo; Raphael Eduardo,9993,0,9999,6
1746587882119,CLRE 253,A00,891867,Vaida; Florin,9994,0,9999,5
1746587882119,CLRE 253,B00,907819,Staff,9999,0,9999,0
1746587883149,CLRE 259,A00,891868,Patel; Hemal,9998,0,9999,1
1746587884173,CLRE 260,A00,891872,Cuomo; Raphael Eduardo,9999,0,9999,0
1746587885200,CLRE 297,001,891888,Cuomo; Raphael Eduardo,9999,0,9999,0
1746587886226,CSE 191,A00,958773,Minnes Kemp; Mor Mia,9995,0,9999,4
1746587887250,CSE 197,001,959846,Minnes Kemp; Mor Mia,9990,0,9999,9
1746587888280,CSS 201S,A01,892054,Mignozzetti; Umberto,25,0,30,5
1746587889305,CSS 202S,A01,892056,Mignozzetti; Umberto,25,0,30,5
1746587890332,DSC 197,001,956898,Eldridge; Justin Matthew,9996,0,9999,3
1746587891357,DSC 297,001,958000,Mazumdar; Arya,9998,0,9999,1
1746587891357,DSC 297,002,959862,Wang; Yusu,9998,0,9999,1
1746587892384,EAP 100,A00,905686,Staff,9778,0,9999,221
1746587893413,ECE 45,A01,892618,Staff,0,0,65,65
1746587895466,ECE 111,A01,892719,Staff,6,0,65,59
1746587896492,ECE 197,001,957920,Mercier; Patrick Philip,9991,0,9999,8
1746587897522,ECON 178,A01,907814,Zhu; Ying,26,0,35,9
1746587898547,EDS 115,A00,895312,Staff,35,0,45,10
1746587899575,EDS 117,A01,895337,Staff,23,0,30,7
1746587900601,EDS 125,A00,895341,Jones; Gabrielle Anastasia,36,0,45,9
1746587901625,EDS 128A,A01,895459,Fargason; Sharon Gayle,44,0,45,1
1746587902651,EDS 128B,A01,895543,Pappas; Elizabeth,44,0,45,1
1746587903679,EDS 139,A00,897203,Pappas; Elizabeth,44,0,45,1
1746587903679,EDS 139,B00,897209,Fargason; Sharon Gayle,41,0,45,4
1746587904712,EDS 201,A00,895545,Staff,22,0,45,23
1746587905738,EDS 203,A01,895581,Halter; Christopher P.,22,0,45,23
1746587906763,EDS 204R,A01,895625,Heinzman; Erica M.,39,0,45,6
1746587906763,EDS 204R,B01,895693,Halter; Christopher P.,10,0,45,35
1746587907792,EDS 206R,A00,895694,Fargason; Sharon Gayle,1,0,30,29
1746587907792,EDS 206R,B00,895695,Choi; Bailey Miyeon,16,0,30,14
1746587908822,EDS 250,A00,895697,Hemans; Patricia Ann Benitez,22,0,45,23
1746587909846,EDS 281,A00,895701,Meyerott; Theresa Ann,1,0,15,14
1746587910875,EDS 284,A00,895736,Meyerott; Theresa Ann,1,0,15,14
1746587911900,EDS 286,A00,897210,Fine; Sarah,0,0,15,15
1746587912930,EDS 289C,A01,895770,Daly; Alan J.,1,0,15,14
1746587913953,EDS 290,A00,897211,Hofstetter; Carolyn,0,0,15,15
1746587914979,LIGM 5A,A00,896162,Fischer-Grunski; Eva K,12,0,20,8
1746587916004,LIGM 5B,A00,896260,Fischer-Grunski; Eva K,17,0,20,3
1746587917031,LIGM 5C,A00,896308,Fischer-Grunski; Eva K,18,0,20,2
1746587918055,LIIT 5AS,A00,896313,Carnelos; Chiara,18,0,20,2
1746587919083,LIIT 5BS,A00,896416,Carnelos; Chiara,20,0,20,0
1746587920115,LIIT 5CS,A00,896564,Carnelos; Chiara,20,0,20,0
1746587921142,LISP 5A,A00,896588,Munoz Sanchez; Alicia,2,0,20,18
1746587922168,LISP 5B,A00,896653,Munoz Sanchez; Alicia,7,0,20,13
1746587923197,LISP 5C,A00,896655,Munoz Sanchez; Alicia,0,1,20,20
1746587924225,MAE 197,001,957918,Kleissl; Jan,9996,0,9999,3
1746587924225,MAE 197,002,959806,Boechler; Nicholas Sebastia,9998,0,9999,1
1746587924225,MAE 197,003,959852,Mullin; Jennifer S,9998,0,9999,1
1746587925249,MATH 2,A01,957937,Staff,33,0,35,2
1746587926273,MATH 197,001,957876,Kedlaya; Kiran S.,9993,0,9999,6
1746587927299,MCWP 40,A00,892729,Duru; Nur,10,0,20,10
1746587927299,MCWP 40,B00,893304,Montejo; Carolina,14,0,20,6
1746587928324,MCWP 40R,A00,893757,Redela; Pamela Morgan,0,5,20,20
1746587929353,MCWP 50,A00,893758,Morshed; Michael James,0,0,20,20
1746587929353,MCWP 50,B00,893761,Bartulis; Jason Michael,17,0,20,3
1746587930383,MCWP 50R,A00,893766,Compas; Sean Matthew,0,1,20,20
1746587930383,MCWP 50R,B00,893769,Carter; Jennifer A,0,1,20,20
1746587930383,MCWP 50R,C00,893771,Krone; Jarret,0,3,20,20
1746587930383,MCWP 50R,D00,893772,Miller; Elizabeth Deen,0,0,20,20
1746587930383,MCWP 50R,E00,893775,Carter; Andrea L,0,1,20,20
1746587931411,MMW 11R,A01,892721,Herbst; Matthew,14,0,30,16
1746587931411,MMW 11R,A02,892722,Herbst; Matthew,0,0,0,3
1746587932438,MMW 12R,A01,892724,Herbst; Matthew,0,11,16,16
1746587932438,MMW 12R,A02,892725,Herbst; Matthew,0,10,16,16
1746587933464,MMW 13R,A01,892727,Staff,0,4,16,16
1746587933464,MMW 13R,A02,892728,Staff,0,4,16,16
1746587933464,MMW 13R,A03,958032,Staff,0,4,16,16
1746587933464,MMW 13R,A04,958033,Staff,0,4,16,16
1746587933464,MMW 13R,A05,958034,Staff,0,4,16,16
1746587934491,SIO 295LS,A00,894015,Staff,5,0,25,20
1746587935515,SIO 295S,A00,894020,Staff,5,0,25,20
1746587936540,SIOC 290S,B01,958918,Merrifield; Mark A,14,0,30,16
1746587937571,SIOC 291S,B01,958922,Gabriel; Corey John,14,0,30,16
1746587938596,SOCI 117,A01,895339,Staff,3,0,5,2
1746587939623,WES 237B,A00,894149,Staff,11,0,20,9
1746587941679,AESE 279B,A00,891859,Staff,13,0,35,22
1746587942707,AIP 197,001,891854,Vespa; Emanuel Ignacio,9999,0,9999,0
1746587943771,ANTH 289S,A00,891856,Gagneux; Pascal,12,0,12,0
1746587944798,BENG 196,001,957946,Engler; Adam J.,9996,0,9999,3
1746587945824,BISP 197,001,959851,Wilhelm; James E.,9998,0,9999,1
1746587946851,CAT 124RS,A01,956906,Staff,6,0,25,19
1746587947879,CAT 125RS,A01,922013,Staff,6,0,25,19
1746587948904,CLRE 250,A00,891860,Morris; Sheldon,9995,0,9999,4
1746587950956,CLRE 251R,A00,907817,Mehta; Ravindra L.,9994,0,9999,5
1746587951981,CLRE 252,A00,891864,Cuomo; Raphael Eduardo,9993,0,9999,6
1746587953005,CLRE 253,A00,891867,Vaida; Florin,9994,0,9999,5
1746587953005,CLRE 253,B00,907819,Staff,9999,0,9999,0
1746587954030,CLRE 259,A00,891868,Patel; Hemal,9998,0,9999,1
1746587955056,CLRE 260,A00,891872,Cuomo; Raphael Eduardo,9999,0,9999,0
1746587956083,CLRE 297,001,891888,Cuomo; Raphael Eduardo,9999,0,9999,0
1746587957110,CSE 191,A00,958773,Minnes Kemp; Mor Mia,9995,0,9999,4
1746587958136,CSE 197,001,959846,Minnes Kemp; Mor Mia,9990,0,9999,9
1746587959167,CSS 201S,A01,892054,Mignozzetti; Umberto,25,0,30,5
1746587960194,CSS 202S,A01,892056,Mignozzetti; Umberto,25,0,30,5
1746587961234,DSC 197,001,956898,Eldridge; Justin Matthew,9996,0,9999,3
1746587962261,DSC 297,001,958000,Mazumdar; Arya,9998,0,9999,1
1746587962261,DSC 297,002,959862,Wang; Yusu,9998,0,9999,1
1746587963285,EAP 100,A00,905686,Staff,9778,0,9999,221
1746587964310,ECE 45,A01,892618,Staff,0,0,65,65
1746587966359,ECE 111,A01,892719,Staff,6,0,65,59
1746587967385,ECE 197,001,957920,Mercier; Patrick Philip,9991,0,9999,8
1746587968409,ECON 178,A01,907814,Zhu; Ying,26,0,35,9
1746587969435,EDS 115,A00,895312,Staff,35,0,45,10
1746587970462,EDS 117,A01,895337,Staff,23,0,30,7
1746587971487,EDS 125,A00,895341,Jones; Gabrielle Anastasia,36,0,45,9
1746587972517,EDS 128A,A01,895459,Fargason; Sharon Gayle,44,0,45,1
1746587973547,EDS 128B,A01,895543,Pappas; Elizabeth,44,0,45,1
1746587974573,EDS 139,A00,897203,Pappas; Elizabeth,44,0,45,1
1746587974573,EDS 139,B00,897209,Fargason; Sharon Gayle,41,0,45,4
1746587975598,EDS 201,A00,895545,Staff,22,0,45,23
1746587976624,EDS 203,A01,895581,Halter; Christopher P.,22,0,45,23
1746587977649,EDS 204R,A01,895625,Heinzman; Erica M.,39,0,45,6
1746587977649,EDS 204R,B01,895693,Halter; Christopher P.,10,0,45,35
1746587978674,EDS 206R,A00,895694,Fargason; Sharon Gayle,1,0,30,29
1746587978674,EDS 206R,B00,895695,Choi; Bailey Miyeon,16,0,30,14
1746587979700,EDS 250,A00,895697,Hemans; Patricia Ann Benitez,22,0,45,23
1746587980729,EDS 281,A00,895701,Meyerott; Theresa Ann,1,0,15,14
1746587981756,EDS 284,A00,895736,Meyerott; Theresa Ann,1,0,15,14
1746587982785,EDS 286,A00,897210,Fine; Sarah,0,0,15,15
1746587983810,EDS 289C,A01,895770,Daly; Alan J.,1,0,15,14
1746587984836,EDS 290,A00,897211,Hofstetter; Carolyn,0,0,15,15
1746587985866,LIGM 5A,A00,896162,Fischer-Grunski; Eva K,12,0,20,8
1746587986892,LIGM 5B,A00,896260,Fischer-Grunski; Eva K,17,0,20,3
1746587987916,LIGM 5C,A00,896308,Fischer-Grunski; Eva K,18,0,20,2
1746587988943,LIIT 5AS,A00,896313,Carnelos; Chiara,18,0,20,2
1746587989972,LIIT 5BS,A00,896416,Carnelos; Chiara,20,0,20,0
1746587990997,LIIT 5CS,A00,896564,Carnelos; Chiara,20,0,20,0
1746587992024,LISP 5A,A00,896588,Munoz Sanchez; Alicia,2,0,20,18
1746587993054,LISP 5B,A00,896653,Munoz Sanchez; Alicia,7,0,20,13
1746587994084,LISP 5C,A00,896655,Munoz Sanchez; Alicia,0,1,20,20
1746587995111,MAE 197,001,957918,Kleissl; Jan,9996,0,9999,3
1746587995111,MAE 197,002,959806,Boechler; Nicholas Sebastia,9998,0,9999,1
1746587995111,MAE 197,003,959852,Mullin; Jennifer S,9998,0,9999,1
1746587996141,MATH 2,A01,957937,Staff,33,0,35,2
1746587997165,MATH 197,001,957876,Kedlaya; Kiran S.,9993,0,9999,6
1746587998193,MCWP 40,A00,892729,Duru; Nur,10,0,20,10
1746587998193,MCWP 40,B00,893304,Montejo; Carolina,14,0,20,6
1746587999223,MCWP 40R,A00,893757,Redela; Pamela Morgan,0,5,20,20
1746588000250,MCWP 50,A00,893758,Morshed; Michael James,0,0,20,20
1746588000250,MCWP 50,B00,893761,Bartulis; Jason Michael,17,0,20,3
1746588001319,MCWP 50R,A00,893766,Compas; Sean Matthew,0,1,20,20
1746588001319,MCWP 50R,B00,893769,Carter; Jennifer A,0,1,20,20
1746588001319,MCWP 50R,C00,893771,Krone; Jarret,0,3,20,20
1746588001319,MCWP 50R,D00,893772,Miller; Elizabeth Deen,0,0,20,20
1746588001319,MCWP 50R,E00,893775,Carter; Andrea L,0,1,20,20
1746588002349,MMW 11R,A01,892721,Herbst; Matthew,14,0,30,16
1746588002349,MMW 11R,A02,892722,Herbst; Matthew,0,0,0,3
1746588003375,MMW 12R,A01,892724,Herbst; Matthew,0,11,16,16
1746588003375,MMW 12R,A02,892725,Herbst; Matthew,0,10,16,16
1746588004404,MMW 13R,A01,892727,Staff,0,4,16,16
1746588004404,MMW 13R,A02,892728,Staff,0,4,16,16
1746588004404,MMW 13R,A03,958032,Staff,0,4,16,16
1746588004404,MMW 13R,A04,958033,Staff,0,4,16,16
1746588004404,MMW 13R,A05,958034,Staff,0,4,16,16
1746588005435,SIO 295LS,A00,894015,Staff,5,0,25,20
1746588006463,SIO 295S,A00,894020,Staff,5,0,25,20
1746588007488,SIOC 290S,B01,958918,Merrifield; Mark A,14,0,30,16
1746588008520,SIOC 291S,B01,958922,Gabriel; Corey John,14,0,30,16
1746588009544,SOCI 117,A01,895339,Staff,3,0,5,2
1746588010570,WES 237B,A00,894149,Staff,11,0,20,9
1746588012625,AESE 279B,A00,891859,Staff,13,0,35,22
1746588013654,AIP 197,001,891854,Vespa; Emanuel Ignacio,9999,0,9999,0
1746588014680,ANTH 289S,A00,891856,Gagneux; Pascal,12,0,12,0
1746588015710,BENG 196,001,957946,Engler; Adam J.,9996,0,9999,3
1746588016735,BISP 197,001,959851,Wilhelm; James E.,9998,0,9999,1
1746588017762,CAT 124RS,A01,956906,Staff,6,0,25,19
1746588018789,CAT 125RS,A01,922013,Staff,6,0,25,19
1746588019819,CLRE 250,A00,891860,Morris; Sheldon,9995,0,9999,4
1746588021874,CLRE 251R,A00,907817,Mehta; Ravindra L.,9994,0,9999,5
1746588022902,CLRE 252,A00,891864,Cuomo; Raphael Eduardo,9993,0,9999,6
1746588023927,CLRE 253,A00,891867,Vaida; Florin,9994,0,9999,5
1746588023927,CLRE 253,B00,907819,Staff,9999,0,9999,0
1746588024951,CLRE 259,A00,891868,Patel; Hemal,9998,0,9999,1
1746588025975,CLRE 260,A00,891872,Cuomo; Raphael Eduardo,9999,0,9999,0
1746588027001,CLRE 297,001,891888,Cuomo; Raphael Eduardo,9999,0,9999,0
1746588028029,CSE 191,A00,958773,Minnes Kemp; Mor Mia,9995,0,9999,4
1746588029057,CSE 197,001,959846,Minnes Kemp; Mor Mia,9990,0,9999,9
1746588030088,CSS 201S,A01,892054,Mignozzetti; Umberto,25,0,30,5
1746588031115,CSS 202S,A01,892056,Mignozzetti; Umberto,25,0,30,5
1746588032147,DSC 197,001,956898,Eldridge; Justin Matthew,9996,0,9999,3
1746588033173,DSC 297,001,958000,Mazumdar; Arya,9998,0,9999,1
1746588033173,DSC 297,002,959862,Wang; Yusu,9998,0,9999,1
1746588034206,EAP 100,A00,905686,Staff,9778,0,9999,221
1746588035232,ECE 45,A01,892618,Staff,0,0,65,65
1746588037284,ECE 111,A01,892719,Staff,6,0,65,59
1746588038309,ECE 197,001,957920,Mercier; Patrick Philip,9991,0,9999,8
1746588039336,ECON 178,A01,907814,Zhu; Ying,26,0,35,9
1746588040360,EDS 115,A00,895312,Staff,35,0,45,10
1746588041386,EDS 117,A01,895337,Staff,23,0,30,7
1746588042412,EDS 125,A00,895341,Jones; Gabrielle Anastasia,36,0,45,9
1746588043440,EDS 128A,A01,895459,Fargason; Sharon Gayle,44,0,45,1
1746588044466,EDS 128B,A01,895543,Pappas; Elizabeth,44,0,45,1
1746588045492,EDS 139,A00,897203,Pappas; Elizabeth,44,0,45,1
1746588045492,EDS 139,B00,897209,Fargason; Sharon Gayle,41,0,45,4
1746588046519,EDS 201,A00,895545,Staff,22,0,45,23
1746588047550,EDS 203,A01,895581,Halter; Christopher P.,22,0,45,23
1746588048579,EDS 204R,A01,895625,Heinzman; Erica M.,39,0,45,6
1746588048579,EDS 204R,B01,895693,Halter; Christopher P.,10,0,45,35
1746588049608,EDS 206R,A00,895694,Fargason; Sharon Gayle,1,0,30,29
1746588049608,EDS 206R,B00,895695,Choi; Bailey Miyeon,16,0,30,14
1746588050634,EDS 250,A00,895697,Hemans; Patricia Ann Benitez,22,0,45,23
1746588051660,EDS 281,A00,895701,Meyerott; Theresa Ann,1,0,15,14
1746588052687,EDS 284,A00,895736,Meyerott; Theresa Ann,1,0,15,14
1746588053718,EDS 286,A00,897210,Fine; Sarah,0,0,15,15
1746588054745,EDS 289C,A01,895770,Daly; Alan J.,1,0,15,14
1746588055772,EDS 290,A00,897211,Hofstetter; Carolyn,0,0,15,15
1746588056797,LIGM 5A,A00,896162,Fischer-Grunski; Eva K,12,0,20,8
1746588057822,LIGM 5B,A00,896260,Fischer-Grunski; Eva K,17,0,20,3
1746588058848,LIGM 5C,A00,896308,Fischer-Grunski; Eva K,18,0,20,2
1746588059879,LIIT 5AS,A00,896313,Carnelos; Chiara,18,0,20,2
1746588060904,LIIT 5BS,A00,896416,Carnelos; Chiara,20,0,20,0
1746588061954,LIIT 5CS,A00,896564,Carnelos; Chiara,20,0,20,0
1746588062980,LISP 5A,A00,896588,Munoz Sanchez; Alicia,2,0,20,18
1746588064005,LISP 5B,A00,896653,Munoz Sanchez; Alicia,7,0,20,13
1746588065035,LISP 5C,A00,896655,Munoz Sanchez; Alicia,0,1,20,20
1746588066061,MAE 197,001,957918,Kleissl; Jan,9996,0,9999,3
1746588066061,MAE 197,002,959806,Boechler; Nicholas Sebastia,9998,0,9999,1
1746588066061,MAE 197,003,959852,Mullin; Jennifer S,9998,0,9999,1
1746588067090,MATH 2,A01,957937,Staff,33,0,35,2
1746588068117,MATH 197,001,957876,Kedlaya; Kiran S.,9993,0,9999,6
1746588069141,MCWP 40,A00,892729,Duru; Nur,10,0,20,10
1746588069141,MCWP 40,B00,893304,Montejo; Carolina,14,0,20,6
1746588070169,MCWP 40R,A00,893757,Redela; Pamela Morgan,0,5,20,20
1746588071197,MCWP 50,A00,893758,Morshed; Michael James,0,0,20,20
1746588071197,MCWP 50,B00,893761,Bartulis; Jason Michael,17,0,20,3
1746588072223,MCWP 50R,A00,893766,Compas; Sean Matthew,0,1,20,20
1746588072223,MCWP 50R,B00,893769,Carter; Jennifer A,0,1,20,20
1746588072223,MCWP 50R,C00,893771,Krone; Jarret,0,3,20,20
1746588072223,MCWP 50R,D00,893772,Miller; Elizabeth Deen,0,0,20,20
1746588072223,MCWP 50R,E00,893775,Carter; Andrea L,0,1,20,20
1746588073250,MMW 11R,A01,892721,Herbst; Matthew,14,0,30,16
1746588073250,MMW 11R,A02,892722,Herbst; Matthew,0,0,0,3
1746588074275,MMW 12R,A01,892724,Herbst; Matthew,0,11,16,16
1746588074275,MMW 12R,A02,892725,Herbst; Matthew,0,10,16,16
1746588075304,MMW 13R,A01,892727,Staff,0,4,16,16
1746588075304,MMW 13R,A02,892728,Staff,0,4,16,16
1746588075304,MMW 13R,A03,958032,Staff,0,4,16,16
1746588075304,MMW 13R,A04,958033,Staff,0,4,16,16
1746588075304,MMW 13R,A05,958034,Staff,0,4,16,16
1746588076329,SIO 295LS,A00,894015,Staff,5,0,25,20
1746588077356,SIO 295S,A00,894020,Staff,5,0,25,20
1746588078385,SIOC 290S,B01,958918,Merrifield; Mark A,14,0,30,16
1746588079415,SIOC 291S,B01,958922,Gabriel; Corey John,14,0,30,16
1746588080441,SOCI 117,A01,895339,Staff,3,0,5,2
1746588081466,WES 237B,A00,894149,Staff,11,0,20,9
1746588083533,AESE 279B,A00,891859,Staff,13,0,35,22
1746588084562,AIP 197,001,891854,Vespa; Emanuel Ignacio,9999,0,9999,0
1746588085588,ANTH 289S,A00,891856,Gagneux; Pascal,12,0,12,0
1746588086614,BENG 196,001,957946,Engler; Adam J.,9996,0,9999,3
1746588087639,BISP 197,001,959851,Wilhelm; James E.,9998,0,9999,1
1746588088664,CAT 124RS,A01,956906,Staff,6,0,25,19
1746588089689,CAT 125RS,A01,922013,Staff,6,0,25,19
1746588090719,CLRE 250,A00,891860,Morris; Sheldon,9995,0,9999,4
1746588092769,CLRE 251R,A00,907817,Mehta; Ravindra L.,9994,0,9999,5
1746588093799,CLRE 252,A00,891864,Cuomo; Raphael Eduardo,9993,0,9999,6
1746588094824,CLRE 253,A00,891867,Vaida; Florin,9994,0,9999,5
1746588094824,CLRE 253,B00,907819,Staff,9999,0,9999,0
1746588095854,CLRE 259,A00,891868,Patel; Hemal,9998,0,9999,1
1746588096884,CLRE 260,A00,891872,Cuomo; Raphael Eduardo,9999,0,9999,0
1746588097908,CLRE 297,001,891888,Cuomo; Raphael Eduardo,9999,0,9999,0
1746588098936,CSE 191,A00,958773,Minnes Kemp; Mor Mia,9995,0,9999,4
1746588099961,CSE 197,001,959846,Minnes Kemp; Mor Mia,9990,0,9999,9
1746588100988,CSS 201S,A01,892054,Mignozzetti; Umberto,25,0,30,5
1746588102017,CSS 202S,A01,892056,Mignozzetti; Umberto,25,0,30,5
1746588103044,DSC 197,001,956898,Eldridge; Justin Matthew,9996,0,9999,3
1746588104070,DSC 297,001,958000,Mazumdar; Arya,9998,0,9999,1
1746588104070,DSC 297,002,959862,Wang; Yusu,9998,0,9999,1
1746588105097,EAP 100,A00,905686,Staff,9778,0,9999,221
1746588106127,ECE 45,A01,892618,Staff,0,0,65,65
1746588108180,ECE 111,A01,892719,Staff,6,0,65,59
1746588109207,ECE 197,001,957920,Mercier; Patrick Philip,9991,0,9999,8
1746588110233,ECON 178,A01,907814,Zhu; Ying,26,0,35,9
1746588111264,EDS 115,A00,895312,Staff,35,0,45,10
1746588112293,EDS 117,A01,895337,Staff,23,0,30,7
1746588113321,EDS 125,A00,895341,Jones; Gabrielle Anastasia,36,0,45,9
1746588114351,EDS 128A,A01,895459,Fargason; Sharon Gayle,44,0,45,1
1746588115375,EDS 128B,A01,895543,Pappas; Elizabeth,44,0,45,1
1746588116400,EDS 139,A00,897203,Pappas; Elizabeth,44,0,45,1
1746588116400,EDS 139,B00,897209,Fargason; Sharon Gayle,41,0,45,4
1746588117429,EDS 201,A00,895545,Staff,22,0,45,23
1746588118459,EDS 203,A01,895581,Halter; Christopher P.,22,0,45,23
1746588119487,EDS 204R,A01,895625,Heinzman; Erica M.,39,0,45,6
1746588119487,EDS 204R,B01,895693,Halter; Christopher P.,10,0,45,35
1746588120513,EDS 206R,A00,895694,Fargason; Sharon Gayle,1,0,30,29
1746588120513,EDS 206R,B00,895695,Choi; Bailey Miyeon,16,0,30,14
1746588121537,EDS 250,A00,895697,Hemans; Patricia Ann Benitez,22,0,45,23
1746588122561,EDS 281,A00,895701,Meyerott; Theresa Ann,1,0,15,14
1746588123589,EDS 284,A00,895736,Meyerott; Theresa Ann,1,0,15,14
1746588124616,EDS 286,A00,897210,Fine; Sarah,0,0,15,15
1746588125645,EDS 289C,A01,895770,Daly; Alan J.,1,0,15,14
1746588126675,EDS 290,A00,897211,Hofstetter; Carolyn,0,0,15,15
1746588127701,LIGM 5A,A00,896162,Fischer-Grunski; Eva K,12,0,20,8
1746588128728,LIGM 5B,A00,896260,Fischer-Grunski; Eva K,17,0,20,3
1746588129761,LIGM 5C,A00,896308,Fischer-Grunski; Eva K,18,0,20,2
1746588130789,LIIT 5AS,A00,896313,Carnelos; Chiara,18,0,20,2
1746588131815,LIIT 5BS,A00,896416,Carnelos; Chiara,20,0,20,0
1746588132841,LIIT 5CS,A00,896564,Carnelos; Chiara,20,0,20,0
1746588133871,LISP 5A,A00,896588,Munoz Sanchez; Alicia,2,0,20,18
1746588134901,LISP 5B,A00,896653,Munoz Sanchez; Alicia,7,0,20,13
1746588135931,LISP 5C,A00,896655,Munoz Sanchez; Alicia,0,1,20,20
1746588136957,MAE 197,001,957918,Kleissl; Jan,9996,0,9999,3
1746588136957,MAE 197,002,959806,Boechler; Nicholas Sebastia,9998,0,9999,1
1746588136957,MAE 197,003,959852,Mullin; Jennifer S,9998,0,9999,1
1746588137984,MATH 2,A01,957937,Staff,33,0,35,2
1746588139010,MATH 197,001,957876,Kedlaya; Kiran S.,9993,0,9999,6
1746588140040,MCWP 40,A00,892729,Duru; Nur,10,0,20,10
1746588140040,MCWP 40,B00,893304,Montejo; Carolina,14,0,20,6
1746588141099,MCWP 40R,A00,893757,Redela; Pamela Morgan,0,5,20,20
1746588142130,MCWP 50,A00,893758,Morshed; Michael James,0,0,20,20
1746588142130,MCWP 50,B00,893761,Bartulis; Jason Michael,17,0,20,3
1746588143210,MCWP 50R,A00,893766,Compas; Sean Matthew,0,1,20,20
1746588143210,MCWP 50R,B00,893769,Carter; Jennifer A,0,1,20,20
1746588143210,MCWP 50R,C00,893771,Krone; Jarret,0,3,20,20
1746588143210,MCWP 50R,D00,893772,Miller; Elizabeth Deen,0,0,20,20
1746588143210,MCWP 50R,E00,893775,Carter; Andrea L,0,1,20,20
1746588144234,MMW 11R,A01,892721,Herbst; Matthew,14,0,30,16
1746588144234,MMW 11R,A02,892722,Herbst; Matthew,0,0,0,3
1746588145259,MMW 12R,A01,892724,Herbst; Matthew,0,11,16,16
1746588145259,MMW 12R,A02,892725,Herbst; Matthew,0,10,16,16
1746588146285,MMW 13R,A01,892727,Staff,0,4,16,16
1746588146285,MMW 13R,A02,892728,Staff,0,4,16,16
1746588146285,MMW 13R,A03,958032,Staff,0,4,16,16
1746588146285,MMW 13R,A04,958033,Staff,0,4,16,16
1746588146285,MMW 13R,A05,958034,Staff,0,4,16,16
1746588147317,SIO 295LS,A00,894015,Staff,5,0,25,20
1746588148343,SIO 295S,A00,894020,Staff,5,0,25,20
1746588149378,SIOC 290S,B01,958918,Merrifield; Mark A,14,0,30,16
1746588150407,SIOC 291S,B01,958922,Gabriel; Corey John,14,0,30,16
1746588151433,SOCI 117,A01,895339,Staff,3,0,5,2
1746588152459,WES 237B,A00,894149,Staff,11,0,20,9
1746588154520,AESE 279B,A00,891859,Staff,13,0,35,22
1746588155549,AIP 197,001,891854,Vespa; Emanuel Ignacio,9999,0,9999,0
1746588156577,ANTH 289S,A00,891856,Gagneux; Pascal,12,0,12,0
1746588157606,BENG 196,001,957946,Engler; Adam J.,9996,0,9999,3
1746588158630,BISP 197,001,959851,Wilhelm; James E.,9998,0,9999,1
1746588159659,CAT 124RS,A01,956906,Staff,6,0,25,19
1746588160687,CAT 125RS,A01,922013,Staff,6,0,25,19
1746588161712,CLRE 250,A00,891860,Morris; Sheldon,9995,0,9999,4
1746588163766,CLRE 251R,A00,907817,Mehta; Ravindra L.,9994,0,9999,5
1746588164796,CLRE 252,A00,891864,Cuomo; Raphael Eduardo,9993,0,9999,6
1746588165824,CLRE 253,A00,891867,Vaida; Florin,9994,0,9999,5
1746588165824,CLRE 253,B00,907819,Staff,9999,0,9999,0
1746588166849,CLRE 259,A00,891868,Patel; Hemal,9998,0,9999,1
1746588167877,CLRE 260,A00,891872,Cuomo; Raphael Eduardo,9999,0,9999,0
1746588168903,CLRE 297,001,891888,Cuomo; Raphael Eduardo,9999,0,9999,0
1746588169932,CSE 191,A00,958773,Minnes Kemp; Mor Mia,9995,0,9999,4
1746588170960,CSE 197,001,959846,Minnes Kemp; Mor Mia,9990,0,9999,9
1746588171987,CSS 201S,A01,892054,Mignozzetti; Umberto,25,0,30,5
1746588173012,CSS 202S,A01,892056,Mignozzetti; Umberto,25,0,30,5
1746588174039,DSC 197,001,956898,Eldridge; Justin Matthew,9996,0,9999,3
1746588175068,DSC 297,001,958000,Mazumdar; Arya,9998,0,9999,1
1746588175068,DSC 297,002,959862,Wang; Yusu,9998,0,9999,1
1746588176097,EAP 100,A00,905686,Staff,9778,0,9999,221
1746588177129,ECE 45,A01,892618,Staff,0,0,65,65
1746588179190,ECE 111,A01,892719,Staff,6,0,65,59
1746588180221,ECE 197,001,957920,Mercier; Patrick Philip,9991,0,9999,8
1746588181246,ECON 178,A01,907814,Zhu; Ying,26,0,35,9
1746588182277,EDS 115,A00,895312,Staff,35,0,45,10
1746588183306,EDS 117,A01,895337,Staff,23,0,30,7
1746588184330,EDS 125,A00,895341,Jones; Gabrielle Anastasia,36,0,45,9
1746588185355,EDS 128A,A01,895459,Fargason; Sharon Gayle,44,0,45,1
1746588186382,EDS 128B,A01,895543,Pappas; Elizabeth,44,0,45,1
1746588187407,EDS 139,A00,897203,Pappas; Elizabeth,44,0,45,1
1746588187407,EDS 139,B00,897209,Fargason; Sharon Gayle,41,0,45,4
1746588188434,EDS 201,A00,895545,Staff,22,0,45,23
1746588189459,EDS 203,A01,895581,Halter; Christopher P.,22,0,45,23
1746588190485,EDS 204R,A01,895625,Heinzman; Erica M.,39,0,45,6
1746588190485,EDS 204R,B01,895693,Halter; Christopher P.,10,0,45,35
1746588191514,EDS 206R,A00,895694,Fargason; Sharon Gayle,1,0,30,29
1746588191514,EDS 206R,B00,895695,Choi; Bailey Miyeon,16,0,30,14
1746588192539,EDS 250,A00,895697,Hemans; Patricia Ann Benitez,22,0,45,23
1746588193567,EDS 281,A00,895701,Meyerott; Theresa Ann,1,0,15,14
1746588194592,EDS 284,A00,895736,Meyerott; Theresa Ann,1,0,15,14
1746588195618,EDS 286,A00,897210,Fine; Sarah,0,0,15,15
1746588196645,EDS 289C,A01,895770,Daly; Alan J.,1,0,15,14
1746588197674,EDS 290,A00,897211,Hofstetter; Carolyn,0,0,15,15
1746588198700,LIGM 5A,A00,896162,Fischer-Grunski; Eva K,12,0,20,8
1746588199728,LIGM 5B,A00,896260,Fischer-Grunski; Eva K,17,0,20,3
1746588200755,LIGM 5C,A00,896308,Fischer-Grunski; Eva K,18,0,20,2
1746588201784,LIIT 5AS,A00,896313,Carnelos; Chiara,18,0,20,2
1746588202812,LIIT 5BS,A00,896416,Carnelos; Chiara,20,0,20,0
1746588203839,LIIT 5CS,A00,896564,Carnelos; Chiara,20,0,20,0
1746588204868,LISP 5A,A00,896588,Munoz Sanchez; Alicia,2,0,20,18
1746588205895,LISP 5B,A00,896653,Munoz Sanchez; Alicia,7,0,20,13
1746588206925,LISP 5C,A00,896655,Munoz Sanchez; Alicia,0,1,20,20
1746588207954,MAE 197,001,957918,Kleissl; Jan,9996,0,9999,3
1746588207954,MAE 197,002,959806,Boechler; Nicholas Sebastia,9998,0,9999,1
1746588207954,MAE 197,003,959852,Mullin; Jennifer S,9998,0,9999,1
1746588208979,MATH 2,A01,957937,Staff,33,0,35,2
1746588210006,MATH 197,001,957876,Kedlaya; Kiran S.,9993,0,9999,6
1746588211032,MCWP 40,A00,892729,Duru; Nur,10,0,20,10
1746588211032,MCWP 40,B00,893304,Montejo; Carolina,14,0,20,6
1746588212057,MCWP 40R,A00,893757,Redela; Pamela Morgan,0,5,20,20
1746588213083,MCWP 50,A00,893758,Morshed; Michael James,0,0,20,20
1746588213083,MCWP 50,B00,893761,Bartulis; Jason Michael,17,0,20,3
1746588214112,MCWP 50R,A00,893766,Compas; Sean Matthew,0,1,20,20
1746588214112,MCWP 50R,B00,893769,Carter; Jennifer A,0,1,20,20
1746588214112,MCWP 50R,C00,893771,Krone; Jarret,0,3,20,20
1746588214112,MCWP 50R,D00,893772,Miller; Elizabeth Deen,0,0,20,20
1746588214112,MCWP 50R,E00,893775,Carter; Andrea L,0,1,20,20
1746588215140,MMW 11R,A01,892721,Herbst; Matthew,14,0,30,16
1746588215140,MMW 11R,A02,892722,Herbst; Matthew,0,0,0,3
1746588216171,MMW 12R,A01,892724,Herbst; Matthew,0,11,16,16
1746588216171,MMW 12R,A02,892725,Herbst; Matthew,0,10,16,16
1746588217199,MMW 13R,A01,892727,Staff,0,4,16,16
1746588217199,MMW 13R,A02,892728,Staff,0,4,16,16
1746588217199,MMW 13R,A03,958032,Staff,0,4,16,16
1746588217199,MMW 13R,A04,958033,Staff,0,4,16,16
1746588217199,MMW 13R,A05,958034,Staff,0,4,16,16
1746588218226,SIO 295LS,A00,894015,Staff,5,0,25,20
1746588219256,SIO 295S,A00,894020,Staff,5,0,25,20
1746588220285,SIOC 290S,B01,958918,Merrifield; Mark A,14,0,30,16
1746588221315,SIOC 291S,B01,958922,Gabriel; Corey John,14,0,30,16
1746588222341,SOCI 117,A01,895339,Staff,3,0,5,2
1746588223368,WES 237B,A00,894149,Staff,11,0,20,9
1746588225444,AESE 279B,A00,891859,Staff,13,0,35,22
1746588226471,AIP 197,001,891854,Vespa; Emanuel Ignacio,9999,0,9999,0
1746588227497,ANTH 289S,A00,891856,Gagneux; Pascal,12,0,12,0
1746588228522,BENG 196,001,957946,Engler; Adam J.,9996,0,9999,3
1746588229548,BISP 197,001,959851,Wilhelm; James E.,9998,0,9999,1
1746588230575,CAT 124RS,A01,956906,Staff,6,0,25,19
1746588231601,CAT 125RS,A01,922013,Staff,6,0,25,19
1746588232629,CLRE 250,A00,891860,Morris; Sheldon,9995,0,9999,4
1746588234681,CLRE 251R,A00,907817,Mehta; Ravindra L.,9994,0,9999,5
1746588235708,CLRE 252,A00,891864,Cuomo; Raphael Eduardo,9993,0,9999,6
1746588236737,CLRE 253,A00,891867,Vaida; Florin,9994,0,9999,5
1746588236737,CLRE 253,B00,907819,Staff,9999,0,9999,0
1746588237762,CLRE 259,A00,891868,Patel; Hemal,9998,0,9999,1
1746588238789,CLRE 260,A00,891872,Cuomo; Raphael Eduardo,9999,0,9999,0
1746588239815,CLRE 297,001,891888,Cuomo; Raphael Eduardo,9999,0,9999,0
1746588240843,CSE 191,A00,958773,Minnes Kemp; Mor Mia,9995,0,9999,4
1746588241870,CSE 197,001,959846,Minnes Kemp; Mor Mia,9990,0,9999,9
1746588242896,CSS 201S,A01,892054,Mignozzetti; Umberto,25,0,30,5
1746588243926,CSS 202S,A01,892056,Mignozzetti; Umberto,25,0,30,5
1746588244953,DSC 197,001,956898,Eldridge; Justin Matthew,9996,0,9999,3
1746588245982,DSC 297,001,958000,Mazumdar; Arya,9998,0,9999,1
1746588245982,DSC 297,002,959862,Wang; Yusu,9998,0,9999,1
1746588247011,EAP 100,A00,905686,Staff,9778,0,9999,221
1746588248038,ECE 45,A01,892618,Staff,0,0,65,65
1746588250096,ECE 111,A01,892719,Staff,6,0,65,59
1746588251123,ECE 197,001,957920,Mercier; Patrick Philip,9991,0,9999,8
1746588252152,ECON 178,A01,907814,Zhu; Ying,26,0,35,9
1746588253180,EDS 115,A00,895312,Staff,35,0,45,10
1746588254206,EDS 117,A01,895337,Staff,23,0,30,7
1746588255231,EDS 125,A00,895341,Jones; Gabrielle Anastasia,36,0,45,9
1746588256256,EDS 128A,A01,895459,Fargason; Sharon Gayle,44,0,45,1
1746588257282,EDS 128B,A01,895543,Pappas; Elizabeth,44,0,45,1
1746588258311,EDS 139,A00,897203,Pappas; Elizabeth,44,0,45,1
1746588258311,EDS 139,B00,897209,Fargason; Sharon Gayle,41,0,45,4
1746588259340,EDS 201,A00,895545,Staff,22,0,45,23
1746588260365,EDS 203,A01,895581,Halter; Christopher P.,22,0,45,23
1746588261394,EDS 204R,A01,895625,Heinzman; Erica M.,39,0,45,6
1746588261394,EDS 204R,B01,895693,Halter; Christopher P.,10,0,45,35
1746588262423,EDS 206R,A00,895694,Fargason; Sharon Gayle,1,0,30,29
1746588262423,EDS 206R,B00,895695,Choi; Bailey Miyeon,16,0,30,14
1746588263451,EDS 250,A00,895697,Hemans; Patricia Ann Benitez,22,0,45,23
1746588264475,EDS 281,A00,895701,Meyerott; Theresa Ann,1,0,15,14
1746588265503,EDS 284,A00,895736,Meyerott; Theresa Ann,1,0,15,14
1746588266530,EDS 286,A00,897210,Fine; Sarah,0,0,15,15
1746588267554,EDS 289C,A01,895770,Daly; Alan J.,1,0,15,14
1746588268582,EDS 290,A00,897211,Hofstetter; Carolyn,0,0,15,15
1746588269608,LIGM 5A,A00,896162,Fischer-Grunski; Eva K,12,0,20,8
1746588270635,LIGM 5B,A00,896260,Fischer-Grunski; Eva K,17,0,20,3
1746588271665,LIGM 5C,A00,896308,Fischer-Grunski; Eva K,18,0,20,2
1746588272691,LIIT 5AS,A00,896313,Carnelos; Chiara,18,0,20,2
1746588273720,LIIT 5BS,A00,896416,Carnelos; Chiara,20,0,20,0
1746588274748,LIIT 5CS,A00,896564,Carnelos; Chiara,20,0,20,0
1746588275773,LISP 5A,A00,896588,Munoz Sanchez; Alicia,2,0,20,18
1746588276801,LISP 5B,A00,896653,Munoz Sanchez; Alicia,7,0,20,13
1746588277833,LISP 5C,A00,896655,Munoz Sanchez; Alicia,0,1,20,20
1746588278859,MAE 197,001,957918,Kleissl; Jan,9996,0,9999,3
1746588278859,MAE 197,002,959806,Boechler; Nicholas Sebastia,9998,0,9999,1
1746588278859,MAE 197,003,959852,Mullin; Jennifer S,9998,0,9999,1
1746588279884,MATH 2,A01,957937,Staff,33,0,35,2
1746588280913,MATH 197,001,957876,Kedlaya; Kiran S.,9993,0,9999,6
1746588281940,MCWP 40,A00,892729,Duru; Nur,10,0,20,10
1746588281940,MCWP 40,B00,893304,Montejo; Carolina,14,0,20,6
1746588282969,MCWP 40R,A00,893757,Redela; Pamela Morgan,0,5,20,20
1746588283995,MCWP 50,A00,893758,Morshed; Michael James,0,0,20,20
1746588283995,MCWP 50,B00,893761,Bartulis; Jason Michael,17,0,20,3
1746588285022,MCWP 50R,A00,893766,Compas; Sean Matthew,0,1,20,20
1746588285022,MCWP 50R,B00,893769,Carter; Jennifer A,0,1,20,20
1746588285022,MCWP 50R,C00,893771,Krone; Jarret,0,3,20,20
1746588285022,MCWP 50R,D00,893772,Miller; Elizabeth Deen,0,0,20,20
1746588285022,MCWP 50R,E00,893775,Carter; Andrea L,0,1,20,20
1746588286047,MMW 11R,A01,892721,Herbst; Matthew,14,0,30,16
1746588286047,MMW 11R,A02,892722,Herbst; Matthew,0,0,0,3
1746588287076,MMW 12R,A01,892724,Herbst; Matthew,0,11,16,16
1746588287076,MMW 12R,A02,892725,Herbst; Matthew,0,10,16,16
1746588288107,MMW 13R,A01,892727,Staff,0,4,16,16
1746588288107,MMW 13R,A02,892728,Staff,0,4,16,16
1746588288107,MMW 13R,A03,958032,Staff,0,4,16,16
1746588288107,MMW 13R,A04,958033,Staff,0,4,16,16
1746588288107,MMW 13R,A05,958034,Staff,0,4,16,16
1746588289133,SIO 295LS,A00,894015,Staff,5,0,25,20
1746588290159,SIO 295S,A00,894020,Staff,5,0,25,20
1746588291190,SIOC 290S,B01,958918,Merrifield; Mark A,14,0,30,16
1746588292216,SIOC 291S,B01,958922,Gabriel; Corey John,14,0,30,16
1746588293244,SOCI 117,A01,895339,Staff,3,0,5,2
1746588294270,WES 237B,A00,894149,Staff,11,0,20,9
1746588296340,AESE 279B,A00,891859,Staff,13,0,35,22
1746588297367,AIP 197,001,891854,Vespa; Emanuel Ignacio,9999,0,9999,0
1746588298392,ANTH 289S,A00,891856,Gagneux; Pascal,12,0,12,0
1746588299418,BENG 196,001,957946,Engler; Adam J.,9996,0,9999,3
1746588300444,BISP 197,001,959851,Wilhelm; James E.,9998,0,9999,1
1746588301469,CAT 124RS,A01,956906,Staff,6,0,25,19
1746588302498,CAT 125RS,A01,922013,Staff,6,0,25,19
1746588303522,CLRE 250,A00,891860,Morris; Sheldon,9995,0,9999,4
1746588305577,CLRE 251R,A00,907817,Mehta; Ravindra L.,9994,0,9999,5
1746588306601,CLRE 252,A00,891864,Cuomo; Raphael Eduardo,9993,0,9999,6
1746588307627,CLRE 253,A00,891867,Vaida; Florin,9994,0,9999,5
1746588307627,CLRE 253,B00,907819,Staff,9999,0,9999,0
1746588308656,CLRE 259,A00,891868,Patel; Hemal,9998,0,9999,1
1746588309681,CLRE 260,A00,891872,Cuomo; Raphael Eduardo,9999,0,9999,0
1746588310706,CLRE 297,001,891888,Cuomo; Raphael Eduardo,9999,0,9999,0
1746588311737,CSE 191,A00,958773,Minnes Kemp; Mor Mia,9995,0,9999,4
1746588312761,CSE 197,001,959846,Minnes Kemp; Mor Mia,9990,0,9999,9
1746588313789,CSS 201S,A01,892054,Mignozzetti; Umberto,25,0,30,5
1746588314815,CSS 202S,A01,892056,Mignozzetti; Umberto,25,0,30,5
1746588315841,DSC 197,001,956898,Eldridge; Justin Matthew,9996,0,9999,3
1746588316876,DSC 297,001,958000,Mazumdar; Arya,9998,0,9999,1
1746588316876,DSC 297,002,959862,Wang; Yusu,9998,0,9999,1
1746588317904,EAP 100,A00,905686,Staff,9778,0,9999,221
1746588318931,ECE 45,A01,892618,Staff,0,0,65,65
1746588320980,ECE 111,A01,892719,Staff,6,0,65,59
1746588322006,ECE 197,001,957920,Mercier; Patrick Philip,9991,0,9999,8
1746588323037,ECON 178,A01,907814,Zhu; Ying,26,0,35,9
1746588324067,EDS 115,A00,895312,Staff,35,0,45,10
1746588325093,EDS 117,A01,895337,Staff,23,0,30,7
1746588326119,EDS 125,A00,895341,Jones; Gabrielle Anastasia,36,0,45,9
1746588327144,EDS 128A,A01,895459,Fargason; Sharon Gayle,44,0,45,1
1746588328171,EDS 128B,A01,895543,Pappas; Elizabeth,44,0,45,1
1746588329195,EDS 139,A00,897203,Pappas; Elizabeth,44,0,45,1
1746588329195,EDS 139,B00,897209,Fargason; Sharon Gayle,41,0,45,4
1746588330221,EDS 201,A00,895545,Staff,22,0,45,23
1746588331247,EDS 203,A01,895581,Halter; Christopher P.,22,0,45,23
1746588332272,EDS 204R,A01,895625,Heinzman; Erica M.,39,0,45,6
1746588332272,EDS 204R,B01,895693,Halter; Christopher P.,10,0,45,35
1746588333300,EDS 206R,A00,895694,Fargason; Sharon Gayle,1,0,30,29
1746588333300,EDS 206R,B00,895695,Choi; Bailey Miyeon,16,0,30,14
1746588334325,EDS 250,A00,895697,Hemans; Patricia Ann Benitez,22,0,45,23
1746588335350,EDS 281,A00,895701,Meyerott; Theresa Ann,1,0,15,14
1746588336376,EDS 284,A00,895736,Meyerott; Theresa Ann,1,0,15,14
1746588337404,EDS 286,A00,897210,Fine; Sarah,0,0,15,15
1746588338433,EDS 289C,A01,895770,Daly; Alan J.,1,0,15,14
1746588339458,EDS 290,A00,897211,Hofstetter; Carolyn,0,0,15,15
1746588340483,LIGM 5A,A00,896162,Fischer-Grunski; Eva K,12,0,20,8
1746588341515,LIGM 5B,A00,896260,Fischer-Grunski; Eva K,17,0,20,3
1746588342541,LIGM 5C,A00,896308,Fischer-Grunski; Eva K,18,0,20,2
1746588343569,LIIT 5AS,A00,896313,Carnelos; Chiara,18,0,20,2
1746588344596,LIIT 5BS,A00,896416,Carnelos; Chiara,20,0,20,0
1746588345622,LIIT 5CS,A00,896564,Carnelos; Chiara,20,0,20,0
1746588346650,LISP 5A,A00,896588,Munoz Sanchez; Alicia,2,0,20,18
1746588347676,LISP 5B,A00,896653,Munoz Sanchez; Alicia,7,0,20,13
1746588348706,LISP 5C,A00,896655,Munoz Sanchez; Alicia,0,1,20,20
1746588349731,MAE 197,001,957918,Kleissl; Jan,9996,0,9999,3
1746588349731,MAE 197,002,959806,Boechler; Nicholas Sebastia,9998,0,9999,1
1746588349731,MAE 197,003,959852,Mullin; Jennifer S,9998,0,9999,1
1746588350757,MATH 2,A01,957937,Staff,33,0,35,2
1746588351785,MATH 197,001,957876,Kedlaya; Kiran S.,9993,0,9999,6
1746588352814,MCWP 40,A00,892729,Duru; Nur,10,0,20,10
1746588352814,MCWP 40,B00,893304,Montejo; Carolina,14,0,20,6
1746588353843,MCWP 40R,A00,893757,Redela; Pamela Morgan,0,5,20,20
1746588354872,MCWP 50,A00,893758,Morshed; Michael James,0,0,20,20
1746588354872,MCWP 50,B00,893761,Bartulis; Jason Michael,17,0,20,3
1746588355905,MCWP 50R,A00,893766,Compas; Sean Matthew,0,1,20,20
1746588355905,MCWP 50R,B00,893769,Carter; Jennifer A,0,1,20,20
1746588355905,MCWP 50R,C00,893771,Krone; Jarret,0,3,20,20
1746588355905,MCWP 50R,D00,893772,Miller; Elizabeth Deen,0,0,20,20
1746588355905,MCWP 50R,E00,893775,Carter; Andrea L,0,1,20,20
1746588356935,MMW 11R,A01,892721,Herbst; Matthew,14,0,30,16
1746588356935,MMW 11R,A02,892722,Herbst; Matthew,0,0,0,3
1746588357964,MMW 12R,A01,892724,Herbst; Matthew,0,11,16,16
1746588357964,MMW 12R,A02,892725,Herbst; Matthew,0,10,16,16
1746588358994,MMW 13R,A01,892727,Staff,0,4,16,16
1746588358994,MMW 13R,A02,892728,Staff,0,4,16,16
1746588358994,MMW 13R,A03,958032,Staff,0,4,16,16
1746588358994,MMW 13R,A04,958033,Staff,0,4,16,16
1746588358994,MMW 13R,A05,958034,Staff,0,4,16,16
1746588360025,SIO 295LS,A00,894015,Staff,5,0,25,20
1746588361054,SIO 295S,A00,894020,Staff,5,0,25,20
1746588362086,SIOC 290S,B01,958918,Merrifield; Mark A,14,0,30,16
1746588363112,SIOC 291S,B01,958922,Gabriel; Corey John,14,0,30,16
1746588364143,SOCI 117,A01,895339,Staff,3,0,5,2
1746588365171,WES 237B,A00,894149,Staff,11,0,20,9
1746588367237,AESE 279B,A00,891859,Staff,13,0,35,22
1746588368264,AIP 197,001,891854,Vespa; Emanuel Ignacio,9999,0,9999,0
1746588369289,ANTH 289S,A00,891856,Gagneux; Pascal,12,0,12,0
1746588370314,BENG 196,001,957946,Engler; Adam J.,9996,0,9999,3
1746588371341,BISP 197,001,959851,Wilhelm; James E.,9998,0,9999,1
1746588372368,CAT 124RS,A01,956906,Staff,6,0,25,19
1746588373393,CAT 125RS,A01,922013,Staff,6,0,25,19
1746588374422,CLRE 250,A00,891860,Morris; Sheldon,9995,0,9999,4
1746588376476,CLRE 251R,A00,907817,Mehta; Ravindra L.,9994,0,9999,5
1746588377503,CLRE 252,A00,891864,Cuomo; Raphael Eduardo,9993,0,9999,6
1746588378529,CLRE 253,A00,891867,Vaida; Florin,9994,0,9999,5
1746588378529,CLRE 253,B00,907819,Staff,9999,0,9999,0
1746588379553,CLRE 259,A00,891868,Patel; Hemal,9998,0,9999,1
1746588380579,CLRE 260,A00,891872,Cuomo; Raphael Eduardo,9999,0,9999,0
1746588381606,CLRE 297,001,891888,Cuomo; Raphael Eduardo,9999,0,9999,0
1746588382631,CSE 191,A00,958773,Minnes Kemp; Mor Mia,9995,0,9999,4
1746588383658,CSE 197,001,959846,Minnes Kemp; Mor Mia,9990,0,9999,9
1746588384683,CSS 201S,A01,892054,Mignozzetti; Umberto,25,0,30,5
1746588385709,CSS 202S,A01,892056,Mignozzetti; Umberto,25,0,30,5
1746588386739,DSC 197,001,956898,Eldridge; Justin Matthew,9996,0,9999,3
1746588387768,DSC 297,001,958000,Mazumdar; Arya,9998,0,9999,1
1746588387768,DSC 297,002,959862,Wang; Yusu,9998,0,9999,1
1746588388796,EAP 100,A00,905686,Staff,9778,0,9999,221
1746588389828,ECE 45,A01,892618,Staff,0,0,65,65
1746588391883,ECE 111,A01,892719,Staff,6,0,65,59
1746588392910,ECE 197,001,957920,Mercier; Patrick Philip,9991,0,9999,8
1746588393936,ECON 178,A01,907814,Zhu; Ying,26,0,35,9
1746588394962,EDS 115,A00,895312,Staff,35,0,45,10
1746588395988,EDS 117,A01,895337,Staff,23,0,30,7
1746588397015,EDS 125,A00,895341,Jones; Gabrielle Anastasia,36,0,45,9
1746588398043,EDS 128A,A01,895459,Fargason; Sharon Gayle,44,0,45,1
1746588399070,EDS 128B,A01,895543,Pappas; Elizabeth,44,0,45,1
1746588400101,EDS 139,A00,897203,Pappas; Elizabeth,44,0,45,1
1746588400101,EDS 139,B00,897209,Fargason; Sharon Gayle,41,0,45,4
1746588401128,EDS 201,A00,895545,Staff,22,0,45,23
1746588402154,EDS 203,A01,895581,Halter; Christopher P.,22,0,45,23
1746588403179,EDS 204R,A01,895625,Heinzman; Erica M.,39,0,45,6
1746588403179,EDS 204R,B01,895693,Halter; Christopher P.,10,0,45,35
1746588404204,EDS 206R,A00,895694,Fargason; Sharon Gayle,1,0,30,29
1746588404204,EDS 206R,B00,895695,Choi; Bailey Miyeon,16,0,30,14
1746588405235,EDS 250,A00,895697,Hemans; Patricia Ann Benitez,22,0,45,23
1746588406265,EDS 281,A00,895701,Meyerott; Theresa Ann,1,0,15,14
1746588407291,EDS 284,A00,895736,Meyerott; Theresa Ann,1,0,15,14
1746588408316,EDS 286,A00,897210,Fine; Sarah,0,0,15,15
1746588409344,EDS 289C,A01,895770,Daly; Alan J.,1,0,15,14
1746588410370,EDS 290,A00,897211,Hofstetter; Carolyn,0,0,15,15
1746588411394,LIGM 5A,A00,896162,Fischer-Grunski; Eva K,12,0,20,8
1746588412419,LIGM 5B,A00,896260,Fischer-Grunski; Eva K,17,0,20,3
1746588413451,LIGM 5C,A00,896308,Fischer-Grunski; Eva K,18,0,20,2
1746588414481,LIIT 5AS,A00,896313,Carnelos; Chiara,18,0,20,2
1746588415507,LIIT 5BS,A00,896416,Carnelos; Chiara,20,0,20,0
1746588416534,LIIT 5CS,A00,896564,Carnelos; Chiara,20,0,20,0
1746588417565,LISP 5A,A00,896588,Munoz Sanchez; Alicia,2,0,20,18
1746588418590,LISP 5B,A00,896653,Munoz Sanchez; Alicia,7,0,20,13
1746588419621,LISP 5C,A00,896655,Munoz Sanchez; Alicia,0,1,20,20
1746588420649,MAE 197,001,957918,Kleissl; Jan,9996,0,9999,3
1746588420649,MAE 197,002,959806,Boechler; Nicholas Sebastia,9998,0,9999,1
1746588420649,MAE 197,003,959852,Mullin; Jennifer S,9998,0,9999,1
1746588421679,MATH 2,A01,957937,Staff,33,0,35,2
1746588422706,MATH 197,001,957876,Kedlaya; Kiran S.,9993,0,9999,6
1746588423737,MCWP 40,A00,892729,Duru; Nur,10,0,20,10
1746588423737,MCWP 40,B00,893304,Montejo; Carolina,14,0,20,6
1746588424762,MCWP 40R,A00,893757,Redela; Pamela Morgan,0,5,20,20
1746588425795,MCWP 50,A00,893758,Morshed; Michael James,0,0,20,20
1746588425795,MCWP 50,B00,893761,Bartulis; Jason Michael,17,0,20,3
1746588426821,MCWP 50R,A00,893766,Compas; Sean Matthew,0,1,20,20
1746588426821,MCWP 50R,B00,893769,Carter; Jennifer A,0,1,20,20
1746588426821,MCWP 50R,C00,893771,Krone; Jarret,0,3,20,20
1746588426821,MCWP 50R,D00,893772,Miller; Elizabeth Deen,0,0,20,20
1746588426821,MCWP 50R,E00,893775,Carter; Andrea L,0,1,20,20
1746588427850,MMW 11R,A01,892721,Herbst; Matthew,14,0,30,16
1746588427850,MMW 11R,A02,892722,Herbst; Matthew,0,0,0,3
1746588428877,MMW 12R,A01,892724,Herbst; Matthew,0,11,16,16
1746588428877,MMW 12R,A02,892725,Herbst; Matthew,0,10,16,16
1746588429907,MMW 13R,A01,892727,Staff,0,4,16,16
1746588429907,MMW 13R,A02,892728,Staff,0,4,16,16
1746588429907,MMW 13R,A03,958032,Staff,0,4,16,16
1746588429907,MMW 13R,A04,958033,Staff,0,4,16,16
1746588429907,MMW 13R,A05,958034,Staff,0,4,16,16
1746588430934,SIO 295LS,A00,894015,Staff,5,0,25,20
1746588431964,SIO 295S,A00,894020,Staff,5,0,25,20
1746588432991,SIOC 290S,B01,958918,Merrifield; Mark A,14,0,30,16
1746588434017,SIOC 291S,B01,958922,Gabriel; Corey John,14,0,30,16
1746588435042,SOCI 117,A01,895339,Staff,3,0,5,2
1746588436066,WES 237B,A00,894149,Staff,11,0,20,9
1746588438123,AESE 279B,A00,891859,Staff,13,0,35,22
1746588439152,AIP 197,001,891854,Vespa; Emanuel Ignacio,9999,0,9999,0
1746588440182,ANTH 289S,A00,891856,Gagneux; Pascal,12,0,12,0
1746588441210,BENG 196,001,957946,Engler; Adam J.,9996,0,9999,3
1746588442237,BISP 197,001,959851,Wilhelm; James E.,9998,0,9999,1
1746588443261,CAT 124RS,A01,956906,Staff,6,0,25,19
1746588444289,CAT 125RS,A01,922013,Staff,6,0,25,19
1746588445315,CLRE 250,A00,891860,Morris; Sheldon,9995,0,9999,4
1746588447366,CLRE 251R,A00,907817,Mehta; Ravindra L.,9994,0,9999,5
1746588448390,CLRE 252,A00,891864,Cuomo; Raphael Eduardo,9993,0,9999,6
1746588449420,CLRE 253,A00,891867,Vaida; Florin,9994,0,9999,5
1746588449420,CLRE 253,B00,907819,Staff,9999,0,9999,0
1746588450445,CLRE 259,A00,891868,Patel; Hemal,9998,0,9999,1
1746588451473,CLRE 260,A00,891872,Cuomo; Raphael Eduardo,9999,0,9999,0
1746588452497,CLRE 297,001,891888,Cuomo; Raphael Eduardo,9999,0,9999,0
1746588453525,CSE 191,A00,958773,Minnes Kemp; Mor Mia,9995,0,9999,4
1746588454550,CSE 197,001,959846,Minnes Kemp; Mor Mia,9990,0,9999,9
1746588455577,CSS 201S,A01,892054,Mignozzetti; Umberto,25,0,30,5
1746588456603,CSS 202S,A01,892056,Mignozzetti; Umberto,25,0,30,5
1746588457629,DSC 197,001,956898,Eldridge; Justin Matthew,9996,0,9999,3
1746588458656,DSC 297,001,958000,Mazumdar; Arya,9998,0,9999,1
1746588458656,DSC 297,002,959862,Wang; Yusu,9998,0,9999,1
1746588459682,EAP 100,A00,905686,Staff,9778,0,9999,221
1746588460707,ECE 45,A01,892618,Staff,0,0,65,65
1746588462759,ECE 111,A01,892719,Staff,6,0,65,59
1746588463788,ECE 197,001,957920,Mercier; Patrick Philip,9991,0,9999,8
1746588464814,ECON 178,A01,907814,Zhu; Ying,26,0,35,9
1746588465840,EDS 115,A00,895312,Staff,35,0,45,10
1746588466872,EDS 117,A01,895337,Staff,23,0,30,7
1746588467898,EDS 125,A00,895341,Jones; Gabrielle Anastasia,36,0,45,9
1746588468928,EDS 128A,A01,895459,Fargason; Sharon Gayle,44,0,45,1
1746588469958,EDS 128B,A01,895543,Pappas; Elizabeth,44,0,45,1
1746588470983,EDS 139,A00,897203,Pappas; Elizabeth,44,0,45,1
1746588470983,EDS 139,B00,897209,Fargason; Sharon Gayle,41,0,45,4
1746588472011,EDS 201,A00,895545,Staff,22,0,45,23
1746588473040,EDS 203,A01,895581,Halter; Christopher P.,22,0,45,23
1746588474065,EDS 204R,A01,895625,Heinzman; Erica M.,39,0,45,6
1746588474065,EDS 204R,B01,895693,Halter; Christopher P.,10,0,45,35
1746588475091,EDS 206R,A00,895694,Fargason; Sharon Gayle,1,0,30,29
1746588475091,EDS 206R,B00,895695,Choi; Bailey Miyeon,16,0,30,14
1746588476119,EDS 250,A00,895697,Hemans; Patricia Ann Benitez,22,0,45,23
1746588477144,EDS 281,A00,895701,Meyerott; Theresa Ann,1,0,15,14
1746588478167,EDS 284,A00,895736,Meyerott; Theresa Ann,1,0,15,14
1746588479196,EDS 286,A00,897210,Fine; Sarah,0,0,15,15
1746588480226,EDS 289C,A01,895770,Daly; Alan J.,1,0,15,14
1746588481255,EDS 290,A00,897211,Hofstetter; Carolyn,0,0,15,15
1746588482285,LIGM 5A,A00,896162,Fischer-Grunski; Eva K,12,0,20,8
1746588483311,LIGM 5B,A00,896260,Fischer-Grunski; Eva K,17,0,20,3
1746588484335,LIGM 5C,A00,896308,Fischer-Grunski; Eva K,18,0,20,2
1746588485361,LIIT 5AS,A00,896313,Carnelos; Chiara,18,0,20,2
1746588486391,LIIT 5BS,A00,896416,Carnelos; Chiara,20,0,20,0
1746588487420,LIIT 5CS,A00,896564,Carnelos; Chiara,20,0,20,0
1746588488446,LISP 5A,A00,896588,Munoz Sanchez; Alicia,2,0,20,18
1746588489473,LISP 5B,A00,896653,Munoz Sanchez; Alicia,7,0,20,13
1746588490498,LISP 5C,A00,896655,Munoz Sanchez; Alicia,0,1,20,20
1746588491527,MAE 197,001,957918,Kleissl; Jan,9996,0,9999,3
1746588491527,MAE 197,002,959806,Boechler; Nicholas Sebastia,9998,0,9999,1
1746588491527,MAE 197,003,959852,Mullin; Jennifer S,9998,0,9999,1
1746588492556,MATH 2,A01,957937,Staff,33,0,35,2
1746588493585,MATH 197,001,957876,Kedlaya; Kiran S.,9993,0,9999,6
1746588494613,MCWP 40,A00,892729,Duru; Nur,10,0,20,10
1746588494613,MCWP 40,B00,893304,Montejo; Carolina,14,0,20,6
1746588495640,MCWP 40R,A00,893757,Redela; Pamela Morgan,0,5,20,20
1746588496666,MCWP 50,A00,893758,Morshed; Michael James,0,0,20,20
1746588496666,MCWP 50,B00,893761,Bartulis; Jason Michael,17,0,20,3
1746588497691,MCWP 50R,A00,893766,Compas; Sean Matthew,0,1,20,20
1746588497691,MCWP 50R,B00,893769,Carter; Jennifer A,0,1,20,20
1746588497691,MCWP 50R,C00,893771,Krone; Jarret,0,3,20,20
1746588497691,MCWP 50R,D00,893772,Miller; Elizabeth Deen,0,0,20,20
1746588497691,MCWP 50R,E00,893775,Carter; Andrea L,0,1,20,20
1746588498716,MMW 11R,A01,892721,Herbst; Matthew,14,0,30,16
1746588498716,MMW 11R,A02,892722,Herbst; Matthew,0,0,0,3
1746588499741,MMW 12R,A01,892724,Herbst; Matthew,0,11,16,16
1746588499741,MMW 12R,A02,892725,Herbst; Matthew,0,10,16,16
1746588500771,MMW 13R,A01,892727,Staff,0,4,16,16
1746588500771,MMW 13R,A02,892728,Staff,0,4,16,16
1746588500771,MMW 13R,A03,958032,Staff,0,4,16,16
1746588500771,MMW 13R,A04,958033,Staff,0,4,16,16
1746588500771,MMW 13R,A05,958034,Staff,0,4,16,16
1746588501798,SIO 295LS,A00,894015,Staff,5,0,25,20
1746588502822,SIO 295S,A00,894020,Staff,5,0,25,20
1746588503849,SIOC 290S,B01,958918,Merrifield; Mark A,14,0,30,16
1746588504876,SIOC 291S,B01,958922,Gabriel; Corey John,14,0,30,16
1746588505903,SOCI 117,A01,895339,Staff,3,0,5,2
1746588506934,WES 237B,A00,894149,Staff,11,0,20,9
1746588509022,AESE 279B,A00,891859,Staff,13,0,35,22
1746588510047,AIP 197,001,891854,Vespa; Emanuel Ignacio,9999,0,9999,0
1746588511076,ANTH 289S,A00,891856,Gagneux; Pascal,12,0,12,0
1746588512101,BENG 196,001,957946,Engler; Adam J.,9996,0,9999,3
1746588513130,BISP 197,001,959851,Wilhelm; James E.,9998,0,9999,1
1746588514156,CAT 124RS,A01,956906,Staff,6,0,25,19
1746588515181,CAT 125RS,A01,922013,Staff,6,0,25,19
1746588516210,CLRE 250,A00,891860,Morris; Sheldon,9995,0,9999,4
1746588518265,CLRE 251R,A00,907817,Mehta; Ravindra L.,9994,0,9999,5
1746588519291,CLRE 252,A00,891864,Cuomo; Raphael Eduardo,9993,0,9999,6
1746588520318,CLRE 253,A00,891867,Vaida; Florin,9994,0,9999,5
1746588520318,CLRE 253,B00,907819,Staff,9999,0,9999,0
1746588521348,CLRE 259,A00,891868,Patel; Hemal,9998,0,9999,1
1746588522376,CLRE 260,A00,891872,Cuomo; Raphael Eduardo,9999,0,9999,0
1746588523405,CLRE 297,001,891888,Cuomo; Raphael Eduardo,9999,0,9999,0
1746588524431,CSE 191,A00,958773,Minnes Kemp; Mor Mia,9995,0,9999,4
1746588525458,CSE 197,001,959846,Minnes Kemp; Mor Mia,9990,0,9999,9
1746588526484,CSS 201S,A01,892054,Mignozzetti; Umberto,25,0,30,5
1746588527511,CSS 202S,A01,892056,Mignozzetti; Umberto,25,0,30,5
1746588528535,DSC 197,001,956898,Eldridge; Justin Matthew,9996,0,9999,3
1746588529566,DSC 297,001,958000,Mazumdar; Arya,9998,0,9999,1
1746588529566,DSC 297,002,959862,Wang; Yusu,9998,0,9999,1
1746588530593,EAP 100,A00,905686,Staff,9778,0,9999,221
1746588531624,ECE 45,A01,892618,Staff,0,0,65,65
1746588533679,ECE 111,A01,892719,Staff,6,0,65,59
1746588534707,ECE 197,001,957920,Mercier; Patrick Philip,9991,0,9999,8
1746588535736,ECON 178,A01,907814,Zhu; Ying,26,0,35,9
1746588536764,EDS 115,A00,895312,Staff,35,0,45,10
1746588537793,EDS 117,A01,895337,Staff,23,0,30,7
1746588538822,EDS 125,A00,895341,Jones; Gabrielle Anastasia,36,0,45,9
1746588539849,EDS 128A,A01,895459,Fargason; Sharon Gayle,44,0,45,1
1746588540874,EDS 128B,A01,895543,Pappas; Elizabeth,44,0,45,1
1746588541903,EDS 139,A00,897203,Pappas; Elizabeth,44,0,45,1
1746588541903,EDS 139,B00,897209,Fargason; Sharon Gayle,41,0,45,4
1746588542936,EDS 201,A00,895545,Staff,22,0,45,23
1746588543963,EDS 203,A01,895581,Halter; Christopher P.,22,0,45,23
1746588544992,EDS 204R,A01,895625,Heinzman; Erica M.,39,0,45,6
1746588544992,EDS 204R,B01,895693,Halter; Christopher P.,10,0,45,35
1746588546017,EDS 206R,A00,895694,Fargason; Sharon Gayle,1,0,30,29
1746588546017,EDS 206R,B00,895695,Choi; Bailey Miyeon,16,0,30,14
1746588547042,EDS 250,A00,895697,Hemans; Patricia Ann Benitez,22,0,45,23
1746588548071,EDS 281,A00,895701,Meyerott; Theresa Ann,1,0,15,14
1746588549096,EDS 284,A00,895736,Meyerott; Theresa Ann,1,0,15,14
1746588550123,EDS 286,A00,897210,Fine; Sarah,0,0,15,15
1746588551152,EDS 289C,A01,895770,Daly; Alan J.,1,0,15,14
1746588552180,EDS 290,A00,897211,Hofstetter; Carolyn,0,0,15,15
1746588553209,LIGM 5A,A00,896162,Fischer-Grunski; Eva K,12,0,20,8
1746588554240,LIGM 5B,A00,896260,Fischer-Grunski; Eva K,17,0,20,3
1746588555269,LIGM 5C,A00,896308,Fischer-Grunski; Eva K,18,0,20,2
1746588556298,LIIT 5AS,A00,896313,Carnelos; Chiara,18,0,20,2
1746588557326,LIIT 5BS,A00,896416,Carnelos; Chiara,20,0,20,0
1746588558351,LIIT 5CS,A00,896564,Carnelos; Chiara,20,0,20,0
1746588559379,LISP 5A,A00,896588,Munoz Sanchez; Alicia,2,0,20,18
1746588560405,LISP 5B,A00,896653,Munoz Sanchez; Alicia,7,0,20,13
1746588561430,LISP 5C,A00,896655,Munoz Sanchez; Alicia,0,1,20,20
1746588562460,MAE 197,001,957918,Kleissl; Jan,9996,0,9999,3
1746588562460,MAE 197,002,959806,Boechler; Nicholas Sebastia,9998,0,9999,1
1746588562460,MAE 197,003,959852,Mullin; Jennifer S,9998,0,9999,1
1746588563488,MATH 2,A01,957937,Staff,33,0,35,2
1746588564516,MATH 197,001,957876,Kedlaya; Kiran S.,9993,0,9999,6
1746588565546,MCWP 40,A00,892729,Duru; Nur,10,0,20,10
1746588565546,MCWP 40,B00,893304,Montejo; Carolina,14,0,20,6
1746588566574,MCWP 40R,A00,893757,Redela; Pamela Morgan,0,5,20,20
1746588567603,MCWP 50,A00,893758,Morshed; Michael James,0,0,20,20
1746588567603,MCWP 50,B00,893761,Bartulis; Jason Michael,17,0,20,3
1746588568630,MCWP 50R,A00,893766,Compas; Sean Matthew,0,1,20,20
1746588568630,MCWP 50R,B00,893769,Carter; Jennifer A,0,1,20,20
1746588568630,MCWP 50R,C00,893771,Krone; Jarret,0,3,20,20
1746588568630,MCWP 50R,D00,893772,Miller; Elizabeth Deen,0,0,20,20
1746588568630,MCWP 50R,E00,893775,Carter; Andrea L,0,1,20,20
1746588569654,MMW 11R,A01,892721,Herbst; Matthew,14,0,30,16
1746588569654,MMW 11R,A02,892722,Herbst; Matthew,0,0,0,3
1746588570679,MMW 12R,A01,892724,Herbst; Matthew,0,11,16,16
1746588570679,MMW 12R,A02,892725,Herbst; Matthew,0,10,16,16
1746588571707,MMW 13R,A01,892727,Staff,0,4,16,16
1746588571707,MMW 13R,A02,892728,Staff,0,4,16,16
1746588571707,MMW 13R,A03,958032,Staff,0,4,16,16
1746588571707,MMW 13R,A04,958033,Staff,0,4,16,16
1746588571707,MMW 13R,A05,958034,Staff,0,4,16,16
1746588572735,SIO 295LS,A00,894015,Staff,5,0,25,20
1746588573760,SIO 295S,A00,894020,Staff,5,0,25,20
1746588574792,SIOC 290S,B01,958918,Merrifield; Mark A,14,0,30,16
1746588575818,SIOC 291S,B01,958922,Gabriel; Corey John,14,0,30,16
1746588576845,SOCI 117,A01,895339,Staff,3,0,5,2
1746588577871,WES 237B,A00,894149,Staff,11,0,20,9
1746588579938,AESE 279B,A00,891859,Staff,13,0,35,22
1746588580963,AIP 197,001,891854,Vespa; Emanuel Ignacio,9999,0,9999,0
1746588581992,ANTH 289S,A00,891856,Gagneux; Pascal,12,0,12,0
1746588583020,BENG 196,001,957946,Engler; Adam J.,9996,0,9999,3
1746588584047,BISP 197,001,959851,Wilhelm; James E.,9998,0,9999,1
1746588585072,CAT 124RS,A01,956906,Staff,6,0,25,19
1746588586098,CAT 125RS,A01,922013,Staff,6,0,25,19
1746588587123,CLRE 250,A00,891860,Morris; Sheldon,9995,0,9999,4
1746588589174,CLRE 251R,A00,907817,Mehta; Ravindra L.,9994,0,9999,5
1746588590200,CLRE 252,A00,891864,Cuomo; Raphael Eduardo,9993,0,9999,6
1746588591226,CLRE 253,A00,891867,Vaida; Florin,9994,0,9999,5
1746588591226,CLRE 253,B00,907819,Staff,9999,0,9999,0
1746588592253,CLRE 259,A00,891868,Patel; Hemal,9998,0,9999,1
1746588593279,CLRE 260,A00,891872,Cuomo; Raphael Eduardo,9999,0,9999,0
1746588594308,CLRE 297,001,891888,Cuomo; Raphael Eduardo,9999,0,9999,0
1746588595332,CSE 191,A00,958773,Minnes Kemp; Mor Mia,9995,0,9999,4
1746588596359,CSE 197,001,959846,Minnes Kemp; Mor Mia,9990,0,9999,9
1746588597391,CSS 201S,A01,892054,Mignozzetti; Umberto,25,0,30,5
1746588598417,CSS 202S,A01,892056,Mignozzetti; Umberto,25,0,30,5
1746588599444,DSC 197,001,956898,Eldridge; Justin Matthew,9996,0,9999,3
1746588600470,DSC 297,001,958000,Mazumdar; Arya,9998,0,9999,1
1746588600470,DSC 297,002,959862,Wang; Yusu,9998,0,9999,1
1746588601498,EAP 100,A00,905686,Staff,9778,0,9999,221
1746588602529,ECE 45,A01,892618,Staff,0,0,65,65
1746588604586,ECE 111,A01,892719,Staff,6,0,65,59
1746588605613,ECE 197,001,957920,Mercier; Patrick Philip,9991,0,9999,8
1746588606643,ECON 178,A01,907814,Zhu; Ying,26,0,35,9
1746588607667,EDS 115,A00,895312,Staff,35,0,45,10
1746588608696,EDS 117,A01,895337,Staff,23,0,30,7
1746588609723,EDS 125,A00,895341,Jones; Gabrielle Anastasia,36,0,45,9
1746588610752,EDS 128A,A01,895459,Fargason; Sharon Gayle,44,0,45,1
1746588611778,EDS 128B,A01,895543,Pappas; Elizabeth,44,0,45,1
1746588612803,EDS 139,A00,897203,Pappas; Elizabeth,44,0,45,1
1746588612803,EDS 139,B00,897209,Fargason; Sharon Gayle,41,0,45,4
1746588613831,EDS 201,A00,895545,Staff,22,0,45,23
1746588614858,EDS 203,A01,895581,Halter; Christopher P.,22,0,45,23
1746588615883,EDS 204R,A01,895625,Heinzman; Erica M.,39,0,45,6
1746588615883,EDS 204R,B01,895693,Halter; Christopher P.,10,0,45,35
1746588616909,EDS 206R,A00,895694,Fargason; Sharon Gayle,1,0,30,29
1746588616909,EDS 206R,B00,895695,Choi; Bailey Miyeon,16,0,30,14
1746588617939,EDS 250,A00,895697,Hemans; Patricia Ann Benitez,22,0,45,23
1746588618967,EDS 281,A00,895701,Meyerott; Theresa Ann,1,0,15,14
1746588619992,EDS 284,A00,895736,Meyerott; Theresa Ann,1,0,15,14
1746588621018,EDS 286,A00,897210,Fine; Sarah,0,0,15,15
1746588622047,EDS 289C,A01,895770,Daly; Alan J.,1,0,15,14
1746588623073,EDS 290,A00,897211,Hofstetter; Carolyn,0,0,15,15
1746588624103,LIGM 5A,A00,896162,Fischer-Grunski; Eva K,12,0,20,8
1746588625133,LIGM 5B,A00,896260,Fischer-Grunski; Eva K,17,0,20,3
1746588626159,LIGM 5C,A00,896308,Fischer-Grunski; Eva K,18,0,20,2
1746588627184,LIIT 5AS,A00,896313,Carnelos; Chiara,18,0,20,2
1746588628210,LIIT 5BS,A00,896416,Carnelos; Chiara,20,0,20,0
1746588629235,LIIT 5CS,A00,896564,Carnelos; Chiara,20,0,20,0
1746588630260,LISP 5A,A00,896588,Munoz Sanchez; Alicia,2,0,20,18
1746588631284,LISP 5B,A00,896653,Munoz Sanchez; Alicia,7,0,20,13
1746588632312,LISP 5C,A00,896655,Munoz Sanchez; Alicia,0,1,20,20
1746588633340,MAE 197,001,957918,Kleissl; Jan,9996,0,9999,3
1746588633340,MAE 197,002,959806,Boechler; Nicholas Sebastia,9998,0,9999,1
1746588633340,MAE 197,003,959852,Mullin; Jennifer S,9998,0,9999,1
1746588634365,MATH 2,A01,957937,Staff,33,0,35,2
1746588635394,MATH 197,001,957876,Kedlaya; Kiran S.,9993,0,9999,6
1746588636422,MCWP 40,A00,892729,Duru; Nur,10,0,20,10
1746588636422,MCWP 40,B00,893304,Montejo; Carolina,14,0,20,6
1746588637449,MCWP 40R,A00,893757,Redela; Pamela Morgan,0,5,20,20
1746588638478,MCWP 50,A00,893758,Morshed; Michael James,0,0,20,20
1746588638478,MCWP 50,B00,893761,Bartulis; Jason Michael,17,0,20,3
1746588639508,MCWP 50R,A00,893766,Compas; Sean Matthew,0,1,20,20
1746588639508,MCWP 50R,B00,893769,Carter; Jennifer A,0,1,20,20
1746588639508,MCWP 50R,C00,893771,Krone; Jarret,0,3,20,20
1746588639508,MCWP 50R,D00,893772,Miller; Elizabeth Deen,0,0,20,20
1746588639508,MCWP 50R,E00,893775,Carter; Andrea L,0,1,20,20
1746588640534,MMW 11R,A01,892721,Herbst; Matthew,14,0,30,16
1746588640534,MMW 11R,A02,892722,Herbst; Matthew,0,0,0,3
1746588641563,MMW 12R,A01,892724,Herbst; Matthew,0,11,16,16
1746588641563,MMW 12R,A02,892725,Herbst; Matthew,0,10,16,16
1746588642593,MMW 13R,A01,892727,Staff,0,4,16,16
1746588642593,MMW 13R,A02,892728,Staff,0,4,16,16
1746588642593,MMW 13R,A03,958032,Staff,0,4,16,16
1746588642593,MMW 13R,A04,958033,Staff,0,4,16,16
1746588642593,MMW 13R,A05,958034,Staff,0,4,16,16
1746588643617,SIO 295LS,A00,894015,Staff,5,0,25,20
1746588644643,SIO 295S,A00,894020,Staff,5,0,25,20
1746588645670,SIOC 290S,B01,958918,Merrifield; Mark A,14,0,30,16
1746588646695,SIOC 291S,B01,958922,Gabriel; Corey John,14,0,30,16
1746588647722,SOCI 117,A01,895339,Staff,3,0,5,2
1746588648748,WES 237B,A00,894149,Staff,11,0,20,9
1746588650809,AESE 279B,A00,891859,Staff,13,0,35,22
1746588651838,AIP 197,001,891854,Vespa; Emanuel Ignacio,9999,0,9999,0
1746588652866,ANTH 289S,A00,891856,Gagneux; Pascal,12,0,12,0
1746588653897,BENG 196,001,957946,Engler; Adam J.,9996,0,9999,3
1746588654924,BISP 197,001,959851,Wilhelm; James E.,9998,0,9999,1
1746588655950,CAT 124RS,A01,956906,Staff,6,0,25,19
1746588656976,CAT 125RS,A01,922013,Staff,6,0,25,19
1746588658003,CLRE 250,A00,891860,Morris; Sheldon,9995,0,9999,4
1746588660059,CLRE 251R,A00,907817,Mehta; Ravindra L.,9994,0,9999,5
1746588661084,CLRE 252,A00,891864,Cuomo; Raphael Eduardo,9993,0,9999,6
1746588662111,CLRE 253,A00,891867,Vaida; Florin,9994,0,9999,5
1746588662111,CLRE 253,B00,907819,Staff,9999,0,9999,0
1746588663136,CLRE 259,A00,891868,Patel; Hemal,9998,0,9999,1
1746588664161,CLRE 260,A00,891872,Cuomo; Raphael Eduardo,9999,0,9999,0
1746588665187,CLRE 297,001,891888,Cuomo; Raphael Eduardo,9999,0,9999,0
1746588666212,CSE 191,A00,958773,Minnes Kemp; Mor Mia,9995,0,9999,4
1746588667239,CSE 197,001,959846,Minnes Kemp; Mor Mia,9990,0,9999,9
1746588668265,CSS 201S,A01,892054,Mignozzetti; Umberto,25,0,30,5
1746588669299,CSS 202S,A01,892056,Mignozzetti; Umberto,25,0,30,5
1746588670324,DSC 197,001,956898,Eldridge; Justin Matthew,9996,0,9999,3
1746588671354,DSC 297,001,958000,Mazumdar; Arya,9998,0,9999,1
1746588671354,DSC 297,002,959862,Wang; Yusu,9998,0,9999,1
1746588672380,EAP 100,A00,905686,Staff,9778,0,9999,221
1746588673410,ECE 45,A01,892618,Staff,0,0,65,65
1746588675466,ECE 111,A01,892719,Staff,6,0,65,59
1746588676491,ECE 197,001,957920,Mercier; Patrick Philip,9991,0,9999,8
1746588677515,ECON 178,A01,907814,Zhu; Ying,26,0,35,9
1746588678541,EDS 115,A00,895312,Staff,35,0,45,10
1746588679566,EDS 117,A01,895337,Staff,23,0,30,7
1746588680595,EDS 125,A00,895341,Jones; Gabrielle Anastasia,36,0,45,9
1746588681619,EDS 128A,A01,895459,Fargason; Sharon Gayle,44,0,45,1
1746588682645,EDS 128B,A01,895543,Pappas; Elizabeth,44,0,45,1
1746588683670,EDS 139,A00,897203,Pappas; Elizabeth,44,0,45,1
1746588683670,EDS 139,B00,897209,Fargason; Sharon Gayle,41,0,45,4
1746588684696,EDS 201,A00,895545,Staff,22,0,45,23
1746588685722,EDS 203,A01,895581,Halter; Christopher P.,22,0,45,23
1746588686749,EDS 204R,A01,895625,Heinzman; Erica M.,39,0,45,6
1746588686749,EDS 204R,B01,895693,Halter; Christopher P.,10,0,45,35
1746588687778,EDS 206R,A00,895694,Fargason; Sharon Gayle,1,0,30,29
1746588687778,EDS 206R,B00,895695,Choi; Bailey Miyeon,16,0,30,14
1746588688805,EDS 250,A00,895697,Hemans; Patricia Ann Benitez,22,0,45,23
1746588689833,EDS 281,A00,895701,Meyerott; Theresa Ann,1,0,15,14
1746588690862,EDS 284,A00,895736,Meyerott; Theresa Ann,1,0,15,14
1746588691887,EDS 286,A00,897210,Fine; Sarah,0,0,15,15
1746588692914,EDS 289C,A01,895770,Daly; Alan J.,1,0,15,14
1746588693939,EDS 290,A00,897211,Hofstetter; Carolyn,0,0,15,15
1746588694966,LIGM 5A,A00,896162,Fischer-Grunski; Eva K,12,0,20,8
1746588695996,LIGM 5B,A00,896260,Fischer-Grunski; Eva K,17,0,20,3
1746588697022,LIGM 5C,A00,896308,Fischer-Grunski; Eva K,18,0,20,2
1746588698047,LIIT 5AS,A00,896313,Carnelos; Chiara,18,0,20,2
1746588699072,LIIT 5BS,A00,896416,Carnelos; Chiara,20,0,20,0
1746588700101,LIIT 5CS,A00,896564,Carnelos; Chiara,20,0,20,0
1746588701127,LISP 5A,A00,896588,Munoz Sanchez; Alicia,2,0,20,18
1746588702153,LISP 5B,A00,896653,Munoz Sanchez; Alicia,7,0,20,13
1746588703179,LISP 5C,A00,896655,Munoz Sanchez; Alicia,0,1,20,20
1746588704203,MAE 197,001,957918,Kleissl; Jan,9996,0,9999,3
1746588704203,MAE 197,002,959806,Boechler; Nicholas Sebastia,9998,0,9999,1
1746588704203,MAE 197,003,959852,Mullin; Jennifer S,9998,0,9999,1
1746588705231,MATH 2,A01,957937,Staff,33,0,35,2
1746588706256,MATH 197,001,957876,Kedlaya; Kiran S.,9993,0,9999,6
1746588707286,MCWP 40,A00,892729,Duru; Nur,10,0,20,10
1746588707286,MCWP 40,B00,893304,Montejo; Carolina,14,0,20,6
1746588708315,MCWP 40R,A00,893757,Redela; Pamela Morgan,0,5,20,20
1746588709342,MCWP 50,A00,893758,Morshed; Michael James,0,0,20,20
1746588709342,MCWP 50,B00,893761,Bartulis; Jason Michael,17,0,20,3
1746588710373,MCWP 50R,A00,893766,Compas; Sean Matthew,0,1,20,20
1746588710373,MCWP 50R,B00,893769,Carter; Jennifer A,0,1,20,20
1746588710373,MCWP 50R,C00,893771,Krone; Jarret,0,3,20,20
1746588710373,MCWP 50R,D00,893772,Miller; Elizabeth Deen,0,0,20,20
1746588710373,MCWP 50R,E00,893775,Carter; Andrea L,0,1,20,20
1746588711399,MMW 11R,A01,892721,Herbst; Matthew,14,0,30,16
1746588711399,MMW 11R,A02,892722,Herbst; Matthew,0,0,0,3
1746588712428,MMW 12R,A01,892724,Herbst; Matthew,0,11,16,16
1746588712428,MMW 12R,A02,892725,Herbst; Matthew,0,10,16,16
1746588713458,MMW 13R,A01,892727,Staff,0,4,16,16
1746588713458,MMW 13R,A02,892728,Staff,0,4,16,16
1746588713458,MMW 13R,A03,958032,Staff,0,4,16,16
1746588713458,MMW 13R,A04,958033,Staff,0,4,16,16
1746588713458,MMW 13R,A05,958034,Staff,0,4,16,16
1746588714488,SIO 295LS,A00,894015,Staff,5,0,25,20
1746588715517,SIO 295S,A00,894020,Staff,5,0,25,20
1746588716544,SIOC 290S,B01,958918,Merrifield; Mark A,14,0,30,16
1746588717570,SIOC 291S,B01,958922,Gabriel; Corey John,14,0,30,16
1746588718596,SOCI 117,A01,895339,Staff,3,0,5,2
1746588719621,WES 237B,A00,894149,Staff,11,0,20,9
1746588721681,AESE 279B,A00,891859,Staff,13,0,35,22
1746588722710,AIP 197,001,891854,Vespa; Emanuel Ignacio,9999,0,9999,0
1746588723735,ANTH 289S,A00,891856,Gagneux; Pascal,12,0,12,0
1746588724761,BENG 196,001,957946,Engler; Adam J.,9996,0,9999,3
1746588725788,BISP 197,001,959851,Wilhelm; James E.,9998,0,9999,1
1746588726813,CAT 124RS,A01,956906,Staff,6,0,25,19
1746588727841,CAT 125RS,A01,922013,Staff,6,0,25,19
1746588728868,CLRE 250,A00,891860,Morris; Sheldon,9995,0,9999,4
1746588730919,CLRE 251R,A00,907817,Mehta; Ravindra L.,9994,0,9999,5
1746588731945,CLRE 252,A00,891864,Cuomo; Raphael Eduardo,9993,0,9999,6
1746588732976,CLRE 253,A00,891867,Vaida; Florin,9994,0,9999,5
1746588732976,CLRE 253,B00,907819,Staff,9999,0,9999,0
1746588734002,CLRE 259,A00,891868,Patel; Hemal,9998,0,9999,1
1746588735030,CLRE 260,A00,891872,Cuomo; Raphael Eduardo,9999,0,9999,0
1746588736056,CLRE 297,001,891888,Cuomo; Raphael Eduardo,9999,0,9999,0
1746588737082,CSE 191,A00,958773,Minnes Kemp; Mor Mia,9995,0,9999,4
1746588738107,CSE 197,001,959846,Minnes Kemp; Mor Mia,9990,0,9999,9
1746588739133,CSS 201S,A01,892054,Mignozzetti; Umberto,25,0,30,5
1746588740160,CSS 202S,A01,892056,Mignozzetti; Umberto,25,0,30,5
1746588741186,DSC 197,001,956898,Eldridge; Justin Matthew,9996,0,9999,3
1746588742215,DSC 297,001,958000,Mazumdar; Arya,9998,0,9999,1
1746588742215,DSC 297,002,959862,Wang; Yusu,9998,0,9999,1
1746588743244,EAP 100,A00,905686,Staff,9778,0,9999,221
1746588744275,ECE 45,A01,892618,Staff,0,0,65,65
1746588746332,ECE 111,A01,892719,Staff,6,0,65,59
1746588747358,ECE 197,001,957920,Mercier; Patrick Philip,9991,0,9999,8
1746588748382,ECON 178,A01,907814,Zhu; Ying,26,0,35,9
1746588749408,EDS 115,A00,895312,Staff,35,0,45,10
1746588750434,EDS 117,A01,895337,Staff,23,0,30,7
1746588751461,EDS 125,A00,895341,Jones; Gabrielle Anastasia,36,0,45,9
1746588752486,EDS 128A,A01,895459,Fargason; Sharon Gayle,44,0,45,1
1746588753513,EDS 128B,A01,895543,Pappas; Elizabeth,44,0,45,1
1746588754538,EDS 139,A00,897203,Pappas; Elizabeth,44,0,45,1
1746588754538,EDS 139,B00,897209,Fargason; Sharon Gayle,41,0,45,4
1746588755565,EDS 201,A00,895545,Staff,22,0,45,23
1746588756590,EDS 203,A01,895581,Halter; Christopher P.,22,0,45,23
1746588757620,EDS 204R,A01,895625,Heinzman; Erica M.,39,0,45,6
1746588757620,EDS 204R,B01,895693,Halter; Christopher P.,10,0,45,35
1746588758645,EDS 206R,A00,895694,Fargason; Sharon Gayle,1,0,30,29
1746588758645,EDS 206R,B00,895695,Choi; Bailey Miyeon,16,0,30,14
1746588759670,EDS 250,A00,895697,Hemans; Patricia Ann Benitez,22,0,45,23
1746588760697,EDS 281,A00,895701,Meyerott; Theresa Ann,1,0,15,14
1746588761722,EDS 284,A00,895736,Meyerott; Theresa Ann,1,0,15,14
1746588762748,EDS 286,A00,897210,Fine; Sarah,0,0,15,15
1746588763772,EDS 289C,A01,895770,Daly; Alan J.,1,0,15,14
1746588764798,EDS 290,A00,897211,Hofstetter; Carolyn,0,0,15,15
1746588765824,LIGM 5A,A00,896162,Fischer-Grunski; Eva K,12,0,20,8
1746588766854,LIGM 5B,A00,896260,Fischer-Grunski; Eva K,17,0,20,3
1746588767880,LIGM 5C,A00,896308,Fischer-Grunski; Eva K,18,0,20,2
1746588768908,LIIT 5AS,A00,896313,Carnelos; Chiara,18,0,20,2
1746588769933,LIIT 5BS,A00,896416,Carnelos; Chiara,20,0,20,0
1746588770960,LIIT 5CS,A00,896564,Carnelos; Chiara,20,0,20,0
1746588771992,LISP 5A,A00,896588,Munoz Sanchez; Alicia,2,0,20,18
1746588773019,LISP 5B,A00,896653,Munoz Sanchez; Alicia,7,0,20,13
1746588774048,LISP 5C,A00,896655,Munoz Sanchez; Alicia,0,1,20,20
1746588775073,MAE 197,001,957918,Kleissl; Jan,9996,0,9999,3
1746588775073,MAE 197,002,959806,Boechler; Nicholas Sebastia,9998,0,9999,1
1746588775073,MAE 197,003,959852,Mullin; Jennifer S,9998,0,9999,1
1746588776100,MATH 2,A01,957937,Staff,33,0,35,2
1746588777126,MATH 197,001,957876,Kedlaya; Kiran S.,9993,0,9999,6
1746588778153,MCWP 40,A00,892729,Duru; Nur,10,0,20,10
1746588778153,MCWP 40,B00,893304,Montejo; Carolina,14,0,20,6
1746588779184,MCWP 40R,A00,893757,Redela; Pamela Morgan,0,5,20,20
1746588780212,MCWP 50,A00,893758,Morshed; Michael James,0,0,20,20
1746588780212,MCWP 50,B00,893761,Bartulis; Jason Michael,17,0,20,3
1746588781238,MCWP 50R,A00,893766,Compas; Sean Matthew,0,1,20,20
1746588781238,MCWP 50R,B00,893769,Carter; Jennifer A,0,1,20,20
1746588781238,MCWP 50R,C00,893771,Krone; Jarret,0,3,20,20
1746588781238,MCWP 50R,D00,893772,Miller; Elizabeth Deen,0,0,20,20
1746588781238,MCWP 50R,E00,893775,Carter; Andrea L,0,1,20,20
1746588782265,MMW 11R,A01,892721,Herbst; Matthew,14,0,30,16
1746588782265,MMW 11R,A02,892722,Herbst; Matthew,0,0,0,3
1746588783290,MMW 12R,A01,892724,Herbst; Matthew,0,11,16,16
1746588783290,MMW 12R,A02,892725,Herbst; Matthew,0,10,16,16
1746588784318,MMW 13R,A01,892727,Staff,0,4,16,16
1746588784318,MMW 13R,A02,892728,Staff,0,4,16,16
1746588784318,MMW 13R,A03,958032,Staff,0,4,16,16
1746588784318,MMW 13R,A04,958033,Staff,0,4,16,16
1746588784318,MMW 13R,A05,958034,Staff,0,4,16,16
1746588785344,SIO 295LS,A00,894015,Staff,5,0,25,20
1746588786369,SIO 295S,A00,894020,Staff,5,0,25,20
1746588787395,SIOC 290S,B01,958918,Merrifield; Mark A,14,0,30,16
1746588788425,SIOC 291S,B01,958922,Gabriel; Corey John,14,0,30,16
1746588789453,SOCI 117,A01,895339,Staff,3,0,5,2
1746588790479,WES 237B,A00,894149,Staff,11,0,20,9
1746588792544,AESE 279B,A00,891859,Staff,13,0,35,22
1746588793574,AIP 197,001,891854,Vespa; Emanuel Ignacio,9999,0,9999,0
1746588794600,ANTH 289S,A00,891856,Gagneux; Pascal,12,0,12,0
1746588795624,BENG 196,001,957946,Engler; Adam J.,9996,0,9999,3
1746588796650,BISP 197,001,959851,Wilhelm; James E.,9998,0,9999,1
1746588797680,CAT 124RS,A01,956906,Staff,6,0,25,19
1746588798705,CAT 125RS,A01,922013,Staff,6,0,25,19
1746588799729,CLRE 250,A00,891860,Morris; Sheldon,9995,0,9999,4
1746588801784,CLRE 251R,A00,907817,Mehta; Ravindra L.,9994,0,9999,5
1746588802813,CLRE 252,A00,891864,Cuomo; Raphael Eduardo,9993,0,9999,6
1746588803841,CLRE 253,A00,891867,Vaida; Florin,9994,0,9999,5
1746588803841,CLRE 253,B00,907819,Staff,9999,0,9999,0
1746588804865,CLRE 259,A00,891868,Patel; Hemal,9998,0,9999,1
1746588805889,CLRE 260,A00,891872,Cuomo; Raphael Eduardo,9999,0,9999,0
1746588806915,CLRE 297,001,891888,Cuomo; Raphael Eduardo,9999,0,9999,0
1746588807941,CSE 191,A00,958773,Minnes Kemp; Mor Mia,9995,0,9999,4
1746588808965,CSE 197,001,959846,Minnes Kemp; Mor Mia,9990,0,9999,9
1746588809995,CSS 201S,A01,892054,Mignozzetti; Umberto,25,0,30,5
1746588811027,CSS 202S,A01,892056,Mignozzetti; Umberto,25,0,30,5
1746588812054,DSC 197,001,956898,Eldridge; Justin Matthew,9996,0,9999,3
1746588813079,DSC 297,001,958000,Mazumdar; Arya,9998,0,9999,1
1746588813079,DSC 297,002,959862,Wang; Yusu,9998,0,9999,1
1746588814107,EAP 100,A00,905686,Staff,9778,0,9999,221
1746588815138,ECE 45,A01,892618,Staff,0,0,65,65
1746588817196,ECE 111,A01,892719,Staff,6,0,65,59
1746588818222,ECE 197,001,957920,Mercier; Patrick Philip,9991,0,9999,8
1746588819246,ECON 178,A01,907814,Zhu; Ying,26,0,35,9
1746588820272,EDS 115,A00,895312,Staff,35,0,45,10
1746588821298,EDS 117,A01,895337,Staff,23,0,30,7
1746588822328,EDS 125,A00,895341,Jones; Gabrielle Anastasia,36,0,45,9
1746588823353,EDS 128A,A01,895459,Fargason; Sharon Gayle,44,0,45,1
1746588824383,EDS 128B,A01,895543,Pappas; Elizabeth,44,0,45,1
1746588825413,EDS 139,A00,897203,Pappas; Elizabeth,44,0,45,1
1746588825413,EDS 139,B00,897209,Fargason; Sharon Gayle,41,0,45,4
1746588826439,EDS 201,A00,895545,Staff,22,0,45,23
1746588827464,EDS 203,A01,895581,Halter; Christopher P.,22,0,45,23
1746588828493,EDS 204R,A01,895625,Heinzman; Erica M.,39,0,45,6
1746588828493,EDS 204R,B01,895693,Halter; Christopher P.,10,0,45,35
1746588829522,EDS 206R,A00,895694,Fargason; Sharon Gayle,1,0,30,29
1746588829522,EDS 206R,B00,895695,Choi; Bailey Miyeon,16,0,30,14
1746588830554,EDS 250,A00,895697,Hemans; Patricia Ann Benitez,22,0,45,23
1746588831581,EDS 281,A00,895701,Meyerott; Theresa Ann,1,0,15,14
1746588832607,EDS 284,A00,895736,Meyerott; Theresa Ann,1,0,15,14
1746588833636,EDS 286,A00,897210,Fine; Sarah,0,0,15,15
1746588834664,EDS 289C,A01,895770,Daly; Alan J.,1,0,15,14
1746588835689,EDS 290,A00,897211,Hofstetter; Carolyn,0,0,15,15
1746588836718,LIGM 5A,A00,896162,Fischer-Grunski; Eva K,12,0,20,8
1746588837748,LIGM 5B,A00,896260,Fischer-Grunski; Eva K,17,0,20,3
1746588838775,LIGM 5C,A00,896308,Fischer-Grunski; Eva K,18,0,20,2
1746588839801,LIIT 5AS,A00,896313,Carnelos; Chiara,18,0,20,2
1746588840827,LIIT 5BS,A00,896416,Carnelos; Chiara,20,0,20,0
1746588841965,LIIT 5CS,A00,896564,Carnelos; Chiara,20,0,20,0
1746588842992,LISP 5A,A00,896588,Munoz Sanchez; Alicia,2,0,20,18
1746588844018,LISP 5B,A00,896653,Munoz Sanchez; Alicia,7,0,20,13
1746588845044,LISP 5C,A00,896655,Munoz Sanchez; Alicia,0,1,20,20
1746588846069,MAE 197,001,957918,Kleissl; Jan,9996,0,9999,3
1746588846069,MAE 197,002,959806,Boechler; Nicholas Sebastia,9998,0,9999,1
1746588846069,MAE 197,003,959852,Mullin; Jennifer S,9998,0,9999,1
1746588847095,MATH 2,A01,957937,Staff,33,0,35,2
1746588848122,MATH 197,001,957876,Kedlaya; Kiran S.,9993,0,9999,6
1746588849149,MCWP 40,A00,892729,Duru; Nur,10,0,20,10
1746588849149,MCWP 40,B00,893304,Montejo; Carolina,14,0,20,6
1746588850174,MCWP 40R,A00,893757,Redela; Pamela Morgan,0,5,20,20
1746588851198,MCWP 50,A00,893758,Morshed; Michael James,0,0,20,20
1746588851198,MCWP 50,B00,893761,Bartulis; Jason Michael,17,0,20,3
1746588852226,MCWP 50R,A00,893766,Compas; Sean Matthew,0,1,20,20
1746588852226,MCWP 50R,B00,893769,Carter; Jennifer A,0,1,20,20
1746588852226,MCWP 50R,C00,893771,Krone; Jarret,0,3,20,20
1746588852226,MCWP 50R,D00,893772,Miller; Elizabeth Deen,0,0,20,20
1746588852226,MCWP 50R,E00,893775,Carter; Andrea L,0,1,20,20
1746588853251,MMW 11R,A01,892721,Herbst; Matthew,14,0,30,16
1746588853251,MMW 11R,A02,892722,Herbst; Matthew,0,0,0,3
1746588854279,MMW 12R,A01,892724,Herbst; Matthew,0,11,16,16
1746588854279,MMW 12R,A02,892725,Herbst; Matthew,0,10,16,16
1746588855306,MMW 13R,A01,892727,Staff,0,4,16,16
1746588855306,MMW 13R,A02,892728,Staff,0,4,16,16
1746588855306,MMW 13R,A03,958032,Staff,0,4,16,16
1746588855306,MMW 13R,A04,958033,Staff,0,4,16,16
1746588855306,MMW 13R,A05,958034,Staff,0,4,16,16
1746588856332,SIO 295LS,A00,894015,Staff,5,0,25,20
1746588857362,SIO 295S,A00,894020,Staff,5,0,25,20
1746588858389,SIOC 290S,B01,958918,Merrifield; Mark A,14,0,30,16
1746588859419,SIOC 291S,B01,958922,Gabriel; Corey John,14,0,30,16
1746588860448,SOCI 117,A01,895339,Staff,3,0,5,2
1746588861473,WES 237B,A00,894149,Staff,11,0,20,9
1746588863538,AESE 279B,A00,891859,Staff,13,0,35,22
1746588864564,AIP 197,001,891854,Vespa; Emanuel Ignacio,9999,0,9999,0
1746588865592,ANTH 289S,A00,891856,Gagneux; Pascal,12,0,12,0
1746588866619,BENG 196,001,957946,Engler; Adam J.,9996,0,9999,3
1746588867646,BISP 197,001,959851,Wilhelm; James E.,9998,0,9999,1
1746588868674,CAT 124RS,A01,956906,Staff,6,0,25,19
1746588869699,CAT 125RS,A01,922013,Staff,6,0,25,19
1746588870724,CLRE 250,A00,891860,Morris; Sheldon,9995,0,9999,4
1746588872788,CLRE 251R,A00,907817,Mehta; Ravindra L.,9994,0,9999,5
1746588873813,CLRE 252,A00,891864,Cuomo; Raphael Eduardo,9993,0,9999,6
1746588874840,CLRE 253,A00,891867,Vaida; Florin,9994,0,9999,5
1746588874840,CLRE 253,B00,907819,Staff,9999,0,9999,0
1746588875865,CLRE 259,A00,891868,Patel; Hemal,9998,0,9999,1
1746588876890,CLRE 260,A00,891872,Cuomo; Raphael Eduardo,9999,0,9999,0
1746588877919,CLRE 297,001,891888,Cuomo; Raphael Eduardo,9999,0,9999,0
1746588878945,CSE 191,A00,958773,Minnes Kemp; Mor Mia,9995,0,9999,4
1746588879970,CSE 197,001,959846,Minnes Kemp; Mor Mia,9990,0,9999,9
1746588880996,CSS 201S,A01,892054,Mignozzetti; Umberto,25,0,30,5
1746588882026,CSS 202S,A01,892056,Mignozzetti; Umberto,25,0,30,5
1746588883051,DSC 197,001,956898,Eldridge; Justin Matthew,9996,0,9999,3
1746588884077,DSC 297,001,958000,Mazumdar; Arya,9998,0,9999,1
1746588884077,DSC 297,002,959862,Wang; Yusu,9998,0,9999,1
1746588885102,EAP 100,A00,905686,Staff,9778,0,9999,221
1746588886127,ECE 45,A01,892618,Staff,0,0,65,65
1746588888180,ECE 111,A01,892719,Staff,6,0,65,59
1746588889205,ECE 197,001,957920,Mercier; Patrick Philip,9991,0,9999,8
1746588890236,ECON 178,A01,907814,Zhu; Ying,26,0,35,9
1746588891261,EDS 115,A00,895312,Staff,35,0,45,10
1746588892287,EDS 117,A01,895337,Staff,23,0,30,7
1746588893313,EDS 125,A00,895341,Jones; Gabrielle Anastasia,36,0,45,9
1746588894338,EDS 128A,A01,895459,Fargason; Sharon Gayle,44,0,45,1
1746588895366,EDS 128B,A01,895543,Pappas; Elizabeth,44,0,45,1
1746588896390,EDS 139,A00,897203,Pappas; Elizabeth,44,0,45,1
1746588896390,EDS 139,B00,897209,Fargason; Sharon Gayle,41,0,45,4
1746588897419,EDS 201,A00,895545,Staff,22,0,45,23
1746588898444,EDS 203,A01,895581,Halter; Christopher P.,22,0,45,23
1746588899470,EDS 204R,A01,895625,Heinzman; Erica M.,39,0,45,6
1746588899470,EDS 204R,B01,895693,Halter; Christopher P.,10,0,45,35
1746588900504,EDS 206R,A00,895694,Fargason; Sharon Gayle,1,0,30,29
1746588900504,EDS 206R,B00,895695,Choi; Bailey Miyeon,16,0,30,14
1746588901531,EDS 250,A00,895697,Hemans; Patricia Ann Benitez,22,0,45,23
1746588902557,EDS 281,A00,895701,Meyerott; Theresa Ann,1,0,15,14
1746588903584,EDS 284,A00,895736,Meyerott; Theresa Ann,1,0,15,14
1746588904610,EDS 286,A00,897210,Fine; Sarah,0,0,15,15
1746588905641,EDS 289C,A01,895770,Daly; Alan J.,1,0,15,14
1746588906666,EDS 290,A00,897211,Hofstetter; Carolyn,0,0,15,15
1746588907691,LIGM 5A,A00,896162,Fischer-Grunski; Eva K,12,0,20,8
1746588908718,LIGM 5B,A00,896260,Fischer-Grunski; Eva K,17,0,20,3
1746588909744,LIGM 5C,A00,896308,Fischer-Grunski; Eva K,18,0,20,2
1746588910769,LIIT 5AS,A00,896313,Carnelos; Chiara,18,0,20,2
1746588911798,LIIT 5BS,A00,896416,Carnelos; Chiara,20,0,20,0
1746588912824,LIIT 5CS,A00,896564,Carnelos; Chiara,20,0,20,0
1746588913850,LISP 5A,A00,896588,Munoz Sanchez; Alicia,2,0,20,18
1746588914878,LISP 5B,A00,896653,Munoz Sanchez; Alicia,7,0,20,13
1746588915908,LISP 5C,A00,896655,Munoz Sanchez; Alicia,0,1,20,20
1746588916938,MAE 197,001,957918,Kleissl; Jan,9996,0,9999,3
1746588916938,MAE 197,002,959806,Boechler; Nicholas Sebastia,9998,0,9999,1
1746588916938,MAE 197,003,959852,Mullin; Jennifer S,9998,0,9999,1
1746588917964,MATH 2,A01,957937,Staff,33,0,35,2
1746588918991,MATH 197,001,957876,Kedlaya; Kiran S.,9993,0,9999,6
1746588920017,MCWP 40,A00,892729,Duru; Nur,10,0,20,10
1746588920017,MCWP 40,B00,893304,Montejo; Carolina,14,0,20,6
1746588921043,MCWP 40R,A00,893757,Redela; Pamela Morgan,0,5,20,20
1746588922074,MCWP 50,A00,893758,Morshed; Michael James,0,0,20,20
1746588922074,MCWP 50,B00,893761,Bartulis; Jason Michael,17,0,20,3
1746588923104,MCWP 50R,A00,893766,Compas; Sean Matthew,0,1,20,20
1746588923104,MCWP 50R,B00,893769,Carter; Jennifer A,0,1,20,20
1746588923104,MCWP 50R,C00,893771,Krone; Jarret,0,3,20,20
1746588923104,MCWP 50R,D00,893772,Miller; Elizabeth Deen,0,0,20,20
1746588923104,MCWP 50R,E00,893775,Carter; Andrea L,0,1,20,20
1746588924131,MMW 11R,A01,892721,Herbst; Matthew,14,0,30,16
1746588924131,MMW 11R,A02,892722,Herbst; Matthew,0,0,0,3
1746588925160,MMW 12R,A01,892724,Herbst; Matthew,0,11,16,16
1746588925160,MMW 12R,A02,892725,Herbst; Matthew,0,10,16,16
1746588926185,MMW 13R,A01,892727,Staff,0,4,16,16
1746588926185,MMW 13R,A02,892728,Staff,0,4,16,16
1746588926185,MMW 13R,A03,958032,Staff,0,4,16,16
1746588926185,MMW 13R,A04,958033,Staff,0,4,16,16
1746588926185,MMW 13R,A05,958034,Staff,0,4,16,16
1746588927213,SIO 295LS,A00,894015,Staff,5,0,25,20
1746588928239,SIO 295S,A00,894020,Staff,5,0,25,20
1746588929265,SIOC 290S,B01,958918,Merrifield; Mark A,14,0,30,16
1746588930290,SIOC 291S,B01,958922,Gabriel; Corey John,14,0,30,16
1746588931315,SOCI 117,A01,895339,Staff,3,0,5,2
1746588932342,WES 237B,A00,894149,Staff,11,0,20,9
1746588934399,AESE 279B,A00,891859,Staff,13,0,35,22
1746588935429,AIP 197,001,891854,Vespa; Emanuel Ignacio,9999,0,9999,0
1746588936456,ANTH 289S,A00,891856,Gagneux; Pascal,12,0,12,0
1746588937481,BENG 196,001,957946,Engler; Adam J.,9996,0,9999,3
1746588938509,BISP 197,001,959851,Wilhelm; James E.,9998,0,9999,1
1746588939537,CAT 124RS,A01,956906,Staff,6,0,25,19
1746588940564,CAT 125RS,A01,922013,Staff,6,0,25,19
1746588941590,CLRE 250,A00,891860,Morris; Sheldon,9995,0,9999,4
1746588943641,CLRE 251R,A00,907817,Mehta; Ravindra L.,9994,0,9999,5
1746588944665,CLRE 252,A00,891864,Cuomo; Raphael Eduardo,9993,0,9999,6
1746588945693,CLRE 253,A00,891867,Vaida; Florin,9994,0,9999,5
1746588945693,CLRE 253,B00,907819,Staff,9999,0,9999,0
1746588946720,CLRE 259,A00,891868,Patel; Hemal,9998,0,9999,1
1746588947745,CLRE 260,A00,891872,Cuomo; Raphael Eduardo,9999,0,9999,0
1746588948772,CLRE 297,001,891888,Cuomo; Raphael Eduardo,9999,0,9999,0
1746588949796,CSE 191,A00,958773,Minnes Kemp; Mor Mia,9995,0,9999,4
1746588950821,CSE 197,001,959846,Minnes Kemp; Mor Mia,9990,0,9999,9
1746588951845,CSS 201S,A01,892054,Mignozzetti; Umberto,25,0,30,5
1746588952878,CSS 202S,A01,892056,Mignozzetti; Umberto,25,0,30,5
1746588953943,DSC 197,001,956898,Eldridge; Justin Matthew,9996,0,9999,3
1746588954968,DSC 297,001,958000,Mazumdar; Arya,9998,0,9999,1
1746588954968,DSC 297,002,959862,Wang; Yusu,9998,0,9999,1
1746588955994,EAP 100,A00,905686,Staff,9778,0,9999,221
1746588957024,ECE 45,A01,892618,Staff,0,0,65,65
1746588959074,ECE 111,A01,892719,Staff,6,0,65,59
1746588960103,ECE 197,001,957920,Mercier; Patrick Philip,9991,0,9999,8
1746588961129,ECON 178,A01,907814,Zhu; Ying,26,0,35,9
1746588962156,EDS 115,A00,895312,Staff,35,0,45,10
1746588963181,EDS 117,A01,895337,Staff,23,0,30,7
1746588964227,EDS 125,A00,895341,Jones; Gabrielle Anastasia,36,0,45,9
1746588965257,EDS 128A,A01,895459,Fargason; Sharon Gayle,44,0,45,1
1746588966281,EDS 128B,A01,895543,Pappas; Elizabeth,44,0,45,1
1746588967309,EDS 139,A00,897203,Pappas; Elizabeth,44,0,45,1
1746588967309,EDS 139,B00,897209,Fargason; Sharon Gayle,41,0,45,4
1746588968337,EDS 201,A00,895545,Staff,22,0,45,23
1746588969363,EDS 203,A01,895581,Halter; Christopher P.,22,0,45,23
1746588970389,EDS 204R,A01,895625,Heinzman; Erica M.,39,0,45,6
1746588970389,EDS 204R,B01,895693,Halter; Christopher P.,10,0,45,35
1746588971418,EDS 206R,A00,895694,Fargason; Sharon Gayle,1,0,30,29
1746588971418,EDS 206R,B00,895695,Choi; Bailey Miyeon,16,0,30,14
1746588972444,EDS 250,A00,895697,Hemans; Patricia Ann Benitez,22,0,45,23
1746588973470,EDS 281,A00,895701,Meyerott; Theresa Ann,1,0,15,14
1746588974499,EDS 284,A00,895736,Meyerott; Theresa Ann,1,0,15,14
1746588975525,EDS 286,A00,897210,Fine; Sarah,0,0,15,15
1746588976550,EDS 289C,A01,895770,Daly; Alan J.,1,0,15,14
1746588977579,EDS 290,A00,897211,Hofstetter; Carolyn,0,0,15,15
1746588978608,LIGM 5A,A00,896162,Fischer-Grunski; Eva K,12,0,20,8
1746588979633,LIGM 5B,A00,896260,Fischer-Grunski; Eva K,17,0,20,3
1746588980660,LIGM 5C,A00,896308,Fischer-Grunski; Eva K,18,0,20,2
1746588981688,LIIT 5AS,A00,896313,Carnelos; Chiara,18,0,20,2
1746588982715,LIIT 5BS,A00,896416,Carnelos; Chiara,20,0,20,0
1746588983744,LIIT 5CS,A00,896564,Carnelos; Chiara,20,0,20,0
1746588984769,LISP 5A,A00,896588,Munoz Sanchez; Alicia,2,0,20,18
1746588985798,LISP 5B,A00,896653,Munoz Sanchez; Alicia,7,0,20,13
1746588986824,LISP 5C,A00,896655,Munoz Sanchez; Alicia,0,1,20,20
1746588987853,MAE 197,001,957918,Kleissl; Jan,9996,0,9999,3
1746588987853,MAE 197,002,959806,Boechler; Nicholas Sebastia,9998,0,9999,1
1746588987853,MAE 197,003,959852,Mullin; Jennifer S,9998,0,9999,1
1746588988880,MATH 2,A01,957937,Staff,33,0,35,2
1746588989904,MATH 197,001,957876,Kedlaya; Kiran S.,9993,0,9999,6
1746588990930,MCWP 40,A00,892729,Duru; Nur,10,0,20,10
1746588990930,MCWP 40,B00,893304,Montejo; Carolina,14,0,20,6
1746588991955,MCWP 40R,A00,893757,Redela; Pamela Morgan,0,5,20,20
1746588992980,MCWP 50,A00,893758,Morshed; Michael James,0,0,20,20
1746588992980,MCWP 50,B00,893761,Bartulis; Jason Michael,17,0,20,3
1746588994011,MCWP 50R,A00,893766,Compas; Sean Matthew,0,1,20,20
1746588994011,MCWP 50R,B00,893769,Carter; Jennifer A,0,1,20,20
1746588994011,MCWP 50R,C00,893771,Krone; Jarret,0,3,20,20
1746588994011,MCWP 50R,D00,893772,Miller; Elizabeth Deen,0,0,20,20
1746588994011,MCWP 50R,E00,893775,Carter; Andrea L,0,1,20,20
1746588995040,MMW 11R,A01,892721,Herbst; Matthew,14,0,30,16
1746588995040,MMW 11R,A02,892722,Herbst; Matthew,0,0,0,3
1746588996071,MMW 12R,A01,892724,Herbst; Matthew,0,11,16,16
1746588996071,MMW 12R,A02,892725,Herbst; Matthew,0,10,16,16
1746588997099,MMW 13R,A01,892727,Staff,0,4,16,16
1746588997099,MMW 13R,A02,892728,Staff,0,4,16,16
1746588997099,MMW 13R,A03,958032,Staff,0,4,16,16
1746588997099,MMW 13R,A04,958033,Staff,0,4,16,16
1746588997099,MMW 13R,A05,958034,Staff,0,4,16,16
1746588998128,SIO 295LS,A00,894015,Staff,5,0,25,20
1746588999154,SIO 295S,A00,894020,Staff,5,0,25,20
1746589000185,SIOC 290S,B01,958918,Merrifield; Mark A,14,0,30,16
1746589001214,SIOC 291S,B01,958922,Gabriel; Corey John,14,0,30,16
1746589002240,SOCI 117,A01,895339,Staff,3,0,5,2
1746589003264,WES 237B,A00,894149,Staff,11,0,20,9
1746589005327,AESE 279B,A00,891859,Staff,13,0,35,22
1746589006355,AIP 197,001,891854,Vespa; Emanuel Ignacio,9999,0,9999,0
1746589007381,ANTH 289S,A00,891856,Gagneux; Pascal,12,0,12,0
1746589008405,BENG 196,001,957946,Engler; Adam J.,9996,0,9999,3
1746589009433,BISP 197,001,959851,Wilhelm; James E.,9998,0,9999,1
1746589010460,CAT 124RS,A01,956906,Staff,6,0,25,19
1746589011486,CAT 125RS,A01,922013,Staff,6,0,25,19
1746589012515,CLRE 250,A00,891860,Morris; Sheldon,9995,0,9999,4
1746589014572,CLRE 251R,A00,907817,Mehta; Ravindra L.,9994,0,9999,5
1746589015602,CLRE 252,A00,891864,Cuomo; Raphael Eduardo,9993,0,9999,6
1746589016628,CLRE 253,A00,891867,Vaida; Florin,9994,0,9999,5
1746589016628,CLRE 253,B00,907819,Staff,9999,0,9999,0
1746589017654,CLRE 259,A00,891868,Patel; Hemal,9998,0,9999,1
1746589018683,CLRE 260,A00,891872,Cuomo; Raphael Eduardo,9999,0,9999,0
1746589019709,CLRE 297,001,891888,Cuomo; Raphael Eduardo,9999,0,9999,0
1746589020738,CSE 191,A00,958773,Minnes Kemp; Mor Mia,9995,0,9999,4
1746589021763,CSE 197,001,959846,Minnes Kemp; Mor Mia,9990,0,9999,9
1746589022790,CSS 201S,A01,892054,Mignozzetti; Umberto,25,0,30,5
1746589023815,CSS 202S,A01,892056,Mignozzetti; Umberto,25,0,30,5
1746589024840,DSC 197,001,956898,Eldridge; Justin Matthew,9996,0,9999,3
1746589025865,DSC 297,001,958000,Mazumdar; Arya,9998,0,9999,1
1746589025865,DSC 297,002,959862,Wang; Yusu,9998,0,9999,1
1746589026892,EAP 100,A00,905686,Staff,9778,0,9999,221
1746589027920,ECE 45,A01,892618,Staff,0,0,65,65
1746589029976,ECE 111,A01,892719,Staff,6,0,65,59
1746589031001,ECE 197,001,957920,Mercier; Patrick Philip,9991,0,9999,8
1746589032027,ECON 178,A01,907814,Zhu; Ying,26,0,35,9
1746589033052,EDS 115,A00,895312,Staff,35,0,45,10
1746589034081,EDS 117,A01,895337,Staff,23,0,30,7
1746589035109,EDS 125,A00,895341,Jones; Gabrielle Anastasia,36,0,45,9
1746589036136,EDS 128A,A01,895459,Fargason; Sharon Gayle,44,0,45,1
1746589037162,EDS 128B,A01,895543,Pappas; Elizabeth,44,0,45,1
1746589038189,EDS 139,A00,897203,Pappas; Elizabeth,44,0,45,1
1746589038189,EDS 139,B00,897209,Fargason; Sharon Gayle,41,0,45,4
1746589039215,EDS 201,A00,895545,Staff,22,0,45,23
1746589040240,EDS 203,A01,895581,Halter; Christopher P.,22,0,45,23
1746589041268,EDS 204R,A01,895625,Heinzman; Erica M.,39,0,45,6
1746589041268,EDS 204R,B01,895693,Halter; Christopher P.,10,0,45,35
1746589042295,EDS 206R,A00,895694,Fargason; Sharon Gayle,1,0,30,29
1746589042295,EDS 206R,B00,895695,Choi; Bailey Miyeon,16,0,30,14
1746589043322,EDS 250,A00,895697,Hemans; Patricia Ann Benitez,22,0,45,23
1746589044349,EDS 281,A00,895701,Meyerott; Theresa Ann,1,0,15,14
1746589045373,EDS 284,A00,895736,Meyerott; Theresa Ann,1,0,15,14
1746589046397,EDS 286,A00,897210,Fine; Sarah,0,0,15,15
1746589047424,EDS 289C,A01,895770,Daly; Alan J.,1,0,15,14
1746589048451,EDS 290,A00,897211,Hofstetter; Carolyn,0,0,15,15
1746589049480,LIGM 5A,A00,896162,Fischer-Grunski; Eva K,12,0,20,8
1746589050508,LIGM 5B,A00,896260,Fischer-Grunski; Eva K,17,0,20,3
1746589051536,LIGM 5C,A00,896308,Fischer-Grunski; Eva K,18,0,20,2
1746589052562,LIIT 5AS,A00,896313,Carnelos; Chiara,18,0,20,2
1746589053590,LIIT 5BS,A00,896416,Carnelos; Chiara,20,0,20,0
1746589054620,LIIT 5CS,A00,896564,Carnelos; Chiara,20,0,20,0
1746589055646,LISP 5A,A00,896588,Munoz Sanchez; Alicia,2,0,20,18
1746589056675,LISP 5B,A00,896653,Munoz Sanchez; Alicia,7,0,20,13
1746589057702,LISP 5C,A00,896655,Munoz Sanchez; Alicia,0,1,20,20
1746589058727,MAE 197,001,957918,Kleissl; Jan,9996,0,9999,3
1746589058727,MAE 197,002,959806,Boechler; Nicholas Sebastia,9998,0,9999,1
1746589058727,MAE 197,003,959852,Mullin; Jennifer S,9998,0,9999,1
1746589059753,MATH 2,A01,957937,Staff,33,0,35,2
1746589060778,MATH 197,001,957876,Kedlaya; Kiran S.,9993,0,9999,6
1746589061804,MCWP 40,A00,892729,Duru; Nur,10,0,20,10
1746589061804,MCWP 40,B00,893304,Montejo; Carolina,14,0,20,6
1746589062829,MCWP 40R,A00,893757,Redela; Pamela Morgan,0,5,20,20
1746589063855,MCWP 50,A00,893758,Morshed; Michael James,0,0,20,20
1746589063855,MCWP 50,B00,893761,Bartulis; Jason Michael,17,0,20,3
1746589064880,MCWP 50R,A00,893766,Compas; Sean Matthew,0,1,20,20
1746589064880,MCWP 50R,B00,893769,Carter; Jennifer A,0,1,20,20
1746589064880,MCWP 50R,C00,893771,Krone; Jarret,0,3,20,20
1746589064880,MCWP 50R,D00,893772,Miller; Elizabeth Deen,0,0,20,20
1746589064880,MCWP 50R,E00,893775,Carter; Andrea L,0,1,20,20
1746589065905,MMW 11R,A01,892721,Herbst; Matthew,14,0,30,16
1746589065905,MMW 11R,A02,892722,Herbst; Matthew,0,0,0,3
1746589066932,MMW 12R,A01,892724,Herbst; Matthew,0,11,16,16
1746589066932,MMW 12R,A02,892725,Herbst; Matthew,0,10,16,16
1746589067963,MMW 13R,A01,892727,Staff,0,4,16,16
1746589067963,MMW 13R,A02,892728,Staff,0,4,16,16
1746589067963,MMW 13R,A03,958032,Staff,0,4,16,16
1746589067963,MMW 13R,A04,958033,Staff,0,4,16,16
1746589067963,MMW 13R,A05,958034,Staff,0,4,16,16
1746589068991,SIO 295LS,A00,894015,Staff,5,0,25,20
1746589070021,SIO 295S,A00,894020,Staff,5,0,25,20
1746589071050,SIOC 290S,B01,958918,Merrifield; Mark A,14,0,30,16
1746589072077,SIOC 291S,B01,958922,Gabriel; Corey John,14,0,30,16
1746589073102,SOCI 117,A01,895339,Staff,3,0,5,2
1746589074128,WES 237B,A00,894149,Staff,11,0,20,9
1746589076202,AESE 279B,A00,891859,Staff,13,0,35,22
1746589077228,AIP 197,001,891854,Vespa; Emanuel Ignacio,9999,0,9999,0
1746589078254,ANTH 289S,A00,891856,Gagneux; Pascal,12,0,12,0
1746589079279,BENG 196,001,957946,Engler; Adam J.,9996,0,9999,3
1746589080307,BISP 197,001,959851,Wilhelm; James E.,9998,0,9999,1
1746589081332,CAT 124RS,A01,956906,Staff,6,0,25,19
1746589082358,CAT 125RS,A01,922013,Staff,6,0,25,19
1746589083384,CLRE 250,A00,891860,Morris; Sheldon,9995,0,9999,4
1746589085439,CLRE 251R,A00,907817,Mehta; Ravindra L.,9994,0,9999,5
1746589086464,CLRE 252,A00,891864,Cuomo; Raphael Eduardo,9993,0,9999,6
1746589087489,CLRE 253,A00,891867,Vaida; Florin,9994,0,9999,5
1746589087489,CLRE 253,B00,907819,Staff,9999,0,9999,0
1746589088518,CLRE 259,A00,891868,Patel; Hemal,9998,0,9999,1
1746589089543,CLRE 260,A00,891872,Cuomo; Raphael Eduardo,9999,0,9999,0
1746589090571,CLRE 297,001,891888,Cuomo; Raphael Eduardo,9999,0,9999,0
1746589091597,CSE 191,A00,958773,Minnes Kemp; Mor Mia,9995,0,9999,4
1746589092622,CSE 197,001,959846,Minnes Kemp; Mor Mia,9990,0,9999,9
1746589093649,CSS 201S,A01,892054,Mignozzetti; Umberto,25,0,30,5
1746589094675,CSS 202S,A01,892056,Mignozzetti; Umberto,25,0,30,5
1746589095701,DSC 197,001,956898,Eldridge; Justin Matthew,9996,0,9999,3
1746589096728,DSC 297,001,958000,Mazumdar; Arya,9998,0,9999,1
1746589096728,DSC 297,002,959862,Wang; Yusu,9998,0,9999,1
1746589097753,EAP 100,A00,905686,Staff,9778,0,9999,221
1746589098782,ECE 45,A01,892618,Staff,0,0,65,65
1746589100840,ECE 111,A01,892719,Staff,6,0,65,59
1746589101864,ECE 197,001,957920,Mercier; Patrick Philip,9991,0,9999,8
1746589102890,ECON 178,A01,907814,Zhu; Ying,26,0,35,9
1746589103915,EDS 115,A00,895312,Staff,35,0,45,10
1746589104943,EDS 117,A01,895337,Staff,23,0,30,7
1746589105972,EDS 125,A00,895341,Jones; Gabrielle Anastasia,36,0,45,9
1746589106998,EDS 128A,A01,895459,Fargason; Sharon Gayle,44,0,45,1
1746589108022,EDS 128B,A01,895543,Pappas; Elizabeth,44,0,45,1
1746589109047,EDS 139,A00,897203,Pappas; Elizabeth,44,0,45,1
1746589109047,EDS 139,B00,897209,Fargason; Sharon Gayle,41,0,45,4
1746589110072,EDS 201,A00,895545,Staff,22,0,45,23
1746589111099,EDS 203,A01,895581,Halter; Christopher P.,22,0,45,23
1746589112125,EDS 204R,A01,895625,Heinzman; Erica M.,39,0,45,6
1746589112125,EDS 204R,B01,895693,Halter; Christopher P.,10,0,45,35
1746589113154,EDS 206R,A00,895694,Fargason; Sharon Gayle,1,0,30,29
1746589113154,EDS 206R,B00,895695,Choi; Bailey Miyeon,16,0,30,14
1746589114179,EDS 250,A00,895697,Hemans; Patricia Ann Benitez,22,0,45,23
1746589115208,EDS 281,A00,895701,Meyerott; Theresa Ann,1,0,15,14
1746589116234,EDS 284,A00,895736,Meyerott; Theresa Ann,1,0,15,14
1746589117260,EDS 286,A00,897210,Fine; Sarah,0,0,15,15
1746589118286,EDS 289C,A01,895770,Daly; Alan J.,1,0,15,14
1746589119314,EDS 290,A00,897211,Hofstetter; Carolyn,0,0,15,15
1746589120339,LIGM 5A,A00,896162,Fischer-Grunski; Eva K,12,0,20,8
1746589121363,LIGM 5B,A00,896260,Fischer-Grunski; Eva K,17,0,20,3
1746589122401,LIGM 5C,A00,896308,Fischer-Grunski; Eva K,18,0,20,2
1746589123426,LIIT 5AS,A00,896313,Carnelos; Chiara,18,0,20,2
1746589124455,LIIT 5BS,A00,896416,Carnelos; Chiara,20,0,20,0
1746589125485,LIIT 5CS,A00,896564,Carnelos; Chiara,20,0,20,0
1746589126511,LISP 5A,A00,896588,Munoz Sanchez; Alicia,2,0,20,18
1746589127536,LISP 5B,A00,896653,Munoz Sanchez; Alicia,7,0,20,13
1746589128562,LISP 5C,A00,896655,Munoz Sanchez; Alicia,0,1,20,20
1746589129590,MAE 197,001,957918,Kleissl; Jan,9996,0,9999,3
1746589129590,MAE 197,002,959806,Boechler; Nicholas Sebastia,9998,0,9999,1
1746589129590,MAE 197,003,959852,Mullin; Jennifer S,9998,0,9999,1
1746589130615,MATH 2,A01,957937,Staff,33,0,35,2
1746589131643,MATH 197,001,957876,Kedlaya; Kiran S.,9993,0,9999,6
1746589132669,MCWP 40,A00,892729,Duru; Nur,10,0,20,10
1746589132669,MCWP 40,B00,893304,Montejo; Carolina,14,0,20,6
1746589133697,MCWP 40R,A00,893757,Redela; Pamela Morgan,0,5,20,20
1746589134723,MCWP 50,A00,893758,Morshed; Michael James,0,0,20,20
1746589134723,MCWP 50,B00,893761,Bartulis; Jason Michael,17,0,20,3
1746589135747,MCWP 50R,A00,893766,Compas; Sean Matthew,0,1,20,20
1746589135747,MCWP 50R,B00,893769,Carter; Jennifer A,0,1,20,20
1746589135747,MCWP 50R,C00,893771,Krone; Jarret,0,3,20,20
1746589135747,MCWP 50R,D00,893772,Miller; Elizabeth Deen,0,0,20,20
1746589135747,MCWP 50R,E00,893775,Carter; Andrea L,0,1,20,20
1746589136775,MMW 11R,A01,892721,Herbst; Matthew,14,0,30,16
1746589136775,MMW 11R,A02,892722,Herbst; Matthew,0,0,0,3
1746589137801,MMW 12R,A01,892724,Herbst; Matthew,0,11,16,16
1746589137801,MMW 12R,A02,892725,Herbst; Matthew,0,10,16,16
1746589138826,MMW 13R,A01,892727,Staff,0,4,16,16
1746589138826,MMW 13R,A02,892728,Staff,0,4,16,16
1746589138826,MMW 13R,A03,958032,Staff,0,4,16,16
1746589138826,MMW 13R,A04,958033,Staff,0,4,16,16
1746589138826,MMW 13R,A05,958034,Staff,0,4,16,16
1746589139854,SIO 295LS,A00,894015,Staff,5,0,25,20
1746589140881,SIO 295S,A00,894020,Staff,5,0,25,20
1746589141907,SIOC 290S,B01,958918,Merrifield; Mark A,14,0,30,16
1746589142934,SIOC 291S,B01,958922,Gabriel; Corey John,14,0,30,16
1746589143961,SOCI 117,A01,895339,Staff,3,0,5,2
1746589144988,WES 237B,A00,894149,Staff,11,0,20,9
1746589147057,AESE 279B,A00,891859,Staff,13,0,35,22
1746589148085,AIP 197,001,891854,Vespa; Emanuel Ignacio,9999,0,9999,0
1746589149110,ANTH 289S,A00,891856,Gagneux; Pascal,12,0,12,0
1746589150137,BENG 196,001,957946,Engler; Adam J.,9996,0,9999,3
1746589151162,BISP 197,001,959851,Wilhelm; James E.,9998,0,9999,1
1746589152187,CAT 124RS,A01,956906,Staff,6,0,25,19
1746589153212,CAT 125RS,A01,922013,Staff,6,0,25,19
1746589154238,CLRE 250,A00,891860,Morris; Sheldon,9995,0,9999,4
1746589156297,CLRE 251R,A00,907817,Mehta; Ravindra L.,9994,0,9999,5
1746589157329,CLRE 252,A00,891864,Cuomo; Raphael Eduardo,9993,0,9999,6
1746589158355,CLRE 253,A00,891867,Vaida; Florin,9994,0,9999,5
1746589158355,CLRE 253,B00,907819,Staff,9999,0,9999,0
1746589159384,CLRE 259,A00,891868,Patel; Hemal,9998,0,9999,1
1746589160413,CLRE 260,A00,891872,Cuomo; Raphael Eduardo,9999,0,9999,0
1746589161442,CLRE 297,001,891888,Cuomo; Raphael Eduardo,9999,0,9999,0
1746589162466,CSE 191,A00,958773,Minnes Kemp; Mor Mia,9995,0,9999,4
1746589163491,CSE 197,001,959846,Minnes Kemp; Mor Mia,9990,0,9999,9
1746589164518,CSS 201S,A01,892054,Mignozzetti; Umberto,25,0,30,5
1746589165544,CSS 202S,A01,892056,Mignozzetti; Umberto,25,0,30,5
1746589166571,DSC 197,001,956898,Eldridge; Justin Matthew,9996,0,9999,3
1746589167601,DSC 297,001,958000,Mazumdar; Arya,9998,0,9999,1
1746589167601,DSC 297,002,959862,Wang; Yusu,9998,0,9999,1
1746589168628,EAP 100,A00,905686,Staff,9778,0,9999,221
1746589169653,ECE 45,A01,892618,Staff,0,0,65,65
1746589171708,ECE 111,A01,892719,Staff,6,0,65,59
1746589172738,ECE 197,001,957920,Mercier; Patrick Philip,9991,0,9999,8
1746589173764,ECON 178,A01,907814,Zhu; Ying,26,0,35,9
1746589174794,EDS 115,A00,895312,Staff,35,0,45,10
1746589175820,EDS 117,A01,895337,Staff,23,0,30,7
1746589176850,EDS 125,A00,895341,Jones; Gabrielle Anastasia,36,0,45,9
1746589177877,EDS 128A,A01,895459,Fargason; Sharon Gayle,44,0,45,1
1746589178902,EDS 128B,A01,895543,Pappas; Elizabeth,44,0,45,1
1746589179932,EDS 139,A00,897203,Pappas; Elizabeth,44,0,45,1
1746589179932,EDS 139,B00,897209,Fargason; Sharon Gayle,41,0,45,4
1746589180958,EDS 201,A00,895545,Staff,22,0,45,23
1746589181983,EDS 203,A01,895581,Halter; Christopher P.,22,0,45,23
1746589183007,EDS 204R,A01,895625,Heinzman; Erica M.,39,0,45,6
1746589183007,EDS 204R,B01,895693,Halter; Christopher P.,10,0,45,35
1746589184033,EDS 206R,A00,895694,Fargason; Sharon Gayle,1,0,30,29
1746589184033,EDS 206R,B00,895695,Choi; Bailey Miyeon,16,0,30,14
1746589185058,EDS 250,A00,895697,Hemans; Patricia Ann Benitez,22,0,45,23
1746589186086,EDS 281,A00,895701,Meyerott; Theresa Ann,1,0,15,14
1746589187111,EDS 284,A00,895736,Meyerott; Theresa Ann,1,0,15,14
1746589188135,EDS 286,A00,897210,Fine; Sarah,0,0,15,15
1746589189162,EDS 289C,A01,895770,Daly; Alan J.,1,0,15,14
1746589190188,EDS 290,A00,897211,Hofstetter; Carolyn,0,0,15,15
1746589191218,LIGM 5A,A00,896162,Fischer-Grunski; Eva K,12,0,20,8
1746589192244,LIGM 5B,A00,896260,Fischer-Grunski; Eva K,17,0,20,3
1746589193273,LIGM 5C,A00,896308,Fischer-Grunski; Eva K,18,0,20,2
1746589194297,LIIT 5AS,A00,896313,Carnelos; Chiara,18,0,20,2
1746589195324,LIIT 5BS,A00,896416,Carnelos; Chiara,20,0,20,0
1746589196350,LIIT 5CS,A00,896564,Carnelos; Chiara,20,0,20,0
1746589197379,LISP 5A,A00,896588,Munoz Sanchez; Alicia,2,0,20,18
1746589198409,LISP 5B,A00,896653,Munoz Sanchez; Alicia,7,0,20,13
1746589199434,LISP 5C,A00,896655,Munoz Sanchez; Alicia,0,1,20,20
1746589200459,MAE 197,001,957918,Kleissl; Jan,9996,0,9999,3
1746589200459,MAE 197,002,959806,Boechler; Nicholas Sebastia,9998,0,9999,1
1746589200459,MAE 197,003,959852,Mullin; Jennifer S,9998,0,9999,1
1746589201486,MATH 2,A01,957937,Staff,33,0,35,2
1746589202514,MATH 197,001,957876,Kedlaya; Kiran S.,9993,0,9999,6
1746589203544,MCWP 40,A00,892729,Duru; Nur,10,0,20,10
1746589203544,MCWP 40,B00,893304,Montejo; Carolina,14,0,20,6
1746589204569,MCWP 40R,A00,893757,Redela; Pamela Morgan,0,5,20,20
1746589205593,MCWP 50,A00,893758,Morshed; Michael James,0,0,20,20
1746589205593,MCWP 50,B00,893761,Bartulis; Jason Michael,17,0,20,3
1746589206619,MCWP 50R,A00,893766,Compas; Sean Matthew,0,1,20,20
1746589206619,MCWP 50R,B00,893769,Carter; Jennifer A,0,1,20,20
1746589206619,MCWP 50R,C00,893771,Krone; Jarret,0,3,20,20
1746589206619,MCWP 50R,D00,893772,Miller; Elizabeth Deen,0,0,20,20
1746589206619,MCWP 50R,E00,893775,Carter; Andrea L,0,1,20,20
1746589207648,MMW 11R,A01,892721,Herbst; Matthew,14,0,30,16
1746589207648,MMW 11R,A02,892722,Herbst; Matthew,0,0,0,3
1746589208672,MMW 12R,A01,892724,Herbst; Matthew,0,11,16,16
1746589208672,MMW 12R,A02,892725,Herbst; Matthew,0,10,16,16
1746589209700,MMW 13R,A01,892727,Staff,0,4,16,16
1746589209700,MMW 13R,A02,892728,Staff,0,4,16,16
1746589209700,MMW 13R,A03,958032,Staff,0,4,16,16
1746589209700,MMW 13R,A04,958033,Staff,0,4,16,16
1746589209700,MMW 13R,A05,958034,Staff,0,4,16,16
1746589210725,SIO 295LS,A00,894015,Staff,5,0,25,20
1746589211758,SIO 295S,A00,894020,Staff,5,0,25,20
1746589212783,SIOC 290S,B01,958918,Merrifield; Mark A,14,0,30,16
1746589213810,SIOC 291S,B01,958922,Gabriel; Corey John,14,0,30,16
1746589214835,SOCI 117,A01,895339,Staff,3,0,5,2
1746589215860,WES 237B,A00,894149,Staff,11,0,20,9
1746589217914,AESE 279B,A00,891859,Staff,13,0,35,22
1746589218940,AIP 197,001,891854,Vespa; Emanuel Ignacio,9999,0,9999,0
1746589219967,ANTH 289S,A00,891856,Gagneux; Pascal,12,0,12,0
1746589220992,BENG 196,001,957946,Engler; Adam J.,9996,0,9999,3
1746589222016,BISP 197,001,959851,Wilhelm; James E.,9998,0,9999,1
1746589223049,CAT 124RS,A01,956906,Staff,6,0,25,19
1746589224074,CAT 125RS,A01,922013,Staff,6,0,25,19
1746589225099,CLRE 250,A00,891860,Morris; Sheldon,9995,0,9999,4
1746589227158,CLRE 251R,A00,907817,Mehta; Ravindra L.,9994,0,9999,5
1746589228187,CLRE 252,A00,891864,Cuomo; Raphael Eduardo,9993,0,9999,6
1746589229211,CLRE 253,A00,891867,Vaida; Florin,9994,0,9999,5
1746589229211,CLRE 253,B00,907819,Staff,9999,0,9999,0
1746589230242,CLRE 259,A00,891868,Patel; Hemal,9998,0,9999,1
1746589231267,CLRE 260,A00,891872,Cuomo; Raphael Eduardo,9999,0,9999,0
1746589232294,CLRE 297,001,891888,Cuomo; Raphael Eduardo,9999,0,9999,0
1746589233319,CSE 191,A00,958773,Minnes Kemp; Mor Mia,9995,0,9999,4
1746589234354,CSE 197,001,959846,Minnes Kemp; Mor Mia,9990,0,9999,9
1746589235384,CSS 201S,A01,892054,Mignozzetti; Umberto,25,0,30,5
1746589236411,CSS 202S,A01,892056,Mignozzetti; Umberto,25,0,30,5
1746589237435,DSC 197,001,956898,Eldridge; Justin Matthew,9996,0,9999,3
1746589238465,DSC 297,001,958000,Mazumdar; Arya,9998,0,9999,1
1746589238465,DSC 297,002,959862,Wang; Yusu,9998,0,9999,1
1746589239494,EAP 100,A00,905686,Staff,9778,0,9999,221
1746589240526,ECE 45,A01,892618,Staff,0,0,65,65
1746589242579,ECE 111,A01,892719,Staff,6,0,65,59
1746589243604,ECE 197,001,957920,Mercier; Patrick Philip,9991,0,9999,8
1746589244629,ECON 178,A01,907814,Zhu; Ying,26,0,35,9
1746589245658,EDS 115,A00,895312,Staff,35,0,45,10
1746589246682,EDS 117,A01,895337,Staff,23,0,30,7
1746589247707,EDS 125,A00,895341,Jones; Gabrielle Anastasia,36,0,45,9
1746589248732,EDS 128A,A01,895459,Fargason; Sharon Gayle,44,0,45,1
1746589249763,EDS 128B,A01,895543,Pappas; Elizabeth,44,0,45,1
1746589250789,EDS 139,A00,897203,Pappas; Elizabeth,44,0,45,1
1746589250789,EDS 139,B00,897209,Fargason; Sharon Gayle,41,0,45,4
1746589251817,EDS 201,A00,895545,Staff,22,0,45,23
1746589252842,EDS 203,A01,895581,Halter; Christopher P.,22,0,45,23
1746589253872,EDS 204R,A01,895625,Heinzman; Erica M.,39,0,45,6
1746589253872,EDS 204R,B01,895693,Halter; Christopher P.,10,0,45,35
1746589254898,EDS 206R,A00,895694,Fargason; Sharon Gayle,1,0,30,29
1746589254898,EDS 206R,B00,895695,Choi; Bailey Miyeon,16,0,30,14
1746589255925,EDS 250,A00,895697,Hemans; Patricia Ann Benitez,22,0,45,23
1746589256951,EDS 281,A00,895701,Meyerott; Theresa Ann,1,0,15,14
1746589257978,EDS 284,A00,895736,Meyerott; Theresa Ann,1,0,15,14
1746589259004,EDS 286,A00,897210,Fine; Sarah,0,0,15,15
1746589260030,EDS 289C,A01,895770,Daly; Alan J.,1,0,15,14
1746589261056,EDS 290,A00,897211,Hofstetter; Carolyn,0,0,15,15
1746589262082,LIGM 5A,A00,896162,Fischer-Grunski; Eva K,12,0,20,8
1746589263111,LIGM 5B,A00,896260,Fischer-Grunski; Eva K,17,0,20,3
1746589264137,LIGM 5C,A00,896308,Fischer-Grunski; Eva K,18,0,20,2
1746589265166,LIIT 5AS,A00,896313,Carnelos; Chiara,18,0,20,2
1746589266195,LIIT 5BS,A00,896416,Carnelos; Chiara,20,0,20,0
1746589267224,LIIT 5CS,A00,896564,Carnelos; Chiara,20,0,20,0
1746589268248,LISP 5A,A00,896588,Munoz Sanchez; Alicia,2,0,20,18
1746589269275,LISP 5B,A00,896653,Munoz Sanchez; Alicia,7,0,20,13
1746589270300,LISP 5C,A00,896655,Munoz Sanchez; Alicia,0,1,20,20
1746589271326,MAE 197,001,957918,Kleissl; Jan,9996,0,9999,3
1746589271326,MAE 197,002,959806,Boechler; Nicholas Sebastia,9998,0,9999,1
1746589271326,MAE 197,003,959852,Mullin; Jennifer S,9998,0,9999,1
1746589272351,MATH 2,A01,957937,Staff,33,0,35,2
1746589273379,MATH 197,001,957876,Kedlaya; Kiran S.,9993,0,9999,6
1746589274409,MCWP 40,A00,892729,Duru; Nur,10,0,20,10
1746589274409,MCWP 40,B00,893304,Montejo; Carolina,14,0,20,6
1746589275434,MCWP 40R,A00,893757,Redela; Pamela Morgan,0,5,20,20
1746589276463,MCWP 50,A00,893758,Morshed; Michael James,0,0,20,20
1746589276463,MCWP 50,B00,893761,Bartulis; Jason Michael,17,0,20,3
1746589277489,MCWP 50R,A00,893766,Compas; Sean Matthew,0,1,20,20
1746589277489,MCWP 50R,B00,893769,Carter; Jennifer A,0,1,20,20
1746589277489,MCWP 50R,C00,893771,Krone; Jarret,0,3,20,20
1746589277489,MCWP 50R,D00,893772,Miller; Elizabeth Deen,0,0,20,20
1746589277489,MCWP 50R,E00,893775,Carter; Andrea L,0,1,20,20
1746589278515,MMW 11R,A01,892721,Herbst; Matthew,14,0,30,16
1746589278515,MMW 11R,A02,892722,Herbst; Matthew,0,0,0,3
1746589279541,MMW 12R,A01,892724,Herbst; Matthew,0,11,16,16
1746589279541,MMW 12R,A02,892725,Herbst; Matthew,0,10,16,16
1746589280567,MMW 13R,A01,892727,Staff,0,4,16,16
1746589280567,MMW 13R,A02,892728,Staff,0,4,16,16
1746589280567,MMW 13R,A03,958032,Staff,0,4,16,16
1746589280567,MMW 13R,A04,958033,Staff,0,4,16,16
1746589280567,MMW 13R,A05,958034,Staff,0,4,16,16
1746589281592,SIO 295LS,A00,894015,Staff,5,0,25,20
1746589282618,SIO 295S,A00,894020,Staff,5,0,25,20
1746589283643,SIOC 290S,B01,958918,Merrifield; Mark A,14,0,30,16
1746589284671,SIOC 291S,B01,958922,Gabriel; Corey John,14,0,30,16
1746589285701,SOCI 117,A01,895339,Staff,3,0,5,2
1746589286728,WES 237B,A00,894149,Staff,11,0,20,9
1746589288800,AESE 279B,A00,891859,Staff,13,0,35,22
1746589289825,AIP 197,001,891854,Vespa; Emanuel Ignacio,9999,0,9999,0
1746589290853,ANTH 289S,A00,891856,Gagneux; Pascal,12,0,12,0
1746589291878,BENG 196,001,957946,Engler; Adam J.,9996,0,9999,3
1746589292907,BISP 197,001,959851,Wilhelm; James E.,9998,0,9999,1
1746589293932,CAT 124RS,A01,956906,Staff,6,0,25,19
1746589294959,CAT 125RS,A01,922013,Staff,6,0,25,19
1746589295989,CLRE 250,A00,891860,Morris; Sheldon,9995,0,9999,4
1746589298046,CLRE 251R,A00,907817,Mehta; Ravindra L.,9994,0,9999,5
1746589299077,CLRE 252,A00,891864,Cuomo; Raphael Eduardo,9993,0,9999,6
1746589300103,CLRE 253,A00,891867,Vaida; Florin,9994,0,9999,5
1746589300103,CLRE 253,B00,907819,Staff,9999,0,9999,0
1746589301128,CLRE 259,A00,891868,Patel; Hemal,9998,0,9999,1
1746589302154,CLRE 260,A00,891872,Cuomo; Raphael Eduardo,9999,0,9999,0
1746589303183,CLRE 297,001,891888,Cuomo; Raphael Eduardo,9999,0,9999,0
1746589304209,CSE 191,A00,958773,Minnes Kemp; Mor Mia,9995,0,9999,4
1746589305239,CSE 197,001,959846,Minnes Kemp; Mor Mia,9990,0,9999,9
1746589306269,CSS 201S,A01,892054,Mignozzetti; Umberto,25,0,30,5
1746589307300,CSS 202S,A01,892056,Mignozzetti; Umberto,25,0,30,5
1746589308325,DSC 197,001,956898,Eldridge; Justin Matthew,9996,0,9999,3
1746589309354,DSC 297,001,958000,Mazumdar; Arya,9998,0,9999,1
1746589309354,DSC 297,002,959862,Wang; Yusu,9998,0,9999,1
1746589310380,EAP 100,A00,905686,Staff,9778,0,9999,221
1746589311406,ECE 45,A01,892618,Staff,0,0,65,65
1746589313460,ECE 111,A01,892719,Staff,6,0,65,59
1746589314485,ECE 197,001,957920,Mercier; Patrick Philip,9991,0,9999,8
1746589315510,ECON 178,A01,907814,Zhu; Ying,26,0,35,9
1746589316535,EDS 115,A00,895312,Staff,35,0,45,10
1746589317560,EDS 117,A01,895337,Staff,23,0,30,7
1746589318588,EDS 125,A00,895341,Jones; Gabrielle Anastasia,36,0,45,9
1746589319617,EDS 128A,A01,895459,Fargason; Sharon Gayle,44,0,45,1
1746589320643,EDS 128B,A01,895543,Pappas; Elizabeth,44,0,45,1
1746589321671,EDS 139,A00,897203,Pappas; Elizabeth,44,0,45,1
1746589321671,EDS 139,B00,897209,Fargason; Sharon Gayle,41,0,45,4
1746589322696,EDS 201,A00,895545,Staff,22,0,45,23
1746589323724,EDS 203,A01,895581,Halter; Christopher P.,22,0,45,23
1746589324749,EDS 204R,A01,895625,Heinzman; Erica M.,39,0,45,6
1746589324749,EDS 204R,B01,895693,Halter; Christopher P.,10,0,45,35
1746589325776,EDS 206R,A00,895694,Fargason; Sharon Gayle,1,0,30,29
1746589325776,EDS 206R,B00,895695,Choi; Bailey Miyeon,16,0,30,14
1746589326805,EDS 250,A00,895697,Hemans; Patricia Ann Benitez,22,0,45,23
1746589327830,EDS 281,A00,895701,Meyerott; Theresa Ann,1,0,15,14
1746589328856,EDS 284,A00,895736,Meyerott; Theresa Ann,1,0,15,14
1746589329884,EDS 286,A00,897210,Fine; Sarah,0,0,15,15
1746589330911,EDS 289C,A01,895770,Daly; Alan J.,1,0,15,14
1746589331939,EDS 290,A00,897211,Hofstetter; Carolyn,0,0,15,15
1746589332970,LIGM 5A,A00,896162,Fischer-Grunski; Eva K,12,0,20,8
1746589333997,LIGM 5B,A00,896260,Fischer-Grunski; Eva K,17,0,20,3
1746589335027,LIGM 5C,A00,896308,Fischer-Grunski; Eva K,18,0,20,2
1746589336052,LIIT 5AS,A00,896313,Carnelos; Chiara,18,0,20,2
1746589337082,LIIT 5BS,A00,896416,Carnelos; Chiara,20,0,20,0
1746589338108,LIIT 5CS,A00,896564,Carnelos; Chiara,20,0,20,0
1746589339134,LISP 5A,A00,896588,Munoz Sanchez; Alicia,2,0,20,18
1746589340161,LISP 5B,A00,896653,Munoz Sanchez; Alicia,7,0,20,13
1746589341186,LISP 5C,A00,896655,Munoz Sanchez; Alicia,0,1,20,20
1746589342212,MAE 197,001,957918,Kleissl; Jan,9996,0,9999,3
1746589342212,MAE 197,002,959806,Boechler; Nicholas Sebastia,9998,0,9999,1
1746589342212,MAE 197,003,959852,Mullin; Jennifer S,9998,0,9999,1
1746589343242,MATH 2,A01,957937,Staff,33,0,35,2
1746589344271,MATH 197,001,957876,Kedlaya; Kiran S.,9993,0,9999,6
1746589345300,MCWP 40,A00,892729,Duru; Nur,10,0,20,10
1746589345300,MCWP 40,B00,893304,Montejo; Carolina,14,0,20,6
1746589346324,MCWP 40R,A00,893757,Redela; Pamela Morgan,0,5,20,20
1746589347352,MCWP 50,A00,893758,Morshed; Michael James,0,0,20,20
1746589347352,MCWP 50,B00,893761,Bartulis; Jason Michael,17,0,20,3
1746589348379,MCWP 50R,A00,893766,Compas; Sean Matthew,0,1,20,20
1746589348379,MCWP 50R,B00,893769,Carter; Jennifer A,0,1,20,20
1746589348379,MCWP 50R,C00,893771,Krone; Jarret,0,3,20,20
1746589348379,MCWP 50R,D00,893772,Miller; Elizabeth Deen,0,0,20,20
1746589348379,MCWP 50R,E00,893775,Carter; Andrea L,0,1,20,20
1746589349408,MMW 11R,A01,892721,Herbst; Matthew,14,0,30,16
1746589349408,MMW 11R,A02,892722,Herbst; Matthew,0,0,0,3
1746589350435,MMW 12R,A01,892724,Herbst; Matthew,0,11,16,16
1746589350435,MMW 12R,A02,892725,Herbst; Matthew,0,10,16,16
1746589351464,MMW 13R,A01,892727,Staff,0,4,16,16
1746589351464,MMW 13R,A02,892728,Staff,0,4,16,16
1746589351464,MMW 13R,A03,958032,Staff,0,4,16,16
1746589351464,MMW 13R,A04,958033,Staff,0,4,16,16
1746589351464,MMW 13R,A05,958034,Staff,0,4,16,16
1746589352493,SIO 295LS,A00,894015,Staff,5,0,25,20
1746589353521,SIO 295S,A00,894020,Staff,5,0,25,20
1746589354547,SIOC 290S,B01,958918,Merrifield; Mark A,14,0,30,16
1746589355573,SIOC 291S,B01,958922,Gabriel; Corey John,14,0,30,16
1746589356598,SOCI 117,A01,895339,Staff,3,0,5,2
1746589357629,WES 237B,A00,894149,Staff,11,0,20,9
1746589359686,AESE 279B,A00,891859,Staff,13,0,35,22
1746589360713,AIP 197,001,891854,Vespa; Emanuel Ignacio,9999,0,9999,0
1746589361739,ANTH 289S,A00,891856,Gagneux; Pascal,12,0,12,0
1746589362768,BENG 196,001,957946,Engler; Adam J.,9996,0,9999,3
1746589363793,BISP 197,001,959851,Wilhelm; James E.,9998,0,9999,1
1746589364819,CAT 124RS,A01,956906,Staff,6,0,25,19
1746589365849,CAT 125RS,A01,922013,Staff,6,0,25,19
1746589366877,CLRE 250,A00,891860,Morris; Sheldon,9995,0,9999,4
1746589368934,CLRE 251R,A00,907817,Mehta; Ravindra L.,9994,0,9999,5
1746589369958,CLRE 252,A00,891864,Cuomo; Raphael Eduardo,9993,0,9999,6
1746589370989,CLRE 253,A00,891867,Vaida; Florin,9994,0,9999,5
1746589370989,CLRE 253,B00,907819,Staff,9999,0,9999,0
1746589372015,CLRE 259,A00,891868,Patel; Hemal,9998,0,9999,1
1746589373044,CLRE 260,A00,891872,Cuomo; Raphael Eduardo,9999,0,9999,0
1746589374069,CLRE 297,001,891888,Cuomo; Raphael Eduardo,9999,0,9999,0
1746589375098,CSE 191,A00,958773,Minnes Kemp; Mor Mia,9995,0,9999,4
1746589376165,CSE 197,001,959846,Minnes Kemp; Mor Mia,9990,0,9999,9
1746589377189,CSS 201S,A01,892054,Mignozzetti; Umberto,25,0,30,5
1746589378214,CSS 202S,A01,892056,Mignozzetti; Umberto,25,0,30,5
1746589379241,DSC 197,001,956898,Eldridge; Justin Matthew,9996,0,9999,3
1746589380267,DSC 297,001,958000,Mazumdar; Arya,9998,0,9999,1
1746589380267,DSC 297,002,959862,Wang; Yusu,9998,0,9999,1
1746589381296,EAP 100,A00,905686,Staff,9778,0,9999,221
1746589382323,ECE 45,A01,892618,Staff,0,0,65,65
1746589384377,ECE 111,A01,892719,Staff,6,0,65,59
1746589385403,ECE 197,001,957920,Mercier; Patrick Philip,9991,0,9999,8
1746589386429,ECON 178,A01,907814,Zhu; Ying,26,0,35,9
1746589387456,EDS 115,A00,895312,Staff,35,0,45,10
1746589388482,EDS 117,A01,895337,Staff,23,0,30,7
1746589389513,EDS 125,A00,895341,Jones; Gabrielle Anastasia,36,0,45,9
1746589390539,EDS 128A,A01,895459,Fargason; Sharon Gayle,44,0,45,1
1746589391564,EDS 128B,A01,895543,Pappas; Elizabeth,44,0,45,1
1746589392593,EDS 139,A00,897203,Pappas; Elizabeth,44,0,45,1
1746589392593,EDS 139,B00,897209,Fargason; Sharon Gayle,41,0,45,4
1746589393620,EDS 201,A00,895545,Staff,22,0,45,23
1746589394646,EDS 203,A01,895581,Halter; Christopher P.,22,0,45,23
1746589395671,EDS 204R,A01,895625,Heinzman; Erica M.,39,0,45,6
1746589395671,EDS 204R,B01,895693,Halter; Christopher P.,10,0,45,35
1746589396697,EDS 206R,A00,895694,Fargason; Sharon Gayle,1,0,30,29
1746589396697,EDS 206R,B00,895695,Choi; Bailey Miyeon,16,0,30,14
1746589397725,EDS 250,A00,895697,Hemans; Patricia Ann Benitez,22,0,45,23
1746589398750,EDS 281,A00,895701,Meyerott; Theresa Ann,1,0,15,14
1746589399779,EDS 284,A00,895736,Meyerott; Theresa Ann,1,0,15,14
1746589400809,EDS 286,A00,897210,Fine; Sarah,0,0,15,15
1746589401832,EDS 289C,A01,895770,Daly; Alan J.,1,0,15,14
1746589402859,EDS 290,A00,897211,Hofstetter; Carolyn,0,0,15,15
1746589403883,LIGM 5A,A00,896162,Fischer-Grunski; Eva K,12,0,20,8
1746589404909,LIGM 5B,A00,896260,Fischer-Grunski; Eva K,17,0,20,3
1746589405939,LIGM 5C,A00,896308,Fischer-Grunski; Eva K,18,0,20,2
1746589406966,LIIT 5AS,A00,896313,Carnelos; Chiara,18,0,20,2
1746589407990,LIIT 5BS,A00,896416,Carnelos; Chiara,20,0,20,0
1746589409020,LIIT 5CS,A00,896564,Carnelos; Chiara,20,0,20,0
1746589410045,LISP 5A,A00,896588,Munoz Sanchez; Alicia,2,0,20,18
1746589411075,LISP 5B,A00,896653,Munoz Sanchez; Alicia,7,0,20,13
1746589412102,LISP 5C,A00,896655,Munoz Sanchez; Alicia,0,1,20,20
1746589413128,MAE 197,001,957918,Kleissl; Jan,9996,0,9999,3
1746589413128,MAE 197,002,959806,Boechler; Nicholas Sebastia,9998,0,9999,1
1746589413128,MAE 197,003,959852,Mullin; Jennifer S,9998,0,9999,1
1746589414157,MATH 2,A01,957937,Staff,33,0,35,2
1746589415184,MATH 197,001,957876,Kedlaya; Kiran S.,9993,0,9999,6
1746589416211,MCWP 40,A00,892729,Duru; Nur,10,0,20,10
1746589416211,MCWP 40,B00,893304,Montejo; Carolina,14,0,20,6
1746589417234,MCWP 40R,A00,893757,Redela; Pamela Morgan,0,5,20,20
1746589418260,MCWP 50,A00,893758,Morshed; Michael James,0,0,20,20
1746589418260,MCWP 50,B00,893761,Bartulis; Jason Michael,17,0,20,3
1746589419290,MCWP 50R,A00,893766,Compas; Sean Matthew,0,1,20,20
1746589419290,MCWP 50R,B00,893769,Carter; Jennifer A,0,1,20,20
1746589419290,MCWP 50R,C00,893771,Krone; Jarret,0,3,20,20
1746589419290,MCWP 50R,D00,893772,Miller; Elizabeth Deen,0,0,20,20
1746589419290,MCWP 50R,E00,893775,Carter; Andrea L,0,1,20,20
1746589420316,MMW 11R,A01,892721,Herbst; Matthew,14,0,30,16
1746589420316,MMW 11R,A02,892722,Herbst; Matthew,0,0,0,3
1746589421343,MMW 12R,A01,892724,Herbst; Matthew,0,11,16,16
1746589421343,MMW 12R,A02,892725,Herbst; Matthew,0,10,16,16
1746589422370,MMW 13R,A01,892727,Staff,0,4,16,16
1746589422370,MMW 13R,A02,892728,Staff,0,4,16,16
1746589422370,MMW 13R,A03,958032,Staff,0,4,16,16
1746589422370,MMW 13R,A04,958033,Staff,0,4,16,16
1746589422370,MMW 13R,A05,958034,Staff,0,4,16,16
1746589423395,SIO 295LS,A00,894015,Staff,5,0,25,20
1746589424422,SIO 295S,A00,894020,Staff,5,0,25,20
1746589425449,SIOC 290S,B01,958918,Merrifield; Mark A,14,0,30,16
1746589426478,SIOC 291S,B01,958922,Gabriel; Corey John,14,0,30,16
1746589427506,SOCI 117,A01,895339,Staff,3,0,5,2
1746589428533,WES 237B,A00,894149,Staff,11,0,20,9
1746589430599,AESE 279B,A00,891859,Staff,13,0,35,22
1746589431626,AIP 197,001,891854,Vespa; Emanuel Ignacio,9999,0,9999,0
1746589432651,ANTH 289S,A00,891856,Gagneux; Pascal,12,0,12,0
1746589433678,BENG 196,001,957946,Engler; Adam J.,9996,0,9999,3
1746589434705,BISP 197,001,959851,Wilhelm; James E.,9998,0,9999,1
1746589435730,CAT 124RS,A01,956906,Staff,6,0,25,19
1746589436758,CAT 125RS,A01,922013,Staff,6,0,25,19
1746589437783,CLRE 250,A00,891860,Morris; Sheldon,9995,0,9999,4
1746589439836,CLRE 251R,A00,907817,Mehta; Ravindra L.,9994,0,9999,5
1746589440862,CLRE 252,A00,891864,Cuomo; Raphael Eduardo,9993,0,9999,6
1746589441890,CLRE 253,A00,891867,Vaida; Florin,9994,0,9999,5
1746589441890,CLRE 253,B00,907819,Staff,9999,0,9999,0
1746589442918,CLRE 259,A00,891868,Patel; Hemal,9998,0,9999,1
1746589443946,CLRE 260,A00,891872,Cuomo; Raphael Eduardo,9999,0,9999,0
1746589444970,CLRE 297,001,891888,Cuomo; Raphael Eduardo,9999,0,9999,0
1746589445995,CSE 191,A00,958773,Minnes Kemp; Mor Mia,9995,0,9999,4
1746589447023,CSE 197,001,959846,Minnes Kemp; Mor Mia,9990,0,9999,9
1746589448049,CSS 201S,A01,892054,Mignozzetti; Umberto,25,0,30,5
1746589449074,CSS 202S,A01,892056,Mignozzetti; Umberto,25,0,30,5
1746589450099,DSC 197,001,956898,Eldridge; Justin Matthew,9996,0,9999,3
1746589451125,DSC 297,001,958000,Mazumdar; Arya,9998,0,9999,1
1746589451125,DSC 297,002,959862,Wang; Yusu,9998,0,9999,1
1746589452153,EAP 100,A00,905686,Staff,9778,0,9999,221
1746589453185,ECE 45,A01,892618,Staff,0,0,65,65
1746589455237,ECE 111,A01,892719,Staff,6,0,65,59
1746589456266,ECE 197,001,957920,Mercier; Patrick Philip,9991,0,9999,8
1746589457293,ECON 178,A01,907814,Zhu; Ying,26,0,35,9
1746589458318,EDS 115,A00,895312,Staff,35,0,45,10
1746589459346,EDS 117,A01,895337,Staff,23,0,30,7
1746589460379,EDS 125,A00,895341,Jones; Gabrielle Anastasia,36,0,45,9
1746589461404,EDS 128A,A01,895459,Fargason; Sharon Gayle,44,0,45,1
1746589462433,EDS 128B,A01,895543,Pappas; Elizabeth,44,0,45,1
1746589463459,EDS 139,A00,897203,Pappas; Elizabeth,44,0,45,1
1746589463459,EDS 139,B00,897209,Fargason; Sharon Gayle,41,0,45,4
1746589464487,EDS 201,A00,895545,Staff,22,0,45,23
1746589465510,EDS 203,A01,895581,Halter; Christopher P.,22,0,45,23
1746589466535,EDS 204R,A01,895625,Heinzman; Erica M.,39,0,45,6
1746589466535,EDS 204R,B01,895693,Halter; Christopher P.,10,0,45,35
1746589467561,EDS 206R,A00,895694,Fargason; Sharon Gayle,1,0,30,29
1746589467561,EDS 206R,B00,895695,Choi; Bailey Miyeon,16,0,30,14
1746589468590,EDS 250,A00,895697,Hemans; Patricia Ann Benitez,22,0,45,23
1746589469615,EDS 281,A00,895701,Meyerott; Theresa Ann,1,0,15,14
1746589470641,EDS 284,A00,895736,Meyerott; Theresa Ann,1,0,15,14
1746589471670,EDS 286,A00,897210,Fine; Sarah,0,0,15,15
1746589472696,EDS 289C,A01,895770,Daly; Alan J.,1,0,15,14
1746589473724,EDS 290,A00,897211,Hofstetter; Carolyn,0,0,15,15
1746589474751,LIGM 5A,A00,896162,Fischer-Grunski; Eva K,12,0,20,8
1746589475780,LIGM 5B,A00,896260,Fischer-Grunski; Eva K,17,0,20,3
1746589476805,LIGM 5C,A00,896308,Fischer-Grunski; Eva K,18,0,20,2
1746589477830,LIIT 5AS,A00,896313,Carnelos; Chiara,18,0,20,2
1746589478856,LIIT 5BS,A00,896416,Carnelos; Chiara,20,0,20,0
1746589479926,LIIT 5CS,A00,896564,Carnelos; Chiara,20,0,20,0
1746589480953,LISP 5A,A00,896588,Munoz Sanchez; Alicia,2,0,20,18
1746589481979,LISP 5B,A00,896653,Munoz Sanchez; Alicia,7,0,20,13
1746589483008,LISP 5C,A00,896655,Munoz Sanchez; Alicia,0,1,20,20
1746589484037,MAE 197,001,957918,Kleissl; Jan,9996,0,9999,3
1746589484037,MAE 197,002,959806,Boechler; Nicholas Sebastia,9998,0,9999,1
1746589484037,MAE 197,003,959852,Mullin; Jennifer S,9998,0,9999,1
1746589485062,MATH 2,A01,957937,Staff,33,0,35,2
1746589486086,MATH 197,001,957876,Kedlaya; Kiran S.,9993,0,9999,6
1746589487112,MCWP 40,A00,892729,Duru; Nur,10,0,20,10
1746589487112,MCWP 40,B00,893304,Montejo; Carolina,14,0,20,6
1746589488140,MCWP 40R,A00,893757,Redela; Pamela Morgan,0,5,20,20
1746589489164,MCWP 50,A00,893758,Morshed; Michael James,0,0,20,20
1746589489164,MCWP 50,B00,893761,Bartulis; Jason Michael,17,0,20,3
1746589490190,MCWP 50R,A00,893766,Compas; Sean Matthew,0,1,20,20
1746589490190,MCWP 50R,B00,893769,Carter; Jennifer A,0,1,20,20
1746589490190,MCWP 50R,C00,893771,Krone; Jarret,0,3,20,20
1746589490190,MCWP 50R,D00,893772,Miller; Elizabeth Deen,0,0,20,20
1746589490190,MCWP 50R,E00,893775,Carter; Andrea L,0,1,20,20
1746589491217,MMW 11R,A01,892721,Herbst; Matthew,14,0,30,16
1746589491217,MMW 11R,A02,892722,Herbst; Matthew,0,0,0,3
1746589492246,MMW 12R,A01,892724,Herbst; Matthew,0,11,16,16
1746589492246,MMW 12R,A02,892725,Herbst; Matthew,0,10,16,16
1746589493275,MMW 13R,A01,892727,Staff,0,4,16,16
1746589493275,MMW 13R,A02,892728,Staff,0,4,16,16
1746589493275,MMW 13R,A03,958032,Staff,0,4,16,16
1746589493275,MMW 13R,A04,958033,Staff,0,4,16,16
1746589493275,MMW 13R,A05,958034,Staff,0,4,16,16
1746589494304,SIO 295LS,A00,894015,Staff,5,0,25,20
1746589495329,SIO 295S,A00,894020,Staff,5,0,25,20
1746589496356,SIOC 290S,B01,958918,Merrifield; Mark A,14,0,30,16
1746589497383,SIOC 291S,B01,958922,Gabriel; Corey John,14,0,30,16
1746589498411,SOCI 117,A01,895339,Staff,3,0,5,2
1746589499436,WES 237B,A00,894149,Staff,11,0,20,9
1746589501509,AESE 279B,A00,891859,Staff,13,0,35,22
1746589502533,AIP 197,001,891854,Vespa; Emanuel Ignacio,9999,0,9999,0
1746589503562,ANTH 289S,A00,891856,Gagneux; Pascal,12,0,12,0
1746589504590,BENG 196,001,957946,Engler; Adam J.,9996,0,9999,3
1746589505617,BISP 197,001,959851,Wilhelm; James E.,9998,0,9999,1
1746589506643,CAT 124RS,A01,956906,Staff,6,0,25,19
1746589507671,CAT 125RS,A01,922013,Staff,6,0,25,19
1746589508696,CLRE 250,A00,891860,Morris; Sheldon,9995,0,9999,4
1746589510748,CLRE 251R,A00,907817,Mehta; Ravindra L.,9994,0,9999,5
1746589511774,CLRE 252,A00,891864,Cuomo; Raphael Eduardo,9993,0,9999,6
1746589512802,CLRE 253,A00,891867,Vaida; Florin,9994,0,9999,5
1746589512802,CLRE 253,B00,907819,Staff,9999,0,9999,0
1746589513829,CLRE 259,A00,891868,Patel; Hemal,9998,0,9999,1
1746589514856,CLRE 260,A00,891872,Cuomo; Raphael Eduardo,9999,0,9999,0
1746589515884,CLRE 297,001,891888,Cuomo; Raphael Eduardo,9999,0,9999,0
1746589516908,CSE 191,A00,958773,Minnes Kemp; Mor Mia,9995,0,9999,4
1746589517933,CSE 197,001,959846,Minnes Kemp; Mor Mia,9990,0,9999,9
1746589518962,CSS 201S,A01,892054,Mignozzetti; Umberto,25,0,30,5
1746589519987,CSS 202S,A01,892056,Mignozzetti; Umberto,25,0,30,5
1746589521013,DSC 197,001,956898,Eldridge; Justin Matthew,9996,0,9999,3
1746589522040,DSC 297,001,958000,Mazumdar; Arya,9998,0,9999,1
1746589522040,DSC 297,002,959862,Wang; Yusu,9998,0,9999,1
1746589523068,EAP 100,A00,905686,Staff,9778,0,9999,221
1746589524094,ECE 45,A01,892618,Staff,0,0,65,65
1746589526149,ECE 111,A01,892719,Staff,6,0,65,59
1746589527177,ECE 197,001,957920,Mercier; Patrick Philip,9991,0,9999,8
1746589528204,ECON 178,A01,907814,Zhu; Ying,26,0,35,9
1746589529229,EDS 115,A00,895312,Staff,35,0,45,10
1746589530256,EDS 117,A01,895337,Staff,23,0,30,7
1746589531284,EDS 125,A00,895341,Jones; Gabrielle Anastasia,36,0,45,9
1746589532314,EDS 128A,A01,895459,Fargason; Sharon Gayle,44,0,45,1
1746589533341,EDS 128B,A01,895543,Pappas; Elizabeth,44,0,45,1
1746589534369,EDS 139,A00,897203,Pappas; Elizabeth,44,0,45,1
1746589534369,EDS 139,B00,897209,Fargason; Sharon Gayle,41,0,45,4
1746589535395,EDS 201,A00,895545,Staff,22,0,45,23
1746589536424,EDS 203,A01,895581,Halter; Christopher P.,22,0,45,23
1746589537448,EDS 204R,A01,895625,Heinzman; Erica M.,39,0,45,6
1746589537448,EDS 204R,B01,895693,Halter; Christopher P.,10,0,45,35
1746589538474,EDS 206R,A00,895694,Fargason; Sharon Gayle,1,0,30,29
1746589538474,EDS 206R,B00,895695,Choi; Bailey Miyeon,16,0,30,14
1746589539499,EDS 250,A00,895697,Hemans; Patricia Ann Benitez,22,0,45,23
1746589540525,EDS 281,A00,895701,Meyerott; Theresa Ann,1,0,15,14
1746589541550,EDS 284,A00,895736,Meyerott; Theresa Ann,1,0,15,14
1746589542576,EDS 286,A00,897210,Fine; Sarah,0,0,15,15
1746589543603,EDS 289C,A01,895770,Daly; Alan J.,1,0,15,14
1746589544629,EDS 290,A00,897211,Hofstetter; Carolyn,0,0,15,15
1746589545654,LIGM 5A,A00,896162,Fischer-Grunski; Eva K,12,0,20,8
1746589546680,LIGM 5B,A00,896260,Fischer-Grunski; Eva K,17,0,20,3
1746589547708,LIGM 5C,A00,896308,Fischer-Grunski; Eva K,18,0,20,2
1746589548735,LIIT 5AS,A00,896313,Carnelos; Chiara,18,0,20,2
1746589549764,LIIT 5BS,A00,896416,Carnelos; Chiara,20,0,20,0
1746589550793,LIIT 5CS,A00,896564,Carnelos; Chiara,20,0,20,0
1746589551822,LISP 5A,A00,896588,Munoz Sanchez; Alicia,2,0,20,18
1746589552847,LISP 5B,A00,896653,Munoz Sanchez; Alicia,7,0,20,13
1746589553876,LISP 5C,A00,896655,Munoz Sanchez; Alicia,0,1,20,20
1746589554902,MAE 197,001,957918,Kleissl; Jan,9996,0,9999,3
1746589554902,MAE 197,002,959806,Boechler; Nicholas Sebastia,9998,0,9999,1
1746589554902,MAE 197,003,959852,Mullin; Jennifer S,9998,0,9999,1
1746589555929,MATH 2,A01,957937,Staff,33,0,35,2
1746589556954,MATH 197,001,957876,Kedlaya; Kiran S.,9993,0,9999,6
1746589557980,MCWP 40,A00,892729,Duru; Nur,10,0,20,10
1746589557980,MCWP 40,B00,893304,Montejo; Carolina,14,0,20,6
1746589559008,MCWP 40R,A00,893757,Redela; Pamela Morgan,0,5,20,20
1746589560034,MCWP 50,A00,893758,Morshed; Michael James,0,0,20,20
1746589560034,MCWP 50,B00,893761,Bartulis; Jason Michael,17,0,20,3
1746589561063,MCWP 50R,A00,893766,Compas; Sean Matthew,0,1,20,20
1746589561063,MCWP 50R,B00,893769,Carter; Jennifer A,0,1,20,20
1746589561063,MCWP 50R,C00,893771,Krone; Jarret,0,3,20,20
1746589561063,MCWP 50R,D00,893772,Miller; Elizabeth Deen,0,0,20,20
1746589561063,MCWP 50R,E00,893775,Carter; Andrea L,0,1,20,20
1746589562091,MMW 11R,A01,892721,Herbst; Matthew,14,0,30,16
1746589562091,MMW 11R,A02,892722,Herbst; Matthew,0,0,0,3
1746589563118,MMW 12R,A01,892724,Herbst; Matthew,0,11,16,16
1746589563118,MMW 12R,A02,892725,Herbst; Matthew,0,10,16,16
1746589564148,MMW 13R,A01,892727,Staff,0,4,16,16
1746589564148,MMW 13R,A02,892728,Staff,0,4,16,16
1746589564148,MMW 13R,A03,958032,Staff,0,4,16,16
1746589564148,MMW 13R,A04,958033,Staff,0,4,16,16
1746589564148,MMW 13R,A05,958034,Staff,0,4,16,16
1746589565173,SIO 295LS,A00,894015,Staff,5,0,25,20
1746589566204,SIO 295S,A00,894020,Staff,5,0,25,20
1746589567233,SIOC 290S,B01,958918,Merrifield; Mark A,14,0,30,16
1746589568258,SIOC 291S,B01,958922,Gabriel; Corey John,14,0,30,16
1746589569286,SOCI 117,A01,895339,Staff,3,0,5,2
1746589570311,WES 237B,A00,894149,Staff,11,0,20,9
1746589572372,AESE 279B,A00,891859,Staff,13,0,35,22
1746589573397,AIP 197,001,891854,Vespa; Emanuel Ignacio,9999,0,9999,0
1746589574425,ANTH 289S,A00,891856,Gagneux; Pascal,12,0,12,0
1746589575450,BENG 196,001,957946,Engler; Adam J.,9996,0,9999,3
1746589576477,BISP 197,001,959851,Wilhelm; James E.,9998,0,9999,1
1746589577504,CAT 124RS,A01,956906,Staff,6,0,25,19
1746589578530,CAT 125RS,A01,922013,Staff,6,0,25,19
1746589579553,CLRE 250,A00,891860,Morris; Sheldon,9995,0,9999,4
1746589581609,CLRE 251R,A00,907817,Mehta; Ravindra L.,9994,0,9999,5
1746589582637,CLRE 252,A00,891864,Cuomo; Raphael Eduardo,9993,0,9999,6
1746589583704,CLRE 253,A00,891867,Vaida; Florin,9994,0,9999,5
1746589583704,CLRE 253,B00,907819,Staff,9999,0,9999,0
1746589584730,CLRE 259,A00,891868,Patel; Hemal,9998,0,9999,1
1746589585758,CLRE 260,A00,891872,Cuomo; Raphael Eduardo,9999,0,9999,0
1746589586785,CLRE 297,001,891888,Cuomo; Raphael Eduardo,9999,0,9999,0
1746589587811,CSE 191,A00,958773,Minnes Kemp; Mor Mia,9995,0,9999,4
1746589588836,CSE 197,001,959846,Minnes Kemp; Mor Mia,9990,0,9999,9
1746589589861,CSS 201S,A01,892054,Mignozzetti; Umberto,25,0,30,5
1746589590890,CSS 202S,A01,892056,Mignozzetti; Umberto,25,0,30,5
1746589591916,DSC 197,001,956898,Eldridge; Justin Matthew,9996,0,9999,3
1746589592940,DSC 297,001,958000,Mazumdar; Arya,9998,0,9999,1
1746589592940,DSC 297,002,959862,Wang; Yusu,9998,0,9999,1
1746589593965,EAP 100,A00,905686,Staff,9778,0,9999,221
1746589594991,ECE 45,A01,892618,Staff,0,0,65,65
1746589597046,ECE 111,A01,892719,Staff,6,0,65,59
1746589598073,ECE 197,001,957920,Mercier; Patrick Philip,9991,0,9999,8
1746589599098,ECON 178,A01,907814,Zhu; Ying,26,0,35,9
1746589600125,EDS 115,A00,895312,Staff,35,0,45,10
1746589601154,EDS 117,A01,895337,Staff,23,0,30,7
1746589602182,EDS 125,A00,895341,Jones; Gabrielle Anastasia,36,0,45,9
1746589603207,EDS 128A,A01,895459,Fargason; Sharon Gayle,44,0,45,1
1746589604251,EDS 128B,A01,895543,Pappas; Elizabeth,44,0,45,1
1746589605278,EDS 139,A00,897203,Pappas; Elizabeth,44,0,45,1
1746589605278,EDS 139,B00,897209,Fargason; Sharon Gayle,41,0,45,4
1746589606302,EDS 201,A00,895545,Staff,22,0,45,23
1746589607326,EDS 203,A01,895581,Halter; Christopher P.,22,0,45,23
1746589608353,EDS 204R,A01,895625,Heinzman; Erica M.,39,0,45,6
1746589608353,EDS 204R,B01,895693,Halter; Christopher P.,10,0,45,35
1746589609379,EDS 206R,A00,895694,Fargason; Sharon Gayle,1,0,30,29
1746589609379,EDS 206R,B00,895695,Choi; Bailey Miyeon,16,0,30,14
1746589610404,EDS 250,A00,895697,Hemans; Patricia Ann Benitez,22,0,45,23
1746589611429,EDS 281,A00,895701,Meyerott; Theresa Ann,1,0,15,14
1746589612456,EDS 284,A00,895736,Meyerott; Theresa Ann,1,0,15,14
1746589613482,EDS 286,A00,897210,Fine; Sarah,0,0,15,15
1746589614509,EDS 289C,A01,895770,Daly; Alan J.,1,0,15,14
1746589615535,EDS 290,A00,897211,Hofstetter; Carolyn,0,0,15,15
1746589616561,LIGM 5A,A00,896162,Fischer-Grunski; Eva K,12,0,20,8
1746589617589,LIGM 5B,A00,896260,Fischer-Grunski; Eva K,17,0,20,3
1746589618615,LIGM 5C,A00,896308,Fischer-Grunski; Eva K,18,0,20,2
1746589619644,LIIT 5AS,A00,896313,Carnelos; Chiara,18,0,20,2
1746589620674,LIIT 5BS,A00,896416,Carnelos; Chiara,20,0,20,0
1746589621701,LIIT 5CS,A00,896564,Carnelos; Chiara,20,0,20,0
1746589622735,LISP 5A,A00,896588,Munoz Sanchez; Alicia,2,0,20,18
1746589623761,LISP 5B,A00,896653,Munoz Sanchez; Alicia,7,0,20,13
1746589624788,LISP 5C,A00,896655,Munoz Sanchez; Alicia,0,1,20,20
1746589625813,MAE 197,001,957918,Kleissl; Jan,9996,0,9999,3
1746589625813,MAE 197,002,959806,Boechler; Nicholas Sebastia,9998,0,9999,1
1746589625813,MAE 197,003,959852,Mullin; Jennifer S,9998,0,9999,1
1746589626839,MATH 2,A01,957937,Staff,33,0,35,2
1746589627867,MATH 197,001,957876,Kedlaya; Kiran S.,9993,0,9999,6
1746589628892,MCWP 40,A00,892729,Duru; Nur,10,0,20,10
1746589628892,MCWP 40,B00,893304,Montejo; Carolina,14,0,20,6
1746589629920,MCWP 40R,A00,893757,Redela; Pamela Morgan,0,5,20,20
1746589630947,MCWP 50,A00,893758,Morshed; Michael James,0,0,20,20
1746589630947,MCWP 50,B00,893761,Bartulis; Jason Michael,17,0,20,3
1746589631974,MCWP 50R,A00,893766,Compas; Sean Matthew,0,1,20,20
1746589631974,MCWP 50R,B00,893769,Carter; Jennifer A,0,1,20,20
1746589631974,MCWP 50R,C00,893771,Krone; Jarret,0,3,20,20
1746589631974,MCWP 50R,D00,893772,Miller; Elizabeth Deen,0,0,20,20
1746589631974,MCWP 50R,E00,893775,Carter; Andrea L,0,1,20,20
1746589633002,MMW 11R,A01,892721,Herbst; Matthew,14,0,30,16
1746589633002,MMW 11R,A02,892722,Herbst; Matthew,0,0,0,3
1746589634030,MMW 12R,A01,892724,Herbst; Matthew,0,11,16,16
1746589634030,MMW 12R,A02,892725,Herbst; Matthew,0,10,16,16
1746589635055,MMW 13R,A01,892727,Staff,0,4,16,16
1746589635055,MMW 13R,A02,892728,Staff,0,4,16,16
1746589635055,MMW 13R,A03,958032,Staff,0,4,16,16
1746589635055,MMW 13R,A04,958033,Staff,0,4,16,16
1746589635055,MMW 13R,A05,958034,Staff,0,4,16,16
1746589636080,SIO 295LS,A00,894015,Staff,5,0,25,20
1746589637107,SIO 295S,A00,894020,Staff,5,0,25,20
1746589638133,SIOC 290S,B01,958918,Merrifield; Mark A,14,0,30,16
1746589639158,SIOC 291S,B01,958922,Gabriel; Corey John,14,0,30,16
1746589640187,SOCI 117,A01,895339,Staff,3,0,5,2
1746589641214,WES 237B,A00,894149,Staff,11,0,20,9
1746589643273,AESE 279B,A00,891859,Staff,13,0,35,22
1746589644300,AIP 197,001,891854,Vespa; Emanuel Ignacio,9999,0,9999,0
1746589645328,ANTH 289S,A00,891856,Gagneux; Pascal,12,0,12,0
1746589646357,BENG 196,001,957946,Engler; Adam J.,9996,0,9999,3
1746589647384,BISP 197,001,959851,Wilhelm; James E.,9998,0,9999,1
1746589648409,CAT 124RS,A01,956906,Staff,6,0,25,19
1746589649434,CAT 125RS,A01,922013,Staff,6,0,25,19
1746589650459,CLRE 250,A00,891860,Morris; Sheldon,9995,0,9999,4
1746589652513,CLRE 251R,A00,907817,Mehta; Ravindra L.,9994,0,9999,5
1746589653538,CLRE 252,A00,891864,Cuomo; Raphael Eduardo,9993,0,9999,6
1746589654562,CLRE 253,A00,891867,Vaida; Florin,9994,0,9999,5
1746589654562,CLRE 253,B00,907819,Staff,9999,0,9999,0
1746589655587,CLRE 259,A00,891868,Patel; Hemal,9998,0,9999,1
1746589656612,CLRE 260,A00,891872,Cuomo; Raphael Eduardo,9999,0,9999,0
1746589657638,CLRE 297,001,891888,Cuomo; Raphael Eduardo,9999,0,9999,0
1746589658664,CSE 191,A00,958773,Minnes Kemp; Mor Mia,9995,0,9999,4
1746589659695,CSE 197,001,959846,Minnes Kemp; Mor Mia,9990,0,9999,9
1746589660724,CSS 201S,A01,892054,Mignozzetti; Umberto,25,0,30,5
1746589661752,CSS 202S,A01,892056,Mignozzetti; Umberto,25,0,30,5
1746589662778,DSC 197,001,956898,Eldridge; Justin Matthew,9996,0,9999,3
1746589663806,DSC 297,001,958000,Mazumdar; Arya,9998,0,9999,1
1746589663806,DSC 297,002,959862,Wang; Yusu,9998,0,9999,1
1746589664831,EAP 100,A00,905686,Staff,9778,0,9999,221
1746589665860,ECE 45,A01,892618,Staff,0,0,65,65
1746589667911,ECE 111,A01,892719,Staff,6,0,65,59
1746589668939,ECE 197,001,957920,Mercier; Patrick Philip,9991,0,9999,8
1746589669968,ECON 178,A01,907814,Zhu; Ying,26,0,35,9
1746589670993,EDS 115,A00,895312,Staff,35,0,45,10
1746589672018,EDS 117,A01,895337,Staff,23,0,30,7
1746589673043,EDS 125,A00,895341,Jones; Gabrielle Anastasia,36,0,45,9
1746589674069,EDS 128A,A01,895459,Fargason; Sharon Gayle,44,0,45,1
1746589675098,EDS 128B,A01,895543,Pappas; Elizabeth,44,0,45,1
1746589676123,EDS 139,A00,897203,Pappas; Elizabeth,44,0,45,1
1746589676123,EDS 139,B00,897209,Fargason; Sharon Gayle,41,0,45,4
1746589677148,EDS 201,A00,895545,Staff,22,0,45,23
1746589678174,EDS 203,A01,895581,Halter; Christopher P.,22,0,45,23
1746589679202,EDS 204R,A01,895625,Heinzman; Erica M.,39,0,45,6
1746589679202,EDS 204R,B01,895693,Halter; Christopher P.,10,0,45,35
1746589680287,EDS 206R,A00,895694,Fargason; Sharon Gayle,1,0,30,29
1746589680287,EDS 206R,B00,895695,Choi; Bailey Miyeon,16,0,30,14
1746589681313,EDS 250,A00,895697,Hemans; Patricia Ann Benitez,22,0,45,23
1746589682344,EDS 281,A00,895701,Meyerott; Theresa Ann,1,0,15,14
1746589683371,EDS 284,A00,895736,Meyerott; Theresa Ann,1,0,15,14
1746589684394,EDS 286,A00,897210,Fine; Sarah,0,0,15,15
1746589685420,EDS 289C,A01,895770,Daly; Alan J.,1,0,15,14
1746589686446,EDS 290,A00,897211,Hofstetter; Carolyn,0,0,15,15
1746589687524,LIGM 5A,A00,896162,Fischer-Grunski; Eva K,12,0,20,8
1746589688552,LIGM 5B,A00,896260,Fischer-Grunski; Eva K,17,0,20,3
1746589689578,LIGM 5C,A00,896308,Fischer-Grunski; Eva K,18,0,20,2
1746589690604,LIIT 5AS,A00,896313,Carnelos; Chiara,18,0,20,2
1746589691629,LIIT 5BS,A00,896416,Carnelos; Chiara,20,0,20,0
1746589692662,LIIT 5CS,A00,896564,Carnelos; Chiara,20,0,20,0
1746589693687,LISP 5A,A00,896588,Munoz Sanchez; Alicia,2,0,20,18
1746589694714,LISP 5B,A00,896653,Munoz Sanchez; Alicia,7,0,20,13
1746589695744,LISP 5C,A00,896655,Munoz Sanchez; Alicia,0,1,20,20
1746589696768,MAE 197,001,957918,Kleissl; Jan,9996,0,9999,3
1746589696768,MAE 197,002,959806,Boechler; Nicholas Sebastia,9998,0,9999,1
1746589696768,MAE 197,003,959852,Mullin; Jennifer S,9998,0,9999,1
1746589697795,MATH 2,A01,957937,Staff,33,0,35,2
1746589698819,MATH 197,001,957876,Kedlaya; Kiran S.,9993,0,9999,6
1746589699845,MCWP 40,A00,892729,Duru; Nur,10,0,20,10
1746589699845,MCWP 40,B00,893304,Montejo; Carolina,14,0,20,6
1746589700873,MCWP 40R,A00,893757,Redela; Pamela Morgan,0,5,20,20
1746589701901,MCWP 50,A00,893758,Morshed; Michael James,0,0,20,20
1746589701901,MCWP 50,B00,893761,Bartulis; Jason Michael,17,0,20,3
1746589702928,MCWP 50R,A00,893766,Compas; Sean Matthew,0,1,20,20
1746589702928,MCWP 50R,B00,893769,Carter; Jennifer A,0,1,20,20
1746589702928,MCWP 50R,C00,893771,Krone; Jarret,0,3,20,20
1746589702928,MCWP 50R,D00,893772,Miller; Elizabeth Deen,0,0,20,20
1746589702928,MCWP 50R,E00,893775,Carter; Andrea L,0,1,20,20
1746589703954,MMW 11R,A01,892721,Herbst; Matthew,14,0,30,16
1746589703954,MMW 11R,A02,892722,Herbst; Matthew,0,0,0,3
1746589704980,MMW 12R,A01,892724,Herbst; Matthew,0,11,16,16
1746589704980,MMW 12R,A02,892725,Herbst; Matthew,0,10,16,16
1746589706007,MMW 13R,A01,892727,Staff,0,4,16,16
1746589706007,MMW 13R,A02,892728,Staff,0,4,16,16
1746589706007,MMW 13R,A03,958032,Staff,0,4,16,16
1746589706007,MMW 13R,A04,958033,Staff,0,4,16,16
1746589706007,MMW 13R,A05,958034,Staff,0,4,16,16
1746589707032,SIO 295LS,A00,894015,Staff,5,0,25,20
1746589708061,SIO 295S,A00,894020,Staff,5,0,25,20
1746589709091,SIOC 290S,B01,958918,Merrifield; Mark A,14,0,30,16
1746589710121,SIOC 291S,B01,958922,Gabriel; Corey John,14,0,30,16
1746589711149,SOCI 117,A01,895339,Staff,3,0,5,2
1746589712176,WES 237B,A00,894149,Staff,11,0,20,9
1746589714238,AESE 279B,A00,891859,Staff,13,0,35,22
1746589715267,AIP 197,001,891854,Vespa; Emanuel Ignacio,9999,0,9999,0
1746589716295,ANTH 289S,A00,891856,Gagneux; Pascal,12,0,12,0
1746589717322,BENG 196,001,957946,Engler; Adam J.,9996,0,9999,3
1746589718347,BISP 197,001,959851,Wilhelm; James E.,9998,0,9999,1
1746589719376,CAT 124RS,A01,956906,Staff,6,0,25,19
1746589720400,CAT 125RS,A01,922013,Staff,6,0,25,19
1746589721427,CLRE 250,A00,891860,Morris; Sheldon,9995,0,9999,4
1746589723485,CLRE 251R,A00,907817,Mehta; Ravindra L.,9994,0,9999,5
1746589724513,CLRE 252,A00,891864,Cuomo; Raphael Eduardo,9993,0,9999,6
1746589725543,CLRE 253,A00,891867,Vaida; Florin,9994,0,9999,5
1746589725543,CLRE 253,B00,907819,Staff,9999,0,9999,0
1746589726571,CLRE 259,A00,891868,Patel; Hemal,9998,0,9999,1
1746589727598,CLRE 260,A00,891872,Cuomo; Raphael Eduardo,9999,0,9999,0
1746589728622,CLRE 297,001,891888,Cuomo; Raphael Eduardo,9999,0,9999,0
1746589729652,CSE 191,A00,958773,Minnes Kemp; Mor Mia,9995,0,9999,4
1746589730682,CSE 197,001,959846,Minnes Kemp; Mor Mia,9990,0,9999,9
1746589731708,CSS 201S,A01,892054,Mignozzetti; Umberto,25,0,30,5
1746589732738,CSS 202S,A01,892056,Mignozzetti; Umberto,25,0,30,5
1746589733766,DSC 197,001,956898,Eldridge; Justin Matthew,9996,0,9999,3
1746589734790,DSC 297,001,958000,Mazumdar; Arya,9998,0,9999,1
1746589734790,DSC 297,002,959862,Wang; Yusu,9998,0,9999,1
1746589735819,EAP 100,A00,905686,Staff,9778,0,9999,221
1746589736846,ECE 45,A01,892618,Staff,0,0,65,65
1746589738907,ECE 111,A01,892719,Staff,6,0,65,59
1746589739935,ECE 197,001,957920,Mercier; Patrick Philip,9991,0,9999,8
1746589740963,ECON 178,A01,907814,Zhu; Ying,26,0,35,9
1746589741989,EDS 115,A00,895312,Staff,35,0,45,10
1746589743017,EDS 117,A01,895337,Staff,23,0,30,7
1746589744043,EDS 125,A00,895341,Jones; Gabrielle Anastasia,36,0,45,9
1746589745070,EDS 128A,A01,895459,Fargason; Sharon Gayle,44,0,45,1
1746589746099,EDS 128B,A01,895543,Pappas; Elizabeth,44,0,45,1
1746589747125,EDS 139,A00,897203,Pappas; Elizabeth,44,0,45,1
1746589747125,EDS 139,B00,897209,Fargason; Sharon Gayle,41,0,45,4
1746589748152,EDS 201,A00,895545,Staff,22,0,45,23
1746589749181,EDS 203,A01,895581,Halter; Christopher P.,22,0,45,23
1746589750207,EDS 204R,A01,895625,Heinzman; Erica M.,39,0,45,6
1746589750207,EDS 204R,B01,895693,Halter; Christopher P.,10,0,45,35
1746589751232,EDS 206R,A00,895694,Fargason; Sharon Gayle,1,0,30,29
1746589751232,EDS 206R,B00,895695,Choi; Bailey Miyeon,16,0,30,14
1746589752256,EDS 250,A00,895697,Hemans; Patricia Ann Benitez,22,0,45,23
1746589753283,EDS 281,A00,895701,Meyerott; Theresa Ann,1,0,15,14
1746589754313,EDS 284,A00,895736,Meyerott; Theresa Ann,1,0,15,14
1746589755341,EDS 286,A00,897210,Fine; Sarah,0,0,15,15
1746589756364,EDS 289C,A01,895770,Daly; Alan J.,1,0,15,14
1746589757393,EDS 290,A00,897211,Hofstetter; Carolyn,0,0,15,15
1746589758419,LIGM 5A,A00,896162,Fischer-Grunski; Eva K,12,0,20,8
1746589759448,LIGM 5B,A00,896260,Fischer-Grunski; Eva K,17,0,20,3
1746589760479,LIGM 5C,A00,896308,Fischer-Grunski; Eva K,18,0,20,2
1746589761508,LIIT 5AS,A00,896313,Carnelos; Chiara,18,0,20,2
1746589762535,LIIT 5BS,A00,896416,Carnelos; Chiara,20,0,20,0
1746589763560,LIIT 5CS,A00,896564,Carnelos; Chiara,20,0,20,0
1746589764590,LISP 5A,A00,896588,Munoz Sanchez; Alicia,2,0,20,18
1746589765615,LISP 5B,A00,896653,Munoz Sanchez; Alicia,7,0,20,13
1746589766644,LISP 5C,A00,896655,Munoz Sanchez; Alicia,0,1,20,20
1746589767676,MAE 197,001,957918,Kleissl; Jan,9996,0,9999,3
1746589767676,MAE 197,002,959806,Boechler; Nicholas Sebastia,9998,0,9999,1
1746589767676,MAE 197,003,959852,Mullin; Jennifer S,9998,0,9999,1
1746589768701,MATH 2,A01,957937,Staff,33,0,35,2
1746589769731,MATH 197,001,957876,Kedlaya; Kiran S.,9993,0,9999,6
1746589770758,MCWP 40,A00,892729,Duru; Nur,10,0,20,10
1746589770758,MCWP 40,B00,893304,Montejo; Carolina,14,0,20,6
1746589771784,MCWP 40R,A00,893757,Redela; Pamela Morgan,0,5,20,20
1746589772810,MCWP 50,A00,893758,Morshed; Michael James,0,0,20,20
1746589772810,MCWP 50,B00,893761,Bartulis; Jason Michael,17,0,20,3
1746589773839,MCWP 50R,A00,893766,Compas; Sean Matthew,0,1,20,20
1746589773839,MCWP 50R,B00,893769,Carter; Jennifer A,0,1,20,20
1746589773839,MCWP 50R,C00,893771,Krone; Jarret,0,3,20,20
1746589773839,MCWP 50R,D00,893772,Miller; Elizabeth Deen,0,0,20,20
1746589773839,MCWP 50R,E00,893775,Carter; Andrea L,0,1,20,20
1746589774866,MMW 11R,A01,892721,Herbst; Matthew,14,0,30,16
1746589774866,MMW 11R,A02,892722,Herbst; Matthew,0,0,0,3
1746589775891,MMW 12R,A01,892724,Herbst; Matthew,0,11,16,16
1746589775891,MMW 12R,A02,892725,Herbst; Matthew,0,10,16,16
1746589776919,MMW 13R,A01,892727,Staff,0,4,16,16
1746589776919,MMW 13R,A02,892728,Staff,0,4,16,16
1746589776919,MMW 13R,A03,958032,Staff,0,4,16,16
1746589776919,MMW 13R,A04,958033,Staff,0,4,16,16
1746589776919,MMW 13R,A05,958034,Staff,0,4,16,16
1746589777962,SIO 295LS,A00,894015,Staff,5,0,25,20
1746589778992,SIO 295S,A00,894020,Staff,5,0,25,20
1746589780021,SIOC 290S,B01,958918,Merrifield; Mark A,14,0,30,16
1746589781047,SIOC 291S,B01,958922,Gabriel; Corey John,14,0,30,16
1746589782076,SOCI 117,A01,895339,Staff,3,0,5,2
1746589783101,WES 237B,A00,894149,Staff,11,0,20,9
1746589785163,AESE 279B,A00,891859,Staff,13,0,35,22
1746589786191,AIP 197,001,891854,Vespa; Emanuel Ignacio,9999,0,9999,0
1746589787220,ANTH 289S,A00,891856,Gagneux; Pascal,12,0,12,0
1746589788245,BENG 196,001,957946,Engler; Adam J.,9996,0,9999,3
1746589789270,BISP 197,001,959851,Wilhelm; James E.,9998,0,9999,1
1746589790296,CAT 124RS,A01,956906,Staff,6,0,25,19
1746589791322,CAT 125RS,A01,922013,Staff,6,0,25,19
1746589792350,CLRE 250,A00,891860,Morris; Sheldon,9995,0,9999,4
1746589794405,CLRE 251R,A00,907817,Mehta; Ravindra L.,9994,0,9999,5
1746589795433,CLRE 252,A00,891864,Cuomo; Raphael Eduardo,9993,0,9999,6
1746589796459,CLRE 253,A00,891867,Vaida; Florin,9994,0,9999,5
1746589796459,CLRE 253,B00,907819,Staff,9999,0,9999,0
1746589797484,CLRE 259,A00,891868,Patel; Hemal,9998,0,9999,1
1746589798509,CLRE 260,A00,891872,Cuomo; Raphael Eduardo,9999,0,9999,0
1746589799535,CLRE 297,001,891888,Cuomo; Raphael Eduardo,9999,0,9999,0
1746589800560,CSE 191,A00,958773,Minnes Kemp; Mor Mia,9995,0,9999,4
1746589801585,CSE 197,001,959846,Minnes Kemp; Mor Mia,9990,0,9999,9
1746589802612,CSS 201S,A01,892054,Mignozzetti; Umberto,25,0,30,5
1746589803637,CSS 202S,A01,892056,Mignozzetti; Umberto,25,0,30,5
1746589804667,DSC 197,001,956898,Eldridge; Justin Matthew,9996,0,9999,3
1746589805697,DSC 297,001,958000,Mazumdar; Arya,9998,0,9999,1
1746589805697,DSC 297,002,959862,Wang; Yusu,9998,0,9999,1
1746589806723,EAP 100,A00,905686,Staff,9778,0,9999,221
1746589807750,ECE 45,A01,892618,Staff,0,0,65,65
1746589809804,ECE 111,A01,892719,Staff,6,0,65,59
1746589810830,ECE 197,001,957920,Mercier; Patrick Philip,9991,0,9999,8
1746589811856,ECON 178,A01,907814,Zhu; Ying,26,0,35,9
1746589812887,EDS 115,A00,895312,Staff,35,0,45,10
1746589813913,EDS 117,A01,895337,Staff,23,0,30,7
1746589814939,EDS 125,A00,895341,Jones; Gabrielle Anastasia,36,0,45,9
1746589815970,EDS 128A,A01,895459,Fargason; Sharon Gayle,44,0,45,1
1746589816995,EDS 128B,A01,895543,Pappas; Elizabeth,44,0,45,1
1746589818024,EDS 139,A00,897203,Pappas; Elizabeth,44,0,45,1
1746589818024,EDS 139,B00,897209,Fargason; Sharon Gayle,41,0,45,4
1746589819051,EDS 201,A00,895545,Staff,22,0,45,23
1746589820077,EDS 203,A01,895581,Halter; Christopher P.,22,0,45,23
1746589821107,EDS 204R,A01,895625,Heinzman; Erica M.,39,0,45,6
1746589821107,EDS 204R,B01,895693,Halter; Christopher P.,10,0,45,35
1746589822136,EDS 206R,A00,895694,Fargason; Sharon Gayle,1,0,30,29
1746589822136,EDS 206R,B00,895695,Choi; Bailey Miyeon,16,0,30,14
1746589823162,EDS 250,A00,895697,Hemans; Patricia Ann Benitez,22,0,45,23
1746589824190,EDS 281,A00,895701,Meyerott; Theresa Ann,1,0,15,14
1746589825214,EDS 284,A00,895736,Meyerott; Theresa Ann,1,0,15,14
1746589826242,EDS 286,A00,897210,Fine; Sarah,0,0,15,15
1746589827271,EDS 289C,A01,895770,Daly; Alan J.,1,0,15,14
1746589828297,EDS 290,A00,897211,Hofstetter; Carolyn,0,0,15,15
1746589829323,LIGM 5A,A00,896162,Fischer-Grunski; Eva K,12,0,20,8
1746589830349,LIGM 5B,A00,896260,Fischer-Grunski; Eva K,17,0,20,3
1746589831374,LIGM 5C,A00,896308,Fischer-Grunski; Eva K,18,0,20,2
1746589832399,LIIT 5AS,A00,896313,Carnelos; Chiara,18,0,20,2
1746589833428,LIIT 5BS,A00,896416,Carnelos; Chiara,20,0,20,0
1746589834453,LIIT 5CS,A00,896564,Carnelos; Chiara,20,0,20,0
1746589835483,LISP 5A,A00,896588,Munoz Sanchez; Alicia,2,0,20,18
1746589836508,LISP 5B,A00,896653,Munoz Sanchez; Alicia,7,0,20,13
1746589837535,LISP 5C,A00,896655,Munoz Sanchez; Alicia,0,1,20,20
1746589838560,MAE 197,001,957918,Kleissl; Jan,9996,0,9999,3
1746589838560,MAE 197,002,959806,Boechler; Nicholas Sebastia,9998,0,9999,1
1746589838560,MAE 197,003,959852,Mullin; Jennifer S,9998,0,9999,1
1746589839586,MATH 2,A01,957937,Staff,33,0,35,2
1746589840614,MATH 197,001,957876,Kedlaya; Kiran S.,9993,0,9999,6
1746589841644,MCWP 40,A00,892729,Duru; Nur,10,0,20,10
1746589841644,MCWP 40,B00,893304,Montejo; Carolina,14,0,20,6
1746589842670,MCWP 40R,A00,893757,Redela; Pamela Morgan,0,5,20,20
1746589843701,MCWP 50,A00,893758,Morshed; Michael James,0,0,20,20
1746589843701,MCWP 50,B00,893761,Bartulis; Jason Michael,17,0,20,3
1746589844727,MCWP 50R,A00,893766,Compas; Sean Matthew,0,1,20,20
1746589844727,MCWP 50R,B00,893769,Carter; Jennifer A,0,1,20,20
1746589844727,MCWP 50R,C00,893771,Krone; Jarret,0,3,20,20
1746589844727,MCWP 50R,D00,893772,Miller; Elizabeth Deen,0,0,20,20
1746589844727,MCWP 50R,E00,893775,Carter; Andrea L,0,1,20,20
1746589845755,MMW 11R,A01,892721,Herbst; Matthew,14,0,30,16
1746589845755,MMW 11R,A02,892722,Herbst; Matthew,0,0,0,3
1746589846784,MMW 12R,A01,892724,Herbst; Matthew,0,11,16,16
1746589846784,MMW 12R,A02,892725,Herbst; Matthew,0,10,16,16
1746589847811,MMW 13R,A01,892727,Staff,0,4,16,16
1746589847811,MMW 13R,A02,892728,Staff,0,4,16,16
1746589847811,MMW 13R,A03,958032,Staff,0,4,16,16
1746589847811,MMW 13R,A04,958033,Staff,0,4,16,16
1746589847811,MMW 13R,A05,958034,Staff,0,4,16,16
1746589848841,SIO 295LS,A00,894015,Staff,5,0,25,20
1746589849868,SIO 295S,A00,894020,Staff,5,0,25,20
1746589850897,SIOC 290S,B01,958918,Merrifield; Mark A,14,0,30,16
1746589851922,SIOC 291S,B01,958922,Gabriel; Corey John,14,0,30,16
1746589852945,SOCI 117,A01,895339,Staff,3,0,5,2
1746589853971,WES 237B,A00,894149,Staff,11,0,20,9
1746589856029,AESE 279B,A00,891859,Staff,13,0,35,22
1746589857059,AIP 197,001,891854,Vespa; Emanuel Ignacio,9999,0,9999,0
1746589858083,ANTH 289S,A00,891856,Gagneux; Pascal,12,0,12,0
1746589859107,BENG 196,001,957946,Engler; Adam J.,9996,0,9999,3
1746589860135,BISP 197,001,959851,Wilhelm; James E.,9998,0,9999,1
1746589861162,CAT 124RS,A01,956906,Staff,6,0,25,19
1746589862192,CAT 125RS,A01,922013,Staff,6,0,25,19
1746589863222,CLRE 250,A00,891860,Morris; Sheldon,9995,0,9999,4
1746589865281,CLRE 251R,A00,907817,Mehta; Ravindra L.,9994,0,9999,5
1746589866307,CLRE 252,A00,891864,Cuomo; Raphael Eduardo,9993,0,9999,6
1746589867331,CLRE 253,A00,891867,Vaida; Florin,9994,0,9999,5
1746589867331,CLRE 253,B00,907819,Staff,9999,0,9999,0
1746589868357,CLRE 259,A00,891868,Patel; Hemal,9998,0,9999,1
1746589869381,CLRE 260,A00,891872,Cuomo; Raphael Eduardo,9999,0,9999,0
1746589870405,CLRE 297,001,891888,Cuomo; Raphael Eduardo,9999,0,9999,0
1746589871433,CSE 191,A00,958773,Minnes Kemp; Mor Mia,9995,0,9999,4
1746589872461,CSE 197,001,959846,Minnes Kemp; Mor Mia,9990,0,9999,9
1746589873487,CSS 201S,A01,892054,Mignozzetti; Umberto,25,0,30,5
1746589874515,CSS 202S,A01,892056,Mignozzetti; Umberto,25,0,30,5
1746589875543,DSC 197,001,956898,Eldridge; Justin Matthew,9996,0,9999,3
1746589876569,DSC 297,001,958000,Mazumdar; Arya,9998,0,9999,1
1746589876569,DSC 297,002,959862,Wang; Yusu,9998,0,9999,1
1746589877595,EAP 100,A00,905686,Staff,9778,0,9999,221
1746589878622,ECE 45,A01,892618,Staff,0,0,65,65
1746589880674,ECE 111,A01,892719,Staff,6,0,65,59
1746589881703,ECE 197,001,957920,Mercier; Patrick Philip,9991,0,9999,8
1746589882732,ECON 178,A01,907814,Zhu; Ying,26,0,35,9
1746589883764,EDS 115,A00,895312,Staff,35,0,45,10
1746589884792,EDS 117,A01,895337,Staff,23,0,30,7
1746589885820,EDS 125,A00,895341,Jones; Gabrielle Anastasia,36,0,45,9
1746589886846,EDS 128A,A01,895459,Fargason; Sharon Gayle,44,0,45,1
1746589887875,EDS 128B,A01,895543,Pappas; Elizabeth,44,0,45,1
1746589888902,EDS 139,A00,897203,Pappas; Elizabeth,44,0,45,1
1746589888902,EDS 139,B00,897209,Fargason; Sharon Gayle,41,0,45,4
1746589889927,EDS 201,A00,895545,Staff,22,0,45,23
1746589890952,EDS 203,A01,895581,Halter; Christopher P.,22,0,45,23
1746589891978,EDS 204R,A01,895625,Heinzman; Erica M.,39,0,45,6
1746589891978,EDS 204R,B01,895693,Halter; Christopher P.,10,0,45,35
1746589893004,EDS 206R,A00,895694,Fargason; Sharon Gayle,1,0,30,29
1746589893004,EDS 206R,B00,895695,Choi; Bailey Miyeon,16,0,30,14
1746589894028,EDS 250,A00,895697,Hemans; Patricia Ann Benitez,22,0,45,23
1746589895057,EDS 281,A00,895701,Meyerott; Theresa Ann,1,0,15,14
1746589896085,EDS 284,A00,895736,Meyerott; Theresa Ann,1,0,15,14
1746589897109,EDS 286,A00,897210,Fine; Sarah,0,0,15,15
1746589898137,EDS 289C,A01,895770,Daly; Alan J.,1,0,15,14
1746589899166,EDS 290,A00,897211,Hofstetter; Carolyn,0,0,15,15
1746589900191,LIGM 5A,A00,896162,Fischer-Grunski; Eva K,12,0,20,8
1746589901215,LIGM 5B,A00,896260,Fischer-Grunski; Eva K,17,0,20,3
1746589902245,LIGM 5C,A00,896308,Fischer-Grunski; Eva K,18,0,20,2
1746589903273,LIIT 5AS,A00,896313,Carnelos; Chiara,18,0,20,2
1746589904303,LIIT 5BS,A00,896416,Carnelos; Chiara,20,0,20,0
1746589905331,LIIT 5CS,A00,896564,Carnelos; Chiara,20,0,20,0
1746589906359,LISP 5A,A00,896588,Munoz Sanchez; Alicia,2,0,20,18
1746589907385,LISP 5B,A00,896653,Munoz Sanchez; Alicia,7,0,20,13
1746589908410,LISP 5C,A00,896655,Munoz Sanchez; Alicia,0,1,20,20
1746589909434,MAE 197,001,957918,Kleissl; Jan,9996,0,9999,3
1746589909434,MAE 197,002,959806,Boechler; Nicholas Sebastia,9998,0,9999,1
1746589909434,MAE 197,003,959852,Mullin; Jennifer S,9998,0,9999,1
1746589910462,MATH 2,A01,957937,Staff,33,0,35,2
1746589911490,MATH 197,001,957876,Kedlaya; Kiran S.,9993,0,9999,6
1746589912521,MCWP 40,A00,892729,Duru; Nur,10,0,20,10
1746589912521,MCWP 40,B00,893304,Montejo; Carolina,14,0,20,6
1746589913547,MCWP 40R,A00,893757,Redela; Pamela Morgan,0,5,20,20
1746589914574,MCWP 50,A00,893758,Morshed; Michael James,0,0,20,20
1746589914574,MCWP 50,B00,893761,Bartulis; Jason Michael,17,0,20,3
1746589915600,MCWP 50R,A00,893766,Compas; Sean Matthew,0,1,20,20
1746589915600,MCWP 50R,B00,893769,Carter; Jennifer A,0,1,20,20
1746589915600,MCWP 50R,C00,893771,Krone; Jarret,0,3,20,20
1746589915600,MCWP 50R,D00,893772,Miller; Elizabeth Deen,0,0,20,20
1746589915600,MCWP 50R,E00,893775,Carter; Andrea L,0,1,20,20
1746589916629,MMW 11R,A01,892721,Herbst; Matthew,14,0,30,16
1746589916629,MMW 11R,A02,892722,Herbst; Matthew,0,0,0,3
1746589917653,MMW 12R,A01,892724,Herbst; Matthew,0,11,16,16
1746589917653,MMW 12R,A02,892725,Herbst; Matthew,0,10,16,16
1746589918677,MMW 13R,A01,892727,Staff,0,4,16,16
1746589918677,MMW 13R,A02,892728,Staff,0,4,16,16
1746589918677,MMW 13R,A03,958032,Staff,0,4,16,16
1746589918677,MMW 13R,A04,958033,Staff,0,4,16,16
1746589918677,MMW 13R,A05,958034,Staff,0,4,16,16
1746589919704,SIO 295LS,A00,894015,Staff,5,0,25,20
1746589920729,SIO 295S,A00,894020,Staff,5,0,25,20
1746589921760,SIOC 290S,B01,958918,Merrifield; Mark A,14,0,30,16
1746589922792,SIOC 291S,B01,958922,Gabriel; Corey John,14,0,30,16
1746589923820,SOCI 117,A01,895339,Staff,3,0,5,2
1746589924846,WES 237B,A00,894149,Staff,11,0,20,9
1746589926914,AESE 279B,A00,891859,Staff,13,0,35,22
1746589927940,AIP 197,001,891854,Vespa; Emanuel Ignacio,9999,0,9999,0
1746589928966,ANTH 289S,A00,891856,Gagneux; Pascal,12,0,12,0
1746589929993,BENG 196,001,957946,Engler; Adam J.,9996,0,9999,3
1746589931018,BISP 197,001,959851,Wilhelm; James E.,9998,0,9999,1
1746589932045,CAT 124RS,A01,956906,Staff,6,0,25,19
1746589933070,CAT 125RS,A01,922013,Staff,6,0,25,19
1746589934095,CLRE 250,A00,891860,Morris; Sheldon,9995,0,9999,4
1746589936146,CLRE 251R,A00,907817,Mehta; Ravindra L.,9994,0,9999,5
1746589937173,CLRE 252,A00,891864,Cuomo; Raphael Eduardo,9993,0,9999,6
1746589938203,CLRE 253,A00,891867,Vaida; Florin,9994,0,9999,5
1746589938203,CLRE 253,B00,907819,Staff,9999,0,9999,0
1746589939232,CLRE 259,A00,891868,Patel; Hemal,9998,0,9999,1
1746589940257,CLRE 260,A00,891872,Cuomo; Raphael Eduardo,9999,0,9999,0
1746589941284,CLRE 297,001,891888,Cuomo; Raphael Eduardo,9999,0,9999,0
1746589942309,CSE 191,A00,958773,Minnes Kemp; Mor Mia,9995,0,9999,4
1746589943335,CSE 197,001,959846,Minnes Kemp; Mor Mia,9990,0,9999,9
1746589944363,CSS 201S,A01,892054,Mignozzetti; Umberto,25,0,30,5
1746589945388,CSS 202S,A01,892056,Mignozzetti; Umberto,25,0,30,5
1746589946414,DSC 197,001,956898,Eldridge; Justin Matthew,9996,0,9999,3
1746589947440,DSC 297,001,958000,Mazumdar; Arya,9998,0,9999,1
1746589947440,DSC 297,002,959862,Wang; Yusu,9998,0,9999,1
1746589948466,EAP 100,A00,905686,Staff,9778,0,9999,221
1746589949496,ECE 45,A01,892618,Staff,0,0,65,65
1746589951547,ECE 111,A01,892719,Staff,6,0,65,59
1746589952574,ECE 197,001,957920,Mercier; Patrick Philip,9991,0,9999,8
1746589953602,ECON 178,A01,907814,Zhu; Ying,26,0,35,9
1746589954629,EDS 115,A00,895312,Staff,35,0,45,10
1746589955659,EDS 117,A01,895337,Staff,23,0,30,7
1746589956683,EDS 125,A00,895341,Jones; Gabrielle Anastasia,36,0,45,9
1746589957712,EDS 128A,A01,895459,Fargason; Sharon Gayle,44,0,45,1
1746589958736,EDS 128B,A01,895543,Pappas; Elizabeth,44,0,45,1
1746589959760,EDS 139,A00,897203,Pappas; Elizabeth,44,0,45,1
1746589959760,EDS 139,B00,897209,Fargason; Sharon Gayle,41,0,45,4
1746589960790,EDS 201,A00,895545,Staff,22,0,45,23
1746589961819,EDS 203,A01,895581,Halter; Christopher P.,22,0,45,23
1746589962847,EDS 204R,A01,895625,Heinzman; Erica M.,39,0,45,6
1746589962847,EDS 204R,B01,895693,Halter; Christopher P.,10,0,45,35
1746589963874,EDS 206R,A00,895694,Fargason; Sharon Gayle,1,0,30,29
1746589963874,EDS 206R,B00,895695,Choi; Bailey Miyeon,16,0,30,14
1746589964900,EDS 250,A00,895697,Hemans; Patricia Ann Benitez,22,0,45,23
1746589965925,EDS 281,A00,895701,Meyerott; Theresa Ann,1,0,15,14
1746589966952,EDS 284,A00,895736,Meyerott; Theresa Ann,1,0,15,14
1746589967979,EDS 286,A00,897210,Fine; Sarah,0,0,15,15
1746589969004,EDS 289C,A01,895770,Daly; Alan J.,1,0,15,14
1746589970031,EDS 290,A00,897211,Hofstetter; Carolyn,0,0,15,15
1746589971056,LIGM 5A,A00,896162,Fischer-Grunski; Eva K,12,0,20,8
1746589972082,LIGM 5B,A00,896260,Fischer-Grunski; Eva K,17,0,20,3
1746589973113,LIGM 5C,A00,896308,Fischer-Grunski; Eva K,18,0,20,2
1746589974137,LIIT 5AS,A00,896313,Carnelos; Chiara,18,0,20,2
1746589975163,LIIT 5BS,A00,896416,Carnelos; Chiara,20,0,20,0
1746589976190,LIIT 5CS,A00,896564,Carnelos; Chiara,20,0,20,0
1746589977217,LISP 5A,A00,896588,Munoz Sanchez; Alicia,2,0,20,18
1746589978248,LISP 5B,A00,896653,Munoz Sanchez; Alicia,7,0,20,13
1746589979295,LISP 5C,A00,896655,Munoz Sanchez; Alicia,0,1,20,20
1746589980324,MAE 197,001,957918,Kleissl; Jan,9996,0,9999,3
1746589980324,MAE 197,002,959806,Boechler; Nicholas Sebastia,9998,0,9999,1
1746589980324,MAE 197,003,959852,Mullin; Jennifer S,9998,0,9999,1
1746589981351,MATH 2,A01,957937,Staff,33,0,35,2
1746589982377,MATH 197,001,957876,Kedlaya; Kiran S.,9993,0,9999,6
1746589983405,MCWP 40,A00,892729,Duru; Nur,10,0,20,10
1746589983405,MCWP 40,B00,893304,Montejo; Carolina,14,0,20,6
1746589984429,MCWP 40R,A00,893757,Redela; Pamela Morgan,0,5,20,20
1746589985453,MCWP 50,A00,893758,Morshed; Michael James,0,0,20,20
1746589985453,MCWP 50,B00,893761,Bartulis; Jason Michael,17,0,20,3
1746589986479,MCWP 50R,A00,893766,Compas; Sean Matthew,0,1,20,20
1746589986479,MCWP 50R,B00,893769,Carter; Jennifer A,0,1,20,20
1746589986479,MCWP 50R,C00,893771,Krone; Jarret,0,3,20,20
1746589986479,MCWP 50R,D00,893772,Miller; Elizabeth Deen,0,0,20,20
1746589986479,MCWP 50R,E00,893775,Carter; Andrea L,0,1,20,20
1746589987508,MMW 11R,A01,892721,Herbst; Matthew,14,0,30,16
1746589987508,MMW 11R,A02,892722,Herbst; Matthew,0,0,0,3
1746589988533,MMW 12R,A01,892724,Herbst; Matthew,0,11,16,16
1746589988533,MMW 12R,A02,892725,Herbst; Matthew,0,10,16,16
1746589989563,MMW 13R,A01,892727,Staff,0,4,16,16
1746589989563,MMW 13R,A02,892728,Staff,0,4,16,16
1746589989563,MMW 13R,A03,958032,Staff,0,4,16,16
1746589989563,MMW 13R,A04,958033,Staff,0,4,16,16
1746589989563,MMW 13R,A05,958034,Staff,0,4,16,16
1746589990589,SIO 295LS,A00,894015,Staff,5,0,25,20
1746589991614,SIO 295S,A00,894020,Staff,5,0,25,20
1746589992639,SIOC 290S,B01,958918,Merrifield; Mark A,14,0,30,16
1746589993665,SIOC 291S,B01,958922,Gabriel; Corey John,14,0,30,16
1746589994691,SOCI 117,A01,895339,Staff,3,0,5,2
1746589995719,WES 237B,A00,894149,Staff,11,0,20,9
1746589997779,AESE 279B,A00,891859,Staff,13,0,35,22
1746589998806,AIP 197,001,891854,Vespa; Emanuel Ignacio,9999,0,9999,0
1746589999833,ANTH 289S,A00,891856,Gagneux; Pascal,12,0,12,0
1746590000864,BENG 196,001,957946,Engler; Adam J.,9996,0,9999,3
1746590001889,BISP 197,001,959851,Wilhelm; James E.,9998,0,9999,1
1746590002916,CAT 124RS,A01,956906,Staff,6,0,25,19
1746590003942,CAT 125RS,A01,922013,Staff,6,0,25,19
1746590004971,CLRE 250,A00,891860,Morris; Sheldon,9995,0,9999,4
1746590007024,CLRE 251R,A00,907817,Mehta; Ravindra L.,9994,0,9999,5
1746590008053,CLRE 252,A00,891864,Cuomo; Raphael Eduardo,9993,0,9999,6
1746590009081,CLRE 253,A00,891867,Vaida; Florin,9994,0,9999,5
1746590009081,CLRE 253,B00,907819,Staff,9999,0,9999,0
1746590010107,CLRE 259,A00,891868,Patel; Hemal,9998,0,9999,1
1746590011135,CLRE 260,A00,891872,Cuomo; Raphael Eduardo,9999,0,9999,0
1746590012161,CLRE 297,001,891888,Cuomo; Raphael Eduardo,9999,0,9999,0
1746590013187,CSE 191,A00,958773,Minnes Kemp; Mor Mia,9995,0,9999,4
1746590014214,CSE 197,001,959846,Minnes Kemp; Mor Mia,9990,0,9999,9
1746590015238,CSS 201S,A01,892054,Mignozzetti; Umberto,25,0,30,5
1746590016268,CSS 202S,A01,892056,Mignozzetti; Umberto,25,0,30,5
1746590017293,DSC 197,001,956898,Eldridge; Justin Matthew,9996,0,9999,3
1746590018324,DSC 297,001,958000,Mazumdar; Arya,9998,0,9999,1
1746590018324,DSC 297,002,959862,Wang; Yusu,9998,0,9999,1
1746590019349,EAP 100,A00,905686,Staff,9778,0,9999,221
1746590020375,ECE 45,A01,892618,Staff,0,0,65,65
1746590022433,ECE 111,A01,892719,Staff,6,0,65,59
1746590023460,ECE 197,001,957920,Mercier; Patrick Philip,9991,0,9999,8
1746590024507,ECON 178,A01,907814,Zhu; Ying,26,0,35,9
1746590025532,EDS 115,A00,895312,Staff,35,0,45,10
1746590026561,EDS 117,A01,895337,Staff,23,0,30,7
1746590027587,EDS 125,A00,895341,Jones; Gabrielle Anastasia,36,0,45,9
1746590028615,EDS 128A,A01,895459,Fargason; Sharon Gayle,44,0,45,1
1746590029644,EDS 128B,A01,895543,Pappas; Elizabeth,44,0,45,1
1746590030669,EDS 139,A00,897203,Pappas; Elizabeth,44,0,45,1
1746590030669,EDS 139,B00,897209,Fargason; Sharon Gayle,41,0,45,4
1746590031696,EDS 201,A00,895545,Staff,22,0,45,23
1746590032721,EDS 203,A01,895581,Halter; Christopher P.,22,0,45,23
1746590033745,EDS 204R,A01,895625,Heinzman; Erica M.,39,0,45,6
1746590033745,EDS 204R,B01,895693,Halter; Christopher P.,10,0,45,35
1746590034771,EDS 206R,A00,895694,Fargason; Sharon Gayle,1,0,30,29
1746590034771,EDS 206R,B00,895695,Choi; Bailey Miyeon,16,0,30,14
1746590035796,EDS 250,A00,895697,Hemans; Patricia Ann Benitez,22,0,45,23
1746590036821,EDS 281,A00,895701,Meyerott; Theresa Ann,1,0,15,14
1746590037845,EDS 284,A00,895736,Meyerott; Theresa Ann,1,0,15,14
1746590038873,EDS 286,A00,897210,Fine; Sarah,0,0,15,15
1746590039897,EDS 289C,A01,895770,Daly; Alan J.,1,0,15,14
1746590040921,EDS 290,A00,897211,Hofstetter; Carolyn,0,0,15,15
1746590041972,LIGM 5A,A00,896162,Fischer-Grunski; Eva K,12,0,20,8
1746590042997,LIGM 5B,A00,896260,Fischer-Grunski; Eva K,17,0,20,3
1746590044022,LIGM 5C,A00,896308,Fischer-Grunski; Eva K,18,0,20,2
1746590045050,LIIT 5AS,A00,896313,Carnelos; Chiara,18,0,20,2
1746590046074,LIIT 5BS,A00,896416,Carnelos; Chiara,20,0,20,0
1746590047100,LIIT 5CS,A00,896564,Carnelos; Chiara,20,0,20,0
1746590048144,LISP 5A,A00,896588,Munoz Sanchez; Alicia,2,0,20,18
1746590049173,LISP 5B,A00,896653,Munoz Sanchez; Alicia,7,0,20,13
1746590050202,LISP 5C,A00,896655,Munoz Sanchez; Alicia,0,1,20,20
1746590051228,MAE 197,001,957918,Kleissl; Jan,9996,0,9999,3
1746590051228,MAE 197,002,959806,Boechler; Nicholas Sebastia,9998,0,9999,1
1746590051228,MAE 197,003,959852,Mullin; Jennifer S,9998,0,9999,1
1746590052254,MATH 2,A01,957937,Staff,33,0,35,2
1746590053279,MATH 197,001,957876,Kedlaya; Kiran S.,9993,0,9999,6
1746590054304,MCWP 40,A00,892729,Duru; Nur,10,0,20,10
1746590054304,MCWP 40,B00,893304,Montejo; Carolina,14,0,20,6
1746590055332,MCWP 40R,A00,893757,Redela; Pamela Morgan,0,5,20,20
1746590056356,MCWP 50,A00,893758,Morshed; Michael James,0,0,20,20
1746590056356,MCWP 50,B00,893761,Bartulis; Jason Michael,17,0,20,3
1746590057382,MCWP 50R,A00,893766,Compas; Sean Matthew,0,1,20,20
1746590057382,MCWP 50R,B00,893769,Carter; Jennifer A,0,1,20,20
1746590057382,MCWP 50R,C00,893771,Krone; Jarret,0,3,20,20
1746590057382,MCWP 50R,D00,893772,Miller; Elizabeth Deen,0,0,20,20
1746590057382,MCWP 50R,E00,893775,Carter; Andrea L,0,1,20,20
1746590058408,MMW 11R,A01,892721,Herbst; Matthew,14,0,30,16
1746590058408,MMW 11R,A02,892722,Herbst; Matthew,0,0,0,3
1746590059434,MMW 12R,A01,892724,Herbst; Matthew,0,11,16,16
1746590059434,MMW 12R,A02,892725,Herbst; Matthew,0,10,16,16
1746590060464,MMW 13R,A01,892727,Staff,0,4,16,16
1746590060464,MMW 13R,A02,892728,Staff,0,4,16,16
1746590060464,MMW 13R,A03,958032,Staff,0,4,16,16
1746590060464,MMW 13R,A04,958033,Staff,0,4,16,16
1746590060464,MMW 13R,A05,958034,Staff,0,4,16,16
1746590061488,SIO 295LS,A00,894015,Staff,5,0,25,20
1746590062515,SIO 295S,A00,894020,Staff,5,0,25,20
1746590063541,SIOC 290S,B01,958918,Merrifield; Mark A,14,0,30,16
1746590064570,SIOC 291S,B01,958922,Gabriel; Corey John,14,0,30,16
1746590065596,SOCI 117,A01,895339,Staff,3,0,5,2
1746590066621,WES 237B,A00,894149,Staff,11,0,20,9
1746590068685,AESE 279B,A00,891859,Staff,13,0,35,22
1746590069711,AIP 197,001,891854,Vespa; Emanuel Ignacio,9999,0,9999,0
1746590070740,ANTH 289S,A00,891856,Gagneux; Pascal,12,0,12,0
1746590071765,BENG 196,001,957946,Engler; Adam J.,9996,0,9999,3
1746590072791,BISP 197,001,959851,Wilhelm; James E.,9998,0,9999,1
1746590073818,CAT 124RS,A01,956906,Staff,6,0,25,19
1746590074846,CAT 125RS,A01,922013,Staff,6,0,25,19
1746590075871,CLRE 250,A00,891860,Morris; Sheldon,9995,0,9999,4
1746590077924,CLRE 251R,A00,907817,Mehta; Ravindra L.,9994,0,9999,5
1746590078952,CLRE 252,A00,891864,Cuomo; Raphael Eduardo,9993,0,9999,6
1746590079977,CLRE 253,A00,891867,Vaida; Florin,9994,0,9999,5
1746590079977,CLRE 253,B00,907819,Staff,9999,0,9999,0
1746590081003,CLRE 259,A00,891868,Patel; Hemal,9998,0,9999,1
1746590082030,CLRE 260,A00,891872,Cuomo; Raphael Eduardo,9999,0,9999,0
1746590083057,CLRE 297,001,891888,Cuomo; Raphael Eduardo,9999,0,9999,0
1746590084081,CSE 191,A00,958773,Minnes Kemp; Mor Mia,9995,0,9999,4
1746590085145,CSE 197,001,959846,Minnes Kemp; Mor Mia,9990,0,9999,9
1746590086170,CSS 201S,A01,892054,Mignozzetti; Umberto,25,0,30,5
1746590087197,CSS 202S,A01,892056,Mignozzetti; Umberto,25,0,30,5
1746590088223,DSC 197,001,956898,Eldridge; Justin Matthew,9996,0,9999,3
1746590089248,DSC 297,001,958000,Mazumdar; Arya,9998,0,9999,1
1746590089248,DSC 297,002,959862,Wang; Yusu,9998,0,9999,1
1746590090274,EAP 100,A00,905686,Staff,9778,0,9999,221
1746590091301,ECE 45,A01,892618,Staff,0,0,65,65
1746590093351,ECE 111,A01,892719,Staff,6,0,65,59
1746590094379,ECE 197,001,957920,Mercier; Patrick Philip,9991,0,9999,8
1746590095406,ECON 178,A01,907814,Zhu; Ying,26,0,35,9
1746590096432,EDS 115,A00,895312,Staff,35,0,45,10
1746590097455,EDS 117,A01,895337,Staff,23,0,30,7
1746590098483,EDS 125,A00,895341,Jones; Gabrielle Anastasia,36,0,45,9
1746590099509,EDS 128A,A01,895459,Fargason; Sharon Gayle,44,0,45,1
1746590100535,EDS 128B,A01,895543,Pappas; Elizabeth,44,0,45,1
1746590101560,EDS 139,A00,897203,Pappas; Elizabeth,44,0,45,1
1746590101560,EDS 139,B00,897209,Fargason; Sharon Gayle,41,0,45,4
1746590102584,EDS 201,A00,895545,Staff,22,0,45,23
1746590103618,EDS 203,A01,895581,Halter; Christopher P.,22,0,45,23
1746590104649,EDS 204R,A01,895625,Heinzman; Erica M.,39,0,45,6
1746590104649,EDS 204R,B01,895693,Halter; Christopher P.,10,0,45,35
1746590105679,EDS 206R,A00,895694,Fargason; Sharon Gayle,1,0,30,29
1746590105679,EDS 206R,B00,895695,Choi; Bailey Miyeon,16,0,30,14
1746590106705,EDS 250,A00,895697,Hemans; Patricia Ann Benitez,22,0,45,23
1746590107733,EDS 281,A00,895701,Meyerott; Theresa Ann,1,0,15,14
1746590108761,EDS 284,A00,895736,Meyerott; Theresa Ann,1,0,15,14
1746590109786,EDS 286,A00,897210,Fine; Sarah,0,0,15,15
1746590110813,EDS 289C,A01,895770,Daly; Alan J.,1,0,15,14
1746590111841,EDS 290,A00,897211,Hofstetter; Carolyn,0,0,15,15
1746590112866,LIGM 5A,A00,896162,Fischer-Grunski; Eva K,12,0,20,8
1746590113895,LIGM 5B,A00,896260,Fischer-Grunski; Eva K,17,0,20,3
1746590114923,LIGM 5C,A00,896308,Fischer-Grunski; Eva K,18,0,20,2
1746590115948,LIIT 5AS,A00,896313,Carnelos; Chiara,18,0,20,2
1746590116975,LIIT 5BS,A00,896416,Carnelos; Chiara,20,0,20,0
1746590118001,LIIT 5CS,A00,896564,Carnelos; Chiara,20,0,20,0
1746590119030,LISP 5A,A00,896588,Munoz Sanchez; Alicia,2,0,20,18
1746590120054,LISP 5B,A00,896653,Munoz Sanchez; Alicia,7,0,20,13
1746590121081,LISP 5C,A00,896655,Munoz Sanchez; Alicia,0,1,20,20
1746590122107,MAE 197,001,957918,Kleissl; Jan,9996,0,9999,3
1746590122107,MAE 197,002,959806,Boechler; Nicholas Sebastia,9998,0,9999,1
1746590122107,MAE 197,003,959852,Mullin; Jennifer S,9998,0,9999,1
1746590123133,MATH 2,A01,957937,Staff,33,0,35,2
1746590124159,MATH 197,001,957876,Kedlaya; Kiran S.,9993,0,9999,6
1746590125185,MCWP 40,A00,892729,Duru; Nur,10,0,20,10
1746590125185,MCWP 40,B00,893304,Montejo; Carolina,14,0,20,6
1746590126209,MCWP 40R,A00,893757,Redela; Pamela Morgan,0,5,20,20
1746590127233,MCWP 50,A00,893758,Morshed; Michael James,0,0,20,20
1746590127233,MCWP 50,B00,893761,Bartulis; Jason Michael,17,0,20,3
1746590128258,MCWP 50R,A00,893766,Compas; Sean Matthew,0,1,20,20
1746590128258,MCWP 50R,B00,893769,Carter; Jennifer A,0,1,20,20
1746590128258,MCWP 50R,C00,893771,Krone; Jarret,0,3,20,20
1746590128258,MCWP 50R,D00,893772,Miller; Elizabeth Deen,0,0,20,20
1746590128258,MCWP 50R,E00,893775,Carter; Andrea L,0,1,20,20
1746590129282,MMW 11R,A01,892721,Herbst; Matthew,14,0,30,16
1746590129282,MMW 11R,A02,892722,Herbst; Matthew,0,0,0,3
1746590130313,MMW 12R,A01,892724,Herbst; Matthew,0,11,16,16
1746590130313,MMW 12R,A02,892725,Herbst; Matthew,0,10,16,16
1746590131339,MMW 13R,A01,892727,Staff,0,4,16,16
1746590131339,MMW 13R,A02,892728,Staff,0,4,16,16
1746590131339,MMW 13R,A03,958032,Staff,0,4,16,16
1746590131339,MMW 13R,A04,958033,Staff,0,4,16,16
1746590131339,MMW 13R,A05,958034,Staff,0,4,16,16
1746590132366,SIO 295LS,A00,894015,Staff,5,0,25,20
1746590133395,SIO 295S,A00,894020,Staff,5,0,25,20
1746590134422,SIOC 290S,B01,958918,Merrifield; Mark A,14,0,30,16
1746590135452,SIOC 291S,B01,958922,Gabriel; Corey John,14,0,30,16
1746590136481,SOCI 117,A01,895339,Staff,3,0,5,2
1746590137508,WES 237B,A00,894149,Staff,11,0,20,9
1746590139578,AESE 279B,A00,891859,Staff,13,0,35,22
1746590140602,AIP 197,001,891854,Vespa; Emanuel Ignacio,9999,0,9999,0
1746590141629,ANTH 289S,A00,891856,Gagneux; Pascal,12,0,12,0
1746590142656,BENG 196,001,957946,Engler; Adam J.,9996,0,9999,3
1746590143681,BISP 197,001,959851,Wilhelm; James E.,9998,0,9999,1
1746590144710,CAT 124RS,A01,956906,Staff,6,0,25,19
1746590145736,CAT 125RS,A01,922013,Staff,6,0,25,19
1746590146761,CLRE 250,A00,891860,Morris; Sheldon,9995,0,9999,4
1746590148814,CLRE 251R,A00,907817,Mehta; Ravindra L.,9994,0,9999,5
1746590149891,CLRE 252,A00,891864,Cuomo; Raphael Eduardo,9993,0,9999,6
1746590150919,CLRE 253,A00,891867,Vaida; Florin,9994,0,9999,5
1746590150919,CLRE 253,B00,907819,Staff,9999,0,9999,0
1746590151946,CLRE 259,A00,891868,Patel; Hemal,9998,0,9999,1
1746590152974,CLRE 260,A00,891872,Cuomo; Raphael Eduardo,9999,0,9999,0
1746590154000,CLRE 297,001,891888,Cuomo; Raphael Eduardo,9999,0,9999,0
1746590155024,CSE 191,A00,958773,Minnes Kemp; Mor Mia,9995,0,9999,4
1746590156051,CSE 197,001,959846,Minnes Kemp; Mor Mia,9990,0,9999,9
1746590157077,CSS 201S,A01,892054,Mignozzetti; Umberto,25,0,30,5
1746590158103,CSS 202S,A01,892056,Mignozzetti; Umberto,25,0,30,5
1746590159129,DSC 197,001,956898,Eldridge; Justin Matthew,9996,0,9999,3
1746590160156,DSC 297,001,958000,Mazumdar; Arya,9998,0,9999,1
1746590160156,DSC 297,002,959862,Wang; Yusu,9998,0,9999,1
1746590161181,EAP 100,A00,905686,Staff,9778,0,9999,221
1746590162206,ECE 45,A01,892618,Staff,0,0,65,65
1746590164260,ECE 111,A01,892719,Staff,6,0,65,59
1746590165287,ECE 197,001,957920,Mercier; Patrick Philip,9991,0,9999,8
1746590166317,ECON 178,A01,907814,Zhu; Ying,26,0,35,9
1746590167344,EDS 115,A00,895312,Staff,35,0,45,10
1746590168372,EDS 117,A01,895337,Staff,23,0,30,7
1746590169399,EDS 125,A00,895341,Jones; Gabrielle Anastasia,36,0,45,9
1746590170425,EDS 128A,A01,895459,Fargason; Sharon Gayle,44,0,45,1
1746590171454,EDS 128B,A01,895543,Pappas; Elizabeth,44,0,45,1
1746590172484,EDS 139,A00,897203,Pappas; Elizabeth,44,0,45,1
1746590172484,EDS 139,B00,897209,Fargason; Sharon Gayle,41,0,45,4
1746590173511,EDS 201,A00,895545,Staff,22,0,45,23
1746590174540,EDS 203,A01,895581,Halter; Christopher P.,22,0,45,23
1746590175569,EDS 204R,A01,895625,Heinzman; Erica M.,39,0,45,6
1746590175569,EDS 204R,B01,895693,Halter; Christopher P.,10,0,45,35
1746590176595,EDS 206R,A00,895694,Fargason; Sharon Gayle,1,0,30,29
1746590176595,EDS 206R,B00,895695,Choi; Bailey Miyeon,16,0,30,14
1746590177622,EDS 250,A00,895697,Hemans; Patricia Ann Benitez,22,0,45,23
1746590178648,EDS 281,A00,895701,Meyerott; Theresa Ann,1,0,15,14
1746590179673,EDS 284,A00,895736,Meyerott; Theresa Ann,1,0,15,14
1746590180697,EDS 286,A00,897210,Fine; Sarah,0,0,15,15
1746590181723,EDS 289C,A01,895770,Daly; Alan J.,1,0,15,14
1746590182747,EDS 290,A00,897211,Hofstetter; Carolyn,0,0,15,15
1746590183775,LIGM 5A,A00,896162,Fischer-Grunski; Eva K,12,0,20,8
1746590184801,LIGM 5B,A00,896260,Fischer-Grunski; Eva K,17,0,20,3
1746590185829,LIGM 5C,A00,896308,Fischer-Grunski; Eva K,18,0,20,2
1746590186854,LIIT 5AS,A00,896313,Carnelos; Chiara,18,0,20,2
1746590187880,LIIT 5BS,A00,896416,Carnelos; Chiara,20,0,20,0
1746590188907,LIIT 5CS,A00,896564,Carnelos; Chiara,20,0,20,0
1746590189935,LISP 5A,A00,896588,Munoz Sanchez; Alicia,2,0,20,18
1746590190961,LISP 5B,A00,896653,Munoz Sanchez; Alicia,7,0,20,13
1746590191989,LISP 5C,A00,896655,Munoz Sanchez; Alicia,0,1,20,20
1746590193013,MAE 197,001,957918,Kleissl; Jan,9996,0,9999,3
1746590193013,MAE 197,002,959806,Boechler; Nicholas Sebastia,9998,0,9999,1
1746590193013,MAE 197,003,959852,Mullin; Jennifer S,9998,0,9999,1
1746590194041,MATH 2,A01,957937,Staff,33,0,35,2
1746590195066,MATH 197,001,957876,Kedlaya; Kiran S.,9993,0,9999,6
1746590196091,MCWP 40,A00,892729,Duru; Nur,10,0,20,10
1746590196091,MCWP 40,B00,893304,Montejo; Carolina,14,0,20,6
1746590197115,MCWP 40R,A00,893757,Redela; Pamela Morgan,0,5,20,20
1746590198140,MCWP 50,A00,893758,Morshed; Michael James,0,0,20,20
1746590198140,MCWP 50,B00,893761,Bartulis; Jason Michael,17,0,20,3
1746590199165,MCWP 50R,A00,893766,Compas; Sean Matthew,0,1,20,20
1746590199165,MCWP 50R,B00,893769,Carter; Jennifer A,0,1,20,20
1746590199165,MCWP 50R,C00,893771,Krone; Jarret,0,3,20,20
1746590199165,MCWP 50R,D00,893772,Miller; Elizabeth Deen,0,0,20,20
1746590199165,MCWP 50R,E00,893775,Carter; Andrea L,0,1,20,20
1746590200194,MMW 11R,A01,892721,Herbst; Matthew,14,0,30,16
1746590200194,MMW 11R,A02,892722,Herbst; Matthew,0,0,0,3
1746590201222,MMW 12R,A01,892724,Herbst; Matthew,0,11,16,16
1746590201222,MMW 12R,A02,892725,Herbst; Matthew,0,10,16,16
1746590202251,MMW 13R,A01,892727,Staff,0,4,16,16
1746590202251,MMW 13R,A02,892728,Staff,0,4,16,16
1746590202251,MMW 13R,A03,958032,Staff,0,4,16,16
1746590202251,MMW 13R,A04,958033,Staff,0,4,16,16
1746590202251,MMW 13R,A05,958034,Staff,0,4,16,16
1746590203275,SIO 295LS,A00,894015,Staff,5,0,25,20
1746590204301,SIO 295S,A00,894020,Staff,5,0,25,20
1746590205330,SIOC 290S,B01,958918,Merrifield; Mark A,14,0,30,16
1746590206355,SIOC 291S,B01,958922,Gabriel; Corey John,14,0,30,16
1746590207383,SOCI 117,A01,895339,Staff,3,0,5,2
1746590208407,WES 237B,A00,894149,Staff,11,0,20,9
1746590210469,AESE 279B,A00,891859,Staff,13,0,35,22
1746590211496,AIP 197,001,891854,Vespa; Emanuel Ignacio,9999,0,9999,0
1746590212523,ANTH 289S,A00,891856,Gagneux; Pascal,12,0,12,0
1746590213550,BENG 196,001,957946,Engler; Adam J.,9996,0,9999,3
1746590214577,BISP 197,001,959851,Wilhelm; James E.,9998,0,9999,1
1746590215604,CAT 124RS,A01,956906,Staff,6,0,25,19
1746590216629,CAT 125RS,A01,922013,Staff,6,0,25,19
1746590217658,CLRE 250,A00,891860,Morris; Sheldon,9995,0,9999,4
1746590219710,CLRE 251R,A00,907817,Mehta; Ravindra L.,9994,0,9999,5
1746590220735,CLRE 252,A00,891864,Cuomo; Raphael Eduardo,9993,0,9999,6
1746590221764,CLRE 253,A00,891867,Vaida; Florin,9994,0,9999,5
1746590221764,CLRE 253,B00,907819,Staff,9999,0,9999,0
1746590222792,CLRE 259,A00,891868,Patel; Hemal,9998,0,9999,1
1746590223818,CLRE 260,A00,891872,Cuomo; Raphael Eduardo,9999,0,9999,0
1746590224846,CLRE 297,001,891888,Cuomo; Raphael Eduardo,9999,0,9999,0
1746590225870,CSE 191,A00,958773,Minnes Kemp; Mor Mia,9995,0,9999,4
1746590226898,CSE 197,001,959846,Minnes Kemp; Mor Mia,9990,0,9999,9
1746590227927,CSS 201S,A01,892054,Mignozzetti; Umberto,25,0,30,5
1746590228952,CSS 202S,A01,892056,Mignozzetti; Umberto,25,0,30,5
1746590229979,DSC 197,001,956898,Eldridge; Justin Matthew,9996,0,9999,3
1746590231004,DSC 297,001,958000,Mazumdar; Arya,9998,0,9999,1
1746590231004,DSC 297,002,959862,Wang; Yusu,9998,0,9999,1
1746590232031,EAP 100,A00,905686,Staff,9778,0,9999,221
1746590233060,ECE 45,A01,892618,Staff,0,0,65,65
1746590235115,ECE 111,A01,892719,Staff,6,0,65,59
1746590236180,ECE 197,001,957920,Mercier; Patrick Philip,9991,0,9999,8
1746590237208,ECON 178,A01,907814,Zhu; Ying,26,0,35,9
1746590238234,EDS 115,A00,895312,Staff,35,0,45,10
1746590239261,EDS 117,A01,895337,Staff,23,0,30,7
1746590240287,EDS 125,A00,895341,Jones; Gabrielle Anastasia,36,0,45,9
1746590241313,EDS 128A,A01,895459,Fargason; Sharon Gayle,44,0,45,1
1746590242340,EDS 128B,A01,895543,Pappas; Elizabeth,44,0,45,1
1746590243367,EDS 139,A00,897203,Pappas; Elizabeth,44,0,45,1
1746590243367,EDS 139,B00,897209,Fargason; Sharon Gayle,41,0,45,4
1746590244394,EDS 201,A00,895545,Staff,22,0,45,23
1746590245421,EDS 203,A01,895581,Halter; Christopher P.,22,0,45,23
1746590246446,EDS 204R,A01,895625,Heinzman; Erica M.,39,0,45,6
1746590246446,EDS 204R,B01,895693,Halter; Christopher P.,10,0,45,35
1746590247473,EDS 206R,A00,895694,Fargason; Sharon Gayle,1,0,30,29
1746590247473,EDS 206R,B00,895695,Choi; Bailey Miyeon,16,0,30,14
1746590248502,EDS 250,A00,895697,Hemans; Patricia Ann Benitez,22,0,45,23
1746590249528,EDS 281,A00,895701,Meyerott; Theresa Ann,1,0,15,14
1746590250553,EDS 284,A00,895736,Meyerott; Theresa Ann,1,0,15,14
1746590251578,EDS 286,A00,897210,Fine; Sarah,0,0,15,15
1746590252607,EDS 289C,A01,895770,Daly; Alan J.,1,0,15,14
1746590253635,EDS 290,A00,897211,Hofstetter; Carolyn,0,0,15,15
1746590254661,LIGM 5A,A00,896162,Fischer-Grunski; Eva K,12,0,20,8
1746590255689,LIGM 5B,A00,896260,Fischer-Grunski; Eva K,17,0,20,3
1746590256715,LIGM 5C,A00,896308,Fischer-Grunski; Eva K,18,0,20,2
1746590257740,LIIT 5AS,A00,896313,Carnelos; Chiara,18,0,20,2
1746590258765,LIIT 5BS,A00,896416,Carnelos; Chiara,20,0,20,0
1746590259795,LIIT 5CS,A00,896564,Carnelos; Chiara,20,0,20,0
1746590260821,LISP 5A,A00,896588,Munoz Sanchez; Alicia,2,0,20,18
1746590261850,LISP 5B,A00,896653,Munoz Sanchez; Alicia,7,0,20,13
1746590262879,LISP 5C,A00,896655,Munoz Sanchez; Alicia,0,1,20,20
1746590263908,MAE 197,001,957918,Kleissl; Jan,9996,0,9999,3
1746590263908,MAE 197,002,959806,Boechler; Nicholas Sebastia,9998,0,9999,1
1746590263908,MAE 197,003,959852,Mullin; Jennifer S,9998,0,9999,1
1746590264932,MATH 2,A01,957937,Staff,33,0,35,2
1746590265958,MATH 197,001,957876,Kedlaya; Kiran S.,9993,0,9999,6
1746590266987,MCWP 40,A00,892729,Duru; Nur,10,0,20,10
1746590266987,MCWP 40,B00,893304,Montejo; Carolina,14,0,20,6
1746590268015,MCWP 40R,A00,893757,Redela; Pamela Morgan,0,5,20,20
1746590269044,MCWP 50,A00,893758,Morshed; Michael James,0,0,20,20
1746590269044,MCWP 50,B00,893761,Bartulis; Jason Michael,17,0,20,3
1746590270074,MCWP 50R,A00,893766,Compas; Sean Matthew,0,1,20,20
1746590270074,MCWP 50R,B00,893769,Carter; Jennifer A,0,1,20,20
1746590270074,MCWP 50R,C00,893771,Krone; Jarret,0,3,20,20
1746590270074,MCWP 50R,D00,893772,Miller; Elizabeth Deen,0,0,20,20
1746590270074,MCWP 50R,E00,893775,Carter; Andrea L,0,1,20,20
1746590271102,MMW 11R,A01,892721,Herbst; Matthew,14,0,30,16
1746590271102,MMW 11R,A02,892722,Herbst; Matthew,0,0,0,3
1746590272129,MMW 12R,A01,892724,Herbst; Matthew,0,11,16,16
1746590272129,MMW 12R,A02,892725,Herbst; Matthew,0,10,16,16
1746590273154,MMW 13R,A01,892727,Staff,0,4,16,16
1746590273154,MMW 13R,A02,892728,Staff,0,4,16,16
1746590273154,MMW 13R,A03,958032,Staff,0,4,16,16
1746590273154,MMW 13R,A04,958033,Staff,0,4,16,16
1746590273154,MMW 13R,A05,958034,Staff,0,4,16,16
1746590274179,SIO 295LS,A00,894015,Staff,5,0,25,20
1746590275204,SIO 295S,A00,894020,Staff,5,0,25,20
1746590276229,SIOC 290S,B01,958918,Merrifield; Mark A,14,0,30,16
1746590277254,SIOC 291S,B01,958922,Gabriel; Corey John,14,0,30,16
1746590278282,SOCI 117,A01,895339,Staff,3,0,5,2
1746590279306,WES 237B,A00,894149,Staff,11,0,20,9
1746590281362,AESE 279B,A00,891859,Staff,13,0,35,22
1746590282388,AIP 197,001,891854,Vespa; Emanuel Ignacio,9999,0,9999,0
1746590283414,ANTH 289S,A00,891856,Gagneux; Pascal,12,0,12,0
1746590284438,BENG 196,001,957946,Engler; Adam J.,9996,0,9999,3
1746590285466,BISP 197,001,959851,Wilhelm; James E.,9998,0,9999,1
1746590286493,CAT 124RS,A01,956906,Staff,6,0,25,19
1746590287521,CAT 125RS,A01,922013,Staff,6,0,25,19
1746590288549,CLRE 250,A00,891860,Morris; Sheldon,9995,0,9999,4
1746590290602,CLRE 251R,A00,907817,Mehta; Ravindra L.,9994,0,9999,5
1746590291628,CLRE 252,A00,891864,Cuomo; Raphael Eduardo,9993,0,9999,6
1746590292657,CLRE 253,A00,891867,Vaida; Florin,9994,0,9999,5
1746590292657,CLRE 253,B00,907819,Staff,9999,0,9999,0
1746590293686,CLRE 259,A00,891868,Patel; Hemal,9998,0,9999,1
1746590294712,CLRE 260,A00,891872,Cuomo; Raphael Eduardo,9999,0,9999,0
1746590295741,CLRE 297,001,891888,Cuomo; Raphael Eduardo,9999,0,9999,0
1746590296767,CSE 191,A00,958773,Minnes Kemp; Mor Mia,9995,0,9999,4
1746590297793,CSE 197,001,959846,Minnes Kemp; Mor Mia,9990,0,9999,9
1746590298823,CSS 201S,A01,892054,Mignozzetti; Umberto,25,0,30,5
1746590299849,CSS 202S,A01,892056,Mignozzetti; Umberto,25,0,30,5
1746590300876,DSC 197,001,956898,Eldridge; Justin Matthew,9996,0,9999,3
1746590301902,DSC 297,001,958000,Mazumdar; Arya,9998,0,9999,1
1746590301902,DSC 297,002,959862,Wang; Yusu,9998,0,9999,1
1746590302929,EAP 100,A00,905686,Staff,9778,0,9999,221
1746590303956,ECE 45,A01,892618,Staff,0,0,65,65
1746590306006,ECE 111,A01,892719,Staff,6,0,65,59
1746590307033,ECE 197,001,957920,Mercier; Patrick Philip,9991,0,9999,8
1746590308059,ECON 178,A01,907814,Zhu; Ying,26,0,35,9
1746590309086,EDS 115,A00,895312,Staff,35,0,45,10
1746590310111,EDS 117,A01,895337,Staff,23,0,30,7
1746590311140,EDS 125,A00,895341,Jones; Gabrielle Anastasia,36,0,45,9
1746590312165,EDS 128A,A01,895459,Fargason; Sharon Gayle,44,0,45,1
1746590313193,EDS 128B,A01,895543,Pappas; Elizabeth,44,0,45,1
1746590314216,EDS 139,A00,897203,Pappas; Elizabeth,44,0,45,1
1746590314216,EDS 139,B00,897209,Fargason; Sharon Gayle,41,0,45,4
1746590315241,EDS 201,A00,895545,Staff,22,0,45,23
1746590316267,EDS 203,A01,895581,Halter; Christopher P.,22,0,45,23
1746590317291,EDS 204R,A01,895625,Heinzman; Erica M.,39,0,45,6
1746590317291,EDS 204R,B01,895693,Halter; Christopher P.,10,0,45,35
1746590318316,EDS 206R,A00,895694,Fargason; Sharon Gayle,1,0,30,29
1746590318316,EDS 206R,B00,895695,Choi; Bailey Miyeon,16,0,30,14
1746590319341,EDS 250,A00,895697,Hemans; Patricia Ann Benitez,22,0,45,23
1746590320364,EDS 281,A00,895701,Meyerott; Theresa Ann,1,0,15,14
1746590321390,EDS 284,A00,895736,Meyerott; Theresa Ann,1,0,15,14
1746590322419,EDS 286,A00,897210,Fine; Sarah,0,0,15,15
1746590323443,EDS 289C,A01,895770,Daly; Alan J.,1,0,15,14
1746590324467,EDS 290,A00,897211,Hofstetter; Carolyn,0,0,15,15
1746590325494,LIGM 5A,A00,896162,Fischer-Grunski; Eva K,12,0,20,8
1746590326517,LIGM 5B,A00,896260,Fischer-Grunski; Eva K,17,0,20,3
1746590327544,LIGM 5C,A00,896308,Fischer-Grunski; Eva K,18,0,20,2
1746590328573,LIIT 5AS,A00,896313,Carnelos; Chiara,18,0,20,2
1746590329601,LIIT 5BS,A00,896416,Carnelos; Chiara,20,0,20,0
1746590330627,LIIT 5CS,A00,896564,Carnelos; Chiara,20,0,20,0
1746590331655,LISP 5A,A00,896588,Munoz Sanchez; Alicia,2,0,20,18
1746590332691,LISP 5B,A00,896653,Munoz Sanchez; Alicia,7,0,20,13
1746590333715,LISP 5C,A00,896655,Munoz Sanchez; Alicia,0,1,20,20
1746590334742,MAE 197,001,957918,Kleissl; Jan,9996,0,9999,3
1746590334742,MAE 197,002,959806,Boechler; Nicholas Sebastia,9998,0,9999,1
1746590334742,MAE 197,003,959852,Mullin; Jennifer S,9998,0,9999,1
1746590335769,MATH 2,A01,957937,Staff,33,0,35,2
1746590336797,MATH 197,001,957876,Kedlaya; Kiran S.,9993,0,9999,6
1746590337822,MCWP 40,A00,892729,Duru; Nur,10,0,20,10
1746590337822,MCWP 40,B00,893304,Montejo; Carolina,14,0,20,6
1746590338847,MCWP 40R,A00,893757,Redela; Pamela Morgan,0,5,20,20
1746590339872,MCWP 50,A00,893758,Morshed; Michael James,0,0,20,20
1746590339872,MCWP 50,B00,893761,Bartulis; Jason Michael,17,0,20,3
1746590340900,MCWP 50R,A00,893766,Compas; Sean Matthew,0,1,20,20
1746590340900,MCWP 50R,B00,893769,Carter; Jennifer A,0,1,20,20
1746590340900,MCWP 50R,C00,893771,Krone; Jarret,0,3,20,20
1746590340900,MCWP 50R,D00,893772,Miller; Elizabeth Deen,0,0,20,20
1746590340900,MCWP 50R,E00,893775,Carter; Andrea L,0,1,20,20
1746590341925,MMW 11R,A01,892721,Herbst; Matthew,14,0,30,16
1746590341925,MMW 11R,A02,892722,Herbst; Matthew,0,0,0,3
1746590342956,MMW 12R,A01,892724,Herbst; Matthew,0,11,16,16
1746590342956,MMW 12R,A02,892725,Herbst; Matthew,0,10,16,16
1746590343981,MMW 13R,A01,892727,Staff,0,4,16,16
1746590343981,MMW 13R,A02,892728,Staff,0,4,16,16
1746590343981,MMW 13R,A03,958032,Staff,0,4,16,16
1746590343981,MMW 13R,A04,958033,Staff,0,4,16,16
1746590343981,MMW 13R,A05,958034,Staff,0,4,16,16
1746590345006,SIO 295LS,A00,894015,Staff,5,0,25,20
1746590346034,SIO 295S,A00,894020,Staff,5,0,25,20
1746590347062,SIOC 290S,B01,958918,Merrifield; Mark A,14,0,30,16
1746590348087,SIOC 291S,B01,958922,Gabriel; Corey John,14,0,30,16
1746590349119,SOCI 117,A01,895339,Staff,3,0,5,2
1746590350144,WES 237B,A00,894149,Staff,11,0,20,9
1746590352202,AESE 279B,A00,891859,Staff,13,0,35,22
1746590353225,AIP 197,001,891854,Vespa; Emanuel Ignacio,9999,0,9999,0
1746590354250,ANTH 289S,A00,891856,Gagneux; Pascal,12,0,12,0
1746590355278,BENG 196,001,957946,Engler; Adam J.,9996,0,9999,3
1746590356309,BISP 197,001,959851,Wilhelm; James E.,9998,0,9999,1
1746590357333,CAT 124RS,A01,956906,Staff,6,0,25,19
1746590358357,CAT 125RS,A01,922013,Staff,6,0,25,19
1746590359380,CLRE 250,A00,891860,Morris; Sheldon,9995,0,9999,4
1746590361436,CLRE 251R,A00,907817,Mehta; Ravindra L.,9994,0,9999,5
1746590362460,CLRE 252,A00,891864,Cuomo; Raphael Eduardo,9993,0,9999,6
1746590363490,CLRE 253,A00,891867,Vaida; Florin,9994,0,9999,5
1746590363490,CLRE 253,B00,907819,Staff,9999,0,9999,0
1746590364518,CLRE 259,A00,891868,Patel; Hemal,9998,0,9999,1
1746590365542,CLRE 260,A00,891872,Cuomo; Raphael Eduardo,9999,0,9999,0
1746590366569,CLRE 297,001,891888,Cuomo; Raphael Eduardo,9999,0,9999,0
1746590367595,CSE 191,A00,958773,Minnes Kemp; Mor Mia,9995,0,9999,4
1746590368622,CSE 197,001,959846,Minnes Kemp; Mor Mia,9990,0,9999,9
1746590369648,CSS 201S,A01,892054,Mignozzetti; Umberto,25,0,30,5
1746590370677,CSS 202S,A01,892056,Mignozzetti; Umberto,25,0,30,5
1746590371702,DSC 197,001,956898,Eldridge; Justin Matthew,9996,0,9999,3
1746590372732,DSC 297,001,958000,Mazumdar; Arya,9998,0,9999,1
1746590372732,DSC 297,002,959862,Wang; Yusu,9998,0,9999,1
1746590373759,EAP 100,A00,905686,Staff,9778,0,9999,221
1746590374825,ECE 45,A01,892618,Staff,0,0,65,65
1746590376873,ECE 111,A01,892719,Staff,6,0,65,59
1746590377899,ECE 197,001,957920,Mercier; Patrick Philip,9991,0,9999,8
1746590378929,ECON 178,A01,907814,Zhu; Ying,26,0,35,9
1746590379956,EDS 115,A00,895312,Staff,35,0,45,10
1746590380982,EDS 117,A01,895337,Staff,23,0,30,7
1746590382007,EDS 125,A00,895341,Jones; Gabrielle Anastasia,36,0,45,9
1746590383031,EDS 128A,A01,895459,Fargason; Sharon Gayle,44,0,45,1
1746590384058,EDS 128B,A01,895543,Pappas; Elizabeth,44,0,45,1
1746590385090,EDS 139,A00,897203,Pappas; Elizabeth,44,0,45,1
1746590385090,EDS 139,B00,897209,Fargason; Sharon Gayle,41,0,45,4
1746590386118,EDS 201,A00,895545,Staff,22,0,45,23
1746590387143,EDS 203,A01,895581,Halter; Christopher P.,22,0,45,23
1746590388170,EDS 204R,A01,895625,Heinzman; Erica M.,39,0,45,6
1746590388170,EDS 204R,B01,895693,Halter; Christopher P.,10,0,45,35
1746590389197,EDS 206R,A00,895694,Fargason; Sharon Gayle,1,0,30,29
1746590389197,EDS 206R,B00,895695,Choi; Bailey Miyeon,16,0,30,14
1746590390223,EDS 250,A00,895697,Hemans; Patricia Ann Benitez,22,0,45,23
1746590391253,EDS 281,A00,895701,Meyerott; Theresa Ann,1,0,15,14
1746590392279,EDS 284,A00,895736,Meyerott; Theresa Ann,1,0,15,14
1746590393302,EDS 286,A00,897210,Fine; Sarah,0,0,15,15
1746590394327,EDS 289C,A01,895770,Daly; Alan J.,1,0,15,14
1746590395351,EDS 290,A00,897211,Hofstetter; Carolyn,0,0,15,15
1746590396375,LIGM 5A,A00,896162,Fischer-Grunski; Eva K,12,0,20,8
1746590397402,LIGM 5B,A00,896260,Fischer-Grunski; Eva K,17,0,20,3
1746590398430,LIGM 5C,A00,896308,Fischer-Grunski; Eva K,18,0,20,2
1746590399459,LIIT 5AS,A00,896313,Carnelos; Chiara,18,0,20,2
1746590400489,LIIT 5BS,A00,896416,Carnelos; Chiara,20,0,20,0
1746590401520,LIIT 5CS,A00,896564,Carnelos; Chiara,20,0,20,0
1746590402552,LISP 5A,A00,896588,Munoz Sanchez; Alicia,2,0,20,18
1746590403579,LISP 5B,A00,896653,Munoz Sanchez; Alicia,7,0,20,13
1746590404606,LISP 5C,A00,896655,Munoz Sanchez; Alicia,0,1,20,20
1746590405631,MAE 197,001,957918,Kleissl; Jan,9996,0,9999,3
1746590405631,MAE 197,002,959806,Boechler; Nicholas Sebastia,9998,0,9999,1
1746590405631,MAE 197,003,959852,Mullin; Jennifer S,9998,0,9999,1
1746590406667,MATH 2,A01,957937,Staff,33,0,35,2
1746590407694,MATH 197,001,957876,Kedlaya; Kiran S.,9993,0,9999,6
1746590408721,MCWP 40,A00,892729,Duru; Nur,10,0,20,10
1746590408721,MCWP 40,B00,893304,Montejo; Carolina,14,0,20,6
1746590409747,MCWP 40R,A00,893757,Redela; Pamela Morgan,0,5,20,20
1746590410773,MCWP 50,A00,893758,Morshed; Michael James,0,0,20,20
1746590410773,MCWP 50,B00,893761,Bartulis; Jason Michael,17,0,20,3
1746590411798,MCWP 50R,A00,893766,Compas; Sean Matthew,0,1,20,20
1746590411798,MCWP 50R,B00,893769,Carter; Jennifer A,0,1,20,20
1746590411798,MCWP 50R,C00,893771,Krone; Jarret,0,3,20,20
1746590411798,MCWP 50R,D00,893772,Miller; Elizabeth Deen,0,0,20,20
1746590411798,MCWP 50R,E00,893775,Carter; Andrea L,0,1,20,20
1746590412824,MMW 11R,A01,892721,Herbst; Matthew,14,0,30,16
1746590412824,MMW 11R,A02,892722,Herbst; Matthew,0,0,0,3
1746590413853,MMW 12R,A01,892724,Herbst; Matthew,0,11,16,16
1746590413853,MMW 12R,A02,892725,Herbst; Matthew,0,10,16,16
1746590414879,MMW 13R,A01,892727,Staff,0,4,16,16
1746590414879,MMW 13R,A02,892728,Staff,0,4,16,16
1746590414879,MMW 13R,A03,958032,Staff,0,4,16,16
1746590414879,MMW 13R,A04,958033,Staff,0,4,16,16
1746590414879,MMW 13R,A05,958034,Staff,0,4,16,16
1746590415907,SIO 295LS,A00,894015,Staff,5,0,25,20
1746590416935,SIO 295S,A00,894020,Staff,5,0,25,20
1746590417960,SIOC 290S,B01,958918,Merrifield; Mark A,14,0,30,16
1746590418990,SIOC 291S,B01,958922,Gabriel; Corey John,14,0,30,16
1746590420015,SOCI 117,A01,895339,Staff,3,0,5,2
1746590421039,WES 237B,A00,894149,Staff,11,0,20,9
1746590423107,AESE 279B,A00,891859,Staff,13,0,35,22
1746590424132,AIP 197,001,891854,Vespa; Emanuel Ignacio,9999,0,9999,0
1746590425155,ANTH 289S,A00,891856,Gagneux; Pascal,12,0,12,0
1746590426180,BENG 196,001,957946,Engler; Adam J.,9996,0,9999,3
1746590427204,BISP 197,001,959851,Wilhelm; James E.,9998,0,9999,1
1746590428229,CAT 124RS,A01,956906,Staff,6,0,25,19
1746590429255,CAT 125RS,A01,922013,Staff,6,0,25,19
1746590430282,CLRE 250,A00,891860,Morris; Sheldon,9995,0,9999,4
1746590432338,CLRE 251R,A00,907817,Mehta; Ravindra L.,9994,0,9999,5
1746590433368,CLRE 252,A00,891864,Cuomo; Raphael Eduardo,9993,0,9999,6
1746590434392,CLRE 253,A00,891867,Vaida; Florin,9994,0,9999,5
1746590434392,CLRE 253,B00,907819,Staff,9999,0,9999,0
1746590435420,CLRE 259,A00,891868,Patel; Hemal,9998,0,9999,1
1746590436468,CLRE 260,A00,891872,Cuomo; Raphael Eduardo,9999,0,9999,0
1746590437494,CLRE 297,001,891888,Cuomo; Raphael Eduardo,9999,0,9999,0
1746590438525,CSE 191,A00,958773,Minnes Kemp; Mor Mia,9995,0,9999,4
1746590439550,CSE 197,001,959846,Minnes Kemp; Mor Mia,9990,0,9999,9
1746590440575,CSS 201S,A01,892054,Mignozzetti; Umberto,25,0,30,5
1746590441623,CSS 202S,A01,892056,Mignozzetti; Umberto,25,0,30,5
1746590442649,DSC 197,001,956898,Eldridge; Justin Matthew,9996,0,9999,3
1746590443674,DSC 297,001,958000,Mazumdar; Arya,9998,0,9999,1
1746590443674,DSC 297,002,959862,Wang; Yusu,9998,0,9999,1
1746590444697,EAP 100,A00,905686,Staff,9778,0,9999,221
1746590445727,ECE 45,A01,892618,Staff,0,0,65,65
1746590447779,ECE 111,A01,892719,Staff,6,0,65,59
1746590448805,ECE 197,001,957920,Mercier; Patrick Philip,9991,0,9999,8
1746590449833,ECON 178,A01,907814,Zhu; Ying,26,0,35,9
1746590450859,EDS 115,A00,895312,Staff,35,0,45,10
1746590451887,EDS 117,A01,895337,Staff,23,0,30,7
1746590452916,EDS 125,A00,895341,Jones; Gabrielle Anastasia,36,0,45,9
1746590453945,EDS 128A,A01,895459,Fargason; Sharon Gayle,44,0,45,1
1746590454970,EDS 128B,A01,895543,Pappas; Elizabeth,44,0,45,1
1746590455995,EDS 139,A00,897203,Pappas; Elizabeth,44,0,45,1
1746590455995,EDS 139,B00,897209,Fargason; Sharon Gayle,41,0,45,4
1746590457019,EDS 201,A00,895545,Staff,22,0,45,23
1746590458045,EDS 203,A01,895581,Halter; Christopher P.,22,0,45,23
1746590459070,EDS 204R,A01,895625,Heinzman; Erica M.,39,0,45,6
1746590459070,EDS 204R,B01,895693,Halter; Christopher P.,10,0,45,35
1746590460095,EDS 206R,A00,895694,Fargason; Sharon Gayle,1,0,30,29
1746590460095,EDS 206R,B00,895695,Choi; Bailey Miyeon,16,0,30,14
1746590461120,EDS 250,A00,895697,Hemans; Patricia Ann Benitez,22,0,45,23
1746590462144,EDS 281,A00,895701,Meyerott; Theresa Ann,1,0,15,14
1746590463171,EDS 284,A00,895736,Meyerott; Theresa Ann,1,0,15,14
1746590464194,EDS 286,A00,897210,Fine; Sarah,0,0,15,15
1746590465224,EDS 289C,A01,895770,Daly; Alan J.,1,0,15,14
1746590466249,EDS 290,A00,897211,Hofstetter; Carolyn,0,0,15,15
1746590467274,LIGM 5A,A00,896162,Fischer-Grunski; Eva K,12,0,20,8
1746590468299,LIGM 5B,A00,896260,Fischer-Grunski; Eva K,17,0,20,3
1746590469327,LIGM 5C,A00,896308,Fischer-Grunski; Eva K,18,0,20,2
1746590470355,LIIT 5AS,A00,896313,Carnelos; Chiara,18,0,20,2
1746590471385,LIIT 5BS,A00,896416,Carnelos; Chiara,20,0,20,0
1746590472427,LIIT 5CS,A00,896564,Carnelos; Chiara,20,0,20,0
1746590473452,LISP 5A,A00,896588,Munoz Sanchez; Alicia,2,0,20,18
1746590474479,LISP 5B,A00,896653,Munoz Sanchez; Alicia,7,0,20,13
1746590475506,LISP 5C,A00,896655,Munoz Sanchez; Alicia,0,1,20,20
1746590476531,MAE 197,001,957918,Kleissl; Jan,9996,0,9999,3
1746590476531,MAE 197,002,959806,Boechler; Nicholas Sebastia,9998,0,9999,1
1746590476531,MAE 197,003,959852,Mullin; Jennifer S,9998,0,9999,1
1746590477557,MATH 2,A01,957937,Staff,33,0,35,2
1746590478586,MATH 197,001,957876,Kedlaya; Kiran S.,9993,0,9999,6
1746590479611,MCWP 40,A00,892729,Duru; Nur,10,0,20,10
1746590479611,MCWP 40,B00,893304,Montejo; Carolina,14,0,20,6
1746590480640,MCWP 40R,A00,893757,Redela; Pamela Morgan,0,5,20,20
1746590481666,MCWP 50,A00,893758,Morshed; Michael James,0,0,20,20
1746590481666,MCWP 50,B00,893761,Bartulis; Jason Michael,17,0,20,3
1746590482692,MCWP 50R,A00,893766,Compas; Sean Matthew,0,1,20,20
1746590482692,MCWP 50R,B00,893769,Carter; Jennifer A,0,1,20,20
1746590482692,MCWP 50R,C00,893771,Krone; Jarret,0,3,20,20
1746590482692,MCWP 50R,D00,893772,Miller; Elizabeth Deen,0,0,20,20
1746590482692,MCWP 50R,E00,893775,Carter; Andrea L,0,1,20,20
1746590483718,MMW 11R,A01,892721,Herbst; Matthew,14,0,30,16
1746590483718,MMW 11R,A02,892722,Herbst; Matthew,0,0,0,3
1746590484745,MMW 12R,A01,892724,Herbst; Matthew,0,11,16,16
1746590484745,MMW 12R,A02,892725,Herbst; Matthew,0,10,16,16
1746590485772,MMW 13R,A01,892727,Staff,0,4,16,16
1746590485772,MMW 13R,A02,892728,Staff,0,4,16,16
1746590485772,MMW 13R,A03,958032,Staff,0,4,16,16
1746590485772,MMW 13R,A04,958033,Staff,0,4,16,16
1746590485772,MMW 13R,A05,958034,Staff,0,4,16,16
1746590486800,SIO 295LS,A00,894015,Staff,5,0,25,20
1746590487829,SIO 295S,A00,894020,Staff,5,0,25,20
1746590488858,SIOC 290S,B01,958918,Merrifield; Mark A,14,0,30,16
1746590489888,SIOC 291S,B01,958922,Gabriel; Corey John,14,0,30,16
1746590490917,SOCI 117,A01,895339,Staff,3,0,5,2
1746590491944,WES 237B,A00,894149,Staff,11,0,20,9
1746590494001,AESE 279B,A00,891859,Staff,13,0,35,22
1746590495029,AIP 197,001,891854,Vespa; Emanuel Ignacio,9999,0,9999,0
1746590496056,ANTH 289S,A00,891856,Gagneux; Pascal,12,0,12,0
1746590497081,BENG 196,001,957946,Engler; Adam J.,9996,0,9999,3
1746590498111,BISP 197,001,959851,Wilhelm; James E.,9998,0,9999,1
1746590499138,CAT 124RS,A01,956906,Staff,6,0,25,19
1746590500162,CAT 125RS,A01,922013,Staff,6,0,25,19
1746590501187,CLRE 250,A00,891860,Morris; Sheldon,9995,0,9999,4
1746590503240,CLRE 251R,A00,907817,Mehta; Ravindra L.,9994,0,9999,5
1746590504266,CLRE 252,A00,891864,Cuomo; Raphael Eduardo,9993,0,9999,6
1746590505294,CLRE 253,A00,891867,Vaida; Florin,9994,0,9999,5
1746590505294,CLRE 253,B00,907819,Staff,9999,0,9999,0
1746590506319,CLRE 259,A00,891868,Patel; Hemal,9998,0,9999,1
1746590507344,CLRE 260,A00,891872,Cuomo; Raphael Eduardo,9999,0,9999,0
1746590508370,CLRE 297,001,891888,Cuomo; Raphael Eduardo,9999,0,9999,0
1746590509397,CSE 191,A00,958773,Minnes Kemp; Mor Mia,9995,0,9999,4
1746590510424,CSE 197,001,959846,Minnes Kemp; Mor Mia,9990,0,9999,9
1746590511453,CSS 201S,A01,892054,Mignozzetti; Umberto,25,0,30,5
1746590512477,CSS 202S,A01,892056,Mignozzetti; Umberto,25,0,30,5
1746590513502,DSC 197,001,956898,Eldridge; Justin Matthew,9996,0,9999,3
1746590514526,DSC 297,001,958000,Mazumdar; Arya,9998,0,9999,1
1746590514526,DSC 297,002,959862,Wang; Yusu,9998,0,9999,1
1746590515550,EAP 100,A00,905686,Staff,9778,0,9999,221
1746590516577,ECE 45,A01,892618,Staff,0,0,65,65
1746590518627,ECE 111,A01,892719,Staff,6,0,65,59
1746590519653,ECE 197,001,957920,Mercier; Patrick Philip,9991,0,9999,8
1746590520683,ECON 178,A01,907814,Zhu; Ying,26,0,35,9
1746590521709,EDS 115,A00,895312,Staff,35,0,45,10
1746590522734,EDS 117,A01,895337,Staff,23,0,30,7
1746590523758,EDS 125,A00,895341,Jones; Gabrielle Anastasia,36,0,45,9
1746590524785,EDS 128A,A01,895459,Fargason; Sharon Gayle,44,0,45,1
1746590525813,EDS 128B,A01,895543,Pappas; Elizabeth,44,0,45,1
1746590526840,EDS 139,A00,897203,Pappas; Elizabeth,44,0,45,1
1746590526840,EDS 139,B00,897209,Fargason; Sharon Gayle,41,0,45,4
1746590527866,EDS 201,A00,895545,Staff,22,0,45,23
1746590528892,EDS 203,A01,895581,Halter; Christopher P.,22,0,45,23
1746590529916,EDS 204R,A01,895625,Heinzman; Erica M.,39,0,45,6
1746590529916,EDS 204R,B01,895693,Halter; Christopher P.,10,0,45,35
1746590530941,EDS 206R,A00,895694,Fargason; Sharon Gayle,1,0,30,29
1746590530941,EDS 206R,B00,895695,Choi; Bailey Miyeon,16,0,30,14
1746590531966,EDS 250,A00,895697,Hemans; Patricia Ann Benitez,22,0,45,23
1746590532991,EDS 281,A00,895701,Meyerott; Theresa Ann,1,0,15,14
1746590534020,EDS 284,A00,895736,Meyerott; Theresa Ann,1,0,15,14
1746590535047,EDS 286,A00,897210,Fine; Sarah,0,0,15,15
1746590536075,EDS 289C,A01,895770,Daly; Alan J.,1,0,15,14
1746590537101,EDS 290,A00,897211,Hofstetter; Carolyn,0,0,15,15
1746590538127,LIGM 5A,A00,896162,Fischer-Grunski; Eva K,12,0,20,8
1746590539151,LIGM 5B,A00,896260,Fischer-Grunski; Eva K,17,0,20,3
1746590540177,LIGM 5C,A00,896308,Fischer-Grunski; Eva K,18,0,20,2
1746590541203,LIIT 5AS,A00,896313,Carnelos; Chiara,18,0,20,2
1746590542231,LIIT 5BS,A00,896416,Carnelos; Chiara,20,0,20,0
1746590543254,LIIT 5CS,A00,896564,Carnelos; Chiara,20,0,20,0
1746590544283,LISP 5A,A00,896588,Munoz Sanchez; Alicia,2,0,20,18
1746590545308,LISP 5B,A00,896653,Munoz Sanchez; Alicia,7,0,20,13
1746590546335,LISP 5C,A00,896655,Munoz Sanchez; Alicia,0,1,20,20
1746590547360,MAE 197,001,957918,Kleissl; Jan,9996,0,9999,3
1746590547360,MAE 197,002,959806,Boechler; Nicholas Sebastia,9998,0,9999,1
1746590547360,MAE 197,003,959852,Mullin; Jennifer S,9998,0,9999,1
1746590548392,MATH 2,A01,957937,Staff,33,0,35,2
1746590549417,MATH 197,001,957876,Kedlaya; Kiran S.,9993,0,9999,6
1746590550442,MCWP 40,A00,892729,Duru; Nur,10,0,20,10
1746590550442,MCWP 40,B00,893304,Montejo; Carolina,14,0,20,6
1746590551467,MCWP 40R,A00,893757,Redela; Pamela Morgan,0,5,20,20
1746590552492,MCWP 50,A00,893758,Morshed; Michael James,0,0,20,20
1746590552492,MCWP 50,B00,893761,Bartulis; Jason Michael,17,0,20,3
1746590553520,MCWP 50R,A00,893766,Compas; Sean Matthew,0,1,20,20
1746590553520,MCWP 50R,B00,893769,Carter; Jennifer A,0,1,20,20
1746590553520,MCWP 50R,C00,893771,Krone; Jarret,0,3,20,20
1746590553520,MCWP 50R,D00,893772,Miller; Elizabeth Deen,0,0,20,20
1746590553520,MCWP 50R,E00,893775,Carter; Andrea L,0,1,20,20
1746590554543,MMW 11R,A01,892721,Herbst; Matthew,14,0,30,16
1746590554543,MMW 11R,A02,892722,Herbst; Matthew,0,0,0,3
1746590555571,MMW 12R,A01,892724,Herbst; Matthew,0,11,16,16
1746590555571,MMW 12R,A02,892725,Herbst; Matthew,0,10,16,16
1746590556596,MMW 13R,A01,892727,Staff,0,4,16,16
1746590556596,MMW 13R,A02,892728,Staff,0,4,16,16
1746590556596,MMW 13R,A03,958032,Staff,0,4,16,16
1746590556596,MMW 13R,A04,958033,Staff,0,4,16,16
1746590556596,MMW 13R,A05,958034,Staff,0,4,16,16
1746590557623,SIO 295LS,A00,894015,Staff,5,0,25,20
1746590558651,SIO 295S,A00,894020,Staff,5,0,25,20
1746590559679,SIOC 290S,B01,958918,Merrifield; Mark A,14,0,30,16
1746590560707,SIOC 291S,B01,958922,Gabriel; Corey John,14,0,30,16
1746590561734,SOCI 117,A01,895339,Staff,3,0,5,2
1746590562760,WES 237B,A00,894149,Staff,11,0,20,9
1746590564818,AESE 279B,A00,891859,Staff,13,0,35,22
1746590565846,AIP 197,001,891854,Vespa; Emanuel Ignacio,9999,0,9999,0
1746590566869,ANTH 289S,A00,891856,Gagneux; Pascal,12,0,12,0
1746590567895,BENG 196,001,957946,Engler; Adam J.,9996,0,9999,3
1746590568918,BISP 197,001,959851,Wilhelm; James E.,9998,0,9999,1
1746590569942,CAT 124RS,A01,956906,Staff,6,0,25,19
1746590570969,CAT 125RS,A01,922013,Staff,6,0,25,19
1746590571997,CLRE 250,A00,891860,Morris; Sheldon,9995,0,9999,4
1746590574053,CLRE 251R,A00,907817,Mehta; Ravindra L.,9994,0,9999,5
1746590575079,CLRE 252,A00,891864,Cuomo; Raphael Eduardo,9993,0,9999,6
1746590576104,CLRE 253,A00,891867,Vaida; Florin,9994,0,9999,5
1746590576104,CLRE 253,B00,907819,Staff,9999,0,9999,0
1746590577129,CLRE 259,A00,891868,Patel; Hemal,9998,0,9999,1
1746590578157,CLRE 260,A00,891872,Cuomo; Raphael Eduardo,9999,0,9999,0
1746590579186,CLRE 297,001,891888,Cuomo; Raphael Eduardo,9999,0,9999,0
1746590580210,CSE 191,A00,958773,Minnes Kemp; Mor Mia,9995,0,9999,4
1746590581234,CSE 197,001,959846,Minnes Kemp; Mor Mia,9990,0,9999,9
1746590582266,CSS 201S,A01,892054,Mignozzetti; Umberto,25,0,30,5
1746590583291,CSS 202S,A01,892056,Mignozzetti; Umberto,25,0,30,5
1746590584320,DSC 197,001,956898,Eldridge; Justin Matthew,9996,0,9999,3
1746590585350,DSC 297,001,958000,Mazumdar; Arya,9998,0,9999,1
1746590585350,DSC 297,002,959862,Wang; Yusu,9998,0,9999,1
1746590586377,EAP 100,A00,905686,Staff,9778,0,9999,221
1746590587404,ECE 45,A01,892618,Staff,0,0,65,65
1746590589465,ECE 111,A01,892719,Staff,6,0,65,59
1746590590493,ECE 197,001,957920,Mercier; Patrick Philip,9991,0,9999,8
1746590591524,ECON 178,A01,907814,Zhu; Ying,26,0,35,9
1746590592547,EDS 115,A00,895312,Staff,35,0,45,10
1746590593576,EDS 117,A01,895337,Staff,23,0,30,7
1746590594603,EDS 125,A00,895341,Jones; Gabrielle Anastasia,36,0,45,9
1746590595629,EDS 128A,A01,895459,Fargason; Sharon Gayle,44,0,45,1
1746590596654,EDS 128B,A01,895543,Pappas; Elizabeth,44,0,45,1
1746590597680,EDS 139,A00,897203,Pappas; Elizabeth,44,0,45,1
1746590597680,EDS 139,B00,897209,Fargason; Sharon Gayle,41,0,45,4
1746590598708,EDS 201,A00,895545,Staff,22,0,45,23
1746590599733,EDS 203,A01,895581,Halter; Christopher P.,22,0,45,23
1746590600761,EDS 204R,A01,895625,Heinzman; Erica M.,39,0,45,6
1746590600761,EDS 204R,B01,895693,Halter; Christopher P.,10,0,45,35
1746590601791,EDS 206R,A00,895694,Fargason; Sharon Gayle,1,0,30,29
1746590601791,EDS 206R,B00,895695,Choi; Bailey Miyeon,16,0,30,14
1746590602816,EDS 250,A00,895697,Hemans; Patricia Ann Benitez,22,0,45,23
1746590603841,EDS 281,A00,895701,Meyerott; Theresa Ann,1,0,15,14
1746590604865,EDS 284,A00,895736,Meyerott; Theresa Ann,1,0,15,14
1746590605891,EDS 286,A00,897210,Fine; Sarah,0,0,15,15
1746590606920,EDS 289C,A01,895770,Daly; Alan J.,1,0,15,14
1746590607947,EDS 290,A00,897211,Hofstetter; Carolyn,0,0,15,15
1746590608971,LIGM 5A,A00,896162,Fischer-Grunski; Eva K,12,0,20,8
1746590609995,LIGM 5B,A00,896260,Fischer-Grunski; Eva K,17,0,20,3
1746590611021,LIGM 5C,A00,896308,Fischer-Grunski; Eva K,18,0,20,2
1746590612049,LIIT 5AS,A00,896313,Carnelos; Chiara,18,0,20,2
1746590613078,LIIT 5BS,A00,896416,Carnelos; Chiara,20,0,20,0
1746590614108,LIIT 5CS,A00,896564,Carnelos; Chiara,20,0,20,0
1746590615133,LISP 5A,A00,896588,Munoz Sanchez; Alicia,2,0,20,18
1746590616158,LISP 5B,A00,896653,Munoz Sanchez; Alicia,7,0,20,13
1746590617186,LISP 5C,A00,896655,Munoz Sanchez; Alicia,0,1,20,20
1746590618214,MAE 197,001,957918,Kleissl; Jan,9996,0,9999,3
1746590618214,MAE 197,002,959806,Boechler; Nicholas Sebastia,9998,0,9999,1
1746590618214,MAE 197,003,959852,Mullin; Jennifer S,9998,0,9999,1
1746590619240,MATH 2,A01,957937,Staff,33,0,35,2
1746590620266,MATH 197,001,957876,Kedlaya; Kiran S.,9993,0,9999,6
1746590621296,MCWP 40,A00,892729,Duru; Nur,10,0,20,10
1746590621296,MCWP 40,B00,893304,Montejo; Carolina,14,0,20,6
1746590622320,MCWP 40R,A00,893757,Redela; Pamela Morgan,0,5,20,20
1746590623347,MCWP 50,A00,893758,Morshed; Michael James,0,0,20,20
1746590623347,MCWP 50,B00,893761,Bartulis; Jason Michael,17,0,20,3
1746590624376,MCWP 50R,A00,893766,Compas; Sean Matthew,0,1,20,20
1746590624376,MCWP 50R,B00,893769,Carter; Jennifer A,0,1,20,20
1746590624376,MCWP 50R,C00,893771,Krone; Jarret,0,3,20,20
1746590624376,MCWP 50R,D00,893772,Miller; Elizabeth Deen,0,0,20,20
1746590624376,MCWP 50R,E00,893775,Carter; Andrea L,0,1,20,20
1746590625404,MMW 11R,A01,892721,Herbst; Matthew,14,0,30,16
1746590625404,MMW 11R,A02,892722,Herbst; Matthew,0,0,0,3
1746590626430,MMW 12R,A01,892724,Herbst; Matthew,0,11,16,16
1746590626430,MMW 12R,A02,892725,Herbst; Matthew,0,10,16,16
1746590627459,MMW 13R,A01,892727,Staff,0,4,16,16
1746590627459,MMW 13R,A02,892728,Staff,0,4,16,16
1746590627459,MMW 13R,A03,958032,Staff,0,4,16,16
1746590627459,MMW 13R,A04,958033,Staff,0,4,16,16
1746590627459,MMW 13R,A05,958034,Staff,0,4,16,16
1746590628484,SIO 295LS,A00,894015,Staff,5,0,25,20
1746590629526,SIO 295S,A00,894020,Staff,5,0,25,20
1746590630559,SIOC 290S,B01,958918,Merrifield; Mark A,14,0,30,16
1746590631590,SIOC 291S,B01,958922,Gabriel; Corey John,14,0,30,16
1746590632615,SOCI 117,A01,895339,Staff,3,0,5,2
1746590633639,WES 237B,A00,894149,Staff,11,0,20,9
1746590635708,AESE 279B,A00,891859,Staff,13,0,35,22
1746590636739,AIP 197,001,891854,Vespa; Emanuel Ignacio,9999,0,9999,0
1746590637763,ANTH 289S,A00,891856,Gagneux; Pascal,12,0,12,0
1746590638790,BENG 196,001,957946,Engler; Adam J.,9996,0,9999,3
1746590639817,BISP 197,001,959851,Wilhelm; James E.,9998,0,9999,1
1746590640841,CAT 124RS,A01,956906,Staff,6,0,25,19
1746590641866,CAT 125RS,A01,922013,Staff,6,0,25,19
1746590642893,CLRE 250,A00,891860,Morris; Sheldon,9995,0,9999,4
1746590644949,CLRE 251R,A00,907817,Mehta; Ravindra L.,9994,0,9999,5
1746590645975,CLRE 252,A00,891864,Cuomo; Raphael Eduardo,9993,0,9999,6
1746590647002,CLRE 253,A00,891867,Vaida; Florin,9994,0,9999,5
1746590647002,CLRE 253,B00,907819,Staff,9999,0,9999,0
1746590648032,CLRE 259,A00,891868,Patel; Hemal,9998,0,9999,1
1746590649057,CLRE 260,A00,891872,Cuomo; Raphael Eduardo,9999,0,9999,0
1746590650082,CLRE 297,001,891888,Cuomo; Raphael Eduardo,9999,0,9999,0
1746590651106,CSE 191,A00,958773,Minnes Kemp; Mor Mia,9995,0,9999,4
1746590652131,CSE 197,001,959846,Minnes Kemp; Mor Mia,9990,0,9999,9
1746590653162,CSS 201S,A01,892054,Mignozzetti; Umberto,25,0,30,5
1746590654195,CSS 202S,A01,892056,Mignozzetti; Umberto,25,0,30,5
1746590655223,DSC 197,001,956898,Eldridge; Justin Matthew,9996,0,9999,3
1746590656248,DSC 297,001,958000,Mazumdar; Arya,9998,0,9999,1
1746590656248,DSC 297,002,959862,Wang; Yusu,9998,0,9999,1
1746590657277,EAP 100,A00,905686,Staff,9778,0,9999,221
1746590658305,ECE 45,A01,892618,Staff,0,0,65,65
1746590660357,ECE 111,A01,892719,Staff,6,0,65,59
1746590661382,ECE 197,001,957920,Mercier; Patrick Philip,9991,0,9999,8
1746590662407,ECON 178,A01,907814,Zhu; Ying,26,0,35,9
1746590663431,EDS 115,A00,895312,Staff,35,0,45,10
1746590664457,EDS 117,A01,895337,Staff,23,0,30,7
1746590665485,EDS 125,A00,895341,Jones; Gabrielle Anastasia,36,0,45,9
1746590666513,EDS 128A,A01,895459,Fargason; Sharon Gayle,44,0,45,1
1746590667539,EDS 128B,A01,895543,Pappas; Elizabeth,44,0,45,1
1746590668565,EDS 139,A00,897203,Pappas; Elizabeth,44,0,45,1
1746590668565,EDS 139,B00,897209,Fargason; Sharon Gayle,41,0,45,4
1746590669589,EDS 201,A00,895545,Staff,22,0,45,23
1746590670617,EDS 203,A01,895581,Halter; Christopher P.,22,0,45,23
1746590671646,EDS 204R,A01,895625,Heinzman; Erica M.,39,0,45,6
1746590671646,EDS 204R,B01,895693,Halter; Christopher P.,10,0,45,35
1746590672669,EDS 206R,A00,895694,Fargason; Sharon Gayle,1,0,30,29
1746590672669,EDS 206R,B00,895695,Choi; Bailey Miyeon,16,0,30,14
1746590673697,EDS 250,A00,895697,Hemans; Patricia Ann Benitez,22,0,45,23
1746590674724,EDS 281,A00,895701,Meyerott; Theresa Ann,1,0,15,14
1746590675750,EDS 284,A00,895736,Meyerott; Theresa Ann,1,0,15,14
1746590676777,EDS 286,A00,897210,Fine; Sarah,0,0,15,15
1746590677803,EDS 289C,A01,895770,Daly; Alan J.,1,0,15,14
1746590678828,EDS 290,A00,897211,Hofstetter; Carolyn,0,0,15,15
1746590679854,LIGM 5A,A00,896162,Fischer-Grunski; Eva K,12,0,20,8
1746590680881,LIGM 5B,A00,896260,Fischer-Grunski; Eva K,17,0,20,3
1746590681908,LIGM 5C,A00,896308,Fischer-Grunski; Eva K,18,0,20,2
1746590682935,LIIT 5AS,A00,896313,Carnelos; Chiara,18,0,20,2
1746590683960,LIIT 5BS,A00,896416,Carnelos; Chiara,20,0,20,0
1746590684989,LIIT 5CS,A00,896564,Carnelos; Chiara,20,0,20,0
1746590686017,LISP 5A,A00,896588,Munoz Sanchez; Alicia,2,0,20,18
1746590687045,LISP 5B,A00,896653,Munoz Sanchez; Alicia,7,0,20,13
1746590688074,LISP 5C,A00,896655,Munoz Sanchez; Alicia,0,1,20,20
1746590689099,MAE 197,001,957918,Kleissl; Jan,9996,0,9999,3
1746590689099,MAE 197,002,959806,Boechler; Nicholas Sebastia,9998,0,9999,1
1746590689099,MAE 197,003,959852,Mullin; Jennifer S,9998,0,9999,1
1746590690126,MATH 2,A01,957937,Staff,33,0,35,2
1746590691153,MATH 197,001,957876,Kedlaya; Kiran S.,9993,0,9999,6
1746590692179,MCWP 40,A00,892729,Duru; Nur,10,0,20,10
1746590692179,MCWP 40,B00,893304,Montejo; Carolina,14,0,20,6
1746590693206,MCWP 40R,A00,893757,Redela; Pamela Morgan,0,5,20,20
1746590694235,MCWP 50,A00,893758,Morshed; Michael James,0,0,20,20
1746590694235,MCWP 50,B00,893761,Bartulis; Jason Michael,17,0,20,3
1746590695261,MCWP 50R,A00,893766,Compas; Sean Matthew,0,1,20,20
1746590695261,MCWP 50R,B00,893769,Carter; Jennifer A,0,1,20,20
1746590695261,MCWP 50R,C00,893771,Krone; Jarret,0,3,20,20
1746590695261,MCWP 50R,D00,893772,Miller; Elizabeth Deen,0,0,20,20
1746590695261,MCWP 50R,E00,893775,Carter; Andrea L,0,1,20,20
1746590696287,MMW 11R,A01,892721,Herbst; Matthew,14,0,30,16
1746590696287,MMW 11R,A02,892722,Herbst; Matthew,0,0,0,3
1746590697312,MMW 12R,A01,892724,Herbst; Matthew,0,11,16,16
1746590697312,MMW 12R,A02,892725,Herbst; Matthew,0,10,16,16
1746590698338,MMW 13R,A01,892727,Staff,0,4,16,16
1746590698338,MMW 13R,A02,892728,Staff,0,4,16,16
1746590698338,MMW 13R,A03,958032,Staff,0,4,16,16
1746590698338,MMW 13R,A04,958033,Staff,0,4,16,16
1746590698338,MMW 13R,A05,958034,Staff,0,4,16,16
1746590699364,SIO 295LS,A00,894015,Staff,5,0,25,20
1746590700391,SIO 295S,A00,894020,Staff,5,0,25,20
1746590701422,SIOC 290S,B01,958918,Merrifield; Mark A,14,0,30,16
1746590702448,SIOC 291S,B01,958922,Gabriel; Corey John,14,0,30,16
1746590703474,SOCI 117,A01,895339,Staff,3,0,5,2
1746590704505,WES 237B,A00,894149,Staff,11,0,20,9
1746590706579,AESE 279B,A00,891859,Staff,13,0,35,22
1746590707605,AIP 197,001,891854,Vespa; Emanuel Ignacio,9999,0,9999,0
1746590708631,ANTH 289S,A00,891856,Gagneux; Pascal,12,0,12,0
1746590709657,BENG 196,001,957946,Engler; Adam J.,9996,0,9999,3
1746590710684,BISP 197,001,959851,Wilhelm; James E.,9998,0,9999,1
1746590711710,CAT 124RS,A01,956906,Staff,6,0,25,19
1746590712740,CAT 125RS,A01,922013,Staff,6,0,25,19
1746590713766,CLRE 250,A00,891860,Morris; Sheldon,9995,0,9999,4
1746590715820,CLRE 251R,A00,907817,Mehta; Ravindra L.,9994,0,9999,5
1746590716845,CLRE 252,A00,891864,Cuomo; Raphael Eduardo,9993,0,9999,6
1746590717872,CLRE 253,A00,891867,Vaida; Florin,9994,0,9999,5
1746590717872,CLRE 253,B00,907819,Staff,9999,0,9999,0
1746590718898,CLRE 259,A00,891868,Patel; Hemal,9998,0,9999,1
1746590719925,CLRE 260,A00,891872,Cuomo; Raphael Eduardo,9999,0,9999,0
1746590720952,CLRE 297,001,891888,Cuomo; Raphael Eduardo,9999,0,9999,0
1746590721976,CSE 191,A00,958773,Minnes Kemp; Mor Mia,9995,0,9999,4
1746590723003,CSE 197,001,959846,Minnes Kemp; Mor Mia,9990,0,9999,9
1746590724030,CSS 201S,A01,892054,Mignozzetti; Umberto,25,0,30,5
1746590725054,CSS 202S,A01,892056,Mignozzetti; Umberto,25,0,30,5
1746590726081,DSC 197,001,956898,Eldridge; Justin Matthew,9996,0,9999,3
1746590727105,DSC 297,001,958000,Mazumdar; Arya,9998,0,9999,1
1746590727105,DSC 297,002,959862,Wang; Yusu,9998,0,9999,1
1746590728131,EAP 100,A00,905686,Staff,9778,0,9999,221
1746590729161,ECE 45,A01,892618,Staff,0,0,65,65
1746590731218,ECE 111,A01,892719,Staff,6,0,65,59
1746590732243,ECE 197,001,957920,Mercier; Patrick Philip,9991,0,9999,8
1746590733269,ECON 178,A01,907814,Zhu; Ying,26,0,35,9
1746590734294,EDS 115,A00,895312,Staff,35,0,45,10
1746590735319,EDS 117,A01,895337,Staff,23,0,30,7
1746590736344,EDS 125,A00,895341,Jones; Gabrielle Anastasia,36,0,45,9
1746590737369,EDS 128A,A01,895459,Fargason; Sharon Gayle,44,0,45,1
1746590738396,EDS 128B,A01,895543,Pappas; Elizabeth,44,0,45,1
1746590739425,EDS 139,A00,897203,Pappas; Elizabeth,44,0,45,1
1746590739425,EDS 139,B00,897209,Fargason; Sharon Gayle,41,0,45,4
1746590740451,EDS 201,A00,895545,Staff,22,0,45,23
1746590741479,EDS 203,A01,895581,Halter; Christopher P.,22,0,45,23
1746590742506,EDS 204R,A01,895625,Heinzman; Erica M.,39,0,45,6
1746590742506,EDS 204R,B01,895693,Halter; Christopher P.,10,0,45,35
1746590743534,EDS 206R,A00,895694,Fargason; Sharon Gayle,1,0,30,29
1746590743534,EDS 206R,B00,895695,Choi; Bailey Miyeon,16,0,30,14
1746590744564,EDS 250,A00,895697,Hemans; Patricia Ann Benitez,22,0,45,23
1746590745589,EDS 281,A00,895701,Meyerott; Theresa Ann,1,0,15,14
1746590746617,EDS 284,A00,895736,Meyerott; Theresa Ann,1,0,15,14
1746590747645,EDS 286,A00,897210,Fine; Sarah,0,0,15,15
1746590748674,EDS 289C,A01,895770,Daly; Alan J.,1,0,15,14
1746590749701,EDS 290,A00,897211,Hofstetter; Carolyn,0,0,15,15
1746590750731,LIGM 5A,A00,896162,Fischer-Grunski; Eva K,12,0,20,8
1746590751756,LIGM 5B,A00,896260,Fischer-Grunski; Eva K,17,0,20,3
1746590752783,LIGM 5C,A00,896308,Fischer-Grunski; Eva K,18,0,20,2
1746590753812,LIIT 5AS,A00,896313,Carnelos; Chiara,18,0,20,2
1746590754837,LIIT 5BS,A00,896416,Carnelos; Chiara,20,0,20,0
1746590755867,LIIT 5CS,A00,896564,Carnelos; Chiara,20,0,20,0
1746590756893,LISP 5A,A00,896588,Munoz Sanchez; Alicia,2,0,20,18
1746590757919,LISP 5B,A00,896653,Munoz Sanchez; Alicia,7,0,20,13
1746590758947,LISP 5C,A00,896655,Munoz Sanchez; Alicia,0,1,20,20
1746590759973,MAE 197,001,957918,Kleissl; Jan,9996,0,9999,3
1746590759973,MAE 197,002,959806,Boechler; Nicholas Sebastia,9998,0,9999,1
1746590759973,MAE 197,003,959852,Mullin; Jennifer S,9998,0,9999,1
1746590761002,MATH 2,A01,957937,Staff,33,0,35,2
1746590762034,MATH 197,001,957876,Kedlaya; Kiran S.,9993,0,9999,6
1746590763059,MCWP 40,A00,892729,Duru; Nur,10,0,20,10
1746590763059,MCWP 40,B00,893304,Montejo; Carolina,14,0,20,6
1746590764088,MCWP 40R,A00,893757,Redela; Pamela Morgan,0,5,20,20
1746590765113,MCWP 50,A00,893758,Morshed; Michael James,0,0,20,20
1746590765113,MCWP 50,B00,893761,Bartulis; Jason Michael,17,0,20,3
1746590766142,MCWP 50R,A00,893766,Compas; Sean Matthew,0,1,20,20
1746590766142,MCWP 50R,B00,893769,Carter; Jennifer A,0,1,20,20
1746590766142,MCWP 50R,C00,893771,Krone; Jarret,0,3,20,20
1746590766142,MCWP 50R,D00,893772,Miller; Elizabeth Deen,0,0,20,20
1746590766142,MCWP 50R,E00,893775,Carter; Andrea L,0,1,20,20
1746590767169,MMW 11R,A01,892721,Herbst; Matthew,14,0,30,16
1746590767169,MMW 11R,A02,892722,Herbst; Matthew,0,0,0,3
1746590768194,MMW 12R,A01,892724,Herbst; Matthew,0,11,16,16
1746590768194,MMW 12R,A02,892725,Herbst; Matthew,0,10,16,16
1746590769223,MMW 13R,A01,892727,Staff,0,4,16,16
1746590769223,MMW 13R,A02,892728,Staff,0,4,16,16
1746590769223,MMW 13R,A03,958032,Staff,0,4,16,16
1746590769223,MMW 13R,A04,958033,Staff,0,4,16,16
1746590769223,MMW 13R,A05,958034,Staff,0,4,16,16
1746590770252,SIO 295LS,A00,894015,Staff,5,0,25,20
1746590771278,SIO 295S,A00,894020,Staff,5,0,25,20
1746590772305,SIOC 290S,B01,958918,Merrifield; Mark A,14,0,30,16
1746590773332,SIOC 291S,B01,958922,Gabriel; Corey John,14,0,30,16
1746590774361,SOCI 117,A01,895339,Staff,3,0,5,2
1746590775387,WES 237B,A00,894149,Staff,11,0,20,9
1746590777459,AESE 279B,A00,891859,Staff,13,0,35,22
1746590778485,AIP 197,001,891854,Vespa; Emanuel Ignacio,9999,0,9999,0
1746590779510,ANTH 289S,A00,891856,Gagneux; Pascal,12,0,12,0
1746590780536,BENG 196,001,957946,Engler; Adam J.,9996,0,9999,3
1746590781563,BISP 197,001,959851,Wilhelm; James E.,9998,0,9999,1
1746590782589,CAT 124RS,A01,956906,Staff,6,0,25,19
1746590783614,CAT 125RS,A01,922013,Staff,6,0,25,19
1746590784643,CLRE 250,A00,891860,Morris; Sheldon,9995,0,9999,4
1746590786698,CLRE 251R,A00,907817,Mehta; Ravindra L.,9994,0,9999,5
1746590787727,CLRE 252,A00,891864,Cuomo; Raphael Eduardo,9993,0,9999,6
1746590788753,CLRE 253,A00,891867,Vaida; Florin,9994,0,9999,5
1746590788753,CLRE 253,B00,907819,Staff,9999,0,9999,0
1746590789783,CLRE 259,A00,891868,Patel; Hemal,9998,0,9999,1
1746590790812,CLRE 260,A00,891872,Cuomo; Raphael Eduardo,9999,0,9999,0
1746590791860,CLRE 297,001,891888,Cuomo; Raphael Eduardo,9999,0,9999,0
1746590792890,CSE 191,A00,958773,Minnes Kemp; Mor Mia,9995,0,9999,4
1746590793918,CSE 197,001,959846,Minnes Kemp; Mor Mia,9990,0,9999,9
1746590794948,CSS 201S,A01,892054,Mignozzetti; Umberto,25,0,30,5
1746590795974,CSS 202S,A01,892056,Mignozzetti; Umberto,25,0,30,5
1746590797001,DSC 197,001,956898,Eldridge; Justin Matthew,9996,0,9999,3
1746590798029,DSC 297,001,958000,Mazumdar; Arya,9998,0,9999,1
1746590798029,DSC 297,002,959862,Wang; Yusu,9998,0,9999,1
1746590799055,EAP 100,A00,905686,Staff,9778,0,9999,221
1746590800081,ECE 45,A01,892618,Staff,0,0,65,65
1746590802136,ECE 111,A01,892719,Staff,6,0,65,59
1746590803163,ECE 197,001,957920,Mercier; Patrick Philip,9991,0,9999,8
1746590804190,ECON 178,A01,907814,Zhu; Ying,26,0,35,9
1746590805215,EDS 115,A00,895312,Staff,35,0,45,10
1746590806242,EDS 117,A01,895337,Staff,23,0,30,7
1746590807269,EDS 125,A00,895341,Jones; Gabrielle Anastasia,36,0,45,9
1746590808296,EDS 128A,A01,895459,Fargason; Sharon Gayle,44,0,45,1
1746590809322,EDS 128B,A01,895543,Pappas; Elizabeth,44,0,45,1
1746590810353,EDS 139,A00,897203,Pappas; Elizabeth,44,0,45,1
1746590810353,EDS 139,B00,897209,Fargason; Sharon Gayle,41,0,45,4
1746590811380,EDS 201,A00,895545,Staff,22,0,45,23
1746590812410,EDS 203,A01,895581,Halter; Christopher P.,22,0,45,23
1746590813436,EDS 204R,A01,895625,Heinzman; Erica M.,39,0,45,6
1746590813436,EDS 204R,B01,895693,Halter; Christopher P.,10,0,45,35
1746590814466,EDS 206R,A00,895694,Fargason; Sharon Gayle,1,0,30,29
1746590814466,EDS 206R,B00,895695,Choi; Bailey Miyeon,16,0,30,14
1746590815492,EDS 250,A00,895697,Hemans; Patricia Ann Benitez,22,0,45,23
1746590816518,EDS 281,A00,895701,Meyerott; Theresa Ann,1,0,15,14
1746590817542,EDS 284,A00,895736,Meyerott; Theresa Ann,1,0,15,14
1746590818569,EDS 286,A00,897210,Fine; Sarah,0,0,15,15
1746590819595,EDS 289C,A01,895770,Daly; Alan J.,1,0,15,14
1746590820620,EDS 290,A00,897211,Hofstetter; Carolyn,0,0,15,15
1746590821649,LIGM 5A,A00,896162,Fischer-Grunski; Eva K,12,0,20,8
1746590822680,LIGM 5B,A00,896260,Fischer-Grunski; Eva K,17,0,20,3
1746590823709,LIGM 5C,A00,896308,Fischer-Grunski; Eva K,18,0,20,2
1746590824735,LIIT 5AS,A00,896313,Carnelos; Chiara,18,0,20,2
1746590825763,LIIT 5BS,A00,896416,Carnelos; Chiara,20,0,20,0
1746590826787,LIIT 5CS,A00,896564,Carnelos; Chiara,20,0,20,0
1746590827814,LISP 5A,A00,896588,Munoz Sanchez; Alicia,2,0,20,18
1746590828841,LISP 5B,A00,896653,Munoz Sanchez; Alicia,7,0,20,13
1746590829870,LISP 5C,A00,896655,Munoz Sanchez; Alicia,0,1,20,20
1746590830901,MAE 197,001,957918,Kleissl; Jan,9996,0,9999,3
1746590830901,MAE 197,002,959806,Boechler; Nicholas Sebastia,9998,0,9999,1
1746590830901,MAE 197,003,959852,Mullin; Jennifer S,9998,0,9999,1
1746590831930,MATH 2,A01,957937,Staff,33,0,35,2
1746590832955,MATH 197,001,957876,Kedlaya; Kiran S.,9993,0,9999,6
1746590833980,MCWP 40,A00,892729,Duru; Nur,10,0,20,10
1746590833980,MCWP 40,B00,893304,Montejo; Carolina,14,0,20,6
1746590835005,MCWP 40R,A00,893757,Redela; Pamela Morgan,0,5,20,20
1746590836034,MCWP 50,A00,893758,Morshed; Michael James,0,0,20,20
1746590836034,MCWP 50,B00,893761,Bartulis; Jason Michael,17,0,20,3
1746590837061,MCWP 50R,A00,893766,Compas; Sean Matthew,0,1,20,20
1746590837061,MCWP 50R,B00,893769,Carter; Jennifer A,0,1,20,20
1746590837061,MCWP 50R,C00,893771,Krone; Jarret,0,3,20,20
1746590837061,MCWP 50R,D00,893772,Miller; Elizabeth Deen,0,0,20,20
1746590837061,MCWP 50R,E00,893775,Carter; Andrea L,0,1,20,20
1746590838091,MMW 11R,A01,892721,Herbst; Matthew,14,0,30,16
1746590838091,MMW 11R,A02,892722,Herbst; Matthew,0,0,0,3
1746590839118,MMW 12R,A01,892724,Herbst; Matthew,0,11,16,16
1746590839118,MMW 12R,A02,892725,Herbst; Matthew,0,10,16,16
1746590840144,MMW 13R,A01,892727,Staff,0,4,16,16
1746590840144,MMW 13R,A02,892728,Staff,0,4,16,16
1746590840144,MMW 13R,A03,958032,Staff,0,4,16,16
1746590840144,MMW 13R,A04,958033,Staff,0,4,16,16
1746590840144,MMW 13R,A05,958034,Staff,0,4,16,16
1746590841174,SIO 295LS,A00,894015,Staff,5,0,25,20
1746590842200,SIO 295S,A00,894020,Staff,5,0,25,20
1746590843226,SIOC 290S,B01,958918,Merrifield; Mark A,14,0,30,16
1746590844251,SIOC 291S,B01,958922,Gabriel; Corey John,14,0,30,16
1746590845276,SOCI 117,A01,895339,Staff,3,0,5,2
1746590846302,WES 237B,A00,894149,Staff,11,0,20,9
1746590848405,AESE 279B,A00,891859,Staff,13,0,35,22
1746590849430,AIP 197,001,891854,Vespa; Emanuel Ignacio,9999,0,9999,0
1746590850455,ANTH 289S,A00,891856,Gagneux; Pascal,12,0,12,0
1746590851481,BENG 196,001,957946,Engler; Adam J.,9996,0,9999,3
1746590852509,BISP 197,001,959851,Wilhelm; James E.,9998,0,9999,1
1746590853536,CAT 124RS,A01,956906,Staff,6,0,25,19
1746590854563,CAT 125RS,A01,922013,Staff,6,0,25,19
1746590855588,CLRE 250,A00,891860,Morris; Sheldon,9995,0,9999,4
1746590857638,CLRE 251R,A00,907817,Mehta; Ravindra L.,9994,0,9999,5
1746590858662,CLRE 252,A00,891864,Cuomo; Raphael Eduardo,9993,0,9999,6
1746590859691,CLRE 253,A00,891867,Vaida; Florin,9994,0,9999,5
1746590859691,CLRE 253,B00,907819,Staff,9999,0,9999,0
1746590860718,CLRE 259,A00,891868,Patel; Hemal,9998,0,9999,1
1746590861745,CLRE 260,A00,891872,Cuomo; Raphael Eduardo,9999,0,9999,0
1746590862771,CLRE 297,001,891888,Cuomo; Raphael Eduardo,9999,0,9999,0
1746590863797,CSE 191,A00,958773,Minnes Kemp; Mor Mia,9995,0,9999,4
1746590864823,CSE 197,001,959846,Minnes Kemp; Mor Mia,9990,0,9999,9
1746590865848,CSS 201S,A01,892054,Mignozzetti; Umberto,25,0,30,5
1746590866872,CSS 202S,A01,892056,Mignozzetti; Umberto,25,0,30,5
1746590867901,DSC 197,001,956898,Eldridge; Justin Matthew,9996,0,9999,3
1746590868930,DSC 297,001,958000,Mazumdar; Arya,9998,0,9999,1
1746590868930,DSC 297,002,959862,Wang; Yusu,9998,0,9999,1
1746590869958,EAP 100,A00,905686,Staff,9778,0,9999,221
1746590870991,ECE 45,A01,892618,Staff,0,0,65,65
1746590873046,ECE 111,A01,892719,Staff,6,0,65,59
1746590874074,ECE 197,001,957920,Mercier; Patrick Philip,9991,0,9999,8
1746590875099,ECON 178,A01,907814,Zhu; Ying,26,0,35,9
1746590876125,EDS 115,A00,895312,Staff,35,0,45,10
1746590877153,EDS 117,A01,895337,Staff,23,0,30,7
1746590878180,EDS 125,A00,895341,Jones; Gabrielle Anastasia,36,0,45,9
1746590879206,EDS 128A,A01,895459,Fargason; Sharon Gayle,44,0,45,1
1746590880237,EDS 128B,A01,895543,Pappas; Elizabeth,44,0,45,1
1746590881264,EDS 139,A00,897203,Pappas; Elizabeth,44,0,45,1
1746590881264,EDS 139,B00,897209,Fargason; Sharon Gayle,41,0,45,4
1746590882295,EDS 201,A00,895545,Staff,22,0,45,23
1746590883324,EDS 203,A01,895581,Halter; Christopher P.,22,0,45,23
1746590884353,EDS 204R,A01,895625,Heinzman; Erica M.,39,0,45,6
1746590884353,EDS 204R,B01,895693,Halter; Christopher P.,10,0,45,35
1746590885381,EDS 206R,A00,895694,Fargason; Sharon Gayle,1,0,30,29
1746590885381,EDS 206R,B00,895695,Choi; Bailey Miyeon,16,0,30,14
1746590886405,EDS 250,A00,895697,Hemans; Patricia Ann Benitez,22,0,45,23
1746590887429,EDS 281,A00,895701,Meyerott; Theresa Ann,1,0,15,14
1746590888459,EDS 284,A00,895736,Meyerott; Theresa Ann,1,0,15,14
1746590889485,EDS 286,A00,897210,Fine; Sarah,0,0,15,15
1746590890511,EDS 289C,A01,895770,Daly; Alan J.,1,0,15,14
1746590891539,EDS 290,A00,897211,Hofstetter; Carolyn,0,0,15,15
1746590892565,LIGM 5A,A00,896162,Fischer-Grunski; Eva K,12,0,20,8
1746590893590,LIGM 5B,A00,896260,Fischer-Grunski; Eva K,17,0,20,3
1746590894620,LIGM 5C,A00,896308,Fischer-Grunski; Eva K,18,0,20,2
1746590895647,LIIT 5AS,A00,896313,Carnelos; Chiara,18,0,20,2
1746590896677,LIIT 5BS,A00,896416,Carnelos; Chiara,20,0,20,0
1746590897704,LIIT 5CS,A00,896564,Carnelos; Chiara,20,0,20,0
1746590898734,LISP 5A,A00,896588,Munoz Sanchez; Alicia,2,0,20,18
1746590899760,LISP 5B,A00,896653,Munoz Sanchez; Alicia,7,0,20,13
1746590900789,LISP 5C,A00,896655,Munoz Sanchez; Alicia,0,1,20,20
1746590901818,MAE 197,001,957918,Kleissl; Jan,9996,0,9999,3
1746590901818,MAE 197,002,959806,Boechler; Nicholas Sebastia,9998,0,9999,1
1746590901818,MAE 197,003,959852,Mullin; Jennifer S,9998,0,9999,1
1746590902843,MATH 2,A01,957937,Staff,33,0,35,2
1746590903869,MATH 197,001,957876,Kedlaya; Kiran S.,9993,0,9999,6
1746590904894,MCWP 40,A00,892729,Duru; Nur,10,0,20,10
1746590904894,MCWP 40,B00,893304,Montejo; Carolina,14,0,20,6
1746590905921,MCWP 40R,A00,893757,Redela; Pamela Morgan,0,5,20,20
1746590906948,MCWP 50,A00,893758,Morshed; Michael James,0,0,20,20
1746590906948,MCWP 50,B00,893761,Bartulis; Jason Michael,17,0,20,3
1746590907973,MCWP 50R,A00,893766,Compas; Sean Matthew,0,1,20,20
1746590907973,MCWP 50R,B00,893769,Carter; Jennifer A,0,1,20,20
1746590907973,MCWP 50R,C00,893771,Krone; Jarret,0,3,20,20
1746590907973,MCWP 50R,D00,893772,Miller; Elizabeth Deen,0,0,20,20
1746590907973,MCWP 50R,E00,893775,Carter; Andrea L,0,1,20,20
1746590909004,MMW 11R,A01,892721,Herbst; Matthew,14,0,30,16
1746590909004,MMW 11R,A02,892722,Herbst; Matthew,0,0,0,3
1746590910029,MMW 12R,A01,892724,Herbst; Matthew,0,11,16,16
1746590910029,MMW 12R,A02,892725,Herbst; Matthew,0,10,16,16
1746590911054,MMW 13R,A01,892727,Staff,0,4,16,16
1746590911054,MMW 13R,A02,892728,Staff,0,4,16,16
1746590911054,MMW 13R,A03,958032,Staff,0,4,16,16
1746590911054,MMW 13R,A04,958033,Staff,0,4,16,16
1746590911054,MMW 13R,A05,958034,Staff,0,4,16,16
1746590912083,SIO 295LS,A00,894015,Staff,5,0,25,20
1746590913110,SIO 295S,A00,894020,Staff,5,0,25,20
1746590914138,SIOC 290S,B01,958918,Merrifield; Mark A,14,0,30,16
1746590915169,SIOC 291S,B01,958922,Gabriel; Corey John,14,0,30,16
1746590916195,SOCI 117,A01,895339,Staff,3,0,5,2
1746590917222,WES 237B,A00,894149,Staff,11,0,20,9
1746590919282,AESE 279B,A00,891859,Staff,13,0,35,22
1746590920309,AIP 197,001,891854,Vespa; Emanuel Ignacio,9999,0,9999,0
1746590921335,ANTH 289S,A00,891856,Gagneux; Pascal,12,0,12,0
1746590922361,BENG 196,001,957946,Engler; Adam J.,9996,0,9999,3
1746590923387,BISP 197,001,959851,Wilhelm; James E.,9998,0,9999,1
1746590924416,CAT 124RS,A01,956906,Staff,6,0,25,19
1746590925444,CAT 125RS,A01,922013,Staff,6,0,25,19
1746590926470,CLRE 250,A00,891860,Morris; Sheldon,9995,0,9999,4
1746590928526,CLRE 251R,A00,907817,Mehta; Ravindra L.,9994,0,9999,5
1746590929553,CLRE 252,A00,891864,Cuomo; Raphael Eduardo,9993,0,9999,6
1746590930580,CLRE 253,A00,891867,Vaida; Florin,9994,0,9999,5
1746590930580,CLRE 253,B00,907819,Staff,9999,0,9999,0
1746590931605,CLRE 259,A00,891868,Patel; Hemal,9998,0,9999,1
1746590932635,CLRE 260,A00,891872,Cuomo; Raphael Eduardo,9999,0,9999,0
1746590933662,CLRE 297,001,891888,Cuomo; Raphael Eduardo,9999,0,9999,0
1746590934688,CSE 191,A00,958773,Minnes Kemp; Mor Mia,9995,0,9999,4
1746590935713,CSE 197,001,959846,Minnes Kemp; Mor Mia,9990,0,9999,9
1746590936745,CSS 201S,A01,892054,Mignozzetti; Umberto,25,0,30,5
1746590937777,CSS 202S,A01,892056,Mignozzetti; Umberto,25,0,30,5
1746590938803,DSC 197,001,956898,Eldridge; Justin Matthew,9996,0,9999,3
1746590939830,DSC 297,001,958000,Mazumdar; Arya,9998,0,9999,1
1746590939830,DSC 297,002,959862,Wang; Yusu,9998,0,9999,1
1746590940859,EAP 100,A00,905686,Staff,9778,0,9999,221
1746590941889,ECE 45,A01,892618,Staff,0,0,65,65
1746590943941,ECE 111,A01,892719,Staff,6,0,65,59
1746590944967,ECE 197,001,957920,Mercier; Patrick Philip,9991,0,9999,8
1746590945997,ECON 178,A01,907814,Zhu; Ying,26,0,35,9
1746590947022,EDS 115,A00,895312,Staff,35,0,45,10
1746590948050,EDS 117,A01,895337,Staff,23,0,30,7
1746590949078,EDS 125,A00,895341,Jones; Gabrielle Anastasia,36,0,45,9
1746590950109,EDS 128A,A01,895459,Fargason; Sharon Gayle,44,0,45,1
1746590951135,EDS 128B,A01,895543,Pappas; Elizabeth,44,0,45,1
1746590952164,EDS 139,A00,897203,Pappas; Elizabeth,44,0,45,1
1746590952164,EDS 139,B00,897209,Fargason; Sharon Gayle,41,0,45,4
1746590953191,EDS 201,A00,895545,Staff,22,0,45,23
1746590954217,EDS 203,A01,895581,Halter; Christopher P.,22,0,45,23
1746590955243,EDS 204R,A01,895625,Heinzman; Erica M.,39,0,45,6
1746590955243,EDS 204R,B01,895693,Halter; Christopher P.,10,0,45,35
1746590956268,EDS 206R,A00,895694,Fargason; Sharon Gayle,1,0,30,29
1746590956268,EDS 206R,B00,895695,Choi; Bailey Miyeon,16,0,30,14
1746590957296,EDS 250,A00,895697,Hemans; Patricia Ann Benitez,22,0,45,23
1746590958323,EDS 281,A00,895701,Meyerott; Theresa Ann,1,0,15,14
1746590959347,EDS 284,A00,895736,Meyerott; Theresa Ann,1,0,15,14
1746590960372,EDS 286,A00,897210,Fine; Sarah,0,0,15,15
1746590961398,EDS 289C,A01,895770,Daly; Alan J.,1,0,15,14
1746590962425,EDS 290,A00,897211,Hofstetter; Carolyn,0,0,15,15
1746590963451,LIGM 5A,A00,896162,Fischer-Grunski; Eva K,12,0,20,8
1746590964477,LIGM 5B,A00,896260,Fischer-Grunski; Eva K,17,0,20,3
1746590965508,LIGM 5C,A00,896308,Fischer-Grunski; Eva K,18,0,20,2
1746590966534,LIIT 5AS,A00,896313,Carnelos; Chiara,18,0,20,2
1746590967562,LIIT 5BS,A00,896416,Carnelos; Chiara,20,0,20,0
1746590968588,LIIT 5CS,A00,896564,Carnelos; Chiara,20,0,20,0
1746590969618,LISP 5A,A00,896588,Munoz Sanchez; Alicia,2,0,20,18
1746590970643,LISP 5B,A00,896653,Munoz Sanchez; Alicia,7,0,20,13
1746590971670,LISP 5C,A00,896655,Munoz Sanchez; Alicia,0,1,20,20
1746590972699,MAE 197,001,957918,Kleissl; Jan,9996,0,9999,3
1746590972699,MAE 197,002,959806,Boechler; Nicholas Sebastia,9998,0,9999,1
1746590972699,MAE 197,003,959852,Mullin; Jennifer S,9998,0,9999,1
1746590973728,MATH 2,A01,957937,Staff,33,0,35,2
1746590974754,MATH 197,001,957876,Kedlaya; Kiran S.,9993,0,9999,6
1746590975780,MCWP 40,A00,892729,Duru; Nur,10,0,20,10
1746590975780,MCWP 40,B00,893304,Montejo; Carolina,14,0,20,6
1746590976808,MCWP 40R,A00,893757,Redela; Pamela Morgan,0,5,20,20
1746590977839,MCWP 50,A00,893758,Morshed; Michael James,0,0,20,20
1746590977839,MCWP 50,B00,893761,Bartulis; Jason Michael,17,0,20,3
1746590978865,MCWP 50R,A00,893766,Compas; Sean Matthew,0,1,20,20
1746590978865,MCWP 50R,B00,893769,Carter; Jennifer A,0,1,20,20
1746590978865,MCWP 50R,C00,893771,Krone; Jarret,0,3,20,20
1746590978865,MCWP 50R,D00,893772,Miller; Elizabeth Deen,0,0,20,20
1746590978865,MCWP 50R,E00,893775,Carter; Andrea L,0,1,20,20
1746590979890,MMW 11R,A01,892721,Herbst; Matthew,14,0,30,16
1746590979890,MMW 11R,A02,892722,Herbst; Matthew,0,0,0,3
1746590980917,MMW 12R,A01,892724,Herbst; Matthew,0,11,16,16
1746590980917,MMW 12R,A02,892725,Herbst; Matthew,0,10,16,16
1746590981947,MMW 13R,A01,892727,Staff,0,4,16,16
1746590981947,MMW 13R,A02,892728,Staff,0,4,16,16
1746590981947,MMW 13R,A03,958032,Staff,0,4,16,16
1746590981947,MMW 13R,A04,958033,Staff,0,4,16,16
1746590981947,MMW 13R,A05,958034,Staff,0,4,16,16
1746590982972,SIO 295LS,A00,894015,Staff,5,0,25,20
1746590983999,SIO 295S,A00,894020,Staff,5,0,25,20
1746590985028,SIOC 290S,B01,958918,Merrifield; Mark A,14,0,30,16
1746590986060,SIOC 291S,B01,958922,Gabriel; Corey John,14,0,30,16
1746590987085,SOCI 117,A01,895339,Staff,3,0,5,2
1746590988113,WES 237B,A00,894149,Staff,11,0,20,9
1746590990173,AESE 279B,A00,891859,Staff,13,0,35,22
1746590991199,AIP 197,001,891854,Vespa; Emanuel Ignacio,9999,0,9999,0
1746590992230,ANTH 289S,A00,891856,Gagneux; Pascal,12,0,12,0
1746590993257,BENG 196,001,957946,Engler; Adam J.,9996,0,9999,3
1746590994285,BISP 197,001,959851,Wilhelm; James E.,9998,0,9999,1
1746590995310,CAT 124RS,A01,956906,Staff,6,0,25,19
1746590996335,CAT 125RS,A01,922013,Staff,6,0,25,19
1746590997364,CLRE 250,A00,891860,Morris; Sheldon,9995,0,9999,4
1746590999414,CLRE 251R,A00,907817,Mehta; Ravindra L.,9994,0,9999,5
1746591000440,CLRE 252,A00,891864,Cuomo; Raphael Eduardo,9993,0,9999,6
1746591001465,CLRE 253,A00,891867,Vaida; Florin,9994,0,9999,5
1746591001465,CLRE 253,B00,907819,Staff,9999,0,9999,0
1746591002496,CLRE 259,A00,891868,Patel; Hemal,9998,0,9999,1
1746591003522,CLRE 260,A00,891872,Cuomo; Raphael Eduardo,9999,0,9999,0
1746591004548,CLRE 297,001,891888,Cuomo; Raphael Eduardo,9999,0,9999,0
1746591005574,CSE 191,A00,958773,Minnes Kemp; Mor Mia,9995,0,9999,4
1746591006601,CSE 197,001,959846,Minnes Kemp; Mor Mia,9990,0,9999,9
1746591007626,CSS 201S,A01,892054,Mignozzetti; Umberto,25,0,30,5
1746591008656,CSS 202S,A01,892056,Mignozzetti; Umberto,25,0,30,5
1746591009682,DSC 197,001,956898,Eldridge; Justin Matthew,9996,0,9999,3
1746591010707,DSC 297,001,958000,Mazumdar; Arya,9998,0,9999,1
1746591010707,DSC 297,002,959862,Wang; Yusu,9998,0,9999,1
1746591011731,EAP 100,A00,905686,Staff,9778,0,9999,221
1746591012757,ECE 45,A01,892618,Staff,0,0,65,65
1746591014814,ECE 111,A01,892719,Staff,6,0,65,59
1746591015838,ECE 197,001,957920,Mercier; Patrick Philip,9991,0,9999,8
1746591016869,ECON 178,A01,907814,Zhu; Ying,26,0,35,9
1746591017896,EDS 115,A00,895312,Staff,35,0,45,10
1746591018966,EDS 117,A01,895337,Staff,23,0,30,7
1746591019999,EDS 125,A00,895341,Jones; Gabrielle Anastasia,36,0,45,9
1746591021028,EDS 128A,A01,895459,Fargason; Sharon Gayle,44,0,45,1
1746591022057,EDS 128B,A01,895543,Pappas; Elizabeth,44,0,45,1
1746591023084,EDS 139,A00,897203,Pappas; Elizabeth,44,0,45,1
1746591023084,EDS 139,B00,897209,Fargason; Sharon Gayle,41,0,45,4
1746591024111,EDS 201,A00,895545,Staff,22,0,45,23
1746591025140,EDS 203,A01,895581,Halter; Christopher P.,22,0,45,23
1746591026169,EDS 204R,A01,895625,Heinzman; Erica M.,39,0,45,6
1746591026169,EDS 204R,B01,895693,Halter; Christopher P.,10,0,45,35
1746591027196,EDS 206R,A00,895694,Fargason; Sharon Gayle,1,0,30,29
1746591027196,EDS 206R,B00,895695,Choi; Bailey Miyeon,16,0,30,14
1746591028221,EDS 250,A00,895697,Hemans; Patricia Ann Benitez,22,0,45,23
1746591029248,EDS 281,A00,895701,Meyerott; Theresa Ann,1,0,15,14
1746591030277,EDS 284,A00,895736,Meyerott; Theresa Ann,1,0,15,14
1746591031302,EDS 286,A00,897210,Fine; Sarah,0,0,15,15
1746591032400,EDS 289C,A01,895770,Daly; Alan J.,1,0,15,14
1746591033429,EDS 290,A00,897211,Hofstetter; Carolyn,0,0,15,15
1746591034453,LIGM 5A,A00,896162,Fischer-Grunski; Eva K,12,0,20,8
1746591035479,LIGM 5B,A00,896260,Fischer-Grunski; Eva K,17,0,20,3
1746591036506,LIGM 5C,A00,896308,Fischer-Grunski; Eva K,18,0,20,2
1746591037533,LIIT 5AS,A00,896313,Carnelos; Chiara,18,0,20,2
1746591038560,LIIT 5BS,A00,896416,Carnelos; Chiara,20,0,20,0
1746591039587,LIIT 5CS,A00,896564,Carnelos; Chiara,20,0,20,0
1746591040615,LISP 5A,A00,896588,Munoz Sanchez; Alicia,2,0,20,18
1746591041643,LISP 5B,A00,896653,Munoz Sanchez; Alicia,7,0,20,13
1746591042668,LISP 5C,A00,896655,Munoz Sanchez; Alicia,0,1,20,20
1746591043694,MAE 197,001,957918,Kleissl; Jan,9996,0,9999,3
1746591043694,MAE 197,002,959806,Boechler; Nicholas Sebastia,9998,0,9999,1
1746591043694,MAE 197,003,959852,Mullin; Jennifer S,9998,0,9999,1
1746591044724,MATH 2,A01,957937,Staff,33,0,35,2
1746591045754,MATH 197,001,957876,Kedlaya; Kiran S.,9993,0,9999,6
1746591046779,MCWP 40,A00,892729,Duru; Nur,10,0,20,10
1746591046779,MCWP 40,B00,893304,Montejo; Carolina,14,0,20,6
1746591047803,MCWP 40R,A00,893757,Redela; Pamela Morgan,0,5,20,20
1746591048830,MCWP 50,A00,893758,Morshed; Michael James,0,0,20,20
1746591048830,MCWP 50,B00,893761,Bartulis; Jason Michael,17,0,20,3
1746591049857,MCWP 50R,A00,893766,Compas; Sean Matthew,0,1,20,20
1746591049857,MCWP 50R,B00,893769,Carter; Jennifer A,0,1,20,20
1746591049857,MCWP 50R,C00,893771,Krone; Jarret,0,3,20,20
1746591049857,MCWP 50R,D00,893772,Miller; Elizabeth Deen,0,0,20,20
1746591049857,MCWP 50R,E00,893775,Carter; Andrea L,0,1,20,20
1746591050882,MMW 11R,A01,892721,Herbst; Matthew,14,0,30,16
1746591050882,MMW 11R,A02,892722,Herbst; Matthew,0,0,0,3
1746591051906,MMW 12R,A01,892724,Herbst; Matthew,0,11,16,16
1746591051906,MMW 12R,A02,892725,Herbst; Matthew,0,10,16,16
1746591052931,MMW 13R,A01,892727,Staff,0,4,16,16
1746591052931,MMW 13R,A02,892728,Staff,0,4,16,16
1746591052931,MMW 13R,A03,958032,Staff,0,4,16,16
1746591052931,MMW 13R,A04,958033,Staff,0,4,16,16
1746591052931,MMW 13R,A05,958034,Staff,0,4,16,16
1746591053959,SIO 295LS,A00,894015,Staff,5,0,25,20
1746591054988,SIO 295S,A00,894020,Staff,5,0,25,20
1746591056019,SIOC 290S,B01,958918,Merrifield; Mark A,14,0,30,16
1746591057045,SIOC 291S,B01,958922,Gabriel; Corey John,14,0,30,16
1746591058074,SOCI 117,A01,895339,Staff,3,0,5,2
1746591059105,WES 237B,A00,894149,Staff,11,0,20,9
1746591061171,AESE 279B,A00,891859,Staff,13,0,35,22
1746591062197,AIP 197,001,891854,Vespa; Emanuel Ignacio,9999,0,9999,0
1746591063224,ANTH 289S,A00,891856,Gagneux; Pascal,12,0,12,0
1746591064249,BENG 196,001,957946,Engler; Adam J.,9996,0,9999,3
1746591065274,BISP 197,001,959851,Wilhelm; James E.,9998,0,9999,1
1746591066298,CAT 124RS,A01,956906,Staff,6,0,25,19
1746591067327,CAT 125RS,A01,922013,Staff,6,0,25,19
1746591068355,CLRE 250,A00,891860,Morris; Sheldon,9995,0,9999,4
1746591070408,CLRE 251R,A00,907817,Mehta; Ravindra L.,9994,0,9999,5
1746591071434,CLRE 252,A00,891864,Cuomo; Raphael Eduardo,9993,0,9999,6
1746591072463,CLRE 253,A00,891867,Vaida; Florin,9994,0,9999,5
1746591072463,CLRE 253,B00,907819,Staff,9999,0,9999,0
1746591073491,CLRE 259,A00,891868,Patel; Hemal,9998,0,9999,1
1746591074516,CLRE 260,A00,891872,Cuomo; Raphael Eduardo,9999,0,9999,0
1746591075543,CLRE 297,001,891888,Cuomo; Raphael Eduardo,9999,0,9999,0
1746591076568,CSE 191,A00,958773,Minnes Kemp; Mor Mia,9995,0,9999,4
1746591077598,CSE 197,001,959846,Minnes Kemp; Mor Mia,9990,0,9999,9
1746591078628,CSS 201S,A01,892054,Mignozzetti; Umberto,25,0,30,5
1746591079659,CSS 202S,A01,892056,Mignozzetti; Umberto,25,0,30,5
1746591080684,DSC 197,001,956898,Eldridge; Justin Matthew,9996,0,9999,3
1746591081711,DSC 297,001,958000,Mazumdar; Arya,9998,0,9999,1
1746591081711,DSC 297,002,959862,Wang; Yusu,9998,0,9999,1
1746591082736,EAP 100,A00,905686,Staff,9778,0,9999,221
1746591083762,ECE 45,A01,892618,Staff,0,0,65,65
1746591085816,ECE 111,A01,892719,Staff,6,0,65,59
1746591086840,ECE 197,001,957920,Mercier; Patrick Philip,9991,0,9999,8
1746591087870,ECON 178,A01,907814,Zhu; Ying,26,0,35,9
1746591088900,EDS 115,A00,895312,Staff,35,0,45,10
1746591089925,EDS 117,A01,895337,Staff,23,0,30,7
1746591090989,EDS 125,A00,895341,Jones; Gabrielle Anastasia,36,0,45,9
1746591092015,EDS 128A,A01,895459,Fargason; Sharon Gayle,44,0,45,1
1746591093041,EDS 128B,A01,895543,Pappas; Elizabeth,44,0,45,1
1746591094070,EDS 139,A00,897203,Pappas; Elizabeth,44,0,45,1
1746591094070,EDS 139,B00,897209,Fargason; Sharon Gayle,41,0,45,4
1746591095096,EDS 201,A00,895545,Staff,22,0,45,23
1746591096121,EDS 203,A01,895581,Halter; Christopher P.,22,0,45,23
1746591097146,EDS 204R,A01,895625,Heinzman; Erica M.,39,0,45,6
1746591097146,EDS 204R,B01,895693,Halter; Christopher P.,10,0,45,35
1746591098174,EDS 206R,A00,895694,Fargason; Sharon Gayle,1,0,30,29
1746591098174,EDS 206R,B00,895695,Choi; Bailey Miyeon,16,0,30,14
1746591099201,EDS 250,A00,895697,Hemans; Patricia Ann Benitez,22,0,45,23
1746591100230,EDS 281,A00,895701,Meyerott; Theresa Ann,1,0,15,14
1746591101255,EDS 284,A00,895736,Meyerott; Theresa Ann,1,0,15,14
1746591102280,EDS 286,A00,897210,Fine; Sarah,0,0,15,15
1746591103308,EDS 289C,A01,895770,Daly; Alan J.,1,0,15,14
1746591104333,EDS 290,A00,897211,Hofstetter; Carolyn,0,0,15,15
1746591105362,LIGM 5A,A00,896162,Fischer-Grunski; Eva K,12,0,20,8
1746591106388,LIGM 5B,A00,896260,Fischer-Grunski; Eva K,17,0,20,3
1746591107414,LIGM 5C,A00,896308,Fischer-Grunski; Eva K,18,0,20,2
1746591108439,LIIT 5AS,A00,896313,Carnelos; Chiara,18,0,20,2
1746591109465,LIIT 5BS,A00,896416,Carnelos; Chiara,20,0,20,0
1746591110492,LIIT 5CS,A00,896564,Carnelos; Chiara,20,0,20,0
1746591111517,LISP 5A,A00,896588,Munoz Sanchez; Alicia,2,0,20,18
1746591112548,LISP 5B,A00,896653,Munoz Sanchez; Alicia,7,0,20,13
1746591113574,LISP 5C,A00,896655,Munoz Sanchez; Alicia,0,1,20,20
1746591114600,MAE 197,001,957918,Kleissl; Jan,9996,0,9999,3
1746591114600,MAE 197,002,959806,Boechler; Nicholas Sebastia,9998,0,9999,1
1746591114600,MAE 197,003,959852,Mullin; Jennifer S,9998,0,9999,1
1746591115626,MATH 2,A01,957937,Staff,33,0,35,2
1746591116652,MATH 197,001,957876,Kedlaya; Kiran S.,9993,0,9999,6
1746591117680,MCWP 40,A00,892729,Duru; Nur,10,0,20,10
1746591117680,MCWP 40,B00,893304,Montejo; Carolina,14,0,20,6
1746591118706,MCWP 40R,A00,893757,Redela; Pamela Morgan,0,5,20,20
1746591119731,MCWP 50,A00,893758,Morshed; Michael James,0,0,20,20
1746591119731,MCWP 50,B00,893761,Bartulis; Jason Michael,17,0,20,3
1746591120756,MCWP 50R,A00,893766,Compas; Sean Matthew,0,1,20,20
1746591120756,MCWP 50R,B00,893769,Carter; Jennifer A,0,1,20,20
1746591120756,MCWP 50R,C00,893771,Krone; Jarret,0,3,20,20
1746591120756,MCWP 50R,D00,893772,Miller; Elizabeth Deen,0,0,20,20
1746591120756,MCWP 50R,E00,893775,Carter; Andrea L,0,1,20,20
1746591121785,MMW 11R,A01,892721,Herbst; Matthew,14,0,30,16
1746591121785,MMW 11R,A02,892722,Herbst; Matthew,0,0,0,3
1746591122812,MMW 12R,A01,892724,Herbst; Matthew,0,11,16,16
1746591122812,MMW 12R,A02,892725,Herbst; Matthew,0,10,16,16
1746591123840,MMW 13R,A01,892727,Staff,0,4,16,16
1746591123840,MMW 13R,A02,892728,Staff,0,4,16,16
1746591123840,MMW 13R,A03,958032,Staff,0,4,16,16
1746591123840,MMW 13R,A04,958033,Staff,0,4,16,16
1746591123840,MMW 13R,A05,958034,Staff,0,4,16,16
1746591124869,SIO 295LS,A00,894015,Staff,5,0,25,20
1746591125894,SIO 295S,A00,894020,Staff,5,0,25,20
1746591126924,SIOC 290S,B01,958918,Merrifield; Mark A,14,0,30,16
1746591127954,SIOC 291S,B01,958922,Gabriel; Corey John,14,0,30,16
1746591128983,SOCI 117,A01,895339,Staff,3,0,5,2
1746591130013,WES 237B,A00,894149,Staff,11,0,20,9
1746591132072,AESE 279B,A00,891859,Staff,13,0,35,22
1746591133101,AIP 197,001,891854,Vespa; Emanuel Ignacio,9999,0,9999,0
1746591134127,ANTH 289S,A00,891856,Gagneux; Pascal,12,0,12,0
1746591135153,BENG 196,001,957946,Engler; Adam J.,9996,0,9999,3
1746591136178,BISP 197,001,959851,Wilhelm; James E.,9998,0,9999,1
1746591137203,CAT 124RS,A01,956906,Staff,6,0,25,19
1746591138231,CAT 125RS,A01,922013,Staff,6,0,25,19
1746591139255,CLRE 250,A00,891860,Morris; Sheldon,9995,0,9999,4
1746591141307,CLRE 251R,A00,907817,Mehta; Ravindra L.,9994,0,9999,5
1746591142334,CLRE 252,A00,891864,Cuomo; Raphael Eduardo,9993,0,9999,6
1746591143359,CLRE 253,A00,891867,Vaida; Florin,9994,0,9999,5
1746591143359,CLRE 253,B00,907819,Staff,9999,0,9999,0
1746591144384,CLRE 259,A00,891868,Patel; Hemal,9998,0,9999,1
1746591145409,CLRE 260,A00,891872,Cuomo; Raphael Eduardo,9999,0,9999,0
1746591146438,CLRE 297,001,891888,Cuomo; Raphael Eduardo,9999,0,9999,0
1746591147464,CSE 191,A00,958773,Minnes Kemp; Mor Mia,9995,0,9999,4
1746591148489,CSE 197,001,959846,Minnes Kemp; Mor Mia,9990,0,9999,9
1746591149514,CSS 201S,A01,892054,Mignozzetti; Umberto,25,0,30,5
1746591150545,CSS 202S,A01,892056,Mignozzetti; Umberto,25,0,30,5
1746591151574,DSC 197,001,956898,Eldridge; Justin Matthew,9996,0,9999,3
1746591152598,DSC 297,001,958000,Mazumdar; Arya,9998,0,9999,1
1746591152598,DSC 297,002,959862,Wang; Yusu,9998,0,9999,1
1746591153626,EAP 100,A00,905686,Staff,9778,0,9999,221
1746591154654,ECE 45,A01,892618,Staff,0,0,65,65
1746591156704,ECE 111,A01,892719,Staff,6,0,65,59
1746591157736,ECE 197,001,957920,Mercier; Patrick Philip,9991,0,9999,8
1746591158765,ECON 178,A01,907814,Zhu; Ying,26,0,35,9
1746591159790,EDS 115,A00,895312,Staff,35,0,45,10
1746591160818,EDS 117,A01,895337,Staff,23,0,30,7
1746591161849,EDS 125,A00,895341,Jones; Gabrielle Anastasia,36,0,45,9
1746591162877,EDS 128A,A01,895459,Fargason; Sharon Gayle,44,0,45,1
1746591163902,EDS 128B,A01,895543,Pappas; Elizabeth,44,0,45,1
1746591164931,EDS 139,A00,897203,Pappas; Elizabeth,44,0,45,1
1746591164931,EDS 139,B00,897209,Fargason; Sharon Gayle,41,0,45,4
1746591165958,EDS 201,A00,895545,Staff,22,0,45,23
1746591166983,EDS 203,A01,895581,Halter; Christopher P.,22,0,45,23
1746591168012,EDS 204R,A01,895625,Heinzman; Erica M.,39,0,45,6
1746591168012,EDS 204R,B01,895693,Halter; Christopher P.,10,0,45,35
1746591169045,EDS 206R,A00,895694,Fargason; Sharon Gayle,1,0,30,29
1746591169045,EDS 206R,B00,895695,Choi; Bailey Miyeon,16,0,30,14
1746591170071,EDS 250,A00,895697,Hemans; Patricia Ann Benitez,22,0,45,23
1746591171098,EDS 281,A00,895701,Meyerott; Theresa Ann,1,0,15,14
1746591172123,EDS 284,A00,895736,Meyerott; Theresa Ann,1,0,15,14
1746591173148,EDS 286,A00,897210,Fine; Sarah,0,0,15,15
1746591174177,EDS 289C,A01,895770,Daly; Alan J.,1,0,15,14
1746591175202,EDS 290,A00,897211,Hofstetter; Carolyn,0,0,15,15
1746591176230,LIGM 5A,A00,896162,Fischer-Grunski; Eva K,12,0,20,8
1746591177257,LIGM 5B,A00,896260,Fischer-Grunski; Eva K,17,0,20,3
1746591178286,LIGM 5C,A00,896308,Fischer-Grunski; Eva K,18,0,20,2
1746591179311,LIIT 5AS,A00,896313,Carnelos; Chiara,18,0,20,2
1746591180341,LIIT 5BS,A00,896416,Carnelos; Chiara,20,0,20,0
1746591181368,LIIT 5CS,A00,896564,Carnelos; Chiara,20,0,20,0
1746591182399,LISP 5A,A00,896588,Munoz Sanchez; Alicia,2,0,20,18
1746591183428,LISP 5B,A00,896653,Munoz Sanchez; Alicia,7,0,20,13
1746591184457,LISP 5C,A00,896655,Munoz Sanchez; Alicia,0,1,20,20
1746591185483,MAE 197,001,957918,Kleissl; Jan,9996,0,9999,3
1746591185483,MAE 197,002,959806,Boechler; Nicholas Sebastia,9998,0,9999,1
1746591185483,MAE 197,003,959852,Mullin; Jennifer S,9998,0,9999,1
1746591186510,MATH 2,A01,957937,Staff,33,0,35,2
1746591187537,MATH 197,001,957876,Kedlaya; Kiran S.,9993,0,9999,6
1746591188562,MCWP 40,A00,892729,Duru; Nur,10,0,20,10
1746591188562,MCWP 40,B00,893304,Montejo; Carolina,14,0,20,6
1746591189590,MCWP 40R,A00,893757,Redela; Pamela Morgan,0,5,20,20
1746591190615,MCWP 50,A00,893758,Morshed; Michael James,0,0,20,20
1746591190615,MCWP 50,B00,893761,Bartulis; Jason Michael,17,0,20,3
1746591191642,MCWP 50R,A00,893766,Compas; Sean Matthew,0,1,20,20
1746591191642,MCWP 50R,B00,893769,Carter; Jennifer A,0,1,20,20
1746591191642,MCWP 50R,C00,893771,Krone; Jarret,0,3,20,20
1746591191642,MCWP 50R,D00,893772,Miller; Elizabeth Deen,0,0,20,20
1746591191642,MCWP 50R,E00,893775,Carter; Andrea L,0,1,20,20
1746591192667,MMW 11R,A01,892721,Herbst; Matthew,14,0,30,16
1746591192667,MMW 11R,A02,892722,Herbst; Matthew,0,0,0,3
1746591193694,MMW 12R,A01,892724,Herbst; Matthew,0,11,16,16
1746591193694,MMW 12R,A02,892725,Herbst; Matthew,0,10,16,16
1746591194762,MMW 13R,A01,892727,Staff,0,4,16,16
1746591194762,MMW 13R,A02,892728,Staff,0,4,16,16
1746591194762,MMW 13R,A03,958032,Staff,0,4,16,16
1746591194762,MMW 13R,A04,958033,Staff,0,4,16,16
1746591194762,MMW 13R,A05,958034,Staff,0,4,16,16
1746591195787,SIO 295LS,A00,894015,Staff,5,0,25,20
1746591196813,SIO 295S,A00,894020,Staff,5,0,25,20
1746591197838,SIOC 290S,B01,958918,Merrifield; Mark A,14,0,30,16
1746591198869,SIOC 291S,B01,958922,Gabriel; Corey John,14,0,30,16
1746591199895,SOCI 117,A01,895339,Staff,3,0,5,2
1746591200923,WES 237B,A00,894149,Staff,11,0,20,9
1746591202984,AESE 279B,A00,891859,Staff,13,0,35,22
1746591204010,AIP 197,001,891854,Vespa; Emanuel Ignacio,9999,0,9999,0
1746591205036,ANTH 289S,A00,891856,Gagneux; Pascal,12,0,12,0
1746591206061,BENG 196,001,957946,Engler; Adam J.,9996,0,9999,3
1746591207089,BISP 197,001,959851,Wilhelm; James E.,9998,0,9999,1
1746591208116,CAT 124RS,A01,956906,Staff,6,0,25,19
1746591209143,CAT 125RS,A01,922013,Staff,6,0,25,19
1746591210170,CLRE 250,A00,891860,Morris; Sheldon,9995,0,9999,4
1746591212227,CLRE 251R,A00,907817,Mehta; Ravindra L.,9994,0,9999,5
1746591213254,CLRE 252,A00,891864,Cuomo; Raphael Eduardo,9993,0,9999,6
1746591214281,CLRE 253,A00,891867,Vaida; Florin,9994,0,9999,5
1746591214281,CLRE 253,B00,907819,Staff,9999,0,9999,0
1746591215311,CLRE 259,A00,891868,Patel; Hemal,9998,0,9999,1
1746591216337,CLRE 260,A00,891872,Cuomo; Raphael Eduardo,9999,0,9999,0
1746591217361,CLRE 297,001,891888,Cuomo; Raphael Eduardo,9999,0,9999,0
1746591218387,CSE 191,A00,958773,Minnes Kemp; Mor Mia,9995,0,9999,4
1746591219414,CSE 197,001,959846,Minnes Kemp; Mor Mia,9990,0,9999,9
1746591220440,CSS 201S,A01,892054,Mignozzetti; Umberto,25,0,30,5
1746591221465,CSS 202S,A01,892056,Mignozzetti; Umberto,25,0,30,5
1746591222492,DSC 197,001,956898,Eldridge; Justin Matthew,9996,0,9999,3
1746591223519,DSC 297,001,958000,Mazumdar; Arya,9998,0,9999,1
1746591223519,DSC 297,002,959862,Wang; Yusu,9998,0,9999,1
1746591224546,EAP 100,A00,905686,Staff,9778,0,9999,221
1746591225575,ECE 45,A01,892618,Staff,0,0,65,65
1746591227632,ECE 111,A01,892719,Staff,6,0,65,59
1746591228659,ECE 197,001,957920,Mercier; Patrick Philip,9991,0,9999,8
1746591229690,ECON 178,A01,907814,Zhu; Ying,26,0,35,9
1746591230716,EDS 115,A00,895312,Staff,35,0,45,10
1746591231742,EDS 117,A01,895337,Staff,23,0,30,7
1746591232770,EDS 125,A00,895341,Jones; Gabrielle Anastasia,36,0,45,9
1746591233797,EDS 128A,A01,895459,Fargason; Sharon Gayle,44,0,45,1
1746591234823,EDS 128B,A01,895543,Pappas; Elizabeth,44,0,45,1
1746591235851,EDS 139,A00,897203,Pappas; Elizabeth,44,0,45,1
1746591235851,EDS 139,B00,897209,Fargason; Sharon Gayle,41,0,45,4
1746591236877,EDS 201,A00,895545,Staff,22,0,45,23
1746591237905,EDS 203,A01,895581,Halter; Christopher P.,22,0,45,23
1746591238930,EDS 204R,A01,895625,Heinzman; Erica M.,39,0,45,6
1746591238930,EDS 204R,B01,895693,Halter; Christopher P.,10,0,45,35
1746591239955,EDS 206R,A00,895694,Fargason; Sharon Gayle,1,0,30,29
1746591239955,EDS 206R,B00,895695,Choi; Bailey Miyeon,16,0,30,14
1746591240983,EDS 250,A00,895697,Hemans; Patricia Ann Benitez,22,0,45,23
1746591242009,EDS 281,A00,895701,Meyerott; Theresa Ann,1,0,15,14
1746591243035,EDS 284,A00,895736,Meyerott; Theresa Ann,1,0,15,14
1746591244063,EDS 286,A00,897210,Fine; Sarah,0,0,15,15
1746591245090,EDS 289C,A01,895770,Daly; Alan J.,1,0,15,14
1746591246117,EDS 290,A00,897211,Hofstetter; Carolyn,0,0,15,15
1746591247147,LIGM 5A,A00,896162,Fischer-Grunski; Eva K,12,0,20,8
1746591248173,LIGM 5B,A00,896260,Fischer-Grunski; Eva K,17,0,20,3
1746591249204,LIGM 5C,A00,896308,Fischer-Grunski; Eva K,18,0,20,2
1746591250232,LIIT 5AS,A00,896313,Carnelos; Chiara,18,0,20,2
1746591251257,LIIT 5BS,A00,896416,Carnelos; Chiara,20,0,20,0
1746591252288,LIIT 5CS,A00,896564,Carnelos; Chiara,20,0,20,0
1746591253316,LISP 5A,A00,896588,Munoz Sanchez; Alicia,2,0,20,18
1746591254341,LISP 5B,A00,896653,Munoz Sanchez; Alicia,7,0,20,13
1746591255366,LISP 5C,A00,896655,Munoz Sanchez; Alicia,0,1,20,20
1746591256392,MAE 197,001,957918,Kleissl; Jan,9996,0,9999,3
1746591256392,MAE 197,002,959806,Boechler; Nicholas Sebastia,9998,0,9999,1
1746591256392,MAE 197,003,959852,Mullin; Jennifer S,9998,0,9999,1
1746591257420,MATH 2,A01,957937,Staff,33,0,35,2
1746591258446,MATH 197,001,957876,Kedlaya; Kiran S.,9993,0,9999,6
1746591259473,MCWP 40,A00,892729,Duru; Nur,10,0,20,10
1746591259473,MCWP 40,B00,893304,Montejo; Carolina,14,0,20,6
1746591260500,MCWP 40R,A00,893757,Redela; Pamela Morgan,0,5,20,20
1746591261526,MCWP 50,A00,893758,Morshed; Michael James,0,0,20,20
1746591261526,MCWP 50,B00,893761,Bartulis; Jason Michael,17,0,20,3
1746591262554,MCWP 50R,A00,893766,Compas; Sean Matthew,0,1,20,20
1746591262554,MCWP 50R,B00,893769,Carter; Jennifer A,0,1,20,20
1746591262554,MCWP 50R,C00,893771,Krone; Jarret,0,3,20,20
1746591262554,MCWP 50R,D00,893772,Miller; Elizabeth Deen,0,0,20,20
1746591262554,MCWP 50R,E00,893775,Carter; Andrea L,0,1,20,20
1746591263583,MMW 11R,A01,892721,Herbst; Matthew,14,0,30,16
1746591263583,MMW 11R,A02,892722,Herbst; Matthew,0,0,0,3
1746591264614,MMW 12R,A01,892724,Herbst; Matthew,0,11,16,16
1746591264614,MMW 12R,A02,892725,Herbst; Matthew,0,10,16,16
1746591265642,MMW 13R,A01,892727,Staff,0,4,16,16
1746591265642,MMW 13R,A02,892728,Staff,0,4,16,16
1746591265642,MMW 13R,A03,958032,Staff,0,4,16,16
1746591265642,MMW 13R,A04,958033,Staff,0,4,16,16
1746591265642,MMW 13R,A05,958034,Staff,0,4,16,16
1746591266672,SIO 295LS,A00,894015,Staff,5,0,25,20
1746591267697,SIO 295S,A00,894020,Staff,5,0,25,20
1746591268726,SIOC 290S,B01,958918,Merrifield; Mark A,14,0,30,16
1746591269755,SIOC 291S,B01,958922,Gabriel; Corey John,14,0,30,16
1746591270780,SOCI 117,A01,895339,Staff,3,0,5,2
1746591271806,WES 237B,A00,894149,Staff,11,0,20,9
1746591273880,AESE 279B,A00,891859,Staff,13,0,35,22
1746591274908,AIP 197,001,891854,Vespa; Emanuel Ignacio,9999,0,9999,0
1746591275934,ANTH 289S,A00,891856,Gagneux; Pascal,12,0,12,0
1746591276961,BENG 196,001,957946,Engler; Adam J.,9996,0,9999,3
1746591277985,BISP 197,001,959851,Wilhelm; James E.,9998,0,9999,1
1746591279011,CAT 124RS,A01,956906,Staff,6,0,25,19
1746591280036,CAT 125RS,A01,922013,Staff,6,0,25,19
1746591281063,CLRE 250,A00,891860,Morris; Sheldon,9995,0,9999,4
1746591283119,CLRE 251R,A00,907817,Mehta; Ravindra L.,9994,0,9999,5
1746591284143,CLRE 252,A00,891864,Cuomo; Raphael Eduardo,9993,0,9999,6
1746591285168,CLRE 253,A00,891867,Vaida; Florin,9994,0,9999,5
1746591285168,CLRE 253,B00,907819,Staff,9999,0,9999,0
1746591286193,CLRE 259,A00,891868,Patel; Hemal,9998,0,9999,1
1746591287217,CLRE 260,A00,891872,Cuomo; Raphael Eduardo,9999,0,9999,0
1746591288245,CLRE 297,001,891888,Cuomo; Raphael Eduardo,9999,0,9999,0
1746591289272,CSE 191,A00,958773,Minnes Kemp; Mor Mia,9995,0,9999,4
1746591290301,CSE 197,001,959846,Minnes Kemp; Mor Mia,9990,0,9999,9
1746591291330,CSS 201S,A01,892054,Mignozzetti; Umberto,25,0,30,5
1746591292354,CSS 202S,A01,892056,Mignozzetti; Umberto,25,0,30,5
1746591293383,DSC 197,001,956898,Eldridge; Justin Matthew,9996,0,9999,3
1746591294411,DSC 297,001,958000,Mazumdar; Arya,9998,0,9999,1
1746591294411,DSC 297,002,959862,Wang; Yusu,9998,0,9999,1
1746591295438,EAP 100,A00,905686,Staff,9778,0,9999,221
1746591296469,ECE 45,A01,892618,Staff,0,0,65,65
1746591298563,ECE 111,A01,892719,Staff,6,0,65,59
1746591299588,ECE 197,001,957920,Mercier; Patrick Philip,9991,0,9999,8
1746591300617,ECON 178,A01,907814,Zhu; Ying,26,0,35,9
1746591301644,EDS 115,A00,895312,Staff,35,0,45,10
1746591302676,EDS 117,A01,895337,Staff,23,0,30,7
1746591303705,EDS 125,A00,895341,Jones; Gabrielle Anastasia,36,0,45,9
1746591304730,EDS 128A,A01,895459,Fargason; Sharon Gayle,44,0,45,1
1746591305754,EDS 128B,A01,895543,Pappas; Elizabeth,44,0,45,1
1746591306780,EDS 139,A00,897203,Pappas; Elizabeth,44,0,45,1
1746591306780,EDS 139,B00,897209,Fargason; Sharon Gayle,41,0,45,4
1746591307806,EDS 201,A00,895545,Staff,22,0,45,23
1746591308833,EDS 203,A01,895581,Halter; Christopher P.,22,0,45,23
1746591309858,EDS 204R,A01,895625,Heinzman; Erica M.,39,0,45,6
1746591309858,EDS 204R,B01,895693,Halter; Christopher P.,10,0,45,35
1746591310883,EDS 206R,A00,895694,Fargason; Sharon Gayle,1,0,30,29
1746591310883,EDS 206R,B00,895695,Choi; Bailey Miyeon,16,0,30,14
1746591311911,EDS 250,A00,895697,Hemans; Patricia Ann Benitez,22,0,45,23
1746591312935,EDS 281,A00,895701,Meyerott; Theresa Ann,1,0,15,14
1746591313963,EDS 284,A00,895736,Meyerott; Theresa Ann,1,0,15,14
1746591314991,EDS 286,A00,897210,Fine; Sarah,0,0,15,15
1746591316016,EDS 289C,A01,895770,Daly; Alan J.,1,0,15,14
1746591317041,EDS 290,A00,897211,Hofstetter; Carolyn,0,0,15,15
1746591318067,LIGM 5A,A00,896162,Fischer-Grunski; Eva K,12,0,20,8
1746591319095,LIGM 5B,A00,896260,Fischer-Grunski; Eva K,17,0,20,3
1746591320127,LIGM 5C,A00,896308,Fischer-Grunski; Eva K,18,0,20,2
1746591321152,LIIT 5AS,A00,896313,Carnelos; Chiara,18,0,20,2
1746591322178,LIIT 5BS,A00,896416,Carnelos; Chiara,20,0,20,0
1746591323202,LIIT 5CS,A00,896564,Carnelos; Chiara,20,0,20,0
1746591324304,LISP 5A,A00,896588,Munoz Sanchez; Alicia,2,0,20,18
1746591325332,LISP 5B,A00,896653,Munoz Sanchez; Alicia,7,0,20,13
1746591326356,LISP 5C,A00,896655,Munoz Sanchez; Alicia,0,1,20,20
1746591327381,MAE 197,001,957918,Kleissl; Jan,9996,0,9999,3
1746591327381,MAE 197,002,959806,Boechler; Nicholas Sebastia,9998,0,9999,1
1746591327381,MAE 197,003,959852,Mullin; Jennifer S,9998,0,9999,1
1746591328406,MATH 2,A01,957937,Staff,33,0,35,2
1746591329431,MATH 197,001,957876,Kedlaya; Kiran S.,9993,0,9999,6
1746591330455,MCWP 40,A00,892729,Duru; Nur,10,0,20,10
1746591330455,MCWP 40,B00,893304,Montejo; Carolina,14,0,20,6
1746591331482,MCWP 40R,A00,893757,Redela; Pamela Morgan,0,5,20,20
1746591332507,MCWP 50,A00,893758,Morshed; Michael James,0,0,20,20
1746591332507,MCWP 50,B00,893761,Bartulis; Jason Michael,17,0,20,3
1746591333533,MCWP 50R,A00,893766,Compas; Sean Matthew,0,1,20,20
1746591333533,MCWP 50R,B00,893769,Carter; Jennifer A,0,1,20,20
1746591333533,MCWP 50R,C00,893771,Krone; Jarret,0,3,20,20
1746591333533,MCWP 50R,D00,893772,Miller; Elizabeth Deen,0,0,20,20
1746591333533,MCWP 50R,E00,893775,Carter; Andrea L,0,1,20,20
1746591334558,MMW 11R,A01,892721,Herbst; Matthew,14,0,30,16
1746591334558,MMW 11R,A02,892722,Herbst; Matthew,0,0,0,3
1746591335585,MMW 12R,A01,892724,Herbst; Matthew,0,11,16,16
1746591335585,MMW 12R,A02,892725,Herbst; Matthew,0,10,16,16
1746591336612,MMW 13R,A01,892727,Staff,0,4,16,16
1746591336612,MMW 13R,A02,892728,Staff,0,4,16,16
1746591336612,MMW 13R,A03,958032,Staff,0,4,16,16
1746591336612,MMW 13R,A04,958033,Staff,0,4,16,16
1746591336612,MMW 13R,A05,958034,Staff,0,4,16,16
1746591337640,SIO 295LS,A00,894015,Staff,5,0,25,20
1746591338664,SIO 295S,A00,894020,Staff,5,0,25,20
1746591339692,SIOC 290S,B01,958918,Merrifield; Mark A,14,0,30,16
1746591340722,SIOC 291S,B01,958922,Gabriel; Corey John,14,0,30,16
1746591341751,SOCI 117,A01,895339,Staff,3,0,5,2
1746591342779,WES 237B,A00,894149,Staff,11,0,20,9
1746591344850,AESE 279B,A00,891859,Staff,13,0,35,22
1746591345875,AIP 197,001,891854,Vespa; Emanuel Ignacio,9999,0,9999,0
1746591346901,ANTH 289S,A00,891856,Gagneux; Pascal,12,0,12,0
1746591347929,BENG 196,001,957946,Engler; Adam J.,9996,0,9999,3
1746591348958,BISP 197,001,959851,Wilhelm; James E.,9998,0,9999,1
1746591349983,CAT 124RS,A01,956906,Staff,6,0,25,19
1746591351013,CAT 125RS,A01,922013,Staff,6,0,25,19
1746591352038,CLRE 250,A00,891860,Morris; Sheldon,9995,0,9999,4
1746591354094,CLRE 251R,A00,907817,Mehta; Ravindra L.,9994,0,9999,5
1746591355125,CLRE 252,A00,891864,Cuomo; Raphael Eduardo,9993,0,9999,6
1746591356150,CLRE 253,A00,891867,Vaida; Florin,9994,0,9999,5
1746591356150,CLRE 253,B00,907819,Staff,9999,0,9999,0
1746591357194,CLRE 259,A00,891868,Patel; Hemal,9998,0,9999,1
1746591358221,CLRE 260,A00,891872,Cuomo; Raphael Eduardo,9999,0,9999,0
1746591359247,CLRE 297,001,891888,Cuomo; Raphael Eduardo,9999,0,9999,0
1746591360272,CSE 191,A00,958773,Minnes Kemp; Mor Mia,9995,0,9999,4
1746591361301,CSE 197,001,959846,Minnes Kemp; Mor Mia,9990,0,9999,9
1746591362336,CSS 201S,A01,892054,Mignozzetti; Umberto,25,0,30,5
1746591363365,CSS 202S,A01,892056,Mignozzetti; Umberto,25,0,30,5
1746591364387,DSC 197,001,956898,Eldridge; Justin Matthew,9996,0,9999,3
1746591365412,DSC 297,001,958000,Mazumdar; Arya,9998,0,9999,1
1746591365412,DSC 297,002,959862,Wang; Yusu,9998,0,9999,1
1746591366440,EAP 100,A00,905686,Staff,9778,0,9999,221
1746591367464,ECE 45,A01,892618,Staff,0,0,65,65
1746591369518,ECE 111,A01,892719,Staff,6,0,65,59
1746591370543,ECE 197,001,957920,Mercier; Patrick Philip,9991,0,9999,8
1746591371573,ECON 178,A01,907814,Zhu; Ying,26,0,35,9
1746591372599,EDS 115,A00,895312,Staff,35,0,45,10
1746591373626,EDS 117,A01,895337,Staff,23,0,30,7
1746591374653,EDS 125,A00,895341,Jones; Gabrielle Anastasia,36,0,45,9
1746591375681,EDS 128A,A01,895459,Fargason; Sharon Gayle,44,0,45,1
1746591376710,EDS 128B,A01,895543,Pappas; Elizabeth,44,0,45,1
1746591377736,EDS 139,A00,897203,Pappas; Elizabeth,44,0,45,1
1746591377736,EDS 139,B00,897209,Fargason; Sharon Gayle,41,0,45,4
1746591378760,EDS 201,A00,895545,Staff,22,0,45,23
1746591379786,EDS 203,A01,895581,Halter; Christopher P.,22,0,45,23
1746591380812,EDS 204R,A01,895625,Heinzman; Erica M.,39,0,45,6
1746591380812,EDS 204R,B01,895693,Halter; Christopher P.,10,0,45,35
1746591381837,EDS 206R,A00,895694,Fargason; Sharon Gayle,1,0,30,29
1746591381837,EDS 206R,B00,895695,Choi; Bailey Miyeon,16,0,30,14
1746591382867,EDS 250,A00,895697,Hemans; Patricia Ann Benitez,22,0,45,23
1746591383892,EDS 281,A00,895701,Meyerott; Theresa Ann,1,0,15,14
1746591384921,EDS 284,A00,895736,Meyerott; Theresa Ann,1,0,15,14
1746591385947,EDS 286,A00,897210,Fine; Sarah,0,0,15,15
1746591386972,EDS 289C,A01,895770,Daly; Alan J.,1,0,15,14
1746591387995,EDS 290,A00,897211,Hofstetter; Carolyn,0,0,15,15
1746591389027,LIGM 5A,A00,896162,Fischer-Grunski; Eva K,12,0,20,8
1746591390052,LIGM 5B,A00,896260,Fischer-Grunski; Eva K,17,0,20,3
1746591391081,LIGM 5C,A00,896308,Fischer-Grunski; Eva K,18,0,20,2
1746591392111,LIIT 5AS,A00,896313,Carnelos; Chiara,18,0,20,2
1746591393138,LIIT 5BS,A00,896416,Carnelos; Chiara,20,0,20,0
1746591394193,LIIT 5CS,A00,896564,Carnelos; Chiara,20,0,20,0
1746591395219,LISP 5A,A00,896588,Munoz Sanchez; Alicia,2,0,20,18
1746591396245,LISP 5B,A00,896653,Munoz Sanchez; Alicia,7,0,20,13
1746591397272,LISP 5C,A00,896655,Munoz Sanchez; Alicia,0,1,20,20
1746591398297,MAE 197,001,957918,Kleissl; Jan,9996,0,9999,3
1746591398297,MAE 197,002,959806,Boechler; Nicholas Sebastia,9998,0,9999,1
1746591398297,MAE 197,003,959852,Mullin; Jennifer S,9998,0,9999,1
1746591399327,MATH 2,A01,957937,Staff,33,0,35,2
1746591400362,MATH 197,001,957876,Kedlaya; Kiran S.,9993,0,9999,6
1746591401386,MCWP 40,A00,892729,Duru; Nur,10,0,20,10
1746591401386,MCWP 40,B00,893304,Montejo; Carolina,14,0,20,6
1746591402415,MCWP 40R,A00,893757,Redela; Pamela Morgan,0,5,20,20
1746591403442,MCWP 50,A00,893758,Morshed; Michael James,0,0,20,20
1746591403442,MCWP 50,B00,893761,Bartulis; Jason Michael,17,0,20,3
1746591404469,MCWP 50R,A00,893766,Compas; Sean Matthew,0,1,20,20
1746591404469,MCWP 50R,B00,893769,Carter; Jennifer A,0,1,20,20
1746591404469,MCWP 50R,C00,893771,Krone; Jarret,0,3,20,20
1746591404469,MCWP 50R,D00,893772,Miller; Elizabeth Deen,0,0,20,20
1746591404469,MCWP 50R,E00,893775,Carter; Andrea L,0,1,20,20
1746591405497,MMW 11R,A01,892721,Herbst; Matthew,14,0,30,16
1746591405497,MMW 11R,A02,892722,Herbst; Matthew,0,0,0,3
1746591406522,MMW 12R,A01,892724,Herbst; Matthew,0,11,16,16
1746591406522,MMW 12R,A02,892725,Herbst; Matthew,0,10,16,16
1746591407548,MMW 13R,A01,892727,Staff,0,4,16,16
1746591407548,MMW 13R,A02,892728,Staff,0,4,16,16
1746591407548,MMW 13R,A03,958032,Staff,0,4,16,16
1746591407548,MMW 13R,A04,958033,Staff,0,4,16,16
1746591407548,MMW 13R,A05,958034,Staff,0,4,16,16
1746591408573,SIO 295LS,A00,894015,Staff,5,0,25,20
1746591409599,SIO 295S,A00,894020,Staff,5,0,25,20
1746591410629,SIOC 290S,B01,958918,Merrifield; Mark A,14,0,30,16
1746591411657,SIOC 291S,B01,958922,Gabriel; Corey John,14,0,30,16
1746591412685,SOCI 117,A01,895339,Staff,3,0,5,2
1746591413709,WES 237B,A00,894149,Staff,11,0,20,9
1746591415784,AESE 279B,A00,891859,Staff,13,0,35,22
1746591416811,AIP 197,001,891854,Vespa; Emanuel Ignacio,9999,0,9999,0
1746591417837,ANTH 289S,A00,891856,Gagneux; Pascal,12,0,12,0
1746591418865,BENG 196,001,957946,Engler; Adam J.,9996,0,9999,3
1746591419889,BISP 197,001,959851,Wilhelm; James E.,9998,0,9999,1
1746591420914,CAT 124RS,A01,956906,Staff,6,0,25,19
1746591421941,CAT 125RS,A01,922013,Staff,6,0,25,19
1746591422966,CLRE 250,A00,891860,Morris; Sheldon,9995,0,9999,4
1746591425026,CLRE 251R,A00,907817,Mehta; Ravindra L.,9994,0,9999,5
1746591426053,CLRE 252,A00,891864,Cuomo; Raphael Eduardo,9993,0,9999,6
1746591427079,CLRE 253,A00,891867,Vaida; Florin,9994,0,9999,5
1746591427079,CLRE 253,B00,907819,Staff,9999,0,9999,0
1746591428106,CLRE 259,A00,891868,Patel; Hemal,9998,0,9999,1
1746591429132,CLRE 260,A00,891872,Cuomo; Raphael Eduardo,9999,0,9999,0
1746591430160,CLRE 297,001,891888,Cuomo; Raphael Eduardo,9999,0,9999,0
1746591431187,CSE 191,A00,958773,Minnes Kemp; Mor Mia,9995,0,9999,4
1746591432215,CSE 197,001,959846,Minnes Kemp; Mor Mia,9990,0,9999,9
1746591433241,CSS 201S,A01,892054,Mignozzetti; Umberto,25,0,30,5
1746591434266,CSS 202S,A01,892056,Mignozzetti; Umberto,25,0,30,5
1746591435294,DSC 197,001,956898,Eldridge; Justin Matthew,9996,0,9999,3
1746591436318,DSC 297,001,958000,Mazumdar; Arya,9998,0,9999,1
1746591436318,DSC 297,002,959862,Wang; Yusu,9998,0,9999,1
1746591437347,EAP 100,A00,905686,Staff,9778,0,9999,221
1746591438371,ECE 45,A01,892618,Staff,0,0,65,65
1746591440426,ECE 111,A01,892719,Staff,6,0,65,59
1746591441451,ECE 197,001,957920,Mercier; Patrick Philip,9991,0,9999,8
1746591442476,ECON 178,A01,907814,Zhu; Ying,26,0,35,9
1746591443501,EDS 115,A00,895312,Staff,35,0,45,10
1746591444527,EDS 117,A01,895337,Staff,23,0,30,7
1746591445553,EDS 125,A00,895341,Jones; Gabrielle Anastasia,36,0,45,9
1746591446579,EDS 128A,A01,895459,Fargason; Sharon Gayle,44,0,45,1
1746591447608,EDS 128B,A01,895543,Pappas; Elizabeth,44,0,45,1
1746591448634,EDS 139,A00,897203,Pappas; Elizabeth,44,0,45,1
1746591448634,EDS 139,B00,897209,Fargason; Sharon Gayle,41,0,45,4
1746591449661,EDS 201,A00,895545,Staff,22,0,45,23
1746591450690,EDS 203,A01,895581,Halter; Christopher P.,22,0,45,23
1746591451715,EDS 204R,A01,895625,Heinzman; Erica M.,39,0,45,6
1746591451715,EDS 204R,B01,895693,Halter; Christopher P.,10,0,45,35
1746591452743,EDS 206R,A00,895694,Fargason; Sharon Gayle,1,0,30,29
1746591452743,EDS 206R,B00,895695,Choi; Bailey Miyeon,16,0,30,14
1746591453809,EDS 250,A00,895697,Hemans; Patricia Ann Benitez,22,0,45,23
1746591454834,EDS 281,A00,895701,Meyerott; Theresa Ann,1,0,15,14
1746591455860,EDS 284,A00,895736,Meyerott; Theresa Ann,1,0,15,14
1746591456888,EDS 286,A00,897210,Fine; Sarah,0,0,15,15
1746591457917,EDS 289C,A01,895770,Daly; Alan J.,1,0,15,14
1746591458945,EDS 290,A00,897211,Hofstetter; Carolyn,0,0,15,15
1746591459972,LIGM 5A,A00,896162,Fischer-Grunski; Eva K,12,0,20,8
1746591461001,LIGM 5B,A00,896260,Fischer-Grunski; Eva K,17,0,20,3
1746591462028,LIGM 5C,A00,896308,Fischer-Grunski; Eva K,18,0,20,2
1746591463059,LIIT 5AS,A00,896313,Carnelos; Chiara,18,0,20,2
1746591464086,LIIT 5BS,A00,896416,Carnelos; Chiara,20,0,20,0
1746591465118,LIIT 5CS,A00,896564,Carnelos; Chiara,20,0,20,0
1746591466148,LISP 5A,A00,896588,Munoz Sanchez; Alicia,2,0,20,18
1746591467178,LISP 5B,A00,896653,Munoz Sanchez; Alicia,7,0,20,13
1746591468207,LISP 5C,A00,896655,Munoz Sanchez; Alicia,0,1,20,20
1746591469232,MAE 197,001,957918,Kleissl; Jan,9996,0,9999,3
1746591469232,MAE 197,002,959806,Boechler; Nicholas Sebastia,9998,0,9999,1
1746591469232,MAE 197,003,959852,Mullin; Jennifer S,9998,0,9999,1
1746591470260,MATH 2,A01,957937,Staff,33,0,35,2
1746591471287,MATH 197,001,957876,Kedlaya; Kiran S.,9993,0,9999,6
1746591472314,MCWP 40,A00,892729,Duru; Nur,10,0,20,10
1746591472314,MCWP 40,B00,893304,Montejo; Carolina,14,0,20,6
1746591473340,MCWP 40R,A00,893757,Redela; Pamela Morgan,0,5,20,20
1746591474366,MCWP 50,A00,893758,Morshed; Michael James,0,0,20,20
1746591474366,MCWP 50,B00,893761,Bartulis; Jason Michael,17,0,20,3
1746591475390,MCWP 50R,A00,893766,Compas; Sean Matthew,0,1,20,20
1746591475390,MCWP 50R,B00,893769,Carter; Jennifer A,0,1,20,20
1746591475390,MCWP 50R,C00,893771,Krone; Jarret,0,3,20,20
1746591475390,MCWP 50R,D00,893772,Miller; Elizabeth Deen,0,0,20,20
1746591475390,MCWP 50R,E00,893775,Carter; Andrea L,0,1,20,20
1746591476417,MMW 11R,A01,892721,Herbst; Matthew,14,0,30,16
1746591476417,MMW 11R,A02,892722,Herbst; Matthew,0,0,0,3
1746591477446,MMW 12R,A01,892724,Herbst; Matthew,0,11,16,16
1746591477446,MMW 12R,A02,892725,Herbst; Matthew,0,10,16,16
1746591478472,MMW 13R,A01,892727,Staff,0,4,16,16
1746591478472,MMW 13R,A02,892728,Staff,0,4,16,16
1746591478472,MMW 13R,A03,958032,Staff,0,4,16,16
1746591478472,MMW 13R,A04,958033,Staff,0,4,16,16
1746591478472,MMW 13R,A05,958034,Staff,0,4,16,16
1746591479496,SIO 295LS,A00,894015,Staff,5,0,25,20
1746591480525,SIO 295S,A00,894020,Staff,5,0,25,20
1746591481557,SIOC 290S,B01,958918,Merrifield; Mark A,14,0,30,16
1746591482600,SIOC 291S,B01,958922,Gabriel; Corey John,14,0,30,16
1746591483626,SOCI 117,A01,895339,Staff,3,0,5,2
1746591484654,WES 237B,A00,894149,Staff,11,0,20,9
1746591486726,AESE 279B,A00,891859,Staff,13,0,35,22
1746591487753,AIP 197,001,891854,Vespa; Emanuel Ignacio,9999,0,9999,0
1746591488778,ANTH 289S,A00,891856,Gagneux; Pascal,12,0,12,0
1746591489804,BENG 196,001,957946,Engler; Adam J.,9996,0,9999,3
1746591490831,BISP 197,001,959851,Wilhelm; James E.,9998,0,9999,1
1746591491857,CAT 124RS,A01,956906,Staff,6,0,25,19
1746591492882,CAT 125RS,A01,922013,Staff,6,0,25,19
1746591493913,CLRE 250,A00,891860,Morris; Sheldon,9995,0,9999,4
1746591495966,CLRE 251R,A00,907817,Mehta; Ravindra L.,9994,0,9999,5
1746591496990,CLRE 252,A00,891864,Cuomo; Raphael Eduardo,9993,0,9999,6
1746591498019,CLRE 253,A00,891867,Vaida; Florin,9994,0,9999,5
1746591498019,CLRE 253,B00,907819,Staff,9999,0,9999,0
1746591499048,CLRE 259,A00,891868,Patel; Hemal,9998,0,9999,1
1746591500073,CLRE 260,A00,891872,Cuomo; Raphael Eduardo,9999,0,9999,0
1746591501101,CLRE 297,001,891888,Cuomo; Raphael Eduardo,9999,0,9999,0
1746591502127,CSE 191,A00,958773,Minnes Kemp; Mor Mia,9995,0,9999,4
1746591503152,CSE 197,001,959846,Minnes Kemp; Mor Mia,9990,0,9999,9
1746591504181,CSS 201S,A01,892054,Mignozzetti; Umberto,25,0,30,5
1746591505207,CSS 202S,A01,892056,Mignozzetti; Umberto,25,0,30,5
1746591506275,DSC 197,001,956898,Eldridge; Justin Matthew,9996,0,9999,3
1746591507303,DSC 297,001,958000,Mazumdar; Arya,9998,0,9999,1
1746591507303,DSC 297,002,959862,Wang; Yusu,9998,0,9999,1
1746591508330,EAP 100,A00,905686,Staff,9778,0,9999,221
1746591509357,ECE 45,A01,892618,Staff,0,0,65,65
1746591511414,ECE 111,A01,892719,Staff,6,0,65,59
1746591512439,ECE 197,001,957920,Mercier; Patrick Philip,9991,0,9999,8
1746591513463,ECON 178,A01,907814,Zhu; Ying,26,0,35,9
1746591514487,EDS 115,A00,895312,Staff,35,0,45,10
1746591515513,EDS 117,A01,895337,Staff,23,0,30,7
1746591516539,EDS 125,A00,895341,Jones; Gabrielle Anastasia,36,0,45,9
1746591517568,EDS 128A,A01,895459,Fargason; Sharon Gayle,44,0,45,1
1746591518594,EDS 128B,A01,895543,Pappas; Elizabeth,44,0,45,1
1746591519621,EDS 139,A00,897203,Pappas; Elizabeth,44,0,45,1
1746591519621,EDS 139,B00,897209,Fargason; Sharon Gayle,41,0,45,4
1746591520651,EDS 201,A00,895545,Staff,22,0,45,23
1746591521675,EDS 203,A01,895581,Halter; Christopher P.,22,0,45,23
1746591522704,EDS 204R,A01,895625,Heinzman; Erica M.,39,0,45,6
1746591522704,EDS 204R,B01,895693,Halter; Christopher P.,10,0,45,35
1746591523731,EDS 206R,A00,895694,Fargason; Sharon Gayle,1,0,30,29
1746591523731,EDS 206R,B00,895695,Choi; Bailey Miyeon,16,0,30,14
1746591524758,EDS 250,A00,895697,Hemans; Patricia Ann Benitez,22,0,45,23
1746591525783,EDS 281,A00,895701,Meyerott; Theresa Ann,1,0,15,14
1746591526808,EDS 284,A00,895736,Meyerott; Theresa Ann,1,0,15,14
1746591527833,EDS 286,A00,897210,Fine; Sarah,0,0,15,15
1746591528863,EDS 289C,A01,895770,Daly; Alan J.,1,0,15,14
1746591529889,EDS 290,A00,897211,Hofstetter; Carolyn,0,0,15,15
1746591530915,LIGM 5A,A00,896162,Fischer-Grunski; Eva K,12,0,20,8
1746591531947,LIGM 5B,A00,896260,Fischer-Grunski; Eva K,17,0,20,3
1746591532978,LIGM 5C,A00,896308,Fischer-Grunski; Eva K,18,0,20,2
1746591534005,LIIT 5AS,A00,896313,Carnelos; Chiara,18,0,20,2
1746591535030,LIIT 5BS,A00,896416,Carnelos; Chiara,20,0,20,0
1746591536057,LIIT 5CS,A00,896564,Carnelos; Chiara,20,0,20,0
1746591537083,LISP 5A,A00,896588,Munoz Sanchez; Alicia,2,0,20,18
1746591538112,LISP 5B,A00,896653,Munoz Sanchez; Alicia,7,0,20,13
1746591539142,LISP 5C,A00,896655,Munoz Sanchez; Alicia,0,1,20,20
1746591540166,MAE 197,001,957918,Kleissl; Jan,9996,0,9999,3
1746591540166,MAE 197,002,959806,Boechler; Nicholas Sebastia,9998,0,9999,1
1746591540166,MAE 197,003,959852,Mullin; Jennifer S,9998,0,9999,1
1746591541193,MATH 2,A01,957937,Staff,33,0,35,2
1746591542231,MATH 197,001,957876,Kedlaya; Kiran S.,9993,0,9999,6
1746591543257,MCWP 40,A00,892729,Duru; Nur,10,0,20,10
1746591543257,MCWP 40,B00,893304,Montejo; Carolina,14,0,20,6
1746591544282,MCWP 40R,A00,893757,Redela; Pamela Morgan,0,5,20,20
1746591545309,MCWP 50,A00,893758,Morshed; Michael James,0,0,20,20
1746591545309,MCWP 50,B00,893761,Bartulis; Jason Michael,17,0,20,3
1746591546336,MCWP 50R,A00,893766,Compas; Sean Matthew,0,1,20,20
1746591546336,MCWP 50R,B00,893769,Carter; Jennifer A,0,1,20,20
1746591546336,MCWP 50R,C00,893771,Krone; Jarret,0,3,20,20
1746591546336,MCWP 50R,D00,893772,Miller; Elizabeth Deen,0,0,20,20
1746591546336,MCWP 50R,E00,893775,Carter; Andrea L,0,1,20,20
1746591547363,MMW 11R,A01,892721,Herbst; Matthew,14,0,30,16
1746591547363,MMW 11R,A02,892722,Herbst; Matthew,0,0,0,3
1746591548390,MMW 12R,A01,892724,Herbst; Matthew,0,11,16,16
1746591548390,MMW 12R,A02,892725,Herbst; Matthew,0,10,16,16
1746591549418,MMW 13R,A01,892727,Staff,0,4,16,16
1746591549418,MMW 13R,A02,892728,Staff,0,4,16,16
1746591549418,MMW 13R,A03,958032,Staff,0,4,16,16
1746591549418,MMW 13R,A04,958033,Staff,0,4,16,16
1746591549418,MMW 13R,A05,958034,Staff,0,4,16,16
1746591550443,SIO 295LS,A00,894015,Staff,5,0,25,20
1746591551467,SIO 295S,A00,894020,Staff,5,0,25,20
1746591552492,SIOC 290S,B01,958918,Merrifield; Mark A,14,0,30,16
1746591553517,SIOC 291S,B01,958922,Gabriel; Corey John,14,0,30,16
1746591554543,SOCI 117,A01,895339,Staff,3,0,5,2
1746591555567,WES 237B,A00,894149,Staff,11,0,20,9
1746591557627,AESE 279B,A00,891859,Staff,13,0,35,22
1746591558654,AIP 197,001,891854,Vespa; Emanuel Ignacio,9999,0,9999,0
1746591559678,ANTH 289S,A00,891856,Gagneux; Pascal,12,0,12,0
1746591560703,BENG 196,001,957946,Engler; Adam J.,9996,0,9999,3
1746591561730,BISP 197,001,959851,Wilhelm; James E.,9998,0,9999,1
1746591562755,CAT 124RS,A01,956906,Staff,6,0,25,19
1746591563781,CAT 125RS,A01,922013,Staff,6,0,25,19
1746591564807,CLRE 250,A00,891860,Morris; Sheldon,9995,0,9999,4
1746591566865,CLRE 251R,A00,907817,Mehta; Ravindra L.,9994,0,9999,5
1746591567890,CLRE 252,A00,891864,Cuomo; Raphael Eduardo,9993,0,9999,6
1746591568916,CLRE 253,A00,891867,Vaida; Florin,9994,0,9999,5
1746591568916,CLRE 253,B00,907819,Staff,9999,0,9999,0
1746591569945,CLRE 259,A00,891868,Patel; Hemal,9998,0,9999,1
1746591570970,CLRE 260,A00,891872,Cuomo; Raphael Eduardo,9999,0,9999,0
1746591571995,CLRE 297,001,891888,Cuomo; Raphael Eduardo,9999,0,9999,0
1746591573022,CSE 191,A00,958773,Minnes Kemp; Mor Mia,9995,0,9999,4
1746591574048,CSE 197,001,959846,Minnes Kemp; Mor Mia,9990,0,9999,9
1746591575074,CSS 201S,A01,892054,Mignozzetti; Umberto,25,0,30,5
1746591576099,CSS 202S,A01,892056,Mignozzetti; Umberto,25,0,30,5
1746591577124,DSC 197,001,956898,Eldridge; Justin Matthew,9996,0,9999,3
1746591578152,DSC 297,001,958000,Mazumdar; Arya,9998,0,9999,1
1746591578152,DSC 297,002,959862,Wang; Yusu,9998,0,9999,1
1746591579177,EAP 100,A00,905686,Staff,9778,0,9999,221
1746591580203,ECE 45,A01,892618,Staff,0,0,65,65
1746591582256,ECE 111,A01,892719,Staff,6,0,65,59
1746591583283,ECE 197,001,957920,Mercier; Patrick Philip,9991,0,9999,8
1746591584311,ECON 178,A01,907814,Zhu; Ying,26,0,35,9
1746591585334,EDS 115,A00,895312,Staff,35,0,45,10
1746591586360,EDS 117,A01,895337,Staff,23,0,30,7
1746591587386,EDS 125,A00,895341,Jones; Gabrielle Anastasia,36,0,45,9
1746591588411,EDS 128A,A01,895459,Fargason; Sharon Gayle,44,0,45,1
1746591589439,EDS 128B,A01,895543,Pappas; Elizabeth,44,0,45,1
1746591590463,EDS 139,A00,897203,Pappas; Elizabeth,44,0,45,1
1746591590463,EDS 139,B00,897209,Fargason; Sharon Gayle,41,0,45,4
1746591591488,EDS 201,A00,895545,Staff,22,0,45,23
1746591592512,EDS 203,A01,895581,Halter; Christopher P.,22,0,45,23
1746591593539,EDS 204R,A01,895625,Heinzman; Erica M.,39,0,45,6
1746591593539,EDS 204R,B01,895693,Halter; Christopher P.,10,0,45,35
1746591594564,EDS 206R,A00,895694,Fargason; Sharon Gayle,1,0,30,29
1746591594564,EDS 206R,B00,895695,Choi; Bailey Miyeon,16,0,30,14
1746591595592,EDS 250,A00,895697,Hemans; Patricia Ann Benitez,22,0,45,23
1746591596617,EDS 281,A00,895701,Meyerott; Theresa Ann,1,0,15,14
1746591597643,EDS 284,A00,895736,Meyerott; Theresa Ann,1,0,15,14
1746591598668,EDS 286,A00,897210,Fine; Sarah,0,0,15,15
1746591599698,EDS 289C,A01,895770,Daly; Alan J.,1,0,15,14
1746591600722,EDS 290,A00,897211,Hofstetter; Carolyn,0,0,15,15
1746591601750,LIGM 5A,A00,896162,Fischer-Grunski; Eva K,12,0,20,8
1746591602779,LIGM 5B,A00,896260,Fischer-Grunski; Eva K,17,0,20,3
1746591603804,LIGM 5C,A00,896308,Fischer-Grunski; Eva K,18,0,20,2
1746591604832,LIIT 5AS,A00,896313,Carnelos; Chiara,18,0,20,2
1746591605861,LIIT 5BS,A00,896416,Carnelos; Chiara,20,0,20,0
1746591606888,LIIT 5CS,A00,896564,Carnelos; Chiara,20,0,20,0
1746591607918,LISP 5A,A00,896588,Munoz Sanchez; Alicia,2,0,20,18
1746591608944,LISP 5B,A00,896653,Munoz Sanchez; Alicia,7,0,20,13
1746591610029,LISP 5C,A00,896655,Munoz Sanchez; Alicia,0,1,20,20
1746591611053,MAE 197,001,957918,Kleissl; Jan,9996,0,9999,3
1746591611053,MAE 197,002,959806,Boechler; Nicholas Sebastia,9998,0,9999,1
1746591611053,MAE 197,003,959852,Mullin; Jennifer S,9998,0,9999,1
1746591612079,MATH 2,A01,957937,Staff,33,0,35,2
1746591613104,MATH 197,001,957876,Kedlaya; Kiran S.,9993,0,9999,6
1746591614129,MCWP 40,A00,892729,Duru; Nur,10,0,20,10
1746591614129,MCWP 40,B00,893304,Montejo; Carolina,14,0,20,6
1746591615158,MCWP 40R,A00,893757,Redela; Pamela Morgan,0,5,20,20
1746591616184,MCWP 50,A00,893758,Morshed; Michael James,0,0,20,20
1746591616184,MCWP 50,B00,893761,Bartulis; Jason Michael,17,0,20,3
1746591617211,MCWP 50R,A00,893766,Compas; Sean Matthew,0,1,20,20
1746591617211,MCWP 50R,B00,893769,Carter; Jennifer A,0,1,20,20
1746591617211,MCWP 50R,C00,893771,Krone; Jarret,0,3,20,20
1746591617211,MCWP 50R,D00,893772,Miller; Elizabeth Deen,0,0,20,20
1746591617211,MCWP 50R,E00,893775,Carter; Andrea L,0,1,20,20
1746591618235,MMW 11R,A01,892721,Herbst; Matthew,14,0,30,16
1746591618235,MMW 11R,A02,892722,Herbst; Matthew,0,0,0,3
1746591619260,MMW 12R,A01,892724,Herbst; Matthew,0,11,16,16
1746591619260,MMW 12R,A02,892725,Herbst; Matthew,0,10,16,16
1746591620285,MMW 13R,A01,892727,Staff,0,4,16,16
1746591620285,MMW 13R,A02,892728,Staff,0,4,16,16
1746591620285,MMW 13R,A03,958032,Staff,0,4,16,16
1746591620285,MMW 13R,A04,958033,Staff,0,4,16,16
1746591620285,MMW 13R,A05,958034,Staff,0,4,16,16
1746591621310,SIO 295LS,A00,894015,Staff,5,0,25,20
1746591622333,SIO 295S,A00,894020,Staff,5,0,25,20
1746591623359,SIOC 290S,B01,958918,Merrifield; Mark A,14,0,30,16
1746591624389,SIOC 291S,B01,958922,Gabriel; Corey John,14,0,30,16
1746591625414,SOCI 117,A01,895339,Staff,3,0,5,2
1746591626440,WES 237B,A00,894149,Staff,11,0,20,9
1746591628500,AESE 279B,A00,891859,Staff,13,0,35,22
1746591629524,AIP 197,001,891854,Vespa; Emanuel Ignacio,9999,0,9999,0
1746591630548,ANTH 289S,A00,891856,Gagneux; Pascal,12,0,12,0
1746591631576,BENG 196,001,957946,Engler; Adam J.,9996,0,9999,3
1746591632604,BISP 197,001,959851,Wilhelm; James E.,9998,0,9999,1
1746591633629,CAT 124RS,A01,956906,Staff,6,0,25,19
1746591634656,CAT 125RS,A01,922013,Staff,6,0,25,19
1746591635686,CLRE 250,A00,891860,Morris; Sheldon,9995,0,9999,4
1746591637740,CLRE 251R,A00,907817,Mehta; Ravindra L.,9994,0,9999,5
1746591638767,CLRE 252,A00,891864,Cuomo; Raphael Eduardo,9993,0,9999,6
1746591639794,CLRE 253,A00,891867,Vaida; Florin,9994,0,9999,5
1746591639794,CLRE 253,B00,907819,Staff,9999,0,9999,0
1746591640823,CLRE 259,A00,891868,Patel; Hemal,9998,0,9999,1
1746591641847,CLRE 260,A00,891872,Cuomo; Raphael Eduardo,9999,0,9999,0
1746591642872,CLRE 297,001,891888,Cuomo; Raphael Eduardo,9999,0,9999,0
1746591643898,CSE 191,A00,958773,Minnes Kemp; Mor Mia,9995,0,9999,4
1746591644926,CSE 197,001,959846,Minnes Kemp; Mor Mia,9990,0,9999,9
1746591645955,CSS 201S,A01,892054,Mignozzetti; Umberto,25,0,30,5
1746591646981,CSS 202S,A01,892056,Mignozzetti; Umberto,25,0,30,5
1746591648006,DSC 197,001,956898,Eldridge; Justin Matthew,9996,0,9999,3
1746591649034,DSC 297,001,958000,Mazumdar; Arya,9998,0,9999,1
1746591649034,DSC 297,002,959862,Wang; Yusu,9998,0,9999,1
1746591650061,EAP 100,A00,905686,Staff,9778,0,9999,221
1746591651087,ECE 45,A01,892618,Staff,0,0,65,65
1746591653141,ECE 111,A01,892719,Staff,6,0,65,59
1746591654165,ECE 197,001,957920,Mercier; Patrick Philip,9991,0,9999,8
1746591655197,ECON 178,A01,907814,Zhu; Ying,26,0,35,9
1746591656224,EDS 115,A00,895312,Staff,35,0,45,10
1746591657251,EDS 117,A01,895337,Staff,23,0,30,7
1746591658278,EDS 125,A00,895341,Jones; Gabrielle Anastasia,36,0,45,9
1746591659303,EDS 128A,A01,895459,Fargason; Sharon Gayle,44,0,45,1
1746591660331,EDS 128B,A01,895543,Pappas; Elizabeth,44,0,45,1
1746591661355,EDS 139,A00,897203,Pappas; Elizabeth,44,0,45,1
1746591661355,EDS 139,B00,897209,Fargason; Sharon Gayle,41,0,45,4
1746591662413,EDS 201,A00,895545,Staff,22,0,45,23
1746591663438,EDS 203,A01,895581,Halter; Christopher P.,22,0,45,23
1746591664462,EDS 204R,A01,895625,Heinzman; Erica M.,39,0,45,6
1746591664462,EDS 204R,B01,895693,Halter; Christopher P.,10,0,45,35
1746591665488,EDS 206R,A00,895694,Fargason; Sharon Gayle,1,0,30,29
1746591665488,EDS 206R,B00,895695,Choi; Bailey Miyeon,16,0,30,14
1746591666514,EDS 250,A00,895697,Hemans; Patricia Ann Benitez,22,0,45,23
1746591667540,EDS 281,A00,895701,Meyerott; Theresa Ann,1,0,15,14
1746591668567,EDS 284,A00,895736,Meyerott; Theresa Ann,1,0,15,14
1746591669593,EDS 286,A00,897210,Fine; Sarah,0,0,15,15
1746591670618,EDS 289C,A01,895770,Daly; Alan J.,1,0,15,14
1746591671646,EDS 290,A00,897211,Hofstetter; Carolyn,0,0,15,15
1746591672673,LIGM 5A,A00,896162,Fischer-Grunski; Eva K,12,0,20,8
1746591673700,LIGM 5B,A00,896260,Fischer-Grunski; Eva K,17,0,20,3
1746591674725,LIGM 5C,A00,896308,Fischer-Grunski; Eva K,18,0,20,2
1746591675756,LIIT 5AS,A00,896313,Carnelos; Chiara,18,0,20,2
1746591676784,LIIT 5BS,A00,896416,Carnelos; Chiara,20,0,20,0
1746591677809,LIIT 5CS,A00,896564,Carnelos; Chiara,20,0,20,0
1746591678836,LISP 5A,A00,896588,Munoz Sanchez; Alicia,2,0,20,18
1746591679867,LISP 5B,A00,896653,Munoz Sanchez; Alicia,7,0,20,13
1746591680892,LISP 5C,A00,896655,Munoz Sanchez; Alicia,0,1,20,20
1746591681919,MAE 197,001,957918,Kleissl; Jan,9996,0,9999,3
1746591681919,MAE 197,002,959806,Boechler; Nicholas Sebastia,9998,0,9999,1
1746591681919,MAE 197,003,959852,Mullin; Jennifer S,9998,0,9999,1
1746591682947,MATH 2,A01,957937,Staff,33,0,35,2
1746591683974,MATH 197,001,957876,Kedlaya; Kiran S.,9993,0,9999,6
1746591685003,MCWP 40,A00,892729,Duru; Nur,10,0,20,10
1746591685003,MCWP 40,B00,893304,Montejo; Carolina,14,0,20,6
1746591686033,MCWP 40R,A00,893757,Redela; Pamela Morgan,0,5,20,20
1746591687062,MCWP 50,A00,893758,Morshed; Michael James,0,0,20,20
1746591687062,MCWP 50,B00,893761,Bartulis; Jason Michael,17,0,20,3
1746591688087,MCWP 50R,A00,893766,Compas; Sean Matthew,0,1,20,20
1746591688087,MCWP 50R,B00,893769,Carter; Jennifer A,0,1,20,20
1746591688087,MCWP 50R,C00,893771,Krone; Jarret,0,3,20,20
1746591688087,MCWP 50R,D00,893772,Miller; Elizabeth Deen,0,0,20,20
1746591688087,MCWP 50R,E00,893775,Carter; Andrea L,0,1,20,20
1746591689116,MMW 11R,A01,892721,Herbst; Matthew,14,0,30,16
1746591689116,MMW 11R,A02,892722,Herbst; Matthew,0,0,0,3
1746591690147,MMW 12R,A01,892724,Herbst; Matthew,0,11,16,16
1746591690147,MMW 12R,A02,892725,Herbst; Matthew,0,10,16,16
1746591691173,MMW 13R,A01,892727,Staff,0,4,16,16
1746591691173,MMW 13R,A02,892728,Staff,0,4,16,16
1746591691173,MMW 13R,A03,958032,Staff,0,4,16,16
1746591691173,MMW 13R,A04,958033,Staff,0,4,16,16
1746591691173,MMW 13R,A05,958034,Staff,0,4,16,16
1746591692200,SIO 295LS,A00,894015,Staff,5,0,25,20
1746591693227,SIO 295S,A00,894020,Staff,5,0,25,20
1746591694258,SIOC 290S,B01,958918,Merrifield; Mark A,14,0,30,16
1746591695289,SIOC 291S,B01,958922,Gabriel; Corey John,14,0,30,16
1746591696316,SOCI 117,A01,895339,Staff,3,0,5,2
1746591697343,WES 237B,A00,894149,Staff,11,0,20,9
1746591699412,AESE 279B,A00,891859,Staff,13,0,35,22
1746591700438,AIP 197,001,891854,Vespa; Emanuel Ignacio,9999,0,9999,0
1746591701467,ANTH 289S,A00,891856,Gagneux; Pascal,12,0,12,0
1746591702496,BENG 196,001,957946,Engler; Adam J.,9996,0,9999,3
1746591703521,BISP 197,001,959851,Wilhelm; James E.,9998,0,9999,1
1746591704548,CAT 124RS,A01,956906,Staff,6,0,25,19
1746591705575,CAT 125RS,A01,922013,Staff,6,0,25,19
1746591706600,CLRE 250,A00,891860,Morris; Sheldon,9995,0,9999,4
1746591708659,CLRE 251R,A00,907817,Mehta; Ravindra L.,9994,0,9999,5
1746591709685,CLRE 252,A00,891864,Cuomo; Raphael Eduardo,9993,0,9999,6
1746591710709,CLRE 253,A00,891867,Vaida; Florin,9994,0,9999,5
1746591710709,CLRE 253,B00,907819,Staff,9999,0,9999,0
1746591711734,CLRE 259,A00,891868,Patel; Hemal,9998,0,9999,1
1746591712766,CLRE 260,A00,891872,Cuomo; Raphael Eduardo,9999,0,9999,0
1746591713791,CLRE 297,001,891888,Cuomo; Raphael Eduardo,9999,0,9999,0
1746591714815,CSE 191,A00,958773,Minnes Kemp; Mor Mia,9995,0,9999,4
1746591715845,CSE 197,001,959846,Minnes Kemp; Mor Mia,9990,0,9999,9
1746591716879,CSS 201S,A01,892054,Mignozzetti; Umberto,25,0,30,5
1746591717917,CSS 202S,A01,892056,Mignozzetti; Umberto,25,0,30,5
1746591718942,DSC 197,001,956898,Eldridge; Justin Matthew,9996,0,9999,3
1746591719969,DSC 297,001,958000,Mazumdar; Arya,9998,0,9999,1
1746591719969,DSC 297,002,959862,Wang; Yusu,9998,0,9999,1
1746591720994,EAP 100,A00,905686,Staff,9778,0,9999,221
1746591722029,ECE 45,A01,892618,Staff,0,0,65,65
1746591724078,ECE 111,A01,892719,Staff,6,0,65,59
1746591725106,ECE 197,001,957920,Mercier; Patrick Philip,9991,0,9999,8
1746591726131,ECON 178,A01,907814,Zhu; Ying,26,0,35,9
1746591727158,EDS 115,A00,895312,Staff,35,0,45,10
1746591728185,EDS 117,A01,895337,Staff,23,0,30,7
1746591729214,EDS 125,A00,895341,Jones; Gabrielle Anastasia,36,0,45,9
1746591730240,EDS 128A,A01,895459,Fargason; Sharon Gayle,44,0,45,1
1746591731262,EDS 128B,A01,895543,Pappas; Elizabeth,44,0,45,1
1746591732286,EDS 139,A00,897203,Pappas; Elizabeth,44,0,45,1
1746591732286,EDS 139,B00,897209,Fargason; Sharon Gayle,41,0,45,4
1746591733333,EDS 201,A00,895545,Staff,22,0,45,23
1746591734362,EDS 203,A01,895581,Halter; Christopher P.,22,0,45,23
1746591735388,EDS 204R,A01,895625,Heinzman; Erica M.,39,0,45,6
1746591735388,EDS 204R,B01,895693,Halter; Christopher P.,10,0,45,35
1746591736411,EDS 206R,A00,895694,Fargason; Sharon Gayle,1,0,30,29
1746591736411,EDS 206R,B00,895695,Choi; Bailey Miyeon,16,0,30,14
1746591737439,EDS 250,A00,895697,Hemans; Patricia Ann Benitez,22,0,45,23
1746591738466,EDS 281,A00,895701,Meyerott; Theresa Ann,1,0,15,14
1746591739512,EDS 284,A00,895736,Meyerott; Theresa Ann,1,0,15,14
1746591740540,EDS 286,A00,897210,Fine; Sarah,0,0,15,15
1746591741567,EDS 289C,A01,895770,Daly; Alan J.,1,0,15,14
1746591742597,EDS 290,A00,897211,Hofstetter; Carolyn,0,0,15,15
1746591743624,LIGM 5A,A00,896162,Fischer-Grunski; Eva K,12,0,20,8
1746591744647,LIGM 5B,A00,896260,Fischer-Grunski; Eva K,17,0,20,3
1746591745672,LIGM 5C,A00,896308,Fischer-Grunski; Eva K,18,0,20,2
1746591746699,LIIT 5AS,A00,896313,Carnelos; Chiara,18,0,20,2
1746591747727,LIIT 5BS,A00,896416,Carnelos; Chiara,20,0,20,0
1746591748753,LIIT 5CS,A00,896564,Carnelos; Chiara,20,0,20,0
1746591749783,LISP 5A,A00,896588,Munoz Sanchez; Alicia,2,0,20,18
1746591750811,LISP 5B,A00,896653,Munoz Sanchez; Alicia,7,0,20,13
1746591751842,LISP 5C,A00,896655,Munoz Sanchez; Alicia,0,1,20,20
1746591752868,MAE 197,001,957918,Kleissl; Jan,9996,0,9999,3
1746591752868,MAE 197,002,959806,Boechler; Nicholas Sebastia,9998,0,9999,1
1746591752868,MAE 197,003,959852,Mullin; Jennifer S,9998,0,9999,1
1746591753893,MATH 2,A01,957937,Staff,33,0,35,2
1746591754919,MATH 197,001,957876,Kedlaya; Kiran S.,9993,0,9999,6
1746591755945,MCWP 40,A00,892729,Duru; Nur,10,0,20,10
1746591755945,MCWP 40,B00,893304,Montejo; Carolina,14,0,20,6
1746591756969,MCWP 40R,A00,893757,Redela; Pamela Morgan,0,5,20,20
1746591757995,MCWP 50,A00,893758,Morshed; Michael James,0,0,20,20
1746591757995,MCWP 50,B00,893761,Bartulis; Jason Michael,17,0,20,3
1746591759022,MCWP 50R,A00,893766,Compas; Sean Matthew,0,1,20,20
1746591759022,MCWP 50R,B00,893769,Carter; Jennifer A,0,1,20,20
1746591759022,MCWP 50R,C00,893771,Krone; Jarret,0,3,20,20
1746591759022,MCWP 50R,D00,893772,Miller; Elizabeth Deen,0,0,20,20
1746591759022,MCWP 50R,E00,893775,Carter; Andrea L,0,1,20,20
1746591760047,MMW 11R,A01,892721,Herbst; Matthew,14,0,30,16
1746591760047,MMW 11R,A02,892722,Herbst; Matthew,0,0,0,3
1746591761073,MMW 12R,A01,892724,Herbst; Matthew,0,11,16,16
1746591761073,MMW 12R,A02,892725,Herbst; Matthew,0,10,16,16
1746591762101,MMW 13R,A01,892727,Staff,0,4,16,16
1746591762101,MMW 13R,A02,892728,Staff,0,4,16,16
1746591762101,MMW 13R,A03,958032,Staff,0,4,16,16
1746591762101,MMW 13R,A04,958033,Staff,0,4,16,16
1746591762101,MMW 13R,A05,958034,Staff,0,4,16,16
1746591763128,SIO 295LS,A00,894015,Staff,5,0,25,20
1746591764153,SIO 295S,A00,894020,Staff,5,0,25,20
1746591765177,SIOC 290S,B01,958918,Merrifield; Mark A,14,0,30,16
1746591766206,SIOC 291S,B01,958922,Gabriel; Corey John,14,0,30,16
1746591767248,SOCI 117,A01,895339,Staff,3,0,5,2
1746591768276,WES 237B,A00,894149,Staff,11,0,20,9
1746591770336,AESE 279B,A00,891859,Staff,13,0,35,22
1746591771364,AIP 197,001,891854,Vespa; Emanuel Ignacio,9999,0,9999,0
1746591772400,ANTH 289S,A00,891856,Gagneux; Pascal,12,0,12,0
1746591773428,BENG 196,001,957946,Engler; Adam J.,9996,0,9999,3
1746591774452,BISP 197,001,959851,Wilhelm; James E.,9998,0,9999,1
1746591775480,CAT 124RS,A01,956906,Staff,6,0,25,19
1746591776506,CAT 125RS,A01,922013,Staff,6,0,25,19
1746591777534,CLRE 250,A00,891860,Morris; Sheldon,9995,0,9999,4
1746591779588,CLRE 251R,A00,907817,Mehta; Ravindra L.,9994,0,9999,5
1746591780618,CLRE 252,A00,891864,Cuomo; Raphael Eduardo,9993,0,9999,6
1746591781649,CLRE 253,A00,891867,Vaida; Florin,9994,0,9999,5
1746591781649,CLRE 253,B00,907819,Staff,9999,0,9999,0
1746591782678,CLRE 259,A00,891868,Patel; Hemal,9998,0,9999,1
1746591783703,CLRE 260,A00,891872,Cuomo; Raphael Eduardo,9999,0,9999,0
1746591784729,CLRE 297,001,891888,Cuomo; Raphael Eduardo,9999,0,9999,0
1746591785758,CSE 191,A00,958773,Minnes Kemp; Mor Mia,9995,0,9999,4
1746591786789,CSE 197,001,959846,Minnes Kemp; Mor Mia,9990,0,9999,9
1746591787815,CSS 201S,A01,892054,Mignozzetti; Umberto,25,0,30,5
1746591788840,CSS 202S,A01,892056,Mignozzetti; Umberto,25,0,30,5
1746591789867,DSC 197,001,956898,Eldridge; Justin Matthew,9996,0,9999,3
1746591790892,DSC 297,001,958000,Mazumdar; Arya,9998,0,9999,1
1746591790892,DSC 297,002,959862,Wang; Yusu,9998,0,9999,1
1746591791917,EAP 100,A00,905686,Staff,9778,0,9999,221
1746591792948,ECE 45,A01,892618,Staff,0,0,65,65
1746591795002,ECE 111,A01,892719,Staff,6,0,65,59
1746591796029,ECE 197,001,957920,Mercier; Patrick Philip,9991,0,9999,8
1746591797059,ECON 178,A01,907814,Zhu; Ying,26,0,35,9
1746591798083,EDS 115,A00,895312,Staff,35,0,45,10
1746591799109,EDS 117,A01,895337,Staff,23,0,30,7
1746591800136,EDS 125,A00,895341,Jones; Gabrielle Anastasia,36,0,45,9
1746591801163,EDS 128A,A01,895459,Fargason; Sharon Gayle,44,0,45,1
1746591802187,EDS 128B,A01,895543,Pappas; Elizabeth,44,0,45,1
1746591803214,EDS 139,A00,897203,Pappas; Elizabeth,44,0,45,1
1746591803214,EDS 139,B00,897209,Fargason; Sharon Gayle,41,0,45,4
1746591804238,EDS 201,A00,895545,Staff,22,0,45,23
1746591805268,EDS 203,A01,895581,Halter; Christopher P.,22,0,45,23
1746591806293,EDS 204R,A01,895625,Heinzman; Erica M.,39,0,45,6
1746591806293,EDS 204R,B01,895693,Halter; Christopher P.,10,0,45,35
1746591807319,EDS 206R,A00,895694,Fargason; Sharon Gayle,1,0,30,29
1746591807319,EDS 206R,B00,895695,Choi; Bailey Miyeon,16,0,30,14
1746591808344,EDS 250,A00,895697,Hemans; Patricia Ann Benitez,22,0,45,23
1746591809370,EDS 281,A00,895701,Meyerott; Theresa Ann,1,0,15,14
1746591810393,EDS 284,A00,895736,Meyerott; Theresa Ann,1,0,15,14
1746591811421,EDS 286,A00,897210,Fine; Sarah,0,0,15,15
1746591812446,EDS 289C,A01,895770,Daly; Alan J.,1,0,15,14
1746591813475,EDS 290,A00,897211,Hofstetter; Carolyn,0,0,15,15
1746591814502,LIGM 5A,A00,896162,Fischer-Grunski; Eva K,12,0,20,8
1746591815529,LIGM 5B,A00,896260,Fischer-Grunski; Eva K,17,0,20,3
1746591816558,LIGM 5C,A00,896308,Fischer-Grunski; Eva K,18,0,20,2
1746591817589,LIIT 5AS,A00,896313,Carnelos; Chiara,18,0,20,2
1746591818617,LIIT 5BS,A00,896416,Carnelos; Chiara,20,0,20,0
1746591819645,LIIT 5CS,A00,896564,Carnelos; Chiara,20,0,20,0
1746591820674,LISP 5A,A00,896588,Munoz Sanchez; Alicia,2,0,20,18
1746591821699,LISP 5B,A00,896653,Munoz Sanchez; Alicia,7,0,20,13
1746591822729,LISP 5C,A00,896655,Munoz Sanchez; Alicia,0,1,20,20
1746591823755,MAE 197,001,957918,Kleissl; Jan,9996,0,9999,3
1746591823755,MAE 197,002,959806,Boechler; Nicholas Sebastia,9998,0,9999,1
1746591823755,MAE 197,003,959852,Mullin; Jennifer S,9998,0,9999,1
1746591824781,MATH 2,A01,957937,Staff,33,0,35,2
1746591825806,MATH 197,001,957876,Kedlaya; Kiran S.,9993,0,9999,6
1746591826832,MCWP 40,A00,892729,Duru; Nur,10,0,20,10
1746591826832,MCWP 40,B00,893304,Montejo; Carolina,14,0,20,6
1746591827858,MCWP 40R,A00,893757,Redela; Pamela Morgan,0,5,20,20
1746591828886,MCWP 50,A00,893758,Morshed; Michael James,0,0,20,20
1746591828886,MCWP 50,B00,893761,Bartulis; Jason Michael,17,0,20,3
1746591829912,MCWP 50R,A00,893766,Compas; Sean Matthew,0,1,20,20
1746591829912,MCWP 50R,B00,893769,Carter; Jennifer A,0,1,20,20
1746591829912,MCWP 50R,C00,893771,Krone; Jarret,0,3,20,20
1746591829912,MCWP 50R,D00,893772,Miller; Elizabeth Deen,0,0,20,20
1746591829912,MCWP 50R,E00,893775,Carter; Andrea L,0,1,20,20
1746591830938,MMW 11R,A01,892721,Herbst; Matthew,14,0,30,16
1746591830938,MMW 11R,A02,892722,Herbst; Matthew,0,0,0,3
1746591831963,MMW 12R,A01,892724,Herbst; Matthew,0,11,16,16
1746591831963,MMW 12R,A02,892725,Herbst; Matthew,0,10,16,16
1746591832990,MMW 13R,A01,892727,Staff,0,4,16,16
1746591832990,MMW 13R,A02,892728,Staff,0,4,16,16
1746591832990,MMW 13R,A03,958032,Staff,0,4,16,16
1746591832990,MMW 13R,A04,958033,Staff,0,4,16,16
1746591832990,MMW 13R,A05,958034,Staff,0,4,16,16
1746591834016,SIO 295LS,A00,894015,Staff,5,0,25,20
1746591835051,SIO 295S,A00,894020,Staff,5,0,25,20
1746591836080,SIOC 290S,B01,958918,Merrifield; Mark A,14,0,30,16
1746591837110,SIOC 291S,B01,958922,Gabriel; Corey John,14,0,30,16
1746591838135,SOCI 117,A01,895339,Staff,3,0,5,2
1746591839160,WES 237B,A00,894149,Staff,11,0,20,9
1746591841230,AESE 279B,A00,891859,Staff,13,0,35,22
1746591842255,AIP 197,001,891854,Vespa; Emanuel Ignacio,9999,0,9999,0
1746591843281,ANTH 289S,A00,891856,Gagneux; Pascal,12,0,12,0
1746591844310,BENG 196,001,957946,Engler; Adam J.,9996,0,9999,3
1746591845338,BISP 197,001,959851,Wilhelm; James E.,9998,0,9999,1
1746591846363,CAT 124RS,A01,956906,Staff,6,0,25,19
1746591847389,CAT 125RS,A01,922013,Staff,6,0,25,19
1746591848418,CLRE 250,A00,891860,Morris; Sheldon,9995,0,9999,4
1746591850470,CLRE 251R,A00,907817,Mehta; Ravindra L.,9994,0,9999,5
1746591851497,CLRE 252,A00,891864,Cuomo; Raphael Eduardo,9993,0,9999,6
1746591852526,CLRE 253,A00,891867,Vaida; Florin,9994,0,9999,5
1746591852526,CLRE 253,B00,907819,Staff,9999,0,9999,0
1746591853551,CLRE 259,A00,891868,Patel; Hemal,9998,0,9999,1
1746591854578,CLRE 260,A00,891872,Cuomo; Raphael Eduardo,9999,0,9999,0
1746591855603,CLRE 297,001,891888,Cuomo; Raphael Eduardo,9999,0,9999,0
1746591856628,CSE 191,A00,958773,Minnes Kemp; Mor Mia,9995,0,9999,4
1746591857652,CSE 197,001,959846,Minnes Kemp; Mor Mia,9990,0,9999,9
1746591858679,CSS 201S,A01,892054,Mignozzetti; Umberto,25,0,30,5
1746591859704,CSS 202S,A01,892056,Mignozzetti; Umberto,25,0,30,5
1746591860733,DSC 197,001,956898,Eldridge; Justin Matthew,9996,0,9999,3
1746591861761,DSC 297,001,958000,Mazumdar; Arya,9998,0,9999,1
1746591861761,DSC 297,002,959862,Wang; Yusu,9998,0,9999,1
1746591862785,EAP 100,A00,905686,Staff,9778,0,9999,221
1746591863810,ECE 45,A01,892618,Staff,0,0,65,65
1746591865868,ECE 111,A01,892719,Staff,6,0,65,59
1746591866893,ECE 197,001,957920,Mercier; Patrick Philip,9991,0,9999,8
1746591867918,ECON 178,A01,907814,Zhu; Ying,26,0,35,9
1746591868942,EDS 115,A00,895312,Staff,35,0,45,10
1746591869971,EDS 117,A01,895337,Staff,23,0,30,7
1746591871021,EDS 125,A00,895341,Jones; Gabrielle Anastasia,36,0,45,9
1746591872048,EDS 128A,A01,895459,Fargason; Sharon Gayle,44,0,45,1
1746591873073,EDS 128B,A01,895543,Pappas; Elizabeth,44,0,45,1
1746591874101,EDS 139,A00,897203,Pappas; Elizabeth,44,0,45,1
1746591874101,EDS 139,B00,897209,Fargason; Sharon Gayle,41,0,45,4
1746591875126,EDS 201,A00,895545,Staff,22,0,45,23
1746591876153,EDS 203,A01,895581,Halter; Christopher P.,22,0,45,23
1746591877181,EDS 204R,A01,895625,Heinzman; Erica M.,39,0,45,6
1746591877181,EDS 204R,B01,895693,Halter; Christopher P.,10,0,45,35
1746591878206,EDS 206R,A00,895694,Fargason; Sharon Gayle,1,0,30,29
1746591878206,EDS 206R,B00,895695,Choi; Bailey Miyeon,16,0,30,14
1746591879232,EDS 250,A00,895697,Hemans; Patricia Ann Benitez,22,0,45,23
1746591880257,EDS 281,A00,895701,Meyerott; Theresa Ann,1,0,15,14
1746591881281,EDS 284,A00,895736,Meyerott; Theresa Ann,1,0,15,14
1746591882306,EDS 286,A00,897210,Fine; Sarah,0,0,15,15
1746591883330,EDS 289C,A01,895770,Daly; Alan J.,1,0,15,14
1746591884357,EDS 290,A00,897211,Hofstetter; Carolyn,0,0,15,15
1746591885383,LIGM 5A,A00,896162,Fischer-Grunski; Eva K,12,0,20,8
1746591886408,LIGM 5B,A00,896260,Fischer-Grunski; Eva K,17,0,20,3
1746591887439,LIGM 5C,A00,896308,Fischer-Grunski; Eva K,18,0,20,2
1746591888464,LIIT 5AS,A00,896313,Carnelos; Chiara,18,0,20,2
1746591889489,LIIT 5BS,A00,896416,Carnelos; Chiara,20,0,20,0
1746591890518,LIIT 5CS,A00,896564,Carnelos; Chiara,20,0,20,0
1746591891542,LISP 5A,A00,896588,Munoz Sanchez; Alicia,2,0,20,18
1746591892568,LISP 5B,A00,896653,Munoz Sanchez; Alicia,7,0,20,13
1746591893592,LISP 5C,A00,896655,Munoz Sanchez; Alicia,0,1,20,20
1746591894622,MAE 197,001,957918,Kleissl; Jan,9996,0,9999,3
1746591894622,MAE 197,002,959806,Boechler; Nicholas Sebastia,9998,0,9999,1
1746591894622,MAE 197,003,959852,Mullin; Jennifer S,9998,0,9999,1
1746591895649,MATH 2,A01,957937,Staff,33,0,35,2
1746591896691,MATH 197,001,957876,Kedlaya; Kiran S.,9993,0,9999,6
1746591897715,MCWP 40,A00,892729,Duru; Nur,10,0,20,10
1746591897715,MCWP 40,B00,893304,Montejo; Carolina,14,0,20,6
1746591898740,MCWP 40R,A00,893757,Redela; Pamela Morgan,0,5,20,20
1746591899765,MCWP 50,A00,893758,Morshed; Michael James,0,0,20,20
1746591899765,MCWP 50,B00,893761,Bartulis; Jason Michael,17,0,20,3
1746591900790,MCWP 50R,A00,893766,Compas; Sean Matthew,0,1,20,20
1746591900790,MCWP 50R,B00,893769,Carter; Jennifer A,0,1,20,20
1746591900790,MCWP 50R,C00,893771,Krone; Jarret,0,3,20,20
1746591900790,MCWP 50R,D00,893772,Miller; Elizabeth Deen,0,0,20,20
1746591900790,MCWP 50R,E00,893775,Carter; Andrea L,0,1,20,20
1746591901833,MMW 11R,A01,892721,Herbst; Matthew,14,0,30,16
1746591901833,MMW 11R,A02,892722,Herbst; Matthew,0,0,0,3
1746591902859,MMW 12R,A01,892724,Herbst; Matthew,0,11,16,16
1746591902859,MMW 12R,A02,892725,Herbst; Matthew,0,10,16,16
1746591903886,MMW 13R,A01,892727,Staff,0,4,16,16
1746591903886,MMW 13R,A02,892728,Staff,0,4,16,16
1746591903886,MMW 13R,A03,958032,Staff,0,4,16,16
1746591903886,MMW 13R,A04,958033,Staff,0,4,16,16
1746591903886,MMW 13R,A05,958034,Staff,0,4,16,16
1746591904914,SIO 295LS,A00,894015,Staff,5,0,25,20
1746591905941,SIO 295S,A00,894020,Staff,5,0,25,20
1746591906971,SIOC 290S,B01,958918,Merrifield; Mark A,14,0,30,16
1746591908001,SIOC 291S,B01,958922,Gabriel; Corey John,14,0,30,16
1746591909101,SOCI 117,A01,895339,Staff,3,0,5,2
1746591910128,WES 237B,A00,894149,Staff,11,0,20,9
1746591912186,AESE 279B,A00,891859,Staff,13,0,35,22
1746591913213,AIP 197,001,891854,Vespa; Emanuel Ignacio,9999,0,9999,0
1746591914241,ANTH 289S,A00,891856,Gagneux; Pascal,12,0,12,0
1746591915266,BENG 196,001,957946,Engler; Adam J.,9996,0,9999,3
1746591916290,BISP 197,001,959851,Wilhelm; James E.,9998,0,9999,1
1746591917317,CAT 124RS,A01,956906,Staff,6,0,25,19
1746591918343,CAT 125RS,A01,922013,Staff,6,0,25,19
1746591919369,CLRE 250,A00,891860,Morris; Sheldon,9995,0,9999,4
1746591921419,CLRE 251R,A00,907817,Mehta; Ravindra L.,9994,0,9999,5
1746591922448,CLRE 252,A00,891864,Cuomo; Raphael Eduardo,9993,0,9999,6
1746591923478,CLRE 253,A00,891867,Vaida; Florin,9994,0,9999,5
1746591923478,CLRE 253,B00,907819,Staff,9999,0,9999,0
1746591924508,CLRE 259,A00,891868,Patel; Hemal,9998,0,9999,1
1746591925536,CLRE 260,A00,891872,Cuomo; Raphael Eduardo,9999,0,9999,0
1746591926562,CLRE 297,001,891888,Cuomo; Raphael Eduardo,9999,0,9999,0
1746591927589,CSE 191,A00,958773,Minnes Kemp; Mor Mia,9995,0,9999,4
1746591928616,CSE 197,001,959846,Minnes Kemp; Mor Mia,9990,0,9999,9
1746591929642,CSS 201S,A01,892054,Mignozzetti; Umberto,25,0,30,5
1746591930667,CSS 202S,A01,892056,Mignozzetti; Umberto,25,0,30,5
1746591931693,DSC 197,001,956898,Eldridge; Justin Matthew,9996,0,9999,3
1746591932721,DSC 297,001,958000,Mazumdar; Arya,9998,0,9999,1
1746591932721,DSC 297,002,959862,Wang; Yusu,9998,0,9999,1
1746591933749,EAP 100,A00,905686,Staff,9778,0,9999,221
1746591934777,ECE 45,A01,892618,Staff,0,0,65,65
1746591936887,ECE 111,A01,892719,Staff,6,0,65,59
1746591937913,ECE 197,001,957920,Mercier; Patrick Philip,9991,0,9999,8
1746591938945,ECON 178,A01,907814,Zhu; Ying,26,0,35,9
1746591939992,EDS 115,A00,895312,Staff,35,0,45,10
1746591941023,EDS 117,A01,895337,Staff,23,0,30,7
1746591942048,EDS 125,A00,895341,Jones; Gabrielle Anastasia,36,0,45,9
1746591943074,EDS 128A,A01,895459,Fargason; Sharon Gayle,44,0,45,1
1746591944100,EDS 128B,A01,895543,Pappas; Elizabeth,44,0,45,1
1746591945124,EDS 139,A00,897203,Pappas; Elizabeth,44,0,45,1
1746591945124,EDS 139,B00,897209,Fargason; Sharon Gayle,41,0,45,4
1746591946149,EDS 201,A00,895545,Staff,22,0,45,23
1746591947176,EDS 203,A01,895581,Halter; Christopher P.,22,0,45,23
1746591948204,EDS 204R,A01,895625,Heinzman; Erica M.,39,0,45,6
1746591948204,EDS 204R,B01,895693,Halter; Christopher P.,10,0,45,35
1746591949234,EDS 206R,A00,895694,Fargason; Sharon Gayle,1,0,30,29
1746591949234,EDS 206R,B00,895695,Choi; Bailey Miyeon,16,0,30,14
1746591950263,EDS 250,A00,895697,Hemans; Patricia Ann Benitez,22,0,45,23
1746591951291,EDS 281,A00,895701,Meyerott; Theresa Ann,1,0,15,14
1746591952319,EDS 284,A00,895736,Meyerott; Theresa Ann,1,0,15,14
1746591953347,EDS 286,A00,897210,Fine; Sarah,0,0,15,15
1746591954376,EDS 289C,A01,895770,Daly; Alan J.,1,0,15,14
1746591955404,EDS 290,A00,897211,Hofstetter; Carolyn,0,0,15,15
1746591956433,LIGM 5A,A00,896162,Fischer-Grunski; Eva K,12,0,20,8
1746591957460,LIGM 5B,A00,896260,Fischer-Grunski; Eva K,17,0,20,3
1746591958488,LIGM 5C,A00,896308,Fischer-Grunski; Eva K,18,0,20,2
1746591959513,LIIT 5AS,A00,896313,Carnelos; Chiara,18,0,20,2
1746591960543,LIIT 5BS,A00,896416,Carnelos; Chiara,20,0,20,0
1746591961567,LIIT 5CS,A00,896564,Carnelos; Chiara,20,0,20,0
1746591962593,LISP 5A,A00,896588,Munoz Sanchez; Alicia,2,0,20,18
1746591963623,LISP 5B,A00,896653,Munoz Sanchez; Alicia,7,0,20,13
1746591964649,LISP 5C,A00,896655,Munoz Sanchez; Alicia,0,1,20,20
1746591965678,MAE 197,001,957918,Kleissl; Jan,9996,0,9999,3
1746591965678,MAE 197,002,959806,Boechler; Nicholas Sebastia,9998,0,9999,1
1746591965678,MAE 197,003,959852,Mullin; Jennifer S,9998,0,9999,1
1746591966707,MATH 2,A01,957937,Staff,33,0,35,2
1746591967733,MATH 197,001,957876,Kedlaya; Kiran S.,9993,0,9999,6
1746591968758,MCWP 40,A00,892729,Duru; Nur,10,0,20,10
1746591968758,MCWP 40,B00,893304,Montejo; Carolina,14,0,20,6
1746591969786,MCWP 40R,A00,893757,Redela; Pamela Morgan,0,5,20,20
1746591970810,MCWP 50,A00,893758,Morshed; Michael James,0,0,20,20
1746591970810,MCWP 50,B00,893761,Bartulis; Jason Michael,17,0,20,3
1746591971835,MCWP 50R,A00,893766,Compas; Sean Matthew,0,1,20,20
1746591971835,MCWP 50R,B00,893769,Carter; Jennifer A,0,1,20,20
1746591971835,MCWP 50R,C00,893771,Krone; Jarret,0,3,20,20
1746591971835,MCWP 50R,D00,893772,Miller; Elizabeth Deen,0,0,20,20
1746591971835,MCWP 50R,E00,893775,Carter; Andrea L,0,1,20,20
1746591972862,MMW 11R,A01,892721,Herbst; Matthew,14,0,30,16
1746591972862,MMW 11R,A02,892722,Herbst; Matthew,0,0,0,3
1746591973890,MMW 12R,A01,892724,Herbst; Matthew,0,11,16,16
1746591973890,MMW 12R,A02,892725,Herbst; Matthew,0,10,16,16
1746591974918,MMW 13R,A01,892727,Staff,0,4,16,16
1746591974918,MMW 13R,A02,892728,Staff,0,4,16,16
1746591974918,MMW 13R,A03,958032,Staff,0,4,16,16
1746591974918,MMW 13R,A04,958033,Staff,0,4,16,16
1746591974918,MMW 13R,A05,958034,Staff,0,4,16,16
1746591975944,SIO 295LS,A00,894015,Staff,5,0,25,20
1746591976972,SIO 295S,A00,894020,Staff,5,0,25,20
1746591977999,SIOC 290S,B01,958918,Merrifield; Mark A,14,0,30,16
1746591979025,SIOC 291S,B01,958922,Gabriel; Corey John,14,0,30,16
1746591980051,SOCI 117,A01,895339,Staff,3,0,5,2
1746591981078,WES 237B,A00,894149,Staff,11,0,20,9
1746591983142,AESE 279B,A00,891859,Staff,13,0,35,22
1746591984173,AIP 197,001,891854,Vespa; Emanuel Ignacio,9999,0,9999,0
1746591985201,ANTH 289S,A00,891856,Gagneux; Pascal,12,0,12,0
1746591986227,BENG 196,001,957946,Engler; Adam J.,9996,0,9999,3
1746591987254,BISP 197,001,959851,Wilhelm; James E.,9998,0,9999,1
1746591988280,CAT 124RS,A01,956906,Staff,6,0,25,19
1746591989309,CAT 125RS,A01,922013,Staff,6,0,25,19
1746591990335,CLRE 250,A00,891860,Morris; Sheldon,9995,0,9999,4
1746591992386,CLRE 251R,A00,907817,Mehta; Ravindra L.,9994,0,9999,5
1746591993413,CLRE 252,A00,891864,Cuomo; Raphael Eduardo,9993,0,9999,6
1746591994437,CLRE 253,A00,891867,Vaida; Florin,9994,0,9999,5
1746591994437,CLRE 253,B00,907819,Staff,9999,0,9999,0
1746591995462,CLRE 259,A00,891868,Patel; Hemal,9998,0,9999,1
1746591996488,CLRE 260,A00,891872,Cuomo; Raphael Eduardo,9999,0,9999,0
1746591997518,CLRE 297,001,891888,Cuomo; Raphael Eduardo,9999,0,9999,0
1746591998545,CSE 191,A00,958773,Minnes Kemp; Mor Mia,9995,0,9999,4
1746591999573,CSE 197,001,959846,Minnes Kemp; Mor Mia,9990,0,9999,9
1746592000605,CSS 201S,A01,892054,Mignozzetti; Umberto,25,0,30,5
1746592001635,CSS 202S,A01,892056,Mignozzetti; Umberto,25,0,30,5
1746592002665,DSC 197,001,956898,Eldridge; Justin Matthew,9996,0,9999,3
1746592003695,DSC 297,001,958000,Mazumdar; Arya,9998,0,9999,1
1746592003695,DSC 297,002,959862,Wang; Yusu,9998,0,9999,1
1746592004725,EAP 100,A00,905686,Staff,9778,0,9999,221
1746592005752,ECE 45,A01,892618,Staff,0,0,65,65
1746592007806,ECE 111,A01,892719,Staff,6,0,65,59
1746592008831,ECE 197,001,957920,Mercier; Patrick Philip,9991,0,9999,8
1746592009861,ECON 178,A01,907814,Zhu; Ying,26,0,35,9
1746592010885,EDS 115,A00,895312,Staff,35,0,45,10
1746592011913,EDS 117,A01,895337,Staff,23,0,30,7
1746592012940,EDS 125,A00,895341,Jones; Gabrielle Anastasia,36,0,45,9
1746592013966,EDS 128A,A01,895459,Fargason; Sharon Gayle,44,0,45,1
1746592014995,EDS 128B,A01,895543,Pappas; Elizabeth,44,0,45,1
1746592016020,EDS 139,A00,897203,Pappas; Elizabeth,44,0,45,1
1746592016020,EDS 139,B00,897209,Fargason; Sharon Gayle,41,0,45,4
1746592017047,EDS 201,A00,895545,Staff,22,0,45,23
1746592018072,EDS 203,A01,895581,Halter; Christopher P.,22,0,45,23
1746592019100,EDS 204R,A01,895625,Heinzman; Erica M.,39,0,45,6
1746592019100,EDS 204R,B01,895693,Halter; Christopher P.,10,0,45,35
1746592020126,EDS 206R,A00,895694,Fargason; Sharon Gayle,1,0,30,29
1746592020126,EDS 206R,B00,895695,Choi; Bailey Miyeon,16,0,30,14
1746592021152,EDS 250,A00,895697,Hemans; Patricia Ann Benitez,22,0,45,23
1746592022181,EDS 281,A00,895701,Meyerott; Theresa Ann,1,0,15,14
1746592023207,EDS 284,A00,895736,Meyerott; Theresa Ann,1,0,15,14
1746592024235,EDS 286,A00,897210,Fine; Sarah,0,0,15,15
1746592025261,EDS 289C,A01,895770,Daly; Alan J.,1,0,15,14
1746592026289,EDS 290,A00,897211,Hofstetter; Carolyn,0,0,15,15
1746592027319,LIGM 5A,A00,896162,Fischer-Grunski; Eva K,12,0,20,8
1746592028345,LIGM 5B,A00,896260,Fischer-Grunski; Eva K,17,0,20,3
1746592029369,LIGM 5C,A00,896308,Fischer-Grunski; Eva K,18,0,20,2
1746592030395,LIIT 5AS,A00,896313,Carnelos; Chiara,18,0,20,2
1746592031424,LIIT 5BS,A00,896416,Carnelos; Chiara,20,0,20,0
1746592032450,LIIT 5CS,A00,896564,Carnelos; Chiara,20,0,20,0
1746592033477,LISP 5A,A00,896588,Munoz Sanchez; Alicia,2,0,20,18
1746592034505,LISP 5B,A00,896653,Munoz Sanchez; Alicia,7,0,20,13
1746592035532,LISP 5C,A00,896655,Munoz Sanchez; Alicia,0,1,20,20
1746592036560,MAE 197,001,957918,Kleissl; Jan,9996,0,9999,3
1746592036560,MAE 197,002,959806,Boechler; Nicholas Sebastia,9998,0,9999,1
1746592036560,MAE 197,003,959852,Mullin; Jennifer S,9998,0,9999,1
1746592037588,MATH 2,A01,957937,Staff,33,0,35,2
1746592038613,MATH 197,001,957876,Kedlaya; Kiran S.,9993,0,9999,6
1746592039642,MCWP 40,A00,892729,Duru; Nur,10,0,20,10
1746592039642,MCWP 40,B00,893304,Montejo; Carolina,14,0,20,6
1746592040670,MCWP 40R,A00,893757,Redela; Pamela Morgan,0,5,20,20
1746592041698,MCWP 50,A00,893758,Morshed; Michael James,0,0,20,20
1746592041698,MCWP 50,B00,893761,Bartulis; Jason Michael,17,0,20,3
1746592042727,MCWP 50R,A00,893766,Compas; Sean Matthew,0,1,20,20
1746592042727,MCWP 50R,B00,893769,Carter; Jennifer A,0,1,20,20
1746592042727,MCWP 50R,C00,893771,Krone; Jarret,0,3,20,20
1746592042727,MCWP 50R,D00,893772,Miller; Elizabeth Deen,0,0,20,20
1746592042727,MCWP 50R,E00,893775,Carter; Andrea L,0,1,20,20
1746592043752,MMW 11R,A01,892721,Herbst; Matthew,14,0,30,16
1746592043752,MMW 11R,A02,892722,Herbst; Matthew,0,0,0,3
1746592044777,MMW 12R,A01,892724,Herbst; Matthew,0,11,16,16
1746592044777,MMW 12R,A02,892725,Herbst; Matthew,0,10,16,16
1746592045804,MMW 13R,A01,892727,Staff,0,4,16,16
1746592045804,MMW 13R,A02,892728,Staff,0,4,16,16
1746592045804,MMW 13R,A03,958032,Staff,0,4,16,16
1746592045804,MMW 13R,A04,958033,Staff,0,4,16,16
1746592045804,MMW 13R,A05,958034,Staff,0,4,16,16
1746592046831,SIO 295LS,A00,894015,Staff,5,0,25,20
1746592047858,SIO 295S,A00,894020,Staff,5,0,25,20
1746592048888,SIOC 290S,B01,958918,Merrifield; Mark A,14,0,30,16
1746592049918,SIOC 291S,B01,958922,Gabriel; Corey John,14,0,30,16
1746592050945,SOCI 117,A01,895339,Staff,3,0,5,2
1746592051969,WES 237B,A00,894149,Staff,11,0,20,9
1746592054035,AESE 279B,A00,891859,Staff,13,0,35,22
1746592055059,AIP 197,001,891854,Vespa; Emanuel Ignacio,9999,0,9999,0
1746592056085,ANTH 289S,A00,891856,Gagneux; Pascal,12,0,12,0
1746592057113,BENG 196,001,957946,Engler; Adam J.,9996,0,9999,3
1746592058141,BISP 197,001,959851,Wilhelm; James E.,9998,0,9999,1
1746592059164,CAT 124RS,A01,956906,Staff,6,0,25,19
1746592060195,CAT 125RS,A01,922013,Staff,6,0,25,19
1746592061217,CLRE 250,A00,891860,Morris; Sheldon,9995,0,9999,4
1746592063272,CLRE 251R,A00,907817,Mehta; Ravindra L.,9994,0,9999,5
1746592064295,CLRE 252,A00,891864,Cuomo; Raphael Eduardo,9993,0,9999,6
1746592065322,CLRE 253,A00,891867,Vaida; Florin,9994,0,9999,5
1746592065322,CLRE 253,B00,907819,Staff,9999,0,9999,0
1746592066350,CLRE 259,A00,891868,Patel; Hemal,9998,0,9999,1
1746592067374,CLRE 260,A00,891872,Cuomo; Raphael Eduardo,9999,0,9999,0
1746592068400,CLRE 297,001,891888,Cuomo; Raphael Eduardo,9999,0,9999,0
1746592069424,CSE 191,A00,958773,Minnes Kemp; Mor Mia,9995,0,9999,4
1746592070453,CSE 197,001,959846,Minnes Kemp; Mor Mia,9990,0,9999,9
1746592071480,CSS 201S,A01,892054,Mignozzetti; Umberto,25,0,30,5
1746592072504,CSS 202S,A01,892056,Mignozzetti; Umberto,25,0,30,5
1746592073530,DSC 197,001,956898,Eldridge; Justin Matthew,9996,0,9999,3
1746592074557,DSC 297,001,958000,Mazumdar; Arya,9998,0,9999,1
1746592074557,DSC 297,002,959862,Wang; Yusu,9998,0,9999,1
1746592075585,EAP 100,A00,905686,Staff,9778,0,9999,221
1746592076616,ECE 45,A01,892618,Staff,0,0,65,65
1746592078668,ECE 111,A01,892719,Staff,6,0,65,59
1746592079696,ECE 197,001,957920,Mercier; Patrick Philip,9991,0,9999,8
1746592080725,ECON 178,A01,907814,Zhu; Ying,26,0,35,9
1746592081756,EDS 115,A00,895312,Staff,35,0,45,10
1746592082789,EDS 117,A01,895337,Staff,23,0,30,7
1746592083817,EDS 125,A00,895341,Jones; Gabrielle Anastasia,36,0,45,9
1746592084842,EDS 128A,A01,895459,Fargason; Sharon Gayle,44,0,45,1
1746592085866,EDS 128B,A01,895543,Pappas; Elizabeth,44,0,45,1
1746592086890,EDS 139,A00,897203,Pappas; Elizabeth,44,0,45,1
1746592086890,EDS 139,B00,897209,Fargason; Sharon Gayle,41,0,45,4
1746592087917,EDS 201,A00,895545,Staff,22,0,45,23
1746592088942,EDS 203,A01,895581,Halter; Christopher P.,22,0,45,23
1746592089966,EDS 204R,A01,895625,Heinzman; Erica M.,39,0,45,6
1746592089966,EDS 204R,B01,895693,Halter; Christopher P.,10,0,45,35
1746592090995,EDS 206R,A00,895694,Fargason; Sharon Gayle,1,0,30,29
1746592090995,EDS 206R,B00,895695,Choi; Bailey Miyeon,16,0,30,14
1746592092042,EDS 250,A00,895697,Hemans; Patricia Ann Benitez,22,0,45,23
1746592093067,EDS 281,A00,895701,Meyerott; Theresa Ann,1,0,15,14
1746592094094,EDS 284,A00,895736,Meyerott; Theresa Ann,1,0,15,14
1746592095123,EDS 286,A00,897210,Fine; Sarah,0,0,15,15
1746592096148,EDS 289C,A01,895770,Daly; Alan J.,1,0,15,14
1746592097176,EDS 290,A00,897211,Hofstetter; Carolyn,0,0,15,15
1746592098206,LIGM 5A,A00,896162,Fischer-Grunski; Eva K,12,0,20,8
1746592099231,LIGM 5B,A00,896260,Fischer-Grunski; Eva K,17,0,20,3
1746592100257,LIGM 5C,A00,896308,Fischer-Grunski; Eva K,18,0,20,2
1746592101284,LIIT 5AS,A00,896313,Carnelos; Chiara,18,0,20,2
1746592102310,LIIT 5BS,A00,896416,Carnelos; Chiara,20,0,20,0
1746592103335,LIIT 5CS,A00,896564,Carnelos; Chiara,20,0,20,0
1746592104363,LISP 5A,A00,896588,Munoz Sanchez; Alicia,2,0,20,18
1746592105389,LISP 5B,A00,896653,Munoz Sanchez; Alicia,7,0,20,13
1746592106413,LISP 5C,A00,896655,Munoz Sanchez; Alicia,0,1,20,20
1746592107441,MAE 197,001,957918,Kleissl; Jan,9996,0,9999,3
1746592107441,MAE 197,002,959806,Boechler; Nicholas Sebastia,9998,0,9999,1
1746592107441,MAE 197,003,959852,Mullin; Jennifer S,9998,0,9999,1
1746592108466,MATH 2,A01,957937,Staff,33,0,35,2
1746592109491,MATH 197,001,957876,Kedlaya; Kiran S.,9993,0,9999,6
1746592110520,MCWP 40,A00,892729,Duru; Nur,10,0,20,10
1746592110520,MCWP 40,B00,893304,Montejo; Carolina,14,0,20,6
1746592111545,MCWP 40R,A00,893757,Redela; Pamela Morgan,0,5,20,20
1746592112574,MCWP 50,A00,893758,Morshed; Michael James,0,0,20,20
1746592112574,MCWP 50,B00,893761,Bartulis; Jason Michael,17,0,20,3
1746592113604,MCWP 50R,A00,893766,Compas; Sean Matthew,0,1,20,20
1746592113604,MCWP 50R,B00,893769,Carter; Jennifer A,0,1,20,20
1746592113604,MCWP 50R,C00,893771,Krone; Jarret,0,3,20,20
1746592113604,MCWP 50R,D00,893772,Miller; Elizabeth Deen,0,0,20,20
1746592113604,MCWP 50R,E00,893775,Carter; Andrea L,0,1,20,20
1746592114632,MMW 11R,A01,892721,Herbst; Matthew,14,0,30,16
1746592114632,MMW 11R,A02,892722,Herbst; Matthew,0,0,0,3
1746592115657,MMW 12R,A01,892724,Herbst; Matthew,0,11,16,16
1746592115657,MMW 12R,A02,892725,Herbst; Matthew,0,10,16,16
1746592116685,MMW 13R,A01,892727,Staff,0,4,16,16
1746592116685,MMW 13R,A02,892728,Staff,0,4,16,16
1746592116685,MMW 13R,A03,958032,Staff,0,4,16,16
1746592116685,MMW 13R,A04,958033,Staff,0,4,16,16
1746592116685,MMW 13R,A05,958034,Staff,0,4,16,16
1746592117713,SIO 295LS,A00,894015,Staff,5,0,25,20
1746592118741,SIO 295S,A00,894020,Staff,5,0,25,20
1746592119774,SIOC 290S,B01,958918,Merrifield; Mark A,14,0,30,16
1746592120801,SIOC 291S,B01,958922,Gabriel; Corey John,14,0,30,16
1746592121826,SOCI 117,A01,895339,Staff,3,0,5,2
1746592122852,WES 237B,A00,894149,Staff,11,0,20,9
1746592124914,AESE 279B,A00,891859,Staff,13,0,35,22
1746592125938,AIP 197,001,891854,Vespa; Emanuel Ignacio,9999,0,9999,0
1746592126963,ANTH 289S,A00,891856,Gagneux; Pascal,12,0,12,0
1746592127990,BENG 196,001,957946,Engler; Adam J.,9996,0,9999,3
1746592129018,BISP 197,001,959851,Wilhelm; James E.,9998,0,9999,1
1746592130046,CAT 124RS,A01,956906,Staff,6,0,25,19
1746592131073,CAT 125RS,A01,922013,Staff,6,0,25,19
1746592132099,CLRE 250,A00,891860,Morris; Sheldon,9995,0,9999,4
1746592134155,CLRE 251R,A00,907817,Mehta; Ravindra L.,9994,0,9999,5
1746592135181,CLRE 252,A00,891864,Cuomo; Raphael Eduardo,9993,0,9999,6
1746592136210,CLRE 253,A00,891867,Vaida; Florin,9994,0,9999,5
1746592136210,CLRE 253,B00,907819,Staff,9999,0,9999,0
1746592137235,CLRE 259,A00,891868,Patel; Hemal,9998,0,9999,1
1746592138261,CLRE 260,A00,891872,Cuomo; Raphael Eduardo,9999,0,9999,0
1746592139286,CLRE 297,001,891888,Cuomo; Raphael Eduardo,9999,0,9999,0
1746592140310,CSE 191,A00,958773,Minnes Kemp; Mor Mia,9995,0,9999,4
1746592141336,CSE 197,001,959846,Minnes Kemp; Mor Mia,9990,0,9999,9
1746592142363,CSS 201S,A01,892054,Mignozzetti; Umberto,25,0,30,5
1746592143390,CSS 202S,A01,892056,Mignozzetti; Umberto,25,0,30,5
1746592144418,DSC 197,001,956898,Eldridge; Justin Matthew,9996,0,9999,3
1746592145444,DSC 297,001,958000,Mazumdar; Arya,9998,0,9999,1
1746592145444,DSC 297,002,959862,Wang; Yusu,9998,0,9999,1
1746592146468,EAP 100,A00,905686,Staff,9778,0,9999,221
1746592147495,ECE 45,A01,892618,Staff,0,0,65,65
1746592149553,ECE 111,A01,892719,Staff,6,0,65,59
1746592150581,ECE 197,001,957920,Mercier; Patrick Philip,9991,0,9999,8
1746592151606,ECON 178,A01,907814,Zhu; Ying,26,0,35,9
1746592152633,EDS 115,A00,895312,Staff,35,0,45,10
1746592153661,EDS 117,A01,895337,Staff,23,0,30,7
1746592154688,EDS 125,A00,895341,Jones; Gabrielle Anastasia,36,0,45,9
1746592155713,EDS 128A,A01,895459,Fargason; Sharon Gayle,44,0,45,1
1746592156738,EDS 128B,A01,895543,Pappas; Elizabeth,44,0,45,1
1746592157762,EDS 139,A00,897203,Pappas; Elizabeth,44,0,45,1
1746592157762,EDS 139,B00,897209,Fargason; Sharon Gayle,41,0,45,4
1746592158791,EDS 201,A00,895545,Staff,22,0,45,23
1746592159849,EDS 203,A01,895581,Halter; Christopher P.,22,0,45,23
1746592160873,EDS 204R,A01,895625,Heinzman; Erica M.,39,0,45,6
1746592160873,EDS 204R,B01,895693,Halter; Christopher P.,10,0,45,35
1746592161905,EDS 206R,A00,895694,Fargason; Sharon Gayle,1,0,30,29
1746592161905,EDS 206R,B00,895695,Choi; Bailey Miyeon,16,0,30,14
1746592162933,EDS 250,A00,895697,Hemans; Patricia Ann Benitez,22,0,45,23
1746592163958,EDS 281,A00,895701,Meyerott; Theresa Ann,1,0,15,14
1746592164993,EDS 284,A00,895736,Meyerott; Theresa Ann,1,0,15,14
1746592166034,EDS 286,A00,897210,Fine; Sarah,0,0,15,15
1746592167059,EDS 289C,A01,895770,Daly; Alan J.,1,0,15,14
1746592168083,EDS 290,A00,897211,Hofstetter; Carolyn,0,0,15,15
1746592169106,LIGM 5A,A00,896162,Fischer-Grunski; Eva K,12,0,20,8
1746592170130,LIGM 5B,A00,896260,Fischer-Grunski; Eva K,17,0,20,3
1746592171157,LIGM 5C,A00,896308,Fischer-Grunski; Eva K,18,0,20,2
1746592172182,LIIT 5AS,A00,896313,Carnelos; Chiara,18,0,20,2
1746592173205,LIIT 5BS,A00,896416,Carnelos; Chiara,20,0,20,0
1746592174228,LIIT 5CS,A00,896564,Carnelos; Chiara,20,0,20,0
1746592175253,LISP 5A,A00,896588,Munoz Sanchez; Alicia,2,0,20,18
1746592176279,LISP 5B,A00,896653,Munoz Sanchez; Alicia,7,0,20,13
1746592177308,LISP 5C,A00,896655,Munoz Sanchez; Alicia,0,1,20,20
1746592178332,MAE 197,001,957918,Kleissl; Jan,9996,0,9999,3
1746592178332,MAE 197,002,959806,Boechler; Nicholas Sebastia,9998,0,9999,1
1746592178332,MAE 197,003,959852,Mullin; Jennifer S,9998,0,9999,1
1746592179358,MATH 2,A01,957937,Staff,33,0,35,2
1746592180387,MATH 197,001,957876,Kedlaya; Kiran S.,9993,0,9999,6
1746592181412,MCWP 40,A00,892729,Duru; Nur,10,0,20,10
1746592181412,MCWP 40,B00,893304,Montejo; Carolina,14,0,20,6
1746592182438,MCWP 40R,A00,893757,Redela; Pamela Morgan,0,5,20,20
1746592183464,MCWP 50,A00,893758,Morshed; Michael James,0,0,20,20
1746592183464,MCWP 50,B00,893761,Bartulis; Jason Michael,17,0,20,3
1746592184496,MCWP 50R,A00,893766,Compas; Sean Matthew,0,1,20,20
1746592184496,MCWP 50R,B00,893769,Carter; Jennifer A,0,1,20,20
1746592184496,MCWP 50R,C00,893771,Krone; Jarret,0,3,20,20
1746592184496,MCWP 50R,D00,893772,Miller; Elizabeth Deen,0,0,20,20
1746592184496,MCWP 50R,E00,893775,Carter; Andrea L,0,1,20,20
1746592185520,MMW 11R,A01,892721,Herbst; Matthew,14,0,30,16
1746592185520,MMW 11R,A02,892722,Herbst; Matthew,0,0,0,3
1746592186550,MMW 12R,A01,892724,Herbst; Matthew,0,11,16,16
1746592186550,MMW 12R,A02,892725,Herbst; Matthew,0,10,16,16
1746592187576,MMW 13R,A01,892727,Staff,0,4,16,16
1746592187576,MMW 13R,A02,892728,Staff,0,4,16,16
1746592187576,MMW 13R,A03,958032,Staff,0,4,16,16
1746592187576,MMW 13R,A04,958033,Staff,0,4,16,16
1746592187576,MMW 13R,A05,958034,Staff,0,4,16,16
1746592188606,SIO 295LS,A00,894015,Staff,5,0,25,20
1746592189632,SIO 295S,A00,894020,Staff,5,0,25,20
1746592190658,SIOC 290S,B01,958918,Merrifield; Mark A,14,0,30,16
1746592191686,SIOC 291S,B01,958922,Gabriel; Corey John,14,0,30,16
1746592192711,SOCI 117,A01,895339,Staff,3,0,5,2
1746592193737,WES 237B,A00,894149,Staff,11,0,20,9
1746592195801,AESE 279B,A00,891859,Staff,13,0,35,22
1746592196827,AIP 197,001,891854,Vespa; Emanuel Ignacio,9999,0,9999,0
1746592197855,ANTH 289S,A00,891856,Gagneux; Pascal,12,0,12,0
1746592198880,BENG 196,001,957946,Engler; Adam J.,9996,0,9999,3
1746592199908,BISP 197,001,959851,Wilhelm; James E.,9998,0,9999,1
1746592200936,CAT 124RS,A01,956906,Staff,6,0,25,19
1746592201962,CAT 125RS,A01,922013,Staff,6,0,25,19
1746592202988,CLRE 250,A00,891860,Morris; Sheldon,9995,0,9999,4
1746592205047,CLRE 251R,A00,907817,Mehta; Ravindra L.,9994,0,9999,5
1746592206073,CLRE 252,A00,891864,Cuomo; Raphael Eduardo,9993,0,9999,6
1746592207103,CLRE 253,A00,891867,Vaida; Florin,9994,0,9999,5
1746592207103,CLRE 253,B00,907819,Staff,9999,0,9999,0
1746592208130,CLRE 259,A00,891868,Patel; Hemal,9998,0,9999,1
1746592209156,CLRE 260,A00,891872,Cuomo; Raphael Eduardo,9999,0,9999,0
1746592210186,CLRE 297,001,891888,Cuomo; Raphael Eduardo,9999,0,9999,0
1746592211214,CSE 191,A00,958773,Minnes Kemp; Mor Mia,9995,0,9999,4
1746592212239,CSE 197,001,959846,Minnes Kemp; Mor Mia,9990,0,9999,9
1746592213270,CSS 201S,A01,892054,Mignozzetti; Umberto,25,0,30,5
1746592214299,CSS 202S,A01,892056,Mignozzetti; Umberto,25,0,30,5
1746592215332,DSC 197,001,956898,Eldridge; Justin Matthew,9996,0,9999,3
1746592216357,DSC 297,001,958000,Mazumdar; Arya,9998,0,9999,1
1746592216357,DSC 297,002,959862,Wang; Yusu,9998,0,9999,1
1746592217382,EAP 100,A00,905686,Staff,9778,0,9999,221
1746592218409,ECE 45,A01,892618,Staff,0,0,65,65
1746592220463,ECE 111,A01,892719,Staff,6,0,65,59
1746592221488,ECE 197,001,957920,Mercier; Patrick Philip,9991,0,9999,8
1746592222517,ECON 178,A01,907814,Zhu; Ying,26,0,35,9
1746592223543,EDS 115,A00,895312,Staff,35,0,45,10
1746592224570,EDS 117,A01,895337,Staff,23,0,30,7
1746592225599,EDS 125,A00,895341,Jones; Gabrielle Anastasia,36,0,45,9
1746592226626,EDS 128A,A01,895459,Fargason; Sharon Gayle,44,0,45,1
1746592227655,EDS 128B,A01,895543,Pappas; Elizabeth,44,0,45,1
1746592228682,EDS 139,A00,897203,Pappas; Elizabeth,44,0,45,1
1746592228682,EDS 139,B00,897209,Fargason; Sharon Gayle,41,0,45,4
1746592229707,EDS 201,A00,895545,Staff,22,0,45,23
1746592230737,EDS 203,A01,895581,Halter; Christopher P.,22,0,45,23
1746592231766,EDS 204R,A01,895625,Heinzman; Erica M.,39,0,45,6
1746592231766,EDS 204R,B01,895693,Halter; Christopher P.,10,0,45,35
1746592232800,EDS 206R,A00,895694,Fargason; Sharon Gayle,1,0,30,29
1746592232800,EDS 206R,B00,895695,Choi; Bailey Miyeon,16,0,30,14
1746592233826,EDS 250,A00,895697,Hemans; Patricia Ann Benitez,22,0,45,23
1746592234854,EDS 281,A00,895701,Meyerott; Theresa Ann,1,0,15,14
1746592236091,EDS 284,A00,895736,Meyerott; Theresa Ann,1,0,15,14
1746592237118,EDS 286,A00,897210,Fine; Sarah,0,0,15,15
1746592238143,EDS 289C,A01,895770,Daly; Alan J.,1,0,15,14
1746592239170,EDS 290,A00,897211,Hofstetter; Carolyn,0,0,15,15
1746592240204,LIGM 5A,A00,896162,Fischer-Grunski; Eva K,12,0,20,8
1746592241234,LIGM 5B,A00,896260,Fischer-Grunski; Eva K,17,0,20,3
1746592242258,LIGM 5C,A00,896308,Fischer-Grunski; Eva K,18,0,20,2
1746592243282,LIIT 5AS,A00,896313,Carnelos; Chiara,18,0,20,2
1746592244309,LIIT 5BS,A00,896416,Carnelos; Chiara,20,0,20,0
1746592245339,LIIT 5CS,A00,896564,Carnelos; Chiara,20,0,20,0
1746592246363,LISP 5A,A00,896588,Munoz Sanchez; Alicia,2,0,20,18
1746592247390,LISP 5B,A00,896653,Munoz Sanchez; Alicia,7,0,20,13
1746592248415,LISP 5C,A00,896655,Munoz Sanchez; Alicia,0,1,20,20
1746592249444,MAE 197,001,957918,Kleissl; Jan,9996,0,9999,3
1746592249444,MAE 197,002,959806,Boechler; Nicholas Sebastia,9998,0,9999,1
1746592249444,MAE 197,003,959852,Mullin; Jennifer S,9998,0,9999,1
1746592250470,MATH 2,A01,957937,Staff,33,0,35,2
1746592251493,MATH 197,001,957876,Kedlaya; Kiran S.,9993,0,9999,6
1746592252518,MCWP 40,A00,892729,Duru; Nur,10,0,20,10
1746592252518,MCWP 40,B00,893304,Montejo; Carolina,14,0,20,6
1746592253547,MCWP 40R,A00,893757,Redela; Pamela Morgan,0,5,20,20
1746592254574,MCWP 50,A00,893758,Morshed; Michael James,0,0,20,20
1746592254574,MCWP 50,B00,893761,Bartulis; Jason Michael,17,0,20,3
1746592255605,MCWP 50R,A00,893766,Compas; Sean Matthew,0,1,20,20
1746592255605,MCWP 50R,B00,893769,Carter; Jennifer A,0,1,20,20
1746592255605,MCWP 50R,C00,893771,Krone; Jarret,0,3,20,20
1746592255605,MCWP 50R,D00,893772,Miller; Elizabeth Deen,0,0,20,20
1746592255605,MCWP 50R,E00,893775,Carter; Andrea L,0,1,20,20
1746592256633,MMW 11R,A01,892721,Herbst; Matthew,14,0,30,16
1746592256633,MMW 11R,A02,892722,Herbst; Matthew,0,0,0,3
1746592257660,MMW 12R,A01,892724,Herbst; Matthew,0,11,16,16
1746592257660,MMW 12R,A02,892725,Herbst; Matthew,0,10,16,16
1746592258690,MMW 13R,A01,892727,Staff,0,4,16,16
1746592258690,MMW 13R,A02,892728,Staff,0,4,16,16
1746592258690,MMW 13R,A03,958032,Staff,0,4,16,16
1746592258690,MMW 13R,A04,958033,Staff,0,4,16,16
1746592258690,MMW 13R,A05,958034,Staff,0,4,16,16
1746592259719,SIO 295LS,A00,894015,Staff,5,0,25,20
1746592260756,SIO 295S,A00,894020,Staff,5,0,25,20
1746592261786,SIOC 290S,B01,958918,Merrifield; Mark A,14,0,30,16
1746592262817,SIOC 291S,B01,958922,Gabriel; Corey John,14,0,30,16
1746592263842,SOCI 117,A01,895339,Staff,2,0,5,3
1746592264867,WES 237B,A00,894149,Staff,11,0,20,9
1746592266924,AESE 279B,A00,891859,Staff,13,0,35,22
1746592267953,AIP 197,001,891854,Vespa; Emanuel Ignacio,9999,0,9999,0
1746592268983,ANTH 289S,A00,891856,Gagneux; Pascal,12,0,12,0
1746592270010,BENG 196,001,957946,Engler; Adam J.,9996,0,9999,3
1746592271039,BISP 197,001,959851,Wilhelm; James E.,9998,0,9999,1
1746592272064,CAT 124RS,A01,956906,Staff,6,0,25,19
1746592273092,CAT 125RS,A01,922013,Staff,6,0,25,19
1746592274120,CLRE 250,A00,891860,Morris; Sheldon,9995,0,9999,4
1746592276171,CLRE 251R,A00,907817,Mehta; Ravindra L.,9994,0,9999,5
1746592277196,CLRE 252,A00,891864,Cuomo; Raphael Eduardo,9993,0,9999,6
1746592278221,CLRE 253,A00,891867,Vaida; Florin,9994,0,9999,5
1746592278221,CLRE 253,B00,907819,Staff,9999,0,9999,0
1746592279247,CLRE 259,A00,891868,Patel; Hemal,9998,0,9999,1
1746592280276,CLRE 260,A00,891872,Cuomo; Raphael Eduardo,9999,0,9999,0
1746592281302,CLRE 297,001,891888,Cuomo; Raphael Eduardo,9999,0,9999,0
1746592282330,CSE 191,A00,958773,Minnes Kemp; Mor Mia,9995,0,9999,4
1746592283357,CSE 197,001,959846,Minnes Kemp; Mor Mia,9990,0,9999,9
1746592284383,CSS 201S,A01,892054,Mignozzetti; Umberto,25,0,30,5
1746592285414,CSS 202S,A01,892056,Mignozzetti; Umberto,25,0,30,5
1746592286442,DSC 197,001,956898,Eldridge; Justin Matthew,9996,0,9999,3
1746592287467,DSC 297,001,958000,Mazumdar; Arya,9998,0,9999,1
1746592287467,DSC 297,002,959862,Wang; Yusu,9998,0,9999,1
1746592288495,EAP 100,A00,905686,Staff,9778,0,9999,221
1746592289522,ECE 45,A01,892618,Staff,0,0,65,65
1746592291578,ECE 111,A01,892719,Staff,6,0,65,59
1746592292607,ECE 197,001,957920,Mercier; Patrick Philip,9991,0,9999,8
1746592293639,ECON 178,A01,907814,Zhu; Ying,26,0,35,9
1746592294664,EDS 115,A00,895312,Staff,35,0,45,10
1746592295692,EDS 117,A01,895337,Staff,23,0,30,7
1746592296721,EDS 125,A00,895341,Jones; Gabrielle Anastasia,36,0,45,9
1746592297748,EDS 128A,A01,895459,Fargason; Sharon Gayle,44,0,45,1
1746592298774,EDS 128B,A01,895543,Pappas; Elizabeth,44,0,45,1
1746592299803,EDS 139,A00,897203,Pappas; Elizabeth,44,0,45,1
1746592299803,EDS 139,B00,897209,Fargason; Sharon Gayle,41,0,45,4
1746592300828,EDS 201,A00,895545,Staff,22,0,45,23
1746592301852,EDS 203,A01,895581,Halter; Christopher P.,22,0,45,23
1746592302882,EDS 204R,A01,895625,Heinzman; Erica M.,39,0,45,6
1746592302882,EDS 204R,B01,895693,Halter; Christopher P.,10,0,45,35
1746592303909,EDS 206R,A00,895694,Fargason; Sharon Gayle,1,0,30,29
1746592303909,EDS 206R,B00,895695,Choi; Bailey Miyeon,16,0,30,14
1746592304936,EDS 250,A00,895697,Hemans; Patricia Ann Benitez,22,0,45,23
1746592305961,EDS 281,A00,895701,Meyerott; Theresa Ann,1,0,15,14
1746592306988,EDS 284,A00,895736,Meyerott; Theresa Ann,1,0,15,14
1746592308017,EDS 286,A00,897210,Fine; Sarah,0,0,15,15
1746592309041,EDS 289C,A01,895770,Daly; Alan J.,1,0,15,14
1746592310068,EDS 290,A00,897211,Hofstetter; Carolyn,0,0,15,15
1746592311093,LIGM 5A,A00,896162,Fischer-Grunski; Eva K,12,0,20,8
1746592312122,LIGM 5B,A00,896260,Fischer-Grunski; Eva K,17,0,20,3
1746592313150,LIGM 5C,A00,896308,Fischer-Grunski; Eva K,18,0,20,2
1746592314181,LIIT 5AS,A00,896313,Carnelos; Chiara,18,0,20,2
1746592315206,LIIT 5BS,A00,896416,Carnelos; Chiara,20,0,20,0
1746592316231,LIIT 5CS,A00,896564,Carnelos; Chiara,20,0,20,0
1746592317257,LISP 5A,A00,896588,Munoz Sanchez; Alicia,2,0,20,18
1746592318282,LISP 5B,A00,896653,Munoz Sanchez; Alicia,7,0,20,13
1746592319308,LISP 5C,A00,896655,Munoz Sanchez; Alicia,0,1,20,20
1746592320338,MAE 197,001,957918,Kleissl; Jan,9996,0,9999,3
1746592320338,MAE 197,002,959806,Boechler; Nicholas Sebastia,9998,0,9999,1
1746592320338,MAE 197,003,959852,Mullin; Jennifer S,9998,0,9999,1
1746592321365,MATH 2,A01,957937,Staff,33,0,35,2
1746592322392,MATH 197,001,957876,Kedlaya; Kiran S.,9993,0,9999,6
1746592323417,MCWP 40,A00,892729,Duru; Nur,10,0,20,10
1746592323417,MCWP 40,B00,893304,Montejo; Carolina,14,0,20,6
1746592324440,MCWP 40R,A00,893757,Redela; Pamela Morgan,0,5,20,20
1746592325465,MCWP 50,A00,893758,Morshed; Michael James,0,0,20,20
1746592325465,MCWP 50,B00,893761,Bartulis; Jason Michael,17,0,20,3
1746592326490,MCWP 50R,A00,893766,Compas; Sean Matthew,0,1,20,20
1746592326490,MCWP 50R,B00,893769,Carter; Jennifer A,0,1,20,20
1746592326490,MCWP 50R,C00,893771,Krone; Jarret,0,3,20,20
1746592326490,MCWP 50R,D00,893772,Miller; Elizabeth Deen,0,0,20,20
1746592326490,MCWP 50R,E00,893775,Carter; Andrea L,0,1,20,20
1746592327515,MMW 11R,A01,892721,Herbst; Matthew,14,0,30,16
1746592327515,MMW 11R,A02,892722,Herbst; Matthew,0,0,0,3
1746592328539,MMW 12R,A01,892724,Herbst; Matthew,0,11,16,16
1746592328539,MMW 12R,A02,892725,Herbst; Matthew,0,10,16,16
1746592329565,MMW 13R,A01,892727,Staff,0,4,16,16
1746592329565,MMW 13R,A02,892728,Staff,0,4,16,16
1746592329565,MMW 13R,A03,958032,Staff,0,4,16,16
1746592329565,MMW 13R,A04,958033,Staff,0,4,16,16
1746592329565,MMW 13R,A05,958034,Staff,0,4,16,16
1746592330590,SIO 295LS,A00,894015,Staff,5,0,25,20
1746592331616,SIO 295S,A00,894020,Staff,5,0,25,20
1746592332646,SIOC 290S,B01,958918,Merrifield; Mark A,14,0,30,16
1746592333674,SIOC 291S,B01,958922,Gabriel; Corey John,14,0,30,16
1746592334701,SOCI 117,A01,895339,Staff,2,0,5,3
1746592335727,WES 237B,A00,894149,Staff,11,0,20,9
1746592337787,AESE 279B,A00,891859,Staff,13,0,35,22
1746592338812,AIP 197,001,891854,Vespa; Emanuel Ignacio,9999,0,9999,0
1746592339838,ANTH 289S,A00,891856,Gagneux; Pascal,12,0,12,0
1746592340868,BENG 196,001,957946,Engler; Adam J.,9996,0,9999,3
1746592341894,BISP 197,001,959851,Wilhelm; James E.,9998,0,9999,1
1746592342923,CAT 124RS,A01,956906,Staff,6,0,25,19
1746592343954,CAT 125RS,A01,922013,Staff,6,0,25,19
1746592345007,CLRE 250,A00,891860,Morris; Sheldon,9995,0,9999,4
1746592347066,CLRE 251R,A00,907817,Mehta; Ravindra L.,9994,0,9999,5
1746592348094,CLRE 252,A00,891864,Cuomo; Raphael Eduardo,9993,0,9999,6
1746592349120,CLRE 253,A00,891867,Vaida; Florin,9994,0,9999,5
1746592349120,CLRE 253,B00,907819,Staff,9999,0,9999,0
1746592350144,CLRE 259,A00,891868,Patel; Hemal,9998,0,9999,1
1746592351171,CLRE 260,A00,891872,Cuomo; Raphael Eduardo,9999,0,9999,0
1746592352196,CLRE 297,001,891888,Cuomo; Raphael Eduardo,9999,0,9999,0
1746592353224,CSE 191,A00,958773,Minnes Kemp; Mor Mia,9995,0,9999,4
1746592354248,CSE 197,001,959846,Minnes Kemp; Mor Mia,9990,0,9999,9
1746592355274,CSS 201S,A01,892054,Mignozzetti; Umberto,25,0,30,5
1746592356303,CSS 202S,A01,892056,Mignozzetti; Umberto,25,0,30,5
1746592357326,DSC 197,001,956898,Eldridge; Justin Matthew,9996,0,9999,3
1746592358352,DSC 297,001,958000,Mazumdar; Arya,9998,0,9999,1
1746592358352,DSC 297,002,959862,Wang; Yusu,9998,0,9999,1
1746592359377,EAP 100,A00,905686,Staff,9778,0,9999,221
1746592360402,ECE 45,A01,892618,Staff,0,0,65,65
1746592362452,ECE 111,A01,892719,Staff,6,0,65,59
1746592363479,ECE 197,001,957920,Mercier; Patrick Philip,9991,0,9999,8
1746592364503,ECON 178,A01,907814,Zhu; Ying,26,0,35,9
1746592365531,EDS 115,A00,895312,Staff,35,0,45,10
1746592366555,EDS 117,A01,895337,Staff,23,0,30,7
1746592367582,EDS 125,A00,895341,Jones; Gabrielle Anastasia,36,0,45,9
1746592368607,EDS 128A,A01,895459,Fargason; Sharon Gayle,44,0,45,1
1746592369632,EDS 128B,A01,895543,Pappas; Elizabeth,44,0,45,1
1746592370660,EDS 139,A00,897203,Pappas; Elizabeth,44,0,45,1
1746592370660,EDS 139,B00,897209,Fargason; Sharon Gayle,41,0,45,4
1746592371687,EDS 201,A00,895545,Staff,22,0,45,23
1746592372712,EDS 203,A01,895581,Halter; Christopher P.,22,0,45,23
1746592373740,EDS 204R,A01,895625,Heinzman; Erica M.,39,0,45,6
1746592373740,EDS 204R,B01,895693,Halter; Christopher P.,10,0,45,35
1746592374768,EDS 206R,A00,895694,Fargason; Sharon Gayle,1,0,30,29
1746592374768,EDS 206R,B00,895695,Choi; Bailey Miyeon,16,0,30,14
1746592375797,EDS 250,A00,895697,Hemans; Patricia Ann Benitez,22,0,45,23
1746592376822,EDS 281,A00,895701,Meyerott; Theresa Ann,1,0,15,14
1746592377847,EDS 284,A00,895736,Meyerott; Theresa Ann,1,0,15,14
1746592378872,EDS 286,A00,897210,Fine; Sarah,0,0,15,15
1746592379903,EDS 289C,A01,895770,Daly; Alan J.,1,0,15,14
1746592380927,EDS 290,A00,897211,Hofstetter; Carolyn,0,0,15,15
1746592381956,LIGM 5A,A00,896162,Fischer-Grunski; Eva K,12,0,20,8
1746592382984,LIGM 5B,A00,896260,Fischer-Grunski; Eva K,17,0,20,3
1746592384011,LIGM 5C,A00,896308,Fischer-Grunski; Eva K,18,0,20,2
1746592385036,LIIT 5AS,A00,896313,Carnelos; Chiara,18,0,20,2
1746592386061,LIIT 5BS,A00,896416,Carnelos; Chiara,20,0,20,0
1746592387091,LIIT 5CS,A00,896564,Carnelos; Chiara,20,0,20,0
1746592388116,LISP 5A,A00,896588,Munoz Sanchez; Alicia,2,0,20,18
1746592389145,LISP 5B,A00,896653,Munoz Sanchez; Alicia,7,0,20,13
1746592390175,LISP 5C,A00,896655,Munoz Sanchez; Alicia,0,1,20,20
1746592391202,MAE 197,001,957918,Kleissl; Jan,9996,0,9999,3
1746592391202,MAE 197,002,959806,Boechler; Nicholas Sebastia,9998,0,9999,1
1746592391202,MAE 197,003,959852,Mullin; Jennifer S,9998,0,9999,1
1746592392231,MATH 2,A01,957937,Staff,33,0,35,2
1746592393259,MATH 197,001,957876,Kedlaya; Kiran S.,9993,0,9999,6
1746592394284,MCWP 40,A00,892729,Duru; Nur,10,0,20,10
1746592394284,MCWP 40,B00,893304,Montejo; Carolina,14,0,20,6
1746592395308,MCWP 40R,A00,893757,Redela; Pamela Morgan,0,5,20,20
1746592396332,MCWP 50,A00,893758,Morshed; Michael James,0,0,20,20
1746592396332,MCWP 50,B00,893761,Bartulis; Jason Michael,17,0,20,3
1746592397357,MCWP 50R,A00,893766,Compas; Sean Matthew,0,1,20,20
1746592397357,MCWP 50R,B00,893769,Carter; Jennifer A,0,1,20,20
1746592397357,MCWP 50R,C00,893771,Krone; Jarret,0,3,20,20
1746592397357,MCWP 50R,D00,893772,Miller; Elizabeth Deen,0,0,20,20
1746592397357,MCWP 50R,E00,893775,Carter; Andrea L,0,1,20,20
1746592398384,MMW 11R,A01,892721,Herbst; Matthew,14,0,30,16
1746592398384,MMW 11R,A02,892722,Herbst; Matthew,0,0,0,3
1746592399408,MMW 12R,A01,892724,Herbst; Matthew,0,11,16,16
1746592399408,MMW 12R,A02,892725,Herbst; Matthew,0,10,16,16
1746592400433,MMW 13R,A01,892727,Staff,0,4,16,16
1746592400433,MMW 13R,A02,892728,Staff,0,4,16,16
1746592400433,MMW 13R,A03,958032,Staff,0,4,16,16
1746592400433,MMW 13R,A04,958033,Staff,0,4,16,16
1746592400433,MMW 13R,A05,958034,Staff,0,4,16,16
1746592401457,SIO 295LS,A00,894015,Staff,5,0,25,20
1746592402484,SIO 295S,A00,894020,Staff,5,0,25,20
1746592403510,SIOC 290S,B01,958918,Merrifield; Mark A,14,0,30,16
1746592404536,SIOC 291S,B01,958922,Gabriel; Corey John,14,0,30,16
1746592405561,SOCI 117,A01,895339,Staff,2,0,5,3
1746592406591,WES 237B,A00,894149,Staff,11,0,20,9
1746592408649,AESE 279B,A00,891859,Staff,13,0,35,22
1746592409676,AIP 197,001,891854,Vespa; Emanuel Ignacio,9999,0,9999,0
1746592410702,ANTH 289S,A00,891856,Gagneux; Pascal,12,0,12,0
1746592411730,BENG 196,001,957946,Engler; Adam J.,9996,0,9999,3
1746592412759,BISP 197,001,959851,Wilhelm; James E.,9998,0,9999,1
1746592413787,CAT 124RS,A01,956906,Staff,6,0,25,19
1746592414813,CAT 125RS,A01,922013,Staff,6,0,25,19
1746592415839,CLRE 250,A00,891860,Morris; Sheldon,9995,0,9999,4
1746592417896,CLRE 251R,A00,907817,Mehta; Ravindra L.,9994,0,9999,5
1746592418923,CLRE 252,A00,891864,Cuomo; Raphael Eduardo,9993,0,9999,6
1746592419948,CLRE 253,A00,891867,Vaida; Florin,9994,0,9999,5
1746592419948,CLRE 253,B00,907819,Staff,9999,0,9999,0
1746592420978,CLRE 259,A00,891868,Patel; Hemal,9998,0,9999,1
1746592422002,CLRE 260,A00,891872,Cuomo; Raphael Eduardo,9999,0,9999,0
1746592423030,CLRE 297,001,891888,Cuomo; Raphael Eduardo,9999,0,9999,0
1746592424082,CSE 191,A00,958773,Minnes Kemp; Mor Mia,9995,0,9999,4
1746592425106,CSE 197,001,959846,Minnes Kemp; Mor Mia,9990,0,9999,9
1746592426132,CSS 201S,A01,892054,Mignozzetti; Umberto,25,0,30,5
1746592427158,CSS 202S,A01,892056,Mignozzetti; Umberto,25,0,30,5
1746592428187,DSC 197,001,956898,Eldridge; Justin Matthew,9996,0,9999,3
1746592429216,DSC 297,001,958000,Mazumdar; Arya,9998,0,9999,1
1746592429216,DSC 297,002,959862,Wang; Yusu,9998,0,9999,1
1746592430244,EAP 100,A00,905686,Staff,9778,0,9999,221
1746592431269,ECE 45,A01,892618,Staff,0,0,65,65
1746592433322,ECE 111,A01,892719,Staff,6,0,65,59
1746592434350,ECE 197,001,957920,Mercier; Patrick Philip,9991,0,9999,8
1746592435376,ECON 178,A01,907814,Zhu; Ying,26,0,35,9
1746592436401,EDS 115,A00,895312,Staff,35,0,45,10
1746592437428,EDS 117,A01,895337,Staff,23,0,30,7
1746592438457,EDS 125,A00,895341,Jones; Gabrielle Anastasia,36,0,45,9
1746592439482,EDS 128A,A01,895459,Fargason; Sharon Gayle,44,0,45,1
1746592440511,EDS 128B,A01,895543,Pappas; Elizabeth,44,0,45,1
1746592441536,EDS 139,A00,897203,Pappas; Elizabeth,44,0,45,1
1746592441536,EDS 139,B00,897209,Fargason; Sharon Gayle,41,0,45,4
1746592442563,EDS 201,A00,895545,Staff,22,0,45,23
1746592443590,EDS 203,A01,895581,Halter; Christopher P.,22,0,45,23
1746592444617,EDS 204R,A01,895625,Heinzman; Erica M.,39,0,45,6
1746592444617,EDS 204R,B01,895693,Halter; Christopher P.,10,0,45,35
1746592445642,EDS 206R,A00,895694,Fargason; Sharon Gayle,1,0,30,29
1746592445642,EDS 206R,B00,895695,Choi; Bailey Miyeon,16,0,30,14
1746592446670,EDS 250,A00,895697,Hemans; Patricia Ann Benitez,22,0,45,23
1746592447696,EDS 281,A00,895701,Meyerott; Theresa Ann,1,0,15,14
1746592448723,EDS 284,A00,895736,Meyerott; Theresa Ann,1,0,15,14
1746592449748,EDS 286,A00,897210,Fine; Sarah,0,0,15,15
1746592450775,EDS 289C,A01,895770,Daly; Alan J.,1,0,15,14
1746592451800,EDS 290,A00,897211,Hofstetter; Carolyn,0,0,15,15
1746592452830,LIGM 5A,A00,896162,Fischer-Grunski; Eva K,12,0,20,8
1746592453855,LIGM 5B,A00,896260,Fischer-Grunski; Eva K,17,0,20,3
1746592454884,LIGM 5C,A00,896308,Fischer-Grunski; Eva K,18,0,20,2
1746592455915,LIIT 5AS,A00,896313,Carnelos; Chiara,18,0,20,2
1746592456944,LIIT 5BS,A00,896416,Carnelos; Chiara,20,0,20,0
1746592457970,LIIT 5CS,A00,896564,Carnelos; Chiara,20,0,20,0
1746592458996,LISP 5A,A00,896588,Munoz Sanchez; Alicia,2,0,20,18
1746592460021,LISP 5B,A00,896653,Munoz Sanchez; Alicia,7,0,20,13
1746592461047,LISP 5C,A00,896655,Munoz Sanchez; Alicia,0,1,20,20
1746592462075,MAE 197,001,957918,Kleissl; Jan,9996,0,9999,3
1746592462075,MAE 197,002,959806,Boechler; Nicholas Sebastia,9998,0,9999,1
1746592462075,MAE 197,003,959852,Mullin; Jennifer S,9998,0,9999,1
1746592463101,MATH 2,A01,957937,Staff,33,0,35,2
1746592464128,MATH 197,001,957876,Kedlaya; Kiran S.,9993,0,9999,6
1746592465159,MCWP 40,A00,892729,Duru; Nur,10,0,20,10
1746592465159,MCWP 40,B00,893304,Montejo; Carolina,14,0,20,6
1746592466187,MCWP 40R,A00,893757,Redela; Pamela Morgan,0,5,20,20
1746592467212,MCWP 50,A00,893758,Morshed; Michael James,0,0,20,20
1746592467212,MCWP 50,B00,893761,Bartulis; Jason Michael,17,0,20,3
1746592468237,MCWP 50R,A00,893766,Compas; Sean Matthew,0,1,20,20
1746592468237,MCWP 50R,B00,893769,Carter; Jennifer A,0,1,20,20
1746592468237,MCWP 50R,C00,893771,Krone; Jarret,0,3,20,20
1746592468237,MCWP 50R,D00,893772,Miller; Elizabeth Deen,0,0,20,20
1746592468237,MCWP 50R,E00,893775,Carter; Andrea L,0,1,20,20
1746592469265,MMW 11R,A01,892721,Herbst; Matthew,14,0,30,16
1746592469265,MMW 11R,A02,892722,Herbst; Matthew,0,0,0,3
1746592470292,MMW 12R,A01,892724,Herbst; Matthew,0,11,16,16
1746592470292,MMW 12R,A02,892725,Herbst; Matthew,0,10,16,16
1746592471319,MMW 13R,A01,892727,Staff,0,4,16,16
1746592471319,MMW 13R,A02,892728,Staff,0,4,16,16
1746592471319,MMW 13R,A03,958032,Staff,0,4,16,16
1746592471319,MMW 13R,A04,958033,Staff,0,4,16,16
1746592471319,MMW 13R,A05,958034,Staff,0,4,16,16
1746592472349,SIO 295LS,A00,894015,Staff,5,0,25,20
1746592473374,SIO 295S,A00,894020,Staff,5,0,25,20
1746592474398,SIOC 290S,B01,958918,Merrifield; Mark A,14,0,30,16
1746592475438,SIOC 291S,B01,958922,Gabriel; Corey John,14,0,30,16
1746592476462,SOCI 117,A01,895339,Staff,2,0,5,3
1746592477486,WES 237B,A00,894149,Staff,11,0,20,9
1746592479539,AESE 279B,A00,891859,Staff,13,0,35,22
1746592480563,AIP 197,001,891854,Vespa; Emanuel Ignacio,9999,0,9999,0
1746592481588,ANTH 289S,A00,891856,Gagneux; Pascal,12,0,12,0
1746592482615,BENG 196,001,957946,Engler; Adam J.,9996,0,9999,3
1746592483643,BISP 197,001,959851,Wilhelm; James E.,9998,0,9999,1
1746592484668,CAT 124RS,A01,956906,Staff,6,0,25,19
1746592485697,CAT 125RS,A01,922013,Staff,6,0,25,19
1746592486721,CLRE 250,A00,891860,Morris; Sheldon,9995,0,9999,4
1746592488794,CLRE 251R,A00,907817,Mehta; Ravindra L.,9994,0,9999,5
1746592489819,CLRE 252,A00,891864,Cuomo; Raphael Eduardo,9993,0,9999,6
1746592490846,CLRE 253,A00,891867,Vaida; Florin,9994,0,9999,5
1746592490846,CLRE 253,B00,907819,Staff,9999,0,9999,0
1746592491874,CLRE 259,A00,891868,Patel; Hemal,9998,0,9999,1
1746592492899,CLRE 260,A00,891872,Cuomo; Raphael Eduardo,9999,0,9999,0
1746592493924,CLRE 297,001,891888,Cuomo; Raphael Eduardo,9999,0,9999,0
1746592494949,CSE 191,A00,958773,Minnes Kemp; Mor Mia,9995,0,9999,4
1746592495975,CSE 197,001,959846,Minnes Kemp; Mor Mia,9990,0,9999,9
1746592497004,CSS 201S,A01,892054,Mignozzetti; Umberto,25,0,30,5
1746592498029,CSS 202S,A01,892056,Mignozzetti; Umberto,25,0,30,5
1746592499055,DSC 197,001,956898,Eldridge; Justin Matthew,9996,0,9999,3
1746592500082,DSC 297,001,958000,Mazumdar; Arya,9998,0,9999,1
1746592500082,DSC 297,002,959862,Wang; Yusu,9998,0,9999,1
1746592501109,EAP 100,A00,905686,Staff,9778,0,9999,221
1746592502137,ECE 45,A01,892618,Staff,0,0,65,65
1746592504191,ECE 111,A01,892719,Staff,6,0,65,59
1746592505217,ECE 197,001,957920,Mercier; Patrick Philip,9991,0,9999,8
1746592506241,ECON 178,A01,907814,Zhu; Ying,26,0,35,9
1746592507266,EDS 115,A00,895312,Staff,35,0,45,10
1746592508289,EDS 117,A01,895337,Staff,23,0,30,7
1746592509316,EDS 125,A00,895341,Jones; Gabrielle Anastasia,36,0,45,9
1746592510343,EDS 128A,A01,895459,Fargason; Sharon Gayle,44,0,45,1
1746592511367,EDS 128B,A01,895543,Pappas; Elizabeth,44,0,45,1
1746592512392,EDS 139,A00,897203,Pappas; Elizabeth,44,0,45,1
1746592512392,EDS 139,B00,897209,Fargason; Sharon Gayle,41,0,45,4
1746592513417,EDS 201,A00,895545,Staff,22,0,45,23
1746592514448,EDS 203,A01,895581,Halter; Christopher P.,22,0,45,23
1746592515479,EDS 204R,A01,895625,Heinzman; Erica M.,39,0,45,6
1746592515479,EDS 204R,B01,895693,Halter; Christopher P.,10,0,45,35
1746592516505,EDS 206R,A00,895694,Fargason; Sharon Gayle,1,0,30,29
1746592516505,EDS 206R,B00,895695,Choi; Bailey Miyeon,16,0,30,14
1746592517532,EDS 250,A00,895697,Hemans; Patricia Ann Benitez,22,0,45,23
1746592518562,EDS 281,A00,895701,Meyerott; Theresa Ann,1,0,15,14
1746592519590,EDS 284,A00,895736,Meyerott; Theresa Ann,1,0,15,14
1746592520618,EDS 286,A00,897210,Fine; Sarah,0,0,15,15
1746592521643,EDS 289C,A01,895770,Daly; Alan J.,1,0,15,14
1746592522668,EDS 290,A00,897211,Hofstetter; Carolyn,0,0,15,15
1746592523696,LIGM 5A,A00,896162,Fischer-Grunski; Eva K,12,0,20,8
1746592524721,LIGM 5B,A00,896260,Fischer-Grunski; Eva K,17,0,20,3
1746592525744,LIGM 5C,A00,896308,Fischer-Grunski; Eva K,18,0,20,2
1746592526794,LIIT 5AS,A00,896313,Carnelos; Chiara,18,0,20,2
1746592527821,LIIT 5BS,A00,896416,Carnelos; Chiara,20,0,20,0
1746592528848,LIIT 5CS,A00,896564,Carnelos; Chiara,20,0,20,0
1746592529873,LISP 5A,A00,896588,Munoz Sanchez; Alicia,2,0,20,18
1746592530899,LISP 5B,A00,896653,Munoz Sanchez; Alicia,7,0,20,13
1746592531929,LISP 5C,A00,896655,Munoz Sanchez; Alicia,0,1,20,20
1746592532956,MAE 197,001,957918,Kleissl; Jan,9996,0,9999,3
1746592532956,MAE 197,002,959806,Boechler; Nicholas Sebastia,9998,0,9999,1
1746592532956,MAE 197,003,959852,Mullin; Jennifer S,9998,0,9999,1
1746592533981,MATH 2,A01,957937,Staff,33,0,35,2
1746592535008,MATH 197,001,957876,Kedlaya; Kiran S.,9993,0,9999,6
1746592536037,MCWP 40,A00,892729,Duru; Nur,10,0,20,10
1746592536037,MCWP 40,B00,893304,Montejo; Carolina,14,0,20,6
1746592537064,MCWP 40R,A00,893757,Redela; Pamela Morgan,0,5,20,20
1746592538088,MCWP 50,A00,893758,Morshed; Michael James,0,0,20,20
1746592538088,MCWP 50,B00,893761,Bartulis; Jason Michael,17,0,20,3
1746592539116,MCWP 50R,A00,893766,Compas; Sean Matthew,0,1,20,20
1746592539116,MCWP 50R,B00,893769,Carter; Jennifer A,0,1,20,20
1746592539116,MCWP 50R,C00,893771,Krone; Jarret,0,3,20,20
1746592539116,MCWP 50R,D00,893772,Miller; Elizabeth Deen,0,0,20,20
1746592539116,MCWP 50R,E00,893775,Carter; Andrea L,0,1,20,20
1746592540142,MMW 11R,A01,892721,Herbst; Matthew,14,0,30,16
1746592540142,MMW 11R,A02,892722,Herbst; Matthew,0,0,0,3
1746592541171,MMW 12R,A01,892724,Herbst; Matthew,0,11,16,16
1746592541171,MMW 12R,A02,892725,Herbst; Matthew,0,10,16,16
1746592542198,MMW 13R,A01,892727,Staff,0,4,16,16
1746592542198,MMW 13R,A02,892728,Staff,0,4,16,16
1746592542198,MMW 13R,A03,958032,Staff,0,4,16,16
1746592542198,MMW 13R,A04,958033,Staff,0,4,16,16
1746592542198,MMW 13R,A05,958034,Staff,0,4,16,16
1746592543225,SIO 295LS,A00,894015,Staff,5,0,25,20
1746592544250,SIO 295S,A00,894020,Staff,5,0,25,20
1746592545275,SIOC 290S,B01,958918,Merrifield; Mark A,14,0,30,16
1746592546300,SIOC 291S,B01,958922,Gabriel; Corey John,14,0,30,16
1746592547325,SOCI 117,A01,895339,Staff,2,0,5,3
1746592548350,WES 237B,A00,894149,Staff,11,0,20,9
1746592550413,AESE 279B,A00,891859,Staff,13,0,35,22
1746592551437,AIP 197,001,891854,Vespa; Emanuel Ignacio,9999,0,9999,0
1746592552464,ANTH 289S,A00,891856,Gagneux; Pascal,12,0,12,0
1746592553491,BENG 196,001,957946,Engler; Adam J.,9996,0,9999,3
1746592554518,BISP 197,001,959851,Wilhelm; James E.,9998,0,9999,1
1746592555544,CAT 124RS,A01,956906,Staff,6,0,25,19
1746592556572,CAT 125RS,A01,922013,Staff,6,0,25,19
1746592557601,CLRE 250,A00,891860,Morris; Sheldon,9995,0,9999,4
1746592559667,CLRE 251R,A00,907817,Mehta; Ravindra L.,9994,0,9999,5
1746592560692,CLRE 252,A00,891864,Cuomo; Raphael Eduardo,9993,0,9999,6
1746592561718,CLRE 253,A00,891867,Vaida; Florin,9994,0,9999,5
1746592561718,CLRE 253,B00,907819,Staff,9999,0,9999,0
1746592562742,CLRE 259,A00,891868,Patel; Hemal,9998,0,9999,1
1746592563767,CLRE 260,A00,891872,Cuomo; Raphael Eduardo,9999,0,9999,0
1746592564794,CLRE 297,001,891888,Cuomo; Raphael Eduardo,9999,0,9999,0
1746592565819,CSE 191,A00,958773,Minnes Kemp; Mor Mia,9995,0,9999,4
1746592566846,CSE 197,001,959846,Minnes Kemp; Mor Mia,9990,0,9999,9
1746592567876,CSS 201S,A01,892054,Mignozzetti; Umberto,25,0,30,5
1746592568903,CSS 202S,A01,892056,Mignozzetti; Umberto,25,0,30,5
1746592569929,DSC 197,001,956898,Eldridge; Justin Matthew,9996,0,9999,3
1746592570957,DSC 297,001,958000,Mazumdar; Arya,9998,0,9999,1
1746592570957,DSC 297,002,959862,Wang; Yusu,9998,0,9999,1
1746592571987,EAP 100,A00,905686,Staff,9778,0,9999,221
1746592573018,ECE 45,A01,892618,Staff,0,0,65,65
1746592575072,ECE 111,A01,892719,Staff,6,0,65,59
1746592576101,ECE 197,001,957920,Mercier; Patrick Philip,9991,0,9999,8
1746592577125,ECON 178,A01,907814,Zhu; Ying,26,0,35,9
1746592578154,EDS 115,A00,895312,Staff,35,0,45,10
1746592579181,EDS 117,A01,895337,Staff,23,0,30,7
1746592580209,EDS 125,A00,895341,Jones; Gabrielle Anastasia,36,0,45,9
1746592581235,EDS 128A,A01,895459,Fargason; Sharon Gayle,44,0,45,1
1746592582262,EDS 128B,A01,895543,Pappas; Elizabeth,44,0,45,1
1746592583289,EDS 139,A00,897203,Pappas; Elizabeth,44,0,45,1
1746592583289,EDS 139,B00,897209,Fargason; Sharon Gayle,41,0,45,4
1746592584315,EDS 201,A00,895545,Staff,22,0,45,23
1746592585342,EDS 203,A01,895581,Halter; Christopher P.,22,0,45,23
1746592586367,EDS 204R,A01,895625,Heinzman; Erica M.,39,0,45,6
1746592586367,EDS 204R,B01,895693,Halter; Christopher P.,10,0,45,35
1746592587392,EDS 206R,A00,895694,Fargason; Sharon Gayle,1,0,30,29
1746592587392,EDS 206R,B00,895695,Choi; Bailey Miyeon,16,0,30,14
1746592588415,EDS 250,A00,895697,Hemans; Patricia Ann Benitez,22,0,45,23
1746592589441,EDS 281,A00,895701,Meyerott; Theresa Ann,1,0,15,14
1746592590466,EDS 284,A00,895736,Meyerott; Theresa Ann,1,0,15,14
1746592591491,EDS 286,A00,897210,Fine; Sarah,0,0,15,15
1746592592519,EDS 289C,A01,895770,Daly; Alan J.,1,0,15,14
1746592593545,EDS 290,A00,897211,Hofstetter; Carolyn,0,0,15,15
1746592594601,LIGM 5A,A00,896162,Fischer-Grunski; Eva K,12,0,20,8
1746592595630,LIGM 5B,A00,896260,Fischer-Grunski; Eva K,17,0,20,3
1746592596655,LIGM 5C,A00,896308,Fischer-Grunski; Eva K,18,0,20,2
1746592597683,LIIT 5AS,A00,896313,Carnelos; Chiara,18,0,20,2
1746592598707,LIIT 5BS,A00,896416,Carnelos; Chiara,20,0,20,0
1746592599735,LIIT 5CS,A00,896564,Carnelos; Chiara,20,0,20,0
1746592600764,LISP 5A,A00,896588,Munoz Sanchez; Alicia,2,0,20,18
1746592601790,LISP 5B,A00,896653,Munoz Sanchez; Alicia,7,0,20,13
1746592602821,LISP 5C,A00,896655,Munoz Sanchez; Alicia,0,1,20,20
1746592603847,MAE 197,001,957918,Kleissl; Jan,9996,0,9999,3
1746592603847,MAE 197,002,959806,Boechler; Nicholas Sebastia,9998,0,9999,1
1746592603847,MAE 197,003,959852,Mullin; Jennifer S,9998,0,9999,1
1746592604875,MATH 2,A01,957937,Staff,33,0,35,2
1746592605904,MATH 197,001,957876,Kedlaya; Kiran S.,9993,0,9999,6
1746592606932,MCWP 40,A00,892729,Duru; Nur,10,0,20,10
1746592606932,MCWP 40,B00,893304,Montejo; Carolina,14,0,20,6
1746592607959,MCWP 40R,A00,893757,Redela; Pamela Morgan,0,5,20,20
1746592608986,MCWP 50,A00,893758,Morshed; Michael James,0,0,20,20
1746592608986,MCWP 50,B00,893761,Bartulis; Jason Michael,17,0,20,3
1746592610012,MCWP 50R,A00,893766,Compas; Sean Matthew,0,1,20,20
1746592610012,MCWP 50R,B00,893769,Carter; Jennifer A,0,1,20,20
1746592610012,MCWP 50R,C00,893771,Krone; Jarret,0,3,20,20
1746592610012,MCWP 50R,D00,893772,Miller; Elizabeth Deen,0,0,20,20
1746592610012,MCWP 50R,E00,893775,Carter; Andrea L,0,1,20,20
1746592611041,MMW 11R,A01,892721,Herbst; Matthew,14,0,30,16
1746592611041,MMW 11R,A02,892722,Herbst; Matthew,0,0,0,3
1746592612066,MMW 12R,A01,892724,Herbst; Matthew,0,11,16,16
1746592612066,MMW 12R,A02,892725,Herbst; Matthew,0,10,16,16
1746592613094,MMW 13R,A01,892727,Staff,0,4,16,16
1746592613094,MMW 13R,A02,892728,Staff,0,4,16,16
1746592613094,MMW 13R,A03,958032,Staff,0,4,16,16
1746592613094,MMW 13R,A04,958033,Staff,0,4,16,16
1746592613094,MMW 13R,A05,958034,Staff,0,4,16,16
1746592614122,SIO 295LS,A00,894015,Staff,5,0,25,20
1746592615150,SIO 295S,A00,894020,Staff,5,0,25,20
1746592616176,SIOC 290S,B01,958918,Merrifield; Mark A,14,0,30,16
1746592617201,SIOC 291S,B01,958922,Gabriel; Corey John,14,0,30,16
1746592618226,SOCI 117,A01,895339,Staff,2,0,5,3
1746592619250,WES 237B,A00,894149,Staff,11,0,20,9
1746592621313,AESE 279B,A00,891859,Staff,13,0,35,22
1746592622341,AIP 197,001,891854,Vespa; Emanuel Ignacio,9999,0,9999,0
1746592623368,ANTH 289S,A00,891856,Gagneux; Pascal,12,0,12,0
1746592624395,BENG 196,001,957946,Engler; Adam J.,9996,0,9999,3
1746592625420,BISP 197,001,959851,Wilhelm; James E.,9998,0,9999,1
1746592626444,CAT 124RS,A01,956906,Staff,6,0,25,19
1746592627472,CAT 125RS,A01,922013,Staff,6,0,25,19
1746592628498,CLRE 250,A00,891860,Morris; Sheldon,9995,0,9999,4
1746592630552,CLRE 251R,A00,907817,Mehta; Ravindra L.,9994,0,9999,5
1746592631579,CLRE 252,A00,891864,Cuomo; Raphael Eduardo,9993,0,9999,6
1746592632603,CLRE 253,A00,891867,Vaida; Florin,9994,0,9999,5
1746592632603,CLRE 253,B00,907819,Staff,9999,0,9999,0
1746592633631,CLRE 259,A00,891868,Patel; Hemal,9998,0,9999,1
1746592634654,CLRE 260,A00,891872,Cuomo; Raphael Eduardo,9999,0,9999,0
1746592635679,CLRE 297,001,891888,Cuomo; Raphael Eduardo,9999,0,9999,0
1746592636706,CSE 191,A00,958773,Minnes Kemp; Mor Mia,9995,0,9999,4
1746592637731,CSE 197,001,959846,Minnes Kemp; Mor Mia,9990,0,9999,9
1746592638756,CSS 201S,A01,892054,Mignozzetti; Umberto,25,0,30,5
1746592639782,CSS 202S,A01,892056,Mignozzetti; Umberto,25,0,30,5
1746592640806,DSC 197,001,956898,Eldridge; Justin Matthew,9996,0,9999,3
1746592641834,DSC 297,001,958000,Mazumdar; Arya,9998,0,9999,1
1746592641834,DSC 297,002,959862,Wang; Yusu,9998,0,9999,1
1746592642860,EAP 100,A00,905686,Staff,9778,0,9999,221
1746592643889,ECE 45,A01,892618,Staff,0,0,65,65
1746592645940,ECE 111,A01,892719,Staff,6,0,65,59
1746592646967,ECE 197,001,957920,Mercier; Patrick Philip,9991,0,9999,8
1746592647996,ECON 178,A01,907814,Zhu; Ying,26,0,35,9
1746592649019,EDS 115,A00,895312,Staff,35,0,45,10
1746592650596,EDS 117,A01,895337,Staff,23,0,30,7
1746592651623,EDS 125,A00,895341,Jones; Gabrielle Anastasia,36,0,45,9
1746592652652,EDS 128A,A01,895459,Fargason; Sharon Gayle,44,0,45,1
1746592653676,EDS 128B,A01,895543,Pappas; Elizabeth,44,0,45,1
1746592654702,EDS 139,A00,897203,Pappas; Elizabeth,44,0,45,1
1746592654702,EDS 139,B00,897209,Fargason; Sharon Gayle,41,0,45,4
1746592655727,EDS 201,A00,895545,Staff,22,0,45,23
1746592656752,EDS 203,A01,895581,Halter; Christopher P.,22,0,45,23
1746592657776,EDS 204R,A01,895625,Heinzman; Erica M.,39,0,45,6
1746592657776,EDS 204R,B01,895693,Halter; Christopher P.,10,0,45,35
1746592658801,EDS 206R,A00,895694,Fargason; Sharon Gayle,1,0,30,29
1746592658801,EDS 206R,B00,895695,Choi; Bailey Miyeon,16,0,30,14
1746592659826,EDS 250,A00,895697,Hemans; Patricia Ann Benitez,22,0,45,23
1746592660853,EDS 281,A00,895701,Meyerott; Theresa Ann,1,0,15,14
1746592661878,EDS 284,A00,895736,Meyerott; Theresa Ann,1,0,15,14
1746592662903,EDS 286,A00,897210,Fine; Sarah,0,0,15,15
1746592663935,EDS 289C,A01,895770,Daly; Alan J.,1,0,15,14
1746592664964,EDS 290,A00,897211,Hofstetter; Carolyn,0,0,15,15
1746592665989,LIGM 5A,A00,896162,Fischer-Grunski; Eva K,12,0,20,8
1746592667016,LIGM 5B,A00,896260,Fischer-Grunski; Eva K,17,0,20,3
1746592668043,LIGM 5C,A00,896308,Fischer-Grunski; Eva K,18,0,20,2
1746592669074,LIIT 5AS,A00,896313,Carnelos; Chiara,18,0,20,2
1746592670103,LIIT 5BS,A00,896416,Carnelos; Chiara,20,0,20,0
1746592671132,LIIT 5CS,A00,896564,Carnelos; Chiara,20,0,20,0
1746592672159,LISP 5A,A00,896588,Munoz Sanchez; Alicia,2,0,20,18
1746592673184,LISP 5B,A00,896653,Munoz Sanchez; Alicia,7,0,20,13
1746592674210,LISP 5C,A00,896655,Munoz Sanchez; Alicia,0,1,20,20
1746592675235,MAE 197,001,957918,Kleissl; Jan,9996,0,9999,3
1746592675235,MAE 197,002,959806,Boechler; Nicholas Sebastia,9998,0,9999,1
1746592675235,MAE 197,003,959852,Mullin; Jennifer S,9998,0,9999,1
1746592676261,MATH 2,A01,957937,Staff,33,0,35,2
1746592677289,MATH 197,001,957876,Kedlaya; Kiran S.,9993,0,9999,6
1746592678315,MCWP 40,A00,892729,Duru; Nur,10,0,20,10
1746592678315,MCWP 40,B00,893304,Montejo; Carolina,14,0,20,6
1746592679340,MCWP 40R,A00,893757,Redela; Pamela Morgan,0,5,20,20
1746592680372,MCWP 50,A00,893758,Morshed; Michael James,0,0,20,20
1746592680372,MCWP 50,B00,893761,Bartulis; Jason Michael,17,0,20,3
1746592681397,MCWP 50R,A00,893766,Compas; Sean Matthew,0,1,20,20
1746592681397,MCWP 50R,B00,893769,Carter; Jennifer A,0,1,20,20
1746592681397,MCWP 50R,C00,893771,Krone; Jarret,0,3,20,20
1746592681397,MCWP 50R,D00,893772,Miller; Elizabeth Deen,0,0,20,20
1746592681397,MCWP 50R,E00,893775,Carter; Andrea L,0,1,20,20
1746592682426,MMW 11R,A01,892721,Herbst; Matthew,14,0,30,16
1746592682426,MMW 11R,A02,892722,Herbst; Matthew,0,0,0,3
1746592683451,MMW 12R,A01,892724,Herbst; Matthew,0,11,16,16
1746592683451,MMW 12R,A02,892725,Herbst; Matthew,0,10,16,16
1746592684538,MMW 13R,A01,892727,Staff,0,4,16,16
1746592684538,MMW 13R,A02,892728,Staff,0,4,16,16
1746592684538,MMW 13R,A03,958032,Staff,0,4,16,16
1746592684538,MMW 13R,A04,958033,Staff,0,4,16,16
1746592684538,MMW 13R,A05,958034,Staff,0,4,16,16
1746592685562,SIO 295LS,A00,894015,Staff,5,0,25,20
1746592686588,SIO 295S,A00,894020,Staff,5,0,25,20
1746592687614,SIOC 290S,B01,958918,Merrifield; Mark A,14,0,30,16
1746592688639,SIOC 291S,B01,958922,Gabriel; Corey John,14,0,30,16
1746592689663,SOCI 117,A01,895339,Staff,2,0,5,3
1746592690692,WES 237B,A00,894149,Staff,11,0,20,9
1746592692757,AESE 279B,A00,891859,Staff,13,0,35,22
1746592693783,AIP 197,001,891854,Vespa; Emanuel Ignacio,9999,0,9999,0
1746592694811,ANTH 289S,A00,891856,Gagneux; Pascal,12,0,12,0
1746592695839,BENG 196,001,957946,Engler; Adam J.,9996,0,9999,3
1746592696866,BISP 197,001,959851,Wilhelm; James E.,9998,0,9999,1
1746592697889,CAT 124RS,A01,956906,Staff,6,0,25,19
1746592698915,CAT 125RS,A01,922013,Staff,6,0,25,19
1746592699943,CLRE 250,A00,891860,Morris; Sheldon,9995,0,9999,4
1746592701995,CLRE 251R,A00,907817,Mehta; Ravindra L.,9994,0,9999,5
1746592703020,CLRE 252,A00,891864,Cuomo; Raphael Eduardo,9993,0,9999,6
1746592704049,CLRE 253,A00,891867,Vaida; Florin,9994,0,9999,5
1746592704049,CLRE 253,B00,907819,Staff,9999,0,9999,0
1746592705080,CLRE 259,A00,891868,Patel; Hemal,9998,0,9999,1
1746592706104,CLRE 260,A00,891872,Cuomo; Raphael Eduardo,9999,0,9999,0
1746592707129,CLRE 297,001,891888,Cuomo; Raphael Eduardo,9999,0,9999,0
1746592708158,CSE 191,A00,958773,Minnes Kemp; Mor Mia,9995,0,9999,4
1746592709182,CSE 197,001,959846,Minnes Kemp; Mor Mia,9990,0,9999,9
1746592710206,CSS 201S,A01,892054,Mignozzetti; Umberto,25,0,30,5
1746592711235,CSS 202S,A01,892056,Mignozzetti; Umberto,25,0,30,5
1746592712258,DSC 197,001,956898,Eldridge; Justin Matthew,9996,0,9999,3
1746592713283,DSC 297,001,958000,Mazumdar; Arya,9998,0,9999,1
1746592713283,DSC 297,002,959862,Wang; Yusu,9998,0,9999,1
1746592714309,EAP 100,A00,905686,Staff,9778,0,9999,221
1746592715335,ECE 45,A01,892618,Staff,0,0,65,65
1746592717426,ECE 111,A01,892719,Staff,6,0,65,59
1746592718451,ECE 197,001,957920,Mercier; Patrick Philip,9991,0,9999,8
1746592719479,ECON 178,A01,907814,Zhu; Ying,26,0,35,9
1746592720505,EDS 115,A00,895312,Staff,35,0,45,10
1746592721533,EDS 117,A01,895337,Staff,23,0,30,7
1746592722557,EDS 125,A00,895341,Jones; Gabrielle Anastasia,36,0,45,9
1746592723581,EDS 128A,A01,895459,Fargason; Sharon Gayle,44,0,45,1
1746592724608,EDS 128B,A01,895543,Pappas; Elizabeth,44,0,45,1
1746592725633,EDS 139,A00,897203,Pappas; Elizabeth,44,0,45,1
1746592725633,EDS 139,B00,897209,Fargason; Sharon Gayle,41,0,45,4
1746592726657,EDS 201,A00,895545,Staff,22,0,45,23
1746592727683,EDS 203,A01,895581,Halter; Christopher P.,22,0,45,23
1746592728708,EDS 204R,A01,895625,Heinzman; Erica M.,39,0,45,6
1746592728708,EDS 204R,B01,895693,Halter; Christopher P.,10,0,45,35
1746592729736,EDS 206R,A00,895694,Fargason; Sharon Gayle,1,0,30,29
1746592729736,EDS 206R,B00,895695,Choi; Bailey Miyeon,16,0,30,14
1746592730760,EDS 250,A00,895697,Hemans; Patricia Ann Benitez,22,0,45,23
1746592731784,EDS 281,A00,895701,Meyerott; Theresa Ann,1,0,15,14
1746592732807,EDS 284,A00,895736,Meyerott; Theresa Ann,1,0,15,14
1746592733836,EDS 286,A00,897210,Fine; Sarah,0,0,15,15
1746592734860,EDS 289C,A01,895770,Daly; Alan J.,1,0,15,14
1746592735888,EDS 290,A00,897211,Hofstetter; Carolyn,0,0,15,15
1746592736913,LIGM 5A,A00,896162,Fischer-Grunski; Eva K,12,0,20,8
1746592737943,LIGM 5B,A00,896260,Fischer-Grunski; Eva K,17,0,20,3
1746592738967,LIGM 5C,A00,896308,Fischer-Grunski; Eva K,18,0,20,2
1746592739991,LIIT 5AS,A00,896313,Carnelos; Chiara,18,0,20,2
1746592741021,LIIT 5BS,A00,896416,Carnelos; Chiara,20,0,20,0
1746592742047,LIIT 5CS,A00,896564,Carnelos; Chiara,20,0,20,0
1746592743077,LISP 5A,A00,896588,Munoz Sanchez; Alicia,2,0,20,18
1746592744106,LISP 5B,A00,896653,Munoz Sanchez; Alicia,7,0,20,13
1746592745135,LISP 5C,A00,896655,Munoz Sanchez; Alicia,0,1,20,20
1746592746160,MAE 197,001,957918,Kleissl; Jan,9996,0,9999,3
1746592746160,MAE 197,002,959806,Boechler; Nicholas Sebastia,9998,0,9999,1
1746592746160,MAE 197,003,959852,Mullin; Jennifer S,9998,0,9999,1
1746592747188,MATH 2,A01,957937,Staff,33,0,35,2
1746592748216,MATH 197,001,957876,Kedlaya; Kiran S.,9993,0,9999,6
1746592749245,MCWP 40,A00,892729,Duru; Nur,10,0,20,10
1746592749245,MCWP 40,B00,893304,Montejo; Carolina,14,0,20,6
1746592750274,MCWP 40R,A00,893757,Redela; Pamela Morgan,0,5,20,20
1746592751299,MCWP 50,A00,893758,Morshed; Michael James,0,0,20,20
1746592751299,MCWP 50,B00,893761,Bartulis; Jason Michael,17,0,20,3
1746592752327,MCWP 50R,A00,893766,Compas; Sean Matthew,0,1,20,20
1746592752327,MCWP 50R,B00,893769,Carter; Jennifer A,0,1,20,20
1746592752327,MCWP 50R,C00,893771,Krone; Jarret,0,3,20,20
1746592752327,MCWP 50R,D00,893772,Miller; Elizabeth Deen,0,0,20,20
1746592752327,MCWP 50R,E00,893775,Carter; Andrea L,0,1,20,20
1746592753355,MMW 11R,A01,892721,Herbst; Matthew,14,0,30,16
1746592753355,MMW 11R,A02,892722,Herbst; Matthew,0,0,0,3
1746592754382,MMW 12R,A01,892724,Herbst; Matthew,0,11,16,16
1746592754382,MMW 12R,A02,892725,Herbst; Matthew,0,10,16,16
1746592755408,MMW 13R,A01,892727,Staff,0,4,16,16
1746592755408,MMW 13R,A02,892728,Staff,0,4,16,16
1746592755408,MMW 13R,A03,958032,Staff,0,4,16,16
1746592755408,MMW 13R,A04,958033,Staff,0,4,16,16
1746592755408,MMW 13R,A05,958034,Staff,0,4,16,16
1746592756436,SIO 295LS,A00,894015,Staff,5,0,25,20
1746592757461,SIO 295S,A00,894020,Staff,5,0,25,20
1746592758487,SIOC 290S,B01,958918,Merrifield; Mark A,14,0,30,16
1746592759516,SIOC 291S,B01,958922,Gabriel; Corey John,14,0,30,16
1746592760542,SOCI 117,A01,895339,Staff,2,0,5,3
1746592761567,WES 237B,A00,894149,Staff,11,0,20,9
1746592763630,AESE 279B,A00,891859,Staff,13,0,35,22
1746592764656,AIP 197,001,891854,Vespa; Emanuel Ignacio,9999,0,9999,0
1746592765681,ANTH 289S,A00,891856,Gagneux; Pascal,12,0,12,0
1746592766709,BENG 196,001,957946,Engler; Adam J.,9996,0,9999,3
1746592767733,BISP 197,001,959851,Wilhelm; James E.,9998,0,9999,1
1746592768757,CAT 124RS,A01,956906,Staff,6,0,25,19
1746592769780,CAT 125RS,A01,922013,Staff,6,0,25,19
1746592770805,CLRE 250,A00,891860,Morris; Sheldon,9995,0,9999,4
1746592772860,CLRE 251R,A00,907817,Mehta; Ravindra L.,9994,0,9999,5
1746592773885,CLRE 252,A00,891864,Cuomo; Raphael Eduardo,9993,0,9999,6
1746592774915,CLRE 253,A00,891867,Vaida; Florin,9994,0,9999,5
1746592774915,CLRE 253,B00,907819,Staff,9999,0,9999,0
1746592775940,CLRE 259,A00,891868,Patel; Hemal,9998,0,9999,1
1746592776968,CLRE 260,A00,891872,Cuomo; Raphael Eduardo,9999,0,9999,0
1746592777996,CLRE 297,001,891888,Cuomo; Raphael Eduardo,9999,0,9999,0
1746592779022,CSE 191,A00,958773,Minnes Kemp; Mor Mia,9995,0,9999,4
1746592780048,CSE 197,001,959846,Minnes Kemp; Mor Mia,9990,0,9999,9
1746592781073,CSS 201S,A01,892054,Mignozzetti; Umberto,25,0,30,5
1746592782102,CSS 202S,A01,892056,Mignozzetti; Umberto,25,0,30,5
1746592783128,DSC 197,001,956898,Eldridge; Justin Matthew,9996,0,9999,3
1746592784154,DSC 297,001,958000,Mazumdar; Arya,9998,0,9999,1
1746592784154,DSC 297,002,959862,Wang; Yusu,9998,0,9999,1
1746592785181,EAP 100,A00,905686,Staff,9778,0,9999,221
1746592786210,ECE 45,A01,892618,Staff,0,0,65,65
1746592788260,ECE 111,A01,892719,Staff,6,0,65,59
1746592789286,ECE 197,001,957920,Mercier; Patrick Philip,9991,0,9999,8
1746592790312,ECON 178,A01,907814,Zhu; Ying,26,0,35,9
1746592791337,EDS 115,A00,895312,Staff,35,0,45,10
1746592792362,EDS 117,A01,895337,Staff,23,0,30,7
1746592793391,EDS 125,A00,895341,Jones; Gabrielle Anastasia,36,0,45,9
1746592794420,EDS 128A,A01,895459,Fargason; Sharon Gayle,44,0,45,1
1746592795445,EDS 128B,A01,895543,Pappas; Elizabeth,44,0,45,1
1746592796474,EDS 139,A00,897203,Pappas; Elizabeth,44,0,45,1
1746592796474,EDS 139,B00,897209,Fargason; Sharon Gayle,41,0,45,4
1746592797499,EDS 201,A00,895545,Staff,22,0,45,23
1746592798525,EDS 203,A01,895581,Halter; Christopher P.,22,0,45,23
1746592799551,EDS 204R,A01,895625,Heinzman; Erica M.,39,0,45,6
1746592799551,EDS 204R,B01,895693,Halter; Christopher P.,10,0,45,35
1746592800580,EDS 206R,A00,895694,Fargason; Sharon Gayle,1,0,30,29
1746592800580,EDS 206R,B00,895695,Choi; Bailey Miyeon,16,0,30,14
1746592801606,EDS 250,A00,895697,Hemans; Patricia Ann Benitez,22,0,45,23
1746592802631,EDS 281,A00,895701,Meyerott; Theresa Ann,1,0,15,14
1746592803657,EDS 284,A00,895736,Meyerott; Theresa Ann,1,0,15,14
1746592804683,EDS 286,A00,897210,Fine; Sarah,0,0,15,15
1746592805712,EDS 289C,A01,895770,Daly; Alan J.,1,0,15,14
1746592806736,EDS 290,A00,897211,Hofstetter; Carolyn,0,0,15,15
1746592807762,LIGM 5A,A00,896162,Fischer-Grunski; Eva K,12,0,20,8
1746592808791,LIGM 5B,A00,896260,Fischer-Grunski; Eva K,17,0,20,3
1746592809816,LIGM 5C,A00,896308,Fischer-Grunski; Eva K,18,0,20,2
1746592810853,LIIT 5AS,A00,896313,Carnelos; Chiara,18,0,20,2
1746592811878,LIIT 5BS,A00,896416,Carnelos; Chiara,20,0,20,0
1746592812904,LIIT 5CS,A00,896564,Carnelos; Chiara,20,0,20,0
1746592813934,LISP 5A,A00,896588,Munoz Sanchez; Alicia,2,0,20,18
1746592814965,LISP 5B,A00,896653,Munoz Sanchez; Alicia,7,0,20,13
1746592815996,LISP 5C,A00,896655,Munoz Sanchez; Alicia,0,1,20,20
1746592817020,MAE 197,001,957918,Kleissl; Jan,9996,0,9999,3
1746592817020,MAE 197,002,959806,Boechler; Nicholas Sebastia,9998,0,9999,1
1746592817020,MAE 197,003,959852,Mullin; Jennifer S,9998,0,9999,1
1746592818045,MATH 2,A01,957937,Staff,33,0,35,2
1746592819069,MATH 197,001,957876,Kedlaya; Kiran S.,9993,0,9999,6
1746592820136,MCWP 40,A00,892729,Duru; Nur,10,0,20,10
1746592820136,MCWP 40,B00,893304,Montejo; Carolina,14,0,20,6
1746592821162,MCWP 40R,A00,893757,Redela; Pamela Morgan,0,5,20,20
1746592822188,MCWP 50,A00,893758,Morshed; Michael James,0,0,20,20
1746592822188,MCWP 50,B00,893761,Bartulis; Jason Michael,17,0,20,3
1746592823214,MCWP 50R,A00,893766,Compas; Sean Matthew,0,1,20,20
1746592823214,MCWP 50R,B00,893769,Carter; Jennifer A,0,1,20,20
1746592823214,MCWP 50R,C00,893771,Krone; Jarret,0,3,20,20
1746592823214,MCWP 50R,D00,893772,Miller; Elizabeth Deen,0,0,20,20
1746592823214,MCWP 50R,E00,893775,Carter; Andrea L,0,1,20,20
1746592824240,MMW 11R,A01,892721,Herbst; Matthew,14,0,30,16
1746592824240,MMW 11R,A02,892722,Herbst; Matthew,0,0,0,3
1746592825265,MMW 12R,A01,892724,Herbst; Matthew,0,11,16,16
1746592825265,MMW 12R,A02,892725,Herbst; Matthew,0,10,16,16
1746592826294,MMW 13R,A01,892727,Staff,0,4,16,16
1746592826294,MMW 13R,A02,892728,Staff,0,4,16,16
1746592826294,MMW 13R,A03,958032,Staff,0,4,16,16
1746592826294,MMW 13R,A04,958033,Staff,0,4,16,16
1746592826294,MMW 13R,A05,958034,Staff,0,4,16,16
1746592827322,SIO 295LS,A00,894015,Staff,5,0,25,20
1746592828350,SIO 295S,A00,894020,Staff,5,0,25,20
1746592829379,SIOC 290S,B01,958918,Merrifield; Mark A,14,0,30,16
1746592830406,SIOC 291S,B01,958922,Gabriel; Corey John,14,0,30,16
1746592831431,SOCI 117,A01,895339,Staff,2,0,5,3
1746592832458,WES 237B,A00,894149,Staff,11,0,20,9
1746592834526,AESE 279B,A00,891859,Staff,13,0,35,22
1746592835552,AIP 197,001,891854,Vespa; Emanuel Ignacio,9999,0,9999,0
1746592836578,ANTH 289S,A00,891856,Gagneux; Pascal,12,0,12,0
1746592837608,BENG 196,001,957946,Engler; Adam J.,9996,0,9999,3
1746592838635,BISP 197,001,959851,Wilhelm; James E.,9998,0,9999,1
1746592839661,CAT 124RS,A01,956906,Staff,6,0,25,19
1746592840688,CAT 125RS,A01,922013,Staff,6,0,25,19
1746592841716,CLRE 250,A00,891860,Morris; Sheldon,9995,0,9999,4
1746592843768,CLRE 251R,A00,907817,Mehta; Ravindra L.,9994,0,9999,5
1746592844792,CLRE 252,A00,891864,Cuomo; Raphael Eduardo,9993,0,9999,6
1746592845818,CLRE 253,A00,891867,Vaida; Florin,9994,0,9999,5
1746592845818,CLRE 253,B00,907819,Staff,9999,0,9999,0
1746592846845,CLRE 259,A00,891868,Patel; Hemal,9998,0,9999,1
1746592847871,CLRE 260,A00,891872,Cuomo; Raphael Eduardo,9999,0,9999,0
1746592848897,CLRE 297,001,891888,Cuomo; Raphael Eduardo,9999,0,9999,0
1746592849922,CSE 191,A00,958773,Minnes Kemp; Mor Mia,9995,0,9999,4
1746592850948,CSE 197,001,959846,Minnes Kemp; Mor Mia,9990,0,9999,9
1746592851974,CSS 201S,A01,892054,Mignozzetti; Umberto,25,0,30,5
1746592853002,CSS 202S,A01,892056,Mignozzetti; Umberto,25,0,30,5
1746592854031,DSC 197,001,956898,Eldridge; Justin Matthew,9996,0,9999,3
1746592855056,DSC 297,001,958000,Mazumdar; Arya,9998,0,9999,1
1746592855056,DSC 297,002,959862,Wang; Yusu,9998,0,9999,1
1746592856081,EAP 100,A00,905686,Staff,9778,0,9999,221
1746592857113,ECE 45,A01,892618,Staff,0,0,65,65
1746592859163,ECE 111,A01,892719,Staff,6,0,65,59
1746592860193,ECE 197,001,957920,Mercier; Patrick Philip,9991,0,9999,8
1746592861222,ECON 178,A01,907814,Zhu; Ying,26,0,35,9
1746592862247,EDS 115,A00,895312,Staff,35,0,45,10
1746592863275,EDS 117,A01,895337,Staff,23,0,30,7
1746592864302,EDS 125,A00,895341,Jones; Gabrielle Anastasia,36,0,45,9
1746592865327,EDS 128A,A01,895459,Fargason; Sharon Gayle,44,0,45,1
1746592866354,EDS 128B,A01,895543,Pappas; Elizabeth,44,0,45,1
1746592867381,EDS 139,A00,897203,Pappas; Elizabeth,44,0,45,1
1746592867381,EDS 139,B00,897209,Fargason; Sharon Gayle,41,0,45,4
1746592868407,EDS 201,A00,895545,Staff,22,0,45,23
1746592869435,EDS 203,A01,895581,Halter; Christopher P.,22,0,45,23
1746592870463,EDS 204R,A01,895625,Heinzman; Erica M.,39,0,45,6
1746592870463,EDS 204R,B01,895693,Halter; Christopher P.,10,0,45,35
1746592871493,EDS 206R,A00,895694,Fargason; Sharon Gayle,1,0,30,29
1746592871493,EDS 206R,B00,895695,Choi; Bailey Miyeon,16,0,30,14
1746592872522,EDS 250,A00,895697,Hemans; Patricia Ann Benitez,22,0,45,23
1746592873550,EDS 281,A00,895701,Meyerott; Theresa Ann,1,0,15,14
1746592874578,EDS 284,A00,895736,Meyerott; Theresa Ann,1,0,15,14
1746592875604,EDS 286,A00,897210,Fine; Sarah,0,0,15,15
1746592876630,EDS 289C,A01,895770,Daly; Alan J.,1,0,15,14
1746592877655,EDS 290,A00,897211,Hofstetter; Carolyn,0,0,15,15
1746592878679,LIGM 5A,A00,896162,Fischer-Grunski; Eva K,12,0,20,8
1746592879705,LIGM 5B,A00,896260,Fischer-Grunski; Eva K,17,0,20,3
1746592880732,LIGM 5C,A00,896308,Fischer-Grunski; Eva K,18,0,20,2
1746592881761,LIIT 5AS,A00,896313,Carnelos; Chiara,18,0,20,2
1746592882789,LIIT 5BS,A00,896416,Carnelos; Chiara,20,0,20,0
1746592883819,LIIT 5CS,A00,896564,Carnelos; Chiara,20,0,20,0
1746592884849,LISP 5A,A00,896588,Munoz Sanchez; Alicia,2,0,20,18
1746592885880,LISP 5B,A00,896653,Munoz Sanchez; Alicia,7,0,20,13
1746592886905,LISP 5C,A00,896655,Munoz Sanchez; Alicia,0,1,20,20
1746592887931,MAE 197,001,957918,Kleissl; Jan,9996,0,9999,3
1746592887931,MAE 197,002,959806,Boechler; Nicholas Sebastia,9998,0,9999,1
1746592887931,MAE 197,003,959852,Mullin; Jennifer S,9998,0,9999,1
1746592888961,MATH 2,A01,957937,Staff,33,0,35,2
1746592889985,MATH 197,001,957876,Kedlaya; Kiran S.,9993,0,9999,6
1746592891011,MCWP 40,A00,892729,Duru; Nur,10,0,20,10
1746592891011,MCWP 40,B00,893304,Montejo; Carolina,14,0,20,6
1746592892041,MCWP 40R,A00,893757,Redela; Pamela Morgan,0,5,20,20
1746592893071,MCWP 50,A00,893758,Morshed; Michael James,0,0,20,20
1746592893071,MCWP 50,B00,893761,Bartulis; Jason Michael,17,0,20,3
1746592894098,MCWP 50R,A00,893766,Compas; Sean Matthew,0,1,20,20
1746592894098,MCWP 50R,B00,893769,Carter; Jennifer A,0,1,20,20
1746592894098,MCWP 50R,C00,893771,Krone; Jarret,0,3,20,20
1746592894098,MCWP 50R,D00,893772,Miller; Elizabeth Deen,0,0,20,20
1746592894098,MCWP 50R,E00,893775,Carter; Andrea L,0,1,20,20
1746592895124,MMW 11R,A01,892721,Herbst; Matthew,14,0,30,16
1746592895124,MMW 11R,A02,892722,Herbst; Matthew,0,0,0,3
1746592897167,MMW 12R,A01,892724,Herbst; Matthew,0,11,16,16
1746592897167,MMW 12R,A02,892725,Herbst; Matthew,0,10,16,16
1746592898196,MMW 13R,A01,892727,Staff,0,4,16,16
1746592898196,MMW 13R,A02,892728,Staff,0,4,16,16
1746592898196,MMW 13R,A03,958032,Staff,0,4,16,16
1746592898196,MMW 13R,A04,958033,Staff,0,4,16,16
1746592898196,MMW 13R,A05,958034,Staff,0,4,16,16
1746592899227,SIO 295LS,A00,894015,Staff,5,0,25,20
1746592900255,SIO 295S,A00,894020,Staff,5,0,25,20
1746592901286,SIOC 290S,B01,958918,Merrifield; Mark A,14,0,30,16
1746592902313,SIOC 291S,B01,958922,Gabriel; Corey John,14,0,30,16
1746592903338,SOCI 117,A01,895339,Staff,2,0,5,3
1746592904362,WES 237B,A00,894149,Staff,11,0,20,9
1746592906420,AESE 279B,A00,891859,Staff,13,0,35,22
1746592907445,AIP 197,001,891854,Vespa; Emanuel Ignacio,9999,0,9999,0
1746592908473,ANTH 289S,A00,891856,Gagneux; Pascal,12,0,12,0
1746592909501,BENG 196,001,957946,Engler; Adam J.,9996,0,9999,3
1746592910530,BISP 197,001,959851,Wilhelm; James E.,9998,0,9999,1
1746592911557,CAT 124RS,A01,956906,Staff,6,0,25,19
1746592912582,CAT 125RS,A01,922013,Staff,6,0,25,19
1746592913606,CLRE 250,A00,891860,Morris; Sheldon,9995,0,9999,4
1746592915660,CLRE 251R,A00,907817,Mehta; Ravindra L.,9994,0,9999,5
1746592916689,CLRE 252,A00,891864,Cuomo; Raphael Eduardo,9993,0,9999,6
1746592917718,CLRE 253,A00,891867,Vaida; Florin,9994,0,9999,5
1746592917718,CLRE 253,B00,907819,Staff,9999,0,9999,0
1746592918743,CLRE 259,A00,891868,Patel; Hemal,9998,0,9999,1
1746592919771,CLRE 260,A00,891872,Cuomo; Raphael Eduardo,9999,0,9999,0
1746592920796,CLRE 297,001,891888,Cuomo; Raphael Eduardo,9999,0,9999,0
1746592921826,CSE 191,A00,958773,Minnes Kemp; Mor Mia,9995,0,9999,4
1746592922855,CSE 197,001,959846,Minnes Kemp; Mor Mia,9990,0,9999,9
1746592923887,CSS 201S,A01,892054,Mignozzetti; Umberto,25,0,30,5
1746592924953,CSS 202S,A01,892056,Mignozzetti; Umberto,25,0,30,5
1746592925982,DSC 197,001,956898,Eldridge; Justin Matthew,9996,0,9999,3
1746592927008,DSC 297,001,958000,Mazumdar; Arya,9998,0,9999,1
1746592927008,DSC 297,002,959862,Wang; Yusu,9998,0,9999,1
1746592928036,EAP 100,A00,905686,Staff,9778,0,9999,221
1746592929066,ECE 45,A01,892618,Staff,0,0,65,65
1746592931122,ECE 111,A01,892719,Staff,6,0,65,59
1746592932147,ECE 197,001,957920,Mercier; Patrick Philip,9991,0,9999,8
1746592933174,ECON 178,A01,907814,Zhu; Ying,26,0,35,9
1746592934202,EDS 115,A00,895312,Staff,35,0,45,10
1746592935227,EDS 117,A01,895337,Staff,23,0,30,7
1746592936257,EDS 125,A00,895341,Jones; Gabrielle Anastasia,36,0,45,9
1746592937285,EDS 128A,A01,895459,Fargason; Sharon Gayle,44,0,45,1
1746592938309,EDS 128B,A01,895543,Pappas; Elizabeth,44,0,45,1
1746592939338,EDS 139,A00,897203,Pappas; Elizabeth,44,0,45,1
1746592939338,EDS 139,B00,897209,Fargason; Sharon Gayle,41,0,45,4
1746592940363,EDS 201,A00,895545,Staff,22,0,45,23
1746592941388,EDS 203,A01,895581,Halter; Christopher P.,22,0,45,23
1746592942421,EDS 204R,A01,895625,Heinzman; Erica M.,39,0,45,6
1746592942421,EDS 204R,B01,895693,Halter; Christopher P.,10,0,45,35
1746592943447,EDS 206R,A00,895694,Fargason; Sharon Gayle,1,0,30,29
1746592943447,EDS 206R,B00,895695,Choi; Bailey Miyeon,16,0,30,14
1746592944472,EDS 250,A00,895697,Hemans; Patricia Ann Benitez,22,0,45,23
1746592945500,EDS 281,A00,895701,Meyerott; Theresa Ann,1,0,15,14
1746592946525,EDS 284,A00,895736,Meyerott; Theresa Ann,1,0,15,14
1746592947553,EDS 286,A00,897210,Fine; Sarah,0,0,15,15
1746592948581,EDS 289C,A01,895770,Daly; Alan J.,1,0,15,14
1746592949606,EDS 290,A00,897211,Hofstetter; Carolyn,0,0,15,15
1746592950636,LIGM 5A,A00,896162,Fischer-Grunski; Eva K,12,0,20,8
1746592951664,LIGM 5B,A00,896260,Fischer-Grunski; Eva K,17,0,20,3
1746592952690,LIGM 5C,A00,896308,Fischer-Grunski; Eva K,18,0,20,2
1746592953717,LIIT 5AS,A00,896313,Carnelos; Chiara,18,0,20,2
1746592954747,LIIT 5BS,A00,896416,Carnelos; Chiara,20,0,20,0
1746592955773,LIIT 5CS,A00,896564,Carnelos; Chiara,20,0,20,0
1746592956801,LISP 5A,A00,896588,Munoz Sanchez; Alicia,2,0,20,18
1746592957832,LISP 5B,A00,896653,Munoz Sanchez; Alicia,7,0,20,13
1746592958860,LISP 5C,A00,896655,Munoz Sanchez; Alicia,0,1,20,20
1746592959891,MAE 197,001,957918,Kleissl; Jan,9996,0,9999,3
1746592959891,MAE 197,002,959806,Boechler; Nicholas Sebastia,9998,0,9999,1
1746592959891,MAE 197,003,959852,Mullin; Jennifer S,9998,0,9999,1
1746592960918,MATH 2,A01,957937,Staff,33,0,35,2
1746592961945,MATH 197,001,957876,Kedlaya; Kiran S.,9993,0,9999,6
1746592962972,MCWP 40,A00,892729,Duru; Nur,10,0,20,10
1746592962972,MCWP 40,B00,893304,Montejo; Carolina,14,0,20,6
1746592963998,MCWP 40R,A00,893757,Redela; Pamela Morgan,0,5,20,20
1746592965024,MCWP 50,A00,893758,Morshed; Michael James,0,0,20,20
1746592965024,MCWP 50,B00,893761,Bartulis; Jason Michael,17,0,20,3
1746592966052,MCWP 50R,A00,893766,Compas; Sean Matthew,0,1,20,20
1746592966052,MCWP 50R,B00,893769,Carter; Jennifer A,0,1,20,20
1746592966052,MCWP 50R,C00,893771,Krone; Jarret,0,3,20,20
1746592966052,MCWP 50R,D00,893772,Miller; Elizabeth Deen,0,0,20,20
1746592966052,MCWP 50R,E00,893775,Carter; Andrea L,0,1,20,20
1746592967078,MMW 11R,A01,892721,Herbst; Matthew,14,0,30,16
1746592967078,MMW 11R,A02,892722,Herbst; Matthew,0,0,0,3
1746592968108,MMW 12R,A01,892724,Herbst; Matthew,0,11,16,16
1746592968108,MMW 12R,A02,892725,Herbst; Matthew,0,10,16,16
1746592969134,MMW 13R,A01,892727,Staff,0,4,16,16
1746592969134,MMW 13R,A02,892728,Staff,0,4,16,16
1746592969134,MMW 13R,A03,958032,Staff,0,4,16,16
1746592969134,MMW 13R,A04,958033,Staff,0,4,16,16
1746592969134,MMW 13R,A05,958034,Staff,0,4,16,16
1746592970164,SIO 295LS,A00,894015,Staff,5,0,25,20
1746592971189,SIO 295S,A00,894020,Staff,5,0,25,20
1746592972219,SIOC 290S,B01,958918,Merrifield; Mark A,14,0,30,16
1746592973246,SIOC 291S,B01,958922,Gabriel; Corey John,14,0,30,16
1746592974272,SOCI 117,A01,895339,Staff,2,0,5,3
1746592975299,WES 237B,A00,894149,Staff,11,0,20,9
1746592977370,AESE 279B,A00,891859,Staff,13,0,35,22
1746592978398,AIP 197,001,891854,Vespa; Emanuel Ignacio,9999,0,9999,0
1746592979422,ANTH 289S,A00,891856,Gagneux; Pascal,12,0,12,0
1746592980448,BENG 196,001,957946,Engler; Adam J.,9996,0,9999,3
1746592981472,BISP 197,001,959851,Wilhelm; James E.,9998,0,9999,1
1746592982499,CAT 124RS,A01,956906,Staff,6,0,25,19
1746592983524,CAT 125RS,A01,922013,Staff,6,0,25,19
1746592984549,CLRE 250,A00,891860,Morris; Sheldon,9995,0,9999,4
1746592986600,CLRE 251R,A00,907817,Mehta; Ravindra L.,9994,0,9999,5
1746592987627,CLRE 252,A00,891864,Cuomo; Raphael Eduardo,9993,0,9999,6
1746592988657,CLRE 253,A00,891867,Vaida; Florin,9994,0,9999,5
1746592988657,CLRE 253,B00,907819,Staff,9999,0,9999,0
1746592989684,CLRE 259,A00,891868,Patel; Hemal,9998,0,9999,1
1746592990710,CLRE 260,A00,891872,Cuomo; Raphael Eduardo,9999,0,9999,0
1746592991734,CLRE 297,001,891888,Cuomo; Raphael Eduardo,9999,0,9999,0
1746592992760,CSE 191,A00,958773,Minnes Kemp; Mor Mia,9995,0,9999,4
1746592993788,CSE 197,001,959846,Minnes Kemp; Mor Mia,9990,0,9999,9
1746592994817,CSS 201S,A01,892054,Mignozzetti; Umberto,25,0,30,5
1746592995841,CSS 202S,A01,892056,Mignozzetti; Umberto,25,0,30,5
1746592996867,DSC 197,001,956898,Eldridge; Justin Matthew,9996,0,9999,3
1746592997895,DSC 297,001,958000,Mazumdar; Arya,9998,0,9999,1
1746592997895,DSC 297,002,959862,Wang; Yusu,9998,0,9999,1
1746592998922,EAP 100,A00,905686,Staff,9778,0,9999,221
1746592999950,ECE 45,A01,892618,Staff,0,0,65,65
1746593002004,ECE 111,A01,892719,Staff,6,0,65,59
1746593003034,ECE 197,001,957920,Mercier; Patrick Philip,9991,0,9999,8
1746593004059,ECON 178,A01,907814,Zhu; Ying,26,0,35,9
1746593005082,EDS 115,A00,895312,Staff,35,0,45,10
1746593006107,EDS 117,A01,895337,Staff,23,0,30,7
1746593007132,EDS 125,A00,895341,Jones; Gabrielle Anastasia,36,0,45,9
1746593008161,EDS 128A,A01,895459,Fargason; Sharon Gayle,44,0,45,1
1746593009185,EDS 128B,A01,895543,Pappas; Elizabeth,44,0,45,1
1746593010211,EDS 139,A00,897203,Pappas; Elizabeth,44,0,45,1
1746593010211,EDS 139,B00,897209,Fargason; Sharon Gayle,41,0,45,4
1746593011236,EDS 201,A00,895545,Staff,22,0,45,23
1746593012268,EDS 203,A01,895581,Halter; Christopher P.,22,0,45,23
1746593013293,EDS 204R,A01,895625,Heinzman; Erica M.,39,0,45,6
1746593013293,EDS 204R,B01,895693,Halter; Christopher P.,10,0,45,35
1746593014317,EDS 206R,A00,895694,Fargason; Sharon Gayle,1,0,30,29
1746593014317,EDS 206R,B00,895695,Choi; Bailey Miyeon,16,0,30,14
1746593015342,EDS 250,A00,895697,Hemans; Patricia Ann Benitez,22,0,45,23
1746593016367,EDS 281,A00,895701,Meyerott; Theresa Ann,1,0,15,14
1746593017391,EDS 284,A00,895736,Meyerott; Theresa Ann,1,0,15,14
1746593018419,EDS 286,A00,897210,Fine; Sarah,0,0,15,15
1746593019443,EDS 289C,A01,895770,Daly; Alan J.,1,0,15,14
1746593020471,EDS 290,A00,897211,Hofstetter; Carolyn,0,0,15,15
1746593021498,LIGM 5A,A00,896162,Fischer-Grunski; Eva K,12,0,20,8
1746593022522,LIGM 5B,A00,896260,Fischer-Grunski; Eva K,17,0,20,3
1746593023550,LIGM 5C,A00,896308,Fischer-Grunski; Eva K,18,0,20,2
1746593024575,LIIT 5AS,A00,896313,Carnelos; Chiara,18,0,20,2
1746593025604,LIIT 5BS,A00,896416,Carnelos; Chiara,20,0,20,0
1746593026633,LIIT 5CS,A00,896564,Carnelos; Chiara,20,0,20,0
1746593027658,LISP 5A,A00,896588,Munoz Sanchez; Alicia,2,0,20,18
1746593028725,LISP 5B,A00,896653,Munoz Sanchez; Alicia,7,0,20,13
1746593029749,LISP 5C,A00,896655,Munoz Sanchez; Alicia,0,1,20,20
1746593030776,MAE 197,001,957918,Kleissl; Jan,9996,0,9999,3
1746593030776,MAE 197,002,959806,Boechler; Nicholas Sebastia,9998,0,9999,1
1746593030776,MAE 197,003,959852,Mullin; Jennifer S,9998,0,9999,1
1746593031803,MATH 2,A01,957937,Staff,33,0,35,2
1746593032828,MATH 197,001,957876,Kedlaya; Kiran S.,9993,0,9999,6
1746593033856,MCWP 40,A00,892729,Duru; Nur,10,0,20,10
1746593033856,MCWP 40,B00,893304,Montejo; Carolina,14,0,20,6
1746593034882,MCWP 40R,A00,893757,Redela; Pamela Morgan,0,5,20,20
1746593035907,MCWP 50,A00,893758,Morshed; Michael James,0,0,20,20
1746593035907,MCWP 50,B00,893761,Bartulis; Jason Michael,17,0,20,3
1746593036936,MCWP 50R,A00,893766,Compas; Sean Matthew,0,1,20,20
1746593036936,MCWP 50R,B00,893769,Carter; Jennifer A,0,1,20,20
1746593036936,MCWP 50R,C00,893771,Krone; Jarret,0,3,20,20
1746593036936,MCWP 50R,D00,893772,Miller; Elizabeth Deen,0,0,20,20
1746593036936,MCWP 50R,E00,893775,Carter; Andrea L,0,1,20,20
1746593037963,MMW 11R,A01,892721,Herbst; Matthew,14,0,30,16
1746593037963,MMW 11R,A02,892722,Herbst; Matthew,0,0,0,3
1746593038989,MMW 12R,A01,892724,Herbst; Matthew,0,11,16,16
1746593038989,MMW 12R,A02,892725,Herbst; Matthew,0,10,16,16
1746593040016,MMW 13R,A01,892727,Staff,0,4,16,16
1746593040016,MMW 13R,A02,892728,Staff,0,4,16,16
1746593040016,MMW 13R,A03,958032,Staff,0,4,16,16
1746593040016,MMW 13R,A04,958033,Staff,0,4,16,16
1746593040016,MMW 13R,A05,958034,Staff,0,4,16,16
1746593041043,SIO 295LS,A00,894015,Staff,5,0,25,20
1746593042067,SIO 295S,A00,894020,Staff,5,0,25,20
1746593043096,SIOC 290S,B01,958918,Merrifield; Mark A,14,0,30,16
1746593044122,SIOC 291S,B01,958922,Gabriel; Corey John,14,0,30,16
1746593045149,SOCI 117,A01,895339,Staff,2,0,5,3
1746593046173,WES 237B,A00,894149,Staff,11,0,20,9
1746593048235,AESE 279B,A00,891859,Staff,13,0,35,22
1746593049263,AIP 197,001,891854,Vespa; Emanuel Ignacio,9999,0,9999,0
1746593050291,ANTH 289S,A00,891856,Gagneux; Pascal,12,0,12,0
1746593051317,BENG 196,001,957946,Engler; Adam J.,9996,0,9999,3
1746593052342,BISP 197,001,959851,Wilhelm; James E.,9998,0,9999,1
1746593053366,CAT 124RS,A01,956906,Staff,6,0,25,19
1746593054391,CAT 125RS,A01,922013,Staff,6,0,25,19
1746593055419,CLRE 250,A00,891860,Morris; Sheldon,9995,0,9999,4
1746593057472,CLRE 251R,A00,907817,Mehta; Ravindra L.,9994,0,9999,5
1746593058496,CLRE 252,A00,891864,Cuomo; Raphael Eduardo,9993,0,9999,6
1746593059522,CLRE 253,A00,891867,Vaida; Florin,9994,0,9999,5
1746593059522,CLRE 253,B00,907819,Staff,9999,0,9999,0
1746593060548,CLRE 259,A00,891868,Patel; Hemal,9998,0,9999,1
1746593061574,CLRE 260,A00,891872,Cuomo; Raphael Eduardo,9999,0,9999,0
1746593062603,CLRE 297,001,891888,Cuomo; Raphael Eduardo,9999,0,9999,0
1746593063631,CSE 191,A00,958773,Minnes Kemp; Mor Mia,9995,0,9999,4
1746593064656,CSE 197,001,959846,Minnes Kemp; Mor Mia,9990,0,9999,9
1746593065686,CSS 201S,A01,892054,Mignozzetti; Umberto,25,0,30,5
1746593066715,CSS 202S,A01,892056,Mignozzetti; Umberto,25,0,30,5
1746593067743,DSC 197,001,956898,Eldridge; Justin Matthew,9996,0,9999,3
1746593068772,DSC 297,001,958000,Mazumdar; Arya,9998,0,9999,1
1746593068772,DSC 297,002,959862,Wang; Yusu,9998,0,9999,1
1746593069798,EAP 100,A00,905686,Staff,9778,0,9999,221
1746593070823,ECE 45,A01,892618,Staff,0,0,65,65
1746593072874,ECE 111,A01,892719,Staff,6,0,65,59
1746593073900,ECE 197,001,957920,Mercier; Patrick Philip,9991,0,9999,8
1746593074929,ECON 178,A01,907814,Zhu; Ying,26,0,35,9
1746593075954,EDS 115,A00,895312,Staff,35,0,45,10
1746593076981,EDS 117,A01,895337,Staff,23,0,30,7
1746593078010,EDS 125,A00,895341,Jones; Gabrielle Anastasia,36,0,45,9
1746593079037,EDS 128A,A01,895459,Fargason; Sharon Gayle,44,0,45,1
1746593080062,EDS 128B,A01,895543,Pappas; Elizabeth,44,0,45,1
1746593081088,EDS 139,A00,897203,Pappas; Elizabeth,44,0,45,1
1746593081088,EDS 139,B00,897209,Fargason; Sharon Gayle,41,0,45,4
1746593082113,EDS 201,A00,895545,Staff,22,0,45,23
1746593083139,EDS 203,A01,895581,Halter; Christopher P.,22,0,45,23
1746593084169,EDS 204R,A01,895625,Heinzman; Erica M.,39,0,45,6
1746593084169,EDS 204R,B01,895693,Halter; Christopher P.,10,0,45,35
1746593085194,EDS 206R,A00,895694,Fargason; Sharon Gayle,1,0,30,29
1746593085194,EDS 206R,B00,895695,Choi; Bailey Miyeon,16,0,30,14
1746593086219,EDS 250,A00,895697,Hemans; Patricia Ann Benitez,22,0,45,23
1746593087244,EDS 281,A00,895701,Meyerott; Theresa Ann,1,0,15,14
1746593088269,EDS 284,A00,895736,Meyerott; Theresa Ann,1,0,15,14
1746593089297,EDS 286,A00,897210,Fine; Sarah,0,0,15,15
1746593090326,EDS 289C,A01,895770,Daly; Alan J.,1,0,15,14
1746593091353,EDS 290,A00,897211,Hofstetter; Carolyn,0,0,15,15
1746593092379,LIGM 5A,A00,896162,Fischer-Grunski; Eva K,12,0,20,8
1746593093404,LIGM 5B,A00,896260,Fischer-Grunski; Eva K,17,0,20,3
1746593094431,LIGM 5C,A00,896308,Fischer-Grunski; Eva K,18,0,20,2
1746593095456,LIIT 5AS,A00,896313,Carnelos; Chiara,18,0,20,2
1746593096480,LIIT 5BS,A00,896416,Carnelos; Chiara,20,0,20,0
1746593097506,LIIT 5CS,A00,896564,Carnelos; Chiara,20,0,20,0
1746593098534,LISP 5A,A00,896588,Munoz Sanchez; Alicia,2,0,20,18
1746593099561,LISP 5B,A00,896653,Munoz Sanchez; Alicia,7,0,20,13
1746593100592,LISP 5C,A00,896655,Munoz Sanchez; Alicia,0,1,20,20
1746593101630,MAE 197,001,957918,Kleissl; Jan,9996,0,9999,3
1746593101630,MAE 197,002,959806,Boechler; Nicholas Sebastia,9998,0,9999,1
1746593101630,MAE 197,003,959852,Mullin; Jennifer S,9998,0,9999,1
1746593102657,MATH 2,A01,957937,Staff,33,0,35,2
1746593103684,MATH 197,001,957876,Kedlaya; Kiran S.,9993,0,9999,6
1746593104711,MCWP 40,A00,892729,Duru; Nur,10,0,20,10
1746593104711,MCWP 40,B00,893304,Montejo; Carolina,14,0,20,6
1746593105739,MCWP 40R,A00,893757,Redela; Pamela Morgan,0,5,20,20
1746593106767,MCWP 50,A00,893758,Morshed; Michael James,0,0,20,20
1746593106767,MCWP 50,B00,893761,Bartulis; Jason Michael,17,0,20,3
1746593107795,MCWP 50R,A00,893766,Compas; Sean Matthew,0,1,20,20
1746593107795,MCWP 50R,B00,893769,Carter; Jennifer A,0,1,20,20
1746593107795,MCWP 50R,C00,893771,Krone; Jarret,0,3,20,20
1746593107795,MCWP 50R,D00,893772,Miller; Elizabeth Deen,0,0,20,20
1746593107795,MCWP 50R,E00,893775,Carter; Andrea L,0,1,20,20
1746593108823,MMW 11R,A01,892721,Herbst; Matthew,14,0,30,16
1746593108823,MMW 11R,A02,892722,Herbst; Matthew,0,0,0,3
1746593109849,MMW 12R,A01,892724,Herbst; Matthew,0,11,16,16
1746593109849,MMW 12R,A02,892725,Herbst; Matthew,0,10,16,16
1746593110876,MMW 13R,A01,892727,Staff,0,4,16,16
1746593110876,MMW 13R,A02,892728,Staff,0,4,16,16
1746593110876,MMW 13R,A03,958032,Staff,0,4,16,16
1746593110876,MMW 13R,A04,958033,Staff,0,4,16,16
1746593110876,MMW 13R,A05,958034,Staff,0,4,16,16
1746593111902,SIO 295LS,A00,894015,Staff,5,0,25,20
1746593112927,SIO 295S,A00,894020,Staff,5,0,25,20
1746593113956,SIOC 290S,B01,958918,Merrifield; Mark A,14,0,30,16
1746593114981,SIOC 291S,B01,958922,Gabriel; Corey John,14,0,30,16
1746593116006,SOCI 117,A01,895339,Staff,2,0,5,3
1746593117030,WES 237B,A00,894149,Staff,11,0,20,9
1746593119089,AESE 279B,A00,891859,Staff,13,0,35,22
1746593120116,AIP 197,001,891854,Vespa; Emanuel Ignacio,9999,0,9999,0
1746593121144,ANTH 289S,A00,891856,Gagneux; Pascal,12,0,12,0
1746593122169,BENG 196,001,957946,Engler; Adam J.,9996,0,9999,3
1746593123195,BISP 197,001,959851,Wilhelm; James E.,9998,0,9999,1
1746593124222,CAT 124RS,A01,956906,Staff,6,0,25,19
1746593125250,CAT 125RS,A01,922013,Staff,6,0,25,19
1746593126275,CLRE 250,A00,891860,Morris; Sheldon,9995,0,9999,4
1746593128345,CLRE 251R,A00,907817,Mehta; Ravindra L.,9994,0,9999,5
1746593129371,CLRE 252,A00,891864,Cuomo; Raphael Eduardo,9993,0,9999,6
1746593130395,CLRE 253,A00,891867,Vaida; Florin,9994,0,9999,5
1746593130395,CLRE 253,B00,907819,Staff,9999,0,9999,0
1746593131422,CLRE 259,A00,891868,Patel; Hemal,9998,0,9999,1
1746593132489,CLRE 260,A00,891872,Cuomo; Raphael Eduardo,9999,0,9999,0
1746593133515,CLRE 297,001,891888,Cuomo; Raphael Eduardo,9999,0,9999,0
1746593134541,CSE 191,A00,958773,Minnes Kemp; Mor Mia,9995,0,9999,4
1746593135566,CSE 197,001,959846,Minnes Kemp; Mor Mia,9990,0,9999,9
1746593136593,CSS 201S,A01,892054,Mignozzetti; Umberto,25,0,30,5
1746593137619,CSS 202S,A01,892056,Mignozzetti; Umberto,25,0,30,5
1746593138645,DSC 197,001,956898,Eldridge; Justin Matthew,9996,0,9999,3
1746593139672,DSC 297,001,958000,Mazumdar; Arya,9998,0,9999,1
1746593139672,DSC 297,002,959862,Wang; Yusu,9998,0,9999,1
1746593140696,EAP 100,A00,905686,Staff,9778,0,9999,221
1746593141722,ECE 45,A01,892618,Staff,0,0,65,65
1746593143776,ECE 111,A01,892719,Staff,6,0,65,59
1746593144805,ECE 197,001,957920,Mercier; Patrick Philip,9991,0,9999,8
1746593145829,ECON 178,A01,907814,Zhu; Ying,26,0,35,9
1746593146855,EDS 115,A00,895312,Staff,35,0,45,10
1746593147881,EDS 117,A01,895337,Staff,23,0,30,7
1746593148907,EDS 125,A00,895341,Jones; Gabrielle Anastasia,36,0,45,9
1746593149932,EDS 128A,A01,895459,Fargason; Sharon Gayle,44,0,45,1
1746593150963,EDS 128B,A01,895543,Pappas; Elizabeth,44,0,45,1
1746593151988,EDS 139,A00,897203,Pappas; Elizabeth,44,0,45,1
1746593151988,EDS 139,B00,897209,Fargason; Sharon Gayle,41,0,45,4
1746593153016,EDS 201,A00,895545,Staff,22,0,45,23
1746593154045,EDS 203,A01,895581,Halter; Christopher P.,22,0,45,23
1746593155073,EDS 204R,A01,895625,Heinzman; Erica M.,39,0,45,6
1746593155073,EDS 204R,B01,895693,Halter; Christopher P.,10,0,45,35
1746593156104,EDS 206R,A00,895694,Fargason; Sharon Gayle,1,0,30,29
1746593156104,EDS 206R,B00,895695,Choi; Bailey Miyeon,16,0,30,14
1746593157129,EDS 250,A00,895697,Hemans; Patricia Ann Benitez,22,0,45,23
1746593158154,EDS 281,A00,895701,Meyerott; Theresa Ann,1,0,15,14
1746593159185,EDS 284,A00,895736,Meyerott; Theresa Ann,1,0,15,14
1746593160209,EDS 286,A00,897210,Fine; Sarah,0,0,15,15
1746593161238,EDS 289C,A01,895770,Daly; Alan J.,1,0,15,14
1746593162264,EDS 290,A00,897211,Hofstetter; Carolyn,0,0,15,15
1746593163290,LIGM 5A,A00,896162,Fischer-Grunski; Eva K,12,0,20,8
1746593164318,LIGM 5B,A00,896260,Fischer-Grunski; Eva K,17,0,20,3
1746593165349,LIGM 5C,A00,896308,Fischer-Grunski; Eva K,18,0,20,2
1746593166376,LIIT 5AS,A00,896313,Carnelos; Chiara,18,0,20,2
1746593167405,LIIT 5BS,A00,896416,Carnelos; Chiara,20,0,20,0
1746593168434,LIIT 5CS,A00,896564,Carnelos; Chiara,20,0,20,0
1746593169465,LISP 5A,A00,896588,Munoz Sanchez; Alicia,2,0,20,18
1746593170495,LISP 5B,A00,896653,Munoz Sanchez; Alicia,7,0,20,13
1746593171526,LISP 5C,A00,896655,Munoz Sanchez; Alicia,0,1,20,20
1746593172553,MAE 197,001,957918,Kleissl; Jan,9996,0,9999,3
1746593172553,MAE 197,002,959806,Boechler; Nicholas Sebastia,9998,0,9999,1
1746593172553,MAE 197,003,959852,Mullin; Jennifer S,9998,0,9999,1
1746593173582,MATH 2,A01,957937,Staff,33,0,35,2
1746593174609,MATH 197,001,957876,Kedlaya; Kiran S.,9993,0,9999,6
1746593175638,MCWP 40,A00,892729,Duru; Nur,10,0,20,10
1746593175638,MCWP 40,B00,893304,Montejo; Carolina,14,0,20,6
1746593176663,MCWP 40R,A00,893757,Redela; Pamela Morgan,0,5,20,20
1746593177687,MCWP 50,A00,893758,Morshed; Michael James,0,0,20,20
1746593177687,MCWP 50,B00,893761,Bartulis; Jason Michael,17,0,20,3
1746593178717,MCWP 50R,A00,893766,Compas; Sean Matthew,0,1,20,20
1746593178717,MCWP 50R,B00,893769,Carter; Jennifer A,0,1,20,20
1746593178717,MCWP 50R,C00,893771,Krone; Jarret,0,3,20,20
1746593178717,MCWP 50R,D00,893772,Miller; Elizabeth Deen,0,0,20,20
1746593178717,MCWP 50R,E00,893775,Carter; Andrea L,0,1,20,20
1746593179747,MMW 11R,A01,892721,Herbst; Matthew,14,0,30,16
1746593179747,MMW 11R,A02,892722,Herbst; Matthew,0,0,0,3
1746593180775,MMW 12R,A01,892724,Herbst; Matthew,0,11,16,16
1746593180775,MMW 12R,A02,892725,Herbst; Matthew,0,10,16,16
1746593181804,MMW 13R,A01,892727,Staff,0,4,16,16
1746593181804,MMW 13R,A02,892728,Staff,0,4,16,16
1746593181804,MMW 13R,A03,958032,Staff,0,4,16,16
1746593181804,MMW 13R,A04,958033,Staff,0,4,16,16
1746593181804,MMW 13R,A05,958034,Staff,0,4,16,16
1746593182832,SIO 295LS,A00,894015,Staff,5,0,25,20
1746593183858,SIO 295S,A00,894020,Staff,5,0,25,20
1746593184883,SIOC 290S,B01,958918,Merrifield; Mark A,14,0,30,16
1746593185910,SIOC 291S,B01,958922,Gabriel; Corey John,14,0,30,16
1746593186936,SOCI 117,A01,895339,Staff,2,0,5,3
1746593187965,WES 237B,A00,894149,Staff,11,0,20,9
1746593190026,AESE 279B,A00,891859,Staff,13,0,35,22
1746593191053,AIP 197,001,891854,Vespa; Emanuel Ignacio,9999,0,9999,0
1746593192079,ANTH 289S,A00,891856,Gagneux; Pascal,12,0,12,0
1746593193106,BENG 196,001,957946,Engler; Adam J.,9996,0,9999,3
1746593194132,BISP 197,001,959851,Wilhelm; James E.,9998,0,9999,1
1746593195160,CAT 124RS,A01,956906,Staff,6,0,25,19
1746593196185,CAT 125RS,A01,922013,Staff,6,0,25,19
1746593197215,CLRE 250,A00,891860,Morris; Sheldon,9995,0,9999,4
1746593199269,CLRE 251R,A00,907817,Mehta; Ravindra L.,9994,0,9999,5
1746593200296,CLRE 252,A00,891864,Cuomo; Raphael Eduardo,9993,0,9999,6
1746593201323,CLRE 253,A00,891867,Vaida; Florin,9994,0,9999,5
1746593201323,CLRE 253,B00,907819,Staff,9999,0,9999,0
1746593202348,CLRE 259,A00,891868,Patel; Hemal,9998,0,9999,1
1746593203375,CLRE 260,A00,891872,Cuomo; Raphael Eduardo,9999,0,9999,0
1746593204401,CLRE 297,001,891888,Cuomo; Raphael Eduardo,9999,0,9999,0
1746593205427,CSE 191,A00,958773,Minnes Kemp; Mor Mia,9995,0,9999,4
1746593206453,CSE 197,001,959846,Minnes Kemp; Mor Mia,9990,0,9999,9
1746593207484,CSS 201S,A01,892054,Mignozzetti; Umberto,25,0,30,5
1746593208515,CSS 202S,A01,892056,Mignozzetti; Umberto,25,0,30,5
1746593209544,DSC 197,001,956898,Eldridge; Justin Matthew,9996,0,9999,3
1746593210570,DSC 297,001,958000,Mazumdar; Arya,9998,0,9999,1
1746593210570,DSC 297,002,959862,Wang; Yusu,9998,0,9999,1
1746593211597,EAP 100,A00,905686,Staff,9778,0,9999,221
1746593212625,ECE 45,A01,892618,Staff,0,0,65,65
1746593214678,ECE 111,A01,892719,Staff,6,0,65,59
1746593215706,ECE 197,001,957920,Mercier; Patrick Philip,9991,0,9999,8
1746593216736,ECON 178,A01,907814,Zhu; Ying,26,0,35,9
1746593217765,EDS 115,A00,895312,Staff,35,0,45,10
1746593218790,EDS 117,A01,895337,Staff,23,0,30,7
1746593219816,EDS 125,A00,895341,Jones; Gabrielle Anastasia,36,0,45,9
1746593220840,EDS 128A,A01,895459,Fargason; Sharon Gayle,44,0,45,1
1746593221866,EDS 128B,A01,895543,Pappas; Elizabeth,44,0,45,1
1746593222894,EDS 139,A00,897203,Pappas; Elizabeth,44,0,45,1
1746593222894,EDS 139,B00,897209,Fargason; Sharon Gayle,41,0,45,4
1746593223920,EDS 201,A00,895545,Staff,22,0,45,23
1746593224948,EDS 203,A01,895581,Halter; Christopher P.,22,0,45,23
1746593225977,EDS 204R,A01,895625,Heinzman; Erica M.,39,0,45,6
1746593225977,EDS 204R,B01,895693,Halter; Christopher P.,10,0,45,35
1746593227003,EDS 206R,A00,895694,Fargason; Sharon Gayle,1,0,30,29
1746593227003,EDS 206R,B00,895695,Choi; Bailey Miyeon,16,0,30,14
1746593228028,EDS 250,A00,895697,Hemans; Patricia Ann Benitez,22,0,45,23
1746593229052,EDS 281,A00,895701,Meyerott; Theresa Ann,1,0,15,14
1746593230079,EDS 284,A00,895736,Meyerott; Theresa Ann,1,0,15,14
1746593231106,EDS 286,A00,897210,Fine; Sarah,0,0,15,15
1746593232134,EDS 289C,A01,895770,Daly; Alan J.,1,0,15,14
1746593233161,EDS 290,A00,897211,Hofstetter; Carolyn,0,0,15,15
1746593234189,LIGM 5A,A00,896162,Fischer-Grunski; Eva K,12,0,20,8
1746593235215,LIGM 5B,A00,896260,Fischer-Grunski; Eva K,17,0,20,3
1746593236239,LIGM 5C,A00,896308,Fischer-Grunski; Eva K,18,0,20,2
1746593237264,LIIT 5AS,A00,896313,Carnelos; Chiara,18,0,20,2
1746593238291,LIIT 5BS,A00,896416,Carnelos; Chiara,20,0,20,0
1746593239320,LIIT 5CS,A00,896564,Carnelos; Chiara,20,0,20,0
1746593240346,LISP 5A,A00,896588,Munoz Sanchez; Alicia,2,0,20,18
1746593241371,LISP 5B,A00,896653,Munoz Sanchez; Alicia,7,0,20,13
1746593242407,LISP 5C,A00,896655,Munoz Sanchez; Alicia,0,1,20,20
1746593243434,MAE 197,001,957918,Kleissl; Jan,9996,0,9999,3
1746593243434,MAE 197,002,959806,Boechler; Nicholas Sebastia,9998,0,9999,1
1746593243434,MAE 197,003,959852,Mullin; Jennifer S,9998,0,9999,1
1746593244460,MATH 2,A01,957937,Staff,33,0,35,2
1746593245488,MATH 197,001,957876,Kedlaya; Kiran S.,9993,0,9999,6
1746593246514,MCWP 40,A00,892729,Duru; Nur,10,0,20,10
1746593246514,MCWP 40,B00,893304,Montejo; Carolina,14,0,20,6
1746593247540,MCWP 40R,A00,893757,Redela; Pamela Morgan,0,5,20,20
1746593248569,MCWP 50,A00,893758,Morshed; Michael James,0,0,20,20
1746593248569,MCWP 50,B00,893761,Bartulis; Jason Michael,17,0,20,3
1746593249595,MCWP 50R,A00,893766,Compas; Sean Matthew,0,1,20,20
1746593249595,MCWP 50R,B00,893769,Carter; Jennifer A,0,1,20,20
1746593249595,MCWP 50R,C00,893771,Krone; Jarret,0,3,20,20
1746593249595,MCWP 50R,D00,893772,Miller; Elizabeth Deen,0,0,20,20
1746593249595,MCWP 50R,E00,893775,Carter; Andrea L,0,1,20,20
1746593250620,MMW 11R,A01,892721,Herbst; Matthew,14,0,30,16
1746593250620,MMW 11R,A02,892722,Herbst; Matthew,0,0,0,3
1746593251648,MMW 12R,A01,892724,Herbst; Matthew,0,11,16,16
1746593251648,MMW 12R,A02,892725,Herbst; Matthew,0,10,16,16
1746593252676,MMW 13R,A01,892727,Staff,0,4,16,16
1746593252676,MMW 13R,A02,892728,Staff,0,4,16,16
1746593252676,MMW 13R,A03,958032,Staff,0,4,16,16
1746593252676,MMW 13R,A04,958033,Staff,0,4,16,16
1746593252676,MMW 13R,A05,958034,Staff,0,4,16,16
1746593253702,SIO 295LS,A00,894015,Staff,5,0,25,20
1746593254729,SIO 295S,A00,894020,Staff,5,0,25,20
1746593255756,SIOC 290S,B01,958918,Merrifield; Mark A,14,0,30,16
1746593256785,SIOC 291S,B01,958922,Gabriel; Corey John,14,0,30,16
1746593257811,SOCI 117,A01,895339,Staff,2,0,5,3
1746593258839,WES 237B,A00,894149,Staff,11,0,20,9
1746593260903,AESE 279B,A00,891859,Staff,13,0,35,22
1746593261930,AIP 197,001,891854,Vespa; Emanuel Ignacio,9999,0,9999,0
1746593262955,ANTH 289S,A00,891856,Gagneux; Pascal,12,0,12,0
1746593263983,BENG 196,001,957946,Engler; Adam J.,9996,0,9999,3
1746593265012,BISP 197,001,959851,Wilhelm; James E.,9998,0,9999,1
1746593266038,CAT 124RS,A01,956906,Staff,6,0,25,19
1746593267064,CAT 125RS,A01,922013,Staff,6,0,25,19
1746593268090,CLRE 250,A00,891860,Morris; Sheldon,9995,0,9999,4
1746593270144,CLRE 251R,A00,907817,Mehta; Ravindra L.,9994,0,9999,5
1746593271171,CLRE 252,A00,891864,Cuomo; Raphael Eduardo,9993,0,9999,6
1746593272198,CLRE 253,A00,891867,Vaida; Florin,9994,0,9999,5
1746593272198,CLRE 253,B00,907819,Staff,9999,0,9999,0
1746593273225,CLRE 259,A00,891868,Patel; Hemal,9998,0,9999,1
1746593274325,CLRE 260,A00,891872,Cuomo; Raphael Eduardo,9999,0,9999,0
1746593275352,CLRE 297,001,891888,Cuomo; Raphael Eduardo,9999,0,9999,0
1746593276377,CSE 191,A00,958773,Minnes Kemp; Mor Mia,9995,0,9999,4
1746593277407,CSE 197,001,959846,Minnes Kemp; Mor Mia,9990,0,9999,9
1746593278435,CSS 201S,A01,892054,Mignozzetti; Umberto,25,0,30,5
1746593279464,CSS 202S,A01,892056,Mignozzetti; Umberto,25,0,30,5
1746593280491,DSC 197,001,956898,Eldridge; Justin Matthew,9996,0,9999,3
1746593281516,DSC 297,001,958000,Mazumdar; Arya,9998,0,9999,1
1746593281516,DSC 297,002,959862,Wang; Yusu,9998,0,9999,1
1746593282541,EAP 100,A00,905686,Staff,9778,0,9999,221
1746593283567,ECE 45,A01,892618,Staff,0,0,65,65
1746593285638,ECE 111,A01,892719,Staff,6,0,65,59
1746593286668,ECE 197,001,957920,Mercier; Patrick Philip,9991,0,9999,8
1746593287692,ECON 178,A01,907814,Zhu; Ying,26,0,35,9
1746593288718,EDS 115,A00,895312,Staff,35,0,45,10
1746593289748,EDS 117,A01,895337,Staff,23,0,30,7
1746593290775,EDS 125,A00,895341,Jones; Gabrielle Anastasia,36,0,45,9
1746593291800,EDS 128A,A01,895459,Fargason; Sharon Gayle,44,0,45,1
1746593292824,EDS 128B,A01,895543,Pappas; Elizabeth,44,0,45,1
1746593293849,EDS 139,A00,897203,Pappas; Elizabeth,44,0,45,1
1746593293849,EDS 139,B00,897209,Fargason; Sharon Gayle,41,0,45,4
1746593294876,EDS 201,A00,895545,Staff,22,0,45,23
1746593295905,EDS 203,A01,895581,Halter; Christopher P.,22,0,45,23
1746593296930,EDS 204R,A01,895625,Heinzman; Erica M.,39,0,45,6
1746593296930,EDS 204R,B01,895693,Halter; Christopher P.,10,0,45,35
1746593297955,EDS 206R,A00,895694,Fargason; Sharon Gayle,1,0,30,29
1746593297955,EDS 206R,B00,895695,Choi; Bailey Miyeon,16,0,30,14
1746593298979,EDS 250,A00,895697,Hemans; Patricia Ann Benitez,22,0,45,23
1746593300006,EDS 281,A00,895701,Meyerott; Theresa Ann,1,0,15,14
1746593301034,EDS 284,A00,895736,Meyerott; Theresa Ann,1,0,15,14
1746593302059,EDS 286,A00,897210,Fine; Sarah,0,0,15,15
1746593303087,EDS 289C,A01,895770,Daly; Alan J.,1,0,15,14
1746593304116,EDS 290,A00,897211,Hofstetter; Carolyn,0,0,15,15
1746593305143,LIGM 5A,A00,896162,Fischer-Grunski; Eva K,12,0,20,8
1746593306168,LIGM 5B,A00,896260,Fischer-Grunski; Eva K,17,0,20,3
1746593307253,LIGM 5C,A00,896308,Fischer-Grunski; Eva K,18,0,20,2
1746593308279,LIIT 5AS,A00,896313,Carnelos; Chiara,18,0,20,2
1746593309306,LIIT 5BS,A00,896416,Carnelos; Chiara,20,0,20,0
1746593310332,LIIT 5CS,A00,896564,Carnelos; Chiara,20,0,20,0
1746593311357,LISP 5A,A00,896588,Munoz Sanchez; Alicia,2,0,20,18
1746593312385,LISP 5B,A00,896653,Munoz Sanchez; Alicia,7,0,20,13
1746593313411,LISP 5C,A00,896655,Munoz Sanchez; Alicia,0,1,20,20
1746593314436,MAE 197,001,957918,Kleissl; Jan,9996,0,9999,3
1746593314436,MAE 197,002,959806,Boechler; Nicholas Sebastia,9998,0,9999,1
1746593314436,MAE 197,003,959852,Mullin; Jennifer S,9998,0,9999,1
1746593315464,MATH 2,A01,957937,Staff,33,0,35,2
1746593316490,MATH 197,001,957876,Kedlaya; Kiran S.,9993,0,9999,6
1746593317518,MCWP 40,A00,892729,Duru; Nur,10,0,20,10
1746593317518,MCWP 40,B00,893304,Montejo; Carolina,14,0,20,6
1746593318544,MCWP 40R,A00,893757,Redela; Pamela Morgan,0,5,20,20
1746593319571,MCWP 50,A00,893758,Morshed; Michael James,0,0,20,20
1746593319571,MCWP 50,B00,893761,Bartulis; Jason Michael,17,0,20,3
1746593320602,MCWP 50R,A00,893766,Compas; Sean Matthew,0,1,20,20
1746593320602,MCWP 50R,B00,893769,Carter; Jennifer A,0,1,20,20
1746593320602,MCWP 50R,C00,893771,Krone; Jarret,0,3,20,20
1746593320602,MCWP 50R,D00,893772,Miller; Elizabeth Deen,0,0,20,20
1746593320602,MCWP 50R,E00,893775,Carter; Andrea L,0,1,20,20
1746593321630,MMW 11R,A01,892721,Herbst; Matthew,14,0,30,16
1746593321630,MMW 11R,A02,892722,Herbst; Matthew,0,0,0,3
1746593322657,MMW 12R,A01,892724,Herbst; Matthew,0,11,16,16
1746593322657,MMW 12R,A02,892725,Herbst; Matthew,0,10,16,16
1746593323682,MMW 13R,A01,892727,Staff,0,4,16,16
1746593323682,MMW 13R,A02,892728,Staff,0,4,16,16
1746593323682,MMW 13R,A03,958032,Staff,0,4,16,16
1746593323682,MMW 13R,A04,958033,Staff,0,4,16,16
1746593323682,MMW 13R,A05,958034,Staff,0,4,16,16
1746593324707,SIO 295LS,A00,894015,Staff,5,0,25,20
1746593325731,SIO 295S,A00,894020,Staff,5,0,25,20
1746593326761,SIOC 290S,B01,958918,Merrifield; Mark A,14,0,30,16
1746593327787,SIOC 291S,B01,958922,Gabriel; Corey John,14,0,30,16
1746593328813,SOCI 117,A01,895339,Staff,2,0,5,3
1746593329838,WES 237B,A00,894149,Staff,11,0,20,9
1746593331906,AESE 279B,A00,891859,Staff,13,0,35,22
1746593332933,AIP 197,001,891854,Vespa; Emanuel Ignacio,9999,0,9999,0
1746593333961,ANTH 289S,A00,891856,Gagneux; Pascal,12,0,12,0
1746593334989,BENG 196,001,957946,Engler; Adam J.,9996,0,9999,3
1746593336016,BISP 197,001,959851,Wilhelm; James E.,9998,0,9999,1
1746593337043,CAT 124RS,A01,956906,Staff,6,0,25,19
1746593338069,CAT 125RS,A01,922013,Staff,6,0,25,19
1746593339096,CLRE 250,A00,891860,Morris; Sheldon,9995,0,9999,4
1746593341150,CLRE 251R,A00,907817,Mehta; Ravindra L.,9994,0,9999,5
1746593342176,CLRE 252,A00,891864,Cuomo; Raphael Eduardo,9993,0,9999,6
1746593343204,CLRE 253,A00,891867,Vaida; Florin,9994,0,9999,5
1746593343204,CLRE 253,B00,907819,Staff,9999,0,9999,0
1746593344228,CLRE 259,A00,891868,Patel; Hemal,9998,0,9999,1
1746593345255,CLRE 260,A00,891872,Cuomo; Raphael Eduardo,9999,0,9999,0
1746593346284,CLRE 297,001,891888,Cuomo; Raphael Eduardo,9999,0,9999,0
1746593347311,CSE 191,A00,958773,Minnes Kemp; Mor Mia,9995,0,9999,4
1746593348339,CSE 197,001,959846,Minnes Kemp; Mor Mia,9990,0,9999,9
1746593349366,CSS 201S,A01,892054,Mignozzetti; Umberto,25,0,30,5
1746593350394,CSS 202S,A01,892056,Mignozzetti; Umberto,25,0,30,5
1746593351419,DSC 197,001,956898,Eldridge; Justin Matthew,9996,0,9999,3
1746593352445,DSC 297,001,958000,Mazumdar; Arya,9998,0,9999,1
1746593352445,DSC 297,002,959862,Wang; Yusu,9998,0,9999,1
1746593353470,EAP 100,A00,905686,Staff,9778,0,9999,221
1746593354497,ECE 45,A01,892618,Staff,0,0,65,65
1746593356552,ECE 111,A01,892719,Staff,6,0,65,59
1746593357576,ECE 197,001,957920,Mercier; Patrick Philip,9991,0,9999,8
1746593358608,ECON 178,A01,907814,Zhu; Ying,26,0,35,9
1746593359632,EDS 115,A00,895312,Staff,35,0,45,10
1746593360658,EDS 117,A01,895337,Staff,23,0,30,7
1746593361684,EDS 125,A00,895341,Jones; Gabrielle Anastasia,36,0,45,9
1746593362713,EDS 128A,A01,895459,Fargason; Sharon Gayle,44,0,45,1
1746593363742,EDS 128B,A01,895543,Pappas; Elizabeth,44,0,45,1
1746593364768,EDS 139,A00,897203,Pappas; Elizabeth,44,0,45,1
1746593364768,EDS 139,B00,897209,Fargason; Sharon Gayle,41,0,45,4
1746593365795,EDS 201,A00,895545,Staff,22,0,45,23
1746593366821,EDS 203,A01,895581,Halter; Christopher P.,22,0,45,23
1746593367846,EDS 204R,A01,895625,Heinzman; Erica M.,39,0,45,6
1746593367846,EDS 204R,B01,895693,Halter; Christopher P.,10,0,45,35
1746593368873,EDS 206R,A00,895694,Fargason; Sharon Gayle,1,0,30,29
1746593368873,EDS 206R,B00,895695,Choi; Bailey Miyeon,16,0,30,14
1746593369898,EDS 250,A00,895697,Hemans; Patricia Ann Benitez,22,0,45,23
1746593370927,EDS 281,A00,895701,Meyerott; Theresa Ann,1,0,15,14
1746593371954,EDS 284,A00,895736,Meyerott; Theresa Ann,1,0,15,14
1746593372980,EDS 286,A00,897210,Fine; Sarah,0,0,15,15
1746593374009,EDS 289C,A01,895770,Daly; Alan J.,1,0,15,14
1746593375038,EDS 290,A00,897211,Hofstetter; Carolyn,0,0,15,15
1746593376066,LIGM 5A,A00,896162,Fischer-Grunski; Eva K,12,0,20,8
1746593377091,LIGM 5B,A00,896260,Fischer-Grunski; Eva K,17,0,20,3
1746593378116,LIGM 5C,A00,896308,Fischer-Grunski; Eva K,18,0,20,2
1746593379142,LIIT 5AS,A00,896313,Carnelos; Chiara,18,0,20,2
1746593380166,LIIT 5BS,A00,896416,Carnelos; Chiara,20,0,20,0
1746593381194,LIIT 5CS,A00,896564,Carnelos; Chiara,20,0,20,0
1746593382221,LISP 5A,A00,896588,Munoz Sanchez; Alicia,2,0,20,18
1746593383249,LISP 5B,A00,896653,Munoz Sanchez; Alicia,7,0,20,13
1746593384277,LISP 5C,A00,896655,Munoz Sanchez; Alicia,0,1,20,20
1746593385303,MAE 197,001,957918,Kleissl; Jan,9996,0,9999,3
1746593385303,MAE 197,002,959806,Boechler; Nicholas Sebastia,9998,0,9999,1
1746593385303,MAE 197,003,959852,Mullin; Jennifer S,9998,0,9999,1
1746593386329,MATH 2,A01,957937,Staff,33,0,35,2
1746593387358,MATH 197,001,957876,Kedlaya; Kiran S.,9993,0,9999,6
1746593388385,MCWP 40,A00,892729,Duru; Nur,10,0,20,10
1746593388385,MCWP 40,B00,893304,Montejo; Carolina,14,0,20,6
1746593389414,MCWP 40R,A00,893757,Redela; Pamela Morgan,0,5,20,20
1746593390441,MCWP 50,A00,893758,Morshed; Michael James,0,0,20,20
1746593390441,MCWP 50,B00,893761,Bartulis; Jason Michael,17,0,20,3
1746593391466,MCWP 50R,A00,893766,Compas; Sean Matthew,0,1,20,20
1746593391466,MCWP 50R,B00,893769,Carter; Jennifer A,0,1,20,20
1746593391466,MCWP 50R,C00,893771,Krone; Jarret,0,3,20,20
1746593391466,MCWP 50R,D00,893772,Miller; Elizabeth Deen,0,0,20,20
1746593391466,MCWP 50R,E00,893775,Carter; Andrea L,0,1,20,20
1746593392494,MMW 11R,A01,892721,Herbst; Matthew,14,0,30,16
1746593392494,MMW 11R,A02,892722,Herbst; Matthew,0,0,0,3
1746593393522,MMW 12R,A01,892724,Herbst; Matthew,0,11,16,16
1746593393522,MMW 12R,A02,892725,Herbst; Matthew,0,10,16,16
1746593394548,MMW 13R,A01,892727,Staff,0,4,16,16
1746593394548,MMW 13R,A02,892728,Staff,0,4,16,16
1746593394548,MMW 13R,A03,958032,Staff,0,4,16,16
1746593394548,MMW 13R,A04,958033,Staff,0,4,16,16
1746593394548,MMW 13R,A05,958034,Staff,0,4,16,16
1746593395577,SIO 295LS,A00,894015,Staff,5,0,25,20
1746593396604,SIO 295S,A00,894020,Staff,5,0,25,20
1746593397631,SIOC 290S,B01,958918,Merrifield; Mark A,14,0,30,16
1746593398661,SIOC 291S,B01,958922,Gabriel; Corey John,14,0,30,16
1746593399687,SOCI 117,A01,895339,Staff,2,0,5,3
1746593400713,WES 237B,A00,894149,Staff,11,0,20,9
1746593402783,AESE 279B,A00,891859,Staff,13,0,35,22
1746593403811,AIP 197,001,891854,Vespa; Emanuel Ignacio,9999,0,9999,0
1746593404837,ANTH 289S,A00,891856,Gagneux; Pascal,12,0,12,0
1746593405866,BENG 196,001,957946,Engler; Adam J.,9996,0,9999,3
1746593406894,BISP 197,001,959851,Wilhelm; James E.,9998,0,9999,1
1746593407922,CAT 124RS,A01,956906,Staff,6,0,25,19
1746593408949,CAT 125RS,A01,922013,Staff,6,0,25,19
1746593409981,CLRE 250,A00,891860,Morris; Sheldon,9995,0,9999,4
1746593412031,CLRE 251R,A00,907817,Mehta; Ravindra L.,9994,0,9999,5
1746593413059,CLRE 252,A00,891864,Cuomo; Raphael Eduardo,9993,0,9999,6
1746593414089,CLRE 253,A00,891867,Vaida; Florin,9994,0,9999,5
1746593414089,CLRE 253,B00,907819,Staff,9999,0,9999,0
1746593415121,CLRE 259,A00,891868,Patel; Hemal,9998,0,9999,1
1746593416149,CLRE 260,A00,891872,Cuomo; Raphael Eduardo,9999,0,9999,0
1746593417174,CLRE 297,001,891888,Cuomo; Raphael Eduardo,9999,0,9999,0
1746593418202,CSE 191,A00,958773,Minnes Kemp; Mor Mia,9995,0,9999,4
1746593419230,CSE 197,001,959846,Minnes Kemp; Mor Mia,9990,0,9999,9
1746593420256,CSS 201S,A01,892054,Mignozzetti; Umberto,25,0,30,5
1746593421283,CSS 202S,A01,892056,Mignozzetti; Umberto,25,0,30,5
1746593422308,DSC 197,001,956898,Eldridge; Justin Matthew,9996,0,9999,3
1746593423335,DSC 297,001,958000,Mazumdar; Arya,9998,0,9999,1
1746593423335,DSC 297,002,959862,Wang; Yusu,9998,0,9999,1
1746593424360,EAP 100,A00,905686,Staff,9778,0,9999,221
1746593425388,ECE 45,A01,892618,Staff,0,0,65,65
1746593427445,ECE 111,A01,892719,Staff,6,0,65,59
1746593428472,ECE 197,001,957920,Mercier; Patrick Philip,9991,0,9999,8
1746593429500,ECON 178,A01,907814,Zhu; Ying,26,0,35,9
1746593430527,EDS 115,A00,895312,Staff,35,0,45,10
1746593431556,EDS 117,A01,895337,Staff,23,0,30,7
1746593432584,EDS 125,A00,895341,Jones; Gabrielle Anastasia,36,0,45,9
1746593433609,EDS 128A,A01,895459,Fargason; Sharon Gayle,44,0,45,1
1746593434635,EDS 128B,A01,895543,Pappas; Elizabeth,44,0,45,1
1746593435662,EDS 139,A00,897203,Pappas; Elizabeth,44,0,45,1
1746593435662,EDS 139,B00,897209,Fargason; Sharon Gayle,41,0,45,4
1746593436686,EDS 201,A00,895545,Staff,22,0,45,23
1746593437711,EDS 203,A01,895581,Halter; Christopher P.,22,0,45,23
1746593438736,EDS 204R,A01,895625,Heinzman; Erica M.,39,0,45,6
1746593438736,EDS 204R,B01,895693,Halter; Christopher P.,10,0,45,35
1746593439765,EDS 206R,A00,895694,Fargason; Sharon Gayle,1,0,30,29
1746593439765,EDS 206R,B00,895695,Choi; Bailey Miyeon,16,0,30,14
1746593440793,EDS 250,A00,895697,Hemans; Patricia Ann Benitez,22,0,45,23
1746593441822,EDS 281,A00,895701,Meyerott; Theresa Ann,1,0,15,14
1746593442848,EDS 284,A00,895736,Meyerott; Theresa Ann,1,0,15,14
1746593443873,EDS 286,A00,897210,Fine; Sarah,0,0,15,15
1746593444899,EDS 289C,A01,895770,Daly; Alan J.,1,0,15,14
1746593445925,EDS 290,A00,897211,Hofstetter; Carolyn,0,0,15,15
1746593446955,LIGM 5A,A00,896162,Fischer-Grunski; Eva K,12,0,20,8
1746593447980,LIGM 5B,A00,896260,Fischer-Grunski; Eva K,17,0,20,3
1746593449007,LIGM 5C,A00,896308,Fischer-Grunski; Eva K,18,0,20,2
1746593450037,LIIT 5AS,A00,896313,Carnelos; Chiara,18,0,20,2
1746593451063,LIIT 5BS,A00,896416,Carnelos; Chiara,20,0,20,0
1746593452089,LIIT 5CS,A00,896564,Carnelos; Chiara,20,0,20,0
1746593453119,LISP 5A,A00,896588,Munoz Sanchez; Alicia,2,0,20,18
1746593454145,LISP 5B,A00,896653,Munoz Sanchez; Alicia,7,0,20,13
1746593455172,LISP 5C,A00,896655,Munoz Sanchez; Alicia,0,1,20,20
1746593456202,MAE 197,001,957918,Kleissl; Jan,9996,0,9999,3
1746593456202,MAE 197,002,959806,Boechler; Nicholas Sebastia,9998,0,9999,1
1746593456202,MAE 197,003,959852,Mullin; Jennifer S,9998,0,9999,1
1746593457229,MATH 2,A01,957937,Staff,33,0,35,2
1746593458253,MATH 197,001,957876,Kedlaya; Kiran S.,9993,0,9999,6
1746593459279,MCWP 40,A00,892729,Duru; Nur,10,0,20,10
1746593459279,MCWP 40,B00,893304,Montejo; Carolina,14,0,20,6
1746593460305,MCWP 40R,A00,893757,Redela; Pamela Morgan,0,5,20,20
1746593461329,MCWP 50,A00,893758,Morshed; Michael James,0,0,20,20
1746593461329,MCWP 50,B00,893761,Bartulis; Jason Michael,17,0,20,3
1746593462364,MCWP 50R,A00,893766,Compas; Sean Matthew,0,1,20,20
1746593462364,MCWP 50R,B00,893769,Carter; Jennifer A,0,1,20,20
1746593462364,MCWP 50R,C00,893771,Krone; Jarret,0,3,20,20
1746593462364,MCWP 50R,D00,893772,Miller; Elizabeth Deen,0,0,20,20
1746593462364,MCWP 50R,E00,893775,Carter; Andrea L,0,1,20,20
1746593463394,MMW 11R,A01,892721,Herbst; Matthew,14,0,30,16
1746593463394,MMW 11R,A02,892722,Herbst; Matthew,0,0,0,3
1746593464418,MMW 12R,A01,892724,Herbst; Matthew,0,11,16,16
1746593464418,MMW 12R,A02,892725,Herbst; Matthew,0,10,16,16
1746593465447,MMW 13R,A01,892727,Staff,0,4,16,16
1746593465447,MMW 13R,A02,892728,Staff,0,4,16,16
1746593465447,MMW 13R,A03,958032,Staff,0,4,16,16
1746593465447,MMW 13R,A04,958033,Staff,0,4,16,16
1746593465447,MMW 13R,A05,958034,Staff,0,4,16,16
1746593466475,SIO 295LS,A00,894015,Staff,5,0,25,20
1746593467503,SIO 295S,A00,894020,Staff,5,0,25,20
1746593468532,SIOC 290S,B01,958918,Merrifield; Mark A,14,0,30,16
1746593469559,SIOC 291S,B01,958922,Gabriel; Corey John,14,0,30,16
1746593470591,SOCI 117,A01,895339,Staff,2,0,5,3
1746593471620,WES 237B,A00,894149,Staff,11,0,20,9
1746593473686,AESE 279B,A00,891859,Staff,13,0,35,22
1746593474710,AIP 197,001,891854,Vespa; Emanuel Ignacio,9999,0,9999,0
1746593475740,ANTH 289S,A00,891856,Gagneux; Pascal,12,0,12,0
1746593476768,BENG 196,001,957946,Engler; Adam J.,9996,0,9999,3
1746593477792,BISP 197,001,959851,Wilhelm; James E.,9998,0,9999,1
1746593478822,CAT 124RS,A01,956906,Staff,6,0,25,19
1746593479848,CAT 125RS,A01,922013,Staff,6,0,25,19
1746593480878,CLRE 250,A00,891860,Morris; Sheldon,9995,0,9999,4
1746593482932,CLRE 251R,A00,907817,Mehta; Ravindra L.,9994,0,9999,5
1746593483961,CLRE 252,A00,891864,Cuomo; Raphael Eduardo,9993,0,9999,6
1746593484987,CLRE 253,A00,891867,Vaida; Florin,9994,0,9999,5
1746593484987,CLRE 253,B00,907819,Staff,9999,0,9999,0
1746593486011,CLRE 259,A00,891868,Patel; Hemal,9998,0,9999,1
1746593487039,CLRE 260,A00,891872,Cuomo; Raphael Eduardo,9999,0,9999,0
1746593488067,CLRE 297,001,891888,Cuomo; Raphael Eduardo,9999,0,9999,0
1746593489092,CSE 191,A00,958773,Minnes Kemp; Mor Mia,9995,0,9999,4
1746593490120,CSE 197,001,959846,Minnes Kemp; Mor Mia,9990,0,9999,9
1746593491149,CSS 201S,A01,892054,Mignozzetti; Umberto,25,0,30,5
1746593492175,CSS 202S,A01,892056,Mignozzetti; Umberto,25,0,30,5
1746593493204,DSC 197,001,956898,Eldridge; Justin Matthew,9996,0,9999,3
1746593494230,DSC 297,001,958000,Mazumdar; Arya,9998,0,9999,1
1746593494230,DSC 297,002,959862,Wang; Yusu,9998,0,9999,1
1746593495259,EAP 100,A00,905686,Staff,9778,0,9999,221
1746593496286,ECE 45,A01,892618,Staff,0,0,65,65
1746593498338,ECE 111,A01,892719,Staff,6,0,65,59
1746593499367,ECE 197,001,957920,Mercier; Patrick Philip,9991,0,9999,8
1746593500396,ECON 178,A01,907814,Zhu; Ying,26,0,35,9
1746593501426,EDS 115,A00,895312,Staff,35,0,45,10
1746593502452,EDS 117,A01,895337,Staff,23,0,30,7
1746593503482,EDS 125,A00,895341,Jones; Gabrielle Anastasia,36,0,45,9
1746593504509,EDS 128A,A01,895459,Fargason; Sharon Gayle,44,0,45,1
1746593505538,EDS 128B,A01,895543,Pappas; Elizabeth,44,0,45,1
1746593506566,EDS 139,A00,897203,Pappas; Elizabeth,44,0,45,1
1746593506566,EDS 139,B00,897209,Fargason; Sharon Gayle,41,0,45,4
1746593507592,EDS 201,A00,895545,Staff,22,0,45,23
1746593508618,EDS 203,A01,895581,Halter; Christopher P.,22,0,45,23
1746593509650,EDS 204R,A01,895625,Heinzman; Erica M.,39,0,45,6
1746593509650,EDS 204R,B01,895693,Halter; Christopher P.,10,0,45,35
1746593510674,EDS 206R,A00,895694,Fargason; Sharon Gayle,1,0,30,29
1746593510674,EDS 206R,B00,895695,Choi; Bailey Miyeon,16,0,30,14
1746593511698,EDS 250,A00,895697,Hemans; Patricia Ann Benitez,22,0,45,23
1746593512727,EDS 281,A00,895701,Meyerott; Theresa Ann,1,0,15,14
1746593513753,EDS 284,A00,895736,Meyerott; Theresa Ann,1,0,15,14
1746593514780,EDS 286,A00,897210,Fine; Sarah,0,0,15,15
1746593515809,EDS 289C,A01,895770,Daly; Alan J.,1,0,15,14
1746593516835,EDS 290,A00,897211,Hofstetter; Carolyn,0,0,15,15
1746593517861,LIGM 5A,A00,896162,Fischer-Grunski; Eva K,12,0,20,8
1746593518892,LIGM 5B,A00,896260,Fischer-Grunski; Eva K,17,0,20,3
1746593519918,LIGM 5C,A00,896308,Fischer-Grunski; Eva K,18,0,20,2
1746593520943,LIIT 5AS,A00,896313,Carnelos; Chiara,18,0,20,2
1746593521969,LIIT 5BS,A00,896416,Carnelos; Chiara,20,0,20,0
1746593522997,LIIT 5CS,A00,896564,Carnelos; Chiara,20,0,20,0
1746593524025,LISP 5A,A00,896588,Munoz Sanchez; Alicia,2,0,20,18
1746593525056,LISP 5B,A00,896653,Munoz Sanchez; Alicia,7,0,20,13
1746593526085,LISP 5C,A00,896655,Munoz Sanchez; Alicia,0,1,20,20
1746593527111,MAE 197,001,957918,Kleissl; Jan,9996,0,9999,3
1746593527111,MAE 197,002,959806,Boechler; Nicholas Sebastia,9998,0,9999,1
1746593527111,MAE 197,003,959852,Mullin; Jennifer S,9998,0,9999,1
1746593528137,MATH 2,A01,957937,Staff,33,0,35,2
1746593529162,MATH 197,001,957876,Kedlaya; Kiran S.,9993,0,9999,6
1746593530192,MCWP 40,A00,892729,Duru; Nur,10,0,20,10
1746593530192,MCWP 40,B00,893304,Montejo; Carolina,14,0,20,6
1746593531221,MCWP 40R,A00,893757,Redela; Pamela Morgan,0,5,20,20
1746593532245,MCWP 50,A00,893758,Morshed; Michael James,0,0,20,20
1746593532245,MCWP 50,B00,893761,Bartulis; Jason Michael,17,0,20,3
1746593533270,MCWP 50R,A00,893766,Compas; Sean Matthew,0,1,20,20
1746593533270,MCWP 50R,B00,893769,Carter; Jennifer A,0,1,20,20
1746593533270,MCWP 50R,C00,893771,Krone; Jarret,0,3,20,20
1746593533270,MCWP 50R,D00,893772,Miller; Elizabeth Deen,0,0,20,20
1746593533270,MCWP 50R,E00,893775,Carter; Andrea L,0,1,20,20
1746593534297,MMW 11R,A01,892721,Herbst; Matthew,14,0,30,16
1746593534297,MMW 11R,A02,892722,Herbst; Matthew,0,0,0,3
1746593535324,MMW 12R,A01,892724,Herbst; Matthew,0,11,16,16
1746593535324,MMW 12R,A02,892725,Herbst; Matthew,0,10,16,16
1746593536354,MMW 13R,A01,892727,Staff,0,4,16,16
1746593536354,MMW 13R,A02,892728,Staff,0,4,16,16
1746593536354,MMW 13R,A03,958032,Staff,0,4,16,16
1746593536354,MMW 13R,A04,958033,Staff,0,4,16,16
1746593536354,MMW 13R,A05,958034,Staff,0,4,16,16
1746593537380,SIO 295LS,A00,894015,Staff,5,0,25,20
1746593538406,SIO 295S,A00,894020,Staff,5,0,25,20
1746593539434,SIOC 290S,B01,958918,Merrifield; Mark A,14,0,30,16
1746593540467,SIOC 291S,B01,958922,Gabriel; Corey John,14,0,30,16
1746593541492,SOCI 117,A01,895339,Staff,2,0,5,3
1746593542520,WES 237B,A00,894149,Staff,11,0,20,9
1746593544582,AESE 279B,A00,891859,Staff,13,0,35,22
1746593545607,AIP 197,001,891854,Vespa; Emanuel Ignacio,9999,0,9999,0
1746593546634,ANTH 289S,A00,891856,Gagneux; Pascal,12,0,12,0
1746593547663,BENG 196,001,957946,Engler; Adam J.,9996,0,9999,3
1746593548691,BISP 197,001,959851,Wilhelm; James E.,9998,0,9999,1
1746593549718,CAT 124RS,A01,956906,Staff,6,0,25,19
1746593550743,CAT 125RS,A01,922013,Staff,6,0,25,19
1746593551768,CLRE 250,A00,891860,Morris; Sheldon,9995,0,9999,4
1746593553822,CLRE 251R,A00,907817,Mehta; Ravindra L.,9994,0,9999,5
1746593554851,CLRE 252,A00,891864,Cuomo; Raphael Eduardo,9993,0,9999,6
1746593555878,CLRE 253,A00,891867,Vaida; Florin,9994,0,9999,5
1746593555878,CLRE 253,B00,907819,Staff,9999,0,9999,0
1746593556904,CLRE 259,A00,891868,Patel; Hemal,9998,0,9999,1
1746593557931,CLRE 260,A00,891872,Cuomo; Raphael Eduardo,9999,0,9999,0
1746593558959,CLRE 297,001,891888,Cuomo; Raphael Eduardo,9999,0,9999,0
1746593559989,CSE 191,A00,958773,Minnes Kemp; Mor Mia,9995,0,9999,4
1746593561014,CSE 197,001,959846,Minnes Kemp; Mor Mia,9990,0,9999,9
1746593562045,CSS 201S,A01,892054,Mignozzetti; Umberto,25,0,30,5
1746593563071,CSS 202S,A01,892056,Mignozzetti; Umberto,25,0,30,5
1746593564096,DSC 197,001,956898,Eldridge; Justin Matthew,9996,0,9999,3
1746593565123,DSC 297,001,958000,Mazumdar; Arya,9998,0,9999,1
1746593565123,DSC 297,002,959862,Wang; Yusu,9998,0,9999,1
1746593566153,EAP 100,A00,905686,Staff,9778,0,9999,221
1746593567179,ECE 45,A01,892618,Staff,0,0,65,65
1746593569230,ECE 111,A01,892719,Staff,6,0,65,59
1746593570256,ECE 197,001,957920,Mercier; Patrick Philip,9991,0,9999,8
1746593571284,ECON 178,A01,907814,Zhu; Ying,26,0,35,9
1746593572308,EDS 115,A00,895312,Staff,35,0,45,10
1746593573334,EDS 117,A01,895337,Staff,23,0,30,7
1746593574362,EDS 125,A00,895341,Jones; Gabrielle Anastasia,36,0,45,9
1746593575387,EDS 128A,A01,895459,Fargason; Sharon Gayle,44,0,45,1
1746593576414,EDS 128B,A01,895543,Pappas; Elizabeth,44,0,45,1
1746593577443,EDS 139,A00,897203,Pappas; Elizabeth,44,0,45,1
1746593577443,EDS 139,B00,897209,Fargason; Sharon Gayle,41,0,45,4
1746593578467,EDS 201,A00,895545,Staff,22,0,45,23
1746593579497,EDS 203,A01,895581,Halter; Christopher P.,22,0,45,23
1746593580523,EDS 204R,A01,895625,Heinzman; Erica M.,39,0,45,6
1746593580523,EDS 204R,B01,895693,Halter; Christopher P.,10,0,45,35
1746593581548,EDS 206R,A00,895694,Fargason; Sharon Gayle,1,0,30,29
1746593581548,EDS 206R,B00,895695,Choi; Bailey Miyeon,16,0,30,14
1746593582574,EDS 250,A00,895697,Hemans; Patricia Ann Benitez,22,0,45,23
1746593583598,EDS 281,A00,895701,Meyerott; Theresa Ann,1,0,15,14
1746593584626,EDS 284,A00,895736,Meyerott; Theresa Ann,1,0,15,14
1746593585652,EDS 286,A00,897210,Fine; Sarah,0,0,15,15
1746593586677,EDS 289C,A01,895770,Daly; Alan J.,1,0,15,14
1746593587702,EDS 290,A00,897211,Hofstetter; Carolyn,0,0,15,15
1746593588726,LIGM 5A,A00,896162,Fischer-Grunski; Eva K,12,0,20,8
1746593589754,LIGM 5B,A00,896260,Fischer-Grunski; Eva K,17,0,20,3
1746593590779,LIGM 5C,A00,896308,Fischer-Grunski; Eva K,18,0,20,2
1746593591804,LIIT 5AS,A00,896313,Carnelos; Chiara,18,0,20,2
1746593592834,LIIT 5BS,A00,896416,Carnelos; Chiara,20,0,20,0
1746593593864,LIIT 5CS,A00,896564,Carnelos; Chiara,20,0,20,0
1746593594892,LISP 5A,A00,896588,Munoz Sanchez; Alicia,2,0,20,18
1746593595923,LISP 5B,A00,896653,Munoz Sanchez; Alicia,7,0,20,13
1746593596951,LISP 5C,A00,896655,Munoz Sanchez; Alicia,0,1,20,20
1746593597978,MAE 197,001,957918,Kleissl; Jan,9996,0,9999,3
1746593597978,MAE 197,002,959806,Boechler; Nicholas Sebastia,9998,0,9999,1
1746593597978,MAE 197,003,959852,Mullin; Jennifer S,9998,0,9999,1
1746593599003,MATH 2,A01,957937,Staff,33,0,35,2
1746593600033,MATH 197,001,957876,Kedlaya; Kiran S.,9993,0,9999,6
1746593601062,MCWP 40,A00,892729,Duru; Nur,10,0,20,10
1746593601062,MCWP 40,B00,893304,Montejo; Carolina,14,0,20,6
1746593602088,MCWP 40R,A00,893757,Redela; Pamela Morgan,0,5,20,20
1746593603118,MCWP 50,A00,893758,Morshed; Michael James,0,0,20,20
1746593603118,MCWP 50,B00,893761,Bartulis; Jason Michael,17,0,20,3
1746593604149,MCWP 50R,A00,893766,Compas; Sean Matthew,0,1,20,20
1746593604149,MCWP 50R,B00,893769,Carter; Jennifer A,0,1,20,20
1746593604149,MCWP 50R,C00,893771,Krone; Jarret,0,3,20,20
1746593604149,MCWP 50R,D00,893772,Miller; Elizabeth Deen,0,0,20,20
1746593604149,MCWP 50R,E00,893775,Carter; Andrea L,0,1,20,20
1746593605177,MMW 11R,A01,892721,Herbst; Matthew,14,0,30,16
1746593605177,MMW 11R,A02,892722,Herbst; Matthew,0,0,0,3
1746593606207,MMW 12R,A01,892724,Herbst; Matthew,0,11,16,16
1746593606207,MMW 12R,A02,892725,Herbst; Matthew,0,10,16,16
1746593607233,MMW 13R,A01,892727,Staff,0,4,16,16
1746593607233,MMW 13R,A02,892728,Staff,0,4,16,16
1746593607233,MMW 13R,A03,958032,Staff,0,4,16,16
1746593607233,MMW 13R,A04,958033,Staff,0,4,16,16
1746593607233,MMW 13R,A05,958034,Staff,0,4,16,16
1746593608262,SIO 295LS,A00,894015,Staff,5,0,25,20
1746593609290,SIO 295S,A00,894020,Staff,5,0,25,20
1746593610316,SIOC 290S,B01,958918,Merrifield; Mark A,14,0,30,16
1746593611346,SIOC 291S,B01,958922,Gabriel; Corey John,14,0,30,16
1746593612373,SOCI 117,A01,895339,Staff,2,0,5,3
1746593613398,WES 237B,A00,894149,Staff,11,0,20,9
1746593615465,AESE 279B,A00,891859,Staff,13,0,35,22
1746593616492,AIP 197,001,891854,Vespa; Emanuel Ignacio,9999,0,9999,0
1746593617525,ANTH 289S,A00,891856,Gagneux; Pascal,12,0,12,0
1746593618554,BENG 196,001,957946,Engler; Adam J.,9996,0,9999,3
1746593619582,BISP 197,001,959851,Wilhelm; James E.,9998,0,9999,1
1746593620611,CAT 124RS,A01,956906,Staff,6,0,25,19
1746593621636,CAT 125RS,A01,922013,Staff,6,0,25,19
1746593622662,CLRE 250,A00,891860,Morris; Sheldon,9995,0,9999,4
1746593624713,CLRE 251R,A00,907817,Mehta; Ravindra L.,9994,0,9999,5
1746593625737,CLRE 252,A00,891864,Cuomo; Raphael Eduardo,9993,0,9999,6
1746593626765,CLRE 253,A00,891867,Vaida; Florin,9994,0,9999,5
1746593626765,CLRE 253,B00,907819,Staff,9999,0,9999,0
1746593627794,CLRE 259,A00,891868,Patel; Hemal,9998,0,9999,1
1746593628820,CLRE 260,A00,891872,Cuomo; Raphael Eduardo,9999,0,9999,0
1746593629847,CLRE 297,001,891888,Cuomo; Raphael Eduardo,9999,0,9999,0
1746593630875,CSE 191,A00,958773,Minnes Kemp; Mor Mia,9995,0,9999,4
1746593631903,CSE 197,001,959846,Minnes Kemp; Mor Mia,9990,0,9999,9
1746593632932,CSS 201S,A01,892054,Mignozzetti; Umberto,25,0,30,5
1746593633959,CSS 202S,A01,892056,Mignozzetti; Umberto,25,0,30,5
1746593634993,DSC 197,001,956898,Eldridge; Justin Matthew,9996,0,9999,3
1746593636019,DSC 297,001,958000,Mazumdar; Arya,9998,0,9999,1
1746593636019,DSC 297,002,959862,Wang; Yusu,9998,0,9999,1
1746593637049,EAP 100,A00,905686,Staff,9778,0,9999,221
1746593638076,ECE 45,A01,892618,Staff,0,0,65,65
1746593640129,ECE 111,A01,892719,Staff,6,0,65,59
1746593641154,ECE 197,001,957920,Mercier; Patrick Philip,9991,0,9999,8
1746593642184,ECON 178,A01,907814,Zhu; Ying,26,0,35,9
1746593643210,EDS 115,A00,895312,Staff,35,0,45,10
1746593644234,EDS 117,A01,895337,Staff,23,0,30,7
1746593645260,EDS 125,A00,895341,Jones; Gabrielle Anastasia,36,0,45,9
1746593646328,EDS 128A,A01,895459,Fargason; Sharon Gayle,44,0,45,1
1746593647356,EDS 128B,A01,895543,Pappas; Elizabeth,44,0,45,1
1746593648380,EDS 139,A00,897203,Pappas; Elizabeth,44,0,45,1
1746593648380,EDS 139,B00,897209,Fargason; Sharon Gayle,41,0,45,4
1746593649406,EDS 201,A00,895545,Staff,22,0,45,23
1746593650433,EDS 203,A01,895581,Halter; Christopher P.,22,0,45,23
1746593651459,EDS 204R,A01,895625,Heinzman; Erica M.,39,0,45,6
1746593651459,EDS 204R,B01,895693,Halter; Christopher P.,10,0,45,35
1746593652485,EDS 206R,A00,895694,Fargason; Sharon Gayle,1,0,30,29
1746593652485,EDS 206R,B00,895695,Choi; Bailey Miyeon,16,0,30,14
1746593653512,EDS 250,A00,895697,Hemans; Patricia Ann Benitez,22,0,45,23
1746593654539,EDS 281,A00,895701,Meyerott; Theresa Ann,1,0,15,14
1746593655568,EDS 284,A00,895736,Meyerott; Theresa Ann,1,0,15,14
1746593656593,EDS 286,A00,897210,Fine; Sarah,0,0,15,15
1746593657618,EDS 289C,A01,895770,Daly; Alan J.,1,0,15,14
1746593658642,EDS 290,A00,897211,Hofstetter; Carolyn,0,0,15,15
1746593659667,LIGM 5A,A00,896162,Fischer-Grunski; Eva K,12,0,20,8
1746593660697,LIGM 5B,A00,896260,Fischer-Grunski; Eva K,17,0,20,3
1746593661722,LIGM 5C,A00,896308,Fischer-Grunski; Eva K,18,0,20,2
1746593662748,LIIT 5AS,A00,896313,Carnelos; Chiara,18,0,20,2
1746593663775,LIIT 5BS,A00,896416,Carnelos; Chiara,20,0,20,0
1746593664800,LIIT 5CS,A00,896564,Carnelos; Chiara,20,0,20,0
1746593665825,LISP 5A,A00,896588,Munoz Sanchez; Alicia,2,0,20,18
1746593666854,LISP 5B,A00,896653,Munoz Sanchez; Alicia,7,0,20,13
1746593667884,LISP 5C,A00,896655,Munoz Sanchez; Alicia,0,1,20,20
1746593668909,MAE 197,001,957918,Kleissl; Jan,9996,0,9999,3
1746593668909,MAE 197,002,959806,Boechler; Nicholas Sebastia,9998,0,9999,1
1746593668909,MAE 197,003,959852,Mullin; Jennifer S,9998,0,9999,1
1746593669936,MATH 2,A01,957937,Staff,33,0,35,2
1746593670966,MATH 197,001,957876,Kedlaya; Kiran S.,9993,0,9999,6
1746593671995,MCWP 40,A00,892729,Duru; Nur,10,0,20,10
1746593671995,MCWP 40,B00,893304,Montejo; Carolina,14,0,20,6
1746593673022,MCWP 40R,A00,893757,Redela; Pamela Morgan,0,5,20,20
1746593674051,MCWP 50,A00,893758,Morshed; Michael James,0,0,20,20
1746593674051,MCWP 50,B00,893761,Bartulis; Jason Michael,17,0,20,3
1746593675081,MCWP 50R,A00,893766,Compas; Sean Matthew,0,1,20,20
1746593675081,MCWP 50R,B00,893769,Carter; Jennifer A,0,1,20,20
1746593675081,MCWP 50R,C00,893771,Krone; Jarret,0,3,20,20
1746593675081,MCWP 50R,D00,893772,Miller; Elizabeth Deen,0,0,20,20
1746593675081,MCWP 50R,E00,893775,Carter; Andrea L,0,1,20,20
1746593676110,MMW 11R,A01,892721,Herbst; Matthew,14,0,30,16
1746593676110,MMW 11R,A02,892722,Herbst; Matthew,0,0,0,3
1746593677140,MMW 12R,A01,892724,Herbst; Matthew,0,11,16,16
1746593677140,MMW 12R,A02,892725,Herbst; Matthew,0,10,16,16
1746593678170,MMW 13R,A01,892727,Staff,0,4,16,16
1746593678170,MMW 13R,A02,892728,Staff,0,4,16,16
1746593678170,MMW 13R,A03,958032,Staff,0,4,16,16
1746593678170,MMW 13R,A04,958033,Staff,0,4,16,16
1746593678170,MMW 13R,A05,958034,Staff,0,4,16,16
1746593679197,SIO 295LS,A00,894015,Staff,5,0,25,20
1746593680223,SIO 295S,A00,894020,Staff,5,0,25,20
1746593681250,SIOC 290S,B01,958918,Merrifield; Mark A,14,0,30,16
1746593682281,SIOC 291S,B01,958922,Gabriel; Corey John,14,0,30,16
1746593683305,SOCI 117,A01,895339,Staff,2,0,5,3
1746593684332,WES 237B,A00,894149,Staff,11,0,20,9
1746593686401,AESE 279B,A00,891859,Staff,13,0,35,22
1746593687426,AIP 197,001,891854,Vespa; Emanuel Ignacio,9999,0,9999,0
1746593688452,ANTH 289S,A00,891856,Gagneux; Pascal,12,0,12,0
1746593689478,BENG 196,001,957946,Engler; Adam J.,9996,0,9999,3
1746593690504,BISP 197,001,959851,Wilhelm; James E.,9998,0,9999,1
1746593691528,CAT 124RS,A01,956906,Staff,6,0,25,19
1746593692552,CAT 125RS,A01,922013,Staff,6,0,25,19
1746593693578,CLRE 250,A00,891860,Morris; Sheldon,9995,0,9999,4
1746593695635,CLRE 251R,A00,907817,Mehta; Ravindra L.,9994,0,9999,5
1746593696662,CLRE 252,A00,891864,Cuomo; Raphael Eduardo,9993,0,9999,6
1746593697688,CLRE 253,A00,891867,Vaida; Florin,9994,0,9999,5
1746593697688,CLRE 253,B00,907819,Staff,9999,0,9999,0
1746593698719,CLRE 259,A00,891868,Patel; Hemal,9998,0,9999,1
1746593699748,CLRE 260,A00,891872,Cuomo; Raphael Eduardo,9999,0,9999,0
1746593700773,CLRE 297,001,891888,Cuomo; Raphael Eduardo,9999,0,9999,0
1746593701799,CSE 191,A00,958773,Minnes Kemp; Mor Mia,9995,0,9999,4
1746593702827,CSE 197,001,959846,Minnes Kemp; Mor Mia,9990,0,9999,9
1746593703858,CSS 201S,A01,892054,Mignozzetti; Umberto,25,0,30,5
1746593704883,CSS 202S,A01,892056,Mignozzetti; Umberto,25,0,30,5
1746593705912,DSC 197,001,956898,Eldridge; Justin Matthew,9996,0,9999,3
1746593706940,DSC 297,001,958000,Mazumdar; Arya,9998,0,9999,1
1746593706940,DSC 297,002,959862,Wang; Yusu,9998,0,9999,1
1746593707968,EAP 100,A00,905686,Staff,9778,0,9999,221
1746593708993,ECE 45,A01,892618,Staff,0,0,65,65
1746593711046,ECE 111,A01,892719,Staff,6,0,65,59
1746593712071,ECE 197,001,957920,Mercier; Patrick Philip,9991,0,9999,8
1746593713100,ECON 178,A01,907814,Zhu; Ying,26,0,35,9
1746593714125,EDS 115,A00,895312,Staff,35,0,45,10
1746593715153,EDS 117,A01,895337,Staff,23,0,30,7
1746593716179,EDS 125,A00,895341,Jones; Gabrielle Anastasia,36,0,45,9
1746593717208,EDS 128A,A01,895459,Fargason; Sharon Gayle,44,0,45,1
1746593718233,EDS 128B,A01,895543,Pappas; Elizabeth,44,0,45,1
1746593719258,EDS 139,A00,897203,Pappas; Elizabeth,44,0,45,1
1746593719258,EDS 139,B00,897209,Fargason; Sharon Gayle,41,0,45,4
1746593720288,EDS 201,A00,895545,Staff,22,0,45,23
1746593721317,EDS 203,A01,895581,Halter; Christopher P.,22,0,45,23
1746593722342,EDS 204R,A01,895625,Heinzman; Erica M.,39,0,45,6
1746593722342,EDS 204R,B01,895693,Halter; Christopher P.,10,0,45,35
1746593723371,EDS 206R,A00,895694,Fargason; Sharon Gayle,1,0,30,29
1746593723371,EDS 206R,B00,895695,Choi; Bailey Miyeon,16,0,30,14
1746593724399,EDS 250,A00,895697,Hemans; Patricia Ann Benitez,22,0,45,23
1746593725424,EDS 281,A00,895701,Meyerott; Theresa Ann,1,0,15,14
1746593726449,EDS 284,A00,895736,Meyerott; Theresa Ann,1,0,15,14
1746593727477,EDS 286,A00,897210,Fine; Sarah,0,0,15,15
1746593728506,EDS 289C,A01,895770,Daly; Alan J.,1,0,15,14
1746593729534,EDS 290,A00,897211,Hofstetter; Carolyn,0,0,15,15
1746593730564,LIGM 5A,A00,896162,Fischer-Grunski; Eva K,12,0,20,8
1746593731589,LIGM 5B,A00,896260,Fischer-Grunski; Eva K,17,0,20,3
1746593732615,LIGM 5C,A00,896308,Fischer-Grunski; Eva K,18,0,20,2
1746593733643,LIIT 5AS,A00,896313,Carnelos; Chiara,18,0,20,2
1746593734670,LIIT 5BS,A00,896416,Carnelos; Chiara,20,0,20,0
1746593735694,LIIT 5CS,A00,896564,Carnelos; Chiara,20,0,20,0
1746593736719,LISP 5A,A00,896588,Munoz Sanchez; Alicia,2,0,20,18
1746593737744,LISP 5B,A00,896653,Munoz Sanchez; Alicia,7,0,20,13
1746593738772,LISP 5C,A00,896655,Munoz Sanchez; Alicia,0,1,20,20
1746593739798,MAE 197,001,957918,Kleissl; Jan,9996,0,9999,3
1746593739798,MAE 197,002,959806,Boechler; Nicholas Sebastia,9998,0,9999,1
1746593739798,MAE 197,003,959852,Mullin; Jennifer S,9998,0,9999,1
1746593740824,MATH 2,A01,957937,Staff,33,0,35,2
1746593741848,MATH 197,001,957876,Kedlaya; Kiran S.,9993,0,9999,6
1746593742876,MCWP 40,A00,892729,Duru; Nur,10,0,20,10
1746593742876,MCWP 40,B00,893304,Montejo; Carolina,14,0,20,6
1746593743902,MCWP 40R,A00,893757,Redela; Pamela Morgan,0,5,20,20
1746593744930,MCWP 50,A00,893758,Morshed; Michael James,0,0,20,20
1746593744930,MCWP 50,B00,893761,Bartulis; Jason Michael,17,0,20,3
1746593745961,MCWP 50R,A00,893766,Compas; Sean Matthew,0,1,20,20
1746593745961,MCWP 50R,B00,893769,Carter; Jennifer A,0,1,20,20
1746593745961,MCWP 50R,C00,893771,Krone; Jarret,0,3,20,20
1746593745961,MCWP 50R,D00,893772,Miller; Elizabeth Deen,0,0,20,20
1746593745961,MCWP 50R,E00,893775,Carter; Andrea L,0,1,20,20
1746593746987,MMW 11R,A01,892721,Herbst; Matthew,14,0,30,16
1746593746987,MMW 11R,A02,892722,Herbst; Matthew,0,0,0,3
1746593748013,MMW 12R,A01,892724,Herbst; Matthew,0,11,16,16
1746593748013,MMW 12R,A02,892725,Herbst; Matthew,0,10,16,16
1746593749040,MMW 13R,A01,892727,Staff,0,4,16,16
1746593749040,MMW 13R,A02,892728,Staff,0,4,16,16
1746593749040,MMW 13R,A03,958032,Staff,0,4,16,16
1746593749040,MMW 13R,A04,958033,Staff,0,4,16,16
1746593749040,MMW 13R,A05,958034,Staff,0,4,16,16
1746593750104,SIO 295LS,A00,894015,Staff,5,0,25,20
1746593751131,SIO 295S,A00,894020,Staff,5,0,25,20
1746593752160,SIOC 290S,B01,958918,Merrifield; Mark A,14,0,30,16
1746593753187,SIOC 291S,B01,958922,Gabriel; Corey John,14,0,30,16
1746593754212,SOCI 117,A01,895339,Staff,2,0,5,3
1746593755239,WES 237B,A00,894149,Staff,11,0,20,9
1746593757300,AESE 279B,A00,891859,Staff,13,0,35,22
1746593758329,AIP 197,001,891854,Vespa; Emanuel Ignacio,9999,0,9999,0
1746593759356,ANTH 289S,A00,891856,Gagneux; Pascal,12,0,12,0
1746593760380,BENG 196,001,957946,Engler; Adam J.,9996,0,9999,3
1746593761408,BISP 197,001,959851,Wilhelm; James E.,9998,0,9999,1
1746593762433,CAT 124RS,A01,956906,Staff,6,0,25,19
1746593763458,CAT 125RS,A01,922013,Staff,6,0,25,19
1746593764482,CLRE 250,A00,891860,Morris; Sheldon,9995,0,9999,4
1746593766539,CLRE 251R,A00,907817,Mehta; Ravindra L.,9994,0,9999,5
1746593767567,CLRE 252,A00,891864,Cuomo; Raphael Eduardo,9993,0,9999,6
1746593768594,CLRE 253,A00,891867,Vaida; Florin,9994,0,9999,5
1746593768594,CLRE 253,B00,907819,Staff,9999,0,9999,0
1746593769618,CLRE 259,A00,891868,Patel; Hemal,9998,0,9999,1
1746593770643,CLRE 260,A00,891872,Cuomo; Raphael Eduardo,9999,0,9999,0
1746593771672,CLRE 297,001,891888,Cuomo; Raphael Eduardo,9999,0,9999,0
1746593772701,CSE 191,A00,958773,Minnes Kemp; Mor Mia,9995,0,9999,4
1746593773725,CSE 197,001,959846,Minnes Kemp; Mor Mia,9990,0,9999,9
1746593774758,CSS 201S,A01,892054,Mignozzetti; Umberto,25,0,30,5
1746593775787,CSS 202S,A01,892056,Mignozzetti; Umberto,25,0,30,5
1746593776816,DSC 197,001,956898,Eldridge; Justin Matthew,9996,0,9999,3
1746593777840,DSC 297,001,958000,Mazumdar; Arya,9998,0,9999,1
1746593777840,DSC 297,002,959862,Wang; Yusu,9998,0,9999,1
1746593778868,EAP 100,A00,905686,Staff,9778,0,9999,221
1746593779893,ECE 45,A01,892618,Staff,0,0,65,65
1746593781946,ECE 111,A01,892719,Staff,6,0,65,59
1746593782973,ECE 197,001,957920,Mercier; Patrick Philip,9991,0,9999,8
1746593784003,ECON 178,A01,907814,Zhu; Ying,26,0,35,9
1746593785031,EDS 115,A00,895312,Staff,35,0,45,10
1746593786055,EDS 117,A01,895337,Staff,23,0,30,7
1746593787080,EDS 125,A00,895341,Jones; Gabrielle Anastasia,36,0,45,9
1746593788106,EDS 128A,A01,895459,Fargason; Sharon Gayle,44,0,45,1
1746593789130,EDS 128B,A01,895543,Pappas; Elizabeth,44,0,45,1
1746593790156,EDS 139,A00,897203,Pappas; Elizabeth,44,0,45,1
1746593790156,EDS 139,B00,897209,Fargason; Sharon Gayle,41,0,45,4
1746593791182,EDS 201,A00,895545,Staff,22,0,45,23
1746593792208,EDS 203,A01,895581,Halter; Christopher P.,22,0,45,23
1746593793234,EDS 204R,A01,895625,Heinzman; Erica M.,39,0,45,6
1746593793234,EDS 204R,B01,895693,Halter; Christopher P.,10,0,45,35
1746593794261,EDS 206R,A00,895694,Fargason; Sharon Gayle,1,0,30,29
1746593794261,EDS 206R,B00,895695,Choi; Bailey Miyeon,16,0,30,14
1746593795287,EDS 250,A00,895697,Hemans; Patricia Ann Benitez,22,0,45,23
1746593796314,EDS 281,A00,895701,Meyerott; Theresa Ann,1,0,15,14
1746593797345,EDS 284,A00,895736,Meyerott; Theresa Ann,1,0,15,14
1746593798372,EDS 286,A00,897210,Fine; Sarah,0,0,15,15
1746593799398,EDS 289C,A01,895770,Daly; Alan J.,1,0,15,14
1746593800423,EDS 290,A00,897211,Hofstetter; Carolyn,0,0,15,15
1746593801448,LIGM 5A,A00,896162,Fischer-Grunski; Eva K,12,0,20,8
1746593802473,LIGM 5B,A00,896260,Fischer-Grunski; Eva K,17,0,20,3
1746593803499,LIGM 5C,A00,896308,Fischer-Grunski; Eva K,18,0,20,2
1746593804525,LIIT 5AS,A00,896313,Carnelos; Chiara,18,0,20,2
1746593805554,LIIT 5BS,A00,896416,Carnelos; Chiara,20,0,20,0
1746593806580,LIIT 5CS,A00,896564,Carnelos; Chiara,20,0,20,0
1746593807606,LISP 5A,A00,896588,Munoz Sanchez; Alicia,2,0,20,18
1746593808634,LISP 5B,A00,896653,Munoz Sanchez; Alicia,7,0,20,13
1746593809662,LISP 5C,A00,896655,Munoz Sanchez; Alicia,0,1,20,20
1746593810687,MAE 197,001,957918,Kleissl; Jan,9996,0,9999,3
1746593810687,MAE 197,002,959806,Boechler; Nicholas Sebastia,9998,0,9999,1
1746593810687,MAE 197,003,959852,Mullin; Jennifer S,9998,0,9999,1
1746593811714,MATH 2,A01,957937,Staff,33,0,35,2
1746593812740,MATH 197,001,957876,Kedlaya; Kiran S.,9993,0,9999,6
1746593813766,MCWP 40,A00,892729,Duru; Nur,10,0,20,10
1746593813766,MCWP 40,B00,893304,Montejo; Carolina,14,0,20,6
1746593814792,MCWP 40R,A00,893757,Redela; Pamela Morgan,0,5,20,20
1746593815820,MCWP 50,A00,893758,Morshed; Michael James,0,0,20,20
1746593815820,MCWP 50,B00,893761,Bartulis; Jason Michael,17,0,20,3
1746593816849,MCWP 50R,A00,893766,Compas; Sean Matthew,0,1,20,20
1746593816849,MCWP 50R,B00,893769,Carter; Jennifer A,0,1,20,20
1746593816849,MCWP 50R,C00,893771,Krone; Jarret,0,3,20,20
1746593816849,MCWP 50R,D00,893772,Miller; Elizabeth Deen,0,0,20,20
1746593816849,MCWP 50R,E00,893775,Carter; Andrea L,0,1,20,20
1746593817875,MMW 11R,A01,892721,Herbst; Matthew,14,0,30,16
1746593817875,MMW 11R,A02,892722,Herbst; Matthew,0,0,0,3
1746593818904,MMW 12R,A01,892724,Herbst; Matthew,0,11,16,16
1746593818904,MMW 12R,A02,892725,Herbst; Matthew,0,10,16,16
1746593819929,MMW 13R,A01,892727,Staff,0,4,16,16
1746593819929,MMW 13R,A02,892728,Staff,0,4,16,16
1746593819929,MMW 13R,A03,958032,Staff,0,4,16,16
1746593819929,MMW 13R,A04,958033,Staff,0,4,16,16
1746593819929,MMW 13R,A05,958034,Staff,0,4,16,16
1746593820953,SIO 295LS,A00,894015,Staff,5,0,25,20
1746593821978,SIO 295S,A00,894020,Staff,5,0,25,20
1746593823008,SIOC 290S,B01,958918,Merrifield; Mark A,14,0,30,16
1746593824034,SIOC 291S,B01,958922,Gabriel; Corey John,14,0,30,16
1746593825062,SOCI 117,A01,895339,Staff,2,0,5,3
1746593826091,WES 237B,A00,894149,Staff,11,0,20,9
1746593828149,AESE 279B,A00,891859,Staff,13,0,35,22
1746593829176,AIP 197,001,891854,Vespa; Emanuel Ignacio,9999,0,9999,0
1746593830201,ANTH 289S,A00,891856,Gagneux; Pascal,12,0,12,0
1746593831226,BENG 196,001,957946,Engler; Adam J.,9996,0,9999,3
1746593832254,BISP 197,001,959851,Wilhelm; James E.,9998,0,9999,1
1746593833279,CAT 124RS,A01,956906,Staff,6,0,25,19
1746593834307,CAT 125RS,A01,922013,Staff,6,0,25,19
1746593835332,CLRE 250,A00,891860,Morris; Sheldon,9995,0,9999,4
1746593837383,CLRE 251R,A00,907817,Mehta; Ravindra L.,9994,0,9999,5
1746593838408,CLRE 252,A00,891864,Cuomo; Raphael Eduardo,9993,0,9999,6
1746593839436,CLRE 253,A00,891867,Vaida; Florin,9994,0,9999,5
1746593839436,CLRE 253,B00,907819,Staff,9999,0,9999,0
1746593840463,CLRE 259,A00,891868,Patel; Hemal,9998,0,9999,1
1746593841489,CLRE 260,A00,891872,Cuomo; Raphael Eduardo,9999,0,9999,0
1746593842516,CLRE 297,001,891888,Cuomo; Raphael Eduardo,9999,0,9999,0
1746593843540,CSE 191,A00,958773,Minnes Kemp; Mor Mia,9995,0,9999,4
1746593844569,CSE 197,001,959846,Minnes Kemp; Mor Mia,9990,0,9999,9
1746593845595,CSS 201S,A01,892054,Mignozzetti; Umberto,25,0,30,5
1746593846622,CSS 202S,A01,892056,Mignozzetti; Umberto,25,0,30,5
1746593847651,DSC 197,001,956898,Eldridge; Justin Matthew,9996,0,9999,3
1746593848676,DSC 297,001,958000,Mazumdar; Arya,9998,0,9999,1
1746593848676,DSC 297,002,959862,Wang; Yusu,9998,0,9999,1
1746593849704,EAP 100,A00,905686,Staff,9778,0,9999,221
1746593850728,ECE 45,A01,892618,Staff,0,0,65,65
1746593852780,ECE 111,A01,892719,Staff,6,0,65,59
1746593853842,ECE 197,001,957920,Mercier; Patrick Philip,9991,0,9999,8
1746593854867,ECON 178,A01,907814,Zhu; Ying,26,0,35,9
1746593855892,EDS 115,A00,895312,Staff,35,0,45,10
1746593856918,EDS 117,A01,895337,Staff,23,0,30,7
1746593857945,EDS 125,A00,895341,Jones; Gabrielle Anastasia,36,0,45,9
1746593858993,EDS 128A,A01,895459,Fargason; Sharon Gayle,44,0,45,1
1746593860018,EDS 128B,A01,895543,Pappas; Elizabeth,44,0,45,1
1746593861047,EDS 139,A00,897203,Pappas; Elizabeth,44,0,45,1
1746593861047,EDS 139,B00,897209,Fargason; Sharon Gayle,41,0,45,4
1746593862074,EDS 201,A00,895545,Staff,22,0,45,23
1746593863102,EDS 203,A01,895581,Halter; Christopher P.,22,0,45,23
1746593864129,EDS 204R,A01,895625,Heinzman; Erica M.,39,0,45,6
1746593864129,EDS 204R,B01,895693,Halter; Christopher P.,10,0,45,35
1746593865156,EDS 206R,A00,895694,Fargason; Sharon Gayle,1,0,30,29
1746593865156,EDS 206R,B00,895695,Choi; Bailey Miyeon,16,0,30,14
1746593866186,EDS 250,A00,895697,Hemans; Patricia Ann Benitez,22,0,45,23
1746593867211,EDS 281,A00,895701,Meyerott; Theresa Ann,1,0,15,14
1746593868240,EDS 284,A00,895736,Meyerott; Theresa Ann,1,0,15,14
1746593869266,EDS 286,A00,897210,Fine; Sarah,0,0,15,15
1746593870291,EDS 289C,A01,895770,Daly; Alan J.,1,0,15,14
1746593871318,EDS 290,A00,897211,Hofstetter; Carolyn,0,0,15,15
1746593872343,LIGM 5A,A00,896162,Fischer-Grunski; Eva K,12,0,20,8
1746593873369,LIGM 5B,A00,896260,Fischer-Grunski; Eva K,17,0,20,3
1746593874395,LIGM 5C,A00,896308,Fischer-Grunski; Eva K,18,0,20,2
1746593875421,LIIT 5AS,A00,896313,Carnelos; Chiara,18,0,20,2
1746593876447,LIIT 5BS,A00,896416,Carnelos; Chiara,20,0,20,0
1746593877472,LIIT 5CS,A00,896564,Carnelos; Chiara,20,0,20,0
1746593878501,LISP 5A,A00,896588,Munoz Sanchez; Alicia,2,0,20,18
1746593879530,LISP 5B,A00,896653,Munoz Sanchez; Alicia,7,0,20,13
1746593880557,LISP 5C,A00,896655,Munoz Sanchez; Alicia,0,1,20,20
1746593881586,MAE 197,001,957918,Kleissl; Jan,9996,0,9999,3
1746593881586,MAE 197,002,959806,Boechler; Nicholas Sebastia,9998,0,9999,1
1746593881586,MAE 197,003,959852,Mullin; Jennifer S,9998,0,9999,1
1746593882612,MATH 2,A01,957937,Staff,33,0,35,2
1746593883639,MATH 197,001,957876,Kedlaya; Kiran S.,9993,0,9999,6
1746593884670,MCWP 40,A00,892729,Duru; Nur,10,0,20,10
1746593884670,MCWP 40,B00,893304,Montejo; Carolina,14,0,20,6
1746593885695,MCWP 40R,A00,893757,Redela; Pamela Morgan,0,5,20,20
1746593886720,MCWP 50,A00,893758,Morshed; Michael James,0,0,20,20
1746593886720,MCWP 50,B00,893761,Bartulis; Jason Michael,17,0,20,3
1746593887745,MCWP 50R,A00,893766,Compas; Sean Matthew,0,1,20,20
1746593887745,MCWP 50R,B00,893769,Carter; Jennifer A,0,1,20,20
1746593887745,MCWP 50R,C00,893771,Krone; Jarret,0,3,20,20
1746593887745,MCWP 50R,D00,893772,Miller; Elizabeth Deen,0,0,20,20
1746593887745,MCWP 50R,E00,893775,Carter; Andrea L,0,1,20,20
1746593888771,MMW 11R,A01,892721,Herbst; Matthew,14,0,30,16
1746593888771,MMW 11R,A02,892722,Herbst; Matthew,0,0,0,3
1746593889800,MMW 12R,A01,892724,Herbst; Matthew,0,11,16,16
1746593889800,MMW 12R,A02,892725,Herbst; Matthew,0,10,16,16
1746593890828,MMW 13R,A01,892727,Staff,0,4,16,16
1746593890828,MMW 13R,A02,892728,Staff,0,4,16,16
1746593890828,MMW 13R,A03,958032,Staff,0,4,16,16
1746593890828,MMW 13R,A04,958033,Staff,0,4,16,16
1746593890828,MMW 13R,A05,958034,Staff,0,4,16,16
1746593891859,SIO 295LS,A00,894015,Staff,5,0,25,20
1746593892890,SIO 295S,A00,894020,Staff,5,0,25,20
1746593893917,SIOC 290S,B01,958918,Merrifield; Mark A,14,0,30,16
1746593894949,SIOC 291S,B01,958922,Gabriel; Corey John,14,0,30,16
1746593895977,SOCI 117,A01,895339,Staff,2,0,5,3
1746593897001,WES 237B,A00,894149,Staff,11,0,20,9
1746593899060,AESE 279B,A00,891859,Staff,13,0,35,22
1746593900090,AIP 197,001,891854,Vespa; Emanuel Ignacio,9999,0,9999,0
1746593901124,ANTH 289S,A00,891856,Gagneux; Pascal,12,0,12,0
1746593902151,BENG 196,001,957946,Engler; Adam J.,9996,0,9999,3
1746593903178,BISP 197,001,959851,Wilhelm; James E.,9998,0,9999,1
1746593904203,CAT 124RS,A01,956906,Staff,6,0,25,19
1746593905227,CAT 125RS,A01,922013,Staff,6,0,25,19
1746593906257,CLRE 250,A00,891860,Morris; Sheldon,9995,0,9999,4
1746593908311,CLRE 251R,A00,907817,Mehta; Ravindra L.,9994,0,9999,5
1746593909337,CLRE 252,A00,891864,Cuomo; Raphael Eduardo,9993,0,9999,6
1746593910364,CLRE 253,A00,891867,Vaida; Florin,9994,0,9999,5
1746593910364,CLRE 253,B00,907819,Staff,9999,0,9999,0
1746593911389,CLRE 259,A00,891868,Patel; Hemal,9998,0,9999,1
1746593912417,CLRE 260,A00,891872,Cuomo; Raphael Eduardo,9999,0,9999,0
1746593913442,CLRE 297,001,891888,Cuomo; Raphael Eduardo,9999,0,9999,0
1746593914467,CSE 191,A00,958773,Minnes Kemp; Mor Mia,9995,0,9999,4
1746593915494,CSE 197,001,959846,Minnes Kemp; Mor Mia,9990,0,9999,9
1746593916521,CSS 201S,A01,892054,Mignozzetti; Umberto,25,0,30,5
1746593917546,CSS 202S,A01,892056,Mignozzetti; Umberto,25,0,30,5
1746593918571,DSC 197,001,956898,Eldridge; Justin Matthew,9996,0,9999,3
1746593919598,DSC 297,001,958000,Mazumdar; Arya,9998,0,9999,1
1746593919598,DSC 297,002,959862,Wang; Yusu,9998,0,9999,1
1746593920624,EAP 100,A00,905686,Staff,9778,0,9999,221
1746593921654,ECE 45,A01,892618,Staff,0,0,65,65
1746593923705,ECE 111,A01,892719,Staff,6,0,65,59
1746593924731,ECE 197,001,957920,Mercier; Patrick Philip,9991,0,9999,8
1746593925757,ECON 178,A01,907814,Zhu; Ying,26,0,35,9
1746593926786,EDS 115,A00,895312,Staff,35,0,45,10
1746593927811,EDS 117,A01,895337,Staff,23,0,30,7
1746593928837,EDS 125,A00,895341,Jones; Gabrielle Anastasia,36,0,45,9
1746593929866,EDS 128A,A01,895459,Fargason; Sharon Gayle,44,0,45,1
1746593930893,EDS 128B,A01,895543,Pappas; Elizabeth,44,0,45,1
1746593931921,EDS 139,A00,897203,Pappas; Elizabeth,44,0,45,1
1746593931921,EDS 139,B00,897209,Fargason; Sharon Gayle,41,0,45,4
1746593932946,EDS 201,A00,895545,Staff,22,0,45,23
1746593933971,EDS 203,A01,895581,Halter; Christopher P.,22,0,45,23
1746593934998,EDS 204R,A01,895625,Heinzman; Erica M.,39,0,45,6
1746593934998,EDS 204R,B01,895693,Halter; Christopher P.,10,0,45,35
1746593936028,EDS 206R,A00,895694,Fargason; Sharon Gayle,1,0,30,29
1746593936028,EDS 206R,B00,895695,Choi; Bailey Miyeon,16,0,30,14
1746593937053,EDS 250,A00,895697,Hemans; Patricia Ann Benitez,22,0,45,23
1746593938080,EDS 281,A00,895701,Meyerott; Theresa Ann,1,0,15,14
1746593939106,EDS 284,A00,895736,Meyerott; Theresa Ann,1,0,15,14
1746593940132,EDS 286,A00,897210,Fine; Sarah,0,0,15,15
1746593941192,EDS 289C,A01,895770,Daly; Alan J.,1,0,15,14
1746593942221,EDS 290,A00,897211,Hofstetter; Carolyn,0,0,15,15
1746593943251,LIGM 5A,A00,896162,Fischer-Grunski; Eva K,12,0,20,8
1746593944278,LIGM 5B,A00,896260,Fischer-Grunski; Eva K,17,0,20,3
1746593945302,LIGM 5C,A00,896308,Fischer-Grunski; Eva K,18,0,20,2
1746593946330,LIIT 5AS,A00,896313,Carnelos; Chiara,18,0,20,2
1746593947356,LIIT 5BS,A00,896416,Carnelos; Chiara,20,0,20,0
1746593948383,LIIT 5CS,A00,896564,Carnelos; Chiara,20,0,20,0
1746593949413,LISP 5A,A00,896588,Munoz Sanchez; Alicia,2,0,20,18
1746593950437,LISP 5B,A00,896653,Munoz Sanchez; Alicia,7,0,20,13
1746593951463,LISP 5C,A00,896655,Munoz Sanchez; Alicia,0,1,20,20
1746593952490,MAE 197,001,957918,Kleissl; Jan,9996,0,9999,3
1746593952490,MAE 197,002,959806,Boechler; Nicholas Sebastia,9998,0,9999,1
1746593952490,MAE 197,003,959852,Mullin; Jennifer S,9998,0,9999,1
1746593953518,MATH 2,A01,957937,Staff,33,0,35,2
1746593954548,MATH 197,001,957876,Kedlaya; Kiran S.,9993,0,9999,6
1746593955573,MCWP 40,A00,892729,Duru; Nur,10,0,20,10
1746593955573,MCWP 40,B00,893304,Montejo; Carolina,14,0,20,6
1746593956601,MCWP 40R,A00,893757,Redela; Pamela Morgan,0,5,20,20
1746593957629,MCWP 50,A00,893758,Morshed; Michael James,0,0,20,20
1746593957629,MCWP 50,B00,893761,Bartulis; Jason Michael,17,0,20,3
1746593958659,MCWP 50R,A00,893766,Compas; Sean Matthew,0,1,20,20
1746593958659,MCWP 50R,B00,893769,Carter; Jennifer A,0,1,20,20
1746593958659,MCWP 50R,C00,893771,Krone; Jarret,0,3,20,20
1746593958659,MCWP 50R,D00,893772,Miller; Elizabeth Deen,0,0,20,20
1746593958659,MCWP 50R,E00,893775,Carter; Andrea L,0,1,20,20
1746593959685,MMW 11R,A01,892721,Herbst; Matthew,14,0,30,16
1746593959685,MMW 11R,A02,892722,Herbst; Matthew,0,0,0,3
1746593960712,MMW 12R,A01,892724,Herbst; Matthew,0,11,16,16
1746593960712,MMW 12R,A02,892725,Herbst; Matthew,0,10,16,16
1746593961738,MMW 13R,A01,892727,Staff,0,4,16,16
1746593961738,MMW 13R,A02,892728,Staff,0,4,16,16
1746593961738,MMW 13R,A03,958032,Staff,0,4,16,16
1746593961738,MMW 13R,A04,958033,Staff,0,4,16,16
1746593961738,MMW 13R,A05,958034,Staff,0,4,16,16
1746593962764,SIO 295LS,A00,894015,Staff,5,0,25,20
1746593963793,SIO 295S,A00,894020,Staff,5,0,25,20
1746593964817,SIOC 290S,B01,958918,Merrifield; Mark A,14,0,30,16
1746593965843,SIOC 291S,B01,958922,Gabriel; Corey John,14,0,30,16
1746593966869,SOCI 117,A01,895339,Staff,2,0,5,3
1746593967899,WES 237B,A00,894149,Staff,11,0,20,9
1746593969957,AESE 279B,A00,891859,Staff,13,0,35,22
1746593970983,AIP 197,001,891854,Vespa; Emanuel Ignacio,9999,0,9999,0
1746593972010,ANTH 289S,A00,891856,Gagneux; Pascal,12,0,12,0
1746593973035,BENG 196,001,957946,Engler; Adam J.,9996,0,9999,3
1746593974063,BISP 197,001,959851,Wilhelm; James E.,9998,0,9999,1
1746593975090,CAT 124RS,A01,956906,Staff,6,0,25,19
1746593976117,CAT 125RS,A01,922013,Staff,6,0,25,19
1746593977146,CLRE 250,A00,891860,Morris; Sheldon,9995,0,9999,4
1746593979196,CLRE 251R,A00,907817,Mehta; Ravindra L.,9994,0,9999,5
1746593980223,CLRE 252,A00,891864,Cuomo; Raphael Eduardo,9993,0,9999,6
1746593981249,CLRE 253,A00,891867,Vaida; Florin,9994,0,9999,5
1746593981249,CLRE 253,B00,907819,Staff,9999,0,9999,0
1746593982275,CLRE 259,A00,891868,Patel; Hemal,9998,0,9999,1
1746593983299,CLRE 260,A00,891872,Cuomo; Raphael Eduardo,9999,0,9999,0
1746593984325,CLRE 297,001,891888,Cuomo; Raphael Eduardo,9999,0,9999,0
1746593985353,CSE 191,A00,958773,Minnes Kemp; Mor Mia,9995,0,9999,4
1746593986386,CSE 197,001,959846,Minnes Kemp; Mor Mia,9990,0,9999,9
1746593987411,CSS 201S,A01,892054,Mignozzetti; Umberto,25,0,30,5
1746593988436,CSS 202S,A01,892056,Mignozzetti; Umberto,25,0,30,5
1746593989465,DSC 197,001,956898,Eldridge; Justin Matthew,9996,0,9999,3
1746593990492,DSC 297,001,958000,Mazumdar; Arya,9998,0,9999,1
1746593990492,DSC 297,002,959862,Wang; Yusu,9998,0,9999,1
1746593991516,EAP 100,A00,905686,Staff,9778,0,9999,221
1746593992589,ECE 45,A01,892618,Staff,0,0,65,65
1746593994639,ECE 111,A01,892719,Staff,6,0,65,59
1746593995667,ECE 197,001,957920,Mercier; Patrick Philip,9991,0,9999,8
1746593996697,ECON 178,A01,907814,Zhu; Ying,26,0,35,9
1746593997722,EDS 115,A00,895312,Staff,35,0,45,10
1746593998747,EDS 117,A01,895337,Staff,23,0,30,7
1746593999775,EDS 125,A00,895341,Jones; Gabrielle Anastasia,36,0,45,9
1746594000803,EDS 128A,A01,895459,Fargason; Sharon Gayle,44,0,45,1
1746594001829,EDS 128B,A01,895543,Pappas; Elizabeth,44,0,45,1
1746594002860,EDS 139,A00,897203,Pappas; Elizabeth,44,0,45,1
1746594002860,EDS 139,B00,897209,Fargason; Sharon Gayle,41,0,45,4
1746594003886,EDS 201,A00,895545,Staff,22,0,45,23
1746594004913,EDS 203,A01,895581,Halter; Christopher P.,22,0,45,23
1746594005942,EDS 204R,A01,895625,Heinzman; Erica M.,39,0,45,6
1746594005942,EDS 204R,B01,895693,Halter; Christopher P.,10,0,45,35
1746594006969,EDS 206R,A00,895694,Fargason; Sharon Gayle,1,0,30,29
1746594006969,EDS 206R,B00,895695,Choi; Bailey Miyeon,16,0,30,14
1746594007994,EDS 250,A00,895697,Hemans; Patricia Ann Benitez,22,0,45,23
1746594009024,EDS 281,A00,895701,Meyerott; Theresa Ann,1,0,15,14
1746594010054,EDS 284,A00,895736,Meyerott; Theresa Ann,1,0,15,14
1746594011084,EDS 286,A00,897210,Fine; Sarah,0,0,15,15
1746594012114,EDS 289C,A01,895770,Daly; Alan J.,1,0,15,14
1746594013144,EDS 290,A00,897211,Hofstetter; Carolyn,0,0,15,15
1746594014173,LIGM 5A,A00,896162,Fischer-Grunski; Eva K,12,0,20,8
1746594015199,LIGM 5B,A00,896260,Fischer-Grunski; Eva K,17,0,20,3
1746594016224,LIGM 5C,A00,896308,Fischer-Grunski; Eva K,18,0,20,2
1746594017251,LIIT 5AS,A00,896313,Carnelos; Chiara,18,0,20,2
1746594018278,LIIT 5BS,A00,896416,Carnelos; Chiara,20,0,20,0
1746594019302,LIIT 5CS,A00,896564,Carnelos; Chiara,20,0,20,0
1746594020327,LISP 5A,A00,896588,Munoz Sanchez; Alicia,2,0,20,18
1746594021352,LISP 5B,A00,896653,Munoz Sanchez; Alicia,7,0,20,13
1746594022378,LISP 5C,A00,896655,Munoz Sanchez; Alicia,0,1,20,20
1746594023403,MAE 197,001,957918,Kleissl; Jan,9996,0,9999,3
1746594023403,MAE 197,002,959806,Boechler; Nicholas Sebastia,9998,0,9999,1
1746594023403,MAE 197,003,959852,Mullin; Jennifer S,9998,0,9999,1
1746594024432,MATH 2,A01,957937,Staff,33,0,35,2
1746594025456,MATH 197,001,957876,Kedlaya; Kiran S.,9993,0,9999,6
1746594026484,MCWP 40,A00,892729,Duru; Nur,10,0,20,10
1746594026484,MCWP 40,B00,893304,Montejo; Carolina,14,0,20,6
1746594027509,MCWP 40R,A00,893757,Redela; Pamela Morgan,0,5,20,20
1746594028535,MCWP 50,A00,893758,Morshed; Michael James,0,0,20,20
1746594028535,MCWP 50,B00,893761,Bartulis; Jason Michael,17,0,20,3
1746594029560,MCWP 50R,A00,893766,Compas; Sean Matthew,0,1,20,20
1746594029560,MCWP 50R,B00,893769,Carter; Jennifer A,0,1,20,20
1746594029560,MCWP 50R,C00,893771,Krone; Jarret,0,3,20,20
1746594029560,MCWP 50R,D00,893772,Miller; Elizabeth Deen,0,0,20,20
1746594029560,MCWP 50R,E00,893775,Carter; Andrea L,0,1,20,20
1746594030589,MMW 11R,A01,892721,Herbst; Matthew,14,0,30,16
1746594030589,MMW 11R,A02,892722,Herbst; Matthew,0,0,0,3
1746594031620,MMW 12R,A01,892724,Herbst; Matthew,0,11,16,16
1746594031620,MMW 12R,A02,892725,Herbst; Matthew,0,10,16,16
1746594032650,MMW 13R,A01,892727,Staff,0,4,16,16
1746594032650,MMW 13R,A02,892728,Staff,0,4,16,16
1746594032650,MMW 13R,A03,958032,Staff,0,4,16,16
1746594032650,MMW 13R,A04,958033,Staff,0,4,16,16
1746594032650,MMW 13R,A05,958034,Staff,0,4,16,16
1746594033676,SIO 295LS,A00,894015,Staff,5,0,25,20
1746594034702,SIO 295S,A00,894020,Staff,5,0,25,20
1746594035728,SIOC 290S,B01,958918,Merrifield; Mark A,14,0,30,16
1746594036754,SIOC 291S,B01,958922,Gabriel; Corey John,14,0,30,16
1746594037781,SOCI 117,A01,895339,Staff,2,0,5,3
1746594038806,WES 237B,A00,894149,Staff,11,0,20,9
1746594040872,AESE 279B,A00,891859,Staff,13,0,35,22
1746594041897,AIP 197,001,891854,Vespa; Emanuel Ignacio,9999,0,9999,0
1746594042923,ANTH 289S,A00,891856,Gagneux; Pascal,12,0,12,0
1746594043952,BENG 196,001,957946,Engler; Adam J.,9996,0,9999,3
1746594044978,BISP 197,001,959851,Wilhelm; James E.,9998,0,9999,1
1746594046005,CAT 124RS,A01,956906,Staff,6,0,25,19
1746594047034,CAT 125RS,A01,922013,Staff,6,0,25,19
1746594048059,CLRE 250,A00,891860,Morris; Sheldon,9995,0,9999,4
1746594050112,CLRE 251R,A00,907817,Mehta; Ravindra L.,9994,0,9999,5
1746594051141,CLRE 252,A00,891864,Cuomo; Raphael Eduardo,9993,0,9999,6
1746594052173,CLRE 253,A00,891867,Vaida; Florin,9994,0,9999,5
1746594052173,CLRE 253,B00,907819,Staff,9999,0,9999,0
1746594053197,CLRE 259,A00,891868,Patel; Hemal,9998,0,9999,1
1746594054221,CLRE 260,A00,891872,Cuomo; Raphael Eduardo,9999,0,9999,0
1746594055249,CLRE 297,001,891888,Cuomo; Raphael Eduardo,9999,0,9999,0
1746594056280,CSE 191,A00,958773,Minnes Kemp; Mor Mia,9995,0,9999,4
1746594057306,CSE 197,001,959846,Minnes Kemp; Mor Mia,9990,0,9999,9
1746594058331,CSS 201S,A01,892054,Mignozzetti; Umberto,25,0,30,5
1746594059362,CSS 202S,A01,892056,Mignozzetti; Umberto,25,0,30,5
1746594060388,DSC 197,001,956898,Eldridge; Justin Matthew,9996,0,9999,3
1746594061413,DSC 297,001,958000,Mazumdar; Arya,9998,0,9999,1
1746594061413,DSC 297,002,959862,Wang; Yusu,9998,0,9999,1
1746594062438,EAP 100,A00,905686,Staff,9778,0,9999,221
1746594063469,ECE 45,A01,892618,Staff,0,0,65,65
1746594065528,ECE 111,A01,892719,Staff,6,0,65,59
1746594066554,ECE 197,001,957920,Mercier; Patrick Philip,9991,0,9999,8
1746594067582,ECON 178,A01,907814,Zhu; Ying,26,0,35,9
1746594068606,EDS 115,A00,895312,Staff,35,0,45,10
1746594069633,EDS 117,A01,895337,Staff,23,0,30,7
1746594070661,EDS 125,A00,895341,Jones; Gabrielle Anastasia,36,0,45,9
1746594071690,EDS 128A,A01,895459,Fargason; Sharon Gayle,44,0,45,1
1746594072717,EDS 128B,A01,895543,Pappas; Elizabeth,44,0,45,1
1746594073744,EDS 139,A00,897203,Pappas; Elizabeth,44,0,45,1
1746594073744,EDS 139,B00,897209,Fargason; Sharon Gayle,41,0,45,4
1746594074770,EDS 201,A00,895545,Staff,22,0,45,23
1746594075796,EDS 203,A01,895581,Halter; Christopher P.,22,0,45,23
1746594076824,EDS 204R,A01,895625,Heinzman; Erica M.,39,0,45,6
1746594076824,EDS 204R,B01,895693,Halter; Christopher P.,10,0,45,35
1746594077851,EDS 206R,A00,895694,Fargason; Sharon Gayle,1,0,30,29
1746594077851,EDS 206R,B00,895695,Choi; Bailey Miyeon,16,0,30,14
1746594078878,EDS 250,A00,895697,Hemans; Patricia Ann Benitez,22,0,45,23
1746594079907,EDS 281,A00,895701,Meyerott; Theresa Ann,1,0,15,14
1746594080933,EDS 284,A00,895736,Meyerott; Theresa Ann,1,0,15,14
1746594081960,EDS 286,A00,897210,Fine; Sarah,0,0,15,15
1746594082986,EDS 289C,A01,895770,Daly; Alan J.,1,0,15,14
1746594084012,EDS 290,A00,897211,Hofstetter; Carolyn,0,0,15,15
1746594085038,LIGM 5A,A00,896162,Fischer-Grunski; Eva K,12,0,20,8
1746594086070,LIGM 5B,A00,896260,Fischer-Grunski; Eva K,17,0,20,3
1746594087096,LIGM 5C,A00,896308,Fischer-Grunski; Eva K,18,0,20,2
1746594088122,LIIT 5AS,A00,896313,Carnelos; Chiara,18,0,20,2
1746594089153,LIIT 5BS,A00,896416,Carnelos; Chiara,20,0,20,0
1746594090183,LIIT 5CS,A00,896564,Carnelos; Chiara,20,0,20,0
1746594091211,LISP 5A,A00,896588,Munoz Sanchez; Alicia,2,0,20,18
1746594092238,LISP 5B,A00,896653,Munoz Sanchez; Alicia,7,0,20,13
1746594093266,LISP 5C,A00,896655,Munoz Sanchez; Alicia,0,1,20,20
1746594094297,MAE 197,001,957918,Kleissl; Jan,9996,0,9999,3
1746594094297,MAE 197,002,959806,Boechler; Nicholas Sebastia,9998,0,9999,1
1746594094297,MAE 197,003,959852,Mullin; Jennifer S,9998,0,9999,1
1746594095322,MATH 2,A01,957937,Staff,33,0,35,2
1746594096385,MATH 197,001,957876,Kedlaya; Kiran S.,9993,0,9999,6
1746594097410,MCWP 40,A00,892729,Duru; Nur,10,0,20,10
1746594097410,MCWP 40,B00,893304,Montejo; Carolina,14,0,20,6
1746594098436,MCWP 40R,A00,893757,Redela; Pamela Morgan,0,5,20,20
1746594099465,MCWP 50,A00,893758,Morshed; Michael James,0,0,20,20
1746594099465,MCWP 50,B00,893761,Bartulis; Jason Michael,17,0,20,3
1746594100496,MCWP 50R,A00,893766,Compas; Sean Matthew,0,1,20,20
1746594100496,MCWP 50R,B00,893769,Carter; Jennifer A,0,1,20,20
1746594100496,MCWP 50R,C00,893771,Krone; Jarret,0,3,20,20
1746594100496,MCWP 50R,D00,893772,Miller; Elizabeth Deen,0,0,20,20
1746594100496,MCWP 50R,E00,893775,Carter; Andrea L,0,1,20,20
1746594101521,MMW 11R,A01,892721,Herbst; Matthew,14,0,30,16
1746594101521,MMW 11R,A02,892722,Herbst; Matthew,0,0,0,3
1746594102548,MMW 12R,A01,892724,Herbst; Matthew,0,11,16,16
1746594102548,MMW 12R,A02,892725,Herbst; Matthew,0,10,16,16
1746594103573,MMW 13R,A01,892727,Staff,0,4,16,16
1746594103573,MMW 13R,A02,892728,Staff,0,4,16,16
1746594103573,MMW 13R,A03,958032,Staff,0,4,16,16
1746594103573,MMW 13R,A04,958033,Staff,0,4,16,16
1746594103573,MMW 13R,A05,958034,Staff,0,4,16,16
1746594104599,SIO 295LS,A00,894015,Staff,5,0,25,20
1746594105626,SIO 295S,A00,894020,Staff,5,0,25,20
1746594106655,SIOC 290S,B01,958918,Merrifield; Mark A,14,0,30,16
1746594107682,SIOC 291S,B01,958922,Gabriel; Corey John,14,0,30,16
1746594108708,SOCI 117,A01,895339,Staff,2,0,5,3
1746594109736,WES 237B,A00,894149,Staff,11,0,20,9
1746594111819,AESE 279B,A00,891859,Staff,13,0,35,22
1746594112845,AIP 197,001,891854,Vespa; Emanuel Ignacio,9999,0,9999,0
1746594113870,ANTH 289S,A00,891856,Gagneux; Pascal,12,0,12,0
1746594114902,BENG 196,001,957946,Engler; Adam J.,9996,0,9999,3
1746594115929,BISP 197,001,959851,Wilhelm; James E.,9998,0,9999,1
1746594116959,CAT 124RS,A01,956906,Staff,6,0,25,19
1746594117990,CAT 125RS,A01,922013,Staff,6,0,25,19
1746594119018,CLRE 250,A00,891860,Morris; Sheldon,9995,0,9999,4
1746594121076,CLRE 251R,A00,907817,Mehta; Ravindra L.,9994,0,9999,5
1746594122105,CLRE 252,A00,891864,Cuomo; Raphael Eduardo,9993,0,9999,6
1746594123134,CLRE 253,A00,891867,Vaida; Florin,9994,0,9999,5
1746594123134,CLRE 253,B00,907819,Staff,9999,0,9999,0
1746594124159,CLRE 259,A00,891868,Patel; Hemal,9998,0,9999,1
1746594125187,CLRE 260,A00,891872,Cuomo; Raphael Eduardo,9999,0,9999,0
1746594126244,CLRE 297,001,891888,Cuomo; Raphael Eduardo,9999,0,9999,0
1746594127269,CSE 191,A00,958773,Minnes Kemp; Mor Mia,9995,0,9999,4
1746594128297,CSE 197,001,959846,Minnes Kemp; Mor Mia,9990,0,9999,9
1746594129323,CSS 201S,A01,892054,Mignozzetti; Umberto,25,0,30,5
1746594130349,CSS 202S,A01,892056,Mignozzetti; Umberto,25,0,30,5
1746594131375,DSC 197,001,956898,Eldridge; Justin Matthew,9996,0,9999,3
1746594132401,DSC 297,001,958000,Mazumdar; Arya,9998,0,9999,1
1746594132401,DSC 297,002,959862,Wang; Yusu,9998,0,9999,1
1746594133428,EAP 100,A00,905686,Staff,9778,0,9999,221
1746594134455,ECE 45,A01,892618,Staff,0,0,65,65
1746594136510,ECE 111,A01,892719,Staff,6,0,65,59
1746594137539,ECE 197,001,957920,Mercier; Patrick Philip,9991,0,9999,8
1746594138568,ECON 178,A01,907814,Zhu; Ying,26,0,35,9
1746594139593,EDS 115,A00,895312,Staff,35,0,45,10
1746594140620,EDS 117,A01,895337,Staff,23,0,30,7
1746594141646,EDS 125,A00,895341,Jones; Gabrielle Anastasia,36,0,45,9
1746594142678,EDS 128A,A01,895459,Fargason; Sharon Gayle,44,0,45,1
1746594143702,EDS 128B,A01,895543,Pappas; Elizabeth,44,0,45,1
1746594144729,EDS 139,A00,897203,Pappas; Elizabeth,44,0,45,1
1746594144729,EDS 139,B00,897209,Fargason; Sharon Gayle,41,0,45,4
1746594145753,EDS 201,A00,895545,Staff,22,0,45,23
1746594146778,EDS 203,A01,895581,Halter; Christopher P.,22,0,45,23
1746594147805,EDS 204R,A01,895625,Heinzman; Erica M.,39,0,45,6
1746594147805,EDS 204R,B01,895693,Halter; Christopher P.,10,0,45,35
1746594148831,EDS 206R,A00,895694,Fargason; Sharon Gayle,1,0,30,29
1746594148831,EDS 206R,B00,895695,Choi; Bailey Miyeon,16,0,30,14
1746594149856,EDS 250,A00,895697,Hemans; Patricia Ann Benitez,22,0,45,23
1746594150883,EDS 281,A00,895701,Meyerott; Theresa Ann,1,0,15,14
1746594151909,EDS 284,A00,895736,Meyerott; Theresa Ann,1,0,15,14
1746594152937,EDS 286,A00,897210,Fine; Sarah,0,0,15,15
1746594153965,EDS 289C,A01,895770,Daly; Alan J.,1,0,15,14
1746594154993,EDS 290,A00,897211,Hofstetter; Carolyn,0,0,15,15
1746594156020,LIGM 5A,A00,896162,Fischer-Grunski; Eva K,12,0,20,8
1746594157048,LIGM 5B,A00,896260,Fischer-Grunski; Eva K,17,0,20,3
1746594158074,LIGM 5C,A00,896308,Fischer-Grunski; Eva K,18,0,20,2
1746594159104,LIIT 5AS,A00,896313,Carnelos; Chiara,18,0,20,2
1746594160130,LIIT 5BS,A00,896416,Carnelos; Chiara,20,0,20,0
1746594161156,LIIT 5CS,A00,896564,Carnelos; Chiara,20,0,20,0
1746594162183,LISP 5A,A00,896588,Munoz Sanchez; Alicia,2,0,20,18
1746594163211,LISP 5B,A00,896653,Munoz Sanchez; Alicia,7,0,20,13
1746594164241,LISP 5C,A00,896655,Munoz Sanchez; Alicia,0,1,20,20
1746594165267,MAE 197,001,957918,Kleissl; Jan,9996,0,9999,3
1746594165267,MAE 197,002,959806,Boechler; Nicholas Sebastia,9998,0,9999,1
1746594165267,MAE 197,003,959852,Mullin; Jennifer S,9998,0,9999,1
1746594166293,MATH 2,A01,957937,Staff,33,0,35,2
1746594167318,MATH 197,001,957876,Kedlaya; Kiran S.,9993,0,9999,6
1746594168345,MCWP 40,A00,892729,Duru; Nur,10,0,20,10
1746594168345,MCWP 40,B00,893304,Montejo; Carolina,14,0,20,6
1746594169369,MCWP 40R,A00,893757,Redela; Pamela Morgan,0,5,20,20
1746594170396,MCWP 50,A00,893758,Morshed; Michael James,0,0,20,20
1746594170396,MCWP 50,B00,893761,Bartulis; Jason Michael,17,0,20,3
1746594171427,MCWP 50R,A00,893766,Compas; Sean Matthew,0,1,20,20
1746594171427,MCWP 50R,B00,893769,Carter; Jennifer A,0,1,20,20
1746594171427,MCWP 50R,C00,893771,Krone; Jarret,0,3,20,20
1746594171427,MCWP 50R,D00,893772,Miller; Elizabeth Deen,0,0,20,20
1746594171427,MCWP 50R,E00,893775,Carter; Andrea L,0,1,20,20
1746594172450,MMW 11R,A01,892721,Herbst; Matthew,14,0,30,16
1746594172450,MMW 11R,A02,892722,Herbst; Matthew,0,0,0,3
1746594173480,MMW 12R,A01,892724,Herbst; Matthew,0,11,16,16
1746594173480,MMW 12R,A02,892725,Herbst; Matthew,0,10,16,16
1746594174505,MMW 13R,A01,892727,Staff,0,4,16,16
1746594174505,MMW 13R,A02,892728,Staff,0,4,16,16
1746594174505,MMW 13R,A03,958032,Staff,0,4,16,16
1746594174505,MMW 13R,A04,958033,Staff,0,4,16,16
1746594174505,MMW 13R,A05,958034,Staff,0,4,16,16
1746594175530,SIO 295LS,A00,894015,Staff,5,0,25,20
1746594176559,SIO 295S,A00,894020,Staff,5,0,25,20
1746594177585,SIOC 290S,B01,958918,Merrifield; Mark A,14,0,30,16
1746594178610,SIOC 291S,B01,958922,Gabriel; Corey John,14,0,30,16
1746594179638,SOCI 117,A01,895339,Staff,2,0,5,3
1746594180665,WES 237B,A00,894149,Staff,11,0,20,9
1746594182731,AESE 279B,A00,891859,Staff,13,0,35,22
1746594183758,AIP 197,001,891854,Vespa; Emanuel Ignacio,9999,0,9999,0
1746594184784,ANTH 289S,A00,891856,Gagneux; Pascal,12,0,12,0
1746594185808,BENG 196,001,957946,Engler; Adam J.,9996,0,9999,3
1746594186838,BISP 197,001,959851,Wilhelm; James E.,9998,0,9999,1
1746594187865,CAT 124RS,A01,956906,Staff,6,0,25,19
1746594188893,CAT 125RS,A01,922013,Staff,6,0,25,19
1746594189917,CLRE 250,A00,891860,Morris; Sheldon,9995,0,9999,4
1746594191967,CLRE 251R,A00,907817,Mehta; Ravindra L.,9994,0,9999,5
1746594192994,CLRE 252,A00,891864,Cuomo; Raphael Eduardo,9993,0,9999,6
1746594194020,CLRE 253,A00,891867,Vaida; Florin,9994,0,9999,5
1746594194020,CLRE 253,B00,907819,Staff,9999,0,9999,0
1746594195044,CLRE 259,A00,891868,Patel; Hemal,9998,0,9999,1
1746594196070,CLRE 260,A00,891872,Cuomo; Raphael Eduardo,9999,0,9999,0
1746594197094,CLRE 297,001,891888,Cuomo; Raphael Eduardo,9999,0,9999,0
1746594198119,CSE 191,A00,958773,Minnes Kemp; Mor Mia,9995,0,9999,4
1746594199144,CSE 197,001,959846,Minnes Kemp; Mor Mia,9990,0,9999,9
1746594200169,CSS 201S,A01,892054,Mignozzetti; Umberto,25,0,30,5
1746594201197,CSS 202S,A01,892056,Mignozzetti; Umberto,25,0,30,5
1746594202223,DSC 197,001,956898,Eldridge; Justin Matthew,9996,0,9999,3
1746594203251,DSC 297,001,958000,Mazumdar; Arya,9998,0,9999,1
1746594203251,DSC 297,002,959862,Wang; Yusu,9998,0,9999,1
1746594204278,EAP 100,A00,905686,Staff,9778,0,9999,221
1746594205304,ECE 45,A01,892618,Staff,0,0,65,65
1746594207356,ECE 111,A01,892719,Staff,6,0,65,59
1746594208380,ECE 197,001,957920,Mercier; Patrick Philip,9991,0,9999,8
1746594209405,ECON 178,A01,907814,Zhu; Ying,26,0,35,9
1746594210431,EDS 115,A00,895312,Staff,35,0,45,10
1746594211458,EDS 117,A01,895337,Staff,23,0,30,7
1746594212483,EDS 125,A00,895341,Jones; Gabrielle Anastasia,36,0,45,9
1746594213514,EDS 128A,A01,895459,Fargason; Sharon Gayle,44,0,45,1
1746594214539,EDS 128B,A01,895543,Pappas; Elizabeth,44,0,45,1
1746594215565,EDS 139,A00,897203,Pappas; Elizabeth,44,0,45,1
1746594215565,EDS 139,B00,897209,Fargason; Sharon Gayle,41,0,45,4
1746594216595,EDS 201,A00,895545,Staff,22,0,45,23
1746594217623,EDS 203,A01,895581,Halter; Christopher P.,22,0,45,23
1746594218653,EDS 204R,A01,895625,Heinzman; Erica M.,39,0,45,6
1746594218653,EDS 204R,B01,895693,Halter; Christopher P.,10,0,45,35
1746594219680,EDS 206R,A00,895694,Fargason; Sharon Gayle,1,0,30,29
1746594219680,EDS 206R,B00,895695,Choi; Bailey Miyeon,16,0,30,14
1746594220711,EDS 250,A00,895697,Hemans; Patricia Ann Benitez,22,0,45,23
1746594221736,EDS 281,A00,895701,Meyerott; Theresa Ann,1,0,15,14
1746594222761,EDS 284,A00,895736,Meyerott; Theresa Ann,1,0,15,14
1746594223790,EDS 286,A00,897210,Fine; Sarah,0,0,15,15
1746594224814,EDS 289C,A01,895770,Daly; Alan J.,1,0,15,14
1746594225843,EDS 290,A00,897211,Hofstetter; Carolyn,0,0,15,15
1746594226869,LIGM 5A,A00,896162,Fischer-Grunski; Eva K,12,0,20,8
1746594227894,LIGM 5B,A00,896260,Fischer-Grunski; Eva K,17,0,20,3
1746594228924,LIGM 5C,A00,896308,Fischer-Grunski; Eva K,18,0,20,2
1746594229950,LIIT 5AS,A00,896313,Carnelos; Chiara,18,0,20,2
1746594230977,LIIT 5BS,A00,896416,Carnelos; Chiara,20,0,20,0
1746594232004,LIIT 5CS,A00,896564,Carnelos; Chiara,20,0,20,0
1746594233031,LISP 5A,A00,896588,Munoz Sanchez; Alicia,2,0,20,18
1746594234057,LISP 5B,A00,896653,Munoz Sanchez; Alicia,7,0,20,13
1746594235083,LISP 5C,A00,896655,Munoz Sanchez; Alicia,0,1,20,20
1746594236110,MAE 197,001,957918,Kleissl; Jan,9996,0,9999,3
1746594236110,MAE 197,002,959806,Boechler; Nicholas Sebastia,9998,0,9999,1
1746594236110,MAE 197,003,959852,Mullin; Jennifer S,9998,0,9999,1
1746594237137,MATH 2,A01,957937,Staff,33,0,35,2
1746594238165,MATH 197,001,957876,Kedlaya; Kiran S.,9993,0,9999,6
1746594239195,MCWP 40,A00,892729,Duru; Nur,10,0,20,10
1746594239195,MCWP 40,B00,893304,Montejo; Carolina,14,0,20,6
1746594240226,MCWP 40R,A00,893757,Redela; Pamela Morgan,0,5,20,20
1746594241250,MCWP 50,A00,893758,Morshed; Michael James,0,0,20,20
1746594241250,MCWP 50,B00,893761,Bartulis; Jason Michael,17,0,20,3
1746594242277,MCWP 50R,A00,893766,Compas; Sean Matthew,0,1,20,20
1746594242277,MCWP 50R,B00,893769,Carter; Jennifer A,0,1,20,20
1746594242277,MCWP 50R,C00,893771,Krone; Jarret,0,3,20,20
1746594242277,MCWP 50R,D00,893772,Miller; Elizabeth Deen,0,0,20,20
1746594242277,MCWP 50R,E00,893775,Carter; Andrea L,0,1,20,20
1746594243304,MMW 11R,A01,892721,Herbst; Matthew,14,0,30,16
1746594243304,MMW 11R,A02,892722,Herbst; Matthew,0,0,0,3
1746594244328,MMW 12R,A01,892724,Herbst; Matthew,0,11,16,16
1746594244328,MMW 12R,A02,892725,Herbst; Matthew,0,10,16,16
1746594245353,MMW 13R,A01,892727,Staff,0,4,16,16
1746594245353,MMW 13R,A02,892728,Staff,0,4,16,16
1746594245353,MMW 13R,A03,958032,Staff,0,4,16,16
1746594245353,MMW 13R,A04,958033,Staff,0,4,16,16
1746594245353,MMW 13R,A05,958034,Staff,0,4,16,16
1746594246384,SIO 295LS,A00,894015,Staff,5,0,25,20
1746594247411,SIO 295S,A00,894020,Staff,5,0,25,20
1746594248439,SIOC 290S,B01,958918,Merrifield; Mark A,14,0,30,16
1746594249469,SIOC 291S,B01,958922,Gabriel; Corey John,14,0,30,16
1746594250496,SOCI 117,A01,895339,Staff,2,0,5,3
1746594251523,WES 237B,A00,894149,Staff,11,0,20,9
1746594253594,AESE 279B,A00,891859,Staff,13,0,35,22
1746594254625,AIP 197,001,891854,Vespa; Emanuel Ignacio,9999,0,9999,0
1746594255654,ANTH 289S,A00,891856,Gagneux; Pascal,12,0,12,0
1746594256681,BENG 196,001,957946,Engler; Adam J.,9996,0,9999,3
1746594257710,BISP 197,001,959851,Wilhelm; James E.,9998,0,9999,1
1746594258735,CAT 124RS,A01,956906,Staff,6,0,25,19
1746594259761,CAT 125RS,A01,922013,Staff,6,0,25,19
1746594260787,CLRE 250,A00,891860,Morris; Sheldon,9995,0,9999,4
1746594262843,CLRE 251R,A00,907817,Mehta; Ravindra L.,9994,0,9999,5
1746594263871,CLRE 252,A00,891864,Cuomo; Raphael Eduardo,9993,0,9999,6
1746594264899,CLRE 253,A00,891867,Vaida; Florin,9994,0,9999,5
1746594264899,CLRE 253,B00,907819,Staff,9999,0,9999,0
1746594265926,CLRE 259,A00,891868,Patel; Hemal,9998,0,9999,1
1746594266950,CLRE 260,A00,891872,Cuomo; Raphael Eduardo,9999,0,9999,0
1746594268002,CLRE 297,001,891888,Cuomo; Raphael Eduardo,9999,0,9999,0
1746594269028,CSE 191,A00,958773,Minnes Kemp; Mor Mia,9995,0,9999,4
1746594270054,CSE 197,001,959846,Minnes Kemp; Mor Mia,9990,0,9999,9
1746594271089,CSS 201S,A01,892054,Mignozzetti; Umberto,25,0,30,5
1746594272113,CSS 202S,A01,892056,Mignozzetti; Umberto,25,0,30,5
1746594273139,DSC 197,001,956898,Eldridge; Justin Matthew,9996,0,9999,3
1746594274164,DSC 297,001,958000,Mazumdar; Arya,9998,0,9999,1
1746594274164,DSC 297,002,959862,Wang; Yusu,9998,0,9999,1
1746594275192,EAP 100,A00,905686,Staff,9778,0,9999,221
1746594276219,ECE 45,A01,892618,Staff,0,0,65,65
1746594278276,ECE 111,A01,892719,Staff,6,0,65,59
1746594279304,ECE 197,001,957920,Mercier; Patrick Philip,9991,0,9999,8
1746594280334,ECON 178,A01,907814,Zhu; Ying,26,0,35,9
1746594281360,EDS 115,A00,895312,Staff,35,0,45,10
1746594282403,EDS 117,A01,895337,Staff,23,0,30,7
1746594283428,EDS 125,A00,895341,Jones; Gabrielle Anastasia,36,0,45,9
1746594284454,EDS 128A,A01,895459,Fargason; Sharon Gayle,44,0,45,1
1746594285481,EDS 128B,A01,895543,Pappas; Elizabeth,44,0,45,1
1746594286506,EDS 139,A00,897203,Pappas; Elizabeth,44,0,45,1
1746594286506,EDS 139,B00,897209,Fargason; Sharon Gayle,41,0,45,4
1746594287532,EDS 201,A00,895545,Staff,22,0,45,23
1746594288558,EDS 203,A01,895581,Halter; Christopher P.,22,0,45,23
1746594289585,EDS 204R,A01,895625,Heinzman; Erica M.,39,0,45,6
1746594289585,EDS 204R,B01,895693,Halter; Christopher P.,10,0,45,35
1746594290611,EDS 206R,A00,895694,Fargason; Sharon Gayle,1,0,30,29
1746594290611,EDS 206R,B00,895695,Choi; Bailey Miyeon,16,0,30,14
1746594291637,EDS 250,A00,895697,Hemans; Patricia Ann Benitez,22,0,45,23
1746594292664,EDS 281,A00,895701,Meyerott; Theresa Ann,1,0,15,14
1746594293688,EDS 284,A00,895736,Meyerott; Theresa Ann,1,0,15,14
1746594294718,EDS 286,A00,897210,Fine; Sarah,0,0,15,15
1746594295745,EDS 289C,A01,895770,Daly; Alan J.,1,0,15,14
1746594296772,EDS 290,A00,897211,Hofstetter; Carolyn,0,0,15,15
1746594297798,LIGM 5A,A00,896162,Fischer-Grunski; Eva K,12,0,20,8
1746594298826,LIGM 5B,A00,896260,Fischer-Grunski; Eva K,17,0,20,3
1746594299853,LIGM 5C,A00,896308,Fischer-Grunski; Eva K,18,0,20,2
1746594300879,LIIT 5AS,A00,896313,Carnelos; Chiara,18,0,20,2
1746594301907,LIIT 5BS,A00,896416,Carnelos; Chiara,20,0,20,0
1746594302936,LIIT 5CS,A00,896564,Carnelos; Chiara,20,0,20,0
1746594303963,LISP 5A,A00,896588,Munoz Sanchez; Alicia,2,0,20,18
1746594304992,LISP 5B,A00,896653,Munoz Sanchez; Alicia,7,0,20,13
1746594306020,LISP 5C,A00,896655,Munoz Sanchez; Alicia,0,1,20,20
1746594307045,MAE 197,001,957918,Kleissl; Jan,9996,0,9999,3
1746594307045,MAE 197,002,959806,Boechler; Nicholas Sebastia,9998,0,9999,1
1746594307045,MAE 197,003,959852,Mullin; Jennifer S,9998,0,9999,1
1746594308074,MATH 2,A01,957937,Staff,33,0,35,2
1746594309100,MATH 197,001,957876,Kedlaya; Kiran S.,9993,0,9999,6
1746594310126,MCWP 40,A00,892729,Duru; Nur,10,0,20,10
1746594310126,MCWP 40,B00,893304,Montejo; Carolina,14,0,20,6
1746594311154,MCWP 40R,A00,893757,Redela; Pamela Morgan,0,5,20,20
1746594312180,MCWP 50,A00,893758,Morshed; Michael James,0,0,20,20
1746594312180,MCWP 50,B00,893761,Bartulis; Jason Michael,17,0,20,3
1746594313206,MCWP 50R,A00,893766,Compas; Sean Matthew,0,1,20,20
1746594313206,MCWP 50R,B00,893769,Carter; Jennifer A,0,1,20,20
1746594313206,MCWP 50R,C00,893771,Krone; Jarret,0,3,20,20
1746594313206,MCWP 50R,D00,893772,Miller; Elizabeth Deen,0,0,20,20
1746594313206,MCWP 50R,E00,893775,Carter; Andrea L,0,1,20,20
1746594314234,MMW 11R,A01,892721,Herbst; Matthew,14,0,30,16
1746594314234,MMW 11R,A02,892722,Herbst; Matthew,0,0,0,3
1746594315262,MMW 12R,A01,892724,Herbst; Matthew,0,11,16,16
1746594315262,MMW 12R,A02,892725,Herbst; Matthew,0,10,16,16
1746594316292,MMW 13R,A01,892727,Staff,0,4,16,16
1746594316292,MMW 13R,A02,892728,Staff,0,4,16,16
1746594316292,MMW 13R,A03,958032,Staff,0,4,16,16
1746594316292,MMW 13R,A04,958033,Staff,0,4,16,16
1746594316292,MMW 13R,A05,958034,Staff,0,4,16,16
1746594317317,SIO 295LS,A00,894015,Staff,5,0,25,20
1746594318347,SIO 295S,A00,894020,Staff,5,0,25,20
1746594319374,SIOC 290S,B01,958918,Merrifield; Mark A,14,0,30,16
1746594320400,SIOC 291S,B01,958922,Gabriel; Corey John,14,0,30,16
1746594321428,SOCI 117,A01,895339,Staff,2,0,5,3
1746594322453,WES 237B,A00,894149,Staff,11,0,20,9
1746594324517,AESE 279B,A00,891859,Staff,13,0,35,22
1746594325545,AIP 197,001,891854,Vespa; Emanuel Ignacio,9999,0,9999,0
1746594326574,ANTH 289S,A00,891856,Gagneux; Pascal,12,0,12,0
1746594327599,BENG 196,001,957946,Engler; Adam J.,9996,0,9999,3
1746594328627,BISP 197,001,959851,Wilhelm; James E.,9998,0,9999,1
1746594329652,CAT 124RS,A01,956906,Staff,6,0,25,19
1746594330679,CAT 125RS,A01,922013,Staff,6,0,25,19
1746594331707,CLRE 250,A00,891860,Morris; Sheldon,9995,0,9999,4
1746594333762,CLRE 251R,A00,907817,Mehta; Ravindra L.,9994,0,9999,5
1746594334792,CLRE 252,A00,891864,Cuomo; Raphael Eduardo,9993,0,9999,6
1746594335818,CLRE 253,A00,891867,Vaida; Florin,9994,0,9999,5
1746594335818,CLRE 253,B00,907819,Staff,9999,0,9999,0
1746594336846,CLRE 259,A00,891868,Patel; Hemal,9998,0,9999,1
1746594337876,CLRE 260,A00,891872,Cuomo; Raphael Eduardo,9999,0,9999,0
1746594338901,CLRE 297,001,891888,Cuomo; Raphael Eduardo,9999,0,9999,0
1746594339926,CSE 191,A00,958773,Minnes Kemp; Mor Mia,9995,0,9999,4
1746594340951,CSE 197,001,959846,Minnes Kemp; Mor Mia,9990,0,9999,9
1746594341977,CSS 201S,A01,892054,Mignozzetti; Umberto,25,0,30,5
1746594343005,CSS 202S,A01,892056,Mignozzetti; Umberto,25,0,30,5
1746594344033,DSC 197,001,956898,Eldridge; Justin Matthew,9996,0,9999,3
1746594345058,DSC 297,001,958000,Mazumdar; Arya,9998,0,9999,1
1746594345058,DSC 297,002,959862,Wang; Yusu,9998,0,9999,1
1746594346085,EAP 100,A00,905686,Staff,9778,0,9999,221
1746594347112,ECE 45,A01,892618,Staff,0,0,65,65
1746594349168,ECE 111,A01,892719,Staff,6,0,65,59
1746594350194,ECE 197,001,957920,Mercier; Patrick Philip,9991,0,9999,8
1746594351219,ECON 178,A01,907814,Zhu; Ying,26,0,35,9
1746594352244,EDS 115,A00,895312,Staff,35,0,45,10
1746594353271,EDS 117,A01,895337,Staff,23,0,30,7
1746594354300,EDS 125,A00,895341,Jones; Gabrielle Anastasia,36,0,45,9
1746594355326,EDS 128A,A01,895459,Fargason; Sharon Gayle,44,0,45,1
1746594356352,EDS 128B,A01,895543,Pappas; Elizabeth,44,0,45,1
1746594357378,EDS 139,A00,897203,Pappas; Elizabeth,44,0,45,1
1746594357378,EDS 139,B00,897209,Fargason; Sharon Gayle,41,0,45,4
1746594358405,EDS 201,A00,895545,Staff,22,0,45,23
1746594359436,EDS 203,A01,895581,Halter; Christopher P.,22,0,45,23
1746594360461,EDS 204R,A01,895625,Heinzman; Erica M.,39,0,45,6
1746594360461,EDS 204R,B01,895693,Halter; Christopher P.,10,0,45,35
1746594361517,EDS 206R,A00,895694,Fargason; Sharon Gayle,1,0,30,29
1746594361517,EDS 206R,B00,895695,Choi; Bailey Miyeon,16,0,30,14
1746594362546,EDS 250,A00,895697,Hemans; Patricia Ann Benitez,22,0,45,23
1746594363569,EDS 281,A00,895701,Meyerott; Theresa Ann,1,0,15,14
1746594364598,EDS 284,A00,895736,Meyerott; Theresa Ann,1,0,15,14
1746594365622,EDS 286,A00,897210,Fine; Sarah,0,0,15,15
1746594366651,EDS 289C,A01,895770,Daly; Alan J.,1,0,15,14
1746594367676,EDS 290,A00,897211,Hofstetter; Carolyn,0,0,15,15
1746594368706,LIGM 5A,A00,896162,Fischer-Grunski; Eva K,12,0,20,8
1746594369733,LIGM 5B,A00,896260,Fischer-Grunski; Eva K,17,0,20,3
1746594370758,LIGM 5C,A00,896308,Fischer-Grunski; Eva K,18,0,20,2
1746594371784,LIIT 5AS,A00,896313,Carnelos; Chiara,18,0,20,2
1746594372814,LIIT 5BS,A00,896416,Carnelos; Chiara,20,0,20,0
1746594373843,LIIT 5CS,A00,896564,Carnelos; Chiara,20,0,20,0
1746594374867,LISP 5A,A00,896588,Munoz Sanchez; Alicia,2,0,20,18
1746594375896,LISP 5B,A00,896653,Munoz Sanchez; Alicia,7,0,20,13
1746594376923,LISP 5C,A00,896655,Munoz Sanchez; Alicia,0,1,20,20
1746594377953,MAE 197,001,957918,Kleissl; Jan,9996,0,9999,3
1746594377953,MAE 197,002,959806,Boechler; Nicholas Sebastia,9998,0,9999,1
1746594377953,MAE 197,003,959852,Mullin; Jennifer S,9998,0,9999,1
1746594378983,MATH 2,A01,957937,Staff,33,0,35,2
1746594380011,MATH 197,001,957876,Kedlaya; Kiran S.,9993,0,9999,6
1746594381039,MCWP 40,A00,892729,Duru; Nur,10,0,20,10
1746594381039,MCWP 40,B00,893304,Montejo; Carolina,14,0,20,6
1746594382068,MCWP 40R,A00,893757,Redela; Pamela Morgan,0,5,20,20
1746594383097,MCWP 50,A00,893758,Morshed; Michael James,0,0,20,20
1746594383097,MCWP 50,B00,893761,Bartulis; Jason Michael,17,0,20,3
1746594384125,MCWP 50R,A00,893766,Compas; Sean Matthew,0,1,20,20
1746594384125,MCWP 50R,B00,893769,Carter; Jennifer A,0,1,20,20
1746594384125,MCWP 50R,C00,893771,Krone; Jarret,0,3,20,20
1746594384125,MCWP 50R,D00,893772,Miller; Elizabeth Deen,0,0,20,20
1746594384125,MCWP 50R,E00,893775,Carter; Andrea L,0,1,20,20
1746594385154,MMW 11R,A01,892721,Herbst; Matthew,14,0,30,16
1746594385154,MMW 11R,A02,892722,Herbst; Matthew,0,0,0,3
1746594386179,MMW 12R,A01,892724,Herbst; Matthew,0,11,16,16
1746594386179,MMW 12R,A02,892725,Herbst; Matthew,0,10,16,16
1746594387205,MMW 13R,A01,892727,Staff,0,4,16,16
1746594387205,MMW 13R,A02,892728,Staff,0,4,16,16
1746594387205,MMW 13R,A03,958032,Staff,0,4,16,16
1746594387205,MMW 13R,A04,958033,Staff,0,4,16,16
1746594387205,MMW 13R,A05,958034,Staff,0,4,16,16
1746594388231,SIO 295LS,A00,894015,Staff,5,0,25,20
1746594389255,SIO 295S,A00,894020,Staff,5,0,25,20
1746594390284,SIOC 290S,B01,958918,Merrifield; Mark A,14,0,30,16
1746594391308,SIOC 291S,B01,958922,Gabriel; Corey John,14,0,30,16
1746594392335,SOCI 117,A01,895339,Staff,2,0,5,3
1746594393362,WES 237B,A00,894149,Staff,11,0,20,9
1746594395429,AESE 279B,A00,891859,Staff,13,0,35,22
1746594396457,AIP 197,001,891854,Vespa; Emanuel Ignacio,9999,0,9999,0
1746594397487,ANTH 289S,A00,891856,Gagneux; Pascal,12,0,12,0
1746594398515,BENG 196,001,957946,Engler; Adam J.,9996,0,9999,3
1746594399544,BISP 197,001,959851,Wilhelm; James E.,9998,0,9999,1
1746594400569,CAT 124RS,A01,956906,Staff,6,0,25,19
1746594401598,CAT 125RS,A01,922013,Staff,6,0,25,19
1746594402624,CLRE 250,A00,891860,Morris; Sheldon,9995,0,9999,4
1746594404678,CLRE 251R,A00,907817,Mehta; Ravindra L.,9994,0,9999,5
1746594405705,CLRE 252,A00,891864,Cuomo; Raphael Eduardo,9993,0,9999,6
1746594406731,CLRE 253,A00,891867,Vaida; Florin,9994,0,9999,5
1746594406731,CLRE 253,B00,907819,Staff,9999,0,9999,0
1746594407756,CLRE 259,A00,891868,Patel; Hemal,9998,0,9999,1
1746594408781,CLRE 260,A00,891872,Cuomo; Raphael Eduardo,9999,0,9999,0
1746594409809,CLRE 297,001,891888,Cuomo; Raphael Eduardo,9999,0,9999,0
1746594410835,CSE 191,A00,958773,Minnes Kemp; Mor Mia,9995,0,9999,4
1746594411860,CSE 197,001,959846,Minnes Kemp; Mor Mia,9990,0,9999,9
1746594412891,CSS 201S,A01,892054,Mignozzetti; Umberto,25,0,30,5
1746594413940,CSS 202S,A01,892056,Mignozzetti; Umberto,25,0,30,5
1746594414966,DSC 197,001,956898,Eldridge; Justin Matthew,9996,0,9999,3
1746594415992,DSC 297,001,958000,Mazumdar; Arya,9998,0,9999,1
1746594415992,DSC 297,002,959862,Wang; Yusu,9998,0,9999,1
1746594417019,EAP 100,A00,905686,Staff,9778,0,9999,221
1746594418045,ECE 45,A01,892618,Staff,0,0,65,65
1746594420098,ECE 111,A01,892719,Staff,6,0,65,59
1746594421122,ECE 197,001,957920,Mercier; Patrick Philip,9991,0,9999,8
1746594422148,ECON 178,A01,907814,Zhu; Ying,26,0,35,9
1746594423172,EDS 115,A00,895312,Staff,35,0,45,10
1746594424203,EDS 117,A01,895337,Staff,23,0,30,7
1746594425231,EDS 125,A00,895341,Jones; Gabrielle Anastasia,36,0,45,9
1746594426259,EDS 128A,A01,895459,Fargason; Sharon Gayle,44,0,45,1
1746594427284,EDS 128B,A01,895543,Pappas; Elizabeth,44,0,45,1
1746594428313,EDS 139,A00,897203,Pappas; Elizabeth,44,0,45,1
1746594428313,EDS 139,B00,897209,Fargason; Sharon Gayle,41,0,45,4
1746594429341,EDS 201,A00,895545,Staff,22,0,45,23
1746594430371,EDS 203,A01,895581,Halter; Christopher P.,22,0,45,23
1746594431400,EDS 204R,A01,895625,Heinzman; Erica M.,39,0,45,6
1746594431400,EDS 204R,B01,895693,Halter; Christopher P.,10,0,45,35
1746594432429,EDS 206R,A00,895694,Fargason; Sharon Gayle,1,0,30,29
1746594432429,EDS 206R,B00,895695,Choi; Bailey Miyeon,16,0,30,14
1746594433456,EDS 250,A00,895697,Hemans; Patricia Ann Benitez,22,0,45,23
1746594434481,EDS 281,A00,895701,Meyerott; Theresa Ann,1,0,15,14
1746594435507,EDS 284,A00,895736,Meyerott; Theresa Ann,1,0,15,14
1746594436534,EDS 286,A00,897210,Fine; Sarah,0,0,15,15
1746594437562,EDS 289C,A01,895770,Daly; Alan J.,1,0,15,14
1746594438587,EDS 290,A00,897211,Hofstetter; Carolyn,0,0,15,15
1746594439612,LIGM 5A,A00,896162,Fischer-Grunski; Eva K,12,0,20,8
1746594440637,LIGM 5B,A00,896260,Fischer-Grunski; Eva K,17,0,20,3
1746594441665,LIGM 5C,A00,896308,Fischer-Grunski; Eva K,18,0,20,2
1746594442689,LIIT 5AS,A00,896313,Carnelos; Chiara,18,0,20,2
1746594443715,LIIT 5BS,A00,896416,Carnelos; Chiara,20,0,20,0
1746594444741,LIIT 5CS,A00,896564,Carnelos; Chiara,20,0,20,0
1746594445768,LISP 5A,A00,896588,Munoz Sanchez; Alicia,2,0,20,18
1746594446799,LISP 5B,A00,896653,Munoz Sanchez; Alicia,7,0,20,13
1746594447824,LISP 5C,A00,896655,Munoz Sanchez; Alicia,0,1,20,20
1746594448849,MAE 197,001,957918,Kleissl; Jan,9996,0,9999,3
1746594448849,MAE 197,002,959806,Boechler; Nicholas Sebastia,9998,0,9999,1
1746594448849,MAE 197,003,959852,Mullin; Jennifer S,9998,0,9999,1
1746594449874,MATH 2,A01,957937,Staff,33,0,35,2
1746594450899,MATH 197,001,957876,Kedlaya; Kiran S.,9993,0,9999,6
1746594451927,MCWP 40,A00,892729,Duru; Nur,10,0,20,10
1746594451927,MCWP 40,B00,893304,Montejo; Carolina,14,0,20,6
1746594452956,MCWP 40R,A00,893757,Redela; Pamela Morgan,0,5,20,20
1746594453982,MCWP 50,A00,893758,Morshed; Michael James,0,0,20,20
1746594453982,MCWP 50,B00,893761,Bartulis; Jason Michael,17,0,20,3
1746594455015,MCWP 50R,A00,893766,Compas; Sean Matthew,0,1,20,20
1746594455015,MCWP 50R,B00,893769,Carter; Jennifer A,0,1,20,20
1746594455015,MCWP 50R,C00,893771,Krone; Jarret,0,3,20,20
1746594455015,MCWP 50R,D00,893772,Miller; Elizabeth Deen,0,0,20,20
1746594455015,MCWP 50R,E00,893775,Carter; Andrea L,0,1,20,20
1746594456042,MMW 11R,A01,892721,Herbst; Matthew,14,0,30,16
1746594456042,MMW 11R,A02,892722,Herbst; Matthew,0,0,0,3
1746594457070,MMW 12R,A01,892724,Herbst; Matthew,0,11,16,16
1746594457070,MMW 12R,A02,892725,Herbst; Matthew,0,10,16,16
1746594458096,MMW 13R,A01,892727,Staff,0,4,16,16
1746594458096,MMW 13R,A02,892728,Staff,0,4,16,16
1746594458096,MMW 13R,A03,958032,Staff,0,4,16,16
1746594458096,MMW 13R,A04,958033,Staff,0,4,16,16
1746594458096,MMW 13R,A05,958034,Staff,0,4,16,16
1746594459122,SIO 295LS,A00,894015,Staff,5,0,25,20
1746594460150,SIO 295S,A00,894020,Staff,5,0,25,20
1746594461180,SIOC 290S,B01,958918,Merrifield; Mark A,14,0,30,16
1746594462207,SIOC 291S,B01,958922,Gabriel; Corey John,14,0,30,16
1746594463235,SOCI 117,A01,895339,Staff,2,0,5,3
1746594464264,WES 237B,A00,894149,Staff,11,0,20,9
1746594466320,AESE 279B,A00,891859,Staff,13,0,35,22
1746594467343,AIP 197,001,891854,Vespa; Emanuel Ignacio,9999,0,9999,0
1746594468372,ANTH 289S,A00,891856,Gagneux; Pascal,12,0,12,0
1746594469398,BENG 196,001,957946,Engler; Adam J.,9996,0,9999,3
1746594470422,BISP 197,001,959851,Wilhelm; James E.,9998,0,9999,1
1746594471450,CAT 124RS,A01,956906,Staff,6,0,25,19
1746594472475,CAT 125RS,A01,922013,Staff,6,0,25,19
1746594473501,CLRE 250,A00,891860,Morris; Sheldon,9995,0,9999,4
1746594475555,CLRE 251R,A00,907817,Mehta; Ravindra L.,9994,0,9999,5
1746594476581,CLRE 252,A00,891864,Cuomo; Raphael Eduardo,9993,0,9999,6
1746594477608,CLRE 253,A00,891867,Vaida; Florin,9994,0,9999,5
1746594477608,CLRE 253,B00,907819,Staff,9999,0,9999,0
1746594478638,CLRE 259,A00,891868,Patel; Hemal,9998,0,9999,1
1746594479665,CLRE 260,A00,891872,Cuomo; Raphael Eduardo,9999,0,9999,0
1746594480692,CLRE 297,001,891888,Cuomo; Raphael Eduardo,9999,0,9999,0
1746594481718,CSE 191,A00,958773,Minnes Kemp; Mor Mia,9995,0,9999,4
1746594482745,CSE 197,001,959846,Minnes Kemp; Mor Mia,9990,0,9999,9
1746594483776,CSS 201S,A01,892054,Mignozzetti; Umberto,25,0,30,5
1746594484806,CSS 202S,A01,892056,Mignozzetti; Umberto,25,0,30,5
1746594485831,DSC 197,001,956898,Eldridge; Justin Matthew,9996,0,9999,3
1746594486856,DSC 297,001,958000,Mazumdar; Arya,9998,0,9999,1
1746594486856,DSC 297,002,959862,Wang; Yusu,9998,0,9999,1
1746594487882,EAP 100,A00,905686,Staff,9778,0,9999,221
1746594488910,ECE 45,A01,892618,Staff,0,0,65,65
1746594490961,ECE 111,A01,892719,Staff,6,0,65,59
1746594491989,ECE 197,001,957920,Mercier; Patrick Philip,9991,0,9999,8
1746594493017,ECON 178,A01,907814,Zhu; Ying,26,0,35,9
1746594494041,EDS 115,A00,895312,Staff,35,0,45,10
1746594495071,EDS 117,A01,895337,Staff,23,0,30,7
1746594496097,EDS 125,A00,895341,Jones; Gabrielle Anastasia,36,0,45,9
1746594497120,EDS 128A,A01,895459,Fargason; Sharon Gayle,44,0,45,1
1746594498145,EDS 128B,A01,895543,Pappas; Elizabeth,44,0,45,1
1746594499170,EDS 139,A00,897203,Pappas; Elizabeth,44,0,45,1
1746594499170,EDS 139,B00,897209,Fargason; Sharon Gayle,41,0,45,4
1746594500195,EDS 201,A00,895545,Staff,22,0,45,23
1746594501221,EDS 203,A01,895581,Halter; Christopher P.,22,0,45,23
1746594502245,EDS 204R,A01,895625,Heinzman; Erica M.,39,0,45,6
1746594502245,EDS 204R,B01,895693,Halter; Christopher P.,10,0,45,35
1746594503272,EDS 206R,A00,895694,Fargason; Sharon Gayle,1,0,30,29
1746594503272,EDS 206R,B00,895695,Choi; Bailey Miyeon,16,0,30,14
1746594504297,EDS 250,A00,895697,Hemans; Patricia Ann Benitez,22,0,45,23
1746594505325,EDS 281,A00,895701,Meyerott; Theresa Ann,1,0,15,14
1746594506356,EDS 284,A00,895736,Meyerott; Theresa Ann,1,0,15,14
1746594507383,EDS 286,A00,897210,Fine; Sarah,0,0,15,15
1746594508407,EDS 289C,A01,895770,Daly; Alan J.,1,0,15,14
1746594509434,EDS 290,A00,897211,Hofstetter; Carolyn,0,0,15,15
1746594510462,LIGM 5A,A00,896162,Fischer-Grunski; Eva K,12,0,20,8
1746594511493,LIGM 5B,A00,896260,Fischer-Grunski; Eva K,17,0,20,3
1746594512517,LIGM 5C,A00,896308,Fischer-Grunski; Eva K,18,0,20,2
1746594513544,LIIT 5AS,A00,896313,Carnelos; Chiara,18,0,20,2
1746594514572,LIIT 5BS,A00,896416,Carnelos; Chiara,20,0,20,0
1746594515599,LIIT 5CS,A00,896564,Carnelos; Chiara,20,0,20,0
1746594516623,LISP 5A,A00,896588,Munoz Sanchez; Alicia,2,0,20,18
1746594517650,LISP 5B,A00,896653,Munoz Sanchez; Alicia,7,0,20,13
1746594518676,LISP 5C,A00,896655,Munoz Sanchez; Alicia,0,1,20,20
1746594519701,MAE 197,001,957918,Kleissl; Jan,9996,0,9999,3
1746594519701,MAE 197,002,959806,Boechler; Nicholas Sebastia,9998,0,9999,1
1746594519701,MAE 197,003,959852,Mullin; Jennifer S,9998,0,9999,1
1746594520730,MATH 2,A01,957937,Staff,33,0,35,2
1746594521755,MATH 197,001,957876,Kedlaya; Kiran S.,9993,0,9999,6
1746594522781,MCWP 40,A00,892729,Duru; Nur,10,0,20,10
1746594522781,MCWP 40,B00,893304,Montejo; Carolina,14,0,20,6
1746594523806,MCWP 40R,A00,893757,Redela; Pamela Morgan,0,5,20,20
1746594524832,MCWP 50,A00,893758,Morshed; Michael James,0,0,20,20
1746594524832,MCWP 50,B00,893761,Bartulis; Jason Michael,17,0,20,3
1746594525861,MCWP 50R,A00,893766,Compas; Sean Matthew,0,1,20,20
1746594525861,MCWP 50R,B00,893769,Carter; Jennifer A,0,1,20,20
1746594525861,MCWP 50R,C00,893771,Krone; Jarret,0,3,20,20
1746594525861,MCWP 50R,D00,893772,Miller; Elizabeth Deen,0,0,20,20
1746594525861,MCWP 50R,E00,893775,Carter; Andrea L,0,1,20,20
1746594526888,MMW 11R,A01,892721,Herbst; Matthew,14,0,30,16
1746594526888,MMW 11R,A02,892722,Herbst; Matthew,0,0,0,3
1746594527917,MMW 12R,A01,892724,Herbst; Matthew,0,11,16,16
1746594527917,MMW 12R,A02,892725,Herbst; Matthew,0,10,16,16
1746594528943,MMW 13R,A01,892727,Staff,0,4,16,16
1746594528943,MMW 13R,A02,892728,Staff,0,4,16,16
1746594528943,MMW 13R,A03,958032,Staff,0,4,16,16
1746594528943,MMW 13R,A04,958033,Staff,0,4,16,16
1746594528943,MMW 13R,A05,958034,Staff,0,4,16,16
1746594529967,SIO 295LS,A00,894015,Staff,5,0,25,20
1746594530995,SIO 295S,A00,894020,Staff,5,0,25,20
1746594532020,SIOC 290S,B01,958918,Merrifield; Mark A,14,0,30,16
1746594533049,SIOC 291S,B01,958922,Gabriel; Corey John,14,0,30,16
1746594534077,SOCI 117,A01,895339,Staff,2,0,5,3
1746594535102,WES 237B,A00,894149,Staff,11,0,20,9
1746594537162,AESE 279B,A00,891859,Staff,13,0,35,22
1746594538190,AIP 197,001,891854,Vespa; Emanuel Ignacio,9999,0,9999,0
1746594539218,ANTH 289S,A00,891856,Gagneux; Pascal,12,0,12,0
1746594540244,BENG 196,001,957946,Engler; Adam J.,9996,0,9999,3
1746594541267,BISP 197,001,959851,Wilhelm; James E.,9998,0,9999,1
1746594542293,CAT 124RS,A01,956906,Staff,6,0,25,19
1746594543322,CAT 125RS,A01,922013,Staff,6,0,25,19
1746594544348,CLRE 250,A00,891860,Morris; Sheldon,9995,0,9999,4
1746594546440,CLRE 251R,A00,907817,Mehta; Ravindra L.,9994,0,9999,5
1746594547468,CLRE 252,A00,891864,Cuomo; Raphael Eduardo,9993,0,9999,6
1746594548493,CLRE 253,A00,891867,Vaida; Florin,9994,0,9999,5
1746594548493,CLRE 253,B00,907819,Staff,9999,0,9999,0
1746594549517,CLRE 259,A00,891868,Patel; Hemal,9998,0,9999,1
1746594550541,CLRE 260,A00,891872,Cuomo; Raphael Eduardo,9999,0,9999,0
1746594551571,CLRE 297,001,891888,Cuomo; Raphael Eduardo,9999,0,9999,0
1746594552596,CSE 191,A00,958773,Minnes Kemp; Mor Mia,9995,0,9999,4
1746594553620,CSE 197,001,959846,Minnes Kemp; Mor Mia,9990,0,9999,9
1746594554646,CSS 201S,A01,892054,Mignozzetti; Umberto,25,0,30,5
1746594555675,CSS 202S,A01,892056,Mignozzetti; Umberto,25,0,30,5
1746594556702,DSC 197,001,956898,Eldridge; Justin Matthew,9996,0,9999,3
1746594557726,DSC 297,001,958000,Mazumdar; Arya,9998,0,9999,1
1746594557726,DSC 297,002,959862,Wang; Yusu,9998,0,9999,1
1746594558754,EAP 100,A00,905686,Staff,9778,0,9999,221
1746594559781,ECE 45,A01,892618,Staff,0,0,65,65
1746594561831,ECE 111,A01,892719,Staff,6,0,65,59
1746594562857,ECE 197,001,957920,Mercier; Patrick Philip,9991,0,9999,8
1746594563882,ECON 178,A01,907814,Zhu; Ying,26,0,35,9
1746594564909,EDS 115,A00,895312,Staff,35,0,45,10
1746594565933,EDS 117,A01,895337,Staff,23,0,30,7
1746594566961,EDS 125,A00,895341,Jones; Gabrielle Anastasia,36,0,45,9
1746594567987,EDS 128A,A01,895459,Fargason; Sharon Gayle,44,0,45,1
1746594569015,EDS 128B,A01,895543,Pappas; Elizabeth,44,0,45,1
1746594570045,EDS 139,A00,897203,Pappas; Elizabeth,44,0,45,1
1746594570045,EDS 139,B00,897209,Fargason; Sharon Gayle,41,0,45,4
1746594571071,EDS 201,A00,895545,Staff,22,0,45,23
1746594572095,EDS 203,A01,895581,Halter; Christopher P.,22,0,45,23
1746594573120,EDS 204R,A01,895625,Heinzman; Erica M.,39,0,45,6
1746594573120,EDS 204R,B01,895693,Halter; Christopher P.,10,0,45,35
1746594574149,EDS 206R,A00,895694,Fargason; Sharon Gayle,1,0,30,29
1746594574149,EDS 206R,B00,895695,Choi; Bailey Miyeon,16,0,30,14
1746594575174,EDS 250,A00,895697,Hemans; Patricia Ann Benitez,22,0,45,23
1746594576198,EDS 281,A00,895701,Meyerott; Theresa Ann,1,0,15,14
1746594577226,EDS 284,A00,895736,Meyerott; Theresa Ann,1,0,15,14
1746594578251,EDS 286,A00,897210,Fine; Sarah,0,0,15,15
1746594579277,EDS 289C,A01,895770,Daly; Alan J.,1,0,15,14
1746594580305,EDS 290,A00,897211,Hofstetter; Carolyn,0,0,15,15
1746594581332,LIGM 5A,A00,896162,Fischer-Grunski; Eva K,12,0,20,8
1746594582358,LIGM 5B,A00,896260,Fischer-Grunski; Eva K,17,0,20,3
1746594583384,LIGM 5C,A00,896308,Fischer-Grunski; Eva K,18,0,20,2
1746594584409,LIIT 5AS,A00,896313,Carnelos; Chiara,18,0,20,2
1746594585436,LIIT 5BS,A00,896416,Carnelos; Chiara,20,0,20,0
1746594586462,LIIT 5CS,A00,896564,Carnelos; Chiara,20,0,20,0
1746594587491,LISP 5A,A00,896588,Munoz Sanchez; Alicia,2,0,20,18
1746594588520,LISP 5B,A00,896653,Munoz Sanchez; Alicia,7,0,20,13
1746594589550,LISP 5C,A00,896655,Munoz Sanchez; Alicia,0,1,20,20
1746594590580,MAE 197,001,957918,Kleissl; Jan,9996,0,9999,3
1746594590580,MAE 197,002,959806,Boechler; Nicholas Sebastia,9998,0,9999,1
1746594590580,MAE 197,003,959852,Mullin; Jennifer S,9998,0,9999,1
1746594591604,MATH 2,A01,957937,Staff,33,0,35,2
1746594592629,MATH 197,001,957876,Kedlaya; Kiran S.,9993,0,9999,6
1746594593654,MCWP 40,A00,892729,Duru; Nur,10,0,20,10
1746594593654,MCWP 40,B00,893304,Montejo; Carolina,14,0,20,6
1746594594681,MCWP 40R,A00,893757,Redela; Pamela Morgan,0,5,20,20
1746594595708,MCWP 50,A00,893758,Morshed; Michael James,0,0,20,20
1746594595708,MCWP 50,B00,893761,Bartulis; Jason Michael,17,0,20,3
1746594596735,MCWP 50R,A00,893766,Compas; Sean Matthew,0,1,20,20
1746594596735,MCWP 50R,B00,893769,Carter; Jennifer A,0,1,20,20
1746594596735,MCWP 50R,C00,893771,Krone; Jarret,0,3,20,20
1746594596735,MCWP 50R,D00,893772,Miller; Elizabeth Deen,0,0,20,20
1746594596735,MCWP 50R,E00,893775,Carter; Andrea L,0,1,20,20
1746594597760,MMW 11R,A01,892721,Herbst; Matthew,14,0,30,16
1746594597760,MMW 11R,A02,892722,Herbst; Matthew,0,0,0,3
1746594598786,MMW 12R,A01,892724,Herbst; Matthew,0,11,16,16
1746594598786,MMW 12R,A02,892725,Herbst; Matthew,0,10,16,16
1746594599811,MMW 13R,A01,892727,Staff,0,4,16,16
1746594599811,MMW 13R,A02,892728,Staff,0,4,16,16
1746594599811,MMW 13R,A03,958032,Staff,0,4,16,16
1746594599811,MMW 13R,A04,958033,Staff,0,4,16,16
1746594599811,MMW 13R,A05,958034,Staff,0,4,16,16
1746594600841,SIO 295LS,A00,894015,Staff,5,0,25,20
1746594601872,SIO 295S,A00,894020,Staff,5,0,25,20
1746594602898,SIOC 290S,B01,958918,Merrifield; Mark A,14,0,30,16
1746594603923,SIOC 291S,B01,958922,Gabriel; Corey John,14,0,30,16
1746594604949,SOCI 117,A01,895339,Staff,2,0,5,3
1746594605976,WES 237B,A00,894149,Staff,11,0,20,9
1746594608033,AESE 279B,A00,891859,Staff,13,0,35,22
1746594609061,AIP 197,001,891854,Vespa; Emanuel Ignacio,9999,0,9999,0
1746594610087,ANTH 289S,A00,891856,Gagneux; Pascal,12,0,12,0
1746594611113,BENG 196,001,957946,Engler; Adam J.,9996,0,9999,3
1746594612138,BISP 197,001,959851,Wilhelm; James E.,9998,0,9999,1
1746594613161,CAT 124RS,A01,956906,Staff,6,0,25,19
1746594614189,CAT 125RS,A01,922013,Staff,6,0,25,19
1746594615215,CLRE 250,A00,891860,Morris; Sheldon,9995,0,9999,4
1746594617269,CLRE 251R,A00,907817,Mehta; Ravindra L.,9994,0,9999,5
1746594618297,CLRE 252,A00,891864,Cuomo; Raphael Eduardo,9993,0,9999,6
1746594619323,CLRE 253,A00,891867,Vaida; Florin,9994,0,9999,5
1746594619323,CLRE 253,B00,907819,Staff,9999,0,9999,0
1746594620350,CLRE 259,A00,891868,Patel; Hemal,9998,0,9999,1
1746594621375,CLRE 260,A00,891872,Cuomo; Raphael Eduardo,9999,0,9999,0
1746594622405,CLRE 297,001,891888,Cuomo; Raphael Eduardo,9999,0,9999,0
1746594623431,CSE 191,A00,958773,Minnes Kemp; Mor Mia,9995,0,9999,4
1746594624455,CSE 197,001,959846,Minnes Kemp; Mor Mia,9990,0,9999,9
1746594625485,CSS 201S,A01,892054,Mignozzetti; Umberto,25,0,30,5
1746594626514,CSS 202S,A01,892056,Mignozzetti; Umberto,25,0,30,5
1746594627539,DSC 197,001,956898,Eldridge; Justin Matthew,9996,0,9999,3
1746594628564,DSC 297,001,958000,Mazumdar; Arya,9998,0,9999,1
1746594628564,DSC 297,002,959862,Wang; Yusu,9998,0,9999,1
1746594629589,EAP 100,A00,905686,Staff,9778,0,9999,221
1746594630621,ECE 45,A01,892618,Staff,0,0,65,65
1746594632674,ECE 111,A01,892719,Staff,6,0,65,59
1746594633699,ECE 197,001,957920,Mercier; Patrick Philip,9991,0,9999,8
1746594634727,ECON 178,A01,907814,Zhu; Ying,26,0,35,9
1746594635755,EDS 115,A00,895312,Staff,35,0,45,10
1746594636782,EDS 117,A01,895337,Staff,23,0,30,7
1746594637807,EDS 125,A00,895341,Jones; Gabrielle Anastasia,36,0,45,9
1746594638837,EDS 128A,A01,895459,Fargason; Sharon Gayle,44,0,45,1
1746594639862,EDS 128B,A01,895543,Pappas; Elizabeth,44,0,45,1
1746594640888,EDS 139,A00,897203,Pappas; Elizabeth,44,0,45,1
1746594640888,EDS 139,B00,897209,Fargason; Sharon Gayle,41,0,45,4
1746594641914,EDS 201,A00,895545,Staff,22,0,45,23
1746594642940,EDS 203,A01,895581,Halter; Christopher P.,22,0,45,23
1746594643966,EDS 204R,A01,895625,Heinzman; Erica M.,39,0,45,6
1746594643966,EDS 204R,B01,895693,Halter; Christopher P.,10,0,45,35
1746594644992,EDS 206R,A00,895694,Fargason; Sharon Gayle,1,0,30,29
1746594644992,EDS 206R,B00,895695,Choi; Bailey Miyeon,16,0,30,14
1746594646020,EDS 250,A00,895697,Hemans; Patricia Ann Benitez,22,0,45,23
1746594647045,EDS 281,A00,895701,Meyerott; Theresa Ann,1,0,15,14
1746594648070,EDS 284,A00,895736,Meyerott; Theresa Ann,1,0,15,14
1746594649095,EDS 286,A00,897210,Fine; Sarah,0,0,15,15
1746594650179,EDS 289C,A01,895770,Daly; Alan J.,1,0,15,14
1746594651207,EDS 290,A00,897211,Hofstetter; Carolyn,0,0,15,15
1746594652234,LIGM 5A,A00,896162,Fischer-Grunski; Eva K,12,0,20,8
1746594653263,LIGM 5B,A00,896260,Fischer-Grunski; Eva K,17,0,20,3
1746594654291,LIGM 5C,A00,896308,Fischer-Grunski; Eva K,18,0,20,2
1746594655318,LIIT 5AS,A00,896313,Carnelos; Chiara,18,0,20,2
1746594656349,LIIT 5BS,A00,896416,Carnelos; Chiara,20,0,20,0
1746594657374,LIIT 5CS,A00,896564,Carnelos; Chiara,20,0,20,0
1746594658399,LISP 5A,A00,896588,Munoz Sanchez; Alicia,2,0,20,18
1746594659427,LISP 5B,A00,896653,Munoz Sanchez; Alicia,7,0,20,13
1746594660453,LISP 5C,A00,896655,Munoz Sanchez; Alicia,0,1,20,20
1746594661481,MAE 197,001,957918,Kleissl; Jan,9996,0,9999,3
1746594661481,MAE 197,002,959806,Boechler; Nicholas Sebastia,9998,0,9999,1
1746594661481,MAE 197,003,959852,Mullin; Jennifer S,9998,0,9999,1
1746594662507,MATH 2,A01,957937,Staff,33,0,35,2
1746594663533,MATH 197,001,957876,Kedlaya; Kiran S.,9993,0,9999,6
1746594664558,MCWP 40,A00,892729,Duru; Nur,10,0,20,10
1746594664558,MCWP 40,B00,893304,Montejo; Carolina,14,0,20,6
1746594665584,MCWP 40R,A00,893757,Redela; Pamela Morgan,0,5,20,20
1746594666613,MCWP 50,A00,893758,Morshed; Michael James,0,0,20,20
1746594666613,MCWP 50,B00,893761,Bartulis; Jason Michael,17,0,20,3
1746594667639,MCWP 50R,A00,893766,Compas; Sean Matthew,0,1,20,20
1746594667639,MCWP 50R,B00,893769,Carter; Jennifer A,0,1,20,20
1746594667639,MCWP 50R,C00,893771,Krone; Jarret,0,3,20,20
1746594667639,MCWP 50R,D00,893772,Miller; Elizabeth Deen,0,0,20,20
1746594667639,MCWP 50R,E00,893775,Carter; Andrea L,0,1,20,20
1746594668665,MMW 11R,A01,892721,Herbst; Matthew,14,0,30,16
1746594668665,MMW 11R,A02,892722,Herbst; Matthew,0,0,0,3
1746594669691,MMW 12R,A01,892724,Herbst; Matthew,0,11,16,16
1746594669691,MMW 12R,A02,892725,Herbst; Matthew,0,10,16,16
1746594670719,MMW 13R,A01,892727,Staff,0,4,16,16
1746594670719,MMW 13R,A02,892728,Staff,0,4,16,16
1746594670719,MMW 13R,A03,958032,Staff,0,4,16,16
1746594670719,MMW 13R,A04,958033,Staff,0,4,16,16
1746594670719,MMW 13R,A05,958034,Staff,0,4,16,16
1746594671744,SIO 295LS,A00,894015,Staff,5,0,25,20
1746594672768,SIO 295S,A00,894020,Staff,5,0,25,20
1746594673794,SIOC 290S,B01,958918,Merrifield; Mark A,14,0,30,16
1746594674824,SIOC 291S,B01,958922,Gabriel; Corey John,14,0,30,16
1746594675850,SOCI 117,A01,895339,Staff,2,0,5,3
1746594676876,WES 237B,A00,894149,Staff,11,0,20,9
1746594678930,AESE 279B,A00,891859,Staff,13,0,35,22
1746594679957,AIP 197,001,891854,Vespa; Emanuel Ignacio,9999,0,9999,0
1746594680983,ANTH 289S,A00,891856,Gagneux; Pascal,12,0,12,0
1746594682009,BENG 196,001,957946,Engler; Adam J.,9996,0,9999,3
1746594683039,BISP 197,001,959851,Wilhelm; James E.,9998,0,9999,1
1746594684064,CAT 124RS,A01,956906,Staff,6,0,25,19
1746594685093,CAT 125RS,A01,922013,Staff,6,0,25,19
1746594686119,CLRE 250,A00,891860,Morris; Sheldon,9995,0,9999,4
1746594688173,CLRE 251R,A00,907817,Mehta; Ravindra L.,9994,0,9999,5
1746594689198,CLRE 252,A00,891864,Cuomo; Raphael Eduardo,9993,0,9999,6
1746594690225,CLRE 253,A00,891867,Vaida; Florin,9994,0,9999,5
1746594690225,CLRE 253,B00,907819,Staff,9999,0,9999,0
1746594691250,CLRE 259,A00,891868,Patel; Hemal,9998,0,9999,1
1746594692276,CLRE 260,A00,891872,Cuomo; Raphael Eduardo,9999,0,9999,0
1746594693303,CLRE 297,001,891888,Cuomo; Raphael Eduardo,9999,0,9999,0
1746594694327,CSE 191,A00,958773,Minnes Kemp; Mor Mia,9995,0,9999,4
1746594695353,CSE 197,001,959846,Minnes Kemp; Mor Mia,9990,0,9999,9
1746594696379,CSS 201S,A01,892054,Mignozzetti; Umberto,25,0,30,5
1746594697403,CSS 202S,A01,892056,Mignozzetti; Umberto,25,0,30,5
1746594698431,DSC 197,001,956898,Eldridge; Justin Matthew,9996,0,9999,3
1746594699461,DSC 297,001,958000,Mazumdar; Arya,9998,0,9999,1
1746594699461,DSC 297,002,959862,Wang; Yusu,9998,0,9999,1
1746594700488,EAP 100,A00,905686,Staff,9778,0,9999,221
1746594701519,ECE 45,A01,892618,Staff,0,0,65,65
1746594703574,ECE 111,A01,892719,Staff,6,0,65,59
1746594704600,ECE 197,001,957920,Mercier; Patrick Philip,9991,0,9999,8
1746594705625,ECON 178,A01,907814,Zhu; Ying,26,0,35,9
1746594706649,EDS 115,A00,895312,Staff,35,0,45,10
1746594707675,EDS 117,A01,895337,Staff,23,0,30,7
1746594708703,EDS 125,A00,895341,Jones; Gabrielle Anastasia,36,0,45,9
1746594709729,EDS 128A,A01,895459,Fargason; Sharon Gayle,44,0,45,1
1746594710755,EDS 128B,A01,895543,Pappas; Elizabeth,44,0,45,1
1746594711781,EDS 139,A00,897203,Pappas; Elizabeth,44,0,45,1
1746594711781,EDS 139,B00,897209,Fargason; Sharon Gayle,41,0,45,4
1746594712806,EDS 201,A00,895545,Staff,22,0,45,23
1746594713832,EDS 203,A01,895581,Halter; Christopher P.,22,0,45,23
1746594714859,EDS 204R,A01,895625,Heinzman; Erica M.,39,0,45,6
1746594714859,EDS 204R,B01,895693,Halter; Christopher P.,10,0,45,35
1746594715888,EDS 206R,A00,895694,Fargason; Sharon Gayle,1,0,30,29
1746594715888,EDS 206R,B00,895695,Choi; Bailey Miyeon,16,0,30,14
1746594716913,EDS 250,A00,895697,Hemans; Patricia Ann Benitez,22,0,45,23
1746594717945,EDS 281,A00,895701,Meyerott; Theresa Ann,1,0,15,14
1746594718972,EDS 284,A00,895736,Meyerott; Theresa Ann,1,0,15,14
1746594719998,EDS 286,A00,897210,Fine; Sarah,0,0,15,15
1746594721027,EDS 289C,A01,895770,Daly; Alan J.,1,0,15,14
1746594722053,EDS 290,A00,897211,Hofstetter; Carolyn,0,0,15,15
1746594723077,LIGM 5A,A00,896162,Fischer-Grunski; Eva K,12,0,20,8
1746594724105,LIGM 5B,A00,896260,Fischer-Grunski; Eva K,17,0,20,3
1746594725131,LIGM 5C,A00,896308,Fischer-Grunski; Eva K,18,0,20,2
1746594726160,LIIT 5AS,A00,896313,Carnelos; Chiara,18,0,20,2
1746594727187,LIIT 5BS,A00,896416,Carnelos; Chiara,20,0,20,0
1746594728212,LIIT 5CS,A00,896564,Carnelos; Chiara,20,0,20,0
1746594729239,LISP 5A,A00,896588,Munoz Sanchez; Alicia,2,0,20,18
1746594730264,LISP 5B,A00,896653,Munoz Sanchez; Alicia,7,0,20,13
1746594731290,LISP 5C,A00,896655,Munoz Sanchez; Alicia,0,1,20,20
1746594732317,MAE 197,001,957918,Kleissl; Jan,9996,0,9999,3
1746594732317,MAE 197,002,959806,Boechler; Nicholas Sebastia,9998,0,9999,1
1746594732317,MAE 197,003,959852,Mullin; Jennifer S,9998,0,9999,1
1746594733342,MATH 2,A01,957937,Staff,33,0,35,2
1746594734369,MATH 197,001,957876,Kedlaya; Kiran S.,9993,0,9999,6
1746594735394,MCWP 40,A00,892729,Duru; Nur,10,0,20,10
1746594735394,MCWP 40,B00,893304,Montejo; Carolina,14,0,20,6
1746594736419,MCWP 40R,A00,893757,Redela; Pamela Morgan,0,5,20,20
1746594737448,MCWP 50,A00,893758,Morshed; Michael James,0,0,20,20
1746594737448,MCWP 50,B00,893761,Bartulis; Jason Michael,17,0,20,3
1746594738476,MCWP 50R,A00,893766,Compas; Sean Matthew,0,1,20,20
1746594738476,MCWP 50R,B00,893769,Carter; Jennifer A,0,1,20,20
1746594738476,MCWP 50R,C00,893771,Krone; Jarret,0,3,20,20
1746594738476,MCWP 50R,D00,893772,Miller; Elizabeth Deen,0,0,20,20
1746594738476,MCWP 50R,E00,893775,Carter; Andrea L,0,1,20,20
1746594739501,MMW 11R,A01,892721,Herbst; Matthew,14,0,30,16
1746594739501,MMW 11R,A02,892722,Herbst; Matthew,0,0,0,3
1746594740528,MMW 12R,A01,892724,Herbst; Matthew,0,11,16,16
1746594740528,MMW 12R,A02,892725,Herbst; Matthew,0,10,16,16
1746594741553,MMW 13R,A01,892727,Staff,0,4,16,16
1746594741553,MMW 13R,A02,892728,Staff,0,4,16,16
1746594741553,MMW 13R,A03,958032,Staff,0,4,16,16
1746594741553,MMW 13R,A04,958033,Staff,0,4,16,16
1746594741553,MMW 13R,A05,958034,Staff,0,4,16,16
1746594742582,SIO 295LS,A00,894015,Staff,5,0,25,20
1746594743611,SIO 295S,A00,894020,Staff,5,0,25,20
1746594744643,SIOC 290S,B01,958918,Merrifield; Mark A,14,0,30,16
1746594745675,SIOC 291S,B01,958922,Gabriel; Corey John,14,0,30,16
1746594746701,SOCI 117,A01,895339,Staff,2,0,5,3
1746594747729,WES 237B,A00,894149,Staff,11,0,20,9
1746594749801,AESE 279B,A00,891859,Staff,13,0,35,22
1746594750827,AIP 197,001,891854,Vespa; Emanuel Ignacio,9999,0,9999,0
1746594751854,ANTH 289S,A00,891856,Gagneux; Pascal,12,0,12,0
1746594752880,BENG 196,001,957946,Engler; Adam J.,9996,0,9999,3
1746594753950,BISP 197,001,959851,Wilhelm; James E.,9998,0,9999,1
1746594754975,CAT 124RS,A01,956906,Staff,6,0,25,19
1746594756002,CAT 125RS,A01,922013,Staff,6,0,25,19
1746594757028,CLRE 250,A00,891860,Morris; Sheldon,9995,0,9999,4
1746594759082,CLRE 251R,A00,907817,Mehta; Ravindra L.,9994,0,9999,5
1746594760108,CLRE 252,A00,891864,Cuomo; Raphael Eduardo,9993,0,9999,6
1746594761134,CLRE 253,A00,891867,Vaida; Florin,9994,0,9999,5
1746594761134,CLRE 253,B00,907819,Staff,9999,0,9999,0
1746594762163,CLRE 259,A00,891868,Patel; Hemal,9998,0,9999,1
1746594763188,CLRE 260,A00,891872,Cuomo; Raphael Eduardo,9999,0,9999,0
1746594764215,CLRE 297,001,891888,Cuomo; Raphael Eduardo,9999,0,9999,0
1746594765240,CSE 191,A00,958773,Minnes Kemp; Mor Mia,9995,0,9999,4
1746594766267,CSE 197,001,959846,Minnes Kemp; Mor Mia,9990,0,9999,9
1746594767297,CSS 201S,A01,892054,Mignozzetti; Umberto,25,0,30,5
1746594768321,CSS 202S,A01,892056,Mignozzetti; Umberto,25,0,30,5
1746594769349,DSC 197,001,956898,Eldridge; Justin Matthew,9996,0,9999,3
1746594770375,DSC 297,001,958000,Mazumdar; Arya,9998,0,9999,1
1746594770375,DSC 297,002,959862,Wang; Yusu,9998,0,9999,1
1746594771403,EAP 100,A00,905686,Staff,9778,0,9999,221
1746594772431,ECE 45,A01,892618,Staff,0,0,65,65
1746594774483,ECE 111,A01,892719,Staff,6,0,65,59
1746594775554,ECE 197,001,957920,Mercier; Patrick Philip,9991,0,9999,8
1746594776583,ECON 178,A01,907814,Zhu; Ying,26,0,35,9
1746594777609,EDS 115,A00,895312,Staff,35,0,45,10
1746594778634,EDS 117,A01,895337,Staff,23,0,30,7
1746594779663,EDS 125,A00,895341,Jones; Gabrielle Anastasia,36,0,45,9
1746594780695,EDS 128A,A01,895459,Fargason; Sharon Gayle,44,0,45,1
1746594781721,EDS 128B,A01,895543,Pappas; Elizabeth,44,0,45,1
1746594782749,EDS 139,A00,897203,Pappas; Elizabeth,44,0,45,1
1746594782749,EDS 139,B00,897209,Fargason; Sharon Gayle,41,0,45,4
1746594783777,EDS 201,A00,895545,Staff,22,0,45,23
1746594784803,EDS 203,A01,895581,Halter; Christopher P.,22,0,45,23
1746594785830,EDS 204R,A01,895625,Heinzman; Erica M.,39,0,45,6
1746594785830,EDS 204R,B01,895693,Halter; Christopher P.,10,0,45,35
1746594786856,EDS 206R,A00,895694,Fargason; Sharon Gayle,1,0,30,29
1746594786856,EDS 206R,B00,895695,Choi; Bailey Miyeon,16,0,30,14
1746594787885,EDS 250,A00,895697,Hemans; Patricia Ann Benitez,22,0,45,23
1746594788910,EDS 281,A00,895701,Meyerott; Theresa Ann,1,0,15,14
1746594789936,EDS 284,A00,895736,Meyerott; Theresa Ann,1,0,15,14
1746594790963,EDS 286,A00,897210,Fine; Sarah,0,0,15,15
1746594791988,EDS 289C,A01,895770,Daly; Alan J.,1,0,15,14
1746594793013,EDS 290,A00,897211,Hofstetter; Carolyn,0,0,15,15
1746594794039,LIGM 5A,A00,896162,Fischer-Grunski; Eva K,12,0,20,8
1746594795066,LIGM 5B,A00,896260,Fischer-Grunski; Eva K,17,0,20,3
1746594796095,LIGM 5C,A00,896308,Fischer-Grunski; Eva K,18,0,20,2
1746594797125,LIIT 5AS,A00,896313,Carnelos; Chiara,18,0,20,2
1746594798152,LIIT 5BS,A00,896416,Carnelos; Chiara,20,0,20,0
1746594799182,LIIT 5CS,A00,896564,Carnelos; Chiara,20,0,20,0
1746594800212,LISP 5A,A00,896588,Munoz Sanchez; Alicia,2,0,20,18
1746594801241,LISP 5B,A00,896653,Munoz Sanchez; Alicia,7,0,20,13
1746594802267,LISP 5C,A00,896655,Munoz Sanchez; Alicia,0,1,20,20
1746594803295,MAE 197,001,957918,Kleissl; Jan,9996,0,9999,3
1746594803295,MAE 197,002,959806,Boechler; Nicholas Sebastia,9998,0,9999,1
1746594803295,MAE 197,003,959852,Mullin; Jennifer S,9998,0,9999,1
1746594804323,MATH 2,A01,957937,Staff,33,0,35,2
1746594805350,MATH 197,001,957876,Kedlaya; Kiran S.,9993,0,9999,6
1746594806375,MCWP 40,A00,892729,Duru; Nur,10,0,20,10
1746594806375,MCWP 40,B00,893304,Montejo; Carolina,14,0,20,6
1746594807402,MCWP 40R,A00,893757,Redela; Pamela Morgan,0,5,20,20
1746594808426,MCWP 50,A00,893758,Morshed; Michael James,0,0,20,20
1746594808426,MCWP 50,B00,893761,Bartulis; Jason Michael,17,0,20,3
1746594809455,MCWP 50R,A00,893766,Compas; Sean Matthew,0,1,20,20
1746594809455,MCWP 50R,B00,893769,Carter; Jennifer A,0,1,20,20
1746594809455,MCWP 50R,C00,893771,Krone; Jarret,0,3,20,20
1746594809455,MCWP 50R,D00,893772,Miller; Elizabeth Deen,0,0,20,20
1746594809455,MCWP 50R,E00,893775,Carter; Andrea L,0,1,20,20
1746594810482,MMW 11R,A01,892721,Herbst; Matthew,14,0,30,16
1746594810482,MMW 11R,A02,892722,Herbst; Matthew,0,0,0,3
1746594811507,MMW 12R,A01,892724,Herbst; Matthew,0,11,16,16
1746594811507,MMW 12R,A02,892725,Herbst; Matthew,0,10,16,16
1746594812535,MMW 13R,A01,892727,Staff,0,4,16,16
1746594812535,MMW 13R,A02,892728,Staff,0,4,16,16
1746594812535,MMW 13R,A03,958032,Staff,0,4,16,16
1746594812535,MMW 13R,A04,958033,Staff,0,4,16,16
1746594812535,MMW 13R,A05,958034,Staff,0,4,16,16
1746594813561,SIO 295LS,A00,894015,Staff,5,0,25,20
1746594814589,SIO 295S,A00,894020,Staff,5,0,25,20
1746594815621,SIOC 290S,B01,958918,Merrifield; Mark A,14,0,30,16
1746594816649,SIOC 291S,B01,958922,Gabriel; Corey John,14,0,30,16
1746594817674,SOCI 117,A01,895339,Staff,2,0,5,3
1746594818699,WES 237B,A00,894149,Staff,11,0,20,9
1746594820766,AESE 279B,A00,891859,Staff,13,0,35,22
1746594821792,AIP 197,001,891854,Vespa; Emanuel Ignacio,9999,0,9999,0
1746594822820,ANTH 289S,A00,891856,Gagneux; Pascal,12,0,12,0
1746594823846,BENG 196,001,957946,Engler; Adam J.,9996,0,9999,3
1746594824873,BISP 197,001,959851,Wilhelm; James E.,9998,0,9999,1
1746594825899,CAT 124RS,A01,956906,Staff,6,0,25,19
1746594826926,CAT 125RS,A01,922013,Staff,6,0,25,19
1746594827954,CLRE 250,A00,891860,Morris; Sheldon,9995,0,9999,4
1746594830007,CLRE 251R,A00,907817,Mehta; Ravindra L.,9994,0,9999,5
1746594831035,CLRE 252,A00,891864,Cuomo; Raphael Eduardo,9993,0,9999,6
1746594832060,CLRE 253,A00,891867,Vaida; Florin,9994,0,9999,5
1746594832060,CLRE 253,B00,907819,Staff,9999,0,9999,0
1746594833086,CLRE 259,A00,891868,Patel; Hemal,9998,0,9999,1
1746594834111,CLRE 260,A00,891872,Cuomo; Raphael Eduardo,9999,0,9999,0
1746594835139,CLRE 297,001,891888,Cuomo; Raphael Eduardo,9999,0,9999,0
1746594836164,CSE 191,A00,958773,Minnes Kemp; Mor Mia,9995,0,9999,4
1746594837188,CSE 197,001,959846,Minnes Kemp; Mor Mia,9990,0,9999,9
1746594838216,CSS 201S,A01,892054,Mignozzetti; Umberto,25,0,30,5
1746594839240,CSS 202S,A01,892056,Mignozzetti; Umberto,25,0,30,5
1746594840269,DSC 197,001,956898,Eldridge; Justin Matthew,9996,0,9999,3
1746594841293,DSC 297,001,958000,Mazumdar; Arya,9998,0,9999,1
1746594841293,DSC 297,002,959862,Wang; Yusu,9998,0,9999,1
1746594842319,EAP 100,A00,905686,Staff,9778,0,9999,221
1746594843346,ECE 45,A01,892618,Staff,0,0,65,65
1746594845397,ECE 111,A01,892719,Staff,6,0,65,59
1746594846422,ECE 197,001,957920,Mercier; Patrick Philip,9991,0,9999,8
1746594847448,ECON 178,A01,907814,Zhu; Ying,26,0,35,9
1746594848477,EDS 115,A00,895312,Staff,35,0,45,10
1746594849502,EDS 117,A01,895337,Staff,23,0,30,7
1746594850528,EDS 125,A00,895341,Jones; Gabrielle Anastasia,36,0,45,9
1746594851553,EDS 128A,A01,895459,Fargason; Sharon Gayle,44,0,45,1
1746594852580,EDS 128B,A01,895543,Pappas; Elizabeth,44,0,45,1
1746594853605,EDS 139,A00,897203,Pappas; Elizabeth,44,0,45,1
1746594853605,EDS 139,B00,897209,Fargason; Sharon Gayle,41,0,45,4
1746594854635,EDS 201,A00,895545,Staff,22,0,45,23
1746594855662,EDS 203,A01,895581,Halter; Christopher P.,22,0,45,23
1746594856688,EDS 204R,A01,895625,Heinzman; Erica M.,39,0,45,6
1746594856688,EDS 204R,B01,895693,Halter; Christopher P.,10,0,45,35
1746594857752,EDS 206R,A00,895694,Fargason; Sharon Gayle,1,0,30,29
1746594857752,EDS 206R,B00,895695,Choi; Bailey Miyeon,16,0,30,14
1746594858781,EDS 250,A00,895697,Hemans; Patricia Ann Benitez,22,0,45,23
1746594859807,EDS 281,A00,895701,Meyerott; Theresa Ann,1,0,15,14
1746594860834,EDS 284,A00,895736,Meyerott; Theresa Ann,1,0,15,14
1746594861864,EDS 286,A00,897210,Fine; Sarah,0,0,15,15
1746594862888,EDS 289C,A01,895770,Daly; Alan J.,1,0,15,14
1746594863915,EDS 290,A00,897211,Hofstetter; Carolyn,0,0,15,15
1746594864945,LIGM 5A,A00,896162,Fischer-Grunski; Eva K,12,0,20,8
1746594865973,LIGM 5B,A00,896260,Fischer-Grunski; Eva K,17,0,20,3
1746594866999,LIGM 5C,A00,896308,Fischer-Grunski; Eva K,18,0,20,2
1746594868025,LIIT 5AS,A00,896313,Carnelos; Chiara,18,0,20,2
1746594869051,LIIT 5BS,A00,896416,Carnelos; Chiara,20,0,20,0
1746594870078,LIIT 5CS,A00,896564,Carnelos; Chiara,20,0,20,0
1746594871104,LISP 5A,A00,896588,Munoz Sanchez; Alicia,2,0,20,18
1746594872131,LISP 5B,A00,896653,Munoz Sanchez; Alicia,7,0,20,13
1746594873158,LISP 5C,A00,896655,Munoz Sanchez; Alicia,0,1,20,20
1746594874185,MAE 197,001,957918,Kleissl; Jan,9996,0,9999,3
1746594874185,MAE 197,002,959806,Boechler; Nicholas Sebastia,9998,0,9999,1
1746594874185,MAE 197,003,959852,Mullin; Jennifer S,9998,0,9999,1
1746594875279,MATH 2,A01,957937,Staff,33,0,35,2
1746594876305,MATH 197,001,957876,Kedlaya; Kiran S.,9993,0,9999,6
1746594877331,MCWP 40,A00,892729,Duru; Nur,10,0,20,10
1746594877331,MCWP 40,B00,893304,Montejo; Carolina,14,0,20,6
1746594878358,MCWP 40R,A00,893757,Redela; Pamela Morgan,0,5,20,20
1746594879387,MCWP 50,A00,893758,Morshed; Michael James,0,0,20,20
1746594879387,MCWP 50,B00,893761,Bartulis; Jason Michael,17,0,20,3
1746594880414,MCWP 50R,A00,893766,Compas; Sean Matthew,0,1,20,20
1746594880414,MCWP 50R,B00,893769,Carter; Jennifer A,0,1,20,20
1746594880414,MCWP 50R,C00,893771,Krone; Jarret,0,3,20,20
1746594880414,MCWP 50R,D00,893772,Miller; Elizabeth Deen,0,0,20,20
1746594880414,MCWP 50R,E00,893775,Carter; Andrea L,0,1,20,20
1746594881442,MMW 11R,A01,892721,Herbst; Matthew,14,0,30,16
1746594881442,MMW 11R,A02,892722,Herbst; Matthew,0,0,0,3
1746594882469,MMW 12R,A01,892724,Herbst; Matthew,0,11,16,16
1746594882469,MMW 12R,A02,892725,Herbst; Matthew,0,10,16,16
1746594883499,MMW 13R,A01,892727,Staff,0,4,16,16
1746594883499,MMW 13R,A02,892728,Staff,0,4,16,16
1746594883499,MMW 13R,A03,958032,Staff,0,4,16,16
1746594883499,MMW 13R,A04,958033,Staff,0,4,16,16
1746594883499,MMW 13R,A05,958034,Staff,0,4,16,16
1746594884525,SIO 295LS,A00,894015,Staff,5,0,25,20
1746594885551,SIO 295S,A00,894020,Staff,5,0,25,20
1746594886576,SIOC 290S,B01,958918,Merrifield; Mark A,14,0,30,16
1746594887602,SIOC 291S,B01,958922,Gabriel; Corey John,14,0,30,16
1746594888631,SOCI 117,A01,895339,Staff,2,0,5,3
1746594889656,WES 237B,A00,894149,Staff,11,0,20,9
1746594891727,AESE 279B,A00,891859,Staff,13,0,35,22
1746594892753,AIP 197,001,891854,Vespa; Emanuel Ignacio,9999,0,9999,0
1746594893778,ANTH 289S,A00,891856,Gagneux; Pascal,12,0,12,0
1746594894808,BENG 196,001,957946,Engler; Adam J.,9996,0,9999,3
1746594895835,BISP 197,001,959851,Wilhelm; James E.,9998,0,9999,1
1746594896861,CAT 124RS,A01,956906,Staff,6,0,25,19
1746594897891,CAT 125RS,A01,922013,Staff,6,0,25,19
1746594898916,CLRE 250,A00,891860,Morris; Sheldon,9995,0,9999,4
1746594900969,CLRE 251R,A00,907817,Mehta; Ravindra L.,9994,0,9999,5
1746594901998,CLRE 252,A00,891864,Cuomo; Raphael Eduardo,9993,0,9999,6
1746594903027,CLRE 253,A00,891867,Vaida; Florin,9994,0,9999,5
1746594903027,CLRE 253,B00,907819,Staff,9999,0,9999,0
1746594904053,CLRE 259,A00,891868,Patel; Hemal,9998,0,9999,1
1746594905078,CLRE 260,A00,891872,Cuomo; Raphael Eduardo,9999,0,9999,0
1746594906106,CLRE 297,001,891888,Cuomo; Raphael Eduardo,9999,0,9999,0
1746594907133,CSE 191,A00,958773,Minnes Kemp; Mor Mia,9995,0,9999,4
1746594908158,CSE 197,001,959846,Minnes Kemp; Mor Mia,9990,0,9999,9
1746594909187,CSS 201S,A01,892054,Mignozzetti; Umberto,25,0,30,5
1746594910211,CSS 202S,A01,892056,Mignozzetti; Umberto,25,0,30,5
1746594911239,DSC 197,001,956898,Eldridge; Justin Matthew,9996,0,9999,3
1746594912264,DSC 297,001,958000,Mazumdar; Arya,9998,0,9999,1
1746594912264,DSC 297,002,959862,Wang; Yusu,9998,0,9999,1
1746594913292,EAP 100,A00,905686,Staff,9778,0,9999,221
1746594914320,ECE 45,A01,892618,Staff,0,0,65,65
1746594916373,ECE 111,A01,892719,Staff,6,0,65,59
1746594917401,ECE 197,001,957920,Mercier; Patrick Philip,9991,0,9999,8
1746594918427,ECON 178,A01,907814,Zhu; Ying,26,0,35,9
1746594919454,EDS 115,A00,895312,Staff,35,0,45,10
1746594920479,EDS 117,A01,895337,Staff,23,0,30,7
1746594921504,EDS 125,A00,895341,Jones; Gabrielle Anastasia,36,0,45,9
1746594922534,EDS 128A,A01,895459,Fargason; Sharon Gayle,44,0,45,1
1746594923560,EDS 128B,A01,895543,Pappas; Elizabeth,44,0,45,1
1746594924584,EDS 139,A00,897203,Pappas; Elizabeth,44,0,45,1
1746594924584,EDS 139,B00,897209,Fargason; Sharon Gayle,41,0,45,4
1746594925613,EDS 201,A00,895545,Staff,22,0,45,23
1746594926640,EDS 203,A01,895581,Halter; Christopher P.,22,0,45,23
1746594927664,EDS 204R,A01,895625,Heinzman; Erica M.,39,0,45,6
1746594927664,EDS 204R,B01,895693,Halter; Christopher P.,10,0,45,35
1746594928690,EDS 206R,A00,895694,Fargason; Sharon Gayle,1,0,30,29
1746594928690,EDS 206R,B00,895695,Choi; Bailey Miyeon,16,0,30,14
1746594929721,EDS 250,A00,895697,Hemans; Patricia Ann Benitez,22,0,45,23
1746594930748,EDS 281,A00,895701,Meyerott; Theresa Ann,1,0,15,14
1746594931773,EDS 284,A00,895736,Meyerott; Theresa Ann,1,0,15,14
1746594932798,EDS 286,A00,897210,Fine; Sarah,0,0,15,15
1746594933826,EDS 289C,A01,895770,Daly; Alan J.,1,0,15,14
1746594934855,EDS 290,A00,897211,Hofstetter; Carolyn,0,0,15,15
1746594935882,LIGM 5A,A00,896162,Fischer-Grunski; Eva K,12,0,20,8
1746594936912,LIGM 5B,A00,896260,Fischer-Grunski; Eva K,17,0,20,3
1746594937941,LIGM 5C,A00,896308,Fischer-Grunski; Eva K,18,0,20,2
1746594938966,LIIT 5AS,A00,896313,Carnelos; Chiara,18,0,20,2
1746594939995,LIIT 5BS,A00,896416,Carnelos; Chiara,20,0,20,0
1746594941025,LIIT 5CS,A00,896564,Carnelos; Chiara,20,0,20,0
1746594942054,LISP 5A,A00,896588,Munoz Sanchez; Alicia,2,0,20,18
1746594943080,LISP 5B,A00,896653,Munoz Sanchez; Alicia,7,0,20,13
1746594944105,LISP 5C,A00,896655,Munoz Sanchez; Alicia,0,1,20,20
1746594945135,MAE 197,001,957918,Kleissl; Jan,9996,0,9999,3
1746594945135,MAE 197,002,959806,Boechler; Nicholas Sebastia,9998,0,9999,1
1746594945135,MAE 197,003,959852,Mullin; Jennifer S,9998,0,9999,1
1746594946161,MATH 2,A01,957937,Staff,33,0,35,2
1746594947188,MATH 197,001,957876,Kedlaya; Kiran S.,9993,0,9999,6
1746594948215,MCWP 40,A00,892729,Duru; Nur,10,0,20,10
1746594948215,MCWP 40,B00,893304,Montejo; Carolina,14,0,20,6
1746594949240,MCWP 40R,A00,893757,Redela; Pamela Morgan,0,5,20,20
1746594950269,MCWP 50,A00,893758,Morshed; Michael James,0,0,20,20
1746594950269,MCWP 50,B00,893761,Bartulis; Jason Michael,17,0,20,3
1746594951301,MCWP 50R,A00,893766,Compas; Sean Matthew,0,1,20,20
1746594951301,MCWP 50R,B00,893769,Carter; Jennifer A,0,1,20,20
1746594951301,MCWP 50R,C00,893771,Krone; Jarret,0,3,20,20
1746594951301,MCWP 50R,D00,893772,Miller; Elizabeth Deen,0,0,20,20
1746594951301,MCWP 50R,E00,893775,Carter; Andrea L,0,1,20,20
1746594952331,MMW 11R,A01,892721,Herbst; Matthew,14,0,30,16
1746594952331,MMW 11R,A02,892722,Herbst; Matthew,0,0,0,3
1746594953362,MMW 12R,A01,892724,Herbst; Matthew,0,11,16,16
1746594953362,MMW 12R,A02,892725,Herbst; Matthew,0,10,16,16
1746594954388,MMW 13R,A01,892727,Staff,0,4,16,16
1746594954388,MMW 13R,A02,892728,Staff,0,4,16,16
1746594954388,MMW 13R,A03,958032,Staff,0,4,16,16
1746594954388,MMW 13R,A04,958033,Staff,0,4,16,16
1746594954388,MMW 13R,A05,958034,Staff,0,4,16,16
1746594955414,SIO 295LS,A00,894015,Staff,5,0,25,20
1746594956442,SIO 295S,A00,894020,Staff,5,0,25,20
1746594957467,SIOC 290S,B01,958918,Merrifield; Mark A,14,0,30,16
1746594958496,SIOC 291S,B01,958922,Gabriel; Corey John,14,0,30,16
1746594959524,SOCI 117,A01,895339,Staff,2,0,5,3
1746594960552,WES 237B,A00,894149,Staff,11,0,20,9
1746594962679,AESE 279B,A00,891859,Staff,13,0,35,22
1746594963707,AIP 197,001,891854,Vespa; Emanuel Ignacio,9999,0,9999,0
1746594964734,ANTH 289S,A00,891856,Gagneux; Pascal,12,0,12,0
1746594965765,BENG 196,001,957946,Engler; Adam J.,9996,0,9999,3
1746594966789,BISP 197,001,959851,Wilhelm; James E.,9998,0,9999,1
1746594967814,CAT 124RS,A01,956906,Staff,6,0,25,19
1746594968841,CAT 125RS,A01,922013,Staff,6,0,25,19
1746594969868,CLRE 250,A00,891860,Morris; Sheldon,9995,0,9999,4
1746594971918,CLRE 251R,A00,907817,Mehta; Ravindra L.,9994,0,9999,5
1746594972943,CLRE 252,A00,891864,Cuomo; Raphael Eduardo,9993,0,9999,6
1746594973969,CLRE 253,A00,891867,Vaida; Florin,9994,0,9999,5
1746594973969,CLRE 253,B00,907819,Staff,9999,0,9999,0
1746594974999,CLRE 259,A00,891868,Patel; Hemal,9998,0,9999,1
1746594976024,CLRE 260,A00,891872,Cuomo; Raphael Eduardo,9999,0,9999,0
1746594977050,CLRE 297,001,891888,Cuomo; Raphael Eduardo,9999,0,9999,0
1746594978078,CSE 191,A00,958773,Minnes Kemp; Mor Mia,9995,0,9999,4
1746594979103,CSE 197,001,959846,Minnes Kemp; Mor Mia,9990,0,9999,9
1746594980131,CSS 201S,A01,892054,Mignozzetti; Umberto,25,0,30,5
1746594981157,CSS 202S,A01,892056,Mignozzetti; Umberto,25,0,30,5
1746594982183,DSC 197,001,956898,Eldridge; Justin Matthew,9996,0,9999,3
1746594983208,DSC 297,001,958000,Mazumdar; Arya,9998,0,9999,1
1746594983208,DSC 297,002,959862,Wang; Yusu,9998,0,9999,1
1746594984236,EAP 100,A00,905686,Staff,9778,0,9999,221
1746594985265,ECE 45,A01,892618,Staff,0,0,65,65
1746594987313,ECE 111,A01,892719,Staff,6,0,65,59
1746594988338,ECE 197,001,957920,Mercier; Patrick Philip,9991,0,9999,8
1746594989366,ECON 178,A01,907814,Zhu; Ying,26,0,35,9
1746594990396,EDS 115,A00,895312,Staff,35,0,45,10
1746594991423,EDS 117,A01,895337,Staff,23,0,30,7
1746594992447,EDS 125,A00,895341,Jones; Gabrielle Anastasia,36,0,45,9
1746594993473,EDS 128A,A01,895459,Fargason; Sharon Gayle,44,0,45,1
1746594994502,EDS 128B,A01,895543,Pappas; Elizabeth,44,0,45,1
1746594995526,EDS 139,A00,897203,Pappas; Elizabeth,44,0,45,1
1746594995526,EDS 139,B00,897209,Fargason; Sharon Gayle,41,0,45,4
1746594996550,EDS 201,A00,895545,Staff,22,0,45,23
1746594997575,EDS 203,A01,895581,Halter; Christopher P.,22,0,45,23
1746594998602,EDS 204R,A01,895625,Heinzman; Erica M.,39,0,45,6
1746594998602,EDS 204R,B01,895693,Halter; Christopher P.,10,0,45,35
1746594999631,EDS 206R,A00,895694,Fargason; Sharon Gayle,1,0,30,29
1746594999631,EDS 206R,B00,895695,Choi; Bailey Miyeon,16,0,30,14
1746595000660,EDS 250,A00,895697,Hemans; Patricia Ann Benitez,22,0,45,23
1746595001683,EDS 281,A00,895701,Meyerott; Theresa Ann,1,0,15,14
1746595002712,EDS 284,A00,895736,Meyerott; Theresa Ann,1,0,15,14
1746595003739,EDS 286,A00,897210,Fine; Sarah,0,0,15,15
1746595004764,EDS 289C,A01,895770,Daly; Alan J.,1,0,15,14
1746595005794,EDS 290,A00,897211,Hofstetter; Carolyn,0,0,15,15
1746595006821,LIGM 5A,A00,896162,Fischer-Grunski; Eva K,12,0,20,8
1746595007847,LIGM 5B,A00,896260,Fischer-Grunski; Eva K,17,0,20,3
1746595008876,LIGM 5C,A00,896308,Fischer-Grunski; Eva K,18,0,20,2
1746595009902,LIIT 5AS,A00,896313,Carnelos; Chiara,18,0,20,2
1746595010928,LIIT 5BS,A00,896416,Carnelos; Chiara,20,0,20,0
1746595011953,LIIT 5CS,A00,896564,Carnelos; Chiara,20,0,20,0
1746595012977,LISP 5A,A00,896588,Munoz Sanchez; Alicia,2,0,20,18
1746595014003,LISP 5B,A00,896653,Munoz Sanchez; Alicia,7,0,20,13
1746595015033,LISP 5C,A00,896655,Munoz Sanchez; Alicia,0,1,20,20
1746595016058,MAE 197,001,957918,Kleissl; Jan,9996,0,9999,3
1746595016058,MAE 197,002,959806,Boechler; Nicholas Sebastia,9998,0,9999,1
1746595016058,MAE 197,003,959852,Mullin; Jennifer S,9998,0,9999,1
1746595017084,MATH 2,A01,957937,Staff,33,0,35,2
1746595018113,MATH 197,001,957876,Kedlaya; Kiran S.,9993,0,9999,6
1746595019144,MCWP 40,A00,892729,Duru; Nur,10,0,20,10
1746595019144,MCWP 40,B00,893304,Montejo; Carolina,14,0,20,6
1746595020170,MCWP 40R,A00,893757,Redela; Pamela Morgan,0,5,20,20
1746595021197,MCWP 50,A00,893758,Morshed; Michael James,0,0,20,20
1746595021197,MCWP 50,B00,893761,Bartulis; Jason Michael,17,0,20,3
1746595022224,MCWP 50R,A00,893766,Compas; Sean Matthew,0,1,20,20
1746595022224,MCWP 50R,B00,893769,Carter; Jennifer A,0,1,20,20
1746595022224,MCWP 50R,C00,893771,Krone; Jarret,0,3,20,20
1746595022224,MCWP 50R,D00,893772,Miller; Elizabeth Deen,0,0,20,20
1746595022224,MCWP 50R,E00,893775,Carter; Andrea L,0,1,20,20
1746595023252,MMW 11R,A01,892721,Herbst; Matthew,14,0,30,16
1746595023252,MMW 11R,A02,892722,Herbst; Matthew,0,0,0,3
1746595024280,MMW 12R,A01,892724,Herbst; Matthew,0,11,16,16
1746595024280,MMW 12R,A02,892725,Herbst; Matthew,0,10,16,16
1746595025306,MMW 13R,A01,892727,Staff,0,4,16,16
1746595025306,MMW 13R,A02,892728,Staff,0,4,16,16
1746595025306,MMW 13R,A03,958032,Staff,0,4,16,16
1746595025306,MMW 13R,A04,958033,Staff,0,4,16,16
1746595025306,MMW 13R,A05,958034,Staff,0,4,16,16
1746595026332,SIO 295LS,A00,894015,Staff,5,0,25,20
1746595027361,SIO 295S,A00,894020,Staff,5,0,25,20
1746595028390,SIOC 290S,B01,958918,Merrifield; Mark A,14,0,30,16
1746595029415,SIOC 291S,B01,958922,Gabriel; Corey John,14,0,30,16
1746595030441,SOCI 117,A01,895339,Staff,2,0,5,3
1746595031468,WES 237B,A00,894149,Staff,11,0,20,9
1746595033530,AESE 279B,A00,891859,Staff,13,0,35,22
1746595034558,AIP 197,001,891854,Vespa; Emanuel Ignacio,9999,0,9999,0
1746595035584,ANTH 289S,A00,891856,Gagneux; Pascal,12,0,12,0
1746595036612,BENG 196,001,957946,Engler; Adam J.,9996,0,9999,3
1746595037640,BISP 197,001,959851,Wilhelm; James E.,9998,0,9999,1
1746595038665,CAT 124RS,A01,956906,Staff,6,0,25,19
1746595039693,CAT 125RS,A01,922013,Staff,6,0,25,19
1746595040718,CLRE 250,A00,891860,Morris; Sheldon,9995,0,9999,4
1746595042773,CLRE 251R,A00,907817,Mehta; Ravindra L.,9994,0,9999,5
1746595043801,CLRE 252,A00,891864,Cuomo; Raphael Eduardo,9993,0,9999,6
1746595044829,CLRE 253,A00,891867,Vaida; Florin,9994,0,9999,5
1746595044829,CLRE 253,B00,907819,Staff,9999,0,9999,0
1746595045853,CLRE 259,A00,891868,Patel; Hemal,9998,0,9999,1
1746595046879,CLRE 260,A00,891872,Cuomo; Raphael Eduardo,9999,0,9999,0
1746595047908,CLRE 297,001,891888,Cuomo; Raphael Eduardo,9999,0,9999,0
1746595048933,CSE 191,A00,958773,Minnes Kemp; Mor Mia,9995,0,9999,4
1746595049961,CSE 197,001,959846,Minnes Kemp; Mor Mia,9990,0,9999,9
1746595050987,CSS 201S,A01,892054,Mignozzetti; Umberto,25,0,30,5
1746595052013,CSS 202S,A01,892056,Mignozzetti; Umberto,25,0,30,5
1746595053039,DSC 197,001,956898,Eldridge; Justin Matthew,9996,0,9999,3
1746595054064,DSC 297,001,958000,Mazumdar; Arya,9998,0,9999,1
1746595054064,DSC 297,002,959862,Wang; Yusu,9998,0,9999,1
1746595055090,EAP 100,A00,905686,Staff,9778,0,9999,221
1746595056117,ECE 45,A01,892618,Staff,0,0,65,65
1746595058170,ECE 111,A01,892719,Staff,6,0,65,59
1746595059196,ECE 197,001,957920,Mercier; Patrick Philip,9991,0,9999,8
1746595060220,ECON 178,A01,907814,Zhu; Ying,26,0,35,9
1746595061249,EDS 115,A00,895312,Staff,35,0,45,10
1746595062275,EDS 117,A01,895337,Staff,23,0,30,7
1746595063306,EDS 125,A00,895341,Jones; Gabrielle Anastasia,36,0,45,9
1746595064334,EDS 128A,A01,895459,Fargason; Sharon Gayle,44,0,45,1
1746595065417,EDS 128B,A01,895543,Pappas; Elizabeth,44,0,45,1
1746595066447,EDS 139,A00,897203,Pappas; Elizabeth,44,0,45,1
1746595066447,EDS 139,B00,897209,Fargason; Sharon Gayle,41,0,45,4
1746595067475,EDS 201,A00,895545,Staff,22,0,45,23
1746595068504,EDS 203,A01,895581,Halter; Christopher P.,22,0,45,23
1746595069534,EDS 204R,A01,895625,Heinzman; Erica M.,39,0,45,6
1746595069534,EDS 204R,B01,895693,Halter; Christopher P.,10,0,45,35
1746595070562,EDS 206R,A00,895694,Fargason; Sharon Gayle,1,0,30,29
1746595070562,EDS 206R,B00,895695,Choi; Bailey Miyeon,16,0,30,14
1746595071587,EDS 250,A00,895697,Hemans; Patricia Ann Benitez,22,0,45,23
1746595072613,EDS 281,A00,895701,Meyerott; Theresa Ann,1,0,15,14
1746595073637,EDS 284,A00,895736,Meyerott; Theresa Ann,1,0,15,14
1746595074665,EDS 286,A00,897210,Fine; Sarah,0,0,15,15
1746595075690,EDS 289C,A01,895770,Daly; Alan J.,1,0,15,14
1746595076715,EDS 290,A00,897211,Hofstetter; Carolyn,0,0,15,15
1746595077743,LIGM 5A,A00,896162,Fischer-Grunski; Eva K,12,0,20,8
1746595078773,LIGM 5B,A00,896260,Fischer-Grunski; Eva K,17,0,20,3
1746595079800,LIGM 5C,A00,896308,Fischer-Grunski; Eva K,18,0,20,2
1746595080828,LIIT 5AS,A00,896313,Carnelos; Chiara,18,0,20,2
1746595081854,LIIT 5BS,A00,896416,Carnelos; Chiara,20,0,20,0
1746595082883,LIIT 5CS,A00,896564,Carnelos; Chiara,20,0,20,0
1746595083908,LISP 5A,A00,896588,Munoz Sanchez; Alicia,2,0,20,18
1746595084936,LISP 5B,A00,896653,Munoz Sanchez; Alicia,7,0,20,13
1746595085967,LISP 5C,A00,896655,Munoz Sanchez; Alicia,0,1,20,20
1746595086994,MAE 197,001,957918,Kleissl; Jan,9996,0,9999,3
1746595086994,MAE 197,002,959806,Boechler; Nicholas Sebastia,9998,0,9999,1
1746595086994,MAE 197,003,959852,Mullin; Jennifer S,9998,0,9999,1
1746595088023,MATH 2,A01,957937,Staff,33,0,35,2
1746595089051,MATH 197,001,957876,Kedlaya; Kiran S.,9993,0,9999,6
1746595090081,MCWP 40,A00,892729,Duru; Nur,10,0,20,10
1746595090081,MCWP 40,B00,893304,Montejo; Carolina,14,0,20,6
1746595091106,MCWP 40R,A00,893757,Redela; Pamela Morgan,0,5,20,20
1746595092137,MCWP 50,A00,893758,Morshed; Michael James,0,0,20,20
1746595092137,MCWP 50,B00,893761,Bartulis; Jason Michael,17,0,20,3
1746595093163,MCWP 50R,A00,893766,Compas; Sean Matthew,0,1,20,20
1746595093163,MCWP 50R,B00,893769,Carter; Jennifer A,0,1,20,20
1746595093163,MCWP 50R,C00,893771,Krone; Jarret,0,3,20,20
1746595093163,MCWP 50R,D00,893772,Miller; Elizabeth Deen,0,0,20,20
1746595093163,MCWP 50R,E00,893775,Carter; Andrea L,0,1,20,20
1746595094188,MMW 11R,A01,892721,Herbst; Matthew,14,0,30,16
1746595094188,MMW 11R,A02,892722,Herbst; Matthew,0,0,0,3
1746595095214,MMW 12R,A01,892724,Herbst; Matthew,0,11,16,16
1746595095214,MMW 12R,A02,892725,Herbst; Matthew,0,10,16,16
1746595096238,MMW 13R,A01,892727,Staff,0,4,16,16
1746595096238,MMW 13R,A02,892728,Staff,0,4,16,16
1746595096238,MMW 13R,A03,958032,Staff,0,4,16,16
1746595096238,MMW 13R,A04,958033,Staff,0,4,16,16
1746595096238,MMW 13R,A05,958034,Staff,0,4,16,16
1746595097264,SIO 295LS,A00,894015,Staff,5,0,25,20
1746595098290,SIO 295S,A00,894020,Staff,5,0,25,20
1746595099314,SIOC 290S,B01,958918,Merrifield; Mark A,14,0,30,16
1746595100346,SIOC 291S,B01,958922,Gabriel; Corey John,14,0,30,16
1746595101374,SOCI 117,A01,895339,Staff,2,0,5,3
1746595102405,WES 237B,A00,894149,Staff,11,0,20,9
1746595104474,AESE 279B,A00,891859,Staff,13,0,35,22
1746595105502,AIP 197,001,891854,Vespa; Emanuel Ignacio,9999,0,9999,0
1746595106527,ANTH 289S,A00,891856,Gagneux; Pascal,12,0,12,0
1746595107555,BENG 196,001,957946,Engler; Adam J.,9996,0,9999,3
1746595108582,BISP 197,001,959851,Wilhelm; James E.,9998,0,9999,1
1746595109606,CAT 124RS,A01,956906,Staff,6,0,25,19
1746595110630,CAT 125RS,A01,922013,Staff,6,0,25,19
1746595111660,CLRE 250,A00,891860,Morris; Sheldon,9995,0,9999,4
1746595113714,CLRE 251R,A00,907817,Mehta; Ravindra L.,9994,0,9999,5
1746595114741,CLRE 252,A00,891864,Cuomo; Raphael Eduardo,9993,0,9999,6
1746595115770,CLRE 253,A00,891867,Vaida; Florin,9994,0,9999,5
1746595115770,CLRE 253,B00,907819,Staff,9999,0,9999,0
1746595116795,CLRE 259,A00,891868,Patel; Hemal,9998,0,9999,1
1746595117820,CLRE 260,A00,891872,Cuomo; Raphael Eduardo,9999,0,9999,0
1746595118845,CLRE 297,001,891888,Cuomo; Raphael Eduardo,9999,0,9999,0
1746595119870,CSE 191,A00,958773,Minnes Kemp; Mor Mia,9995,0,9999,4
1746595120900,CSE 197,001,959846,Minnes Kemp; Mor Mia,9990,0,9999,9
1746595121926,CSS 201S,A01,892054,Mignozzetti; Umberto,25,0,30,5
1746595122955,CSS 202S,A01,892056,Mignozzetti; Umberto,25,0,30,5
1746595123981,DSC 197,001,956898,Eldridge; Justin Matthew,9996,0,9999,3
1746595125007,DSC 297,001,958000,Mazumdar; Arya,9998,0,9999,1
1746595125007,DSC 297,002,959862,Wang; Yusu,9998,0,9999,1
1746595126032,EAP 100,A00,905686,Staff,9778,0,9999,221
1746595127058,ECE 45,A01,892618,Staff,0,0,65,65
1746595129109,ECE 111,A01,892719,Staff,6,0,65,59
1746595130138,ECE 197,001,957920,Mercier; Patrick Philip,9991,0,9999,8
1746595131165,ECON 178,A01,907814,Zhu; Ying,26,0,35,9
1746595132190,EDS 115,A00,895312,Staff,35,0,45,10
1746595133217,EDS 117,A01,895337,Staff,23,0,30,7
1746595134243,EDS 125,A00,895341,Jones; Gabrielle Anastasia,36,0,45,9
1746595135273,EDS 128A,A01,895459,Fargason; Sharon Gayle,44,0,45,1
1746595136298,EDS 128B,A01,895543,Pappas; Elizabeth,44,0,45,1
1746595137323,EDS 139,A00,897203,Pappas; Elizabeth,44,0,45,1
1746595137323,EDS 139,B00,897209,Fargason; Sharon Gayle,41,0,45,4
1746595138347,EDS 201,A00,895545,Staff,22,0,45,23
1746595139372,EDS 203,A01,895581,Halter; Christopher P.,22,0,45,23
1746595140399,EDS 204R,A01,895625,Heinzman; Erica M.,39,0,45,6
1746595140399,EDS 204R,B01,895693,Halter; Christopher P.,10,0,45,35
1746595141424,EDS 206R,A00,895694,Fargason; Sharon Gayle,1,0,30,29
1746595141424,EDS 206R,B00,895695,Choi; Bailey Miyeon,16,0,30,14
1746595142449,EDS 250,A00,895697,Hemans; Patricia Ann Benitez,22,0,45,23
1746595143475,EDS 281,A00,895701,Meyerott; Theresa Ann,1,0,15,14
1746595144500,EDS 284,A00,895736,Meyerott; Theresa Ann,1,0,15,14
1746595145524,EDS 286,A00,897210,Fine; Sarah,0,0,15,15
1746595146551,EDS 289C,A01,895770,Daly; Alan J.,1,0,15,14
1746595147578,EDS 290,A00,897211,Hofstetter; Carolyn,0,0,15,15
1746595148604,LIGM 5A,A00,896162,Fischer-Grunski; Eva K,12,0,20,8
1746595149628,LIGM 5B,A00,896260,Fischer-Grunski; Eva K,17,0,20,3
1746595150655,LIGM 5C,A00,896308,Fischer-Grunski; Eva K,18,0,20,2
1746595151685,LIIT 5AS,A00,896313,Carnelos; Chiara,18,0,20,2
1746595152714,LIIT 5BS,A00,896416,Carnelos; Chiara,20,0,20,0
1746595153743,LIIT 5CS,A00,896564,Carnelos; Chiara,20,0,20,0
1746595154767,LISP 5A,A00,896588,Munoz Sanchez; Alicia,2,0,20,18
1746595155798,LISP 5B,A00,896653,Munoz Sanchez; Alicia,7,0,20,13
1746595156824,LISP 5C,A00,896655,Munoz Sanchez; Alicia,0,1,20,20
1746595157852,MAE 197,001,957918,Kleissl; Jan,9996,0,9999,3
1746595157852,MAE 197,002,959806,Boechler; Nicholas Sebastia,9998,0,9999,1
1746595157852,MAE 197,003,959852,Mullin; Jennifer S,9998,0,9999,1
1746595158882,MATH 2,A01,957937,Staff,33,0,35,2
1746595159909,MATH 197,001,957876,Kedlaya; Kiran S.,9993,0,9999,6
1746595160935,MCWP 40,A00,892729,Duru; Nur,10,0,20,10
1746595160935,MCWP 40,B00,893304,Montejo; Carolina,14,0,20,6
1746595161961,MCWP 40R,A00,893757,Redela; Pamela Morgan,0,5,20,20
1746595162986,MCWP 50,A00,893758,Morshed; Michael James,0,0,20,20
1746595162986,MCWP 50,B00,893761,Bartulis; Jason Michael,17,0,20,3
1746595164012,MCWP 50R,A00,893766,Compas; Sean Matthew,0,1,20,20
1746595164012,MCWP 50R,B00,893769,Carter; Jennifer A,0,1,20,20
1746595164012,MCWP 50R,C00,893771,Krone; Jarret,0,3,20,20
1746595164012,MCWP 50R,D00,893772,Miller; Elizabeth Deen,0,0,20,20
1746595164012,MCWP 50R,E00,893775,Carter; Andrea L,0,1,20,20
1746595165037,MMW 11R,A01,892721,Herbst; Matthew,14,0,30,16
1746595165037,MMW 11R,A02,892722,Herbst; Matthew,0,0,0,3
1746595166066,MMW 12R,A01,892724,Herbst; Matthew,0,11,16,16
1746595166066,MMW 12R,A02,892725,Herbst; Matthew,0,10,16,16
1746595167090,MMW 13R,A01,892727,Staff,0,4,16,16
1746595167090,MMW 13R,A02,892728,Staff,0,4,16,16
1746595167090,MMW 13R,A03,958032,Staff,0,4,16,16
1746595167090,MMW 13R,A04,958033,Staff,0,4,16,16
1746595167090,MMW 13R,A05,958034,Staff,0,4,16,16
1746595168119,SIO 295LS,A00,894015,Staff,5,0,25,20
1746595169184,SIO 295S,A00,894020,Staff,5,0,25,20
1746595170210,SIOC 290S,B01,958918,Merrifield; Mark A,14,0,30,16
1746595171234,SIOC 291S,B01,958922,Gabriel; Corey John,14,0,30,16
1746595172261,SOCI 117,A01,895339,Staff,2,0,5,3
1746595173285,WES 237B,A00,894149,Staff,11,0,20,9
1746595175346,AESE 279B,A00,891859,Staff,13,0,35,22
1746595176373,AIP 197,001,891854,Vespa; Emanuel Ignacio,9999,0,9999,0
1746595177398,ANTH 289S,A00,891856,Gagneux; Pascal,12,0,12,0
1746595178424,BENG 196,001,957946,Engler; Adam J.,9996,0,9999,3
1746595179449,BISP 197,001,959851,Wilhelm; James E.,9998,0,9999,1
1746595180474,CAT 124RS,A01,956906,Staff,6,0,25,19
1746595181502,CAT 125RS,A01,922013,Staff,6,0,25,19
1746595182530,CLRE 250,A00,891860,Morris; Sheldon,9995,0,9999,4
1746595184581,CLRE 251R,A00,907817,Mehta; Ravindra L.,9994,0,9999,5
1746595185609,CLRE 252,A00,891864,Cuomo; Raphael Eduardo,9993,0,9999,6
1746595186637,CLRE 253,A00,891867,Vaida; Florin,9994,0,9999,5
1746595186637,CLRE 253,B00,907819,Staff,9999,0,9999,0
1746595187662,CLRE 259,A00,891868,Patel; Hemal,9998,0,9999,1
1746595188691,CLRE 260,A00,891872,Cuomo; Raphael Eduardo,9999,0,9999,0
1746595189721,CLRE 297,001,891888,Cuomo; Raphael Eduardo,9999,0,9999,0
1746595190745,CSE 191,A00,958773,Minnes Kemp; Mor Mia,9995,0,9999,4
1746595191772,CSE 197,001,959846,Minnes Kemp; Mor Mia,9990,0,9999,9
1746595192799,CSS 201S,A01,892054,Mignozzetti; Umberto,25,0,30,5
1746595193828,CSS 202S,A01,892056,Mignozzetti; Umberto,25,0,30,5
1746595194854,DSC 197,001,956898,Eldridge; Justin Matthew,9996,0,9999,3
1746595195880,DSC 297,001,958000,Mazumdar; Arya,9998,0,9999,1
1746595195880,DSC 297,002,959862,Wang; Yusu,9998,0,9999,1
1746595196905,EAP 100,A00,905686,Staff,9778,0,9999,221
1746595197930,ECE 45,A01,892618,Staff,0,0,65,65
1746595199986,ECE 111,A01,892719,Staff,6,0,65,59
1746595201014,ECE 197,001,957920,Mercier; Patrick Philip,9991,0,9999,8
1746595202043,ECON 178,A01,907814,Zhu; Ying,26,0,35,9
1746595203069,EDS 115,A00,895312,Staff,35,0,45,10
1746595204093,EDS 117,A01,895337,Staff,23,0,30,7
1746595205120,EDS 125,A00,895341,Jones; Gabrielle Anastasia,36,0,45,9
1746595206146,EDS 128A,A01,895459,Fargason; Sharon Gayle,44,0,45,1
1746595207175,EDS 128B,A01,895543,Pappas; Elizabeth,44,0,45,1
1746595208206,EDS 139,A00,897203,Pappas; Elizabeth,44,0,45,1
1746595208206,EDS 139,B00,897209,Fargason; Sharon Gayle,41,0,45,4
1746595209232,EDS 201,A00,895545,Staff,22,0,45,23
1746595210260,EDS 203,A01,895581,Halter; Christopher P.,22,0,45,23
1746595211289,EDS 204R,A01,895625,Heinzman; Erica M.,39,0,45,6
1746595211289,EDS 204R,B01,895693,Halter; Christopher P.,10,0,45,35
1746595212317,EDS 206R,A00,895694,Fargason; Sharon Gayle,1,0,30,29
1746595212317,EDS 206R,B00,895695,Choi; Bailey Miyeon,16,0,30,14
1746595213345,EDS 250,A00,895697,Hemans; Patricia Ann Benitez,22,0,45,23
1746595214369,EDS 281,A00,895701,Meyerott; Theresa Ann,1,0,15,14
1746595215396,EDS 284,A00,895736,Meyerott; Theresa Ann,1,0,15,14
1746595216421,EDS 286,A00,897210,Fine; Sarah,0,0,15,15
1746595217449,EDS 289C,A01,895770,Daly; Alan J.,1,0,15,14
1746595218478,EDS 290,A00,897211,Hofstetter; Carolyn,0,0,15,15
1746595219504,LIGM 5A,A00,896162,Fischer-Grunski; Eva K,12,0,20,8
1746595220530,LIGM 5B,A00,896260,Fischer-Grunski; Eva K,17,0,20,3
1746595221561,LIGM 5C,A00,896308,Fischer-Grunski; Eva K,18,0,20,2
1746595222591,LIIT 5AS,A00,896313,Carnelos; Chiara,18,0,20,2
1746595223621,LIIT 5BS,A00,896416,Carnelos; Chiara,20,0,20,0
1746595224650,LIIT 5CS,A00,896564,Carnelos; Chiara,20,0,20,0
1746595225675,LISP 5A,A00,896588,Munoz Sanchez; Alicia,2,0,20,18
1746595226703,LISP 5B,A00,896653,Munoz Sanchez; Alicia,7,0,20,13
1746595227730,LISP 5C,A00,896655,Munoz Sanchez; Alicia,0,1,20,20
1746595228759,MAE 197,001,957918,Kleissl; Jan,9996,0,9999,3
1746595228759,MAE 197,002,959806,Boechler; Nicholas Sebastia,9998,0,9999,1
1746595228759,MAE 197,003,959852,Mullin; Jennifer S,9998,0,9999,1
1746595229785,MATH 2,A01,957937,Staff,33,0,35,2
1746595230811,MATH 197,001,957876,Kedlaya; Kiran S.,9993,0,9999,6
1746595231838,MCWP 40,A00,892729,Duru; Nur,10,0,20,10
1746595231838,MCWP 40,B00,893304,Montejo; Carolina,14,0,20,6
1746595232863,MCWP 40R,A00,893757,Redela; Pamela Morgan,0,5,20,20
1746595233890,MCWP 50,A00,893758,Morshed; Michael James,0,0,20,20
1746595233890,MCWP 50,B00,893761,Bartulis; Jason Michael,17,0,20,3
1746595234915,MCWP 50R,A00,893766,Compas; Sean Matthew,0,1,20,20
1746595234915,MCWP 50R,B00,893769,Carter; Jennifer A,0,1,20,20
1746595234915,MCWP 50R,C00,893771,Krone; Jarret,0,3,20,20
1746595234915,MCWP 50R,D00,893772,Miller; Elizabeth Deen,0,0,20,20
1746595234915,MCWP 50R,E00,893775,Carter; Andrea L,0,1,20,20
1746595235944,MMW 11R,A01,892721,Herbst; Matthew,14,0,30,16
1746595235944,MMW 11R,A02,892722,Herbst; Matthew,0,0,0,3
1746595236968,MMW 12R,A01,892724,Herbst; Matthew,0,11,16,16
1746595236968,MMW 12R,A02,892725,Herbst; Matthew,0,10,16,16
1746595237995,MMW 13R,A01,892727,Staff,0,4,16,16
1746595237995,MMW 13R,A02,892728,Staff,0,4,16,16
1746595237995,MMW 13R,A03,958032,Staff,0,4,16,16
1746595237995,MMW 13R,A04,958033,Staff,0,4,16,16
1746595237995,MMW 13R,A05,958034,Staff,0,4,16,16
1746595239023,SIO 295LS,A00,894015,Staff,5,0,25,20
1746595240048,SIO 295S,A00,894020,Staff,5,0,25,20
1746595241079,SIOC 290S,B01,958918,Merrifield; Mark A,14,0,30,16
1746595242106,SIOC 291S,B01,958922,Gabriel; Corey John,14,0,30,16
1746595243198,SOCI 117,A01,895339,Staff,2,0,5,3
1746595244228,WES 237B,A00,894149,Staff,11,0,20,9
1746595246298,AESE 279B,A00,891859,Staff,13,0,35,22
1746595247327,AIP 197,001,891854,Vespa; Emanuel Ignacio,9999,0,9999,0
1746595248352,ANTH 289S,A00,891856,Gagneux; Pascal,12,0,12,0
1746595249376,BENG 196,001,957946,Engler; Adam J.,9996,0,9999,3
1746595250403,BISP 197,001,959851,Wilhelm; James E.,9998,0,9999,1
1746595251428,CAT 124RS,A01,956906,Staff,6,0,25,19
1746595252452,CAT 125RS,A01,922013,Staff,6,0,25,19
1746595253476,CLRE 250,A00,891860,Morris; Sheldon,9995,0,9999,4
1746595255528,CLRE 251R,A00,907817,Mehta; Ravindra L.,9994,0,9999,5
1746595256554,CLRE 252,A00,891864,Cuomo; Raphael Eduardo,9993,0,9999,6
1746595257580,CLRE 253,A00,891867,Vaida; Florin,9994,0,9999,5
1746595257580,CLRE 253,B00,907819,Staff,9999,0,9999,0
1746595258609,CLRE 259,A00,891868,Patel; Hemal,9998,0,9999,1
1746595259634,CLRE 260,A00,891872,Cuomo; Raphael Eduardo,9999,0,9999,0
1746595260663,CLRE 297,001,891888,Cuomo; Raphael Eduardo,9999,0,9999,0
1746595261688,CSE 191,A00,958773,Minnes Kemp; Mor Mia,9995,0,9999,4
1746595262716,CSE 197,001,959846,Minnes Kemp; Mor Mia,9990,0,9999,9
1746595263747,CSS 201S,A01,892054,Mignozzetti; Umberto,25,0,30,5
1746595264774,CSS 202S,A01,892056,Mignozzetti; Umberto,25,0,30,5
1746595265801,DSC 197,001,956898,Eldridge; Justin Matthew,9996,0,9999,3
1746595266829,DSC 297,001,958000,Mazumdar; Arya,9998,0,9999,1
1746595266829,DSC 297,002,959862,Wang; Yusu,9998,0,9999,1
1746595267855,EAP 100,A00,905686,Staff,9778,0,9999,221
1746595268883,ECE 45,A01,892618,Staff,0,0,65,65
1746595270935,ECE 111,A01,892719,Staff,6,0,65,59
1746595271959,ECE 197,001,957920,Mercier; Patrick Philip,9991,0,9999,8
1746595273023,ECON 178,A01,907814,Zhu; Ying,26,0,35,9
1746595274049,EDS 115,A00,895312,Staff,35,0,45,10
1746595275073,EDS 117,A01,895337,Staff,23,0,30,7
1746595276099,EDS 125,A00,895341,Jones; Gabrielle Anastasia,36,0,45,9
1746595277124,EDS 128A,A01,895459,Fargason; Sharon Gayle,44,0,45,1
1746595278151,EDS 128B,A01,895543,Pappas; Elizabeth,44,0,45,1
1746595279176,EDS 139,A00,897203,Pappas; Elizabeth,44,0,45,1
1746595279176,EDS 139,B00,897209,Fargason; Sharon Gayle,41,0,45,4
1746595280203,EDS 201,A00,895545,Staff,22,0,45,23
1746595281234,EDS 203,A01,895581,Halter; Christopher P.,22,0,45,23
1746595282262,EDS 204R,A01,895625,Heinzman; Erica M.,39,0,45,6
1746595282262,EDS 204R,B01,895693,Halter; Christopher P.,10,0,45,35
1746595283287,EDS 206R,A00,895694,Fargason; Sharon Gayle,1,0,30,29
1746595283287,EDS 206R,B00,895695,Choi; Bailey Miyeon,16,0,30,14
1746595284313,EDS 250,A00,895697,Hemans; Patricia Ann Benitez,22,0,45,23
1746595285338,EDS 281,A00,895701,Meyerott; Theresa Ann,1,0,15,14
1746595286362,EDS 284,A00,895736,Meyerott; Theresa Ann,1,0,15,14
1746595287388,EDS 286,A00,897210,Fine; Sarah,0,0,15,15
1746595288416,EDS 289C,A01,895770,Daly; Alan J.,1,0,15,14
1746595289440,EDS 290,A00,897211,Hofstetter; Carolyn,0,0,15,15
1746595290466,LIGM 5A,A00,896162,Fischer-Grunski; Eva K,12,0,20,8
1746595291496,LIGM 5B,A00,896260,Fischer-Grunski; Eva K,17,0,20,3
1746595292524,LIGM 5C,A00,896308,Fischer-Grunski; Eva K,18,0,20,2
1746595293553,LIIT 5AS,A00,896313,Carnelos; Chiara,18,0,20,2
1746595294581,LIIT 5BS,A00,896416,Carnelos; Chiara,20,0,20,0
1746595295607,LIIT 5CS,A00,896564,Carnelos; Chiara,20,0,20,0
1746595296631,LISP 5A,A00,896588,Munoz Sanchez; Alicia,2,0,20,18
1746595297657,LISP 5B,A00,896653,Munoz Sanchez; Alicia,7,0,20,13
1746595298688,LISP 5C,A00,896655,Munoz Sanchez; Alicia,0,1,20,20
1746595299715,MAE 197,001,957918,Kleissl; Jan,9996,0,9999,3
1746595299715,MAE 197,002,959806,Boechler; Nicholas Sebastia,9998,0,9999,1
1746595299715,MAE 197,003,959852,Mullin; Jennifer S,9998,0,9999,1
1746595300743,MATH 2,A01,957937,Staff,33,0,35,2
1746595301770,MATH 197,001,957876,Kedlaya; Kiran S.,9993,0,9999,6
1746595302796,MCWP 40,A00,892729,Duru; Nur,10,0,20,10
1746595302796,MCWP 40,B00,893304,Montejo; Carolina,14,0,20,6
1746595303822,MCWP 40R,A00,893757,Redela; Pamela Morgan,0,5,20,20
1746595304847,MCWP 50,A00,893758,Morshed; Michael James,0,0,20,20
1746595304847,MCWP 50,B00,893761,Bartulis; Jason Michael,17,0,20,3
1746595305877,MCWP 50R,A00,893766,Compas; Sean Matthew,0,1,20,20
1746595305877,MCWP 50R,B00,893769,Carter; Jennifer A,0,1,20,20
1746595305877,MCWP 50R,C00,893771,Krone; Jarret,0,3,20,20
1746595305877,MCWP 50R,D00,893772,Miller; Elizabeth Deen,0,0,20,20
1746595305877,MCWP 50R,E00,893775,Carter; Andrea L,0,1,20,20
1746595306903,MMW 11R,A01,892721,Herbst; Matthew,14,0,30,16
1746595306903,MMW 11R,A02,892722,Herbst; Matthew,0,0,0,3
1746595307931,MMW 12R,A01,892724,Herbst; Matthew,0,11,16,16
1746595307931,MMW 12R,A02,892725,Herbst; Matthew,0,10,16,16
1746595308956,MMW 13R,A01,892727,Staff,0,4,16,16
1746595308956,MMW 13R,A02,892728,Staff,0,4,16,16
1746595308956,MMW 13R,A03,958032,Staff,0,4,16,16
1746595308956,MMW 13R,A04,958033,Staff,0,4,16,16
1746595308956,MMW 13R,A05,958034,Staff,0,4,16,16
1746595309982,SIO 295LS,A00,894015,Staff,5,0,25,20
1746595311011,SIO 295S,A00,894020,Staff,5,0,25,20
1746595312042,SIOC 290S,B01,958918,Merrifield; Mark A,14,0,30,16
1746595313069,SIOC 291S,B01,958922,Gabriel; Corey John,14,0,30,16
1746595314094,SOCI 117,A01,895339,Staff,2,0,5,3
1746595315118,WES 237B,A00,894149,Staff,11,0,20,9
1746595317179,AESE 279B,A00,891859,Staff,13,0,35,22
1746595318207,AIP 197,001,891854,Vespa; Emanuel Ignacio,9999,0,9999,0
1746595319235,ANTH 289S,A00,891856,Gagneux; Pascal,12,0,12,0
1746595320259,BENG 196,001,957946,Engler; Adam J.,9996,0,9999,3
1746595321286,BISP 197,001,959851,Wilhelm; James E.,9998,0,9999,1
1746595322310,CAT 124RS,A01,956906,Staff,6,0,25,19
1746595323339,CAT 125RS,A01,922013,Staff,6,0,25,19
1746595324363,CLRE 250,A00,891860,Morris; Sheldon,9995,0,9999,4
1746595326416,CLRE 251R,A00,907817,Mehta; Ravindra L.,9994,0,9999,5
1746595327442,CLRE 252,A00,891864,Cuomo; Raphael Eduardo,9993,0,9999,6
1746595328467,CLRE 253,A00,891867,Vaida; Florin,9994,0,9999,5
1746595328467,CLRE 253,B00,907819,Staff,9999,0,9999,0
1746595329492,CLRE 259,A00,891868,Patel; Hemal,9998,0,9999,1
1746595330519,CLRE 260,A00,891872,Cuomo; Raphael Eduardo,9999,0,9999,0
1746595331543,CLRE 297,001,891888,Cuomo; Raphael Eduardo,9999,0,9999,0
1746595332568,CSE 191,A00,958773,Minnes Kemp; Mor Mia,9995,0,9999,4
1746595333594,CSE 197,001,959846,Minnes Kemp; Mor Mia,9990,0,9999,9
1746595334624,CSS 201S,A01,892054,Mignozzetti; Umberto,25,0,30,5
1746595335648,CSS 202S,A01,892056,Mignozzetti; Umberto,25,0,30,5
1746595336673,DSC 197,001,956898,Eldridge; Justin Matthew,9996,0,9999,3
1746595337700,DSC 297,001,958000,Mazumdar; Arya,9998,0,9999,1
1746595337700,DSC 297,002,959862,Wang; Yusu,9998,0,9999,1
1746595338728,EAP 100,A00,905686,Staff,9778,0,9999,221
1746595339758,ECE 45,A01,892618,Staff,0,0,65,65
1746595341810,ECE 111,A01,892719,Staff,6,0,65,59
1746595342839,ECE 197,001,957920,Mercier; Patrick Philip,9991,0,9999,8
1746595343864,ECON 178,A01,907814,Zhu; Ying,26,0,35,9
1746595344889,EDS 115,A00,895312,Staff,35,0,45,10
1746595345915,EDS 117,A01,895337,Staff,23,0,30,7
1746595346942,EDS 125,A00,895341,Jones; Gabrielle Anastasia,36,0,45,9
1746595347967,EDS 128A,A01,895459,Fargason; Sharon Gayle,44,0,45,1
1746595348992,EDS 128B,A01,895543,Pappas; Elizabeth,44,0,45,1
1746595350022,EDS 139,A00,897203,Pappas; Elizabeth,44,0,45,1
1746595350022,EDS 139,B00,897209,Fargason; Sharon Gayle,41,0,45,4
1746595351053,EDS 201,A00,895545,Staff,22,0,45,23
1746595352081,EDS 203,A01,895581,Halter; Christopher P.,22,0,45,23
1746595353107,EDS 204R,A01,895625,Heinzman; Erica M.,39,0,45,6
1746595353107,EDS 204R,B01,895693,Halter; Christopher P.,10,0,45,35
1746595354134,EDS 206R,A00,895694,Fargason; Sharon Gayle,1,0,30,29
1746595354134,EDS 206R,B00,895695,Choi; Bailey Miyeon,16,0,30,14
1746595355163,EDS 250,A00,895697,Hemans; Patricia Ann Benitez,22,0,45,23
1746595356189,EDS 281,A00,895701,Meyerott; Theresa Ann,1,0,15,14
1746595357216,EDS 284,A00,895736,Meyerott; Theresa Ann,1,0,15,14
1746595358241,EDS 286,A00,897210,Fine; Sarah,0,0,15,15
1746595359269,EDS 289C,A01,895770,Daly; Alan J.,1,0,15,14
1746595360293,EDS 290,A00,897211,Hofstetter; Carolyn,0,0,15,15
1746595361324,LIGM 5A,A00,896162,Fischer-Grunski; Eva K,12,0,20,8
1746595362351,LIGM 5B,A00,896260,Fischer-Grunski; Eva K,17,0,20,3
1746595363376,LIGM 5C,A00,896308,Fischer-Grunski; Eva K,18,0,20,2
1746595364401,LIIT 5AS,A00,896313,Carnelos; Chiara,18,0,20,2
1746595365428,LIIT 5BS,A00,896416,Carnelos; Chiara,20,0,20,0
1746595366458,LIIT 5CS,A00,896564,Carnelos; Chiara,20,0,20,0
1746595367484,LISP 5A,A00,896588,Munoz Sanchez; Alicia,2,0,20,18
1746595368509,LISP 5B,A00,896653,Munoz Sanchez; Alicia,7,0,20,13
1746595369538,LISP 5C,A00,896655,Munoz Sanchez; Alicia,0,1,20,20
1746595370567,MAE 197,001,957918,Kleissl; Jan,9996,0,9999,3
1746595370567,MAE 197,002,959806,Boechler; Nicholas Sebastia,9998,0,9999,1
1746595370567,MAE 197,003,959852,Mullin; Jennifer S,9998,0,9999,1
1746595371593,MATH 2,A01,957937,Staff,33,0,35,2
1746595372622,MATH 197,001,957876,Kedlaya; Kiran S.,9993,0,9999,6
1746595373650,MCWP 40,A00,892729,Duru; Nur,10,0,20,10
1746595373650,MCWP 40,B00,893304,Montejo; Carolina,14,0,20,6
1746595374678,MCWP 40R,A00,893757,Redela; Pamela Morgan,0,5,20,20
1746595375704,MCWP 50,A00,893758,Morshed; Michael James,0,0,20,20
1746595375704,MCWP 50,B00,893761,Bartulis; Jason Michael,17,0,20,3
1746595376768,MCWP 50R,A00,893766,Compas; Sean Matthew,0,1,20,20
1746595376768,MCWP 50R,B00,893769,Carter; Jennifer A,0,1,20,20
1746595376768,MCWP 50R,C00,893771,Krone; Jarret,0,3,20,20
1746595376768,MCWP 50R,D00,893772,Miller; Elizabeth Deen,0,0,20,20
1746595376768,MCWP 50R,E00,893775,Carter; Andrea L,0,1,20,20
1746595377793,MMW 11R,A01,892721,Herbst; Matthew,14,0,30,16
1746595377793,MMW 11R,A02,892722,Herbst; Matthew,0,0,0,3
1746595378819,MMW 12R,A01,892724,Herbst; Matthew,0,11,16,16
1746595378819,MMW 12R,A02,892725,Herbst; Matthew,0,10,16,16
1746595379844,MMW 13R,A01,892727,Staff,0,4,16,16
1746595379844,MMW 13R,A02,892728,Staff,0,4,16,16
1746595379844,MMW 13R,A03,958032,Staff,0,4,16,16
1746595379844,MMW 13R,A04,958033,Staff,0,4,16,16
1746595379844,MMW 13R,A05,958034,Staff,0,4,16,16
1746595380871,SIO 295LS,A00,894015,Staff,5,0,25,20
1746595381900,SIO 295S,A00,894020,Staff,5,0,25,20
1746595382927,SIOC 290S,B01,958918,Merrifield; Mark A,14,0,30,16
1746595383957,SIOC 291S,B01,958922,Gabriel; Corey John,14,0,30,16
1746595384984,SOCI 117,A01,895339,Staff,2,0,5,3
1746595386012,WES 237B,A00,894149,Staff,11,0,20,9
1746595388072,AESE 279B,A00,891859,Staff,13,0,35,22
1746595389099,AIP 197,001,891854,Vespa; Emanuel Ignacio,9999,0,9999,0
1746595390127,ANTH 289S,A00,891856,Gagneux; Pascal,12,0,12,0
1746595391151,BENG 196,001,957946,Engler; Adam J.,9996,0,9999,3
1746595392178,BISP 197,001,959851,Wilhelm; James E.,9998,0,9999,1
1746595393204,CAT 124RS,A01,956906,Staff,6,0,25,19
1746595394229,CAT 125RS,A01,922013,Staff,6,0,25,19
1746595395257,CLRE 250,A00,891860,Morris; Sheldon,9995,0,9999,4
1746595397306,CLRE 251R,A00,907817,Mehta; Ravindra L.,9994,0,9999,5
1746595398336,CLRE 252,A00,891864,Cuomo; Raphael Eduardo,9993,0,9999,6
1746595399360,CLRE 253,A00,891867,Vaida; Florin,9994,0,9999,5
1746595399360,CLRE 253,B00,907819,Staff,9999,0,9999,0
1746595400384,CLRE 259,A00,891868,Patel; Hemal,9998,0,9999,1
1746595401408,CLRE 260,A00,891872,Cuomo; Raphael Eduardo,9999,0,9999,0
1746595402435,CLRE 297,001,891888,Cuomo; Raphael Eduardo,9999,0,9999,0
1746595403464,CSE 191,A00,958773,Minnes Kemp; Mor Mia,9995,0,9999,4
1746595404492,CSE 197,001,959846,Minnes Kemp; Mor Mia,9990,0,9999,9
1746595405521,CSS 201S,A01,892054,Mignozzetti; Umberto,25,0,30,5
1746595406548,CSS 202S,A01,892056,Mignozzetti; Umberto,25,0,30,5
1746595407574,DSC 197,001,956898,Eldridge; Justin Matthew,9996,0,9999,3
1746595408599,DSC 297,001,958000,Mazumdar; Arya,9998,0,9999,1
1746595408599,DSC 297,002,959862,Wang; Yusu,9998,0,9999,1
1746595409624,EAP 100,A00,905686,Staff,9778,0,9999,221
1746595410654,ECE 45,A01,892618,Staff,0,0,65,65
1746595412712,ECE 111,A01,892719,Staff,6,0,65,59
1746595413737,ECE 197,001,957920,Mercier; Patrick Philip,9991,0,9999,8
1746595414763,ECON 178,A01,907814,Zhu; Ying,26,0,35,9
1746595415789,EDS 115,A00,895312,Staff,35,0,45,10
1746595416815,EDS 117,A01,895337,Staff,23,0,30,7
1746595417841,EDS 125,A00,895341,Jones; Gabrielle Anastasia,36,0,45,9
1746595418870,EDS 128A,A01,895459,Fargason; Sharon Gayle,44,0,45,1
1746595419899,EDS 128B,A01,895543,Pappas; Elizabeth,44,0,45,1
1746595420927,EDS 139,A00,897203,Pappas; Elizabeth,44,0,45,1
1746595420927,EDS 139,B00,897209,Fargason; Sharon Gayle,41,0,45,4
1746595421952,EDS 201,A00,895545,Staff,22,0,45,23
1746595422983,EDS 203,A01,895581,Halter; Christopher P.,22,0,45,23
1746595424009,EDS 204R,A01,895625,Heinzman; Erica M.,39,0,45,6
1746595424009,EDS 204R,B01,895693,Halter; Christopher P.,10,0,45,35
1746595425038,EDS 206R,A00,895694,Fargason; Sharon Gayle,1,0,30,29
1746595425038,EDS 206R,B00,895695,Choi; Bailey Miyeon,16,0,30,14
1746595426068,EDS 250,A00,895697,Hemans; Patricia Ann Benitez,22,0,45,23
1746595427098,EDS 281,A00,895701,Meyerott; Theresa Ann,1,0,15,14
1746595428124,EDS 284,A00,895736,Meyerott; Theresa Ann,1,0,15,14
1746595429152,EDS 286,A00,897210,Fine; Sarah,0,0,15,15
1746595430179,EDS 289C,A01,895770,Daly; Alan J.,1,0,15,14
1746595431204,EDS 290,A00,897211,Hofstetter; Carolyn,0,0,15,15
1746595432228,LIGM 5A,A00,896162,Fischer-Grunski; Eva K,12,0,20,8
1746595433257,LIGM 5B,A00,896260,Fischer-Grunski; Eva K,17,0,20,3
1746595434286,LIGM 5C,A00,896308,Fischer-Grunski; Eva K,18,0,20,2
1746595435312,LIIT 5AS,A00,896313,Carnelos; Chiara,18,0,20,2
1746595436339,LIIT 5BS,A00,896416,Carnelos; Chiara,20,0,20,0
1746595437364,LIIT 5CS,A00,896564,Carnelos; Chiara,20,0,20,0
1746595438390,LISP 5A,A00,896588,Munoz Sanchez; Alicia,2,0,20,18
1746595439418,LISP 5B,A00,896653,Munoz Sanchez; Alicia,7,0,20,13
1746595440445,LISP 5C,A00,896655,Munoz Sanchez; Alicia,0,1,20,20
1746595441474,MAE 197,001,957918,Kleissl; Jan,9996,0,9999,3
1746595441474,MAE 197,002,959806,Boechler; Nicholas Sebastia,9998,0,9999,1
1746595441474,MAE 197,003,959852,Mullin; Jennifer S,9998,0,9999,1
1746595442498,MATH 2,A01,957937,Staff,33,0,35,2
1746595443524,MATH 197,001,957876,Kedlaya; Kiran S.,9993,0,9999,6
1746595444554,MCWP 40,A00,892729,Duru; Nur,10,0,20,10
1746595444554,MCWP 40,B00,893304,Montejo; Carolina,14,0,20,6
1746595445579,MCWP 40R,A00,893757,Redela; Pamela Morgan,0,5,20,20
1746595446607,MCWP 50,A00,893758,Morshed; Michael James,0,0,20,20
1746595446607,MCWP 50,B00,893761,Bartulis; Jason Michael,17,0,20,3
1746595447632,MCWP 50R,A00,893766,Compas; Sean Matthew,0,1,20,20
1746595447632,MCWP 50R,B00,893769,Carter; Jennifer A,0,1,20,20
1746595447632,MCWP 50R,C00,893771,Krone; Jarret,0,3,20,20
1746595447632,MCWP 50R,D00,893772,Miller; Elizabeth Deen,0,0,20,20
1746595447632,MCWP 50R,E00,893775,Carter; Andrea L,0,1,20,20
1746595448661,MMW 11R,A01,892721,Herbst; Matthew,14,0,30,16
1746595448661,MMW 11R,A02,892722,Herbst; Matthew,0,0,0,3
1746595449686,MMW 12R,A01,892724,Herbst; Matthew,0,11,16,16
1746595449686,MMW 12R,A02,892725,Herbst; Matthew,0,10,16,16
1746595450712,MMW 13R,A01,892727,Staff,0,4,16,16
1746595450712,MMW 13R,A02,892728,Staff,0,4,16,16
1746595450712,MMW 13R,A03,958032,Staff,0,4,16,16
1746595450712,MMW 13R,A04,958033,Staff,0,4,16,16
1746595450712,MMW 13R,A05,958034,Staff,0,4,16,16
1746595451736,SIO 295LS,A00,894015,Staff,5,0,25,20
1746595452762,SIO 295S,A00,894020,Staff,5,0,25,20
1746595453788,SIOC 290S,B01,958918,Merrifield; Mark A,14,0,30,16
1746595454817,SIOC 291S,B01,958922,Gabriel; Corey John,14,0,30,16
1746595455844,SOCI 117,A01,895339,Staff,2,0,5,3
1746595456872,WES 237B,A00,894149,Staff,11,0,20,9
1746595458940,AESE 279B,A00,891859,Staff,13,0,35,22
1746595459966,AIP 197,001,891854,Vespa; Emanuel Ignacio,9999,0,9999,0
1746595460995,ANTH 289S,A00,891856,Gagneux; Pascal,12,0,12,0
1746595462022,BENG 196,001,957946,Engler; Adam J.,9996,0,9999,3
1746595463050,BISP 197,001,959851,Wilhelm; James E.,9998,0,9999,1
1746595464077,CAT 124RS,A01,956906,Staff,6,0,25,19
1746595465105,CAT 125RS,A01,922013,Staff,6,0,25,19
1746595466130,CLRE 250,A00,891860,Morris; Sheldon,9995,0,9999,4
1746595468185,CLRE 251R,A00,907817,Mehta; Ravindra L.,9994,0,9999,5
1746595469210,CLRE 252,A00,891864,Cuomo; Raphael Eduardo,9993,0,9999,6
1746595470235,CLRE 253,A00,891867,Vaida; Florin,9994,0,9999,5
1746595470235,CLRE 253,B00,907819,Staff,9999,0,9999,0
1746595471259,CLRE 259,A00,891868,Patel; Hemal,9998,0,9999,1
1746595472289,CLRE 260,A00,891872,Cuomo; Raphael Eduardo,9999,0,9999,0
1746595473315,CLRE 297,001,891888,Cuomo; Raphael Eduardo,9999,0,9999,0
1746595474340,CSE 191,A00,958773,Minnes Kemp; Mor Mia,9995,0,9999,4
1746595475366,CSE 197,001,959846,Minnes Kemp; Mor Mia,9990,0,9999,9
1746595476393,CSS 201S,A01,892054,Mignozzetti; Umberto,25,0,30,5
1746595477419,CSS 202S,A01,892056,Mignozzetti; Umberto,25,0,30,5
1746595478446,DSC 197,001,956898,Eldridge; Justin Matthew,9996,0,9999,3
1746595479471,DSC 297,001,958000,Mazumdar; Arya,9998,0,9999,1
1746595479471,DSC 297,002,959862,Wang; Yusu,9998,0,9999,1
1746595480555,EAP 100,A00,905686,Staff,9778,0,9999,221
1746595481581,ECE 45,A01,892618,Staff,0,0,65,65
1746595483641,ECE 111,A01,892719,Staff,6,0,65,59
1746595484668,ECE 197,001,957920,Mercier; Patrick Philip,9991,0,9999,8
1746595485699,ECON 178,A01,907814,Zhu; Ying,26,0,35,9
1746595486727,EDS 115,A00,895312,Staff,35,0,45,10
1746595487751,EDS 117,A01,895337,Staff,23,0,30,7
1746595488779,EDS 125,A00,895341,Jones; Gabrielle Anastasia,36,0,45,9
1746595489804,EDS 128A,A01,895459,Fargason; Sharon Gayle,44,0,45,1
1746595490830,EDS 128B,A01,895543,Pappas; Elizabeth,44,0,45,1
1746595491856,EDS 139,A00,897203,Pappas; Elizabeth,44,0,45,1
1746595491856,EDS 139,B00,897209,Fargason; Sharon Gayle,41,0,45,4
1746595492880,EDS 201,A00,895545,Staff,22,0,45,23
1746595493908,EDS 203,A01,895581,Halter; Christopher P.,22,0,45,23
1746595494936,EDS 204R,A01,895625,Heinzman; Erica M.,39,0,45,6
1746595494936,EDS 204R,B01,895693,Halter; Christopher P.,10,0,45,35
1746595495960,EDS 206R,A00,895694,Fargason; Sharon Gayle,1,0,30,29
1746595495960,EDS 206R,B00,895695,Choi; Bailey Miyeon,16,0,30,14
1746595496987,EDS 250,A00,895697,Hemans; Patricia Ann Benitez,22,0,45,23
1746595498017,EDS 281,A00,895701,Meyerott; Theresa Ann,1,0,15,14
1746595499041,EDS 284,A00,895736,Meyerott; Theresa Ann,1,0,15,14
1746595500066,EDS 286,A00,897210,Fine; Sarah,0,0,15,15
1746595501093,EDS 289C,A01,895770,Daly; Alan J.,1,0,15,14
1746595502124,EDS 290,A00,897211,Hofstetter; Carolyn,0,0,15,15
1746595503148,LIGM 5A,A00,896162,Fischer-Grunski; Eva K,12,0,20,8
1746595504174,LIGM 5B,A00,896260,Fischer-Grunski; Eva K,17,0,20,3
1746595505201,LIGM 5C,A00,896308,Fischer-Grunski; Eva K,18,0,20,2
1746595506227,LIIT 5AS,A00,896313,Carnelos; Chiara,18,0,20,2
1746595507255,LIIT 5BS,A00,896416,Carnelos; Chiara,20,0,20,0
1746595508285,LIIT 5CS,A00,896564,Carnelos; Chiara,20,0,20,0
1746595509309,LISP 5A,A00,896588,Munoz Sanchez; Alicia,2,0,20,18
1746595510338,LISP 5B,A00,896653,Munoz Sanchez; Alicia,7,0,20,13
1746595511368,LISP 5C,A00,896655,Munoz Sanchez; Alicia,0,1,20,20
1746595512424,MAE 197,001,957918,Kleissl; Jan,9996,0,9999,3
1746595512424,MAE 197,002,959806,Boechler; Nicholas Sebastia,9998,0,9999,1
1746595512424,MAE 197,003,959852,Mullin; Jennifer S,9998,0,9999,1
1746595513450,MATH 2,A01,957937,Staff,33,0,35,2
1746595514478,MATH 197,001,957876,Kedlaya; Kiran S.,9993,0,9999,6
1746595515504,MCWP 40,A00,892729,Duru; Nur,10,0,20,10
1746595515504,MCWP 40,B00,893304,Montejo; Carolina,14,0,20,6
1746595516529,MCWP 40R,A00,893757,Redela; Pamela Morgan,0,5,20,20
1746595517558,MCWP 50,A00,893758,Morshed; Michael James,0,0,20,20
1746595517558,MCWP 50,B00,893761,Bartulis; Jason Michael,17,0,20,3
1746595518587,MCWP 50R,A00,893766,Compas; Sean Matthew,0,1,20,20
1746595518587,MCWP 50R,B00,893769,Carter; Jennifer A,0,1,20,20
1746595518587,MCWP 50R,C00,893771,Krone; Jarret,0,3,20,20
1746595518587,MCWP 50R,D00,893772,Miller; Elizabeth Deen,0,0,20,20
1746595518587,MCWP 50R,E00,893775,Carter; Andrea L,0,1,20,20
1746595519613,MMW 11R,A01,892721,Herbst; Matthew,14,0,30,16
1746595519613,MMW 11R,A02,892722,Herbst; Matthew,0,0,0,3
1746595520638,MMW 12R,A01,892724,Herbst; Matthew,0,11,16,16
1746595520638,MMW 12R,A02,892725,Herbst; Matthew,0,10,16,16
1746595521665,MMW 13R,A01,892727,Staff,0,4,16,16
1746595521665,MMW 13R,A02,892728,Staff,0,4,16,16
1746595521665,MMW 13R,A03,958032,Staff,0,4,16,16
1746595521665,MMW 13R,A04,958033,Staff,0,4,16,16
1746595521665,MMW 13R,A05,958034,Staff,0,4,16,16
1746595522691,SIO 295LS,A00,894015,Staff,5,0,25,20
1746595523717,SIO 295S,A00,894020,Staff,5,0,25,20
1746595524746,SIOC 290S,B01,958918,Merrifield; Mark A,14,0,30,16
1746595525777,SIOC 291S,B01,958922,Gabriel; Corey John,14,0,30,16
1746595526805,SOCI 117,A01,895339,Staff,2,0,5,3
1746595527833,WES 237B,A00,894149,Staff,11,0,20,9
1746595529892,AESE 279B,A00,891859,Staff,13,0,35,22
1746595530920,AIP 197,001,891854,Vespa; Emanuel Ignacio,9999,0,9999,0
1746595531948,ANTH 289S,A00,891856,Gagneux; Pascal,12,0,12,0
1746595532977,BENG 196,001,957946,Engler; Adam J.,9996,0,9999,3
1746595534003,BISP 197,001,959851,Wilhelm; James E.,9998,0,9999,1
1746595535032,CAT 124RS,A01,956906,Staff,6,0,25,19
1746595536060,CAT 125RS,A01,922013,Staff,6,0,25,19
1746595537087,CLRE 250,A00,891860,Morris; Sheldon,9995,0,9999,4
1746595539140,CLRE 251R,A00,907817,Mehta; Ravindra L.,9994,0,9999,5
1746595540166,CLRE 252,A00,891864,Cuomo; Raphael Eduardo,9993,0,9999,6
1746595541192,CLRE 253,A00,891867,Vaida; Florin,9994,0,9999,5
1746595541192,CLRE 253,B00,907819,Staff,9999,0,9999,0
1746595542220,CLRE 259,A00,891868,Patel; Hemal,9998,0,9999,1
1746595543245,CLRE 260,A00,891872,Cuomo; Raphael Eduardo,9999,0,9999,0
1746595544274,CLRE 297,001,891888,Cuomo; Raphael Eduardo,9999,0,9999,0
1746595545301,CSE 191,A00,958773,Minnes Kemp; Mor Mia,9995,0,9999,4
1746595546327,CSE 197,001,959846,Minnes Kemp; Mor Mia,9990,0,9999,9
1746595547352,CSS 201S,A01,892054,Mignozzetti; Umberto,25,0,30,5
1746595548379,CSS 202S,A01,892056,Mignozzetti; Umberto,25,0,30,5
1746595549408,DSC 197,001,956898,Eldridge; Justin Matthew,9996,0,9999,3
1746595550432,DSC 297,001,958000,Mazumdar; Arya,9998,0,9999,1
1746595550432,DSC 297,002,959862,Wang; Yusu,9998,0,9999,1
1746595551456,EAP 100,A00,905686,Staff,9778,0,9999,221
1746595552483,ECE 45,A01,892618,Staff,0,0,65,65
1746595554537,ECE 111,A01,892719,Staff,6,0,65,59
1746595555562,ECE 197,001,957920,Mercier; Patrick Philip,9991,0,9999,8
1746595556589,ECON 178,A01,907814,Zhu; Ying,26,0,35,9
1746595557617,EDS 115,A00,895312,Staff,35,0,45,10
1746595558645,EDS 117,A01,895337,Staff,23,0,30,7
1746595559670,EDS 125,A00,895341,Jones; Gabrielle Anastasia,36,0,45,9
1746595560695,EDS 128A,A01,895459,Fargason; Sharon Gayle,44,0,45,1
1746595561722,EDS 128B,A01,895543,Pappas; Elizabeth,44,0,45,1
1746595562750,EDS 139,A00,897203,Pappas; Elizabeth,44,0,45,1
1746595562750,EDS 139,B00,897209,Fargason; Sharon Gayle,41,0,45,4
1746595563776,EDS 201,A00,895545,Staff,22,0,45,23
1746595564802,EDS 203,A01,895581,Halter; Christopher P.,22,0,45,23
1746595565827,EDS 204R,A01,895625,Heinzman; Erica M.,39,0,45,6
1746595565827,EDS 204R,B01,895693,Halter; Christopher P.,10,0,45,35
1746595566856,EDS 206R,A00,895694,Fargason; Sharon Gayle,1,0,30,29
1746595566856,EDS 206R,B00,895695,Choi; Bailey Miyeon,16,0,30,14
1746595567880,EDS 250,A00,895697,Hemans; Patricia Ann Benitez,22,0,45,23
1746595568906,EDS 281,A00,895701,Meyerott; Theresa Ann,1,0,15,14
1746595569933,EDS 284,A00,895736,Meyerott; Theresa Ann,1,0,15,14
1746595570961,EDS 286,A00,897210,Fine; Sarah,0,0,15,15
1746595571989,EDS 289C,A01,895770,Daly; Alan J.,1,0,15,14
1746595573019,EDS 290,A00,897211,Hofstetter; Carolyn,0,0,15,15
1746595574047,LIGM 5A,A00,896162,Fischer-Grunski; Eva K,12,0,20,8
1746595575078,LIGM 5B,A00,896260,Fischer-Grunski; Eva K,17,0,20,3
1746595576107,LIGM 5C,A00,896308,Fischer-Grunski; Eva K,18,0,20,2
1746595577136,LIIT 5AS,A00,896313,Carnelos; Chiara,18,0,20,2
1746595578162,LIIT 5BS,A00,896416,Carnelos; Chiara,20,0,20,0
1746595579192,LIIT 5CS,A00,896564,Carnelos; Chiara,20,0,20,0
1746595580216,LISP 5A,A00,896588,Munoz Sanchez; Alicia,2,0,20,18
1746595581243,LISP 5B,A00,896653,Munoz Sanchez; Alicia,7,0,20,13
1746595582269,LISP 5C,A00,896655,Munoz Sanchez; Alicia,0,1,20,20
1746595583297,MAE 197,001,957918,Kleissl; Jan,9996,0,9999,3
1746595583297,MAE 197,002,959806,Boechler; Nicholas Sebastia,9998,0,9999,1
1746595583297,MAE 197,003,959852,Mullin; Jennifer S,9998,0,9999,1
1746595584361,MATH 2,A01,957937,Staff,33,0,35,2
1746595585390,MATH 197,001,957876,Kedlaya; Kiran S.,9993,0,9999,6
1746595586414,MCWP 40,A00,892729,Duru; Nur,10,0,20,10
1746595586414,MCWP 40,B00,893304,Montejo; Carolina,14,0,20,6
1746595587439,MCWP 40R,A00,893757,Redela; Pamela Morgan,0,5,20,20
1746595588464,MCWP 50,A00,893758,Morshed; Michael James,0,0,20,20
1746595588464,MCWP 50,B00,893761,Bartulis; Jason Michael,17,0,20,3
1746595589495,MCWP 50R,A00,893766,Compas; Sean Matthew,0,1,20,20
1746595589495,MCWP 50R,B00,893769,Carter; Jennifer A,0,1,20,20
1746595589495,MCWP 50R,C00,893771,Krone; Jarret,0,3,20,20
1746595589495,MCWP 50R,D00,893772,Miller; Elizabeth Deen,0,0,20,20
1746595589495,MCWP 50R,E00,893775,Carter; Andrea L,0,1,20,20
1746595590521,MMW 11R,A01,892721,Herbst; Matthew,14,0,30,16
1746595590521,MMW 11R,A02,892722,Herbst; Matthew,0,0,0,3
1746595591550,MMW 12R,A01,892724,Herbst; Matthew,0,11,16,16
1746595591550,MMW 12R,A02,892725,Herbst; Matthew,0,10,16,16
1746595592577,MMW 13R,A01,892727,Staff,0,4,16,16
1746595592577,MMW 13R,A02,892728,Staff,0,4,16,16
1746595592577,MMW 13R,A03,958032,Staff,0,4,16,16
1746595592577,MMW 13R,A04,958033,Staff,0,4,16,16
1746595592577,MMW 13R,A05,958034,Staff,0,4,16,16
1746595593603,SIO 295LS,A00,894015,Staff,5,0,25,20
1746595594630,SIO 295S,A00,894020,Staff,5,0,25,20
1746595595661,SIOC 290S,B01,958918,Merrifield; Mark A,14,0,30,16
1746595596687,SIOC 291S,B01,958922,Gabriel; Corey John,14,0,30,16
1746595597713,SOCI 117,A01,895339,Staff,2,0,5,3
1746595598742,WES 237B,A00,894149,Staff,11,0,20,9
1746595600803,AESE 279B,A00,891859,Staff,13,0,35,22
1746595601828,AIP 197,001,891854,Vespa; Emanuel Ignacio,9999,0,9999,0
1746595602853,ANTH 289S,A00,891856,Gagneux; Pascal,12,0,12,0
1746595603880,BENG 196,001,957946,Engler; Adam J.,9996,0,9999,3
1746595604909,BISP 197,001,959851,Wilhelm; James E.,9998,0,9999,1
1746595605933,CAT 124RS,A01,956906,Staff,6,0,25,19
1746595606958,CAT 125RS,A01,922013,Staff,6,0,25,19
1746595607983,CLRE 250,A00,891860,Morris; Sheldon,9995,0,9999,4
1746595610038,CLRE 251R,A00,907817,Mehta; Ravindra L.,9994,0,9999,5
1746595611067,CLRE 252,A00,891864,Cuomo; Raphael Eduardo,9993,0,9999,6
1746595612095,CLRE 253,A00,891867,Vaida; Florin,9994,0,9999,5
1746595612095,CLRE 253,B00,907819,Staff,9999,0,9999,0
1746595613124,CLRE 259,A00,891868,Patel; Hemal,9998,0,9999,1
1746595614148,CLRE 260,A00,891872,Cuomo; Raphael Eduardo,9999,0,9999,0
1746595615177,CLRE 297,001,891888,Cuomo; Raphael Eduardo,9999,0,9999,0
1746595616203,CSE 191,A00,958773,Minnes Kemp; Mor Mia,9995,0,9999,4
1746595617229,CSE 197,001,959846,Minnes Kemp; Mor Mia,9990,0,9999,9
1746595618257,CSS 201S,A01,892054,Mignozzetti; Umberto,25,0,30,5
1746595619283,CSS 202S,A01,892056,Mignozzetti; Umberto,25,0,30,5
1746595620308,DSC 197,001,956898,Eldridge; Justin Matthew,9996,0,9999,3
1746595621335,DSC 297,001,958000,Mazumdar; Arya,9998,0,9999,1
1746595621335,DSC 297,002,959862,Wang; Yusu,9998,0,9999,1
1746595622360,EAP 100,A00,905686,Staff,9778,0,9999,221
1746595623387,ECE 45,A01,892618,Staff,0,0,65,65
1746595625438,ECE 111,A01,892719,Staff,6,0,65,59
1746595626466,ECE 197,001,957920,Mercier; Patrick Philip,9991,0,9999,8
1746595627495,ECON 178,A01,907814,Zhu; Ying,26,0,35,9
1746595628520,EDS 115,A00,895312,Staff,35,0,45,10
1746595629546,EDS 117,A01,895337,Staff,23,0,30,7
1746595630574,EDS 125,A00,895341,Jones; Gabrielle Anastasia,36,0,45,9
1746595631599,EDS 128A,A01,895459,Fargason; Sharon Gayle,44,0,45,1
1746595632625,EDS 128B,A01,895543,Pappas; Elizabeth,44,0,45,1
1746595633652,EDS 139,A00,897203,Pappas; Elizabeth,44,0,45,1
1746595633652,EDS 139,B00,897209,Fargason; Sharon Gayle,41,0,45,4
1746595634681,EDS 201,A00,895545,Staff,22,0,45,23
1746595635709,EDS 203,A01,895581,Halter; Christopher P.,22,0,45,23
1746595636733,EDS 204R,A01,895625,Heinzman; Erica M.,39,0,45,6
1746595636733,EDS 204R,B01,895693,Halter; Christopher P.,10,0,45,35
1746595637759,EDS 206R,A00,895694,Fargason; Sharon Gayle,1,0,30,29
1746595637759,EDS 206R,B00,895695,Choi; Bailey Miyeon,16,0,30,14
1746595638786,EDS 250,A00,895697,Hemans; Patricia Ann Benitez,22,0,45,23
1746595639813,EDS 281,A00,895701,Meyerott; Theresa Ann,1,0,15,14
1746595640837,EDS 284,A00,895736,Meyerott; Theresa Ann,1,0,15,14
1746595641864,EDS 286,A00,897210,Fine; Sarah,0,0,15,15
1746595642890,EDS 289C,A01,895770,Daly; Alan J.,1,0,15,14
1746595643917,EDS 290,A00,897211,Hofstetter; Carolyn,0,0,15,15
1746595644947,LIGM 5A,A00,896162,Fischer-Grunski; Eva K,12,0,20,8
1746595645973,LIGM 5B,A00,896260,Fischer-Grunski; Eva K,17,0,20,3
1746595646997,LIGM 5C,A00,896308,Fischer-Grunski; Eva K,18,0,20,2
1746595648021,LIIT 5AS,A00,896313,Carnelos; Chiara,18,0,20,2
1746595649045,LIIT 5BS,A00,896416,Carnelos; Chiara,20,0,20,0
1746595650072,LIIT 5CS,A00,896564,Carnelos; Chiara,20,0,20,0
1746595651097,LISP 5A,A00,896588,Munoz Sanchez; Alicia,2,0,20,18
1746595652126,LISP 5B,A00,896653,Munoz Sanchez; Alicia,7,0,20,13
1746595653151,LISP 5C,A00,896655,Munoz Sanchez; Alicia,0,1,20,20
1746595654177,MAE 197,001,957918,Kleissl; Jan,9996,0,9999,3
1746595654177,MAE 197,002,959806,Boechler; Nicholas Sebastia,9998,0,9999,1
1746595654177,MAE 197,003,959852,Mullin; Jennifer S,9998,0,9999,1
1746595655202,MATH 2,A01,957937,Staff,33,0,35,2
1746595656226,MATH 197,001,957876,Kedlaya; Kiran S.,9993,0,9999,6
1746595657251,MCWP 40,A00,892729,Duru; Nur,10,0,20,10
1746595657251,MCWP 40,B00,893304,Montejo; Carolina,14,0,20,6
1746595658277,MCWP 40R,A00,893757,Redela; Pamela Morgan,0,5,20,20
1746595659302,MCWP 50,A00,893758,Morshed; Michael James,0,0,20,20
1746595659302,MCWP 50,B00,893761,Bartulis; Jason Michael,17,0,20,3
1746595660329,MCWP 50R,A00,893766,Compas; Sean Matthew,0,1,20,20
1746595660329,MCWP 50R,B00,893769,Carter; Jennifer A,0,1,20,20
1746595660329,MCWP 50R,C00,893771,Krone; Jarret,0,3,20,20
1746595660329,MCWP 50R,D00,893772,Miller; Elizabeth Deen,0,0,20,20
1746595660329,MCWP 50R,E00,893775,Carter; Andrea L,0,1,20,20
1746595661353,MMW 11R,A01,892721,Herbst; Matthew,14,0,30,16
1746595661353,MMW 11R,A02,892722,Herbst; Matthew,0,0,0,3
1746595662380,MMW 12R,A01,892724,Herbst; Matthew,0,11,16,16
1746595662380,MMW 12R,A02,892725,Herbst; Matthew,0,10,16,16
1746595663410,MMW 13R,A01,892727,Staff,0,4,16,16
1746595663410,MMW 13R,A02,892728,Staff,0,4,16,16
1746595663410,MMW 13R,A03,958032,Staff,0,4,16,16
1746595663410,MMW 13R,A04,958033,Staff,0,4,16,16
1746595663410,MMW 13R,A05,958034,Staff,0,4,16,16
1746595664435,SIO 295LS,A00,894015,Staff,5,0,25,20
1746595665465,SIO 295S,A00,894020,Staff,5,0,25,20
1746595666489,SIOC 290S,B01,958918,Merrifield; Mark A,14,0,30,16
1746595667515,SIOC 291S,B01,958922,Gabriel; Corey John,14,0,30,16
1746595668543,SOCI 117,A01,895339,Staff,2,0,5,3
1746595669568,WES 237B,A00,894149,Staff,11,0,20,9
1746595671635,AESE 279B,A00,891859,Staff,13,0,35,22
1746595672659,AIP 197,001,891854,Vespa; Emanuel Ignacio,9999,0,9999,0
1746595673687,ANTH 289S,A00,891856,Gagneux; Pascal,12,0,12,0
1746595674712,BENG 196,001,957946,Engler; Adam J.,9996,0,9999,3
1746595675739,BISP 197,001,959851,Wilhelm; James E.,9998,0,9999,1
1746595676765,CAT 124RS,A01,956906,Staff,6,0,25,19
1746595677790,CAT 125RS,A01,922013,Staff,6,0,25,19
1746595678819,CLRE 250,A00,891860,Morris; Sheldon,9995,0,9999,4
1746595680870,CLRE 251R,A00,907817,Mehta; Ravindra L.,9994,0,9999,5
1746595681900,CLRE 252,A00,891864,Cuomo; Raphael Eduardo,9993,0,9999,6
1746595682924,CLRE 253,A00,891867,Vaida; Florin,9994,0,9999,5
1746595682924,CLRE 253,B00,907819,Staff,9999,0,9999,0
1746595683950,CLRE 259,A00,891868,Patel; Hemal,9998,0,9999,1
1746595684974,CLRE 260,A00,891872,Cuomo; Raphael Eduardo,9999,0,9999,0
1746595686000,CLRE 297,001,891888,Cuomo; Raphael Eduardo,9999,0,9999,0
1746595687027,CSE 191,A00,958773,Minnes Kemp; Mor Mia,9995,0,9999,4
1746595688055,CSE 197,001,959846,Minnes Kemp; Mor Mia,9990,0,9999,9
1746595689080,CSS 201S,A01,892054,Mignozzetti; Umberto,25,0,30,5
1746595690107,CSS 202S,A01,892056,Mignozzetti; Umberto,25,0,30,5
1746595691134,DSC 197,001,956898,Eldridge; Justin Matthew,9996,0,9999,3
1746595692160,DSC 297,001,958000,Mazumdar; Arya,9998,0,9999,1
1746595692160,DSC 297,002,959862,Wang; Yusu,9998,0,9999,1
1746595693187,EAP 100,A00,905686,Staff,9778,0,9999,221
1746595694216,ECE 45,A01,892618,Staff,0,0,65,65
1746595696264,ECE 111,A01,892719,Staff,6,0,65,59
1746595697289,ECE 197,001,957920,Mercier; Patrick Philip,9991,0,9999,8
1746595698314,ECON 178,A01,907814,Zhu; Ying,26,0,35,9
1746595699342,EDS 115,A00,895312,Staff,35,0,45,10
1746595700370,EDS 117,A01,895337,Staff,23,0,30,7
1746595701396,EDS 125,A00,895341,Jones; Gabrielle Anastasia,36,0,45,9
1746595702421,EDS 128A,A01,895459,Fargason; Sharon Gayle,44,0,45,1
1746595703449,EDS 128B,A01,895543,Pappas; Elizabeth,44,0,45,1
1746595704475,EDS 139,A00,897203,Pappas; Elizabeth,44,0,45,1
1746595704475,EDS 139,B00,897209,Fargason; Sharon Gayle,41,0,45,4
1746595705501,EDS 201,A00,895545,Staff,22,0,45,23
1746595706531,EDS 203,A01,895581,Halter; Christopher P.,22,0,45,23
1746595707556,EDS 204R,A01,895625,Heinzman; Erica M.,39,0,45,6
1746595707556,EDS 204R,B01,895693,Halter; Christopher P.,10,0,45,35
1746595708582,EDS 206R,A00,895694,Fargason; Sharon Gayle,1,0,30,29
1746595708582,EDS 206R,B00,895695,Choi; Bailey Miyeon,16,0,30,14
1746595709605,EDS 250,A00,895697,Hemans; Patricia Ann Benitez,22,0,45,23
1746595710630,EDS 281,A00,895701,Meyerott; Theresa Ann,1,0,15,14
1746595711656,EDS 284,A00,895736,Meyerott; Theresa Ann,1,0,15,14
1746595712685,EDS 286,A00,897210,Fine; Sarah,0,0,15,15
1746595713711,EDS 289C,A01,895770,Daly; Alan J.,1,0,15,14
1746595714738,EDS 290,A00,897211,Hofstetter; Carolyn,0,0,15,15
1746595715767,LIGM 5A,A00,896162,Fischer-Grunski; Eva K,12,0,20,8
1746595716797,LIGM 5B,A00,896260,Fischer-Grunski; Eva K,17,0,20,3
1746595717822,LIGM 5C,A00,896308,Fischer-Grunski; Eva K,18,0,20,2
1746595718853,LIIT 5AS,A00,896313,Carnelos; Chiara,18,0,20,2
1746595719879,LIIT 5BS,A00,896416,Carnelos; Chiara,20,0,20,0
1746595720909,LIIT 5CS,A00,896564,Carnelos; Chiara,20,0,20,0
1746595721937,LISP 5A,A00,896588,Munoz Sanchez; Alicia,2,0,20,18
1746595722965,LISP 5B,A00,896653,Munoz Sanchez; Alicia,7,0,20,13
1746595723993,LISP 5C,A00,896655,Munoz Sanchez; Alicia,0,1,20,20
1746595725021,MAE 197,001,957918,Kleissl; Jan,9996,0,9999,3
1746595725021,MAE 197,002,959806,Boechler; Nicholas Sebastia,9998,0,9999,1
1746595725021,MAE 197,003,959852,Mullin; Jennifer S,9998,0,9999,1
1746595726047,MATH 2,A01,957937,Staff,33,0,35,2
1746595727077,MATH 197,001,957876,Kedlaya; Kiran S.,9993,0,9999,6
1746595728103,MCWP 40,A00,892729,Duru; Nur,10,0,20,10
1746595728103,MCWP 40,B00,893304,Montejo; Carolina,14,0,20,6
1746595729127,MCWP 40R,A00,893757,Redela; Pamela Morgan,0,5,20,20
1746595730153,MCWP 50,A00,893758,Morshed; Michael James,0,0,20,20
1746595730153,MCWP 50,B00,893761,Bartulis; Jason Michael,17,0,20,3
1746595731180,MCWP 50R,A00,893766,Compas; Sean Matthew,0,1,20,20
1746595731180,MCWP 50R,B00,893769,Carter; Jennifer A,0,1,20,20
1746595731180,MCWP 50R,C00,893771,Krone; Jarret,0,3,20,20
1746595731180,MCWP 50R,D00,893772,Miller; Elizabeth Deen,0,0,20,20
1746595731180,MCWP 50R,E00,893775,Carter; Andrea L,0,1,20,20
1746595732205,MMW 11R,A01,892721,Herbst; Matthew,14,0,30,16
1746595732205,MMW 11R,A02,892722,Herbst; Matthew,0,0,0,3
1746595733233,MMW 12R,A01,892724,Herbst; Matthew,0,11,16,16
1746595733233,MMW 12R,A02,892725,Herbst; Matthew,0,10,16,16
1746595734262,MMW 13R,A01,892727,Staff,0,4,16,16
1746595734262,MMW 13R,A02,892728,Staff,0,4,16,16
1746595734262,MMW 13R,A03,958032,Staff,0,4,16,16
1746595734262,MMW 13R,A04,958033,Staff,0,4,16,16
1746595734262,MMW 13R,A05,958034,Staff,0,4,16,16
1746595735288,SIO 295LS,A00,894015,Staff,5,0,25,20
1746595736317,SIO 295S,A00,894020,Staff,5,0,25,20
1746595737343,SIOC 290S,B01,958918,Merrifield; Mark A,14,0,30,16
1746595738371,SIOC 291S,B01,958922,Gabriel; Corey John,14,0,30,16
1746595739400,SOCI 117,A01,895339,Staff,2,0,5,3
1746595740424,WES 237B,A00,894149,Staff,11,0,20,9
1746595742488,AESE 279B,A00,891859,Staff,13,0,35,22
1746595743514,AIP 197,001,891854,Vespa; Emanuel Ignacio,9999,0,9999,0
1746595744540,ANTH 289S,A00,891856,Gagneux; Pascal,12,0,12,0
1746595745564,BENG 196,001,957946,Engler; Adam J.,9996,0,9999,3
1746595746591,BISP 197,001,959851,Wilhelm; James E.,9998,0,9999,1
1746595747615,CAT 124RS,A01,956906,Staff,6,0,25,19
1746595748640,CAT 125RS,A01,922013,Staff,6,0,25,19
1746595749670,CLRE 250,A00,891860,Morris; Sheldon,9995,0,9999,4
1746595751723,CLRE 251R,A00,907817,Mehta; Ravindra L.,9994,0,9999,5
1746595752750,CLRE 252,A00,891864,Cuomo; Raphael Eduardo,9993,0,9999,6
1746595753776,CLRE 253,A00,891867,Vaida; Florin,9994,0,9999,5
1746595753776,CLRE 253,B00,907819,Staff,9999,0,9999,0
1746595754805,CLRE 259,A00,891868,Patel; Hemal,9998,0,9999,1
1746595755829,CLRE 260,A00,891872,Cuomo; Raphael Eduardo,9999,0,9999,0
1746595756853,CLRE 297,001,891888,Cuomo; Raphael Eduardo,9999,0,9999,0
1746595757878,CSE 191,A00,958773,Minnes Kemp; Mor Mia,9995,0,9999,4
1746595758906,CSE 197,001,959846,Minnes Kemp; Mor Mia,9990,0,9999,9
1746595759935,CSS 201S,A01,892054,Mignozzetti; Umberto,25,0,30,5
1746595760962,CSS 202S,A01,892056,Mignozzetti; Umberto,25,0,30,5
1746595761988,DSC 197,001,956898,Eldridge; Justin Matthew,9996,0,9999,3
1746595763013,DSC 297,001,958000,Mazumdar; Arya,9998,0,9999,1
1746595763013,DSC 297,002,959862,Wang; Yusu,9998,0,9999,1
1746595764038,EAP 100,A00,905686,Staff,9778,0,9999,221
1746595765067,ECE 45,A01,892618,Staff,0,0,65,65
1746595767118,ECE 111,A01,892719,Staff,6,0,65,59
1746595768142,ECE 197,001,957920,Mercier; Patrick Philip,9991,0,9999,8
1746595769170,ECON 178,A01,907814,Zhu; Ying,26,0,35,9
1746595770195,EDS 115,A00,895312,Staff,35,0,45,10
1746595771219,EDS 117,A01,895337,Staff,23,0,30,7
1746595772246,EDS 125,A00,895341,Jones; Gabrielle Anastasia,36,0,45,9
1746595773272,EDS 128A,A01,895459,Fargason; Sharon Gayle,44,0,45,1
1746595774300,EDS 128B,A01,895543,Pappas; Elizabeth,44,0,45,1
1746595775329,EDS 139,A00,897203,Pappas; Elizabeth,44,0,45,1
1746595775329,EDS 139,B00,897209,Fargason; Sharon Gayle,41,0,45,4
1746595776356,EDS 201,A00,895545,Staff,22,0,45,23
1746595777380,EDS 203,A01,895581,Halter; Christopher P.,22,0,45,23
1746595778405,EDS 204R,A01,895625,Heinzman; Erica M.,39,0,45,6
1746595778405,EDS 204R,B01,895693,Halter; Christopher P.,10,0,45,35
1746595779429,EDS 206R,A00,895694,Fargason; Sharon Gayle,1,0,30,29
1746595779429,EDS 206R,B00,895695,Choi; Bailey Miyeon,16,0,30,14
1746595780455,EDS 250,A00,895697,Hemans; Patricia Ann Benitez,22,0,45,23
1746595781481,EDS 281,A00,895701,Meyerott; Theresa Ann,1,0,15,14
1746595782508,EDS 284,A00,895736,Meyerott; Theresa Ann,1,0,15,14
1746595783536,EDS 286,A00,897210,Fine; Sarah,0,0,15,15
1746595784562,EDS 289C,A01,895770,Daly; Alan J.,1,0,15,14
1746595785590,EDS 290,A00,897211,Hofstetter; Carolyn,0,0,15,15
1746595786620,LIGM 5A,A00,896162,Fischer-Grunski; Eva K,12,0,20,8
1746595787650,LIGM 5B,A00,896260,Fischer-Grunski; Eva K,17,0,20,3
1746595788675,LIGM 5C,A00,896308,Fischer-Grunski; Eva K,18,0,20,2
1746595789701,LIIT 5AS,A00,896313,Carnelos; Chiara,18,0,20,2
1746595790728,LIIT 5BS,A00,896416,Carnelos; Chiara,20,0,20,0
1746595791753,LIIT 5CS,A00,896564,Carnelos; Chiara,20,0,20,0
1746595792780,LISP 5A,A00,896588,Munoz Sanchez; Alicia,2,0,20,18
1746595793806,LISP 5B,A00,896653,Munoz Sanchez; Alicia,7,0,20,13
1746595794832,LISP 5C,A00,896655,Munoz Sanchez; Alicia,0,1,20,20
1746595795858,MAE 197,001,957918,Kleissl; Jan,9996,0,9999,3
1746595795858,MAE 197,002,959806,Boechler; Nicholas Sebastia,9998,0,9999,1
1746595795858,MAE 197,003,959852,Mullin; Jennifer S,9998,0,9999,1
1746595796886,MATH 2,A01,957937,Staff,33,0,35,2
1746595797911,MATH 197,001,957876,Kedlaya; Kiran S.,9993,0,9999,6
1746595798937,MCWP 40,A00,892729,Duru; Nur,10,0,20,10
1746595798937,MCWP 40,B00,893304,Montejo; Carolina,14,0,20,6
1746595799963,MCWP 40R,A00,893757,Redela; Pamela Morgan,0,5,20,20
1746595800988,MCWP 50,A00,893758,Morshed; Michael James,0,0,20,20
1746595800988,MCWP 50,B00,893761,Bartulis; Jason Michael,17,0,20,3
1746595802020,MCWP 50R,A00,893766,Compas; Sean Matthew,0,1,20,20
1746595802020,MCWP 50R,B00,893769,Carter; Jennifer A,0,1,20,20
1746595802020,MCWP 50R,C00,893771,Krone; Jarret,0,3,20,20
1746595802020,MCWP 50R,D00,893772,Miller; Elizabeth Deen,0,0,20,20
1746595802020,MCWP 50R,E00,893775,Carter; Andrea L,0,1,20,20
1746595803046,MMW 11R,A01,892721,Herbst; Matthew,14,0,30,16
1746595803046,MMW 11R,A02,892722,Herbst; Matthew,0,0,0,3
1746595804075,MMW 12R,A01,892724,Herbst; Matthew,0,11,16,16
1746595804075,MMW 12R,A02,892725,Herbst; Matthew,0,10,16,16
1746595805100,MMW 13R,A01,892727,Staff,0,4,16,16
1746595805100,MMW 13R,A02,892728,Staff,0,4,16,16
1746595805100,MMW 13R,A03,958032,Staff,0,4,16,16
1746595805100,MMW 13R,A04,958033,Staff,0,4,16,16
1746595805100,MMW 13R,A05,958034,Staff,0,4,16,16
1746595806126,SIO 295LS,A00,894015,Staff,5,0,25,20
1746595807153,SIO 295S,A00,894020,Staff,5,0,25,20
1746595808178,SIOC 290S,B01,958918,Merrifield; Mark A,14,0,30,16
1746595809205,SIOC 291S,B01,958922,Gabriel; Corey John,14,0,30,16
1746595810230,SOCI 117,A01,895339,Staff,2,0,5,3
1746595811258,WES 237B,A00,894149,Staff,11,0,20,9
1746595813328,AESE 279B,A00,891859,Staff,13,0,35,22
1746595814355,AIP 197,001,891854,Vespa; Emanuel Ignacio,9999,0,9999,0
1746595815383,ANTH 289S,A00,891856,Gagneux; Pascal,12,0,12,0
1746595816406,BENG 196,001,957946,Engler; Adam J.,9996,0,9999,3
1746595817435,BISP 197,001,959851,Wilhelm; James E.,9998,0,9999,1
1746595818460,CAT 124RS,A01,956906,Staff,6,0,25,19
1746595819486,CAT 125RS,A01,922013,Staff,6,0,25,19
1746595820516,CLRE 250,A00,891860,Morris; Sheldon,9995,0,9999,4
1746595822566,CLRE 251R,A00,907817,Mehta; Ravindra L.,9994,0,9999,5
1746595823591,CLRE 252,A00,891864,Cuomo; Raphael Eduardo,9993,0,9999,6
1746595824622,CLRE 253,A00,891867,Vaida; Florin,9994,0,9999,5
1746595824622,CLRE 253,B00,907819,Staff,9999,0,9999,0
1746595825647,CLRE 259,A00,891868,Patel; Hemal,9998,0,9999,1
1746595826672,CLRE 260,A00,891872,Cuomo; Raphael Eduardo,9999,0,9999,0
1746595827697,CLRE 297,001,891888,Cuomo; Raphael Eduardo,9999,0,9999,0
1746595828723,CSE 191,A00,958773,Minnes Kemp; Mor Mia,9995,0,9999,4
1746595829750,CSE 197,001,959846,Minnes Kemp; Mor Mia,9990,0,9999,9
1746595830779,CSS 201S,A01,892054,Mignozzetti; Umberto,25,0,30,5
1746595831811,CSS 202S,A01,892056,Mignozzetti; Umberto,25,0,30,5
1746595832836,DSC 197,001,956898,Eldridge; Justin Matthew,9996,0,9999,3
1746595833860,DSC 297,001,958000,Mazumdar; Arya,9998,0,9999,1
1746595833860,DSC 297,002,959862,Wang; Yusu,9998,0,9999,1
1746595834886,EAP 100,A00,905686,Staff,9778,0,9999,221
1746595835915,ECE 45,A01,892618,Staff,0,0,65,65
1746595837965,ECE 111,A01,892719,Staff,6,0,65,59
1746595838990,ECE 197,001,957920,Mercier; Patrick Philip,9991,0,9999,8
1746595840016,ECON 178,A01,907814,Zhu; Ying,26,0,35,9
1746595841040,EDS 115,A00,895312,Staff,35,0,45,10
1746595842070,EDS 117,A01,895337,Staff,23,0,30,7
1746595843095,EDS 125,A00,895341,Jones; Gabrielle Anastasia,36,0,45,9
1746595844121,EDS 128A,A01,895459,Fargason; Sharon Gayle,44,0,45,1
1746595845146,EDS 128B,A01,895543,Pappas; Elizabeth,44,0,45,1
1746595846177,EDS 139,A00,897203,Pappas; Elizabeth,44,0,45,1
1746595846177,EDS 139,B00,897209,Fargason; Sharon Gayle,41,0,45,4
1746595847202,EDS 201,A00,895545,Staff,22,0,45,23
1746595848230,EDS 203,A01,895581,Halter; Christopher P.,22,0,45,23
1746595849260,EDS 204R,A01,895625,Heinzman; Erica M.,39,0,45,6
1746595849260,EDS 204R,B01,895693,Halter; Christopher P.,10,0,45,35
1746595850288,EDS 206R,A00,895694,Fargason; Sharon Gayle,1,0,30,29
1746595850288,EDS 206R,B00,895695,Choi; Bailey Miyeon,16,0,30,14
1746595851315,EDS 250,A00,895697,Hemans; Patricia Ann Benitez,22,0,45,23
1746595852340,EDS 281,A00,895701,Meyerott; Theresa Ann,1,0,15,14
1746595853366,EDS 284,A00,895736,Meyerott; Theresa Ann,1,0,15,14
1746595854392,EDS 286,A00,897210,Fine; Sarah,0,0,15,15
1746595855416,EDS 289C,A01,895770,Daly; Alan J.,1,0,15,14
1746595856443,EDS 290,A00,897211,Hofstetter; Carolyn,0,0,15,15
1746595857469,LIGM 5A,A00,896162,Fischer-Grunski; Eva K,12,0,20,8
1746595858494,LIGM 5B,A00,896260,Fischer-Grunski; Eva K,17,0,20,3
1746595859520,LIGM 5C,A00,896308,Fischer-Grunski; Eva K,18,0,20,2
1746595860550,LIIT 5AS,A00,896313,Carnelos; Chiara,18,0,20,2
1746595861577,LIIT 5BS,A00,896416,Carnelos; Chiara,20,0,20,0
1746595862605,LIIT 5CS,A00,896564,Carnelos; Chiara,20,0,20,0
1746595863631,LISP 5A,A00,896588,Munoz Sanchez; Alicia,2,0,20,18
1746595864657,LISP 5B,A00,896653,Munoz Sanchez; Alicia,7,0,20,13
1746595865684,LISP 5C,A00,896655,Munoz Sanchez; Alicia,0,1,20,20
1746595866710,MAE 197,001,957918,Kleissl; Jan,9996,0,9999,3
1746595866710,MAE 197,002,959806,Boechler; Nicholas Sebastia,9998,0,9999,1
1746595866710,MAE 197,003,959852,Mullin; Jennifer S,9998,0,9999,1
1746595867736,MATH 2,A01,957937,Staff,33,0,35,2
1746595868764,MATH 197,001,957876,Kedlaya; Kiran S.,9993,0,9999,6
1746595869793,MCWP 40,A00,892729,Duru; Nur,10,0,20,10
1746595869793,MCWP 40,B00,893304,Montejo; Carolina,14,0,20,6
1746595870819,MCWP 40R,A00,893757,Redela; Pamela Morgan,0,5,20,20
1746595871845,MCWP 50,A00,893758,Morshed; Michael James,0,0,20,20
1746595871845,MCWP 50,B00,893761,Bartulis; Jason Michael,17,0,20,3
1746595872872,MCWP 50R,A00,893766,Compas; Sean Matthew,0,1,20,20
1746595872872,MCWP 50R,B00,893769,Carter; Jennifer A,0,1,20,20
1746595872872,MCWP 50R,C00,893771,Krone; Jarret,0,3,20,20
1746595872872,MCWP 50R,D00,893772,Miller; Elizabeth Deen,0,0,20,20
1746595872872,MCWP 50R,E00,893775,Carter; Andrea L,0,1,20,20
1746595873897,MMW 11R,A01,892721,Herbst; Matthew,14,0,30,16
1746595873897,MMW 11R,A02,892722,Herbst; Matthew,0,0,0,3
1746595874924,MMW 12R,A01,892724,Herbst; Matthew,0,11,16,16
1746595874924,MMW 12R,A02,892725,Herbst; Matthew,0,10,16,16
1746595875951,MMW 13R,A01,892727,Staff,0,4,16,16
1746595875951,MMW 13R,A02,892728,Staff,0,4,16,16
1746595875951,MMW 13R,A03,958032,Staff,0,4,16,16
1746595875951,MMW 13R,A04,958033,Staff,0,4,16,16
1746595875951,MMW 13R,A05,958034,Staff,0,4,16,16
1746595876977,SIO 295LS,A00,894015,Staff,5,0,25,20
1746595878004,SIO 295S,A00,894020,Staff,5,0,25,20
1746595879029,SIOC 290S,B01,958918,Merrifield; Mark A,14,0,30,16
1746595880056,SIOC 291S,B01,958922,Gabriel; Corey John,14,0,30,16
1746595881085,SOCI 117,A01,895339,Staff,2,0,5,3
1746595882111,WES 237B,A00,894149,Staff,11,0,20,9
1746595884174,AESE 279B,A00,891859,Staff,13,0,35,22
1746595885199,AIP 197,001,891854,Vespa; Emanuel Ignacio,9999,0,9999,0
1746595886225,ANTH 289S,A00,891856,Gagneux; Pascal,12,0,12,0
1746595887249,BENG 196,001,957946,Engler; Adam J.,9996,0,9999,3
1746595888278,BISP 197,001,959851,Wilhelm; James E.,9998,0,9999,1
1746595889304,CAT 124RS,A01,956906,Staff,6,0,25,19
1746595890331,CAT 125RS,A01,922013,Staff,6,0,25,19
1746595891358,CLRE 250,A00,891860,Morris; Sheldon,9995,0,9999,4
1746595893408,CLRE 251R,A00,907817,Mehta; Ravindra L.,9994,0,9999,5
1746595894433,CLRE 252,A00,891864,Cuomo; Raphael Eduardo,9993,0,9999,6
1746595895461,CLRE 253,A00,891867,Vaida; Florin,9994,0,9999,5
1746595895461,CLRE 253,B00,907819,Staff,9999,0,9999,0
1746595896488,CLRE 259,A00,891868,Patel; Hemal,9998,0,9999,1
1746595897519,CLRE 260,A00,891872,Cuomo; Raphael Eduardo,9999,0,9999,0
1746595898546,CLRE 297,001,891888,Cuomo; Raphael Eduardo,9999,0,9999,0
1746595899575,CSE 191,A00,958773,Minnes Kemp; Mor Mia,9995,0,9999,4
1746595900601,CSE 197,001,959846,Minnes Kemp; Mor Mia,9990,0,9999,9
1746595901628,CSS 201S,A01,892054,Mignozzetti; Umberto,25,0,30,5
1746595902654,CSS 202S,A01,892056,Mignozzetti; Umberto,25,0,30,5
1746595903682,DSC 197,001,956898,Eldridge; Justin Matthew,9996,0,9999,3
1746595904706,DSC 297,001,958000,Mazumdar; Arya,9998,0,9999,1
1746595904706,DSC 297,002,959862,Wang; Yusu,9998,0,9999,1
1746595905733,EAP 100,A00,905686,Staff,9778,0,9999,221
1746595906764,ECE 45,A01,892618,Staff,0,0,65,65
1746595908815,ECE 111,A01,892719,Staff,6,0,65,59
1746595909840,ECE 197,001,957920,Mercier; Patrick Philip,9991,0,9999,8
1746595910872,ECON 178,A01,907814,Zhu; Ying,26,0,35,9
1746595911897,EDS 115,A00,895312,Staff,35,0,45,10
1746595912923,EDS 117,A01,895337,Staff,23,0,30,7
1746595913950,EDS 125,A00,895341,Jones; Gabrielle Anastasia,36,0,45,9
1746595914979,EDS 128A,A01,895459,Fargason; Sharon Gayle,44,0,45,1
1746595916004,EDS 128B,A01,895543,Pappas; Elizabeth,44,0,45,1
1746595917034,EDS 139,A00,897203,Pappas; Elizabeth,44,0,45,1
1746595917034,EDS 139,B00,897209,Fargason; Sharon Gayle,41,0,45,4
1746595918059,EDS 201,A00,895545,Staff,22,0,45,23
1746595919085,EDS 203,A01,895581,Halter; Christopher P.,22,0,45,23
1746595920111,EDS 204R,A01,895625,Heinzman; Erica M.,39,0,45,6
1746595920111,EDS 204R,B01,895693,Halter; Christopher P.,10,0,45,35
1746595921136,EDS 206R,A00,895694,Fargason; Sharon Gayle,1,0,30,29
1746595921136,EDS 206R,B00,895695,Choi; Bailey Miyeon,16,0,30,14
1746595922162,EDS 250,A00,895697,Hemans; Patricia Ann Benitez,22,0,45,23
1746595923190,EDS 281,A00,895701,Meyerott; Theresa Ann,1,0,15,14
1746595924217,EDS 284,A00,895736,Meyerott; Theresa Ann,1,0,15,14
1746595925243,EDS 286,A00,897210,Fine; Sarah,0,0,15,15
1746595926270,EDS 289C,A01,895770,Daly; Alan J.,1,0,15,14
1746595927294,EDS 290,A00,897211,Hofstetter; Carolyn,0,0,15,15
1746595928320,LIGM 5A,A00,896162,Fischer-Grunski; Eva K,12,0,20,8
1746595929346,LIGM 5B,A00,896260,Fischer-Grunski; Eva K,17,0,20,3
1746595930370,LIGM 5C,A00,896308,Fischer-Grunski; Eva K,18,0,20,2
1746595931397,LIIT 5AS,A00,896313,Carnelos; Chiara,18,0,20,2
1746595932422,LIIT 5BS,A00,896416,Carnelos; Chiara,20,0,20,0
1746595933448,LIIT 5CS,A00,896564,Carnelos; Chiara,20,0,20,0
1746595934472,LISP 5A,A00,896588,Munoz Sanchez; Alicia,2,0,20,18
1746595935501,LISP 5B,A00,896653,Munoz Sanchez; Alicia,7,0,20,13
1746595936527,LISP 5C,A00,896655,Munoz Sanchez; Alicia,0,1,20,20
1746595937557,MAE 197,001,957918,Kleissl; Jan,9996,0,9999,3
1746595937557,MAE 197,002,959806,Boechler; Nicholas Sebastia,9998,0,9999,1
1746595937557,MAE 197,003,959852,Mullin; Jennifer S,9998,0,9999,1
1746595938584,MATH 2,A01,957937,Staff,33,0,35,2
1746595939609,MATH 197,001,957876,Kedlaya; Kiran S.,9993,0,9999,6
1746595940633,MCWP 40,A00,892729,Duru; Nur,10,0,20,10
1746595940633,MCWP 40,B00,893304,Montejo; Carolina,14,0,20,6
1746595941659,MCWP 40R,A00,893757,Redela; Pamela Morgan,0,5,20,20
1746595942684,MCWP 50,A00,893758,Morshed; Michael James,0,0,20,20
1746595942684,MCWP 50,B00,893761,Bartulis; Jason Michael,17,0,20,3
1746595943713,MCWP 50R,A00,893766,Compas; Sean Matthew,0,1,20,20
1746595943713,MCWP 50R,B00,893769,Carter; Jennifer A,0,1,20,20
1746595943713,MCWP 50R,C00,893771,Krone; Jarret,0,3,20,20
1746595943713,MCWP 50R,D00,893772,Miller; Elizabeth Deen,0,0,20,20
1746595943713,MCWP 50R,E00,893775,Carter; Andrea L,0,1,20,20
1746595944742,MMW 11R,A01,892721,Herbst; Matthew,14,0,30,16
1746595944742,MMW 11R,A02,892722,Herbst; Matthew,0,0,0,3
1746595945769,MMW 12R,A01,892724,Herbst; Matthew,0,11,16,16
1746595945769,MMW 12R,A02,892725,Herbst; Matthew,0,10,16,16
1746595946794,MMW 13R,A01,892727,Staff,0,4,16,16
1746595946794,MMW 13R,A02,892728,Staff,0,4,16,16
1746595946794,MMW 13R,A03,958032,Staff,0,4,16,16
1746595946794,MMW 13R,A04,958033,Staff,0,4,16,16
1746595946794,MMW 13R,A05,958034,Staff,0,4,16,16
1746595947820,SIO 295LS,A00,894015,Staff,5,0,25,20
1746595948848,SIO 295S,A00,894020,Staff,5,0,25,20
1746595949873,SIOC 290S,B01,958918,Merrifield; Mark A,14,0,30,16
1746595951104,SIOC 291S,B01,958922,Gabriel; Corey John,14,0,30,16
1746595952130,SOCI 117,A01,895339,Staff,2,0,5,3
1746595953155,WES 237B,A00,894149,Staff,11,0,20,9
1746595955223,AESE 279B,A00,891859,Staff,13,0,35,22
1746595956248,AIP 197,001,891854,Vespa; Emanuel Ignacio,9999,0,9999,0
1746595957275,ANTH 289S,A00,891856,Gagneux; Pascal,12,0,12,0
1746595958300,BENG 196,001,957946,Engler; Adam J.,9996,0,9999,3
1746595959325,BISP 197,001,959851,Wilhelm; James E.,9998,0,9999,1
1746595960352,CAT 124RS,A01,956906,Staff,6,0,25,19
1746595961377,CAT 125RS,A01,922013,Staff,6,0,25,19
1746595962403,CLRE 250,A00,891860,Morris; Sheldon,9995,0,9999,4
1746595964454,CLRE 251R,A00,907817,Mehta; Ravindra L.,9994,0,9999,5
1746595965479,CLRE 252,A00,891864,Cuomo; Raphael Eduardo,9993,0,9999,6
1746595966508,CLRE 253,A00,891867,Vaida; Florin,9994,0,9999,5
1746595966508,CLRE 253,B00,907819,Staff,9999,0,9999,0
1746595967536,CLRE 259,A00,891868,Patel; Hemal,9998,0,9999,1
1746595968562,CLRE 260,A00,891872,Cuomo; Raphael Eduardo,9999,0,9999,0
1746595969591,CLRE 297,001,891888,Cuomo; Raphael Eduardo,9999,0,9999,0
1746595970618,CSE 191,A00,958773,Minnes Kemp; Mor Mia,9995,0,9999,4
1746595971645,CSE 197,001,959846,Minnes Kemp; Mor Mia,9990,0,9999,9
1746595972674,CSS 201S,A01,892054,Mignozzetti; Umberto,25,0,30,5
1746595973700,CSS 202S,A01,892056,Mignozzetti; Umberto,25,0,30,5
1746595974729,DSC 197,001,956898,Eldridge; Justin Matthew,9996,0,9999,3
1746595975755,DSC 297,001,958000,Mazumdar; Arya,9998,0,9999,1
1746595975755,DSC 297,002,959862,Wang; Yusu,9998,0,9999,1
1746595976782,EAP 100,A00,905686,Staff,9778,0,9999,221
1746595977810,ECE 45,A01,892618,Staff,0,0,65,65
1746595979861,ECE 111,A01,892719,Staff,6,0,65,59
1746595980888,ECE 197,001,957920,Mercier; Patrick Philip,9991,0,9999,8
1746595981970,ECON 178,A01,907814,Zhu; Ying,26,0,35,9
1746595982995,EDS 115,A00,895312,Staff,35,0,45,10
1746595984022,EDS 117,A01,895337,Staff,23,0,30,7
1746595985047,EDS 125,A00,895341,Jones; Gabrielle Anastasia,36,0,45,9
1746595986072,EDS 128A,A01,895459,Fargason; Sharon Gayle,44,0,45,1
1746595987095,EDS 128B,A01,895543,Pappas; Elizabeth,44,0,45,1
1746595988124,EDS 139,A00,897203,Pappas; Elizabeth,44,0,45,1
1746595988124,EDS 139,B00,897209,Fargason; Sharon Gayle,41,0,45,4
1746595989152,EDS 201,A00,895545,Staff,22,0,45,23
1746595990180,EDS 203,A01,895581,Halter; Christopher P.,22,0,45,23
1746595991209,EDS 204R,A01,895625,Heinzman; Erica M.,39,0,45,6
1746595991209,EDS 204R,B01,895693,Halter; Christopher P.,10,0,45,35
1746595992235,EDS 206R,A00,895694,Fargason; Sharon Gayle,1,0,30,29
1746595992235,EDS 206R,B00,895695,Choi; Bailey Miyeon,16,0,30,14
1746595993263,EDS 250,A00,895697,Hemans; Patricia Ann Benitez,22,0,45,23
1746595994291,EDS 281,A00,895701,Meyerott; Theresa Ann,1,0,15,14
1746595995314,EDS 284,A00,895736,Meyerott; Theresa Ann,1,0,15,14
1746595996339,EDS 286,A00,897210,Fine; Sarah,0,0,15,15
1746595997364,EDS 289C,A01,895770,Daly; Alan J.,1,0,15,14
1746595998388,EDS 290,A00,897211,Hofstetter; Carolyn,0,0,15,15
1746595999414,LIGM 5A,A00,896162,Fischer-Grunski; Eva K,12,0,20,8
1746596000441,LIGM 5B,A00,896260,Fischer-Grunski; Eva K,17,0,20,3
1746596001470,LIGM 5C,A00,896308,Fischer-Grunski; Eva K,18,0,20,2
1746596002494,LIIT 5AS,A00,896313,Carnelos; Chiara,18,0,20,2
1746596003520,LIIT 5BS,A00,896416,Carnelos; Chiara,20,0,20,0
1746596004545,LIIT 5CS,A00,896564,Carnelos; Chiara,20,0,20,0
1746596005597,LISP 5A,A00,896588,Munoz Sanchez; Alicia,2,0,20,18
1746596006624,LISP 5B,A00,896653,Munoz Sanchez; Alicia,7,0,20,13
1746596007655,LISP 5C,A00,896655,Munoz Sanchez; Alicia,0,1,20,20
1746596009223,MAE 197,001,957918,Kleissl; Jan,9996,0,9999,3
1746596009223,MAE 197,002,959806,Boechler; Nicholas Sebastia,9998,0,9999,1
1746596009223,MAE 197,003,959852,Mullin; Jennifer S,9998,0,9999,1
1746596010251,MATH 2,A01,957937,Staff,33,0,35,2
1746596011275,MATH 197,001,957876,Kedlaya; Kiran S.,9993,0,9999,6
1746596012303,MCWP 40,A00,892729,Duru; Nur,10,0,20,10
1746596012303,MCWP 40,B00,893304,Montejo; Carolina,14,0,20,6
1746596013327,MCWP 40R,A00,893757,Redela; Pamela Morgan,0,5,20,20
1746596014351,MCWP 50,A00,893758,Morshed; Michael James,0,0,20,20
1746596014351,MCWP 50,B00,893761,Bartulis; Jason Michael,17,0,20,3
1746596015380,MCWP 50R,A00,893766,Compas; Sean Matthew,0,1,20,20
1746596015380,MCWP 50R,B00,893769,Carter; Jennifer A,0,1,20,20
1746596015380,MCWP 50R,C00,893771,Krone; Jarret,0,3,20,20
1746596015380,MCWP 50R,D00,893772,Miller; Elizabeth Deen,0,0,20,20
1746596015380,MCWP 50R,E00,893775,Carter; Andrea L,0,1,20,20
1746596016405,MMW 11R,A01,892721,Herbst; Matthew,14,0,30,16
1746596016405,MMW 11R,A02,892722,Herbst; Matthew,0,0,0,3
1746596017431,MMW 12R,A01,892724,Herbst; Matthew,0,11,16,16
1746596017431,MMW 12R,A02,892725,Herbst; Matthew,0,10,16,16
1746596018460,MMW 13R,A01,892727,Staff,0,4,16,16
1746596018460,MMW 13R,A02,892728,Staff,0,4,16,16
1746596018460,MMW 13R,A03,958032,Staff,0,4,16,16
1746596018460,MMW 13R,A04,958033,Staff,0,4,16,16
1746596018460,MMW 13R,A05,958034,Staff,0,4,16,16
1746596019486,SIO 295LS,A00,894015,Staff,5,0,25,20
1746596020512,SIO 295S,A00,894020,Staff,5,0,25,20
1746596021539,SIOC 290S,B01,958918,Merrifield; Mark A,14,0,30,16
1746596022569,SIOC 291S,B01,958922,Gabriel; Corey John,14,0,30,16
1746596023596,SOCI 117,A01,895339,Staff,2,0,5,3
1746596024624,WES 237B,A00,894149,Staff,11,0,20,9
1746596026694,AESE 279B,A00,891859,Staff,13,0,35,22
1746596027719,AIP 197,001,891854,Vespa; Emanuel Ignacio,9999,0,9999,0
1746596028745,ANTH 289S,A00,891856,Gagneux; Pascal,12,0,12,0
1746596029769,BENG 196,001,957946,Engler; Adam J.,9996,0,9999,3
1746596030795,BISP 197,001,959851,Wilhelm; James E.,9998,0,9999,1
1746596031825,CAT 124RS,A01,956906,Staff,6,0,25,19
1746596032851,CAT 125RS,A01,922013,Staff,6,0,25,19
1746596033876,CLRE 250,A00,891860,Morris; Sheldon,9995,0,9999,4
1746596035928,CLRE 251R,A00,907817,Mehta; Ravindra L.,9994,0,9999,5
1746596036957,CLRE 252,A00,891864,Cuomo; Raphael Eduardo,9993,0,9999,6
1746596037987,CLRE 253,A00,891867,Vaida; Florin,9994,0,9999,5
1746596037987,CLRE 253,B00,907819,Staff,9999,0,9999,0
1746596039013,CLRE 259,A00,891868,Patel; Hemal,9998,0,9999,1
1746596040041,CLRE 260,A00,891872,Cuomo; Raphael Eduardo,9999,0,9999,0
1746596041070,CLRE 297,001,891888,Cuomo; Raphael Eduardo,9999,0,9999,0
1746596042298,CSE 191,A00,958773,Minnes Kemp; Mor Mia,9995,0,9999,4
1746596043328,CSE 197,001,959846,Minnes Kemp; Mor Mia,9990,0,9999,9
1746596044352,CSS 201S,A01,892054,Mignozzetti; Umberto,25,0,30,5
1746596045379,CSS 202S,A01,892056,Mignozzetti; Umberto,25,0,30,5
1746596046406,DSC 197,001,956898,Eldridge; Justin Matthew,9996,0,9999,3
1746596047435,DSC 297,001,958000,Mazumdar; Arya,9998,0,9999,1
1746596047435,DSC 297,002,959862,Wang; Yusu,9998,0,9999,1
1746596048461,EAP 100,A00,905686,Staff,9778,0,9999,221
1746596049489,ECE 45,A01,892618,Staff,0,0,65,65
1746596051595,ECE 111,A01,892719,Staff,6,0,65,59
1746596052621,ECE 197,001,957920,Mercier; Patrick Philip,9991,0,9999,8
1746596053648,ECON 178,A01,907814,Zhu; Ying,26,0,35,9
1746596054678,EDS 115,A00,895312,Staff,35,0,45,10
1746596055705,EDS 117,A01,895337,Staff,23,0,30,7
1746596056732,EDS 125,A00,895341,Jones; Gabrielle Anastasia,36,0,45,9
1746596057757,EDS 128A,A01,895459,Fargason; Sharon Gayle,44,0,45,1
1746596058785,EDS 128B,A01,895543,Pappas; Elizabeth,44,0,45,1
1746596059811,EDS 139,A00,897203,Pappas; Elizabeth,44,0,45,1
1746596059811,EDS 139,B00,897209,Fargason; Sharon Gayle,41,0,45,4
1746596060840,EDS 201,A00,895545,Staff,22,0,45,23
1746596061867,EDS 203,A01,895581,Halter; Christopher P.,22,0,45,23
1746596062894,EDS 204R,A01,895625,Heinzman; Erica M.,39,0,45,6
1746596062894,EDS 204R,B01,895693,Halter; Christopher P.,10,0,45,35
1746596063921,EDS 206R,A00,895694,Fargason; Sharon Gayle,1,0,30,29
1746596063921,EDS 206R,B00,895695,Choi; Bailey Miyeon,16,0,30,14
1746596064947,EDS 250,A00,895697,Hemans; Patricia Ann Benitez,22,0,45,23
1746596065973,EDS 281,A00,895701,Meyerott; Theresa Ann,1,0,15,14
1746596067003,EDS 284,A00,895736,Meyerott; Theresa Ann,1,0,15,14
1746596068028,EDS 286,A00,897210,Fine; Sarah,0,0,15,15
1746596069053,EDS 289C,A01,895770,Daly; Alan J.,1,0,15,14
1746596070082,EDS 290,A00,897211,Hofstetter; Carolyn,0,0,15,15
1746596071108,LIGM 5A,A00,896162,Fischer-Grunski; Eva K,12,0,20,8
1746596072137,LIGM 5B,A00,896260,Fischer-Grunski; Eva K,17,0,20,3
1746596073166,LIGM 5C,A00,896308,Fischer-Grunski; Eva K,18,0,20,2
1746596074193,LIIT 5AS,A00,896313,Carnelos; Chiara,18,0,20,2
1746596075220,LIIT 5BS,A00,896416,Carnelos; Chiara,20,0,20,0
1746596076245,LIIT 5CS,A00,896564,Carnelos; Chiara,20,0,20,0
1746596077273,LISP 5A,A00,896588,Munoz Sanchez; Alicia,2,0,20,18
1746596078304,LISP 5B,A00,896653,Munoz Sanchez; Alicia,7,0,20,13
1746596079331,LISP 5C,A00,896655,Munoz Sanchez; Alicia,0,1,20,20
1746596080357,MAE 197,001,957918,Kleissl; Jan,9996,0,9999,3
1746596080357,MAE 197,002,959806,Boechler; Nicholas Sebastia,9998,0,9999,1
1746596080357,MAE 197,003,959852,Mullin; Jennifer S,9998,0,9999,1
1746596081385,MATH 2,A01,957937,Staff,33,0,35,2
1746596082424,MATH 197,001,957876,Kedlaya; Kiran S.,9993,0,9999,6
1746596083450,MCWP 40,A00,892729,Duru; Nur,10,0,20,10
1746596083450,MCWP 40,B00,893304,Montejo; Carolina,14,0,20,6
1746596084479,MCWP 40R,A00,893757,Redela; Pamela Morgan,0,5,20,20
1746596085504,MCWP 50,A00,893758,Morshed; Michael James,0,0,20,20
1746596085504,MCWP 50,B00,893761,Bartulis; Jason Michael,17,0,20,3
1746596086533,MCWP 50R,A00,893766,Compas; Sean Matthew,0,1,20,20
1746596086533,MCWP 50R,B00,893769,Carter; Jennifer A,0,1,20,20
1746596086533,MCWP 50R,C00,893771,Krone; Jarret,0,3,20,20
1746596086533,MCWP 50R,D00,893772,Miller; Elizabeth Deen,0,0,20,20
1746596086533,MCWP 50R,E00,893775,Carter; Andrea L,0,1,20,20
1746596087561,MMW 11R,A01,892721,Herbst; Matthew,14,0,30,16
1746596087561,MMW 11R,A02,892722,Herbst; Matthew,0,0,0,3
1746596088587,MMW 12R,A01,892724,Herbst; Matthew,0,11,16,16
1746596088587,MMW 12R,A02,892725,Herbst; Matthew,0,10,16,16
1746596089613,MMW 13R,A01,892727,Staff,0,4,16,16
1746596089613,MMW 13R,A02,892728,Staff,0,4,16,16
1746596089613,MMW 13R,A03,958032,Staff,0,4,16,16
1746596089613,MMW 13R,A04,958033,Staff,0,4,16,16
1746596089613,MMW 13R,A05,958034,Staff,0,4,16,16
1746596090638,SIO 295LS,A00,894015,Staff,5,0,25,20
1746596091666,SIO 295S,A00,894020,Staff,5,0,25,20
1746596092695,SIOC 290S,B01,958918,Merrifield; Mark A,14,0,30,16
1746596093721,SIOC 291S,B01,958922,Gabriel; Corey John,14,0,30,16
1746596094749,SOCI 117,A01,895339,Staff,2,0,5,3
1746596095777,WES 237B,A00,894149,Staff,11,0,20,9
1746596097832,AESE 279B,A00,891859,Staff,13,0,35,22
1746596098857,AIP 197,001,891854,Vespa; Emanuel Ignacio,9999,0,9999,0
1746596099883,ANTH 289S,A00,891856,Gagneux; Pascal,12,0,12,0
1746596100908,BENG 196,001,957946,Engler; Adam J.,9996,0,9999,3
1746596101935,BISP 197,001,959851,Wilhelm; James E.,9998,0,9999,1
1746596102962,CAT 124RS,A01,956906,Staff,6,0,25,19
1746596103990,CAT 125RS,A01,922013,Staff,6,0,25,19
1746596105018,CLRE 250,A00,891860,Morris; Sheldon,9995,0,9999,4
1746596107072,CLRE 251R,A00,907817,Mehta; Ravindra L.,9994,0,9999,5
1746596108098,CLRE 252,A00,891864,Cuomo; Raphael Eduardo,9993,0,9999,6
1746596109122,CLRE 253,A00,891867,Vaida; Florin,9994,0,9999,5
1746596109122,CLRE 253,B00,907819,Staff,9999,0,9999,0
1746596110149,CLRE 259,A00,891868,Patel; Hemal,9998,0,9999,1
1746596111190,CLRE 260,A00,891872,Cuomo; Raphael Eduardo,9999,0,9999,0
1746596112218,CLRE 297,001,891888,Cuomo; Raphael Eduardo,9999,0,9999,0
1746596113246,CSE 191,A00,958773,Minnes Kemp; Mor Mia,9995,0,9999,4
1746596114273,CSE 197,001,959846,Minnes Kemp; Mor Mia,9990,0,9999,9
1746596115298,CSS 201S,A01,892054,Mignozzetti; Umberto,25,0,30,5
1746596116322,CSS 202S,A01,892056,Mignozzetti; Umberto,25,0,30,5
1746596117352,DSC 197,001,956898,Eldridge; Justin Matthew,9996,0,9999,3
1746596118383,DSC 297,001,958000,Mazumdar; Arya,9998,0,9999,1
1746596118383,DSC 297,002,959862,Wang; Yusu,9998,0,9999,1
1746596119408,EAP 100,A00,905686,Staff,9778,0,9999,221
1746596120435,ECE 45,A01,892618,Staff,0,0,65,65
1746596122492,ECE 111,A01,892719,Staff,6,0,65,59
1746596123522,ECE 197,001,957920,Mercier; Patrick Philip,9991,0,9999,8
1746596124551,ECON 178,A01,907814,Zhu; Ying,26,0,35,9
1746596125578,EDS 115,A00,895312,Staff,35,0,45,10
1746596126618,EDS 117,A01,895337,Staff,23,0,30,7
1746596127646,EDS 125,A00,895341,Jones; Gabrielle Anastasia,36,0,45,9
1746596128671,EDS 128A,A01,895459,Fargason; Sharon Gayle,44,0,45,1
1746596129697,EDS 128B,A01,895543,Pappas; Elizabeth,44,0,45,1
1746596130724,EDS 139,A00,897203,Pappas; Elizabeth,44,0,45,1
1746596130724,EDS 139,B00,897209,Fargason; Sharon Gayle,41,0,45,4
1746596131753,EDS 201,A00,895545,Staff,22,0,45,23
1746596132780,EDS 203,A01,895581,Halter; Christopher P.,22,0,45,23
1746596133806,EDS 204R,A01,895625,Heinzman; Erica M.,39,0,45,6
1746596133806,EDS 204R,B01,895693,Halter; Christopher P.,10,0,45,35
1746596134831,EDS 206R,A00,895694,Fargason; Sharon Gayle,1,0,30,29
1746596134831,EDS 206R,B00,895695,Choi; Bailey Miyeon,16,0,30,14
1746596135860,EDS 250,A00,895697,Hemans; Patricia Ann Benitez,22,0,45,23
1746596136886,EDS 281,A00,895701,Meyerott; Theresa Ann,1,0,15,14
1746596137916,EDS 284,A00,895736,Meyerott; Theresa Ann,1,0,15,14
1746596138942,EDS 286,A00,897210,Fine; Sarah,0,0,15,15
1746596139970,EDS 289C,A01,895770,Daly; Alan J.,1,0,15,14
1746596140995,EDS 290,A00,897211,Hofstetter; Carolyn,0,0,15,15
1746596142020,LIGM 5A,A00,896162,Fischer-Grunski; Eva K,12,0,20,8
1746596143048,LIGM 5B,A00,896260,Fischer-Grunski; Eva K,17,0,20,3
1746596144079,LIGM 5C,A00,896308,Fischer-Grunski; Eva K,18,0,20,2
1746596145104,LIIT 5AS,A00,896313,Carnelos; Chiara,18,0,20,2
1746596146130,LIIT 5BS,A00,896416,Carnelos; Chiara,20,0,20,0
1746596147160,LIIT 5CS,A00,896564,Carnelos; Chiara,20,0,20,0
1746596148187,LISP 5A,A00,896588,Munoz Sanchez; Alicia,2,0,20,18
1746596149215,LISP 5B,A00,896653,Munoz Sanchez; Alicia,7,0,20,13
1746596150245,LISP 5C,A00,896655,Munoz Sanchez; Alicia,0,1,20,20
1746596151270,MAE 197,001,957918,Kleissl; Jan,9996,0,9999,3
1746596151270,MAE 197,002,959806,Boechler; Nicholas Sebastia,9998,0,9999,1
1746596151270,MAE 197,003,959852,Mullin; Jennifer S,9998,0,9999,1
1746596152297,MATH 2,A01,957937,Staff,33,0,35,2
1746596153324,MATH 197,001,957876,Kedlaya; Kiran S.,9993,0,9999,6
1746596154357,MCWP 40,A00,892729,Duru; Nur,10,0,20,10
1746596154357,MCWP 40,B00,893304,Montejo; Carolina,14,0,20,6
1746596155389,MCWP 40R,A00,893757,Redela; Pamela Morgan,0,5,20,20
1746596156417,MCWP 50,A00,893758,Morshed; Michael James,0,0,20,20
1746596156417,MCWP 50,B00,893761,Bartulis; Jason Michael,17,0,20,3
1746596157447,MCWP 50R,A00,893766,Compas; Sean Matthew,0,1,20,20
1746596157447,MCWP 50R,B00,893769,Carter; Jennifer A,0,1,20,20
1746596157447,MCWP 50R,C00,893771,Krone; Jarret,0,3,20,20
1746596157447,MCWP 50R,D00,893772,Miller; Elizabeth Deen,0,0,20,20
1746596157447,MCWP 50R,E00,893775,Carter; Andrea L,0,1,20,20
1746596158475,MMW 11R,A01,892721,Herbst; Matthew,14,0,30,16
1746596158475,MMW 11R,A02,892722,Herbst; Matthew,0,0,0,3
1746596159503,MMW 12R,A01,892724,Herbst; Matthew,0,11,16,16
1746596159503,MMW 12R,A02,892725,Herbst; Matthew,0,10,16,16
1746596160529,MMW 13R,A01,892727,Staff,0,4,16,16
1746596160529,MMW 13R,A02,892728,Staff,0,4,16,16
1746596160529,MMW 13R,A03,958032,Staff,0,4,16,16
1746596160529,MMW 13R,A04,958033,Staff,0,4,16,16
1746596160529,MMW 13R,A05,958034,Staff,0,4,16,16
1746596161555,SIO 295LS,A00,894015,Staff,5,0,25,20
1746596162581,SIO 295S,A00,894020,Staff,5,0,25,20
1746596163608,SIOC 290S,B01,958918,Merrifield; Mark A,14,0,30,16
1746596164635,SIOC 291S,B01,958922,Gabriel; Corey John,14,0,30,16
1746596165660,SOCI 117,A01,895339,Staff,2,0,5,3
1746596166685,WES 237B,A00,894149,Staff,11,0,20,9
1746596168748,AESE 279B,A00,891859,Staff,13,0,35,22
1746596169780,AIP 197,001,891854,Vespa; Emanuel Ignacio,9999,0,9999,0
1746596170807,ANTH 289S,A00,891856,Gagneux; Pascal,12,0,12,0
1746596171832,BENG 196,001,957946,Engler; Adam J.,9996,0,9999,3
1746596172860,BISP 197,001,959851,Wilhelm; James E.,9998,0,9999,1
1746596173953,CAT 124RS,A01,956906,Staff,6,0,25,19
1746596174983,CAT 125RS,A01,922013,Staff,6,0,25,19
1746596176012,CLRE 250,A00,891860,Morris; Sheldon,9995,0,9999,4
1746596178068,CLRE 251R,A00,907817,Mehta; Ravindra L.,9994,0,9999,5
1746596179093,CLRE 252,A00,891864,Cuomo; Raphael Eduardo,9993,0,9999,6
1746596180124,CLRE 253,A00,891867,Vaida; Florin,9994,0,9999,5
1746596180124,CLRE 253,B00,907819,Staff,9999,0,9999,0
1746596181153,CLRE 259,A00,891868,Patel; Hemal,9998,0,9999,1
1746596182178,CLRE 260,A00,891872,Cuomo; Raphael Eduardo,9999,0,9999,0
1746596183204,CLRE 297,001,891888,Cuomo; Raphael Eduardo,9999,0,9999,0
1746596184231,CSE 191,A00,958773,Minnes Kemp; Mor Mia,9995,0,9999,4
1746596185255,CSE 197,001,959846,Minnes Kemp; Mor Mia,9990,0,9999,9
1746596186284,CSS 201S,A01,892054,Mignozzetti; Umberto,25,0,30,5
1746596187310,CSS 202S,A01,892056,Mignozzetti; Umberto,25,0,30,5
1746596188334,DSC 197,001,956898,Eldridge; Justin Matthew,9996,0,9999,3
1746596189360,DSC 297,001,958000,Mazumdar; Arya,9998,0,9999,1
1746596189360,DSC 297,002,959862,Wang; Yusu,9998,0,9999,1
1746596190388,EAP 100,A00,905686,Staff,9778,0,9999,221
1746596191415,ECE 45,A01,892618,Staff,0,0,65,65
1746596193473,ECE 111,A01,892719,Staff,6,0,65,59
1746596194499,ECE 197,001,957920,Mercier; Patrick Philip,9991,0,9999,8
1746596195529,ECON 178,A01,907814,Zhu; Ying,26,0,35,9
1746596196558,EDS 115,A00,895312,Staff,35,0,45,10
1746596197586,EDS 117,A01,895337,Staff,23,0,30,7
1746596198613,EDS 125,A00,895341,Jones; Gabrielle Anastasia,36,0,45,9
1746596199641,EDS 128A,A01,895459,Fargason; Sharon Gayle,44,0,45,1
1746596200670,EDS 128B,A01,895543,Pappas; Elizabeth,44,0,45,1
1746596201697,EDS 139,A00,897203,Pappas; Elizabeth,44,0,45,1
1746596201697,EDS 139,B00,897209,Fargason; Sharon Gayle,41,0,45,4
1746596202723,EDS 201,A00,895545,Staff,22,0,45,23
1746596203748,EDS 203,A01,895581,Halter; Christopher P.,22,0,45,23
1746596204773,EDS 204R,A01,895625,Heinzman; Erica M.,39,0,45,6
1746596204773,EDS 204R,B01,895693,Halter; Christopher P.,10,0,45,35
1746596205801,EDS 206R,A00,895694,Fargason; Sharon Gayle,1,0,30,29
1746596205801,EDS 206R,B00,895695,Choi; Bailey Miyeon,16,0,30,14
1746596206827,EDS 250,A00,895697,Hemans; Patricia Ann Benitez,22,0,45,23
1746596207854,EDS 281,A00,895701,Meyerott; Theresa Ann,1,0,15,14
1746596208881,EDS 284,A00,895736,Meyerott; Theresa Ann,1,0,15,14
1746596209908,EDS 286,A00,897210,Fine; Sarah,0,0,15,15
1746596210933,EDS 289C,A01,895770,Daly; Alan J.,1,0,15,14
1746596211960,EDS 290,A00,897211,Hofstetter; Carolyn,0,0,15,15
1746596212992,LIGM 5A,A00,896162,Fischer-Grunski; Eva K,12,0,20,8
1746596214019,LIGM 5B,A00,896260,Fischer-Grunski; Eva K,17,0,20,3
1746596215049,LIGM 5C,A00,896308,Fischer-Grunski; Eva K,18,0,20,2
1746596216075,LIIT 5AS,A00,896313,Carnelos; Chiara,18,0,20,2
1746596217101,LIIT 5BS,A00,896416,Carnelos; Chiara,20,0,20,0
1746596218130,LIIT 5CS,A00,896564,Carnelos; Chiara,20,0,20,0
1746596219156,LISP 5A,A00,896588,Munoz Sanchez; Alicia,2,0,20,18
1746596220182,LISP 5B,A00,896653,Munoz Sanchez; Alicia,7,0,20,13
1746596221209,LISP 5C,A00,896655,Munoz Sanchez; Alicia,0,1,20,20
1746596222236,MAE 197,001,957918,Kleissl; Jan,9996,0,9999,3
1746596222236,MAE 197,002,959806,Boechler; Nicholas Sebastia,9998,0,9999,1
1746596222236,MAE 197,003,959852,Mullin; Jennifer S,9998,0,9999,1
1746596223261,MATH 2,A01,957937,Staff,33,0,35,2
1746596224287,MATH 197,001,957876,Kedlaya; Kiran S.,9993,0,9999,6
1746596225313,MCWP 40,A00,892729,Duru; Nur,10,0,20,10
1746596225313,MCWP 40,B00,893304,Montejo; Carolina,14,0,20,6
1746596226340,MCWP 40R,A00,893757,Redela; Pamela Morgan,0,5,20,20
1746596227367,MCWP 50,A00,893758,Morshed; Michael James,0,0,20,20
1746596227367,MCWP 50,B00,893761,Bartulis; Jason Michael,17,0,20,3
1746596228396,MCWP 50R,A00,893766,Compas; Sean Matthew,0,1,20,20
1746596228396,MCWP 50R,B00,893769,Carter; Jennifer A,0,1,20,20
1746596228396,MCWP 50R,C00,893771,Krone; Jarret,0,3,20,20
1746596228396,MCWP 50R,D00,893772,Miller; Elizabeth Deen,0,0,20,20
1746596228396,MCWP 50R,E00,893775,Carter; Andrea L,0,1,20,20
1746596229424,MMW 11R,A01,892721,Herbst; Matthew,14,0,30,16
1746596229424,MMW 11R,A02,892722,Herbst; Matthew,0,0,0,3
1746596230450,MMW 12R,A01,892724,Herbst; Matthew,0,11,16,16
1746596230450,MMW 12R,A02,892725,Herbst; Matthew,0,10,16,16
1746596231477,MMW 13R,A01,892727,Staff,0,4,16,16
1746596231477,MMW 13R,A02,892728,Staff,0,4,16,16
1746596231477,MMW 13R,A03,958032,Staff,0,4,16,16
1746596231477,MMW 13R,A04,958033,Staff,0,4,16,16
1746596231477,MMW 13R,A05,958034,Staff,0,4,16,16
1746596232504,SIO 295LS,A00,894015,Staff,5,0,25,20
1746596233528,SIO 295S,A00,894020,Staff,5,0,25,20
1746596234558,SIOC 290S,B01,958918,Merrifield; Mark A,14,0,30,16
1746596235584,SIOC 291S,B01,958922,Gabriel; Corey John,14,0,30,16
1746596236613,SOCI 117,A01,895339,Staff,2,0,5,3
1746596237641,WES 237B,A00,894149,Staff,11,0,20,9
1746596239717,AESE 279B,A00,891859,Staff,13,0,35,22
1746596240747,AIP 197,001,891854,Vespa; Emanuel Ignacio,9999,0,9999,0
1746596241770,ANTH 289S,A00,891856,Gagneux; Pascal,12,0,12,0
1746596242795,BENG 196,001,957946,Engler; Adam J.,9996,0,9999,3
1746596243824,BISP 197,001,959851,Wilhelm; James E.,9998,0,9999,1
1746596244850,CAT 124RS,A01,956906,Staff,6,0,25,19
1746596245879,CAT 125RS,A01,922013,Staff,6,0,25,19
1746596246906,CLRE 250,A00,891860,Morris; Sheldon,9995,0,9999,4
1746596248961,CLRE 251R,A00,907817,Mehta; Ravindra L.,9994,0,9999,5
1746596249990,CLRE 252,A00,891864,Cuomo; Raphael Eduardo,9993,0,9999,6
1746596251017,CLRE 253,A00,891867,Vaida; Florin,9994,0,9999,5
1746596251017,CLRE 253,B00,907819,Staff,9999,0,9999,0
1746596252041,CLRE 259,A00,891868,Patel; Hemal,9998,0,9999,1
1746596253068,CLRE 260,A00,891872,Cuomo; Raphael Eduardo,9999,0,9999,0
1746596254094,CLRE 297,001,891888,Cuomo; Raphael Eduardo,9999,0,9999,0
1746596255119,CSE 191,A00,958773,Minnes Kemp; Mor Mia,9995,0,9999,4
1746596256145,CSE 197,001,959846,Minnes Kemp; Mor Mia,9990,0,9999,9
1746596257175,CSS 201S,A01,892054,Mignozzetti; Umberto,25,0,30,5
1746596258202,CSS 202S,A01,892056,Mignozzetti; Umberto,25,0,30,5
1746596259230,DSC 197,001,956898,Eldridge; Justin Matthew,9996,0,9999,3
1746596260259,DSC 297,001,958000,Mazumdar; Arya,9998,0,9999,1
1746596260259,DSC 297,002,959862,Wang; Yusu,9998,0,9999,1
1746596261284,EAP 100,A00,905686,Staff,9778,0,9999,221
1746596262314,ECE 45,A01,892618,Staff,0,0,65,65
1746596264374,ECE 111,A01,892719,Staff,6,0,65,59
1746596265400,ECE 197,001,957920,Mercier; Patrick Philip,9991,0,9999,8
1746596266427,ECON 178,A01,907814,Zhu; Ying,26,0,35,9
1746596267453,EDS 115,A00,895312,Staff,35,0,45,10
1746596268478,EDS 117,A01,895337,Staff,23,0,30,7
1746596269504,EDS 125,A00,895341,Jones; Gabrielle Anastasia,36,0,45,9
1746596270533,EDS 128A,A01,895459,Fargason; Sharon Gayle,44,0,45,1
1746596271561,EDS 128B,A01,895543,Pappas; Elizabeth,44,0,45,1
1746596272587,EDS 139,A00,897203,Pappas; Elizabeth,44,0,45,1
1746596272587,EDS 139,B00,897209,Fargason; Sharon Gayle,41,0,45,4
1746596273613,EDS 201,A00,895545,Staff,22,0,45,23
1746596274641,EDS 203,A01,895581,Halter; Christopher P.,22,0,45,23
1746596275669,EDS 204R,A01,895625,Heinzman; Erica M.,39,0,45,6
1746596275669,EDS 204R,B01,895693,Halter; Christopher P.,10,0,45,35
1746596276695,EDS 206R,A00,895694,Fargason; Sharon Gayle,1,0,30,29
1746596276695,EDS 206R,B00,895695,Choi; Bailey Miyeon,16,0,30,14
1746596277725,EDS 250,A00,895697,Hemans; Patricia Ann Benitez,22,0,45,23
1746596278751,EDS 281,A00,895701,Meyerott; Theresa Ann,1,0,15,14
1746596279779,EDS 284,A00,895736,Meyerott; Theresa Ann,1,0,15,14
1746596280808,EDS 286,A00,897210,Fine; Sarah,0,0,15,15
1746596281833,EDS 289C,A01,895770,Daly; Alan J.,1,0,15,14
1746596282860,EDS 290,A00,897211,Hofstetter; Carolyn,0,0,15,15
1746596283885,LIGM 5A,A00,896162,Fischer-Grunski; Eva K,12,0,20,8
1746596284911,LIGM 5B,A00,896260,Fischer-Grunski; Eva K,17,0,20,3
1746596285935,LIGM 5C,A00,896308,Fischer-Grunski; Eva K,18,0,20,2
1746596286963,LIIT 5AS,A00,896313,Carnelos; Chiara,18,0,20,2
1746596287992,LIIT 5BS,A00,896416,Carnelos; Chiara,20,0,20,0
1746596289019,LIIT 5CS,A00,896564,Carnelos; Chiara,20,0,20,0
1746596290049,LISP 5A,A00,896588,Munoz Sanchez; Alicia,2,0,20,18
1746596291077,LISP 5B,A00,896653,Munoz Sanchez; Alicia,7,0,20,13
1746596292103,LISP 5C,A00,896655,Munoz Sanchez; Alicia,0,1,20,20
1746596293133,MAE 197,001,957918,Kleissl; Jan,9996,0,9999,3
1746596293133,MAE 197,002,959806,Boechler; Nicholas Sebastia,9998,0,9999,1
1746596293133,MAE 197,003,959852,Mullin; Jennifer S,9998,0,9999,1
1746596294158,MATH 2,A01,957937,Staff,33,0,35,2
1746596295184,MATH 197,001,957876,Kedlaya; Kiran S.,9993,0,9999,6
1746596296211,MCWP 40,A00,892729,Duru; Nur,10,0,20,10
1746596296211,MCWP 40,B00,893304,Montejo; Carolina,14,0,20,6
1746596297239,MCWP 40R,A00,893757,Redela; Pamela Morgan,0,5,20,20
1746596298264,MCWP 50,A00,893758,Morshed; Michael James,0,0,20,20
1746596298264,MCWP 50,B00,893761,Bartulis; Jason Michael,17,0,20,3
1746596299290,MCWP 50R,A00,893766,Compas; Sean Matthew,0,1,20,20
1746596299290,MCWP 50R,B00,893769,Carter; Jennifer A,0,1,20,20
1746596299290,MCWP 50R,C00,893771,Krone; Jarret,0,3,20,20
1746596299290,MCWP 50R,D00,893772,Miller; Elizabeth Deen,0,0,20,20
1746596299290,MCWP 50R,E00,893775,Carter; Andrea L,0,1,20,20
1746596300318,MMW 11R,A01,892721,Herbst; Matthew,14,0,30,16
1746596300318,MMW 11R,A02,892722,Herbst; Matthew,0,0,0,3
1746596301345,MMW 12R,A01,892724,Herbst; Matthew,0,11,16,16
1746596301345,MMW 12R,A02,892725,Herbst; Matthew,0,10,16,16
1746596302372,MMW 13R,A01,892727,Staff,0,4,16,16
1746596302372,MMW 13R,A02,892728,Staff,0,4,16,16
1746596302372,MMW 13R,A03,958032,Staff,0,4,16,16
1746596302372,MMW 13R,A04,958033,Staff,0,4,16,16
1746596302372,MMW 13R,A05,958034,Staff,0,4,16,16
1746596303400,SIO 295LS,A00,894015,Staff,5,0,25,20
1746596304430,SIO 295S,A00,894020,Staff,5,0,25,20
1746596305457,SIOC 290S,B01,958918,Merrifield; Mark A,14,0,30,16
1746596306482,SIOC 291S,B01,958922,Gabriel; Corey John,14,0,30,16
1746596307511,SOCI 117,A01,895339,Staff,2,0,5,3
1746596308538,WES 237B,A00,894149,Staff,11,0,20,9
1746596310603,AESE 279B,A00,891859,Staff,13,0,35,22
1746596311630,AIP 197,001,891854,Vespa; Emanuel Ignacio,9999,0,9999,0
1746596312657,ANTH 289S,A00,891856,Gagneux; Pascal,12,0,12,0
1746596313681,BENG 196,001,957946,Engler; Adam J.,9996,0,9999,3
1746596314709,BISP 197,001,959851,Wilhelm; James E.,9998,0,9999,1
1746596315735,CAT 124RS,A01,956906,Staff,6,0,25,19
1746596316761,CAT 125RS,A01,922013,Staff,6,0,25,19
1746596317788,CLRE 250,A00,891860,Morris; Sheldon,9995,0,9999,4
1746596319840,CLRE 251R,A00,907817,Mehta; Ravindra L.,9994,0,9999,5
1746596321449,CLRE 252,A00,891864,Cuomo; Raphael Eduardo,9993,0,9999,6
1746596322477,CLRE 253,A00,891867,Vaida; Florin,9994,0,9999,5
1746596322477,CLRE 253,B00,907819,Staff,9999,0,9999,0
1746596323504,CLRE 259,A00,891868,Patel; Hemal,9998,0,9999,1
1746596324528,CLRE 260,A00,891872,Cuomo; Raphael Eduardo,9999,0,9999,0
1746596325553,CLRE 297,001,891888,Cuomo; Raphael Eduardo,9999,0,9999,0
1746596326581,CSE 191,A00,958773,Minnes Kemp; Mor Mia,9995,0,9999,4
1746596327604,CSE 197,001,959846,Minnes Kemp; Mor Mia,9990,0,9999,9
1746596328630,CSS 201S,A01,892054,Mignozzetti; Umberto,25,0,30,5
1746596329659,CSS 202S,A01,892056,Mignozzetti; Umberto,25,0,30,5
1746596330684,DSC 197,001,956898,Eldridge; Justin Matthew,9996,0,9999,3
1746596331714,DSC 297,001,958000,Mazumdar; Arya,9998,0,9999,1
1746596331714,DSC 297,002,959862,Wang; Yusu,9998,0,9999,1
1746596332739,EAP 100,A00,905686,Staff,9778,0,9999,221
1746596333770,ECE 45,A01,892618,Staff,0,0,65,65
1746596335822,ECE 111,A01,892719,Staff,6,0,65,59
1746596336849,ECE 197,001,957920,Mercier; Patrick Philip,9991,0,9999,8
1746596337878,ECON 178,A01,907814,Zhu; Ying,26,0,35,9
1746596338902,EDS 115,A00,895312,Staff,35,0,45,10
1746596339931,EDS 117,A01,895337,Staff,23,0,30,7
1746596340956,EDS 125,A00,895341,Jones; Gabrielle Anastasia,36,0,45,9
1746596341982,EDS 128A,A01,895459,Fargason; Sharon Gayle,44,0,45,1
1746596343012,EDS 128B,A01,895543,Pappas; Elizabeth,44,0,45,1
1746596344041,EDS 139,A00,897203,Pappas; Elizabeth,44,0,45,1
1746596344041,EDS 139,B00,897209,Fargason; Sharon Gayle,41,0,45,4
1746596345069,EDS 201,A00,895545,Staff,22,0,45,23
1746596346093,EDS 203,A01,895581,Halter; Christopher P.,22,0,45,23
1746596347119,EDS 204R,A01,895625,Heinzman; Erica M.,39,0,45,6
1746596347119,EDS 204R,B01,895693,Halter; Christopher P.,10,0,45,35
1746596348147,EDS 206R,A00,895694,Fargason; Sharon Gayle,1,0,30,29
1746596348147,EDS 206R,B00,895695,Choi; Bailey Miyeon,16,0,30,14
1746596349173,EDS 250,A00,895697,Hemans; Patricia Ann Benitez,22,0,45,23
1746596350201,EDS 281,A00,895701,Meyerott; Theresa Ann,1,0,15,14
1746596351229,EDS 284,A00,895736,Meyerott; Theresa Ann,1,0,15,14
1746596352255,EDS 286,A00,897210,Fine; Sarah,0,0,15,15
1746596353283,EDS 289C,A01,895770,Daly; Alan J.,1,0,15,14
1746596354309,EDS 290,A00,897211,Hofstetter; Carolyn,0,0,15,15
1746596355338,LIGM 5A,A00,896162,Fischer-Grunski; Eva K,12,0,20,8
1746596356364,LIGM 5B,A00,896260,Fischer-Grunski; Eva K,17,0,20,3
1746596357394,LIGM 5C,A00,896308,Fischer-Grunski; Eva K,18,0,20,2
1746596358424,LIIT 5AS,A00,896313,Carnelos; Chiara,18,0,20,2
1746596359454,LIIT 5BS,A00,896416,Carnelos; Chiara,20,0,20,0
1746596360481,LIIT 5CS,A00,896564,Carnelos; Chiara,20,0,20,0
1746596361510,LISP 5A,A00,896588,Munoz Sanchez; Alicia,2,0,20,18
1746596362535,LISP 5B,A00,896653,Munoz Sanchez; Alicia,7,0,20,13
1746596363559,LISP 5C,A00,896655,Munoz Sanchez; Alicia,0,1,20,20
1746596364585,MAE 197,001,957918,Kleissl; Jan,9996,0,9999,3
1746596364585,MAE 197,002,959806,Boechler; Nicholas Sebastia,9998,0,9999,1
1746596364585,MAE 197,003,959852,Mullin; Jennifer S,9998,0,9999,1
1746596365615,MATH 2,A01,957937,Staff,33,0,35,2
1746596366643,MATH 197,001,957876,Kedlaya; Kiran S.,9993,0,9999,6
1746596367674,MCWP 40,A00,892729,Duru; Nur,10,0,20,10
1746596367674,MCWP 40,B00,893304,Montejo; Carolina,14,0,20,6
1746596368700,MCWP 40R,A00,893757,Redela; Pamela Morgan,0,5,20,20
1746596369725,MCWP 50,A00,893758,Morshed; Michael James,0,0,20,20
1746596369725,MCWP 50,B00,893761,Bartulis; Jason Michael,17,0,20,3
1746596370751,MCWP 50R,A00,893766,Compas; Sean Matthew,0,1,20,20
1746596370751,MCWP 50R,B00,893769,Carter; Jennifer A,0,1,20,20
1746596370751,MCWP 50R,C00,893771,Krone; Jarret,0,3,20,20
1746596370751,MCWP 50R,D00,893772,Miller; Elizabeth Deen,0,0,20,20
1746596370751,MCWP 50R,E00,893775,Carter; Andrea L,0,1,20,20
1746596371779,MMW 11R,A01,892721,Herbst; Matthew,14,0,30,16
1746596371779,MMW 11R,A02,892722,Herbst; Matthew,0,0,0,3
1746596372806,MMW 12R,A01,892724,Herbst; Matthew,0,11,16,16
1746596372806,MMW 12R,A02,892725,Herbst; Matthew,0,10,16,16
1746596373835,MMW 13R,A01,892727,Staff,0,4,16,16
1746596373835,MMW 13R,A02,892728,Staff,0,4,16,16
1746596373835,MMW 13R,A03,958032,Staff,0,4,16,16
1746596373835,MMW 13R,A04,958033,Staff,0,4,16,16
1746596373835,MMW 13R,A05,958034,Staff,0,4,16,16
1746596374864,SIO 295LS,A00,894015,Staff,5,0,25,20
1746596375891,SIO 295S,A00,894020,Staff,5,0,25,20
1746596376918,SIOC 290S,B01,958918,Merrifield; Mark A,14,0,30,16
1746596377943,SIOC 291S,B01,958922,Gabriel; Corey John,14,0,30,16
1746596378970,SOCI 117,A01,895339,Staff,2,0,5,3
1746596379997,WES 237B,A00,894149,Staff,11,0,20,9
1746596382063,AESE 279B,A00,891859,Staff,13,0,35,22
1746596383092,AIP 197,001,891854,Vespa; Emanuel Ignacio,9999,0,9999,0
1746596384120,ANTH 289S,A00,891856,Gagneux; Pascal,12,0,12,0
1746596385151,BENG 196,001,957946,Engler; Adam J.,9996,0,9999,3
1746596386177,BISP 197,001,959851,Wilhelm; James E.,9998,0,9999,1
1746596387204,CAT 124RS,A01,956906,Staff,6,0,25,19
1746596388229,CAT 125RS,A01,922013,Staff,6,0,25,19
1746596389257,CLRE 250,A00,891860,Morris; Sheldon,9995,0,9999,4
1746596391315,CLRE 251R,A00,907817,Mehta; Ravindra L.,9994,0,9999,5
1746596392339,CLRE 252,A00,891864,Cuomo; Raphael Eduardo,9993,0,9999,6
1746596393364,CLRE 253,A00,891867,Vaida; Florin,9994,0,9999,5
1746596393364,CLRE 253,B00,907819,Staff,9999,0,9999,0
1746596394390,CLRE 259,A00,891868,Patel; Hemal,9998,0,9999,1
1746596395416,CLRE 260,A00,891872,Cuomo; Raphael Eduardo,9999,0,9999,0
1746596396441,CLRE 297,001,891888,Cuomo; Raphael Eduardo,9999,0,9999,0
1746596397467,CSE 191,A00,958773,Minnes Kemp; Mor Mia,9995,0,9999,4
1746596398507,CSE 197,001,959846,Minnes Kemp; Mor Mia,9990,0,9999,9
1746596399535,CSS 201S,A01,892054,Mignozzetti; Umberto,25,0,30,5
1746596400564,CSS 202S,A01,892056,Mignozzetti; Umberto,25,0,30,5
1746596401590,DSC 197,001,956898,Eldridge; Justin Matthew,9996,0,9999,3
1746596402616,DSC 297,001,958000,Mazumdar; Arya,9998,0,9999,1
1746596402616,DSC 297,002,959862,Wang; Yusu,9998,0,9999,1
1746596403642,EAP 100,A00,905686,Staff,9778,0,9999,221
1746596404671,ECE 45,A01,892618,Staff,0,0,65,65
1746596406723,ECE 111,A01,892719,Staff,6,0,65,59
1746596407751,ECE 197,001,957920,Mercier; Patrick Philip,9991,0,9999,8
1746596408786,ECON 178,A01,907814,Zhu; Ying,26,0,35,9
1746596409812,EDS 115,A00,895312,Staff,35,0,45,10
1746596410841,EDS 117,A01,895337,Staff,23,0,30,7
1746596411870,EDS 125,A00,895341,Jones; Gabrielle Anastasia,36,0,45,9
1746596412901,EDS 128A,A01,895459,Fargason; Sharon Gayle,44,0,45,1
1746596413929,EDS 128B,A01,895543,Pappas; Elizabeth,44,0,45,1
1746596414957,EDS 139,A00,897203,Pappas; Elizabeth,44,0,45,1
1746596414957,EDS 139,B00,897209,Fargason; Sharon Gayle,41,0,45,4
1746596415984,EDS 201,A00,895545,Staff,22,0,45,23
1746596417012,EDS 203,A01,895581,Halter; Christopher P.,22,0,45,23
1746596418043,EDS 204R,A01,895625,Heinzman; Erica M.,39,0,45,6
1746596418043,EDS 204R,B01,895693,Halter; Christopher P.,10,0,45,35
1746596419068,EDS 206R,A00,895694,Fargason; Sharon Gayle,1,0,30,29
1746596419068,EDS 206R,B00,895695,Choi; Bailey Miyeon,16,0,30,14
1746596420093,EDS 250,A00,895697,Hemans; Patricia Ann Benitez,22,0,45,23
1746596421118,EDS 281,A00,895701,Meyerott; Theresa Ann,1,0,15,14
1746596422146,EDS 284,A00,895736,Meyerott; Theresa Ann,1,0,15,14
1746596423175,EDS 286,A00,897210,Fine; Sarah,0,0,15,15
1746596424202,EDS 289C,A01,895770,Daly; Alan J.,1,0,15,14
1746596425227,EDS 290,A00,897211,Hofstetter; Carolyn,0,0,15,15
1746596426257,LIGM 5A,A00,896162,Fischer-Grunski; Eva K,12,0,20,8
1746596427285,LIGM 5B,A00,896260,Fischer-Grunski; Eva K,17,0,20,3
1746596428314,LIGM 5C,A00,896308,Fischer-Grunski; Eva K,18,0,20,2
1746596429339,LIIT 5AS,A00,896313,Carnelos; Chiara,18,0,20,2
1746596430367,LIIT 5BS,A00,896416,Carnelos; Chiara,20,0,20,0
1746596431391,LIIT 5CS,A00,896564,Carnelos; Chiara,20,0,20,0
1746596432424,LISP 5A,A00,896588,Munoz Sanchez; Alicia,2,0,20,18
1746596433450,LISP 5B,A00,896653,Munoz Sanchez; Alicia,7,0,20,13
1746596434474,LISP 5C,A00,896655,Munoz Sanchez; Alicia,0,1,20,20
1746596435500,MAE 197,001,957918,Kleissl; Jan,9996,0,9999,3
1746596435500,MAE 197,002,959806,Boechler; Nicholas Sebastia,9998,0,9999,1
1746596435500,MAE 197,003,959852,Mullin; Jennifer S,9998,0,9999,1
1746596436529,MATH 2,A01,957937,Staff,33,0,35,2
1746596437554,MATH 197,001,957876,Kedlaya; Kiran S.,9993,0,9999,6
1746596438581,MCWP 40,A00,892729,Duru; Nur,10,0,20,10
1746596438581,MCWP 40,B00,893304,Montejo; Carolina,14,0,20,6
1746596439609,MCWP 40R,A00,893757,Redela; Pamela Morgan,0,5,20,20
1746596440636,MCWP 50,A00,893758,Morshed; Michael James,0,0,20,20
1746596440636,MCWP 50,B00,893761,Bartulis; Jason Michael,17,0,20,3
1746596441662,MCWP 50R,A00,893766,Compas; Sean Matthew,0,1,20,20
1746596441662,MCWP 50R,B00,893769,Carter; Jennifer A,0,1,20,20
1746596441662,MCWP 50R,C00,893771,Krone; Jarret,0,3,20,20
1746596441662,MCWP 50R,D00,893772,Miller; Elizabeth Deen,0,0,20,20
1746596441662,MCWP 50R,E00,893775,Carter; Andrea L,0,1,20,20
1746596442687,MMW 11R,A01,892721,Herbst; Matthew,14,0,30,16
1746596442687,MMW 11R,A02,892722,Herbst; Matthew,0,0,0,3
1746596443716,MMW 12R,A01,892724,Herbst; Matthew,0,11,16,16
1746596443716,MMW 12R,A02,892725,Herbst; Matthew,0,10,16,16
1746596444742,MMW 13R,A01,892727,Staff,0,4,16,16
1746596444742,MMW 13R,A02,892728,Staff,0,4,16,16
1746596444742,MMW 13R,A03,958032,Staff,0,4,16,16
1746596444742,MMW 13R,A04,958033,Staff,0,4,16,16
1746596444742,MMW 13R,A05,958034,Staff,0,4,16,16
1746596445768,SIO 295LS,A00,894015,Staff,5,0,25,20
1746596446796,SIO 295S,A00,894020,Staff,5,0,25,20
1746596447822,SIOC 290S,B01,958918,Merrifield; Mark A,14,0,30,16
1746596448851,SIOC 291S,B01,958922,Gabriel; Corey John,14,0,30,16
1746596449878,SOCI 117,A01,895339,Staff,2,0,5,3
1746596450903,WES 237B,A00,894149,Staff,11,0,20,9
1746596452971,AESE 279B,A00,891859,Staff,13,0,35,22
1746596453997,AIP 197,001,891854,Vespa; Emanuel Ignacio,9999,0,9999,0
1746596455028,ANTH 289S,A00,891856,Gagneux; Pascal,12,0,12,0
1746596456054,BENG 196,001,957946,Engler; Adam J.,9996,0,9999,3
1746596457079,BISP 197,001,959851,Wilhelm; James E.,9998,0,9999,1
1746596458103,CAT 124RS,A01,956906,Staff,6,0,25,19
1746596459129,CAT 125RS,A01,922013,Staff,6,0,25,19
1746596460154,CLRE 250,A00,891860,Morris; Sheldon,9995,0,9999,4
1746596462205,CLRE 251R,A00,907817,Mehta; Ravindra L.,9994,0,9999,5
1746596463231,CLRE 252,A00,891864,Cuomo; Raphael Eduardo,9993,0,9999,6
1746596464255,CLRE 253,A00,891867,Vaida; Florin,9994,0,9999,5
1746596464255,CLRE 253,B00,907819,Staff,9999,0,9999,0
1746596465286,CLRE 259,A00,891868,Patel; Hemal,9998,0,9999,1
1746596466311,CLRE 260,A00,891872,Cuomo; Raphael Eduardo,9999,0,9999,0
1746596467338,CLRE 297,001,891888,Cuomo; Raphael Eduardo,9999,0,9999,0
1746596468363,CSE 191,A00,958773,Minnes Kemp; Mor Mia,9995,0,9999,4
1746596469388,CSE 197,001,959846,Minnes Kemp; Mor Mia,9990,0,9999,9
1746596470417,CSS 201S,A01,892054,Mignozzetti; Umberto,25,0,30,5
1746596471442,CSS 202S,A01,892056,Mignozzetti; Umberto,25,0,30,5
1746596472469,DSC 197,001,956898,Eldridge; Justin Matthew,9996,0,9999,3
1746596473502,DSC 297,001,958000,Mazumdar; Arya,9998,0,9999,1
1746596473502,DSC 297,002,959862,Wang; Yusu,9998,0,9999,1
1746596474526,EAP 100,A00,905686,Staff,9778,0,9999,221
1746596475556,ECE 45,A01,892618,Staff,0,0,65,65
1746596477607,ECE 111,A01,892719,Staff,6,0,65,59
1746596478631,ECE 197,001,957920,Mercier; Patrick Philip,9991,0,9999,8
1746596479661,ECON 178,A01,907814,Zhu; Ying,26,0,35,9
1746596480688,EDS 115,A00,895312,Staff,35,0,45,10
1746596481716,EDS 117,A01,895337,Staff,23,0,30,7
1746596482742,EDS 125,A00,895341,Jones; Gabrielle Anastasia,36,0,45,9
1746596483765,EDS 128A,A01,895459,Fargason; Sharon Gayle,44,0,45,1
1746596484790,EDS 128B,A01,895543,Pappas; Elizabeth,44,0,45,1
1746596485817,EDS 139,A00,897203,Pappas; Elizabeth,44,0,45,1
1746596485817,EDS 139,B00,897209,Fargason; Sharon Gayle,41,0,45,4
1746596486844,EDS 201,A00,895545,Staff,22,0,45,23
1746596487869,EDS 203,A01,895581,Halter; Christopher P.,22,0,45,23
1746596488894,EDS 204R,A01,895625,Heinzman; Erica M.,39,0,45,6
1746596488894,EDS 204R,B01,895693,Halter; Christopher P.,10,0,45,35
1746596489922,EDS 206R,A00,895694,Fargason; Sharon Gayle,1,0,30,29
1746596489922,EDS 206R,B00,895695,Choi; Bailey Miyeon,16,0,30,14
1746596490948,EDS 250,A00,895697,Hemans; Patricia Ann Benitez,22,0,45,23
1746596491975,EDS 281,A00,895701,Meyerott; Theresa Ann,1,0,15,14
1746596493000,EDS 284,A00,895736,Meyerott; Theresa Ann,1,0,15,14
1746596494027,EDS 286,A00,897210,Fine; Sarah,0,0,15,15
1746596495051,EDS 289C,A01,895770,Daly; Alan J.,1,0,15,14
1746596496077,EDS 290,A00,897211,Hofstetter; Carolyn,0,0,15,15
1746596497103,LIGM 5A,A00,896162,Fischer-Grunski; Eva K,12,0,20,8
1746596498130,LIGM 5B,A00,896260,Fischer-Grunski; Eva K,17,0,20,3
1746596499158,LIGM 5C,A00,896308,Fischer-Grunski; Eva K,18,0,20,2
1746596500187,LIIT 5AS,A00,896313,Carnelos; Chiara,18,0,20,2
1746596501216,LIIT 5BS,A00,896416,Carnelos; Chiara,20,0,20,0
1746596502242,LIIT 5CS,A00,896564,Carnelos; Chiara,20,0,20,0
1746596503270,LISP 5A,A00,896588,Munoz Sanchez; Alicia,2,0,20,18
1746596504299,LISP 5B,A00,896653,Munoz Sanchez; Alicia,7,0,20,13
1746596505325,LISP 5C,A00,896655,Munoz Sanchez; Alicia,0,1,20,20
1746596506353,MAE 197,001,957918,Kleissl; Jan,9996,0,9999,3
1746596506353,MAE 197,002,959806,Boechler; Nicholas Sebastia,9998,0,9999,1
1746596506353,MAE 197,003,959852,Mullin; Jennifer S,9998,0,9999,1
1746596507377,MATH 2,A01,957937,Staff,33,0,35,2
1746596508403,MATH 197,001,957876,Kedlaya; Kiran S.,9993,0,9999,6
1746596509430,MCWP 40,A00,892729,Duru; Nur,10,0,20,10
1746596509430,MCWP 40,B00,893304,Montejo; Carolina,14,0,20,6
1746596510457,MCWP 40R,A00,893757,Redela; Pamela Morgan,0,5,20,20
1746596511486,MCWP 50,A00,893758,Morshed; Michael James,0,0,20,20
1746596511486,MCWP 50,B00,893761,Bartulis; Jason Michael,17,0,20,3
1746596512514,MCWP 50R,A00,893766,Compas; Sean Matthew,0,1,20,20
1746596512514,MCWP 50R,B00,893769,Carter; Jennifer A,0,1,20,20
1746596512514,MCWP 50R,C00,893771,Krone; Jarret,0,3,20,20
1746596512514,MCWP 50R,D00,893772,Miller; Elizabeth Deen,0,0,20,20
1746596512514,MCWP 50R,E00,893775,Carter; Andrea L,0,1,20,20
1746596513542,MMW 11R,A01,892721,Herbst; Matthew,14,0,30,16
1746596513542,MMW 11R,A02,892722,Herbst; Matthew,0,0,0,3
1746596514567,MMW 12R,A01,892724,Herbst; Matthew,0,11,16,16
1746596514567,MMW 12R,A02,892725,Herbst; Matthew,0,10,16,16
1746596515592,MMW 13R,A01,892727,Staff,0,4,16,16
1746596515592,MMW 13R,A02,892728,Staff,0,4,16,16
1746596515592,MMW 13R,A03,958032,Staff,0,4,16,16
1746596515592,MMW 13R,A04,958033,Staff,0,4,16,16
1746596515592,MMW 13R,A05,958034,Staff,0,4,16,16
1746596516617,SIO 295LS,A00,894015,Staff,5,0,25,20
1746596517642,SIO 295S,A00,894020,Staff,5,0,25,20
1746596518668,SIOC 290S,B01,958918,Merrifield; Mark A,14,0,30,16
1746596519695,SIOC 291S,B01,958922,Gabriel; Corey John,14,0,30,16
1746596520721,SOCI 117,A01,895339,Staff,2,0,5,3
1746596521746,WES 237B,A00,894149,Staff,11,0,20,9
1746596523803,AESE 279B,A00,891859,Staff,13,0,35,22
1746596524899,AIP 197,001,891854,Vespa; Emanuel Ignacio,9999,0,9999,0
1746596525928,ANTH 289S,A00,891856,Gagneux; Pascal,12,0,12,0
1746596526953,BENG 196,001,957946,Engler; Adam J.,9996,0,9999,3
1746596527978,BISP 197,001,959851,Wilhelm; James E.,9998,0,9999,1
1746596529006,CAT 124RS,A01,956906,Staff,6,0,25,19
1746596530032,CAT 125RS,A01,922013,Staff,6,0,25,19
1746596531057,CLRE 250,A00,891860,Morris; Sheldon,9995,0,9999,4
1746596533107,CLRE 251R,A00,907817,Mehta; Ravindra L.,9994,0,9999,5
1746596534133,CLRE 252,A00,891864,Cuomo; Raphael Eduardo,9993,0,9999,6
1746596535160,CLRE 253,A00,891867,Vaida; Florin,9994,0,9999,5
1746596535160,CLRE 253,B00,907819,Staff,9999,0,9999,0
1746596536187,CLRE 259,A00,891868,Patel; Hemal,9998,0,9999,1
1746596537215,CLRE 260,A00,891872,Cuomo; Raphael Eduardo,9999,0,9999,0
1746596538240,CLRE 297,001,891888,Cuomo; Raphael Eduardo,9999,0,9999,0
1746596539267,CSE 191,A00,958773,Minnes Kemp; Mor Mia,9995,0,9999,4
1746596540292,CSE 197,001,959846,Minnes Kemp; Mor Mia,9990,0,9999,9
1746596541317,CSS 201S,A01,892054,Mignozzetti; Umberto,25,0,30,5
1746596542345,CSS 202S,A01,892056,Mignozzetti; Umberto,25,0,30,5
1746596543377,DSC 197,001,956898,Eldridge; Justin Matthew,9996,0,9999,3
1746596544401,DSC 297,001,958000,Mazumdar; Arya,9998,0,9999,1
1746596544401,DSC 297,002,959862,Wang; Yusu,9998,0,9999,1
1746596545428,EAP 100,A00,905686,Staff,9778,0,9999,221
1746596546458,ECE 45,A01,892618,Staff,0,0,65,65
1746596548551,ECE 111,A01,892719,Staff,6,0,65,59
1746596549575,ECE 197,001,957920,Mercier; Patrick Philip,9991,0,9999,8
1746596550605,ECON 178,A01,907814,Zhu; Ying,26,0,35,9
1746596551630,EDS 115,A00,895312,Staff,35,0,45,10
1746596552656,EDS 117,A01,895337,Staff,23,0,30,7
1746596553681,EDS 125,A00,895341,Jones; Gabrielle Anastasia,36,0,45,9
1746596554711,EDS 128A,A01,895459,Fargason; Sharon Gayle,44,0,45,1
1746596555739,EDS 128B,A01,895543,Pappas; Elizabeth,44,0,45,1
1746596556765,EDS 139,A00,897203,Pappas; Elizabeth,44,0,45,1
1746596556765,EDS 139,B00,897209,Fargason; Sharon Gayle,41,0,45,4
1746596557793,EDS 201,A00,895545,Staff,22,0,45,23
1746596558819,EDS 203,A01,895581,Halter; Christopher P.,22,0,45,23
1746596559848,EDS 204R,A01,895625,Heinzman; Erica M.,39,0,45,6
1746596559848,EDS 204R,B01,895693,Halter; Christopher P.,10,0,45,35
1746596560874,EDS 206R,A00,895694,Fargason; Sharon Gayle,1,0,30,29
1746596560874,EDS 206R,B00,895695,Choi; Bailey Miyeon,16,0,30,14
1746596561904,EDS 250,A00,895697,Hemans; Patricia Ann Benitez,22,0,45,23
1746596562931,EDS 281,A00,895701,Meyerott; Theresa Ann,1,0,15,14
1746596563961,EDS 284,A00,895736,Meyerott; Theresa Ann,1,0,15,14
1746596564988,EDS 286,A00,897210,Fine; Sarah,0,0,15,15
1746596566013,EDS 289C,A01,895770,Daly; Alan J.,1,0,15,14
1746596567037,EDS 290,A00,897211,Hofstetter; Carolyn,0,0,15,15
1746596568065,LIGM 5A,A00,896162,Fischer-Grunski; Eva K,12,0,20,8
1746596569092,LIGM 5B,A00,896260,Fischer-Grunski; Eva K,17,0,20,3
1746596570119,LIGM 5C,A00,896308,Fischer-Grunski; Eva K,18,0,20,2
1746596571150,LIIT 5AS,A00,896313,Carnelos; Chiara,18,0,20,2
1746596572175,LIIT 5BS,A00,896416,Carnelos; Chiara,20,0,20,0
1746596573204,LIIT 5CS,A00,896564,Carnelos; Chiara,20,0,20,0
1746596574230,LISP 5A,A00,896588,Munoz Sanchez; Alicia,2,0,20,18
1746596575254,LISP 5B,A00,896653,Munoz Sanchez; Alicia,7,0,20,13
1746596576283,LISP 5C,A00,896655,Munoz Sanchez; Alicia,0,1,20,20
1746596577331,MAE 197,001,957918,Kleissl; Jan,9996,0,9999,3
1746596577331,MAE 197,002,959806,Boechler; Nicholas Sebastia,9998,0,9999,1
1746596577331,MAE 197,003,959852,Mullin; Jennifer S,9998,0,9999,1
1746596578360,MATH 2,A01,957937,Staff,33,0,35,2
1746596579387,MATH 197,001,957876,Kedlaya; Kiran S.,9993,0,9999,6
1746596580413,MCWP 40,A00,892729,Duru; Nur,10,0,20,10
1746596580413,MCWP 40,B00,893304,Montejo; Carolina,14,0,20,6
1746596581438,MCWP 40R,A00,893757,Redela; Pamela Morgan,0,5,20,20
1746596582466,MCWP 50,A00,893758,Morshed; Michael James,0,0,20,20
1746596582466,MCWP 50,B00,893761,Bartulis; Jason Michael,17,0,20,3
1746596583492,MCWP 50R,A00,893766,Compas; Sean Matthew,0,1,20,20
1746596583492,MCWP 50R,B00,893769,Carter; Jennifer A,0,1,20,20
1746596583492,MCWP 50R,C00,893771,Krone; Jarret,0,3,20,20
1746596583492,MCWP 50R,D00,893772,Miller; Elizabeth Deen,0,0,20,20
1746596583492,MCWP 50R,E00,893775,Carter; Andrea L,0,1,20,20
1746596584516,MMW 11R,A01,892721,Herbst; Matthew,14,0,30,16
1746596584516,MMW 11R,A02,892722,Herbst; Matthew,0,0,0,3
1746596585542,MMW 12R,A01,892724,Herbst; Matthew,0,11,16,16
1746596585542,MMW 12R,A02,892725,Herbst; Matthew,0,10,16,16
1746596586568,MMW 13R,A01,892727,Staff,0,4,16,16
1746596586568,MMW 13R,A02,892728,Staff,0,4,16,16
1746596586568,MMW 13R,A03,958032,Staff,0,4,16,16
1746596586568,MMW 13R,A04,958033,Staff,0,4,16,16
1746596586568,MMW 13R,A05,958034,Staff,0,4,16,16
1746596587595,SIO 295LS,A00,894015,Staff,5,0,25,20
1746596588622,SIO 295S,A00,894020,Staff,5,0,25,20
1746596589651,SIOC 290S,B01,958918,Merrifield; Mark A,14,0,30,16
1746596590677,SIOC 291S,B01,958922,Gabriel; Corey John,14,0,30,16
1746596591701,SOCI 117,A01,895339,Staff,2,0,5,3
1746596592729,WES 237B,A00,894149,Staff,11,0,20,9
1746596594785,AESE 279B,A00,891859,Staff,13,0,35,22
1746596595813,AIP 197,001,891854,Vespa; Emanuel Ignacio,9999,0,9999,0
1746596596838,ANTH 289S,A00,891856,Gagneux; Pascal,12,0,12,0
1746596597864,BENG 196,001,957946,Engler; Adam J.,9996,0,9999,3
1746596598893,BISP 197,001,959851,Wilhelm; James E.,9998,0,9999,1
1746596599919,CAT 124RS,A01,956906,Staff,6,0,25,19
1746596600948,CAT 125RS,A01,922013,Staff,6,0,25,19
1746596601976,CLRE 250,A00,891860,Morris; Sheldon,9995,0,9999,4
1746596604033,CLRE 251R,A00,907817,Mehta; Ravindra L.,9994,0,9999,5
1746596605059,CLRE 252,A00,891864,Cuomo; Raphael Eduardo,9993,0,9999,6
1746596606084,CLRE 253,A00,891867,Vaida; Florin,9994,0,9999,5
1746596606084,CLRE 253,B00,907819,Staff,9999,0,9999,0
1746596607111,CLRE 259,A00,891868,Patel; Hemal,9998,0,9999,1
1746596608136,CLRE 260,A00,891872,Cuomo; Raphael Eduardo,9999,0,9999,0
1746596609164,CLRE 297,001,891888,Cuomo; Raphael Eduardo,9999,0,9999,0
1746596610191,CSE 191,A00,958773,Minnes Kemp; Mor Mia,9995,0,9999,4
1746596611221,CSE 197,001,959846,Minnes Kemp; Mor Mia,9990,0,9999,9
1746596612251,CSS 201S,A01,892054,Mignozzetti; Umberto,25,0,30,5
1746596613280,CSS 202S,A01,892056,Mignozzetti; Umberto,25,0,30,5
1746596614307,DSC 197,001,956898,Eldridge; Justin Matthew,9996,0,9999,3
1746596615333,DSC 297,001,958000,Mazumdar; Arya,9998,0,9999,1
1746596615333,DSC 297,002,959862,Wang; Yusu,9998,0,9999,1
1746596616359,EAP 100,A00,905686,Staff,9778,0,9999,221
1746596617408,ECE 45,A01,892618,Staff,0,0,65,65
1746596619462,ECE 111,A01,892719,Staff,6,0,65,59
1746596620487,ECE 197,001,957920,Mercier; Patrick Philip,9991,0,9999,8
1746596621512,ECON 178,A01,907814,Zhu; Ying,26,0,35,9
1746596622537,EDS 115,A00,895312,Staff,35,0,45,10
1746596623564,EDS 117,A01,895337,Staff,23,0,30,7
1746596624588,EDS 125,A00,895341,Jones; Gabrielle Anastasia,36,0,45,9
1746596625618,EDS 128A,A01,895459,Fargason; Sharon Gayle,44,0,45,1
1746596626642,EDS 128B,A01,895543,Pappas; Elizabeth,44,0,45,1
1746596627667,EDS 139,A00,897203,Pappas; Elizabeth,44,0,45,1
1746596627667,EDS 139,B00,897209,Fargason; Sharon Gayle,41,0,45,4
1746596628694,EDS 201,A00,895545,Staff,22,0,45,23
1746596629718,EDS 203,A01,895581,Halter; Christopher P.,22,0,45,23
1746596630743,EDS 204R,A01,895625,Heinzman; Erica M.,39,0,45,6
1746596630743,EDS 204R,B01,895693,Halter; Christopher P.,10,0,45,35
1746596631767,EDS 206R,A00,895694,Fargason; Sharon Gayle,1,0,30,29
1746596631767,EDS 206R,B00,895695,Choi; Bailey Miyeon,16,0,30,14
1746596632795,EDS 250,A00,895697,Hemans; Patricia Ann Benitez,22,0,45,23
1746596633820,EDS 281,A00,895701,Meyerott; Theresa Ann,1,0,15,14
1746596634844,EDS 284,A00,895736,Meyerott; Theresa Ann,1,0,15,14
1746596635870,EDS 286,A00,897210,Fine; Sarah,0,0,15,15
1746596636897,EDS 289C,A01,895770,Daly; Alan J.,1,0,15,14
1746596637921,EDS 290,A00,897211,Hofstetter; Carolyn,0,0,15,15
1746596638951,LIGM 5A,A00,896162,Fischer-Grunski; Eva K,12,0,20,8
1746596639979,LIGM 5B,A00,896260,Fischer-Grunski; Eva K,17,0,20,3
1746596641004,LIGM 5C,A00,896308,Fischer-Grunski; Eva K,18,0,20,2
1746596642029,LIIT 5AS,A00,896313,Carnelos; Chiara,18,0,20,2
1746596643058,LIIT 5BS,A00,896416,Carnelos; Chiara,20,0,20,0
1746596644082,LIIT 5CS,A00,896564,Carnelos; Chiara,20,0,20,0
1746596645108,LISP 5A,A00,896588,Munoz Sanchez; Alicia,2,0,20,18
1746596646132,LISP 5B,A00,896653,Munoz Sanchez; Alicia,7,0,20,13
1746596647158,LISP 5C,A00,896655,Munoz Sanchez; Alicia,0,1,20,20
1746596648184,MAE 197,001,957918,Kleissl; Jan,9996,0,9999,3
1746596648184,MAE 197,002,959806,Boechler; Nicholas Sebastia,9998,0,9999,1
1746596648184,MAE 197,003,959852,Mullin; Jennifer S,9998,0,9999,1
1746596649415,MATH 2,A01,957937,Staff,33,0,35,2
1746596650445,MATH 197,001,957876,Kedlaya; Kiran S.,9993,0,9999,6
1746596651470,MCWP 40,A00,892729,Duru; Nur,10,0,20,10
1746596651470,MCWP 40,B00,893304,Montejo; Carolina,14,0,20,6
1746596652550,MCWP 40R,A00,893757,Redela; Pamela Morgan,0,5,20,20
1746596653579,MCWP 50,A00,893758,Morshed; Michael James,0,0,20,20
1746596653579,MCWP 50,B00,893761,Bartulis; Jason Michael,17,0,20,3
1746596654609,MCWP 50R,A00,893766,Compas; Sean Matthew,0,1,20,20
1746596654609,MCWP 50R,B00,893769,Carter; Jennifer A,0,1,20,20
1746596654609,MCWP 50R,C00,893771,Krone; Jarret,0,3,20,20
1746596654609,MCWP 50R,D00,893772,Miller; Elizabeth Deen,0,0,20,20
1746596654609,MCWP 50R,E00,893775,Carter; Andrea L,0,1,20,20
1746596655632,MMW 11R,A01,892721,Herbst; Matthew,14,0,30,16
1746596655632,MMW 11R,A02,892722,Herbst; Matthew,0,0,0,3
1746596656660,MMW 12R,A01,892724,Herbst; Matthew,0,11,16,16
1746596656660,MMW 12R,A02,892725,Herbst; Matthew,0,10,16,16
1746596657686,MMW 13R,A01,892727,Staff,0,4,16,16
1746596657686,MMW 13R,A02,892728,Staff,0,4,16,16
1746596657686,MMW 13R,A03,958032,Staff,0,4,16,16
1746596657686,MMW 13R,A04,958033,Staff,0,4,16,16
1746596657686,MMW 13R,A05,958034,Staff,0,4,16,16
1746596658711,SIO 295LS,A00,894015,Staff,5,0,25,20
1746596659735,SIO 295S,A00,894020,Staff,5,0,25,20
1746596660764,SIOC 290S,B01,958918,Merrifield; Mark A,14,0,30,16
1746596661793,SIOC 291S,B01,958922,Gabriel; Corey John,14,0,30,16
1746596662819,SOCI 117,A01,895339,Staff,2,0,5,3
1746596663844,WES 237B,A00,894149,Staff,11,0,20,9
1746596665906,AESE 279B,A00,891859,Staff,13,0,35,22
1746596666931,AIP 197,001,891854,Vespa; Emanuel Ignacio,9999,0,9999,0
1746596667959,ANTH 289S,A00,891856,Gagneux; Pascal,12,0,12,0
1746596668985,BENG 196,001,957946,Engler; Adam J.,9996,0,9999,3
1746596670010,BISP 197,001,959851,Wilhelm; James E.,9998,0,9999,1
1746596671037,CAT 124RS,A01,956906,Staff,6,0,25,19
1746596672063,CAT 125RS,A01,922013,Staff,6,0,25,19
1746596673089,CLRE 250,A00,891860,Morris; Sheldon,9995,0,9999,4
1746596675149,CLRE 251R,A00,907817,Mehta; Ravindra L.,9994,0,9999,5
1746596676177,CLRE 252,A00,891864,Cuomo; Raphael Eduardo,9993,0,9999,6
1746596677203,CLRE 253,A00,891867,Vaida; Florin,9994,0,9999,5
1746596677203,CLRE 253,B00,907819,Staff,9999,0,9999,0
1746596678232,CLRE 259,A00,891868,Patel; Hemal,9998,0,9999,1
1746596679260,CLRE 260,A00,891872,Cuomo; Raphael Eduardo,9999,0,9999,0
1746596680286,CLRE 297,001,891888,Cuomo; Raphael Eduardo,9999,0,9999,0
1746596681311,CSE 191,A00,958773,Minnes Kemp; Mor Mia,9995,0,9999,4
1746596682340,CSE 197,001,959846,Minnes Kemp; Mor Mia,9990,0,9999,9
1746596683370,CSS 201S,A01,892054,Mignozzetti; Umberto,25,0,30,5
1746596684400,CSS 202S,A01,892056,Mignozzetti; Umberto,25,0,30,5
1746596685425,DSC 197,001,956898,Eldridge; Justin Matthew,9996,0,9999,3
1746596686454,DSC 297,001,958000,Mazumdar; Arya,9998,0,9999,1
1746596686454,DSC 297,002,959862,Wang; Yusu,9998,0,9999,1
1746596687480,EAP 100,A00,905686,Staff,9778,0,9999,221
1746596688512,ECE 45,A01,892618,Staff,0,0,65,65
1746596690580,ECE 111,A01,892719,Staff,6,0,65,59
1746596691605,ECE 197,001,957920,Mercier; Patrick Philip,9991,0,9999,8
1746596692630,ECON 178,A01,907814,Zhu; Ying,26,0,35,9
1746596693658,EDS 115,A00,895312,Staff,35,0,45,10
1746596694685,EDS 117,A01,895337,Staff,23,0,30,7
1746596695712,EDS 125,A00,895341,Jones; Gabrielle Anastasia,36,0,45,9
1746596696738,EDS 128A,A01,895459,Fargason; Sharon Gayle,44,0,45,1
1746596697767,EDS 128B,A01,895543,Pappas; Elizabeth,44,0,45,1
1746596698791,EDS 139,A00,897203,Pappas; Elizabeth,44,0,45,1
1746596698791,EDS 139,B00,897209,Fargason; Sharon Gayle,41,0,45,4
1746596699817,EDS 201,A00,895545,Staff,22,0,45,23
1746596700844,EDS 203,A01,895581,Halter; Christopher P.,22,0,45,23
1746596701871,EDS 204R,A01,895625,Heinzman; Erica M.,39,0,45,6
1746596701871,EDS 204R,B01,895693,Halter; Christopher P.,10,0,45,35
1746596702905,EDS 206R,A00,895694,Fargason; Sharon Gayle,1,0,30,29
1746596702905,EDS 206R,B00,895695,Choi; Bailey Miyeon,16,0,30,14
1746596703935,EDS 250,A00,895697,Hemans; Patricia Ann Benitez,22,0,45,23
1746596704960,EDS 281,A00,895701,Meyerott; Theresa Ann,1,0,15,14
1746596716263,EDS 284,A00,895736,Meyerott; Theresa Ann,1,0,15,14
1746596717288,EDS 286,A00,897210,Fine; Sarah,0,0,15,15
1746596718315,EDS 289C,A01,895770,Daly; Alan J.,1,0,15,14
1746596719340,EDS 290,A00,897211,Hofstetter; Carolyn,0,0,15,15
1746596720368,LIGM 5A,A00,896162,Fischer-Grunski; Eva K,12,0,20,8
1746596721395,LIGM 5B,A00,896260,Fischer-Grunski; Eva K,17,0,20,3
1746596722420,LIGM 5C,A00,896308,Fischer-Grunski; Eva K,18,0,20,2
1746596723447,LIIT 5AS,A00,896313,Carnelos; Chiara,18,0,20,2
1746596724477,LIIT 5BS,A00,896416,Carnelos; Chiara,20,0,20,0
1746596725504,LIIT 5CS,A00,896564,Carnelos; Chiara,20,0,20,0
1746596726532,LISP 5A,A00,896588,Munoz Sanchez; Alicia,2,0,20,18
1746596727563,LISP 5B,A00,896653,Munoz Sanchez; Alicia,7,0,20,13
1746596728592,LISP 5C,A00,896655,Munoz Sanchez; Alicia,0,1,20,20
1746596729617,MAE 197,001,957918,Kleissl; Jan,9996,0,9999,3
1746596729617,MAE 197,002,959806,Boechler; Nicholas Sebastia,9998,0,9999,1
1746596729617,MAE 197,003,959852,Mullin; Jennifer S,9998,0,9999,1
1746596730645,MATH 2,A01,957937,Staff,33,0,35,2
1746596731676,MATH 197,001,957876,Kedlaya; Kiran S.,9993,0,9999,6
1746596732704,MCWP 40,A00,892729,Duru; Nur,10,0,20,10
1746596732704,MCWP 40,B00,893304,Montejo; Carolina,14,0,20,6
1746596733728,MCWP 40R,A00,893757,Redela; Pamela Morgan,0,5,20,20
1746596734753,MCWP 50,A00,893758,Morshed; Michael James,0,0,20,20
1746596734753,MCWP 50,B00,893761,Bartulis; Jason Michael,17,0,20,3
1746596735781,MCWP 50R,A00,893766,Compas; Sean Matthew,0,1,20,20
1746596735781,MCWP 50R,B00,893769,Carter; Jennifer A,0,1,20,20
1746596735781,MCWP 50R,C00,893771,Krone; Jarret,0,3,20,20
1746596735781,MCWP 50R,D00,893772,Miller; Elizabeth Deen,0,0,20,20
1746596735781,MCWP 50R,E00,893775,Carter; Andrea L,0,1,20,20
1746596736811,MMW 11R,A01,892721,Herbst; Matthew,14,0,30,16
1746596736811,MMW 11R,A02,892722,Herbst; Matthew,0,0,0,3
1746596737840,MMW 12R,A01,892724,Herbst; Matthew,0,11,16,16
1746596737840,MMW 12R,A02,892725,Herbst; Matthew,0,10,16,16
1746596738870,MMW 13R,A01,892727,Staff,0,4,16,16
1746596738870,MMW 13R,A02,892728,Staff,0,4,16,16
1746596738870,MMW 13R,A03,958032,Staff,0,4,16,16
1746596738870,MMW 13R,A04,958033,Staff,0,4,16,16
1746596738870,MMW 13R,A05,958034,Staff,0,4,16,16
1746596739899,SIO 295LS,A00,894015,Staff,5,0,25,20
1746596740926,SIO 295S,A00,894020,Staff,5,0,25,20
1746596741951,SIOC 290S,B01,958918,Merrifield; Mark A,14,0,30,16
1746596742977,SIOC 291S,B01,958922,Gabriel; Corey John,14,0,30,16
1746596744002,SOCI 117,A01,895339,Staff,2,0,5,3
1746596745031,WES 237B,A00,894149,Staff,11,0,20,9
1746596747093,AESE 279B,A00,891859,Staff,13,0,35,22
1746596748119,AIP 197,001,891854,Vespa; Emanuel Ignacio,9999,0,9999,0
1746596749142,ANTH 289S,A00,891856,Gagneux; Pascal,12,0,12,0
1746596750169,BENG 196,001,957946,Engler; Adam J.,9996,0,9999,3
1746596751197,BISP 197,001,959851,Wilhelm; James E.,9998,0,9999,1
1746596752223,CAT 124RS,A01,956906,Staff,6,0,25,19
1746596753252,CAT 125RS,A01,922013,Staff,6,0,25,19
1746596754277,CLRE 250,A00,891860,Morris; Sheldon,9995,0,9999,4
1746596756329,CLRE 251R,A00,907817,Mehta; Ravindra L.,9994,0,9999,5
1746596757357,CLRE 252,A00,891864,Cuomo; Raphael Eduardo,9993,0,9999,6
1746596758382,CLRE 253,A00,891867,Vaida; Florin,9994,0,9999,5
1746596758382,CLRE 253,B00,907819,Staff,9999,0,9999,0
1746596759612,CLRE 259,A00,891868,Patel; Hemal,9998,0,9999,1
1746596760639,CLRE 260,A00,891872,Cuomo; Raphael Eduardo,9999,0,9999,0
1746596761665,CLRE 297,001,891888,Cuomo; Raphael Eduardo,9999,0,9999,0
1746596762691,CSE 191,A00,958773,Minnes Kemp; Mor Mia,9995,0,9999,4
1746596763715,CSE 197,001,959846,Minnes Kemp; Mor Mia,9990,0,9999,9
1746596764745,CSS 201S,A01,892054,Mignozzetti; Umberto,25,0,30,5
1746596765771,CSS 202S,A01,892056,Mignozzetti; Umberto,25,0,30,5
1746596766801,DSC 197,001,956898,Eldridge; Justin Matthew,9996,0,9999,3
1746596767826,DSC 297,001,958000,Mazumdar; Arya,9998,0,9999,1
1746596767826,DSC 297,002,959862,Wang; Yusu,9998,0,9999,1
1746596768853,EAP 100,A00,905686,Staff,9778,0,9999,221
1746596769878,ECE 45,A01,892618,Staff,0,0,65,65
1746596771933,ECE 111,A01,892719,Staff,6,0,65,59
1746596772959,ECE 197,001,957920,Mercier; Patrick Philip,9991,0,9999,8
1746596773991,ECON 178,A01,907814,Zhu; Ying,26,0,35,9
1746596775021,EDS 115,A00,895312,Staff,35,0,45,10
1746596776048,EDS 117,A01,895337,Staff,23,0,30,7
1746596777073,EDS 125,A00,895341,Jones; Gabrielle Anastasia,36,0,45,9
1746596778097,EDS 128A,A01,895459,Fargason; Sharon Gayle,44,0,45,1
1746596779128,EDS 128B,A01,895543,Pappas; Elizabeth,44,0,45,1
1746596780156,EDS 139,A00,897203,Pappas; Elizabeth,44,0,45,1
1746596780156,EDS 139,B00,897209,Fargason; Sharon Gayle,41,0,45,4
1746596781183,EDS 201,A00,895545,Staff,22,0,45,23
1746596782217,EDS 203,A01,895581,Halter; Christopher P.,22,0,45,23
1746596783246,EDS 204R,A01,895625,Heinzman; Erica M.,39,0,45,6
1746596783246,EDS 204R,B01,895693,Halter; Christopher P.,10,0,45,35
1746596784272,EDS 206R,A00,895694,Fargason; Sharon Gayle,1,0,30,29
1746596784272,EDS 206R,B00,895695,Choi; Bailey Miyeon,16,0,30,14
1746596785298,EDS 250,A00,895697,Hemans; Patricia Ann Benitez,22,0,45,23
1746596786329,EDS 281,A00,895701,Meyerott; Theresa Ann,1,0,15,14
1746596787355,EDS 284,A00,895736,Meyerott; Theresa Ann,1,0,15,14
1746596788379,EDS 286,A00,897210,Fine; Sarah,0,0,15,15
1746596789404,EDS 289C,A01,895770,Daly; Alan J.,1,0,15,14
1746596790428,EDS 290,A00,897211,Hofstetter; Carolyn,0,0,15,15
1746596791453,LIGM 5A,A00,896162,Fischer-Grunski; Eva K,12,0,20,8
1746596792481,LIGM 5B,A00,896260,Fischer-Grunski; Eva K,17,0,20,3
1746596793505,LIGM 5C,A00,896308,Fischer-Grunski; Eva K,18,0,20,2
1746596794533,LIIT 5AS,A00,896313,Carnelos; Chiara,18,0,20,2
1746596795558,LIIT 5BS,A00,896416,Carnelos; Chiara,20,0,20,0
1746596796587,LIIT 5CS,A00,896564,Carnelos; Chiara,20,0,20,0
1746596797614,LISP 5A,A00,896588,Munoz Sanchez; Alicia,2,0,20,18
1746596798642,LISP 5B,A00,896653,Munoz Sanchez; Alicia,7,0,20,13
1746596799671,LISP 5C,A00,896655,Munoz Sanchez; Alicia,0,1,20,20
1746596800696,MAE 197,001,957918,Kleissl; Jan,9996,0,9999,3
1746596800696,MAE 197,002,959806,Boechler; Nicholas Sebastia,9998,0,9999,1
1746596800696,MAE 197,003,959852,Mullin; Jennifer S,9998,0,9999,1
1746596801724,MATH 2,A01,957937,Staff,33,0,35,2
1746596802751,MATH 197,001,957876,Kedlaya; Kiran S.,9993,0,9999,6
1746596803777,MCWP 40,A00,892729,Duru; Nur,10,0,20,10
1746596803777,MCWP 40,B00,893304,Montejo; Carolina,14,0,20,6
1746596804802,MCWP 40R,A00,893757,Redela; Pamela Morgan,0,5,20,20
1746596805828,MCWP 50,A00,893758,Morshed; Michael James,0,0,20,20
1746596805828,MCWP 50,B00,893761,Bartulis; Jason Michael,17,0,20,3
1746596806855,MCWP 50R,A00,893766,Compas; Sean Matthew,0,1,20,20
1746596806855,MCWP 50R,B00,893769,Carter; Jennifer A,0,1,20,20
1746596806855,MCWP 50R,C00,893771,Krone; Jarret,0,3,20,20
1746596806855,MCWP 50R,D00,893772,Miller; Elizabeth Deen,0,0,20,20
1746596806855,MCWP 50R,E00,893775,Carter; Andrea L,0,1,20,20
1746596807883,MMW 11R,A01,892721,Herbst; Matthew,14,0,30,16
1746596807883,MMW 11R,A02,892722,Herbst; Matthew,0,0,0,3
1746596808911,MMW 12R,A01,892724,Herbst; Matthew,0,11,16,16
1746596808911,MMW 12R,A02,892725,Herbst; Matthew,0,10,16,16
1746596809939,MMW 13R,A01,892727,Staff,0,4,16,16
1746596809939,MMW 13R,A02,892728,Staff,0,4,16,16
1746596809939,MMW 13R,A03,958032,Staff,0,4,16,16
1746596809939,MMW 13R,A04,958033,Staff,0,4,16,16
1746596809939,MMW 13R,A05,958034,Staff,0,4,16,16
1746596810967,SIO 295LS,A00,894015,Staff,5,0,25,20
1746596811994,SIO 295S,A00,894020,Staff,5,0,25,20
1746596813020,SIOC 290S,B01,958918,Merrifield; Mark A,14,0,30,16
1746596814050,SIOC 291S,B01,958922,Gabriel; Corey John,14,0,30,16
1746596815077,SOCI 117,A01,895339,Staff,2,0,5,3
1746596816102,WES 237B,A00,894149,Staff,11,0,20,9
1746596818159,AESE 279B,A00,891859,Staff,13,0,35,22
1746596819186,AIP 197,001,891854,Vespa; Emanuel Ignacio,9999,0,9999,0
1746596820211,ANTH 289S,A00,891856,Gagneux; Pascal,12,0,12,0
1746596821237,BENG 196,001,957946,Engler; Adam J.,9996,0,9999,3
1746596822263,BISP 197,001,959851,Wilhelm; James E.,9998,0,9999,1
1746596823288,CAT 124RS,A01,956906,Staff,6,0,25,19
1746596824316,CAT 125RS,A01,922013,Staff,6,0,25,19
1746596825340,CLRE 250,A00,891860,Morris; Sheldon,9995,0,9999,4
1746596827396,CLRE 251R,A00,907817,Mehta; Ravindra L.,9994,0,9999,5
1746596828425,CLRE 252,A00,891864,Cuomo; Raphael Eduardo,9993,0,9999,6
1746596829452,CLRE 253,A00,891867,Vaida; Florin,9994,0,9999,5
1746596829452,CLRE 253,B00,907819,Staff,9999,0,9999,0
1746596830480,CLRE 259,A00,891868,Patel; Hemal,9998,0,9999,1
1746596831507,CLRE 260,A00,891872,Cuomo; Raphael Eduardo,9999,0,9999,0
1746596832532,CLRE 297,001,891888,Cuomo; Raphael Eduardo,9999,0,9999,0
1746596833557,CSE 191,A00,958773,Minnes Kemp; Mor Mia,9995,0,9999,4
1746596834586,CSE 197,001,959846,Minnes Kemp; Mor Mia,9990,0,9999,9
1746596835616,CSS 201S,A01,892054,Mignozzetti; Umberto,25,0,30,5
1746596836646,CSS 202S,A01,892056,Mignozzetti; Umberto,25,0,30,5
1746596837672,DSC 197,001,956898,Eldridge; Justin Matthew,9996,0,9999,3
1746596838699,DSC 297,001,958000,Mazumdar; Arya,9998,0,9999,1
1746596838699,DSC 297,002,959862,Wang; Yusu,9998,0,9999,1
1746596839727,EAP 100,A00,905686,Staff,9778,0,9999,221
1746596840757,ECE 45,A01,892618,Staff,0,0,65,65
1746596842851,ECE 111,A01,892719,Staff,6,0,65,59
1746596843878,ECE 197,001,957920,Mercier; Patrick Philip,9991,0,9999,8
1746596844902,ECON 178,A01,907814,Zhu; Ying,26,0,35,9
1746596845927,EDS 115,A00,895312,Staff,35,0,45,10
1746596846951,EDS 117,A01,895337,Staff,23,0,30,7
1746596847975,EDS 125,A00,895341,Jones; Gabrielle Anastasia,36,0,45,9
1746596849004,EDS 128A,A01,895459,Fargason; Sharon Gayle,44,0,45,1
1746596850033,EDS 128B,A01,895543,Pappas; Elizabeth,44,0,45,1
1746596851058,EDS 139,A00,897203,Pappas; Elizabeth,44,0,45,1
1746596851058,EDS 139,B00,897209,Fargason; Sharon Gayle,41,0,45,4
1746596852083,EDS 201,A00,895545,Staff,22,0,45,23
1746596853111,EDS 203,A01,895581,Halter; Christopher P.,22,0,45,23
1746596854136,EDS 204R,A01,895625,Heinzman; Erica M.,39,0,45,6
1746596854136,EDS 204R,B01,895693,Halter; Christopher P.,10,0,45,35
1746596855163,EDS 206R,A00,895694,Fargason; Sharon Gayle,1,0,30,29
1746596855163,EDS 206R,B00,895695,Choi; Bailey Miyeon,16,0,30,14
1746596856191,EDS 250,A00,895697,Hemans; Patricia Ann Benitez,22,0,45,23
1746596857753,EDS 281,A00,895701,Meyerott; Theresa Ann,1,0,15,14
1746596858778,EDS 284,A00,895736,Meyerott; Theresa Ann,1,0,15,14
1746596859804,EDS 286,A00,897210,Fine; Sarah,0,0,15,15
1746596861037,EDS 289C,A01,895770,Daly; Alan J.,1,0,15,14
1746596862065,EDS 290,A00,897211,Hofstetter; Carolyn,0,0,15,15
1746596863091,LIGM 5A,A00,896162,Fischer-Grunski; Eva K,12,0,20,8
1746596864115,LIGM 5B,A00,896260,Fischer-Grunski; Eva K,17,0,20,3
1746596865144,LIGM 5C,A00,896308,Fischer-Grunski; Eva K,18,0,20,2
1746596866172,LIIT 5AS,A00,896313,Carnelos; Chiara,18,0,20,2
1746596867197,LIIT 5BS,A00,896416,Carnelos; Chiara,20,0,20,0
1746596868224,LIIT 5CS,A00,896564,Carnelos; Chiara,20,0,20,0
1746596869251,LISP 5A,A00,896588,Munoz Sanchez; Alicia,2,0,20,18
1746596870276,LISP 5B,A00,896653,Munoz Sanchez; Alicia,7,0,20,13
1746596871305,LISP 5C,A00,896655,Munoz Sanchez; Alicia,0,1,20,20
1746596872332,MAE 197,001,957918,Kleissl; Jan,9996,0,9999,3
1746596872332,MAE 197,002,959806,Boechler; Nicholas Sebastia,9998,0,9999,1
1746596872332,MAE 197,003,959852,Mullin; Jennifer S,9998,0,9999,1
1746596873360,MATH 2,A01,957937,Staff,33,0,35,2
1746596874386,MATH 197,001,957876,Kedlaya; Kiran S.,9993,0,9999,6
1746596875414,MCWP 40,A00,892729,Duru; Nur,10,0,20,10
1746596875414,MCWP 40,B00,893304,Montejo; Carolina,14,0,20,6
1746596876441,MCWP 40R,A00,893757,Redela; Pamela Morgan,0,5,20,20
1746596877466,MCWP 50,A00,893758,Morshed; Michael James,0,0,20,20
1746596877466,MCWP 50,B00,893761,Bartulis; Jason Michael,17,0,20,3
1746596878492,MCWP 50R,A00,893766,Compas; Sean Matthew,0,1,20,20
1746596878492,MCWP 50R,B00,893769,Carter; Jennifer A,0,1,20,20
1746596878492,MCWP 50R,C00,893771,Krone; Jarret,0,3,20,20
1746596878492,MCWP 50R,D00,893772,Miller; Elizabeth Deen,0,0,20,20
1746596878492,MCWP 50R,E00,893775,Carter; Andrea L,0,1,20,20
1746596879520,MMW 11R,A01,892721,Herbst; Matthew,14,0,30,16
1746596879520,MMW 11R,A02,892722,Herbst; Matthew,0,0,0,3
1746596880545,MMW 12R,A01,892724,Herbst; Matthew,0,11,16,16
1746596880545,MMW 12R,A02,892725,Herbst; Matthew,0,10,16,16
1746596881574,MMW 13R,A01,892727,Staff,0,4,16,16
1746596881574,MMW 13R,A02,892728,Staff,0,4,16,16
1746596881574,MMW 13R,A03,958032,Staff,0,4,16,16
1746596881574,MMW 13R,A04,958033,Staff,0,4,16,16
1746596881574,MMW 13R,A05,958034,Staff,0,4,16,16
1746596882600,SIO 295LS,A00,894015,Staff,5,0,25,20
1746596883625,SIO 295S,A00,894020,Staff,5,0,25,20
1746596884652,SIOC 290S,B01,958918,Merrifield; Mark A,14,0,30,16
1746596885679,SIOC 291S,B01,958922,Gabriel; Corey John,14,0,30,16
1746596886707,SOCI 117,A01,895339,Staff,2,0,5,3
1746596887731,WES 237B,A00,894149,Staff,11,0,20,9
1746596889799,AESE 279B,A00,891859,Staff,13,0,35,22
1746596890826,AIP 197,001,891854,Vespa; Emanuel Ignacio,9999,0,9999,0
1746596891850,ANTH 289S,A00,891856,Gagneux; Pascal,12,0,12,0
1746596892874,BENG 196,001,957946,Engler; Adam J.,9996,0,9999,3
1746596893941,BISP 197,001,959851,Wilhelm; James E.,9998,0,9999,1
1746596894967,CAT 124RS,A01,956906,Staff,6,0,25,19
1746596895995,CAT 125RS,A01,922013,Staff,6,0,25,19
1746596897023,CLRE 250,A00,891860,Morris; Sheldon,9995,0,9999,4
1746596899074,CLRE 251R,A00,907817,Mehta; Ravindra L.,9994,0,9999,5
1746596900100,CLRE 252,A00,891864,Cuomo; Raphael Eduardo,9993,0,9999,6
1746596901129,CLRE 253,A00,891867,Vaida; Florin,9994,0,9999,5
1746596901129,CLRE 253,B00,907819,Staff,9999,0,9999,0
1746596902154,CLRE 259,A00,891868,Patel; Hemal,9998,0,9999,1
1746596903178,CLRE 260,A00,891872,Cuomo; Raphael Eduardo,9999,0,9999,0
1746596904206,CLRE 297,001,891888,Cuomo; Raphael Eduardo,9999,0,9999,0
1746596905231,CSE 191,A00,958773,Minnes Kemp; Mor Mia,9995,0,9999,4
1746596906258,CSE 197,001,959846,Minnes Kemp; Mor Mia,9990,0,9999,9
1746596907286,CSS 201S,A01,892054,Mignozzetti; Umberto,25,0,30,5
1746596908310,CSS 202S,A01,892056,Mignozzetti; Umberto,25,0,30,5
1746596909338,DSC 197,001,956898,Eldridge; Justin Matthew,9996,0,9999,3
1746596910362,DSC 297,001,958000,Mazumdar; Arya,9998,0,9999,1
1746596910362,DSC 297,002,959862,Wang; Yusu,9998,0,9999,1
1746596911388,EAP 100,A00,905686,Staff,9778,0,9999,221
1746596912420,ECE 45,A01,892618,Staff,0,0,65,65
1746596914475,ECE 111,A01,892719,Staff,6,0,65,59
1746596915501,ECE 197,001,957920,Mercier; Patrick Philip,9991,0,9999,8
1746596916527,ECON 178,A01,907814,Zhu; Ying,26,0,35,9
1746596917553,EDS 115,A00,895312,Staff,35,0,45,10
1746596918578,EDS 117,A01,895337,Staff,23,0,30,7
1746596919609,EDS 125,A00,895341,Jones; Gabrielle Anastasia,36,0,45,9
1746596920635,EDS 128A,A01,895459,Fargason; Sharon Gayle,44,0,45,1
1746596921661,EDS 128B,A01,895543,Pappas; Elizabeth,44,0,45,1
1746596922686,EDS 139,A00,897203,Pappas; Elizabeth,44,0,45,1
1746596922686,EDS 139,B00,897209,Fargason; Sharon Gayle,41,0,45,4
1746596923712,EDS 201,A00,895545,Staff,22,0,45,23
1746596924737,EDS 203,A01,895581,Halter; Christopher P.,22,0,45,23
1746596925766,EDS 204R,A01,895625,Heinzman; Erica M.,39,0,45,6
1746596925766,EDS 204R,B01,895693,Halter; Christopher P.,10,0,45,35
1746596926794,EDS 206R,A00,895694,Fargason; Sharon Gayle,1,0,30,29
1746596926794,EDS 206R,B00,895695,Choi; Bailey Miyeon,16,0,30,14
1746596927819,EDS 250,A00,895697,Hemans; Patricia Ann Benitez,22,0,45,23
1746596928882,EDS 281,A00,895701,Meyerott; Theresa Ann,1,0,15,14
1746596929908,EDS 284,A00,895736,Meyerott; Theresa Ann,1,0,15,14
1746596930934,EDS 286,A00,897210,Fine; Sarah,0,0,15,15
1746596931961,EDS 289C,A01,895770,Daly; Alan J.,1,0,15,14
1746596932986,EDS 290,A00,897211,Hofstetter; Carolyn,0,0,15,15
1746596934011,LIGM 5A,A00,896162,Fischer-Grunski; Eva K,12,0,20,8
1746596935040,LIGM 5B,A00,896260,Fischer-Grunski; Eva K,17,0,20,3
1746596936070,LIGM 5C,A00,896308,Fischer-Grunski; Eva K,18,0,20,2
1746596937099,LIIT 5AS,A00,896313,Carnelos; Chiara,18,0,20,2
1746596938127,LIIT 5BS,A00,896416,Carnelos; Chiara,20,0,20,0
1746596939157,LIIT 5CS,A00,896564,Carnelos; Chiara,20,0,20,0
1746596940181,LISP 5A,A00,896588,Munoz Sanchez; Alicia,2,0,20,18
1746596941209,LISP 5B,A00,896653,Munoz Sanchez; Alicia,7,0,20,13
1746596942235,LISP 5C,A00,896655,Munoz Sanchez; Alicia,0,1,20,20
1746596943262,MAE 197,001,957918,Kleissl; Jan,9996,0,9999,3
1746596943262,MAE 197,002,959806,Boechler; Nicholas Sebastia,9998,0,9999,1
1746596943262,MAE 197,003,959852,Mullin; Jennifer S,9998,0,9999,1
1746596944290,MATH 2,A01,957937,Staff,33,0,35,2
1746596945320,MATH 197,001,957876,Kedlaya; Kiran S.,9993,0,9999,6
1746596946344,MCWP 40,A00,892729,Duru; Nur,10,0,20,10
1746596946344,MCWP 40,B00,893304,Montejo; Carolina,14,0,20,6
1746596947423,MCWP 40R,A00,893757,Redela; Pamela Morgan,0,5,20,20
1746596948449,MCWP 50,A00,893758,Morshed; Michael James,0,0,20,20
1746596948449,MCWP 50,B00,893761,Bartulis; Jason Michael,17,0,20,3
1746596949476,MCWP 50R,A00,893766,Compas; Sean Matthew,0,1,20,20
1746596949476,MCWP 50R,B00,893769,Carter; Jennifer A,0,1,20,20
1746596949476,MCWP 50R,C00,893771,Krone; Jarret,0,3,20,20
1746596949476,MCWP 50R,D00,893772,Miller; Elizabeth Deen,0,0,20,20
1746596949476,MCWP 50R,E00,893775,Carter; Andrea L,0,1,20,20
1746596950500,MMW 11R,A01,892721,Herbst; Matthew,14,0,30,16
1746596950500,MMW 11R,A02,892722,Herbst; Matthew,0,0,0,3
1746596951525,MMW 12R,A01,892724,Herbst; Matthew,0,11,16,16
1746596951525,MMW 12R,A02,892725,Herbst; Matthew,0,10,16,16
1746596952555,MMW 13R,A01,892727,Staff,0,4,16,16
1746596952555,MMW 13R,A02,892728,Staff,0,4,16,16
1746596952555,MMW 13R,A03,958032,Staff,0,4,16,16
1746596952555,MMW 13R,A04,958033,Staff,0,4,16,16
1746596952555,MMW 13R,A05,958034,Staff,0,4,16,16
1746596953582,SIO 295LS,A00,894015,Staff,5,0,25,20
1746596954608,SIO 295S,A00,894020,Staff,5,0,25,20
1746596955639,SIOC 290S,B01,958918,Merrifield; Mark A,14,0,30,16
1746596956666,SIOC 291S,B01,958922,Gabriel; Corey John,14,0,30,16
1746596957691,SOCI 117,A01,895339,Staff,2,0,5,3
1746596958717,WES 237B,A00,894149,Staff,11,0,20,9
1746596960783,AESE 279B,A00,891859,Staff,13,0,35,22
1746596961814,AIP 197,001,891854,Vespa; Emanuel Ignacio,9999,0,9999,0
1746596962839,ANTH 289S,A00,891856,Gagneux; Pascal,12,0,12,0
1746596963868,BENG 196,001,957946,Engler; Adam J.,9996,0,9999,3
1746596964896,BISP 197,001,959851,Wilhelm; James E.,9998,0,9999,1
1746596965925,CAT 124RS,A01,956906,Staff,6,0,25,19
1746596966951,CAT 125RS,A01,922013,Staff,6,0,25,19
1746596967979,CLRE 250,A00,891860,Morris; Sheldon,9995,0,9999,4
1746596970029,CLRE 251R,A00,907817,Mehta; Ravindra L.,9994,0,9999,5
1746596971053,CLRE 252,A00,891864,Cuomo; Raphael Eduardo,9993,0,9999,6
1746596972080,CLRE 253,A00,891867,Vaida; Florin,9994,0,9999,5
1746596972080,CLRE 253,B00,907819,Staff,9999,0,9999,0
1746596973108,CLRE 259,A00,891868,Patel; Hemal,9998,0,9999,1
1746596974132,CLRE 260,A00,891872,Cuomo; Raphael Eduardo,9999,0,9999,0
1746596975160,CLRE 297,001,891888,Cuomo; Raphael Eduardo,9999,0,9999,0
1746596976185,CSE 191,A00,958773,Minnes Kemp; Mor Mia,9995,0,9999,4
1746596977211,CSE 197,001,959846,Minnes Kemp; Mor Mia,9990,0,9999,9
1746596978240,CSS 201S,A01,892054,Mignozzetti; Umberto,25,0,30,5
1746596979268,CSS 202S,A01,892056,Mignozzetti; Umberto,25,0,30,5
1746596980294,DSC 197,001,956898,Eldridge; Justin Matthew,9996,0,9999,3
1746596981349,DSC 297,001,958000,Mazumdar; Arya,9998,0,9999,1
1746596981349,DSC 297,002,959862,Wang; Yusu,9998,0,9999,1
1746596982376,EAP 100,A00,905686,Staff,9778,0,9999,221
1746596983402,ECE 45,A01,892618,Staff,0,0,65,65
1746596985455,ECE 111,A01,892719,Staff,6,0,65,59
1746596986479,ECE 197,001,957920,Mercier; Patrick Philip,9991,0,9999,8
1746596987504,ECON 178,A01,907814,Zhu; Ying,26,0,35,9
1746596988589,EDS 115,A00,895312,Staff,35,0,45,10
1746596989618,EDS 117,A01,895337,Staff,23,0,30,7
1746596990644,EDS 125,A00,895341,Jones; Gabrielle Anastasia,36,0,45,9
1746596991673,EDS 128A,A01,895459,Fargason; Sharon Gayle,44,0,45,1
1746596992701,EDS 128B,A01,895543,Pappas; Elizabeth,44,0,45,1
1746596993725,EDS 139,A00,897203,Pappas; Elizabeth,44,0,45,1
1746596993725,EDS 139,B00,897209,Fargason; Sharon Gayle,41,0,45,4
1746596994753,EDS 201,A00,895545,Staff,22,0,45,23
1746596995778,EDS 203,A01,895581,Halter; Christopher P.,22,0,45,23
1746596996803,EDS 204R,A01,895625,Heinzman; Erica M.,39,0,45,6
1746596996803,EDS 204R,B01,895693,Halter; Christopher P.,10,0,45,35
1746596997830,EDS 206R,A00,895694,Fargason; Sharon Gayle,1,0,30,29
1746596997830,EDS 206R,B00,895695,Choi; Bailey Miyeon,16,0,30,14
1746596998857,EDS 250,A00,895697,Hemans; Patricia Ann Benitez,22,0,45,23
1746596999886,EDS 281,A00,895701,Meyerott; Theresa Ann,1,0,15,14
1746597000912,EDS 284,A00,895736,Meyerott; Theresa Ann,1,0,15,14
1746597001942,EDS 286,A00,897210,Fine; Sarah,0,0,15,15
1746597002968,EDS 289C,A01,895770,Daly; Alan J.,1,0,15,14
1746597003993,EDS 290,A00,897211,Hofstetter; Carolyn,0,0,15,15
1746597005021,LIGM 5A,A00,896162,Fischer-Grunski; Eva K,12,0,20,8
1746597006048,LIGM 5B,A00,896260,Fischer-Grunski; Eva K,17,0,20,3
1746597007074,LIGM 5C,A00,896308,Fischer-Grunski; Eva K,18,0,20,2
1746597008104,LIIT 5AS,A00,896313,Carnelos; Chiara,18,0,20,2
1746597009130,LIIT 5BS,A00,896416,Carnelos; Chiara,20,0,20,0
1746597010160,LIIT 5CS,A00,896564,Carnelos; Chiara,20,0,20,0
1746597011185,LISP 5A,A00,896588,Munoz Sanchez; Alicia,2,0,20,18
1746597012214,LISP 5B,A00,896653,Munoz Sanchez; Alicia,7,0,20,13
1746597013242,LISP 5C,A00,896655,Munoz Sanchez; Alicia,0,1,20,20
1746597014269,MAE 197,001,957918,Kleissl; Jan,9996,0,9999,3
1746597014269,MAE 197,002,959806,Boechler; Nicholas Sebastia,9998,0,9999,1
1746597014269,MAE 197,003,959852,Mullin; Jennifer S,9998,0,9999,1
1746597015293,MATH 2,A01,957937,Staff,33,0,35,2
1746597016319,MATH 197,001,957876,Kedlaya; Kiran S.,9993,0,9999,6
1746597017347,MCWP 40,A00,892729,Duru; Nur,10,0,20,10
1746597017347,MCWP 40,B00,893304,Montejo; Carolina,14,0,20,6
1746597018374,MCWP 40R,A00,893757,Redela; Pamela Morgan,0,5,20,20
1746597019403,MCWP 50,A00,893758,Morshed; Michael James,0,0,20,20
1746597019403,MCWP 50,B00,893761,Bartulis; Jason Michael,17,0,20,3
1746597020429,MCWP 50R,A00,893766,Compas; Sean Matthew,0,1,20,20
1746597020429,MCWP 50R,B00,893769,Carter; Jennifer A,0,1,20,20
1746597020429,MCWP 50R,C00,893771,Krone; Jarret,0,3,20,20
1746597020429,MCWP 50R,D00,893772,Miller; Elizabeth Deen,0,0,20,20
1746597020429,MCWP 50R,E00,893775,Carter; Andrea L,0,1,20,20
1746597021459,MMW 11R,A01,892721,Herbst; Matthew,14,0,30,16
1746597021459,MMW 11R,A02,892722,Herbst; Matthew,0,0,0,3
1746597022483,MMW 12R,A01,892724,Herbst; Matthew,0,11,16,16
1746597022483,MMW 12R,A02,892725,Herbst; Matthew,0,10,16,16
1746597023513,MMW 13R,A01,892727,Staff,0,4,16,16
1746597023513,MMW 13R,A02,892728,Staff,0,4,16,16
1746597023513,MMW 13R,A03,958032,Staff,0,4,16,16
1746597023513,MMW 13R,A04,958033,Staff,0,4,16,16
1746597023513,MMW 13R,A05,958034,Staff,0,4,16,16
1746597024537,SIO 295LS,A00,894015,Staff,5,0,25,20
1746597025564,SIO 295S,A00,894020,Staff,5,0,25,20
1746597026591,SIOC 290S,B01,958918,Merrifield; Mark A,14,0,30,16
1746597027616,SIOC 291S,B01,958922,Gabriel; Corey John,14,0,30,16
1746597028643,SOCI 117,A01,895339,Staff,2,0,5,3
1746597029669,WES 237B,A00,894149,Staff,11,0,20,9
1746597031733,AESE 279B,A00,891859,Staff,13,0,35,22
1746597032761,AIP 197,001,891854,Vespa; Emanuel Ignacio,9999,0,9999,0
1746597033788,ANTH 289S,A00,891856,Gagneux; Pascal,12,0,12,0
1746597034812,BENG 196,001,957946,Engler; Adam J.,9996,0,9999,3
1746597035841,BISP 197,001,959851,Wilhelm; James E.,9998,0,9999,1
1746597036868,CAT 124RS,A01,956906,Staff,6,0,25,19
1746597037892,CAT 125RS,A01,922013,Staff,6,0,25,19
1746597038921,CLRE 250,A00,891860,Morris; Sheldon,9995,0,9999,4
1746597040974,CLRE 251R,A00,907817,Mehta; Ravindra L.,9994,0,9999,5
1746597042000,CLRE 252,A00,891864,Cuomo; Raphael Eduardo,9993,0,9999,6
1746597043026,CLRE 253,A00,891867,Vaida; Florin,9994,0,9999,5
1746597043026,CLRE 253,B00,907819,Staff,9999,0,9999,0
1746597044050,CLRE 259,A00,891868,Patel; Hemal,9998,0,9999,1
1746597045075,CLRE 260,A00,891872,Cuomo; Raphael Eduardo,9999,0,9999,0
1746597046100,CLRE 297,001,891888,Cuomo; Raphael Eduardo,9999,0,9999,0
1746597047127,CSE 191,A00,958773,Minnes Kemp; Mor Mia,9995,0,9999,4
1746597048154,CSE 197,001,959846,Minnes Kemp; Mor Mia,9990,0,9999,9
1746597049182,CSS 201S,A01,892054,Mignozzetti; Umberto,25,0,30,5
1746597050208,CSS 202S,A01,892056,Mignozzetti; Umberto,25,0,30,5
1746597051237,DSC 197,001,956898,Eldridge; Justin Matthew,9996,0,9999,3
1746597052261,DSC 297,001,958000,Mazumdar; Arya,9998,0,9999,1
1746597052261,DSC 297,002,959862,Wang; Yusu,9998,0,9999,1
1746597053286,EAP 100,A00,905686,Staff,9778,0,9999,221
1746597054311,ECE 45,A01,892618,Staff,0,0,65,65
1746597056363,ECE 111,A01,892719,Staff,6,0,65,59
1746597057390,ECE 197,001,957920,Mercier; Patrick Philip,9991,0,9999,8
1746597058415,ECON 178,A01,907814,Zhu; Ying,26,0,35,9
1746597059439,EDS 115,A00,895312,Staff,35,0,45,10
1746597060468,EDS 117,A01,895337,Staff,23,0,30,7
1746597061492,EDS 125,A00,895341,Jones; Gabrielle Anastasia,36,0,45,9
1746597062519,EDS 128A,A01,895459,Fargason; Sharon Gayle,44,0,45,1
1746597063545,EDS 128B,A01,895543,Pappas; Elizabeth,44,0,45,1
1746597064572,EDS 139,A00,897203,Pappas; Elizabeth,44,0,45,1
1746597064572,EDS 139,B00,897209,Fargason; Sharon Gayle,41,0,45,4
1746597065597,EDS 201,A00,895545,Staff,22,0,45,23
1746597066624,EDS 203,A01,895581,Halter; Christopher P.,22,0,45,23
1746597067650,EDS 204R,A01,895625,Heinzman; Erica M.,39,0,45,6
1746597067650,EDS 204R,B01,895693,Halter; Christopher P.,10,0,45,35
1746597068675,EDS 206R,A00,895694,Fargason; Sharon Gayle,1,0,30,29
1746597068675,EDS 206R,B00,895695,Choi; Bailey Miyeon,16,0,30,14
1746597069699,EDS 250,A00,895697,Hemans; Patricia Ann Benitez,22,0,45,23
1746597070726,EDS 281,A00,895701,Meyerott; Theresa Ann,1,0,15,14
1746597071756,EDS 284,A00,895736,Meyerott; Theresa Ann,1,0,15,14
1746597072783,EDS 286,A00,897210,Fine; Sarah,0,0,15,15
1746597073809,EDS 289C,A01,895770,Daly; Alan J.,1,0,15,14
1746597074835,EDS 290,A00,897211,Hofstetter; Carolyn,0,0,15,15
1746597075858,LIGM 5A,A00,896162,Fischer-Grunski; Eva K,12,0,20,8
1746597076887,LIGM 5B,A00,896260,Fischer-Grunski; Eva K,17,0,20,3
1746597077918,LIGM 5C,A00,896308,Fischer-Grunski; Eva K,18,0,20,2
1746597078949,LIIT 5AS,A00,896313,Carnelos; Chiara,18,0,20,2
1746597079977,LIIT 5BS,A00,896416,Carnelos; Chiara,20,0,20,0
1746597081007,LIIT 5CS,A00,896564,Carnelos; Chiara,20,0,20,0
1746597082035,LISP 5A,A00,896588,Munoz Sanchez; Alicia,2,0,20,18
1746597083062,LISP 5B,A00,896653,Munoz Sanchez; Alicia,7,0,20,13
1746597084091,LISP 5C,A00,896655,Munoz Sanchez; Alicia,0,1,20,20
1746597085119,MAE 197,001,957918,Kleissl; Jan,9996,0,9999,3
1746597085119,MAE 197,002,959806,Boechler; Nicholas Sebastia,9998,0,9999,1
1746597085119,MAE 197,003,959852,Mullin; Jennifer S,9998,0,9999,1
1746597086145,MATH 2,A01,957937,Staff,33,0,35,2
1746597087174,MATH 197,001,957876,Kedlaya; Kiran S.,9993,0,9999,6
1746597088200,MCWP 40,A00,892729,Duru; Nur,10,0,20,10
1746597088200,MCWP 40,B00,893304,Montejo; Carolina,14,0,20,6
1746597089228,MCWP 40R,A00,893757,Redela; Pamela Morgan,0,5,20,20
1746597090252,MCWP 50,A00,893758,Morshed; Michael James,0,0,20,20
1746597090252,MCWP 50,B00,893761,Bartulis; Jason Michael,17,0,20,3
1746597091282,MCWP 50R,A00,893766,Compas; Sean Matthew,0,1,20,20
1746597091282,MCWP 50R,B00,893769,Carter; Jennifer A,0,1,20,20
1746597091282,MCWP 50R,C00,893771,Krone; Jarret,0,3,20,20
1746597091282,MCWP 50R,D00,893772,Miller; Elizabeth Deen,0,0,20,20
1746597091282,MCWP 50R,E00,893775,Carter; Andrea L,0,1,20,20
1746597092306,MMW 11R,A01,892721,Herbst; Matthew,14,0,30,16
1746597092306,MMW 11R,A02,892722,Herbst; Matthew,0,0,0,3
1746597093336,MMW 12R,A01,892724,Herbst; Matthew,0,11,16,16
1746597093336,MMW 12R,A02,892725,Herbst; Matthew,0,10,16,16
1746597094360,MMW 13R,A01,892727,Staff,0,4,16,16
1746597094360,MMW 13R,A02,892728,Staff,0,4,16,16
1746597094360,MMW 13R,A03,958032,Staff,0,4,16,16
1746597094360,MMW 13R,A04,958033,Staff,0,4,16,16
1746597094360,MMW 13R,A05,958034,Staff,0,4,16,16
1746597095386,SIO 295LS,A00,894015,Staff,5,0,25,20
1746597096410,SIO 295S,A00,894020,Staff,5,0,25,20
1746597097435,SIOC 290S,B01,958918,Merrifield; Mark A,14,0,30,16
1746597098463,SIOC 291S,B01,958922,Gabriel; Corey John,14,0,30,16
1746597099493,SOCI 117,A01,895339,Staff,2,0,5,3
1746597100521,WES 237B,A00,894149,Staff,11,0,20,9
1746597102589,AESE 279B,A00,891859,Staff,13,0,35,22
1746597103613,AIP 197,001,891854,Vespa; Emanuel Ignacio,9999,0,9999,0
1746597104638,ANTH 289S,A00,891856,Gagneux; Pascal,12,0,12,0
1746597105666,BENG 196,001,957946,Engler; Adam J.,9996,0,9999,3
1746597106693,BISP 197,001,959851,Wilhelm; James E.,9998,0,9999,1
1746597107720,CAT 124RS,A01,956906,Staff,6,0,25,19
1746597108744,CAT 125RS,A01,922013,Staff,6,0,25,19
1746597109773,CLRE 250,A00,891860,Morris; Sheldon,9995,0,9999,4
1746597111827,CLRE 251R,A00,907817,Mehta; Ravindra L.,9994,0,9999,5
1746597112855,CLRE 252,A00,891864,Cuomo; Raphael Eduardo,9993,0,9999,6
1746597113880,CLRE 253,A00,891867,Vaida; Florin,9994,0,9999,5
1746597113880,CLRE 253,B00,907819,Staff,9999,0,9999,0
1746597114906,CLRE 259,A00,891868,Patel; Hemal,9998,0,9999,1
1746597115931,CLRE 260,A00,891872,Cuomo; Raphael Eduardo,9999,0,9999,0
1746597116956,CLRE 297,001,891888,Cuomo; Raphael Eduardo,9999,0,9999,0
1746597117982,CSE 191,A00,958773,Minnes Kemp; Mor Mia,9995,0,9999,4
1746597119009,CSE 197,001,959846,Minnes Kemp; Mor Mia,9990,0,9999,9
1746597120038,CSS 201S,A01,892054,Mignozzetti; Umberto,25,0,30,5
1746597121062,CSS 202S,A01,892056,Mignozzetti; Umberto,25,0,30,5
1746597122087,DSC 197,001,956898,Eldridge; Justin Matthew,9996,0,9999,3
1746597123113,DSC 297,001,958000,Mazumdar; Arya,9998,0,9999,1
1746597123113,DSC 297,002,959862,Wang; Yusu,9998,0,9999,1
1746597124142,EAP 100,A00,905686,Staff,9778,0,9999,221
1746597125170,ECE 45,A01,892618,Staff,0,0,65,65
1746597127218,ECE 111,A01,892719,Staff,6,0,65,59
1746597128242,ECE 197,001,957920,Mercier; Patrick Philip,9991,0,9999,8
1746597129266,ECON 178,A01,907814,Zhu; Ying,26,0,35,9
1746597130291,EDS 115,A00,895312,Staff,35,0,45,10
1746597131319,EDS 117,A01,895337,Staff,23,0,30,7
1746597132347,EDS 125,A00,895341,Jones; Gabrielle Anastasia,36,0,45,9
1746597133373,EDS 128A,A01,895459,Fargason; Sharon Gayle,44,0,45,1
1746597134399,EDS 128B,A01,895543,Pappas; Elizabeth,44,0,45,1
1746597135427,EDS 139,A00,897203,Pappas; Elizabeth,44,0,45,1
1746597135427,EDS 139,B00,897209,Fargason; Sharon Gayle,41,0,45,4
1746597136452,EDS 201,A00,895545,Staff,22,0,45,23
1746597137477,EDS 203,A01,895581,Halter; Christopher P.,22,0,45,23
1746597138504,EDS 204R,A01,895625,Heinzman; Erica M.,39,0,45,6
1746597138504,EDS 204R,B01,895693,Halter; Christopher P.,10,0,45,35
1746597139531,EDS 206R,A00,895694,Fargason; Sharon Gayle,1,0,30,29
1746597139531,EDS 206R,B00,895695,Choi; Bailey Miyeon,16,0,30,14
1746597140557,EDS 250,A00,895697,Hemans; Patricia Ann Benitez,22,0,45,23
1746597141583,EDS 281,A00,895701,Meyerott; Theresa Ann,1,0,15,14
1746597142609,EDS 284,A00,895736,Meyerott; Theresa Ann,1,0,15,14
1746597143635,EDS 286,A00,897210,Fine; Sarah,0,0,15,15
1746597144659,EDS 289C,A01,895770,Daly; Alan J.,1,0,15,14
1746597145686,EDS 290,A00,897211,Hofstetter; Carolyn,0,0,15,15
1746597146712,LIGM 5A,A00,896162,Fischer-Grunski; Eva K,12,0,20,8
1746597147737,LIGM 5B,A00,896260,Fischer-Grunski; Eva K,17,0,20,3
1746597148763,LIGM 5C,A00,896308,Fischer-Grunski; Eva K,18,0,20,2
1746597149788,LIIT 5AS,A00,896313,Carnelos; Chiara,18,0,20,2
1746597150814,LIIT 5BS,A00,896416,Carnelos; Chiara,20,0,20,0
1746597151846,LIIT 5CS,A00,896564,Carnelos; Chiara,20,0,20,0
1746597152871,LISP 5A,A00,896588,Munoz Sanchez; Alicia,2,0,20,18
1746597153902,LISP 5B,A00,896653,Munoz Sanchez; Alicia,7,0,20,13
1746597154929,LISP 5C,A00,896655,Munoz Sanchez; Alicia,0,1,20,20
1746597155954,MAE 197,001,957918,Kleissl; Jan,9996,0,9999,3
1746597155954,MAE 197,002,959806,Boechler; Nicholas Sebastia,9998,0,9999,1
1746597155954,MAE 197,003,959852,Mullin; Jennifer S,9998,0,9999,1
1746597156980,MATH 2,A01,957937,Staff,33,0,35,2
1746597158006,MATH 197,001,957876,Kedlaya; Kiran S.,9993,0,9999,6
1746597159034,MCWP 40,A00,892729,Duru; Nur,10,0,20,10
1746597159034,MCWP 40,B00,893304,Montejo; Carolina,14,0,20,6
1746597160057,MCWP 40R,A00,893757,Redela; Pamela Morgan,0,5,20,20
1746597161083,MCWP 50,A00,893758,Morshed; Michael James,0,0,20,20
1746597161083,MCWP 50,B00,893761,Bartulis; Jason Michael,17,0,20,3
1746597162114,MCWP 50R,A00,893766,Compas; Sean Matthew,0,1,20,20
1746597162114,MCWP 50R,B00,893769,Carter; Jennifer A,0,1,20,20
1746597162114,MCWP 50R,C00,893771,Krone; Jarret,0,3,20,20
1746597162114,MCWP 50R,D00,893772,Miller; Elizabeth Deen,0,0,20,20
1746597162114,MCWP 50R,E00,893775,Carter; Andrea L,0,1,20,20
1746597163142,MMW 11R,A01,892721,Herbst; Matthew,14,0,30,16
1746597163142,MMW 11R,A02,892722,Herbst; Matthew,0,0,0,3
1746597164168,MMW 12R,A01,892724,Herbst; Matthew,0,11,16,16
1746597164168,MMW 12R,A02,892725,Herbst; Matthew,0,10,16,16
1746597165196,MMW 13R,A01,892727,Staff,0,4,16,16
1746597165196,MMW 13R,A02,892728,Staff,0,4,16,16
1746597165196,MMW 13R,A03,958032,Staff,0,4,16,16
1746597165196,MMW 13R,A04,958033,Staff,0,4,16,16
1746597165196,MMW 13R,A05,958034,Staff,0,4,16,16
1746597166220,SIO 295LS,A00,894015,Staff,5,0,25,20
1746597167248,SIO 295S,A00,894020,Staff,5,0,25,20
1746597168276,SIOC 290S,B01,958918,Merrifield; Mark A,14,0,30,16
1746597169302,SIOC 291S,B01,958922,Gabriel; Corey John,14,0,30,16
1746597170329,SOCI 117,A01,895339,Staff,2,0,5,3
1746597171357,WES 237B,A00,894149,Staff,11,0,20,9
1746597173421,AESE 279B,A00,891859,Staff,13,0,35,22
1746597174448,AIP 197,001,891854,Vespa; Emanuel Ignacio,9999,0,9999,0
1746597175474,ANTH 289S,A00,891856,Gagneux; Pascal,12,0,12,0
1746597176500,BENG 196,001,957946,Engler; Adam J.,9996,0,9999,3
1746597177528,BISP 197,001,959851,Wilhelm; James E.,9998,0,9999,1
1746597178555,CAT 124RS,A01,956906,Staff,6,0,25,19
1746597179578,CAT 125RS,A01,922013,Staff,6,0,25,19
1746597180603,CLRE 250,A00,891860,Morris; Sheldon,9995,0,9999,4
1746597182655,CLRE 251R,A00,907817,Mehta; Ravindra L.,9994,0,9999,5
1746597183681,CLRE 252,A00,891864,Cuomo; Raphael Eduardo,9993,0,9999,6
1746597184708,CLRE 253,A00,891867,Vaida; Florin,9994,0,9999,5
1746597184708,CLRE 253,B00,907819,Staff,9999,0,9999,0
1746597185735,CLRE 259,A00,891868,Patel; Hemal,9998,0,9999,1
1746597186763,CLRE 260,A00,891872,Cuomo; Raphael Eduardo,9999,0,9999,0
1746597187790,CLRE 297,001,891888,Cuomo; Raphael Eduardo,9999,0,9999,0
1746597188815,CSE 191,A00,958773,Minnes Kemp; Mor Mia,9995,0,9999,4
1746597189840,CSE 197,001,959846,Minnes Kemp; Mor Mia,9990,0,9999,9
1746597190866,CSS 201S,A01,892054,Mignozzetti; Umberto,25,0,30,5
1746597191892,CSS 202S,A01,892056,Mignozzetti; Umberto,25,0,30,5
1746597192918,DSC 197,001,956898,Eldridge; Justin Matthew,9996,0,9999,3
1746597193946,DSC 297,001,958000,Mazumdar; Arya,9998,0,9999,1
1746597193946,DSC 297,002,959862,Wang; Yusu,9998,0,9999,1
1746597194972,EAP 100,A00,905686,Staff,9778,0,9999,221
1746597195998,ECE 45,A01,892618,Staff,0,0,65,65
1746597198050,ECE 111,A01,892719,Staff,6,0,65,59
1746597199075,ECE 197,001,957920,Mercier; Patrick Philip,9991,0,9999,8
1746597200105,ECON 178,A01,907814,Zhu; Ying,26,0,35,9
1746597201134,EDS 115,A00,895312,Staff,35,0,45,10
1746597202164,EDS 117,A01,895337,Staff,23,0,30,7
1746597203191,EDS 125,A00,895341,Jones; Gabrielle Anastasia,36,0,45,9
1746597204216,EDS 128A,A01,895459,Fargason; Sharon Gayle,44,0,45,1
1746597205241,EDS 128B,A01,895543,Pappas; Elizabeth,44,0,45,1
1746597206268,EDS 139,A00,897203,Pappas; Elizabeth,44,0,45,1
1746597206268,EDS 139,B00,897209,Fargason; Sharon Gayle,41,0,45,4
1746597207296,EDS 201,A00,895545,Staff,22,0,45,23
1746597208321,EDS 203,A01,895581,Halter; Christopher P.,22,0,45,23
1746597209348,EDS 204R,A01,895625,Heinzman; Erica M.,39,0,45,6
1746597209348,EDS 204R,B01,895693,Halter; Christopher P.,10,0,45,35
1746597210375,EDS 206R,A00,895694,Fargason; Sharon Gayle,1,0,30,29
1746597210375,EDS 206R,B00,895695,Choi; Bailey Miyeon,16,0,30,14
1746597211400,EDS 250,A00,895697,Hemans; Patricia Ann Benitez,22,0,45,23
1746597212425,EDS 281,A00,895701,Meyerott; Theresa Ann,1,0,15,14
1746597213451,EDS 284,A00,895736,Meyerott; Theresa Ann,1,0,15,14
1746597214479,EDS 286,A00,897210,Fine; Sarah,0,0,15,15
1746597215505,EDS 289C,A01,895770,Daly; Alan J.,1,0,15,14
1746597216531,EDS 290,A00,897211,Hofstetter; Carolyn,0,0,15,15
1746597217557,LIGM 5A,A00,896162,Fischer-Grunski; Eva K,12,0,20,8
1746597218586,LIGM 5B,A00,896260,Fischer-Grunski; Eva K,17,0,20,3
1746597219613,LIGM 5C,A00,896308,Fischer-Grunski; Eva K,18,0,20,2
1746597220643,LIIT 5AS,A00,896313,Carnelos; Chiara,18,0,20,2
1746597221674,LIIT 5BS,A00,896416,Carnelos; Chiara,20,0,20,0
1746597222699,LIIT 5CS,A00,896564,Carnelos; Chiara,20,0,20,0
1746597223728,LISP 5A,A00,896588,Munoz Sanchez; Alicia,2,0,20,18
1746597224755,LISP 5B,A00,896653,Munoz Sanchez; Alicia,7,0,20,13
1746597225780,LISP 5C,A00,896655,Munoz Sanchez; Alicia,0,1,20,20
1746597226806,MAE 197,001,957918,Kleissl; Jan,9996,0,9999,3
1746597226806,MAE 197,002,959806,Boechler; Nicholas Sebastia,9998,0,9999,1
1746597226806,MAE 197,003,959852,Mullin; Jennifer S,9998,0,9999,1
1746597227832,MATH 2,A01,957937,Staff,33,0,35,2
1746597228861,MATH 197,001,957876,Kedlaya; Kiran S.,9993,0,9999,6
1746597229890,MCWP 40,A00,892729,Duru; Nur,10,0,20,10
1746597229890,MCWP 40,B00,893304,Montejo; Carolina,14,0,20,6
1746597230916,MCWP 40R,A00,893757,Redela; Pamela Morgan,0,5,20,20
1746597231945,MCWP 50,A00,893758,Morshed; Michael James,0,0,20,20
1746597231945,MCWP 50,B00,893761,Bartulis; Jason Michael,17,0,20,3
1746597232975,MCWP 50R,A00,893766,Compas; Sean Matthew,0,1,20,20
1746597232975,MCWP 50R,B00,893769,Carter; Jennifer A,0,1,20,20
1746597232975,MCWP 50R,C00,893771,Krone; Jarret,0,3,20,20
1746597232975,MCWP 50R,D00,893772,Miller; Elizabeth Deen,0,0,20,20
1746597232975,MCWP 50R,E00,893775,Carter; Andrea L,0,1,20,20
1746597234001,MMW 11R,A01,892721,Herbst; Matthew,14,0,30,16
1746597234001,MMW 11R,A02,892722,Herbst; Matthew,0,0,0,3
1746597235032,MMW 12R,A01,892724,Herbst; Matthew,0,11,16,16
1746597235032,MMW 12R,A02,892725,Herbst; Matthew,0,10,16,16
1746597236060,MMW 13R,A01,892727,Staff,0,4,16,16
1746597236060,MMW 13R,A02,892728,Staff,0,4,16,16
1746597236060,MMW 13R,A03,958032,Staff,0,4,16,16
1746597236060,MMW 13R,A04,958033,Staff,0,4,16,16
1746597236060,MMW 13R,A05,958034,Staff,0,4,16,16
1746597237086,SIO 295LS,A00,894015,Staff,5,0,25,20
1746597238111,SIO 295S,A00,894020,Staff,5,0,25,20
1746597239137,SIOC 290S,B01,958918,Merrifield; Mark A,14,0,30,16
1746597240169,SIOC 291S,B01,958922,Gabriel; Corey John,14,0,30,16
1746597241194,SOCI 117,A01,895339,Staff,2,0,5,3
1746597242225,WES 237B,A00,894149,Staff,11,0,20,9
1746597244280,AESE 279B,A00,891859,Staff,13,0,35,22
1746597245305,AIP 197,001,891854,Vespa; Emanuel Ignacio,9999,0,9999,0
1746597246330,ANTH 289S,A00,891856,Gagneux; Pascal,12,0,12,0
1746597247354,BENG 196,001,957946,Engler; Adam J.,9996,0,9999,3
1746597248378,BISP 197,001,959851,Wilhelm; James E.,9998,0,9999,1
1746597249403,CAT 124RS,A01,956906,Staff,6,0,25,19
1746597250428,CAT 125RS,A01,922013,Staff,6,0,25,19
1746597251457,CLRE 250,A00,891860,Morris; Sheldon,9995,0,9999,4
1746597253514,CLRE 251R,A00,907817,Mehta; Ravindra L.,9994,0,9999,5
1746597254540,CLRE 252,A00,891864,Cuomo; Raphael Eduardo,9993,0,9999,6
1746597255565,CLRE 253,A00,891867,Vaida; Florin,9994,0,9999,5
1746597255565,CLRE 253,B00,907819,Staff,9999,0,9999,0
1746597256590,CLRE 259,A00,891868,Patel; Hemal,9998,0,9999,1
1746597257616,CLRE 260,A00,891872,Cuomo; Raphael Eduardo,9999,0,9999,0
1746597258641,CLRE 297,001,891888,Cuomo; Raphael Eduardo,9999,0,9999,0
1746597259666,CSE 191,A00,958773,Minnes Kemp; Mor Mia,9995,0,9999,4
1746597260691,CSE 197,001,959846,Minnes Kemp; Mor Mia,9990,0,9999,9
1746597261717,CSS 201S,A01,892054,Mignozzetti; Umberto,25,0,30,5
1746597262744,CSS 202S,A01,892056,Mignozzetti; Umberto,25,0,30,5
1746597263772,DSC 197,001,956898,Eldridge; Justin Matthew,9996,0,9999,3
1746597264801,DSC 297,001,958000,Mazumdar; Arya,9998,0,9999,1
1746597264801,DSC 297,002,959862,Wang; Yusu,9998,0,9999,1
1746597265828,EAP 100,A00,905686,Staff,9778,0,9999,221
1746597266857,ECE 45,A01,892618,Staff,0,0,65,65
1746597268911,ECE 111,A01,892719,Staff,6,0,65,59
1746597269937,ECE 197,001,957920,Mercier; Patrick Philip,9991,0,9999,8
1746597270962,ECON 178,A01,907814,Zhu; Ying,26,0,35,9
1746597271992,EDS 115,A00,895312,Staff,35,0,45,10
1746597273018,EDS 117,A01,895337,Staff,23,0,30,7
1746597274045,EDS 125,A00,895341,Jones; Gabrielle Anastasia,36,0,45,9
1746597275069,EDS 128A,A01,895459,Fargason; Sharon Gayle,44,0,45,1
1746597276099,EDS 128B,A01,895543,Pappas; Elizabeth,44,0,45,1
1746597277125,EDS 139,A00,897203,Pappas; Elizabeth,44,0,45,1
1746597277125,EDS 139,B00,897209,Fargason; Sharon Gayle,41,0,45,4
1746597278153,EDS 201,A00,895545,Staff,22,0,45,23
1746597279183,EDS 203,A01,895581,Halter; Christopher P.,22,0,45,23
1746597280210,EDS 204R,A01,895625,Heinzman; Erica M.,39,0,45,6
1746597280210,EDS 204R,B01,895693,Halter; Christopher P.,10,0,45,35
1746597281238,EDS 206R,A00,895694,Fargason; Sharon Gayle,1,0,30,29
1746597281238,EDS 206R,B00,895695,Choi; Bailey Miyeon,16,0,30,14
1746597282264,EDS 250,A00,895697,Hemans; Patricia Ann Benitez,22,0,45,23
1746597283288,EDS 281,A00,895701,Meyerott; Theresa Ann,1,0,15,14
1746597284316,EDS 284,A00,895736,Meyerott; Theresa Ann,1,0,15,14
1746597285341,EDS 286,A00,897210,Fine; Sarah,0,0,15,15
1746597286367,EDS 289C,A01,895770,Daly; Alan J.,1,0,15,14
1746597287395,EDS 290,A00,897211,Hofstetter; Carolyn,0,0,15,15
1746597288424,LIGM 5A,A00,896162,Fischer-Grunski; Eva K,12,0,20,8
1746597289449,LIGM 5B,A00,896260,Fischer-Grunski; Eva K,17,0,20,3
1746597290477,LIGM 5C,A00,896308,Fischer-Grunski; Eva K,18,0,20,2
1746597291507,LIIT 5AS,A00,896313,Carnelos; Chiara,18,0,20,2
1746597292532,LIIT 5BS,A00,896416,Carnelos; Chiara,20,0,20,0
1746597293559,LIIT 5CS,A00,896564,Carnelos; Chiara,20,0,20,0
1746597294586,LISP 5A,A00,896588,Munoz Sanchez; Alicia,2,0,20,18
1746597295612,LISP 5B,A00,896653,Munoz Sanchez; Alicia,7,0,20,13
1746597296640,LISP 5C,A00,896655,Munoz Sanchez; Alicia,0,1,20,20
1746597297667,MAE 197,001,957918,Kleissl; Jan,9996,0,9999,3
1746597297667,MAE 197,002,959806,Boechler; Nicholas Sebastia,9998,0,9999,1
1746597297667,MAE 197,003,959852,Mullin; Jennifer S,9998,0,9999,1
1746597298696,MATH 2,A01,957937,Staff,33,0,35,2
1746597299723,MATH 197,001,957876,Kedlaya; Kiran S.,9993,0,9999,6
1746597300750,MCWP 40,A00,892729,Duru; Nur,10,0,20,10
1746597300750,MCWP 40,B00,893304,Montejo; Carolina,14,0,20,6
1746597301785,MCWP 40R,A00,893757,Redela; Pamela Morgan,0,5,20,20
1746597302815,MCWP 50,A00,893758,Morshed; Michael James,0,0,20,20
1746597302815,MCWP 50,B00,893761,Bartulis; Jason Michael,17,0,20,3
1746597303843,MCWP 50R,A00,893766,Compas; Sean Matthew,0,1,20,20
1746597303843,MCWP 50R,B00,893769,Carter; Jennifer A,0,1,20,20
1746597303843,MCWP 50R,C00,893771,Krone; Jarret,0,3,20,20
1746597303843,MCWP 50R,D00,893772,Miller; Elizabeth Deen,0,0,20,20
1746597303843,MCWP 50R,E00,893775,Carter; Andrea L,0,1,20,20
1746597304869,MMW 11R,A01,892721,Herbst; Matthew,14,0,30,16
1746597304869,MMW 11R,A02,892722,Herbst; Matthew,0,0,0,3
1746597305896,MMW 12R,A01,892724,Herbst; Matthew,0,11,16,16
1746597305896,MMW 12R,A02,892725,Herbst; Matthew,0,10,16,16
1746597306922,MMW 13R,A01,892727,Staff,0,4,16,16
1746597306922,MMW 13R,A02,892728,Staff,0,4,16,16
1746597306922,MMW 13R,A03,958032,Staff,0,4,16,16
1746597306922,MMW 13R,A04,958033,Staff,0,4,16,16
1746597306922,MMW 13R,A05,958034,Staff,0,4,16,16
1746597307949,SIO 295LS,A00,894015,Staff,5,0,25,20
1746597308975,SIO 295S,A00,894020,Staff,5,0,25,20
1746597310008,SIOC 290S,B01,958918,Merrifield; Mark A,14,0,30,16
1746597311039,SIOC 291S,B01,958922,Gabriel; Corey John,14,0,30,16
1746597312063,SOCI 117,A01,895339,Staff,2,0,5,3
1746597313092,WES 237B,A00,894149,Staff,11,0,20,9
1746597315152,AESE 279B,A00,891859,Staff,13,0,35,22
1746597316176,AIP 197,001,891854,Vespa; Emanuel Ignacio,9999,0,9999,0
1746597317203,ANTH 289S,A00,891856,Gagneux; Pascal,12,0,12,0
1746597318230,BENG 196,001,957946,Engler; Adam J.,9996,0,9999,3
1746597319256,BISP 197,001,959851,Wilhelm; James E.,9998,0,9999,1
1746597320284,CAT 124RS,A01,956906,Staff,6,0,25,19
1746597321309,CAT 125RS,A01,922013,Staff,6,0,25,19
1746597322334,CLRE 250,A00,891860,Morris; Sheldon,9995,0,9999,4
1746597324388,CLRE 251R,A00,907817,Mehta; Ravindra L.,9994,0,9999,5
1746597325416,CLRE 252,A00,891864,Cuomo; Raphael Eduardo,9993,0,9999,6
1746597326443,CLRE 253,A00,891867,Vaida; Florin,9994,0,9999,5
1746597326443,CLRE 253,B00,907819,Staff,9999,0,9999,0
1746597327471,CLRE 259,A00,891868,Patel; Hemal,9998,0,9999,1
1746597328500,CLRE 260,A00,891872,Cuomo; Raphael Eduardo,9999,0,9999,0
1746597329524,CLRE 297,001,891888,Cuomo; Raphael Eduardo,9999,0,9999,0
1746597330549,CSE 191,A00,958773,Minnes Kemp; Mor Mia,9995,0,9999,4
1746597331577,CSE 197,001,959846,Minnes Kemp; Mor Mia,9990,0,9999,9
1746597332607,CSS 201S,A01,892054,Mignozzetti; Umberto,25,0,30,5
1746597333633,CSS 202S,A01,892056,Mignozzetti; Umberto,25,0,30,5
1746597334660,DSC 197,001,956898,Eldridge; Justin Matthew,9996,0,9999,3
1746597335685,DSC 297,001,958000,Mazumdar; Arya,9998,0,9999,1
1746597335685,DSC 297,002,959862,Wang; Yusu,9998,0,9999,1
1746597336710,EAP 100,A00,905686,Staff,9778,0,9999,221
1746597337939,ECE 45,A01,892618,Staff,0,0,65,65
1746597339989,ECE 111,A01,892719,Staff,6,0,65,59
1746597341017,ECE 197,001,957920,Mercier; Patrick Philip,9991,0,9999,8
1746597342042,ECON 178,A01,907814,Zhu; Ying,26,0,35,9
1746597343067,EDS 115,A00,895312,Staff,35,0,45,10
1746597344094,EDS 117,A01,895337,Staff,23,0,30,7
1746597345122,EDS 125,A00,895341,Jones; Gabrielle Anastasia,36,0,45,9
1746597346150,EDS 128A,A01,895459,Fargason; Sharon Gayle,44,0,45,1
1746597347176,EDS 128B,A01,895543,Pappas; Elizabeth,44,0,45,1
1746597348201,EDS 139,A00,897203,Pappas; Elizabeth,44,0,45,1
1746597348201,EDS 139,B00,897209,Fargason; Sharon Gayle,41,0,45,4
1746597349229,EDS 201,A00,895545,Staff,22,0,45,23
1746597350254,EDS 203,A01,895581,Halter; Christopher P.,22,0,45,23
1746597351282,EDS 204R,A01,895625,Heinzman; Erica M.,39,0,45,6
1746597351282,EDS 204R,B01,895693,Halter; Christopher P.,10,0,45,35
1746597352307,EDS 206R,A00,895694,Fargason; Sharon Gayle,1,0,30,29
1746597352307,EDS 206R,B00,895695,Choi; Bailey Miyeon,16,0,30,14
1746597353331,EDS 250,A00,895697,Hemans; Patricia Ann Benitez,22,0,45,23
1746597354358,EDS 281,A00,895701,Meyerott; Theresa Ann,1,0,15,14
1746597355382,EDS 284,A00,895736,Meyerott; Theresa Ann,1,0,15,14
1746597356411,EDS 286,A00,897210,Fine; Sarah,0,0,15,15
1746597357437,EDS 289C,A01,895770,Daly; Alan J.,1,0,15,14
1746597358466,EDS 290,A00,897211,Hofstetter; Carolyn,0,0,15,15
1746597359492,LIGM 5A,A00,896162,Fischer-Grunski; Eva K,12,0,20,8
1746597360523,LIGM 5B,A00,896260,Fischer-Grunski; Eva K,17,0,20,3
1746597361548,LIGM 5C,A00,896308,Fischer-Grunski; Eva K,18,0,20,2
1746597362574,LIIT 5AS,A00,896313,Carnelos; Chiara,18,0,20,2
1746597363603,LIIT 5BS,A00,896416,Carnelos; Chiara,20,0,20,0
1746597364835,LIIT 5CS,A00,896564,Carnelos; Chiara,20,0,20,0
1746597365862,LISP 5A,A00,896588,Munoz Sanchez; Alicia,2,0,20,18
1746597366893,LISP 5B,A00,896653,Munoz Sanchez; Alicia,7,0,20,13
1746597367917,LISP 5C,A00,896655,Munoz Sanchez; Alicia,0,1,20,20
1746597368946,MAE 197,001,957918,Kleissl; Jan,9996,0,9999,3
1746597368946,MAE 197,002,959806,Boechler; Nicholas Sebastia,9998,0,9999,1
1746597368946,MAE 197,003,959852,Mullin; Jennifer S,9998,0,9999,1
1746597369974,MATH 2,A01,957937,Staff,33,0,35,2
1746597371000,MATH 197,001,957876,Kedlaya; Kiran S.,9993,0,9999,6
1746597372028,MCWP 40,A00,892729,Duru; Nur,10,0,20,10
1746597372028,MCWP 40,B00,893304,Montejo; Carolina,14,0,20,6
1746597373054,MCWP 40R,A00,893757,Redela; Pamela Morgan,0,5,20,20
1746597374081,MCWP 50,A00,893758,Morshed; Michael James,0,0,20,20
1746597374081,MCWP 50,B00,893761,Bartulis; Jason Michael,17,0,20,3
1746597375111,MCWP 50R,A00,893766,Compas; Sean Matthew,0,1,20,20
1746597375111,MCWP 50R,B00,893769,Carter; Jennifer A,0,1,20,20
1746597375111,MCWP 50R,C00,893771,Krone; Jarret,0,3,20,20
1746597375111,MCWP 50R,D00,893772,Miller; Elizabeth Deen,0,0,20,20
1746597375111,MCWP 50R,E00,893775,Carter; Andrea L,0,1,20,20
1746597376138,MMW 11R,A01,892721,Herbst; Matthew,14,0,30,16
1746597376138,MMW 11R,A02,892722,Herbst; Matthew,0,0,0,3
1746597377162,MMW 12R,A01,892724,Herbst; Matthew,0,11,16,16
1746597377162,MMW 12R,A02,892725,Herbst; Matthew,0,10,16,16
1746597378187,MMW 13R,A01,892727,Staff,0,4,16,16
1746597378187,MMW 13R,A02,892728,Staff,0,4,16,16
1746597378187,MMW 13R,A03,958032,Staff,0,4,16,16
1746597378187,MMW 13R,A04,958033,Staff,0,4,16,16
1746597378187,MMW 13R,A05,958034,Staff,0,4,16,16
1746597379212,SIO 295LS,A00,894015,Staff,5,0,25,20
1746597380242,SIO 295S,A00,894020,Staff,5,0,25,20
1746597381268,SIOC 290S,B01,958918,Merrifield; Mark A,14,0,30,16
1746597382294,SIOC 291S,B01,958922,Gabriel; Corey John,14,0,30,16
1746597383318,SOCI 117,A01,895339,Staff,2,0,5,3
1746597384343,WES 237B,A00,894149,Staff,11,0,20,9
1746597386405,AESE 279B,A00,891859,Staff,13,0,35,22
1746597387433,AIP 197,001,891854,Vespa; Emanuel Ignacio,9999,0,9999,0
1746597388462,ANTH 289S,A00,891856,Gagneux; Pascal,12,0,12,0
1746597389490,BENG 196,001,957946,Engler; Adam J.,9996,0,9999,3
1746597390521,BISP 197,001,959851,Wilhelm; James E.,9998,0,9999,1
1746597391549,CAT 124RS,A01,956906,Staff,6,0,25,19
1746597392580,CAT 125RS,A01,922013,Staff,6,0,25,19
1746597393606,CLRE 250,A00,891860,Morris; Sheldon,9995,0,9999,4
1746597395657,CLRE 251R,A00,907817,Mehta; Ravindra L.,9994,0,9999,5
1746597396682,CLRE 252,A00,891864,Cuomo; Raphael Eduardo,9993,0,9999,6
1746597397707,CLRE 253,A00,891867,Vaida; Florin,9994,0,9999,5
1746597397707,CLRE 253,B00,907819,Staff,9999,0,9999,0
1746597398732,CLRE 259,A00,891868,Patel; Hemal,9998,0,9999,1
1746597399762,CLRE 260,A00,891872,Cuomo; Raphael Eduardo,9999,0,9999,0
1746597400788,CLRE 297,001,891888,Cuomo; Raphael Eduardo,9999,0,9999,0
1746597401812,CSE 191,A00,958773,Minnes Kemp; Mor Mia,9995,0,9999,4
1746597402836,CSE 197,001,959846,Minnes Kemp; Mor Mia,9990,0,9999,9
1746597403861,CSS 201S,A01,892054,Mignozzetti; Umberto,25,0,30,5
1746597404887,CSS 202S,A01,892056,Mignozzetti; Umberto,25,0,30,5
1746597405912,DSC 197,001,956898,Eldridge; Justin Matthew,9996,0,9999,3
1746597406940,DSC 297,001,958000,Mazumdar; Arya,9998,0,9999,1
1746597406940,DSC 297,002,959862,Wang; Yusu,9998,0,9999,1
1746597407968,EAP 100,A00,905686,Staff,9778,0,9999,221
1746597408992,ECE 45,A01,892618,Staff,0,0,65,65
1746597411047,ECE 111,A01,892719,Staff,6,0,65,59
1746597412114,ECE 197,001,957920,Mercier; Patrick Philip,9991,0,9999,8
1746597413140,ECON 178,A01,907814,Zhu; Ying,26,0,35,9
1746597414166,EDS 115,A00,895312,Staff,35,0,45,10
1746597415192,EDS 117,A01,895337,Staff,23,0,30,7
1746597416217,EDS 125,A00,895341,Jones; Gabrielle Anastasia,36,0,45,9
1746597417242,EDS 128A,A01,895459,Fargason; Sharon Gayle,44,0,45,1
1746597418272,EDS 128B,A01,895543,Pappas; Elizabeth,44,0,45,1
1746597419300,EDS 139,A00,897203,Pappas; Elizabeth,44,0,45,1
1746597419300,EDS 139,B00,897209,Fargason; Sharon Gayle,41,0,45,4
1746597420325,EDS 201,A00,895545,Staff,22,0,45,23
1746597421354,EDS 203,A01,895581,Halter; Christopher P.,22,0,45,23
1746597422379,EDS 204R,A01,895625,Heinzman; Erica M.,39,0,45,6
1746597422379,EDS 204R,B01,895693,Halter; Christopher P.,10,0,45,35
1746597423409,EDS 206R,A00,895694,Fargason; Sharon Gayle,1,0,30,29
1746597423409,EDS 206R,B00,895695,Choi; Bailey Miyeon,16,0,30,14
1746597424434,EDS 250,A00,895697,Hemans; Patricia Ann Benitez,22,0,45,23
1746597425460,EDS 281,A00,895701,Meyerott; Theresa Ann,1,0,15,14
1746597426484,EDS 284,A00,895736,Meyerott; Theresa Ann,1,0,15,14
1746597427509,EDS 286,A00,897210,Fine; Sarah,0,0,15,15
1746597428536,EDS 289C,A01,895770,Daly; Alan J.,1,0,15,14
1746597429564,EDS 290,A00,897211,Hofstetter; Carolyn,0,0,15,15
1746597430589,LIGM 5A,A00,896162,Fischer-Grunski; Eva K,12,0,20,8
1746597431617,LIGM 5B,A00,896260,Fischer-Grunski; Eva K,17,0,20,3
1746597432643,LIGM 5C,A00,896308,Fischer-Grunski; Eva K,18,0,20,2
1746597433670,LIIT 5AS,A00,896313,Carnelos; Chiara,18,0,20,2
1746597434697,LIIT 5BS,A00,896416,Carnelos; Chiara,20,0,20,0
1746597435722,LIIT 5CS,A00,896564,Carnelos; Chiara,20,0,20,0
1746597436751,LISP 5A,A00,896588,Munoz Sanchez; Alicia,2,0,20,18
1746597437779,LISP 5B,A00,896653,Munoz Sanchez; Alicia,7,0,20,13
1746597438806,LISP 5C,A00,896655,Munoz Sanchez; Alicia,0,1,20,20
1746597439831,MAE 197,001,957918,Kleissl; Jan,9996,0,9999,3
1746597439831,MAE 197,002,959806,Boechler; Nicholas Sebastia,9998,0,9999,1
1746597439831,MAE 197,003,959852,Mullin; Jennifer S,9998,0,9999,1
1746597440856,MATH 2,A01,957937,Staff,33,0,35,2
1746597441883,MATH 197,001,957876,Kedlaya; Kiran S.,9993,0,9999,6
1746597442908,MCWP 40,A00,892729,Duru; Nur,10,0,20,10
1746597442908,MCWP 40,B00,893304,Montejo; Carolina,14,0,20,6
1746597443932,MCWP 40R,A00,893757,Redela; Pamela Morgan,0,5,20,20
1746597444962,MCWP 50,A00,893758,Morshed; Michael James,0,0,20,20
1746597444962,MCWP 50,B00,893761,Bartulis; Jason Michael,17,0,20,3
1746597445991,MCWP 50R,A00,893766,Compas; Sean Matthew,0,1,20,20
1746597445991,MCWP 50R,B00,893769,Carter; Jennifer A,0,1,20,20
1746597445991,MCWP 50R,C00,893771,Krone; Jarret,0,3,20,20
1746597445991,MCWP 50R,D00,893772,Miller; Elizabeth Deen,0,0,20,20
1746597445991,MCWP 50R,E00,893775,Carter; Andrea L,0,1,20,20
1746597447016,MMW 11R,A01,892721,Herbst; Matthew,14,0,30,16
1746597447016,MMW 11R,A02,892722,Herbst; Matthew,0,0,0,3
1746597448040,MMW 12R,A01,892724,Herbst; Matthew,0,11,16,16
1746597448040,MMW 12R,A02,892725,Herbst; Matthew,0,10,16,16
1746597449066,MMW 13R,A01,892727,Staff,0,4,16,16
1746597449066,MMW 13R,A02,892728,Staff,0,4,16,16
1746597449066,MMW 13R,A03,958032,Staff,0,4,16,16
1746597449066,MMW 13R,A04,958033,Staff,0,4,16,16
1746597449066,MMW 13R,A05,958034,Staff,0,4,16,16
1746597450091,SIO 295LS,A00,894015,Staff,5,0,25,20
1746597451116,SIO 295S,A00,894020,Staff,5,0,25,20
1746597452148,SIOC 290S,B01,958918,Merrifield; Mark A,14,0,30,16
1746597453174,SIOC 291S,B01,958922,Gabriel; Corey John,14,0,30,16
1746597454200,SOCI 117,A01,895339,Staff,2,0,5,3
1746597455228,WES 237B,A00,894149,Staff,11,0,20,9
1746597457285,AESE 279B,A00,891859,Staff,13,0,35,22
1746597458309,AIP 197,001,891854,Vespa; Emanuel Ignacio,9999,0,9999,0
1746597459336,ANTH 289S,A00,891856,Gagneux; Pascal,12,0,12,0
1746597460360,BENG 196,001,957946,Engler; Adam J.,9996,0,9999,3
1746597461385,BISP 197,001,959851,Wilhelm; James E.,9998,0,9999,1
1746597462422,CAT 124RS,A01,956906,Staff,6,0,25,19
1746597463447,CAT 125RS,A01,922013,Staff,6,0,25,19
1746597464473,CLRE 250,A00,891860,Morris; Sheldon,9995,0,9999,4
1746597466524,CLRE 251R,A00,907817,Mehta; Ravindra L.,9994,0,9999,5
1746597467549,CLRE 252,A00,891864,Cuomo; Raphael Eduardo,9993,0,9999,6
1746597468577,CLRE 253,A00,891867,Vaida; Florin,9994,0,9999,5
1746597468577,CLRE 253,B00,907819,Staff,9999,0,9999,0
1746597469606,CLRE 259,A00,891868,Patel; Hemal,9998,0,9999,1
1746597470630,CLRE 260,A00,891872,Cuomo; Raphael Eduardo,9999,0,9999,0
1746597471658,CLRE 297,001,891888,Cuomo; Raphael Eduardo,9999,0,9999,0
1746597472685,CSE 191,A00,958773,Minnes Kemp; Mor Mia,9995,0,9999,4
1746597473711,CSE 197,001,959846,Minnes Kemp; Mor Mia,9990,0,9999,9
1746597474737,CSS 201S,A01,892054,Mignozzetti; Umberto,25,0,30,5
1746597475763,CSS 202S,A01,892056,Mignozzetti; Umberto,25,0,30,5
1746597476790,DSC 197,001,956898,Eldridge; Justin Matthew,9996,0,9999,3
1746597477814,DSC 297,001,958000,Mazumdar; Arya,9998,0,9999,1
1746597477814,DSC 297,002,959862,Wang; Yusu,9998,0,9999,1
1746597478838,EAP 100,A00,905686,Staff,9778,0,9999,221
1746597479864,ECE 45,A01,892618,Staff,0,0,65,65
1746597481921,ECE 111,A01,892719,Staff,6,0,65,59
1746597482945,ECE 197,001,957920,Mercier; Patrick Philip,9991,0,9999,8
1746597483974,ECON 178,A01,907814,Zhu; Ying,26,0,35,9
1746597485003,EDS 115,A00,895312,Staff,35,0,45,10
1746597486029,EDS 117,A01,895337,Staff,23,0,30,7
1746597487054,EDS 125,A00,895341,Jones; Gabrielle Anastasia,36,0,45,9
1746597488084,EDS 128A,A01,895459,Fargason; Sharon Gayle,44,0,45,1
1746597489110,EDS 128B,A01,895543,Pappas; Elizabeth,44,0,45,1
1746597490134,EDS 139,A00,897203,Pappas; Elizabeth,44,0,45,1
1746597490134,EDS 139,B00,897209,Fargason; Sharon Gayle,41,0,45,4
1746597491160,EDS 201,A00,895545,Staff,22,0,45,23
1746597492188,EDS 203,A01,895581,Halter; Christopher P.,22,0,45,23
1746597493213,EDS 204R,A01,895625,Heinzman; Erica M.,39,0,45,6
1746597493213,EDS 204R,B01,895693,Halter; Christopher P.,10,0,45,35
1746597494238,EDS 206R,A00,895694,Fargason; Sharon Gayle,1,0,30,29
1746597494238,EDS 206R,B00,895695,Choi; Bailey Miyeon,16,0,30,14
1746597495264,EDS 250,A00,895697,Hemans; Patricia Ann Benitez,22,0,45,23
1746597496290,EDS 281,A00,895701,Meyerott; Theresa Ann,1,0,15,14
1746597497315,EDS 284,A00,895736,Meyerott; Theresa Ann,1,0,15,14
1746597498342,EDS 286,A00,897210,Fine; Sarah,0,0,15,15
1746597499366,EDS 289C,A01,895770,Daly; Alan J.,1,0,15,14
1746597500391,EDS 290,A00,897211,Hofstetter; Carolyn,0,0,15,15
1746597501420,LIGM 5A,A00,896162,Fischer-Grunski; Eva K,12,0,20,8
1746597502484,LIGM 5B,A00,896260,Fischer-Grunski; Eva K,17,0,20,3
1746597503513,LIGM 5C,A00,896308,Fischer-Grunski; Eva K,18,0,20,2
1746597504542,LIIT 5AS,A00,896313,Carnelos; Chiara,18,0,20,2
1746597505567,LIIT 5BS,A00,896416,Carnelos; Chiara,20,0,20,0
1746597506593,LIIT 5CS,A00,896564,Carnelos; Chiara,20,0,20,0
1746597507618,LISP 5A,A00,896588,Munoz Sanchez; Alicia,2,0,20,18
1746597508647,LISP 5B,A00,896653,Munoz Sanchez; Alicia,7,0,20,13
1746597509672,LISP 5C,A00,896655,Munoz Sanchez; Alicia,0,1,20,20
1746597510698,MAE 197,001,957918,Kleissl; Jan,9996,0,9999,3
1746597510698,MAE 197,002,959806,Boechler; Nicholas Sebastia,9998,0,9999,1
1746597510698,MAE 197,003,959852,Mullin; Jennifer S,9998,0,9999,1
1746597511722,MATH 2,A01,957937,Staff,33,0,35,2
1746597512748,MATH 197,001,957876,Kedlaya; Kiran S.,9993,0,9999,6
1746597513776,MCWP 40,A00,892729,Duru; Nur,10,0,20,10
1746597513776,MCWP 40,B00,893304,Montejo; Carolina,14,0,20,6
1746597514801,MCWP 40R,A00,893757,Redela; Pamela Morgan,0,5,20,20
1746597515827,MCWP 50,A00,893758,Morshed; Michael James,0,0,20,20
1746597515827,MCWP 50,B00,893761,Bartulis; Jason Michael,17,0,20,3
1746597516852,MCWP 50R,A00,893766,Compas; Sean Matthew,0,1,20,20
1746597516852,MCWP 50R,B00,893769,Carter; Jennifer A,0,1,20,20
1746597516852,MCWP 50R,C00,893771,Krone; Jarret,0,3,20,20
1746597516852,MCWP 50R,D00,893772,Miller; Elizabeth Deen,0,0,20,20
1746597516852,MCWP 50R,E00,893775,Carter; Andrea L,0,1,20,20
1746597517881,MMW 11R,A01,892721,Herbst; Matthew,14,0,30,16
1746597517881,MMW 11R,A02,892722,Herbst; Matthew,0,0,0,3
1746597518905,MMW 12R,A01,892724,Herbst; Matthew,0,11,16,16
1746597518905,MMW 12R,A02,892725,Herbst; Matthew,0,10,16,16
1746597519932,MMW 13R,A01,892727,Staff,0,4,16,16
1746597519932,MMW 13R,A02,892728,Staff,0,4,16,16
1746597519932,MMW 13R,A03,958032,Staff,0,4,16,16
1746597519932,MMW 13R,A04,958033,Staff,0,4,16,16
1746597519932,MMW 13R,A05,958034,Staff,0,4,16,16
1746597520957,SIO 295LS,A00,894015,Staff,5,0,25,20
1746597521982,SIO 295S,A00,894020,Staff,5,0,25,20
1746597523013,SIOC 290S,B01,958918,Merrifield; Mark A,14,0,30,16
1746597524081,SIOC 291S,B01,958922,Gabriel; Corey John,14,0,30,16
1746597525105,SOCI 117,A01,895339,Staff,2,0,5,3
1746597526130,WES 237B,A00,894149,Staff,11,0,20,9
1746597528201,AESE 279B,A00,891859,Staff,13,0,35,22
1746597529226,AIP 197,001,891854,Vespa; Emanuel Ignacio,9999,0,9999,0
1746597530251,ANTH 289S,A00,891856,Gagneux; Pascal,12,0,12,0
1746597531279,BENG 196,001,957946,Engler; Adam J.,9996,0,9999,3
1746597532306,BISP 197,001,959851,Wilhelm; James E.,9998,0,9999,1
1746597533333,CAT 124RS,A01,956906,Staff,6,0,25,19
1746597534358,CAT 125RS,A01,922013,Staff,6,0,25,19
1746597535385,CLRE 250,A00,891860,Morris; Sheldon,9995,0,9999,4
1746597537441,CLRE 251R,A00,907817,Mehta; Ravindra L.,9994,0,9999,5
1746597538467,CLRE 252,A00,891864,Cuomo; Raphael Eduardo,9993,0,9999,6
1746597539495,CLRE 253,A00,891867,Vaida; Florin,9994,0,9999,5
1746597539495,CLRE 253,B00,907819,Staff,9999,0,9999,0
1746597540527,CLRE 259,A00,891868,Patel; Hemal,9998,0,9999,1
1746597541555,CLRE 260,A00,891872,Cuomo; Raphael Eduardo,9999,0,9999,0
1746597542580,CLRE 297,001,891888,Cuomo; Raphael Eduardo,9999,0,9999,0
1746597543605,CSE 191,A00,958773,Minnes Kemp; Mor Mia,9995,0,9999,4
1746597544630,CSE 197,001,959846,Minnes Kemp; Mor Mia,9990,0,9999,9
1746597545657,CSS 201S,A01,892054,Mignozzetti; Umberto,25,0,30,5
1746597546682,CSS 202S,A01,892056,Mignozzetti; Umberto,25,0,30,5
1746597547707,DSC 197,001,956898,Eldridge; Justin Matthew,9996,0,9999,3
1746597548736,DSC 297,001,958000,Mazumdar; Arya,9998,0,9999,1
1746597548736,DSC 297,002,959862,Wang; Yusu,9998,0,9999,1
1746597549760,EAP 100,A00,905686,Staff,9778,0,9999,221
1746597550790,ECE 45,A01,892618,Staff,0,0,65,65
1746597552843,ECE 111,A01,892719,Staff,6,0,65,59
1746597553868,ECE 197,001,957920,Mercier; Patrick Philip,9991,0,9999,8
1746597554898,ECON 178,A01,907814,Zhu; Ying,26,0,35,9
1746597555927,EDS 115,A00,895312,Staff,35,0,45,10
1746597556952,EDS 117,A01,895337,Staff,23,0,30,7
1746597557980,EDS 125,A00,895341,Jones; Gabrielle Anastasia,36,0,45,9
1746597559008,EDS 128A,A01,895459,Fargason; Sharon Gayle,44,0,45,1
1746597560032,EDS 128B,A01,895543,Pappas; Elizabeth,44,0,45,1
1746597561057,EDS 139,A00,897203,Pappas; Elizabeth,44,0,45,1
1746597561057,EDS 139,B00,897209,Fargason; Sharon Gayle,41,0,45,4
1746597562084,EDS 201,A00,895545,Staff,22,0,45,23
1746597563108,EDS 203,A01,895581,Halter; Christopher P.,22,0,45,23
1746597564135,EDS 204R,A01,895625,Heinzman; Erica M.,39,0,45,6
1746597564135,EDS 204R,B01,895693,Halter; Christopher P.,10,0,45,35
1746597565165,EDS 206R,A00,895694,Fargason; Sharon Gayle,1,0,30,29
1746597565165,EDS 206R,B00,895695,Choi; Bailey Miyeon,16,0,30,14
1746597566190,EDS 250,A00,895697,Hemans; Patricia Ann Benitez,22,0,45,23
1746597567216,EDS 281,A00,895701,Meyerott; Theresa Ann,1,0,15,14
1746597568244,EDS 284,A00,895736,Meyerott; Theresa Ann,1,0,15,14
1746597569268,EDS 286,A00,897210,Fine; Sarah,0,0,15,15
1746597570295,EDS 289C,A01,895770,Daly; Alan J.,1,0,15,14
1746597571319,EDS 290,A00,897211,Hofstetter; Carolyn,0,0,15,15
1746597572347,LIGM 5A,A00,896162,Fischer-Grunski; Eva K,12,0,20,8
1746597573376,LIGM 5B,A00,896260,Fischer-Grunski; Eva K,17,0,20,3
1746597574399,LIGM 5C,A00,896308,Fischer-Grunski; Eva K,18,0,20,2
1746597575426,LIIT 5AS,A00,896313,Carnelos; Chiara,18,0,20,2
1746597576454,LIIT 5BS,A00,896416,Carnelos; Chiara,20,0,20,0
1746597577480,LIIT 5CS,A00,896564,Carnelos; Chiara,20,0,20,0
1746597578508,LISP 5A,A00,896588,Munoz Sanchez; Alicia,2,0,20,18
1746597579535,LISP 5B,A00,896653,Munoz Sanchez; Alicia,7,0,20,13
1746597580560,LISP 5C,A00,896655,Munoz Sanchez; Alicia,0,1,20,20
1746597581586,MAE 197,001,957918,Kleissl; Jan,9996,0,9999,3
1746597581586,MAE 197,002,959806,Boechler; Nicholas Sebastia,9998,0,9999,1
1746597581586,MAE 197,003,959852,Mullin; Jennifer S,9998,0,9999,1
1746597582613,MATH 2,A01,957937,Staff,33,0,35,2
1746597583642,MATH 197,001,957876,Kedlaya; Kiran S.,9993,0,9999,6
1746597584667,MCWP 40,A00,892729,Duru; Nur,10,0,20,10
1746597584667,MCWP 40,B00,893304,Montejo; Carolina,14,0,20,6
1746597585692,MCWP 40R,A00,893757,Redela; Pamela Morgan,0,5,20,20
1746597586723,MCWP 50,A00,893758,Morshed; Michael James,0,0,20,20
1746597586723,MCWP 50,B00,893761,Bartulis; Jason Michael,17,0,20,3
1746597587750,MCWP 50R,A00,893766,Compas; Sean Matthew,0,1,20,20
1746597587750,MCWP 50R,B00,893769,Carter; Jennifer A,0,1,20,20
1746597587750,MCWP 50R,C00,893771,Krone; Jarret,0,3,20,20
1746597587750,MCWP 50R,D00,893772,Miller; Elizabeth Deen,0,0,20,20
1746597587750,MCWP 50R,E00,893775,Carter; Andrea L,0,1,20,20
1746597588774,MMW 11R,A01,892721,Herbst; Matthew,14,0,30,16
1746597588774,MMW 11R,A02,892722,Herbst; Matthew,0,0,0,3
1746597589803,MMW 12R,A01,892724,Herbst; Matthew,0,11,16,16
1746597589803,MMW 12R,A02,892725,Herbst; Matthew,0,10,16,16
1746597590834,MMW 13R,A01,892727,Staff,0,4,16,16
1746597590834,MMW 13R,A02,892728,Staff,0,4,16,16
1746597590834,MMW 13R,A03,958032,Staff,0,4,16,16
1746597590834,MMW 13R,A04,958033,Staff,0,4,16,16
1746597590834,MMW 13R,A05,958034,Staff,0,4,16,16
1746597591859,SIO 295LS,A00,894015,Staff,5,0,25,20
1746597592885,SIO 295S,A00,894020,Staff,5,0,25,20
1746597593915,SIOC 290S,B01,958918,Merrifield; Mark A,14,0,30,16
1746597594944,SIOC 291S,B01,958922,Gabriel; Corey John,14,0,30,16
1746597595970,SOCI 117,A01,895339,Staff,2,0,5,3
1746597596999,WES 237B,A00,894149,Staff,11,0,20,9
1746597599066,AESE 279B,A00,891859,Staff,13,0,35,22
1746597600090,AIP 197,001,891854,Vespa; Emanuel Ignacio,9999,0,9999,0
1746597601132,ANTH 289S,A00,891856,Gagneux; Pascal,12,0,12,0
1746597602165,BENG 196,001,957946,Engler; Adam J.,9996,0,9999,3
1746597603192,BISP 197,001,959851,Wilhelm; James E.,9998,0,9999,1
1746597604218,CAT 124RS,A01,956906,Staff,6,0,25,19
1746597605245,CAT 125RS,A01,922013,Staff,6,0,25,19
1746597606273,CLRE 250,A00,891860,Morris; Sheldon,9995,0,9999,4
1746597608323,CLRE 251R,A00,907817,Mehta; Ravindra L.,9994,0,9999,5
1746597609347,CLRE 252,A00,891864,Cuomo; Raphael Eduardo,9993,0,9999,6
1746597610380,CLRE 253,A00,891867,Vaida; Florin,9994,0,9999,5
1746597610380,CLRE 253,B00,907819,Staff,9999,0,9999,0
1746597611408,CLRE 259,A00,891868,Patel; Hemal,9998,0,9999,1
1746597612437,CLRE 260,A00,891872,Cuomo; Raphael Eduardo,9999,0,9999,0
1746597613463,CLRE 297,001,891888,Cuomo; Raphael Eduardo,9999,0,9999,0
1746597614489,CSE 191,A00,958773,Minnes Kemp; Mor Mia,9995,0,9999,4
1746597615515,CSE 197,001,959846,Minnes Kemp; Mor Mia,9990,0,9999,9
1746597616543,CSS 201S,A01,892054,Mignozzetti; Umberto,25,0,30,5
1746597617572,CSS 202S,A01,892056,Mignozzetti; Umberto,25,0,30,5
1746597618599,DSC 197,001,956898,Eldridge; Justin Matthew,9996,0,9999,3
1746597619627,DSC 297,001,958000,Mazumdar; Arya,9998,0,9999,1
1746597619627,DSC 297,002,959862,Wang; Yusu,9998,0,9999,1
1746597620657,EAP 100,A00,905686,Staff,9778,0,9999,221
1746597621684,ECE 45,A01,892618,Staff,0,0,65,65
1746597623745,ECE 111,A01,892719,Staff,6,0,65,59
1746597624793,ECE 197,001,957920,Mercier; Patrick Philip,9991,0,9999,8
1746597625819,ECON 178,A01,907814,Zhu; Ying,26,0,35,9
1746597626846,EDS 115,A00,895312,Staff,35,0,45,10
1746597627872,EDS 117,A01,895337,Staff,23,0,30,7
1746597628905,EDS 125,A00,895341,Jones; Gabrielle Anastasia,36,0,45,9
1746597629934,EDS 128A,A01,895459,Fargason; Sharon Gayle,44,0,45,1
1746597630968,EDS 128B,A01,895543,Pappas; Elizabeth,44,0,45,1
1746597631996,EDS 139,A00,897203,Pappas; Elizabeth,44,0,45,1
1746597631996,EDS 139,B00,897209,Fargason; Sharon Gayle,41,0,45,4
1746597633026,EDS 201,A00,895545,Staff,22,0,45,23
1746597634053,EDS 203,A01,895581,Halter; Christopher P.,22,0,45,23
1746597635094,EDS 204R,A01,895625,Heinzman; Erica M.,39,0,45,6
1746597635094,EDS 204R,B01,895693,Halter; Christopher P.,10,0,45,35
1746597636128,EDS 206R,A00,895694,Fargason; Sharon Gayle,1,0,30,29
1746597636128,EDS 206R,B00,895695,Choi; Bailey Miyeon,16,0,30,14
1746597637166,EDS 250,A00,895697,Hemans; Patricia Ann Benitez,22,0,45,23
1746597638207,EDS 281,A00,895701,Meyerott; Theresa Ann,1,0,15,14
1746597639242,EDS 284,A00,895736,Meyerott; Theresa Ann,1,0,15,14
1746597640274,EDS 286,A00,897210,Fine; Sarah,0,0,15,15
1746597641305,EDS 289C,A01,895770,Daly; Alan J.,1,0,15,14
1746597642332,EDS 290,A00,897211,Hofstetter; Carolyn,0,0,15,15
1746597643359,LIGM 5A,A00,896162,Fischer-Grunski; Eva K,12,0,20,8
1746597644388,LIGM 5B,A00,896260,Fischer-Grunski; Eva K,17,0,20,3
1746597645417,LIGM 5C,A00,896308,Fischer-Grunski; Eva K,18,0,20,2
1746597646445,LIIT 5AS,A00,896313,Carnelos; Chiara,18,0,20,2
1746597647471,LIIT 5BS,A00,896416,Carnelos; Chiara,20,0,20,0
1746597648497,LIIT 5CS,A00,896564,Carnelos; Chiara,20,0,20,0
1746597649524,LISP 5A,A00,896588,Munoz Sanchez; Alicia,2,0,20,18
1746597650550,LISP 5B,A00,896653,Munoz Sanchez; Alicia,7,0,20,13
1746597651576,LISP 5C,A00,896655,Munoz Sanchez; Alicia,0,1,20,20
1746597652606,MAE 197,001,957918,Kleissl; Jan,9996,0,9999,3
1746597652606,MAE 197,002,959806,Boechler; Nicholas Sebastia,9998,0,9999,1
1746597652606,MAE 197,003,959852,Mullin; Jennifer S,9998,0,9999,1
1746597653630,MATH 2,A01,957937,Staff,33,0,35,2
1746597654660,MATH 197,001,957876,Kedlaya; Kiran S.,9993,0,9999,6
1746597655692,MCWP 40,A00,892729,Duru; Nur,10,0,20,10
1746597655692,MCWP 40,B00,893304,Montejo; Carolina,14,0,20,6
1746597656723,MCWP 40R,A00,893757,Redela; Pamela Morgan,0,5,20,20
1746597657751,MCWP 50,A00,893758,Morshed; Michael James,0,0,20,20
1746597657751,MCWP 50,B00,893761,Bartulis; Jason Michael,17,0,20,3
1746597658779,MCWP 50R,A00,893766,Compas; Sean Matthew,0,1,20,20
1746597658779,MCWP 50R,B00,893769,Carter; Jennifer A,0,1,20,20
1746597658779,MCWP 50R,C00,893771,Krone; Jarret,0,3,20,20
1746597658779,MCWP 50R,D00,893772,Miller; Elizabeth Deen,0,0,20,20
1746597658779,MCWP 50R,E00,893775,Carter; Andrea L,0,1,20,20
1746597659810,MMW 11R,A01,892721,Herbst; Matthew,14,0,30,16
1746597659810,MMW 11R,A02,892722,Herbst; Matthew,0,0,0,3
1746597660835,MMW 12R,A01,892724,Herbst; Matthew,0,11,16,16
1746597660835,MMW 12R,A02,892725,Herbst; Matthew,0,10,16,16
1746597661860,MMW 13R,A01,892727,Staff,0,4,16,16
1746597661860,MMW 13R,A02,892728,Staff,0,4,16,16
1746597661860,MMW 13R,A03,958032,Staff,0,4,16,16
1746597661860,MMW 13R,A04,958033,Staff,0,4,16,16
1746597661860,MMW 13R,A05,958034,Staff,0,4,16,16
1746597662888,SIO 295LS,A00,894015,Staff,5,0,25,20
1746597663914,SIO 295S,A00,894020,Staff,5,0,25,20
1746597664941,SIOC 290S,B01,958918,Merrifield; Mark A,14,0,30,16
1746597665975,SIOC 291S,B01,958922,Gabriel; Corey John,14,0,30,16
1746597667000,SOCI 117,A01,895339,Staff,2,0,5,3
1746597668027,WES 237B,A00,894149,Staff,11,0,20,9
1746597670134,AESE 279B,A00,891859,Staff,13,0,35,22
1746597671159,AIP 197,001,891854,Vespa; Emanuel Ignacio,9999,0,9999,0
1746597672192,ANTH 289S,A00,891856,Gagneux; Pascal,12,0,12,0
1746597673216,BENG 196,001,957946,Engler; Adam J.,9996,0,9999,3
1746597674242,BISP 197,001,959851,Wilhelm; James E.,9998,0,9999,1
1746597675268,CAT 124RS,A01,956906,Staff,6,0,25,19
1746597676294,CAT 125RS,A01,922013,Staff,6,0,25,19
1746597677322,CLRE 250,A00,891860,Morris; Sheldon,9995,0,9999,4
1746597679377,CLRE 251R,A00,907817,Mehta; Ravindra L.,9994,0,9999,5
1746597680403,CLRE 252,A00,891864,Cuomo; Raphael Eduardo,9993,0,9999,6
1746597681428,CLRE 253,A00,891867,Vaida; Florin,9994,0,9999,5
1746597681428,CLRE 253,B00,907819,Staff,9999,0,9999,0
1746597682454,CLRE 259,A00,891868,Patel; Hemal,9998,0,9999,1
1746597683482,CLRE 260,A00,891872,Cuomo; Raphael Eduardo,9999,0,9999,0
1746597684509,CLRE 297,001,891888,Cuomo; Raphael Eduardo,9999,0,9999,0
1746597685535,CSE 191,A00,958773,Minnes Kemp; Mor Mia,9995,0,9999,4
1746597686559,CSE 197,001,959846,Minnes Kemp; Mor Mia,9990,0,9999,9
1746597687588,CSS 201S,A01,892054,Mignozzetti; Umberto,25,0,30,5
1746597688615,CSS 202S,A01,892056,Mignozzetti; Umberto,25,0,30,5
1746597689640,DSC 197,001,956898,Eldridge; Justin Matthew,9996,0,9999,3
1746597690667,DSC 297,001,958000,Mazumdar; Arya,9998,0,9999,1
1746597690667,DSC 297,002,959862,Wang; Yusu,9998,0,9999,1
1746597691694,EAP 100,A00,905686,Staff,9778,0,9999,221
1746597692726,ECE 45,A01,892618,Staff,0,0,65,65
1746597694782,ECE 111,A01,892719,Staff,6,0,65,59
1746597695808,ECE 197,001,957920,Mercier; Patrick Philip,9991,0,9999,8
1746597696839,ECON 178,A01,907814,Zhu; Ying,26,0,35,9
1746597697865,EDS 115,A00,895312,Staff,35,0,45,10
1746597698894,EDS 117,A01,895337,Staff,23,0,30,7
1746597699919,EDS 125,A00,895341,Jones; Gabrielle Anastasia,36,0,45,9
1746597700949,EDS 128A,A01,895459,Fargason; Sharon Gayle,44,0,45,1
1746597701975,EDS 128B,A01,895543,Pappas; Elizabeth,44,0,45,1
1746597703004,EDS 139,A00,897203,Pappas; Elizabeth,44,0,45,1
1746597703004,EDS 139,B00,897209,Fargason; Sharon Gayle,41,0,45,4
1746597704035,EDS 201,A00,895545,Staff,22,0,45,23
1746597705063,EDS 203,A01,895581,Halter; Christopher P.,22,0,45,23
1746597706088,EDS 204R,A01,895625,Heinzman; Erica M.,39,0,45,6
1746597706088,EDS 204R,B01,895693,Halter; Christopher P.,10,0,45,35
1746597707115,EDS 206R,A00,895694,Fargason; Sharon Gayle,1,0,30,29
1746597707115,EDS 206R,B00,895695,Choi; Bailey Miyeon,16,0,30,14
1746597708139,EDS 250,A00,895697,Hemans; Patricia Ann Benitez,22,0,45,23
1746597709163,EDS 281,A00,895701,Meyerott; Theresa Ann,1,0,15,14
1746597710187,EDS 284,A00,895736,Meyerott; Theresa Ann,1,0,15,14
1746597711214,EDS 286,A00,897210,Fine; Sarah,0,0,15,15
1746597712242,EDS 289C,A01,895770,Daly; Alan J.,1,0,15,14
1746597713267,EDS 290,A00,897211,Hofstetter; Carolyn,0,0,15,15
1746597714297,LIGM 5A,A00,896162,Fischer-Grunski; Eva K,12,0,20,8
1746597715327,LIGM 5B,A00,896260,Fischer-Grunski; Eva K,17,0,20,3
1746597716353,LIGM 5C,A00,896308,Fischer-Grunski; Eva K,18,0,20,2
1746597717403,LIIT 5AS,A00,896313,Carnelos; Chiara,18,0,20,2
1746597718430,LIIT 5BS,A00,896416,Carnelos; Chiara,20,0,20,0
1746597719458,LIIT 5CS,A00,896564,Carnelos; Chiara,20,0,20,0
1746597720483,LISP 5A,A00,896588,Munoz Sanchez; Alicia,2,0,20,18
1746597721514,LISP 5B,A00,896653,Munoz Sanchez; Alicia,7,0,20,13
1746597722540,LISP 5C,A00,896655,Munoz Sanchez; Alicia,0,1,20,20
1746597723567,MAE 197,001,957918,Kleissl; Jan,9996,0,9999,3
1746597723567,MAE 197,002,959806,Boechler; Nicholas Sebastia,9998,0,9999,1
1746597723567,MAE 197,003,959852,Mullin; Jennifer S,9998,0,9999,1
1746597724596,MATH 2,A01,957937,Staff,33,0,35,2
1746597725622,MATH 197,001,957876,Kedlaya; Kiran S.,9993,0,9999,6
1746597726649,MCWP 40,A00,892729,Duru; Nur,10,0,20,10
1746597726649,MCWP 40,B00,893304,Montejo; Carolina,14,0,20,6
1746597727679,MCWP 40R,A00,893757,Redela; Pamela Morgan,0,5,20,20
1746597728708,MCWP 50,A00,893758,Morshed; Michael James,0,0,20,20
1746597728708,MCWP 50,B00,893761,Bartulis; Jason Michael,17,0,20,3
1746597729741,MCWP 50R,A00,893766,Compas; Sean Matthew,0,1,20,20
1746597729741,MCWP 50R,B00,893769,Carter; Jennifer A,0,1,20,20
1746597729741,MCWP 50R,C00,893771,Krone; Jarret,0,3,20,20
1746597729741,MCWP 50R,D00,893772,Miller; Elizabeth Deen,0,0,20,20
1746597729741,MCWP 50R,E00,893775,Carter; Andrea L,0,1,20,20
1746597730770,MMW 11R,A01,892721,Herbst; Matthew,14,0,30,16
1746597730770,MMW 11R,A02,892722,Herbst; Matthew,0,0,0,3
1746597731796,MMW 12R,A01,892724,Herbst; Matthew,0,11,16,16
1746597731796,MMW 12R,A02,892725,Herbst; Matthew,0,10,16,16
1746597732822,MMW 13R,A01,892727,Staff,0,4,16,16
1746597732822,MMW 13R,A02,892728,Staff,0,4,16,16
1746597732822,MMW 13R,A03,958032,Staff,0,4,16,16
1746597732822,MMW 13R,A04,958033,Staff,0,4,16,16
1746597732822,MMW 13R,A05,958034,Staff,0,4,16,16
1746597733851,SIO 295LS,A00,894015,Staff,5,0,25,20
1746597734888,SIO 295S,A00,894020,Staff,5,0,25,20
1746597735923,SIOC 290S,B01,958918,Merrifield; Mark A,14,0,30,16
1746597736953,SIOC 291S,B01,958922,Gabriel; Corey John,14,0,30,16
1746597737978,SOCI 117,A01,895339,Staff,2,0,5,3
1746597739058,WES 237B,A00,894149,Staff,11,0,20,9
1746597741123,AESE 279B,A00,891859,Staff,13,0,35,22
1746597742148,AIP 197,001,891854,Vespa; Emanuel Ignacio,9999,0,9999,0
1746597743177,ANTH 289S,A00,891856,Gagneux; Pascal,12,0,12,0
1746597744211,BENG 196,001,957946,Engler; Adam J.,9996,0,9999,3
1746597745240,BISP 197,001,959851,Wilhelm; James E.,9998,0,9999,1
1746597746269,CAT 124RS,A01,956906,Staff,6,0,25,19
1746597747295,CAT 125RS,A01,922013,Staff,6,0,25,19
1746597748322,CLRE 250,A00,891860,Morris; Sheldon,9995,0,9999,4
1746597750376,CLRE 251R,A00,907817,Mehta; Ravindra L.,9994,0,9999,5
1746597751400,CLRE 252,A00,891864,Cuomo; Raphael Eduardo,9993,0,9999,6
1746597752429,CLRE 253,A00,891867,Vaida; Florin,9994,0,9999,5
1746597752429,CLRE 253,B00,907819,Staff,9999,0,9999,0
1746597753458,CLRE 259,A00,891868,Patel; Hemal,9998,0,9999,1
1746597754486,CLRE 260,A00,891872,Cuomo; Raphael Eduardo,9999,0,9999,0
1746597755515,CLRE 297,001,891888,Cuomo; Raphael Eduardo,9999,0,9999,0
1746597756542,CSE 191,A00,958773,Minnes Kemp; Mor Mia,9995,0,9999,4
1746597757588,CSE 197,001,959846,Minnes Kemp; Mor Mia,9990,0,9999,9
1746597758615,CSS 201S,A01,892054,Mignozzetti; Umberto,25,0,30,5
1746597759641,CSS 202S,A01,892056,Mignozzetti; Umberto,25,0,30,5
1746597760666,DSC 197,001,956898,Eldridge; Justin Matthew,9996,0,9999,3
1746597761689,DSC 297,001,958000,Mazumdar; Arya,9998,0,9999,1
1746597761689,DSC 297,002,959862,Wang; Yusu,9998,0,9999,1
1746597762714,EAP 100,A00,905686,Staff,9778,0,9999,221
1746597763741,ECE 45,A01,892618,Staff,0,0,65,65
1746597765794,ECE 111,A01,892719,Staff,6,0,65,59
1746597766822,ECE 197,001,957920,Mercier; Patrick Philip,9991,0,9999,8
1746597767848,ECON 178,A01,907814,Zhu; Ying,26,0,35,9
1746597768876,EDS 115,A00,895312,Staff,35,0,45,10
1746597769902,EDS 117,A01,895337,Staff,23,0,30,7
1746597770928,EDS 125,A00,895341,Jones; Gabrielle Anastasia,36,0,45,9
1746597771955,EDS 128A,A01,895459,Fargason; Sharon Gayle,44,0,45,1
1746597772981,EDS 128B,A01,895543,Pappas; Elizabeth,44,0,45,1
1746597774009,EDS 139,A00,897203,Pappas; Elizabeth,44,0,45,1
1746597774009,EDS 139,B00,897209,Fargason; Sharon Gayle,41,0,45,4
1746597775037,EDS 201,A00,895545,Staff,22,0,45,23
1746597776063,EDS 203,A01,895581,Halter; Christopher P.,22,0,45,23
1746597777091,EDS 204R,A01,895625,Heinzman; Erica M.,39,0,45,6
1746597777091,EDS 204R,B01,895693,Halter; Christopher P.,10,0,45,35
1746597778116,EDS 206R,A00,895694,Fargason; Sharon Gayle,1,0,30,29
1746597778116,EDS 206R,B00,895695,Choi; Bailey Miyeon,16,0,30,14
1746597779147,EDS 250,A00,895697,Hemans; Patricia Ann Benitez,22,0,45,23
1746597780174,EDS 281,A00,895701,Meyerott; Theresa Ann,1,0,15,14
1746597781200,EDS 284,A00,895736,Meyerott; Theresa Ann,1,0,15,14
1746597782232,EDS 286,A00,897210,Fine; Sarah,0,0,15,15
1746597783258,EDS 289C,A01,895770,Daly; Alan J.,1,0,15,14
1746597784291,EDS 290,A00,897211,Hofstetter; Carolyn,0,0,15,15
1746597785318,LIGM 5A,A00,896162,Fischer-Grunski; Eva K,12,0,20,8
1746597786348,LIGM 5B,A00,896260,Fischer-Grunski; Eva K,17,0,20,3
1746597787374,LIGM 5C,A00,896308,Fischer-Grunski; Eva K,18,0,20,2
1746597788403,LIIT 5AS,A00,896313,Carnelos; Chiara,18,0,20,2
1746597789428,LIIT 5BS,A00,896416,Carnelos; Chiara,20,0,20,0
1746597790460,LIIT 5CS,A00,896564,Carnelos; Chiara,20,0,20,0
1746597791485,LISP 5A,A00,896588,Munoz Sanchez; Alicia,2,0,20,18
1746597792511,LISP 5B,A00,896653,Munoz Sanchez; Alicia,7,0,20,13
1746597793536,LISP 5C,A00,896655,Munoz Sanchez; Alicia,0,1,20,20
1746597794560,MAE 197,001,957918,Kleissl; Jan,9996,0,9999,3
1746597794560,MAE 197,002,959806,Boechler; Nicholas Sebastia,9998,0,9999,1
1746597794560,MAE 197,003,959852,Mullin; Jennifer S,9998,0,9999,1
1746597795584,MATH 2,A01,957937,Staff,33,0,35,2
1746597796609,MATH 197,001,957876,Kedlaya; Kiran S.,9993,0,9999,6
1746597797635,MCWP 40,A00,892729,Duru; Nur,10,0,20,10
1746597797635,MCWP 40,B00,893304,Montejo; Carolina,14,0,20,6
1746597798661,MCWP 40R,A00,893757,Redela; Pamela Morgan,0,5,20,20
1746597799690,MCWP 50,A00,893758,Morshed; Michael James,0,0,20,20
1746597799690,MCWP 50,B00,893761,Bartulis; Jason Michael,17,0,20,3
1746597800718,MCWP 50R,A00,893766,Compas; Sean Matthew,0,1,20,20
1746597800718,MCWP 50R,B00,893769,Carter; Jennifer A,0,1,20,20
1746597800718,MCWP 50R,C00,893771,Krone; Jarret,0,3,20,20
1746597800718,MCWP 50R,D00,893772,Miller; Elizabeth Deen,0,0,20,20
1746597800718,MCWP 50R,E00,893775,Carter; Andrea L,0,1,20,20
1746597801743,MMW 11R,A01,892721,Herbst; Matthew,14,0,30,16
1746597801743,MMW 11R,A02,892722,Herbst; Matthew,0,0,0,3
1746597802772,MMW 12R,A01,892724,Herbst; Matthew,0,11,16,16
1746597802772,MMW 12R,A02,892725,Herbst; Matthew,0,10,16,16
1746597803796,MMW 13R,A01,892727,Staff,0,4,16,16
1746597803796,MMW 13R,A02,892728,Staff,0,4,16,16
1746597803796,MMW 13R,A03,958032,Staff,0,4,16,16
1746597803796,MMW 13R,A04,958033,Staff,0,4,16,16
1746597803796,MMW 13R,A05,958034,Staff,0,4,16,16
1746597804822,SIO 295LS,A00,894015,Staff,5,0,25,20
1746597805848,SIO 295S,A00,894020,Staff,5,0,25,20
1746597806876,SIOC 290S,B01,958918,Merrifield; Mark A,14,0,30,16
1746597807907,SIOC 291S,B01,958922,Gabriel; Corey John,14,0,30,16
1746597808934,SOCI 117,A01,895339,Staff,2,0,5,3
1746597809958,WES 237B,A00,894149,Staff,11,0,20,9
1746597812015,AESE 279B,A00,891859,Staff,13,0,35,22
1746597813041,AIP 197,001,891854,Vespa; Emanuel Ignacio,9999,0,9999,0
1746597814070,ANTH 289S,A00,891856,Gagneux; Pascal,12,0,12,0
1746597815096,BENG 196,001,957946,Engler; Adam J.,9996,0,9999,3
1746597816124,BISP 197,001,959851,Wilhelm; James E.,9998,0,9999,1
1746597817153,CAT 124RS,A01,956906,Staff,6,0,25,19
1746597818180,CAT 125RS,A01,922013,Staff,6,0,25,19
1746597819206,CLRE 250,A00,891860,Morris; Sheldon,9995,0,9999,4
1746597821264,CLRE 251R,A00,907817,Mehta; Ravindra L.,9994,0,9999,5
1746597822289,CLRE 252,A00,891864,Cuomo; Raphael Eduardo,9993,0,9999,6
1746597823317,CLRE 253,A00,891867,Vaida; Florin,9994,0,9999,5
1746597823317,CLRE 253,B00,907819,Staff,9999,0,9999,0
1746597824343,CLRE 259,A00,891868,Patel; Hemal,9998,0,9999,1
1746597825374,CLRE 260,A00,891872,Cuomo; Raphael Eduardo,9999,0,9999,0
1746597826399,CLRE 297,001,891888,Cuomo; Raphael Eduardo,9999,0,9999,0
1746597827427,CSE 191,A00,958773,Minnes Kemp; Mor Mia,9995,0,9999,4
1746597828455,CSE 197,001,959846,Minnes Kemp; Mor Mia,9990,0,9999,9
1746597829482,CSS 201S,A01,892054,Mignozzetti; Umberto,25,0,30,5
1746597830508,CSS 202S,A01,892056,Mignozzetti; Umberto,25,0,30,5
1746597831537,DSC 197,001,956898,Eldridge; Justin Matthew,9996,0,9999,3
1746597832562,DSC 297,001,958000,Mazumdar; Arya,9998,0,9999,1
1746597832562,DSC 297,002,959862,Wang; Yusu,9998,0,9999,1
1746597833587,EAP 100,A00,905686,Staff,9778,0,9999,221
1746597834615,ECE 45,A01,892618,Staff,0,0,65,65
1746597836670,ECE 111,A01,892719,Staff,6,0,65,59
1746597837696,ECE 197,001,957920,Mercier; Patrick Philip,9991,0,9999,8
1746597838721,ECON 178,A01,907814,Zhu; Ying,26,0,35,9
1746597839749,EDS 115,A00,895312,Staff,35,0,45,10
1746597840793,EDS 117,A01,895337,Staff,23,0,30,7
1746597841822,EDS 125,A00,895341,Jones; Gabrielle Anastasia,36,0,45,9
1746597842848,EDS 128A,A01,895459,Fargason; Sharon Gayle,44,0,45,1
1746597843874,EDS 128B,A01,895543,Pappas; Elizabeth,44,0,45,1
1746597844900,EDS 139,A00,897203,Pappas; Elizabeth,44,0,45,1
1746597844900,EDS 139,B00,897209,Fargason; Sharon Gayle,41,0,45,4
1746597845926,EDS 201,A00,895545,Staff,22,0,45,23
1746597846952,EDS 203,A01,895581,Halter; Christopher P.,22,0,45,23
1746597847980,EDS 204R,A01,895625,Heinzman; Erica M.,39,0,45,6
1746597847980,EDS 204R,B01,895693,Halter; Christopher P.,10,0,45,35
1746597849006,EDS 206R,A00,895694,Fargason; Sharon Gayle,1,0,30,29
1746597849006,EDS 206R,B00,895695,Choi; Bailey Miyeon,16,0,30,14
1746597850032,EDS 250,A00,895697,Hemans; Patricia Ann Benitez,22,0,45,23
1746597851058,EDS 281,A00,895701,Meyerott; Theresa Ann,1,0,15,14
1746597852086,EDS 284,A00,895736,Meyerott; Theresa Ann,1,0,15,14
1746597853113,EDS 286,A00,897210,Fine; Sarah,0,0,15,15
1746597854143,EDS 289C,A01,895770,Daly; Alan J.,1,0,15,14
1746597855169,EDS 290,A00,897211,Hofstetter; Carolyn,0,0,15,15
1746597856197,LIGM 5A,A00,896162,Fischer-Grunski; Eva K,12,0,20,8
1746597857222,LIGM 5B,A00,896260,Fischer-Grunski; Eva K,17,0,20,3
1746597858248,LIGM 5C,A00,896308,Fischer-Grunski; Eva K,18,0,20,2
1746597859279,LIIT 5AS,A00,896313,Carnelos; Chiara,18,0,20,2
1746597860309,LIIT 5BS,A00,896416,Carnelos; Chiara,20,0,20,0
1746597861338,LIIT 5CS,A00,896564,Carnelos; Chiara,20,0,20,0
1746597862367,LISP 5A,A00,896588,Munoz Sanchez; Alicia,2,0,20,18
1746597863393,LISP 5B,A00,896653,Munoz Sanchez; Alicia,7,0,20,13
1746597864419,LISP 5C,A00,896655,Munoz Sanchez; Alicia,0,1,20,20
1746597865444,MAE 197,001,957918,Kleissl; Jan,9996,0,9999,3
1746597865444,MAE 197,002,959806,Boechler; Nicholas Sebastia,9998,0,9999,1
1746597865444,MAE 197,003,959852,Mullin; Jennifer S,9998,0,9999,1
1746597866469,MATH 2,A01,957937,Staff,33,0,35,2
1746597867493,MATH 197,001,957876,Kedlaya; Kiran S.,9993,0,9999,6
1746597868523,MCWP 40,A00,892729,Duru; Nur,10,0,20,10
1746597868523,MCWP 40,B00,893304,Montejo; Carolina,14,0,20,6
1746597869547,MCWP 40R,A00,893757,Redela; Pamela Morgan,0,5,20,20
1746597870571,MCWP 50,A00,893758,Morshed; Michael James,0,0,20,20
1746597870571,MCWP 50,B00,893761,Bartulis; Jason Michael,17,0,20,3
1746597871597,MCWP 50R,A00,893766,Compas; Sean Matthew,0,1,20,20
1746597871597,MCWP 50R,B00,893769,Carter; Jennifer A,0,1,20,20
1746597871597,MCWP 50R,C00,893771,Krone; Jarret,0,3,20,20
1746597871597,MCWP 50R,D00,893772,Miller; Elizabeth Deen,0,0,20,20
1746597871597,MCWP 50R,E00,893775,Carter; Andrea L,0,1,20,20
1746597872622,MMW 11R,A01,892721,Herbst; Matthew,14,0,30,16
1746597872622,MMW 11R,A02,892722,Herbst; Matthew,0,0,0,3
1746597873648,MMW 12R,A01,892724,Herbst; Matthew,0,11,16,16
1746597873648,MMW 12R,A02,892725,Herbst; Matthew,0,10,16,16
1746597874673,MMW 13R,A01,892727,Staff,0,4,16,16
1746597874673,MMW 13R,A02,892728,Staff,0,4,16,16
1746597874673,MMW 13R,A03,958032,Staff,0,4,16,16
1746597874673,MMW 13R,A04,958033,Staff,0,4,16,16
1746597874673,MMW 13R,A05,958034,Staff,0,4,16,16
1746597875702,SIO 295LS,A00,894015,Staff,5,0,25,20
1746597876731,SIO 295S,A00,894020,Staff,5,0,25,20
1746597877760,SIOC 290S,B01,958918,Merrifield; Mark A,14,0,30,16
1746597878786,SIOC 291S,B01,958922,Gabriel; Corey John,14,0,30,16
1746597879815,SOCI 117,A01,895339,Staff,2,0,5,3
1746597880840,WES 237B,A00,894149,Staff,11,0,20,9
1746597882901,AESE 279B,A00,891859,Staff,13,0,35,22
1746597883925,AIP 197,001,891854,Vespa; Emanuel Ignacio,9999,0,9999,0
1746597884949,ANTH 289S,A00,891856,Gagneux; Pascal,12,0,12,0
1746597885978,BENG 196,001,957946,Engler; Adam J.,9996,0,9999,3
1746597887003,BISP 197,001,959851,Wilhelm; James E.,9998,0,9999,1
1746597888030,CAT 124RS,A01,956906,Staff,6,0,25,19
1746597889058,CAT 125RS,A01,922013,Staff,6,0,25,19
1746597890085,CLRE 250,A00,891860,Morris; Sheldon,9995,0,9999,4
1746597892208,CLRE 251R,A00,907817,Mehta; Ravindra L.,9994,0,9999,5
1746597893234,CLRE 252,A00,891864,Cuomo; Raphael Eduardo,9993,0,9999,6
1746597894261,CLRE 253,A00,891867,Vaida; Florin,9994,0,9999,5
1746597894261,CLRE 253,B00,907819,Staff,9999,0,9999,0
1746597895290,CLRE 259,A00,891868,Patel; Hemal,9998,0,9999,1
1746597896316,CLRE 260,A00,891872,Cuomo; Raphael Eduardo,9999,0,9999,0
1746597897343,CLRE 297,001,891888,Cuomo; Raphael Eduardo,9999,0,9999,0
1746597898373,CSE 191,A00,958773,Minnes Kemp; Mor Mia,9995,0,9999,4
1746597899401,CSE 197,001,959846,Minnes Kemp; Mor Mia,9990,0,9999,9
1746597900426,CSS 201S,A01,892054,Mignozzetti; Umberto,25,0,30,5
1746597901452,CSS 202S,A01,892056,Mignozzetti; Umberto,25,0,30,5
1746597902483,DSC 197,001,956898,Eldridge; Justin Matthew,9996,0,9999,3
1746597903507,DSC 297,001,958000,Mazumdar; Arya,9998,0,9999,1
1746597903507,DSC 297,002,959862,Wang; Yusu,9998,0,9999,1
1746597904533,EAP 100,A00,905686,Staff,9778,0,9999,221
1746597905561,ECE 45,A01,892618,Staff,0,0,65,65
1746597907616,ECE 111,A01,892719,Staff,6,0,65,59
1746597908644,ECE 197,001,957920,Mercier; Patrick Philip,9991,0,9999,8
1746597909669,ECON 178,A01,907814,Zhu; Ying,26,0,35,9
1746597910697,EDS 115,A00,895312,Staff,35,0,45,10
1746597911727,EDS 117,A01,895337,Staff,23,0,30,7
1746597912752,EDS 125,A00,895341,Jones; Gabrielle Anastasia,36,0,45,9
1746597913778,EDS 128A,A01,895459,Fargason; Sharon Gayle,44,0,45,1
1746597914808,EDS 128B,A01,895543,Pappas; Elizabeth,44,0,45,1
1746597915837,EDS 139,A00,897203,Pappas; Elizabeth,44,0,45,1
1746597915837,EDS 139,B00,897209,Fargason; Sharon Gayle,41,0,45,4
1746597916861,EDS 201,A00,895545,Staff,22,0,45,23
1746597917886,EDS 203,A01,895581,Halter; Christopher P.,22,0,45,23
1746597918917,EDS 204R,A01,895625,Heinzman; Erica M.,39,0,45,6
1746597918917,EDS 204R,B01,895693,Halter; Christopher P.,10,0,45,35
1746597919943,EDS 206R,A00,895694,Fargason; Sharon Gayle,1,0,30,29
1746597919943,EDS 206R,B00,895695,Choi; Bailey Miyeon,16,0,30,14
1746597920969,EDS 250,A00,895697,Hemans; Patricia Ann Benitez,22,0,45,23
1746597921997,EDS 281,A00,895701,Meyerott; Theresa Ann,1,0,15,14
1746597923026,EDS 284,A00,895736,Meyerott; Theresa Ann,1,0,15,14
1746597924052,EDS 286,A00,897210,Fine; Sarah,0,0,15,15
1746597925081,EDS 289C,A01,895770,Daly; Alan J.,1,0,15,14
1746597926108,EDS 290,A00,897211,Hofstetter; Carolyn,0,0,15,15
1746597927139,LIGM 5A,A00,896162,Fischer-Grunski; Eva K,12,0,20,8
1746597928164,LIGM 5B,A00,896260,Fischer-Grunski; Eva K,17,0,20,3
1746597929192,LIGM 5C,A00,896308,Fischer-Grunski; Eva K,18,0,20,2
1746597930219,LIIT 5AS,A00,896313,Carnelos; Chiara,18,0,20,2
1746597931243,LIIT 5BS,A00,896416,Carnelos; Chiara,20,0,20,0
1746597932271,LIIT 5CS,A00,896564,Carnelos; Chiara,20,0,20,0
1746597933302,LISP 5A,A00,896588,Munoz Sanchez; Alicia,2,0,20,18
1746597934326,LISP 5B,A00,896653,Munoz Sanchez; Alicia,7,0,20,13
1746597935350,LISP 5C,A00,896655,Munoz Sanchez; Alicia,0,1,20,20
1746597936379,MAE 197,001,957918,Kleissl; Jan,9996,0,9999,3
1746597936379,MAE 197,002,959806,Boechler; Nicholas Sebastia,9998,0,9999,1
1746597936379,MAE 197,003,959852,Mullin; Jennifer S,9998,0,9999,1
1746597937404,MATH 2,A01,957937,Staff,33,0,35,2
1746597938430,MATH 197,001,957876,Kedlaya; Kiran S.,9993,0,9999,6
1746597939462,MCWP 40,A00,892729,Duru; Nur,10,0,20,10
1746597939462,MCWP 40,B00,893304,Montejo; Carolina,14,0,20,6
1746597940488,MCWP 40R,A00,893757,Redela; Pamela Morgan,0,5,20,20
1746597941518,MCWP 50,A00,893758,Morshed; Michael James,0,0,20,20
1746597941518,MCWP 50,B00,893761,Bartulis; Jason Michael,17,0,20,3
1746597942544,MCWP 50R,A00,893766,Compas; Sean Matthew,0,1,20,20
1746597942544,MCWP 50R,B00,893769,Carter; Jennifer A,0,1,20,20
1746597942544,MCWP 50R,C00,893771,Krone; Jarret,0,3,20,20
1746597942544,MCWP 50R,D00,893772,Miller; Elizabeth Deen,0,0,20,20
1746597942544,MCWP 50R,E00,893775,Carter; Andrea L,0,1,20,20
1746597943570,MMW 11R,A01,892721,Herbst; Matthew,14,0,30,16
1746597943570,MMW 11R,A02,892722,Herbst; Matthew,0,0,0,3
1746597944601,MMW 12R,A01,892724,Herbst; Matthew,0,11,16,16
1746597944601,MMW 12R,A02,892725,Herbst; Matthew,0,10,16,16
1746597945627,MMW 13R,A01,892727,Staff,0,4,16,16
1746597945627,MMW 13R,A02,892728,Staff,0,4,16,16
1746597945627,MMW 13R,A03,958032,Staff,0,4,16,16
1746597945627,MMW 13R,A04,958033,Staff,0,4,16,16
1746597945627,MMW 13R,A05,958034,Staff,0,4,16,16
1746597946652,SIO 295LS,A00,894015,Staff,5,0,25,20
1746597947678,SIO 295S,A00,894020,Staff,5,0,25,20
1746597948711,SIOC 290S,B01,958918,Merrifield; Mark A,14,0,30,16
1746597949795,SIOC 291S,B01,958922,Gabriel; Corey John,14,0,30,16
1746597950823,SOCI 117,A01,895339,Staff,2,0,5,3
1746597951848,WES 237B,A00,894149,Staff,11,0,20,9
1746597953915,AESE 279B,A00,891859,Staff,13,0,35,22
1746597954940,AIP 197,001,891854,Vespa; Emanuel Ignacio,9999,0,9999,0
1746597955968,ANTH 289S,A00,891856,Gagneux; Pascal,12,0,12,0
1746597956999,BENG 196,001,957946,Engler; Adam J.,9996,0,9999,3
1746597958027,BISP 197,001,959851,Wilhelm; James E.,9998,0,9999,1
1746597959057,CAT 124RS,A01,956906,Staff,6,0,25,19
1746597960081,CAT 125RS,A01,922013,Staff,6,0,25,19
1746597961106,CLRE 250,A00,891860,Morris; Sheldon,9995,0,9999,4
1746597963159,CLRE 251R,A00,907817,Mehta; Ravindra L.,9994,0,9999,5
1746597964183,CLRE 252,A00,891864,Cuomo; Raphael Eduardo,9993,0,9999,6
1746597965208,CLRE 253,A00,891867,Vaida; Florin,9994,0,9999,5
1746597965208,CLRE 253,B00,907819,Staff,9999,0,9999,0
1746597966236,CLRE 259,A00,891868,Patel; Hemal,9998,0,9999,1
1746597967262,CLRE 260,A00,891872,Cuomo; Raphael Eduardo,9999,0,9999,0
1746597968287,CLRE 297,001,891888,Cuomo; Raphael Eduardo,9999,0,9999,0
1746597969316,CSE 191,A00,958773,Minnes Kemp; Mor Mia,9995,0,9999,4
1746597970344,CSE 197,001,959846,Minnes Kemp; Mor Mia,9990,0,9999,9
1746597971375,CSS 201S,A01,892054,Mignozzetti; Umberto,25,0,30,5
1746597972412,CSS 202S,A01,892056,Mignozzetti; Umberto,25,0,30,5
1746597973438,DSC 197,001,956898,Eldridge; Justin Matthew,9996,0,9999,3
1746597974466,DSC 297,001,958000,Mazumdar; Arya,9998,0,9999,1
1746597974466,DSC 297,002,959862,Wang; Yusu,9998,0,9999,1
1746597975494,EAP 100,A00,905686,Staff,9778,0,9999,221
1746597976520,ECE 45,A01,892618,Staff,0,0,65,65
1746597978577,ECE 111,A01,892719,Staff,6,0,65,59
1746597979604,ECE 197,001,957920,Mercier; Patrick Philip,9991,0,9999,8
1746597980636,ECON 178,A01,907814,Zhu; Ying,26,0,35,9
1746597981663,EDS 115,A00,895312,Staff,35,0,45,10
1746597982691,EDS 117,A01,895337,Staff,23,0,30,7
1746597983717,EDS 125,A00,895341,Jones; Gabrielle Anastasia,36,0,45,9
1746597984746,EDS 128A,A01,895459,Fargason; Sharon Gayle,44,0,45,1
1746597985773,EDS 128B,A01,895543,Pappas; Elizabeth,44,0,45,1
1746597986799,EDS 139,A00,897203,Pappas; Elizabeth,44,0,45,1
1746597986799,EDS 139,B00,897209,Fargason; Sharon Gayle,41,0,45,4
1746597987824,EDS 201,A00,895545,Staff,22,0,45,23
1746597988852,EDS 203,A01,895581,Halter; Christopher P.,22,0,45,23
1746597989879,EDS 204R,A01,895625,Heinzman; Erica M.,39,0,45,6
1746597989879,EDS 204R,B01,895693,Halter; Christopher P.,10,0,45,35
1746597990905,EDS 206R,A00,895694,Fargason; Sharon Gayle,1,0,30,29
1746597990905,EDS 206R,B00,895695,Choi; Bailey Miyeon,16,0,30,14
1746597991934,EDS 250,A00,895697,Hemans; Patricia Ann Benitez,22,0,45,23
1746597992959,EDS 281,A00,895701,Meyerott; Theresa Ann,1,0,15,14
1746597993987,EDS 284,A00,895736,Meyerott; Theresa Ann,1,0,15,14
1746597995018,EDS 286,A00,897210,Fine; Sarah,0,0,15,15
1746597996044,EDS 289C,A01,895770,Daly; Alan J.,1,0,15,14
1746597997072,EDS 290,A00,897211,Hofstetter; Carolyn,0,0,15,15
1746597998098,LIGM 5A,A00,896162,Fischer-Grunski; Eva K,12,0,20,8
1746597999124,LIGM 5B,A00,896260,Fischer-Grunski; Eva K,17,0,20,3
1746598000160,LIGM 5C,A00,896308,Fischer-Grunski; Eva K,18,0,20,2
1746598001185,LIIT 5AS,A00,896313,Carnelos; Chiara,18,0,20,2
1746598002211,LIIT 5BS,A00,896416,Carnelos; Chiara,20,0,20,0
1746598003241,LIIT 5CS,A00,896564,Carnelos; Chiara,20,0,20,0
1746598004268,LISP 5A,A00,896588,Munoz Sanchez; Alicia,2,0,20,18
1746598005297,LISP 5B,A00,896653,Munoz Sanchez; Alicia,7,0,20,13
1746598006328,LISP 5C,A00,896655,Munoz Sanchez; Alicia,0,1,20,20
1746598007354,MAE 197,001,957918,Kleissl; Jan,9996,0,9999,3
1746598007354,MAE 197,002,959806,Boechler; Nicholas Sebastia,9998,0,9999,1
1746598007354,MAE 197,003,959852,Mullin; Jennifer S,9998,0,9999,1
1746598008385,MATH 2,A01,957937,Staff,33,0,35,2
1746598009412,MATH 197,001,957876,Kedlaya; Kiran S.,9993,0,9999,6
1746598010440,MCWP 40,A00,892729,Duru; Nur,10,0,20,10
1746598010440,MCWP 40,B00,893304,Montejo; Carolina,14,0,20,6
1746598011469,MCWP 40R,A00,893757,Redela; Pamela Morgan,0,5,20,20
1746598012497,MCWP 50,A00,893758,Morshed; Michael James,0,0,20,20
1746598012497,MCWP 50,B00,893761,Bartulis; Jason Michael,17,0,20,3
1746598013526,MCWP 50R,A00,893766,Compas; Sean Matthew,0,1,20,20
1746598013526,MCWP 50R,B00,893769,Carter; Jennifer A,0,1,20,20
1746598013526,MCWP 50R,C00,893771,Krone; Jarret,0,3,20,20
1746598013526,MCWP 50R,D00,893772,Miller; Elizabeth Deen,0,0,20,20
1746598013526,MCWP 50R,E00,893775,Carter; Andrea L,0,1,20,20
1746598014555,MMW 11R,A01,892721,Herbst; Matthew,14,0,30,16
1746598014555,MMW 11R,A02,892722,Herbst; Matthew,0,0,0,3
1746598015580,MMW 12R,A01,892724,Herbst; Matthew,0,11,16,16
1746598015580,MMW 12R,A02,892725,Herbst; Matthew,0,10,16,16
1746598016609,MMW 13R,A01,892727,Staff,0,4,16,16
1746598016609,MMW 13R,A02,892728,Staff,0,4,16,16
1746598016609,MMW 13R,A03,958032,Staff,0,4,16,16
1746598016609,MMW 13R,A04,958033,Staff,0,4,16,16
1746598016609,MMW 13R,A05,958034,Staff,0,4,16,16
1746598017635,SIO 295LS,A00,894015,Staff,5,0,25,20
1746598018664,SIO 295S,A00,894020,Staff,5,0,25,20
1746598019692,SIOC 290S,B01,958918,Merrifield; Mark A,14,0,30,16
1746598020719,SIOC 291S,B01,958922,Gabriel; Corey John,14,0,30,16
1746598021745,SOCI 117,A01,895339,Staff,2,0,5,3
1746598022770,WES 237B,A00,894149,Staff,11,0,20,9
1746598024842,AESE 279B,A00,891859,Staff,13,0,35,22
1746598025869,AIP 197,001,891854,Vespa; Emanuel Ignacio,9999,0,9999,0
1746598026897,ANTH 289S,A00,891856,Gagneux; Pascal,12,0,12,0
1746598027925,BENG 196,001,957946,Engler; Adam J.,9996,0,9999,3
1746598028949,BISP 197,001,959851,Wilhelm; James E.,9998,0,9999,1
1746598029980,CAT 124RS,A01,956906,Staff,6,0,25,19
1746598031010,CAT 125RS,A01,922013,Staff,6,0,25,19
1746598032035,CLRE 250,A00,891860,Morris; Sheldon,9995,0,9999,4
1746598034091,CLRE 251R,A00,907817,Mehta; Ravindra L.,9994,0,9999,5
1746598035116,CLRE 252,A00,891864,Cuomo; Raphael Eduardo,9993,0,9999,6
1746598036146,CLRE 253,A00,891867,Vaida; Florin,9994,0,9999,5
1746598036146,CLRE 253,B00,907819,Staff,9999,0,9999,0
1746598037171,CLRE 259,A00,891868,Patel; Hemal,9998,0,9999,1
1746598038200,CLRE 260,A00,891872,Cuomo; Raphael Eduardo,9999,0,9999,0
1746598039224,CLRE 297,001,891888,Cuomo; Raphael Eduardo,9999,0,9999,0
1746598040253,CSE 191,A00,958773,Minnes Kemp; Mor Mia,9995,0,9999,4
1746598041279,CSE 197,001,959846,Minnes Kemp; Mor Mia,9990,0,9999,9
1746598042308,CSS 201S,A01,892054,Mignozzetti; Umberto,25,0,30,5
1746598043338,CSS 202S,A01,892056,Mignozzetti; Umberto,25,0,30,5
1746598044371,DSC 197,001,956898,Eldridge; Justin Matthew,9996,0,9999,3
1746598045399,DSC 297,001,958000,Mazumdar; Arya,9998,0,9999,1
1746598045399,DSC 297,002,959862,Wang; Yusu,9998,0,9999,1
1746598046424,EAP 100,A00,905686,Staff,9778,0,9999,221
1746598047450,ECE 45,A01,892618,Staff,0,0,65,65
1746598049508,ECE 111,A01,892719,Staff,6,0,65,59
1746598050538,ECE 197,001,957920,Mercier; Patrick Philip,9991,0,9999,8
1746598051568,ECON 178,A01,907814,Zhu; Ying,26,0,35,9
1746598052592,EDS 115,A00,895312,Staff,35,0,45,10
1746598053672,EDS 117,A01,895337,Staff,23,0,30,7
1746598054702,EDS 125,A00,895341,Jones; Gabrielle Anastasia,36,0,45,9
1746598055730,EDS 128A,A01,895459,Fargason; Sharon Gayle,44,0,45,1
1746598056756,EDS 128B,A01,895543,Pappas; Elizabeth,44,0,45,1
1746598057780,EDS 139,A00,897203,Pappas; Elizabeth,44,0,45,1
1746598057780,EDS 139,B00,897209,Fargason; Sharon Gayle,41,0,45,4
1746598058806,EDS 201,A00,895545,Staff,22,0,45,23
1746598059835,EDS 203,A01,895581,Halter; Christopher P.,22,0,45,23
1746598060860,EDS 204R,A01,895625,Heinzman; Erica M.,39,0,45,6
1746598060860,EDS 204R,B01,895693,Halter; Christopher P.,10,0,45,35
1746598061889,EDS 206R,A00,895694,Fargason; Sharon Gayle,1,0,30,29
1746598061889,EDS 206R,B00,895695,Choi; Bailey Miyeon,16,0,30,14
1746598062918,EDS 250,A00,895697,Hemans; Patricia Ann Benitez,22,0,45,23
1746598063943,EDS 281,A00,895701,Meyerott; Theresa Ann,1,0,15,14
1746598064967,EDS 284,A00,895736,Meyerott; Theresa Ann,1,0,15,14
1746598065993,EDS 286,A00,897210,Fine; Sarah,0,0,15,15
1746598067022,EDS 289C,A01,895770,Daly; Alan J.,1,0,15,14
1746598068048,EDS 290,A00,897211,Hofstetter; Carolyn,0,0,15,15
1746598069075,LIGM 5A,A00,896162,Fischer-Grunski; Eva K,12,0,20,8
1746598070104,LIGM 5B,A00,896260,Fischer-Grunski; Eva K,17,0,20,3
1746598071131,LIGM 5C,A00,896308,Fischer-Grunski; Eva K,18,0,20,2
1746598072155,LIIT 5AS,A00,896313,Carnelos; Chiara,18,0,20,2
1746598073187,LIIT 5BS,A00,896416,Carnelos; Chiara,20,0,20,0
1746598074211,LIIT 5CS,A00,896564,Carnelos; Chiara,20,0,20,0
1746598075250,LISP 5A,A00,896588,Munoz Sanchez; Alicia,2,0,20,18
1746598076275,LISP 5B,A00,896653,Munoz Sanchez; Alicia,7,0,20,13
1746598077300,LISP 5C,A00,896655,Munoz Sanchez; Alicia,0,1,20,20
1746598078326,MAE 197,001,957918,Kleissl; Jan,9996,0,9999,3
1746598078326,MAE 197,002,959806,Boechler; Nicholas Sebastia,9998,0,9999,1
1746598078326,MAE 197,003,959852,Mullin; Jennifer S,9998,0,9999,1
1746598079359,MATH 2,A01,957937,Staff,33,0,35,2
1746598080392,MATH 197,001,957876,Kedlaya; Kiran S.,9993,0,9999,6
1746598081421,MCWP 40,A00,892729,Duru; Nur,10,0,20,10
1746598081421,MCWP 40,B00,893304,Montejo; Carolina,14,0,20,6
1746598082447,MCWP 40R,A00,893757,Redela; Pamela Morgan,0,5,20,20
1746598083472,MCWP 50,A00,893758,Morshed; Michael James,0,0,20,20
1746598083472,MCWP 50,B00,893761,Bartulis; Jason Michael,17,0,20,3
1746598084500,MCWP 50R,A00,893766,Compas; Sean Matthew,0,1,20,20
1746598084500,MCWP 50R,B00,893769,Carter; Jennifer A,0,1,20,20
1746598084500,MCWP 50R,C00,893771,Krone; Jarret,0,3,20,20
1746598084500,MCWP 50R,D00,893772,Miller; Elizabeth Deen,0,0,20,20
1746598084500,MCWP 50R,E00,893775,Carter; Andrea L,0,1,20,20
1746598085527,MMW 11R,A01,892721,Herbst; Matthew,14,0,30,16
1746598085527,MMW 11R,A02,892722,Herbst; Matthew,0,0,0,3
1746598086556,MMW 12R,A01,892724,Herbst; Matthew,0,11,16,16
1746598086556,MMW 12R,A02,892725,Herbst; Matthew,0,10,16,16
1746598087582,MMW 13R,A01,892727,Staff,0,4,16,16
1746598087582,MMW 13R,A02,892728,Staff,0,4,16,16
1746598087582,MMW 13R,A03,958032,Staff,0,4,16,16
1746598087582,MMW 13R,A04,958033,Staff,0,4,16,16
1746598087582,MMW 13R,A05,958034,Staff,0,4,16,16
1746598088618,SIO 295LS,A00,894015,Staff,5,0,25,20
1746598089644,SIO 295S,A00,894020,Staff,5,0,25,20
1746598090670,SIOC 290S,B01,958918,Merrifield; Mark A,14,0,30,16
1746598091705,SIOC 291S,B01,958922,Gabriel; Corey John,14,0,30,16
1746598092734,SOCI 117,A01,895339,Staff,2,0,5,3
1746598093759,WES 237B,A00,894149,Staff,11,0,20,9
1746598095841,AESE 279B,A00,891859,Staff,13,0,35,22
1746598096868,AIP 197,001,891854,Vespa; Emanuel Ignacio,9999,0,9999,0
1746598097899,ANTH 289S,A00,891856,Gagneux; Pascal,12,0,12,0
1746598098926,BENG 196,001,957946,Engler; Adam J.,9996,0,9999,3
1746598099954,BISP 197,001,959851,Wilhelm; James E.,9998,0,9999,1
1746598100995,CAT 124RS,A01,956906,Staff,6,0,25,19
1746598102020,CAT 125RS,A01,922013,Staff,6,0,25,19
1746598103048,CLRE 250,A00,891860,Morris; Sheldon,9995,0,9999,4
1746598105137,CLRE 251R,A00,907817,Mehta; Ravindra L.,9994,0,9999,5
1746598106162,CLRE 252,A00,891864,Cuomo; Raphael Eduardo,9993,0,9999,6
1746598107190,CLRE 253,A00,891867,Vaida; Florin,9994,0,9999,5
1746598107190,CLRE 253,B00,907819,Staff,9999,0,9999,0
1746598108217,CLRE 259,A00,891868,Patel; Hemal,9998,0,9999,1
1746598109245,CLRE 260,A00,891872,Cuomo; Raphael Eduardo,9999,0,9999,0
1746598110275,CLRE 297,001,891888,Cuomo; Raphael Eduardo,9999,0,9999,0
1746598111301,CSE 191,A00,958773,Minnes Kemp; Mor Mia,9995,0,9999,4
1746598112329,CSE 197,001,959846,Minnes Kemp; Mor Mia,9990,0,9999,9
1746598113355,CSS 201S,A01,892054,Mignozzetti; Umberto,25,0,30,5
1746598114379,CSS 202S,A01,892056,Mignozzetti; Umberto,25,0,30,5
1746598115410,DSC 197,001,956898,Eldridge; Justin Matthew,9996,0,9999,3
1746598116439,DSC 297,001,958000,Mazumdar; Arya,9998,0,9999,1
1746598116439,DSC 297,002,959862,Wang; Yusu,9998,0,9999,1
1746598117463,EAP 100,A00,905686,Staff,9778,0,9999,221
1746598118490,ECE 45,A01,892618,Staff,0,0,65,65
1746598120540,ECE 111,A01,892719,Staff,6,0,65,59
1746598121567,ECE 197,001,957920,Mercier; Patrick Philip,9991,0,9999,8
1746598122594,ECON 178,A01,907814,Zhu; Ying,26,0,35,9
1746598123619,EDS 115,A00,895312,Staff,35,0,45,10
1746598124644,EDS 117,A01,895337,Staff,23,0,30,7
1746598125673,EDS 125,A00,895341,Jones; Gabrielle Anastasia,36,0,45,9
1746598126700,EDS 128A,A01,895459,Fargason; Sharon Gayle,44,0,45,1
1746598127731,EDS 128B,A01,895543,Pappas; Elizabeth,44,0,45,1
1746598128761,EDS 139,A00,897203,Pappas; Elizabeth,44,0,45,1
1746598128761,EDS 139,B00,897209,Fargason; Sharon Gayle,41,0,45,4
1746598129791,EDS 201,A00,895545,Staff,22,0,45,23
1746598130816,EDS 203,A01,895581,Halter; Christopher P.,22,0,45,23
1746598131845,EDS 204R,A01,895625,Heinzman; Erica M.,39,0,45,6
1746598131845,EDS 204R,B01,895693,Halter; Christopher P.,10,0,45,35
1746598132872,EDS 206R,A00,895694,Fargason; Sharon Gayle,1,0,30,29
1746598132872,EDS 206R,B00,895695,Choi; Bailey Miyeon,16,0,30,14
1746598133902,EDS 250,A00,895697,Hemans; Patricia Ann Benitez,22,0,45,23
1746598134929,EDS 281,A00,895701,Meyerott; Theresa Ann,1,0,15,14
1746598135955,EDS 284,A00,895736,Meyerott; Theresa Ann,1,0,15,14
1746598136982,EDS 286,A00,897210,Fine; Sarah,0,0,15,15
1746598138010,EDS 289C,A01,895770,Daly; Alan J.,1,0,15,14
1746598139037,EDS 290,A00,897211,Hofstetter; Carolyn,0,0,15,15
1746598140066,LIGM 5A,A00,896162,Fischer-Grunski; Eva K,12,0,20,8
1746598141091,LIGM 5B,A00,896260,Fischer-Grunski; Eva K,17,0,20,3
1746598142118,LIGM 5C,A00,896308,Fischer-Grunski; Eva K,18,0,20,2
1746598143157,LIIT 5AS,A00,896313,Carnelos; Chiara,18,0,20,2
1746598144184,LIIT 5BS,A00,896416,Carnelos; Chiara,20,0,20,0
1746598145213,LIIT 5CS,A00,896564,Carnelos; Chiara,20,0,20,0
1746598146243,LISP 5A,A00,896588,Munoz Sanchez; Alicia,2,0,20,18
1746598147272,LISP 5B,A00,896653,Munoz Sanchez; Alicia,7,0,20,13
1746598148298,LISP 5C,A00,896655,Munoz Sanchez; Alicia,0,1,20,20
1746598149324,MAE 197,001,957918,Kleissl; Jan,9996,0,9999,3
1746598149324,MAE 197,002,959806,Boechler; Nicholas Sebastia,9998,0,9999,1
1746598149324,MAE 197,003,959852,Mullin; Jennifer S,9998,0,9999,1
1746598150355,MATH 2,A01,957937,Staff,33,0,35,2
1746598151382,MATH 197,001,957876,Kedlaya; Kiran S.,9993,0,9999,6
1746598152421,MCWP 40,A00,892729,Duru; Nur,10,0,20,10
1746598152421,MCWP 40,B00,893304,Montejo; Carolina,14,0,20,6
1746598153447,MCWP 40R,A00,893757,Redela; Pamela Morgan,0,5,20,20
1746598154476,MCWP 50,A00,893758,Morshed; Michael James,0,0,20,20
1746598154476,MCWP 50,B00,893761,Bartulis; Jason Michael,17,0,20,3
1746598155504,MCWP 50R,A00,893766,Compas; Sean Matthew,0,1,20,20
1746598155504,MCWP 50R,B00,893769,Carter; Jennifer A,0,1,20,20
1746598155504,MCWP 50R,C00,893771,Krone; Jarret,0,3,20,20
1746598155504,MCWP 50R,D00,893772,Miller; Elizabeth Deen,0,0,20,20
1746598155504,MCWP 50R,E00,893775,Carter; Andrea L,0,1,20,20
1746598156530,MMW 11R,A01,892721,Herbst; Matthew,14,0,30,16
1746598156530,MMW 11R,A02,892722,Herbst; Matthew,0,0,0,3
1746598157557,MMW 12R,A01,892724,Herbst; Matthew,0,11,16,16
1746598157557,MMW 12R,A02,892725,Herbst; Matthew,0,10,16,16
1746598158623,MMW 13R,A01,892727,Staff,0,4,16,16
1746598158623,MMW 13R,A02,892728,Staff,0,4,16,16
1746598158623,MMW 13R,A03,958032,Staff,0,4,16,16
1746598158623,MMW 13R,A04,958033,Staff,0,4,16,16
1746598158623,MMW 13R,A05,958034,Staff,0,4,16,16
1746598159650,SIO 295LS,A00,894015,Staff,5,0,25,20
1746598160681,SIO 295S,A00,894020,Staff,5,0,25,20
1746598161710,SIOC 290S,B01,958918,Merrifield; Mark A,14,0,30,16
1746598162741,SIOC 291S,B01,958922,Gabriel; Corey John,14,0,30,16
1746598163771,SOCI 117,A01,895339,Staff,2,0,5,3
1746598164797,WES 237B,A00,894149,Staff,11,0,20,9
1746598166858,AESE 279B,A00,891859,Staff,13,0,35,22
1746598167884,AIP 197,001,891854,Vespa; Emanuel Ignacio,9999,0,9999,0
1746598168909,ANTH 289S,A00,891856,Gagneux; Pascal,12,0,12,0
1746598169935,BENG 196,001,957946,Engler; Adam J.,9996,0,9999,3
1746598170960,BISP 197,001,959851,Wilhelm; James E.,9998,0,9999,1
1746598171986,CAT 124RS,A01,956906,Staff,6,0,25,19
1746598173015,CAT 125RS,A01,922013,Staff,6,0,25,19
1746598174044,CLRE 250,A00,891860,Morris; Sheldon,9995,0,9999,4
1746598176105,CLRE 251R,A00,907817,Mehta; Ravindra L.,9994,0,9999,5
1746598177132,CLRE 252,A00,891864,Cuomo; Raphael Eduardo,9993,0,9999,6
1746598178168,CLRE 253,A00,891867,Vaida; Florin,9994,0,9999,5
1746598178168,CLRE 253,B00,907819,Staff,9999,0,9999,0
1746598179193,CLRE 259,A00,891868,Patel; Hemal,9998,0,9999,1
1746598180226,CLRE 260,A00,891872,Cuomo; Raphael Eduardo,9999,0,9999,0
1746598181252,CLRE 297,001,891888,Cuomo; Raphael Eduardo,9999,0,9999,0
1746598182278,CSE 191,A00,958773,Minnes Kemp; Mor Mia,9995,0,9999,4
1746598183303,CSE 197,001,959846,Minnes Kemp; Mor Mia,9990,0,9999,9
1746598184330,CSS 201S,A01,892054,Mignozzetti; Umberto,25,0,30,5
1746598185357,CSS 202S,A01,892056,Mignozzetti; Umberto,25,0,30,5
1746598186391,DSC 197,001,956898,Eldridge; Justin Matthew,9996,0,9999,3
1746598187416,DSC 297,001,958000,Mazumdar; Arya,9998,0,9999,1
1746598187416,DSC 297,002,959862,Wang; Yusu,9998,0,9999,1
1746598188442,EAP 100,A00,905686,Staff,9778,0,9999,221
1746598189470,ECE 45,A01,892618,Staff,0,0,65,65
1746598191525,ECE 111,A01,892719,Staff,6,0,65,59
1746598192555,ECE 197,001,957920,Mercier; Patrick Philip,9991,0,9999,8
1746598193580,ECON 178,A01,907814,Zhu; Ying,26,0,35,9
1746598194616,EDS 115,A00,895312,Staff,35,0,45,10
1746598195642,EDS 117,A01,895337,Staff,23,0,30,7
1746598196680,EDS 125,A00,895341,Jones; Gabrielle Anastasia,36,0,45,9
1746598197785,EDS 128A,A01,895459,Fargason; Sharon Gayle,44,0,45,1
1746598198809,EDS 128B,A01,895543,Pappas; Elizabeth,44,0,45,1
1746598199837,EDS 139,A00,897203,Pappas; Elizabeth,44,0,45,1
1746598199837,EDS 139,B00,897209,Fargason; Sharon Gayle,41,0,45,4
1746598200865,EDS 201,A00,895545,Staff,22,0,45,23
1746598201891,EDS 203,A01,895581,Halter; Christopher P.,22,0,45,23
1746598202918,EDS 204R,A01,895625,Heinzman; Erica M.,39,0,45,6
1746598202918,EDS 204R,B01,895693,Halter; Christopher P.,10,0,45,35
1746598203947,EDS 206R,A00,895694,Fargason; Sharon Gayle,1,0,30,29
1746598203947,EDS 206R,B00,895695,Choi; Bailey Miyeon,16,0,30,14
1746598204980,EDS 250,A00,895697,Hemans; Patricia Ann Benitez,22,0,45,23
1746598206010,EDS 281,A00,895701,Meyerott; Theresa Ann,1,0,15,14
1746598207036,EDS 284,A00,895736,Meyerott; Theresa Ann,1,0,15,14
1746598208062,EDS 286,A00,897210,Fine; Sarah,0,0,15,15
1746598209089,EDS 289C,A01,895770,Daly; Alan J.,1,0,15,14
1746598210115,EDS 290,A00,897211,Hofstetter; Carolyn,0,0,15,15
1746598211147,LIGM 5A,A00,896162,Fischer-Grunski; Eva K,12,0,20,8
1746598212173,LIGM 5B,A00,896260,Fischer-Grunski; Eva K,17,0,20,3
1746598213198,LIGM 5C,A00,896308,Fischer-Grunski; Eva K,18,0,20,2
1746598214223,LIIT 5AS,A00,896313,Carnelos; Chiara,18,0,20,2
1746598215253,LIIT 5BS,A00,896416,Carnelos; Chiara,20,0,20,0
1746598216281,LIIT 5CS,A00,896564,Carnelos; Chiara,20,0,20,0
1746598217306,LISP 5A,A00,896588,Munoz Sanchez; Alicia,2,0,20,18
1746598218335,LISP 5B,A00,896653,Munoz Sanchez; Alicia,7,0,20,13
1746598219359,LISP 5C,A00,896655,Munoz Sanchez; Alicia,0,1,20,20
1746598220389,MAE 197,001,957918,Kleissl; Jan,9996,0,9999,3
1746598220389,MAE 197,002,959806,Boechler; Nicholas Sebastia,9998,0,9999,1
1746598220389,MAE 197,003,959852,Mullin; Jennifer S,9998,0,9999,1
1746598221415,MATH 2,A01,957937,Staff,33,0,35,2
1746598222441,MATH 197,001,957876,Kedlaya; Kiran S.,9993,0,9999,6
1746598223467,MCWP 40,A00,892729,Duru; Nur,10,0,20,10
1746598223467,MCWP 40,B00,893304,Montejo; Carolina,14,0,20,6
1746598224493,MCWP 40R,A00,893757,Redela; Pamela Morgan,0,5,20,20
1746598225519,MCWP 50,A00,893758,Morshed; Michael James,0,0,20,20
1746598225519,MCWP 50,B00,893761,Bartulis; Jason Michael,17,0,20,3
1746598226545,MCWP 50R,A00,893766,Compas; Sean Matthew,0,1,20,20
1746598226545,MCWP 50R,B00,893769,Carter; Jennifer A,0,1,20,20
1746598226545,MCWP 50R,C00,893771,Krone; Jarret,0,3,20,20
1746598226545,MCWP 50R,D00,893772,Miller; Elizabeth Deen,0,0,20,20
1746598226545,MCWP 50R,E00,893775,Carter; Andrea L,0,1,20,20
1746598227574,MMW 11R,A01,892721,Herbst; Matthew,14,0,30,16
1746598227574,MMW 11R,A02,892722,Herbst; Matthew,0,0,0,3
1746598228604,MMW 12R,A01,892724,Herbst; Matthew,0,11,16,16
1746598228604,MMW 12R,A02,892725,Herbst; Matthew,0,10,16,16
1746598229631,MMW 13R,A01,892727,Staff,0,4,16,16
1746598229631,MMW 13R,A02,892728,Staff,0,4,16,16
1746598229631,MMW 13R,A03,958032,Staff,0,4,16,16
1746598229631,MMW 13R,A04,958033,Staff,0,4,16,16
1746598229631,MMW 13R,A05,958034,Staff,0,4,16,16
1746598230660,SIO 295LS,A00,894015,Staff,5,0,25,20
1746598231687,SIO 295S,A00,894020,Staff,5,0,25,20
1746598232716,SIOC 290S,B01,958918,Merrifield; Mark A,14,0,30,16
1746598233742,SIOC 291S,B01,958922,Gabriel; Corey John,14,0,30,16
1746598234774,SOCI 117,A01,895339,Staff,2,0,5,3
1746598235801,WES 237B,A00,894149,Staff,11,0,20,9
1746598238074,AESE 279B,A00,891859,Staff,13,0,35,22
1746598239101,AIP 197,001,891854,Vespa; Emanuel Ignacio,9999,0,9999,0
1746598240127,ANTH 289S,A00,891856,Gagneux; Pascal,12,0,12,0
1746598241152,BENG 196,001,957946,Engler; Adam J.,9996,0,9999,3
1746598242179,BISP 197,001,959851,Wilhelm; James E.,9998,0,9999,1
1746598243204,CAT 124RS,A01,956906,Staff,6,0,25,19
1746598244232,CAT 125RS,A01,922013,Staff,6,0,25,19
1746598245258,CLRE 250,A00,891860,Morris; Sheldon,9995,0,9999,4
1746598247307,CLRE 251R,A00,907817,Mehta; Ravindra L.,9994,0,9999,5
1746598248332,CLRE 252,A00,891864,Cuomo; Raphael Eduardo,9993,0,9999,6
1746598249356,CLRE 253,A00,891867,Vaida; Florin,9994,0,9999,5
1746598249356,CLRE 253,B00,907819,Staff,9999,0,9999,0
1746598250385,CLRE 259,A00,891868,Patel; Hemal,9998,0,9999,1
1746598251412,CLRE 260,A00,891872,Cuomo; Raphael Eduardo,9999,0,9999,0
1746598252437,CLRE 297,001,891888,Cuomo; Raphael Eduardo,9999,0,9999,0
1746598253465,CSE 191,A00,958773,Minnes Kemp; Mor Mia,9995,0,9999,4
1746598254491,CSE 197,001,959846,Minnes Kemp; Mor Mia,9990,0,9999,9
1746598255516,CSS 201S,A01,892054,Mignozzetti; Umberto,25,0,30,5
1746598256541,CSS 202S,A01,892056,Mignozzetti; Umberto,25,0,30,5
1746598257571,DSC 197,001,956898,Eldridge; Justin Matthew,9996,0,9999,3
1746598258597,DSC 297,001,958000,Mazumdar; Arya,9998,0,9999,1
1746598258597,DSC 297,002,959862,Wang; Yusu,9998,0,9999,1
1746598259621,EAP 100,A00,905686,Staff,9778,0,9999,221
1746598260647,ECE 45,A01,892618,Staff,0,0,65,65
1746598262700,ECE 111,A01,892719,Staff,6,0,65,59
1746598263724,ECE 197,001,957920,Mercier; Patrick Philip,9991,0,9999,8
1746598264749,ECON 178,A01,907814,Zhu; Ying,26,0,35,9
1746598265774,EDS 115,A00,895312,Staff,35,0,45,10
1746598266801,EDS 117,A01,895337,Staff,23,0,30,7
1746598267829,EDS 125,A00,895341,Jones; Gabrielle Anastasia,36,0,45,9
1746598268854,EDS 128A,A01,895459,Fargason; Sharon Gayle,44,0,45,1
1746598269882,EDS 128B,A01,895543,Pappas; Elizabeth,44,0,45,1
1746598270908,EDS 139,A00,897203,Pappas; Elizabeth,44,0,45,1
1746598270908,EDS 139,B00,897209,Fargason; Sharon Gayle,41,0,45,4
1746598271934,EDS 201,A00,895545,Staff,22,0,45,23
1746598272958,EDS 203,A01,895581,Halter; Christopher P.,22,0,45,23
1746598273987,EDS 204R,A01,895625,Heinzman; Erica M.,39,0,45,6
1746598273987,EDS 204R,B01,895693,Halter; Christopher P.,10,0,45,35
1746598275017,EDS 206R,A00,895694,Fargason; Sharon Gayle,1,0,30,29
1746598275017,EDS 206R,B00,895695,Choi; Bailey Miyeon,16,0,30,14
1746598276043,EDS 250,A00,895697,Hemans; Patricia Ann Benitez,22,0,45,23
1746598277068,EDS 281,A00,895701,Meyerott; Theresa Ann,1,0,15,14
1746598278098,EDS 284,A00,895736,Meyerott; Theresa Ann,1,0,15,14
1746598279124,EDS 286,A00,897210,Fine; Sarah,0,0,15,15
1746598280148,EDS 289C,A01,895770,Daly; Alan J.,1,0,15,14
1746598281172,EDS 290,A00,897211,Hofstetter; Carolyn,0,0,15,15
1746598282199,LIGM 5A,A00,896162,Fischer-Grunski; Eva K,12,0,20,8
1746598283224,LIGM 5B,A00,896260,Fischer-Grunski; Eva K,17,0,20,3
1746598284250,LIGM 5C,A00,896308,Fischer-Grunski; Eva K,18,0,20,2
1746598285279,LIIT 5AS,A00,896313,Carnelos; Chiara,18,0,20,2
1746598286308,LIIT 5BS,A00,896416,Carnelos; Chiara,20,0,20,0
1746598287333,LIIT 5CS,A00,896564,Carnelos; Chiara,20,0,20,0
1746598288361,LISP 5A,A00,896588,Munoz Sanchez; Alicia,2,0,20,18
1746598289392,LISP 5B,A00,896653,Munoz Sanchez; Alicia,7,0,20,13
1746598290418,LISP 5C,A00,896655,Munoz Sanchez; Alicia,0,1,20,20
1746598291444,MAE 197,001,957918,Kleissl; Jan,9996,0,9999,3
1746598291444,MAE 197,002,959806,Boechler; Nicholas Sebastia,9998,0,9999,1
1746598291444,MAE 197,003,959852,Mullin; Jennifer S,9998,0,9999,1
1746598292471,MATH 2,A01,957937,Staff,33,0,35,2
1746598293497,MATH 197,001,957876,Kedlaya; Kiran S.,9993,0,9999,6
1746598294527,MCWP 40,A00,892729,Duru; Nur,10,0,20,10
1746598294527,MCWP 40,B00,893304,Montejo; Carolina,14,0,20,6
1746598295554,MCWP 40R,A00,893757,Redela; Pamela Morgan,0,5,20,20
1746598296585,MCWP 50,A00,893758,Morshed; Michael James,0,0,20,20
1746598296585,MCWP 50,B00,893761,Bartulis; Jason Michael,17,0,20,3
1746598297611,MCWP 50R,A00,893766,Compas; Sean Matthew,0,1,20,20
1746598297611,MCWP 50R,B00,893769,Carter; Jennifer A,0,1,20,20
1746598297611,MCWP 50R,C00,893771,Krone; Jarret,0,3,20,20
1746598297611,MCWP 50R,D00,893772,Miller; Elizabeth Deen,0,0,20,20
1746598297611,MCWP 50R,E00,893775,Carter; Andrea L,0,1,20,20
1746598298636,MMW 11R,A01,892721,Herbst; Matthew,14,0,30,16
1746598298636,MMW 11R,A02,892722,Herbst; Matthew,0,0,0,3
1746598299661,MMW 12R,A01,892724,Herbst; Matthew,0,11,16,16
1746598299661,MMW 12R,A02,892725,Herbst; Matthew,0,10,16,16
1746598300687,MMW 13R,A01,892727,Staff,0,4,16,16
1746598300687,MMW 13R,A02,892728,Staff,0,4,16,16
1746598300687,MMW 13R,A03,958032,Staff,0,4,16,16
1746598300687,MMW 13R,A04,958033,Staff,0,4,16,16
1746598300687,MMW 13R,A05,958034,Staff,0,4,16,16
1746598301713,SIO 295LS,A00,894015,Staff,5,0,25,20
1746598302738,SIO 295S,A00,894020,Staff,5,0,25,20
1746598303769,SIOC 290S,B01,958918,Merrifield; Mark A,14,0,30,16
1746598304795,SIOC 291S,B01,958922,Gabriel; Corey John,14,0,30,16
1746598305820,SOCI 117,A01,895339,Staff,2,0,5,3
1746598306849,WES 237B,A00,894149,Staff,11,0,20,9
1746598308903,AESE 279B,A00,891859,Staff,13,0,35,22
1746598309929,AIP 197,001,891854,Vespa; Emanuel Ignacio,9999,0,9999,0
1746598310957,ANTH 289S,A00,891856,Gagneux; Pascal,12,0,12,0
1746598311983,BENG 196,001,957946,Engler; Adam J.,9996,0,9999,3
1746598313011,BISP 197,001,959851,Wilhelm; James E.,9998,0,9999,1
1746598314036,CAT 124RS,A01,956906,Staff,6,0,25,19
1746598315062,CAT 125RS,A01,922013,Staff,6,0,25,19
1746598316087,CLRE 250,A00,891860,Morris; Sheldon,9995,0,9999,4
1746598318139,CLRE 251R,A00,907817,Mehta; Ravindra L.,9994,0,9999,5
1746598319168,CLRE 252,A00,891864,Cuomo; Raphael Eduardo,9993,0,9999,6
1746598320194,CLRE 253,A00,891867,Vaida; Florin,9994,0,9999,5
1746598320194,CLRE 253,B00,907819,Staff,9999,0,9999,0
1746598321218,CLRE 259,A00,891868,Patel; Hemal,9998,0,9999,1
1746598322244,CLRE 260,A00,891872,Cuomo; Raphael Eduardo,9999,0,9999,0
1746598323270,CLRE 297,001,891888,Cuomo; Raphael Eduardo,9999,0,9999,0
1746598324300,CSE 191,A00,958773,Minnes Kemp; Mor Mia,9995,0,9999,4
1746598325325,CSE 197,001,959846,Minnes Kemp; Mor Mia,9990,0,9999,9
1746598326356,CSS 201S,A01,892054,Mignozzetti; Umberto,25,0,30,5
1746598327385,CSS 202S,A01,892056,Mignozzetti; Umberto,25,0,30,5
1746598328412,DSC 197,001,956898,Eldridge; Justin Matthew,9996,0,9999,3
1746598329440,DSC 297,001,958000,Mazumdar; Arya,9998,0,9999,1
1746598329440,DSC 297,002,959862,Wang; Yusu,9998,0,9999,1
1746598330464,EAP 100,A00,905686,Staff,9778,0,9999,221
1746598331532,ECE 45,A01,892618,Staff,0,0,65,65
1746598333584,ECE 111,A01,892719,Staff,6,0,65,59
1746598334617,ECE 197,001,957920,Mercier; Patrick Philip,9991,0,9999,8
1746598335642,ECON 178,A01,907814,Zhu; Ying,26,0,35,9
1746598336666,EDS 115,A00,895312,Staff,35,0,45,10
1746598337696,EDS 117,A01,895337,Staff,23,0,30,7
1746598338725,EDS 125,A00,895341,Jones; Gabrielle Anastasia,36,0,45,9
1746598339751,EDS 128A,A01,895459,Fargason; Sharon Gayle,44,0,45,1
1746598340777,EDS 128B,A01,895543,Pappas; Elizabeth,44,0,45,1
1746598341801,EDS 139,A00,897203,Pappas; Elizabeth,44,0,45,1
1746598341801,EDS 139,B00,897209,Fargason; Sharon Gayle,41,0,45,4
1746598342831,EDS 201,A00,895545,Staff,22,0,45,23
1746598343859,EDS 203,A01,895581,Halter; Christopher P.,22,0,45,23
1746598344883,EDS 204R,A01,895625,Heinzman; Erica M.,39,0,45,6
1746598344883,EDS 204R,B01,895693,Halter; Christopher P.,10,0,45,35
1746598345911,EDS 206R,A00,895694,Fargason; Sharon Gayle,1,0,30,29
1746598345911,EDS 206R,B00,895695,Choi; Bailey Miyeon,16,0,30,14
1746598346938,EDS 250,A00,895697,Hemans; Patricia Ann Benitez,22,0,45,23
1746598347964,EDS 281,A00,895701,Meyerott; Theresa Ann,1,0,15,14
1746598348991,EDS 284,A00,895736,Meyerott; Theresa Ann,1,0,15,14
1746598350015,EDS 286,A00,897210,Fine; Sarah,0,0,15,15
1746598351042,EDS 289C,A01,895770,Daly; Alan J.,1,0,15,14
1746598352070,EDS 290,A00,897211,Hofstetter; Carolyn,0,0,15,15
1746598353095,LIGM 5A,A00,896162,Fischer-Grunski; Eva K,12,0,20,8
1746598354123,LIGM 5B,A00,896260,Fischer-Grunski; Eva K,17,0,20,3
1746598355153,LIGM 5C,A00,896308,Fischer-Grunski; Eva K,18,0,20,2
1746598356178,LIIT 5AS,A00,896313,Carnelos; Chiara,18,0,20,2
1746598357205,LIIT 5BS,A00,896416,Carnelos; Chiara,20,0,20,0
1746598358231,LIIT 5CS,A00,896564,Carnelos; Chiara,20,0,20,0
1746598359261,LISP 5A,A00,896588,Munoz Sanchez; Alicia,2,0,20,18
1746598360286,LISP 5B,A00,896653,Munoz Sanchez; Alicia,7,0,20,13
1746598361314,LISP 5C,A00,896655,Munoz Sanchez; Alicia,0,1,20,20
1746598362341,MAE 197,001,957918,Kleissl; Jan,9996,0,9999,3
1746598362341,MAE 197,002,959806,Boechler; Nicholas Sebastia,9998,0,9999,1
1746598362341,MAE 197,003,959852,Mullin; Jennifer S,9998,0,9999,1
1746598363368,MATH 2,A01,957937,Staff,33,0,35,2
1746598364396,MATH 197,001,957876,Kedlaya; Kiran S.,9993,0,9999,6
1746598365424,MCWP 40,A00,892729,Duru; Nur,10,0,20,10
1746598365424,MCWP 40,B00,893304,Montejo; Carolina,14,0,20,6
1746598366450,MCWP 40R,A00,893757,Redela; Pamela Morgan,0,5,20,20
1746598367478,MCWP 50,A00,893758,Morshed; Michael James,0,0,20,20
1746598367478,MCWP 50,B00,893761,Bartulis; Jason Michael,17,0,20,3
1746598368504,MCWP 50R,A00,893766,Compas; Sean Matthew,0,1,20,20
1746598368504,MCWP 50R,B00,893769,Carter; Jennifer A,0,1,20,20
1746598368504,MCWP 50R,C00,893771,Krone; Jarret,0,3,20,20
1746598368504,MCWP 50R,D00,893772,Miller; Elizabeth Deen,0,0,20,20
1746598368504,MCWP 50R,E00,893775,Carter; Andrea L,0,1,20,20
1746598369530,MMW 11R,A01,892721,Herbst; Matthew,14,0,30,16
1746598369530,MMW 11R,A02,892722,Herbst; Matthew,0,0,0,3
1746598370558,MMW 12R,A01,892724,Herbst; Matthew,0,11,16,16
1746598370558,MMW 12R,A02,892725,Herbst; Matthew,0,10,16,16
1746598371583,MMW 13R,A01,892727,Staff,0,4,16,16
1746598371583,MMW 13R,A02,892728,Staff,0,4,16,16
1746598371583,MMW 13R,A03,958032,Staff,0,4,16,16
1746598371583,MMW 13R,A04,958033,Staff,0,4,16,16
1746598371583,MMW 13R,A05,958034,Staff,0,4,16,16
1746598372608,SIO 295LS,A00,894015,Staff,5,0,25,20
1746598373636,SIO 295S,A00,894020,Staff,5,0,25,20
1746598374667,SIOC 290S,B01,958918,Merrifield; Mark A,14,0,30,16
1746598375693,SIOC 291S,B01,958922,Gabriel; Corey John,14,0,30,16
1746598376719,SOCI 117,A01,895339,Staff,2,0,5,3
1746598377743,WES 237B,A00,894149,Staff,11,0,20,9
1746598379801,AESE 279B,A00,891859,Staff,13,0,35,22
1746598380825,AIP 197,001,891854,Vespa; Emanuel Ignacio,9999,0,9999,0
1746598381852,ANTH 289S,A00,891856,Gagneux; Pascal,12,0,12,0
1746598382877,BENG 196,001,957946,Engler; Adam J.,9996,0,9999,3
1746598383902,BISP 197,001,959851,Wilhelm; James E.,9998,0,9999,1
1746598384927,CAT 124RS,A01,956906,Staff,6,0,25,19
1746598385951,CAT 125RS,A01,922013,Staff,6,0,25,19
1746598386976,CLRE 250,A00,891860,Morris; Sheldon,9995,0,9999,4
1746598389027,CLRE 251R,A00,907817,Mehta; Ravindra L.,9994,0,9999,5
1746598390054,CLRE 252,A00,891864,Cuomo; Raphael Eduardo,9993,0,9999,6
1746598391079,CLRE 253,A00,891867,Vaida; Florin,9994,0,9999,5
1746598391079,CLRE 253,B00,907819,Staff,9999,0,9999,0
1746598392108,CLRE 259,A00,891868,Patel; Hemal,9998,0,9999,1
1746598393135,CLRE 260,A00,891872,Cuomo; Raphael Eduardo,9999,0,9999,0
1746598394161,CLRE 297,001,891888,Cuomo; Raphael Eduardo,9999,0,9999,0
1746598395185,CSE 191,A00,958773,Minnes Kemp; Mor Mia,9995,0,9999,4
1746598396211,CSE 197,001,959846,Minnes Kemp; Mor Mia,9990,0,9999,9
1746598397236,CSS 201S,A01,892054,Mignozzetti; Umberto,25,0,30,5
1746598398266,CSS 202S,A01,892056,Mignozzetti; Umberto,25,0,30,5
1746598399294,DSC 197,001,956898,Eldridge; Justin Matthew,9996,0,9999,3
1746598400320,DSC 297,001,958000,Mazumdar; Arya,9998,0,9999,1
1746598400320,DSC 297,002,959862,Wang; Yusu,9998,0,9999,1
1746598401344,EAP 100,A00,905686,Staff,9778,0,9999,221
1746598402369,ECE 45,A01,892618,Staff,0,0,65,65
1746598404423,ECE 111,A01,892719,Staff,6,0,65,59
1746598405447,ECE 197,001,957920,Mercier; Patrick Philip,9991,0,9999,8
1746598406472,ECON 178,A01,907814,Zhu; Ying,26,0,35,9
1746598407498,EDS 115,A00,895312,Staff,35,0,45,10
1746598408523,EDS 117,A01,895337,Staff,23,0,30,7
1746598409551,EDS 125,A00,895341,Jones; Gabrielle Anastasia,36,0,45,9
1746598410581,EDS 128A,A01,895459,Fargason; Sharon Gayle,44,0,45,1
1746598411608,EDS 128B,A01,895543,Pappas; Elizabeth,44,0,45,1
1746598412635,EDS 139,A00,897203,Pappas; Elizabeth,44,0,45,1
1746598412635,EDS 139,B00,897209,Fargason; Sharon Gayle,41,0,45,4
1746598413661,EDS 201,A00,895545,Staff,22,0,45,23
1746598414688,EDS 203,A01,895581,Halter; Christopher P.,22,0,45,23
1746598415715,EDS 204R,A01,895625,Heinzman; Erica M.,39,0,45,6
1746598415715,EDS 204R,B01,895693,Halter; Christopher P.,10,0,45,35
1746598416744,EDS 206R,A00,895694,Fargason; Sharon Gayle,1,0,30,29
1746598416744,EDS 206R,B00,895695,Choi; Bailey Miyeon,16,0,30,14
1746598417769,EDS 250,A00,895697,Hemans; Patricia Ann Benitez,22,0,45,23
1746598418793,EDS 281,A00,895701,Meyerott; Theresa Ann,1,0,15,14
1746598419820,EDS 284,A00,895736,Meyerott; Theresa Ann,1,0,15,14
1746598420848,EDS 286,A00,897210,Fine; Sarah,0,0,15,15
1746598421875,EDS 289C,A01,895770,Daly; Alan J.,1,0,15,14
1746598422900,EDS 290,A00,897211,Hofstetter; Carolyn,0,0,15,15
1746598423930,LIGM 5A,A00,896162,Fischer-Grunski; Eva K,12,0,20,8
1746598424959,LIGM 5B,A00,896260,Fischer-Grunski; Eva K,17,0,20,3
1746598425987,LIGM 5C,A00,896308,Fischer-Grunski; Eva K,18,0,20,2
1746598427012,LIIT 5AS,A00,896313,Carnelos; Chiara,18,0,20,2
1746598428037,LIIT 5BS,A00,896416,Carnelos; Chiara,20,0,20,0
1746598429064,LIIT 5CS,A00,896564,Carnelos; Chiara,20,0,20,0
1746598430094,LISP 5A,A00,896588,Munoz Sanchez; Alicia,2,0,20,18
1746598431122,LISP 5B,A00,896653,Munoz Sanchez; Alicia,7,0,20,13
1746598432146,LISP 5C,A00,896655,Munoz Sanchez; Alicia,0,1,20,20
1746598433179,MAE 197,001,957918,Kleissl; Jan,9996,0,9999,3
1746598433179,MAE 197,002,959806,Boechler; Nicholas Sebastia,9998,0,9999,1
1746598433179,MAE 197,003,959852,Mullin; Jennifer S,9998,0,9999,1
1746598434204,MATH 2,A01,957937,Staff,33,0,35,2
1746598435231,MATH 197,001,957876,Kedlaya; Kiran S.,9993,0,9999,6
1746598436260,MCWP 40,A00,892729,Duru; Nur,10,0,20,10
1746598436260,MCWP 40,B00,893304,Montejo; Carolina,14,0,20,6
1746598437287,MCWP 40R,A00,893757,Redela; Pamela Morgan,0,5,20,20
1746598438316,MCWP 50,A00,893758,Morshed; Michael James,0,0,20,20
1746598438316,MCWP 50,B00,893761,Bartulis; Jason Michael,17,0,20,3
1746598439342,MCWP 50R,A00,893766,Compas; Sean Matthew,0,1,20,20
1746598439342,MCWP 50R,B00,893769,Carter; Jennifer A,0,1,20,20
1746598439342,MCWP 50R,C00,893771,Krone; Jarret,0,3,20,20
1746598439342,MCWP 50R,D00,893772,Miller; Elizabeth Deen,0,0,20,20
1746598439342,MCWP 50R,E00,893775,Carter; Andrea L,0,1,20,20
1746598440367,MMW 11R,A01,892721,Herbst; Matthew,14,0,30,16
1746598440367,MMW 11R,A02,892722,Herbst; Matthew,0,0,0,3
1746598441395,MMW 12R,A01,892724,Herbst; Matthew,0,11,16,16
1746598441395,MMW 12R,A02,892725,Herbst; Matthew,0,10,16,16
1746598442424,MMW 13R,A01,892727,Staff,0,4,16,16
1746598442424,MMW 13R,A02,892728,Staff,0,4,16,16
1746598442424,MMW 13R,A03,958032,Staff,0,4,16,16
1746598442424,MMW 13R,A04,958033,Staff,0,4,16,16
1746598442424,MMW 13R,A05,958034,Staff,0,4,16,16
1746598443452,SIO 295LS,A00,894015,Staff,5,0,25,20
1746598444477,SIO 295S,A00,894020,Staff,5,0,25,20
1746598445505,SIOC 290S,B01,958918,Merrifield; Mark A,14,0,30,16
1746598446535,SIOC 291S,B01,958922,Gabriel; Corey John,14,0,30,16
1746598447560,SOCI 117,A01,895339,Staff,2,0,5,3
1746598448587,WES 237B,A00,894149,Staff,11,0,20,9
1746598450651,AESE 279B,A00,891859,Staff,13,0,35,22
1746598451675,AIP 197,001,891854,Vespa; Emanuel Ignacio,9999,0,9999,0
1746598452700,ANTH 289S,A00,891856,Gagneux; Pascal,12,0,12,0
1746598453724,BENG 196,001,957946,Engler; Adam J.,9996,0,9999,3
1746598454751,BISP 197,001,959851,Wilhelm; James E.,9998,0,9999,1
1746598455778,CAT 124RS,A01,956906,Staff,6,0,25,19
1746598456802,CAT 125RS,A01,922013,Staff,6,0,25,19
1746598457829,CLRE 250,A00,891860,Morris; Sheldon,9995,0,9999,4
1746598459904,CLRE 251R,A00,907817,Mehta; Ravindra L.,9994,0,9999,5
1746598460934,CLRE 252,A00,891864,Cuomo; Raphael Eduardo,9993,0,9999,6
1746598461962,CLRE 253,A00,891867,Vaida; Florin,9994,0,9999,5
1746598461962,CLRE 253,B00,907819,Staff,9999,0,9999,0
1746598462987,CLRE 259,A00,891868,Patel; Hemal,9998,0,9999,1
1746598464011,CLRE 260,A00,891872,Cuomo; Raphael Eduardo,9999,0,9999,0
1746598465037,CLRE 297,001,891888,Cuomo; Raphael Eduardo,9999,0,9999,0
1746598466063,CSE 191,A00,958773,Minnes Kemp; Mor Mia,9995,0,9999,4
1746598467089,CSE 197,001,959846,Minnes Kemp; Mor Mia,9990,0,9999,9
1746598468115,CSS 201S,A01,892054,Mignozzetti; Umberto,25,0,30,5
1746598469140,CSS 202S,A01,892056,Mignozzetti; Umberto,25,0,30,5
1746598470165,DSC 197,001,956898,Eldridge; Justin Matthew,9996,0,9999,3
1746598471190,DSC 297,001,958000,Mazumdar; Arya,9998,0,9999,1
1746598471190,DSC 297,002,959862,Wang; Yusu,9998,0,9999,1
1746598472216,EAP 100,A00,905686,Staff,9778,0,9999,221
1746598473243,ECE 45,A01,892618,Staff,0,0,65,65
1746598475293,ECE 111,A01,892719,Staff,6,0,65,59
1746598476321,ECE 197,001,957920,Mercier; Patrick Philip,9991,0,9999,8
1746598477346,ECON 178,A01,907814,Zhu; Ying,26,0,35,9
1746598478372,EDS 115,A00,895312,Staff,35,0,45,10
1746598479397,EDS 117,A01,895337,Staff,23,0,30,7
1746598480444,EDS 125,A00,895341,Jones; Gabrielle Anastasia,36,0,45,9
1746598481469,EDS 128A,A01,895459,Fargason; Sharon Gayle,44,0,45,1
1746598482496,EDS 128B,A01,895543,Pappas; Elizabeth,44,0,45,1
1746598483521,EDS 139,A00,897203,Pappas; Elizabeth,44,0,45,1
1746598483521,EDS 139,B00,897209,Fargason; Sharon Gayle,41,0,45,4
1746598484547,EDS 201,A00,895545,Staff,22,0,45,23
1746598485572,EDS 203,A01,895581,Halter; Christopher P.,22,0,45,23
1746598486655,EDS 204R,A01,895625,Heinzman; Erica M.,39,0,45,6
1746598486655,EDS 204R,B01,895693,Halter; Christopher P.,10,0,45,35
1746598487683,EDS 206R,A00,895694,Fargason; Sharon Gayle,1,0,30,29
1746598487683,EDS 206R,B00,895695,Choi; Bailey Miyeon,16,0,30,14
1746598488709,EDS 250,A00,895697,Hemans; Patricia Ann Benitez,22,0,45,23
1746598489732,EDS 281,A00,895701,Meyerott; Theresa Ann,1,0,15,14
1746598490762,EDS 284,A00,895736,Meyerott; Theresa Ann,1,0,15,14
1746598491787,EDS 286,A00,897210,Fine; Sarah,0,0,15,15
1746598492811,EDS 289C,A01,895770,Daly; Alan J.,1,0,15,14
1746598493839,EDS 290,A00,897211,Hofstetter; Carolyn,0,0,15,15
1746598494868,LIGM 5A,A00,896162,Fischer-Grunski; Eva K,12,0,20,8
1746598495896,LIGM 5B,A00,896260,Fischer-Grunski; Eva K,17,0,20,3
1746598496921,LIGM 5C,A00,896308,Fischer-Grunski; Eva K,18,0,20,2
1746598497947,LIIT 5AS,A00,896313,Carnelos; Chiara,18,0,20,2
1746598498972,LIIT 5BS,A00,896416,Carnelos; Chiara,20,0,20,0
1746598500000,LIIT 5CS,A00,896564,Carnelos; Chiara,20,0,20,0
1746598501025,LISP 5A,A00,896588,Munoz Sanchez; Alicia,2,0,20,18
1746598502050,LISP 5B,A00,896653,Munoz Sanchez; Alicia,7,0,20,13
1746598503079,LISP 5C,A00,896655,Munoz Sanchez; Alicia,0,1,20,20
1746598504104,MAE 197,001,957918,Kleissl; Jan,9996,0,9999,3
1746598504104,MAE 197,002,959806,Boechler; Nicholas Sebastia,9998,0,9999,1
1746598504104,MAE 197,003,959852,Mullin; Jennifer S,9998,0,9999,1
1746598505131,MATH 2,A01,957937,Staff,33,0,35,2
1746598506156,MATH 197,001,957876,Kedlaya; Kiran S.,9993,0,9999,6
1746598507181,MCWP 40,A00,892729,Duru; Nur,10,0,20,10
1746598507181,MCWP 40,B00,893304,Montejo; Carolina,14,0,20,6
1746598508209,MCWP 40R,A00,893757,Redela; Pamela Morgan,0,5,20,20
1746598509237,MCWP 50,A00,893758,Morshed; Michael James,0,0,20,20
1746598509237,MCWP 50,B00,893761,Bartulis; Jason Michael,17,0,20,3
1746598510267,MCWP 50R,A00,893766,Compas; Sean Matthew,0,1,20,20
1746598510267,MCWP 50R,B00,893769,Carter; Jennifer A,0,1,20,20
1746598510267,MCWP 50R,C00,893771,Krone; Jarret,0,3,20,20
1746598510267,MCWP 50R,D00,893772,Miller; Elizabeth Deen,0,0,20,20
1746598510267,MCWP 50R,E00,893775,Carter; Andrea L,0,1,20,20
1746598511295,MMW 11R,A01,892721,Herbst; Matthew,14,0,30,16
1746598511295,MMW 11R,A02,892722,Herbst; Matthew,0,0,0,3
1746598512322,MMW 12R,A01,892724,Herbst; Matthew,0,11,16,16
1746598512322,MMW 12R,A02,892725,Herbst; Matthew,0,10,16,16
1746598513352,MMW 13R,A01,892727,Staff,0,4,16,16
1746598513352,MMW 13R,A02,892728,Staff,0,4,16,16
1746598513352,MMW 13R,A03,958032,Staff,0,4,16,16
1746598513352,MMW 13R,A04,958033,Staff,0,4,16,16
1746598513352,MMW 13R,A05,958034,Staff,0,4,16,16
1746598514378,SIO 295LS,A00,894015,Staff,5,0,25,20
1746598515402,SIO 295S,A00,894020,Staff,5,0,25,20
1746598516428,SIOC 290S,B01,958918,Merrifield; Mark A,14,0,30,16
1746598517454,SIOC 291S,B01,958922,Gabriel; Corey John,14,0,30,16
1746598518519,SOCI 117,A01,895339,Staff,2,0,5,3
1746598519544,WES 237B,A00,894149,Staff,11,0,20,9
1746598521612,AESE 279B,A00,891859,Staff,13,0,35,22
1746598522636,AIP 197,001,891854,Vespa; Emanuel Ignacio,9999,0,9999,0
1746598523661,ANTH 289S,A00,891856,Gagneux; Pascal,12,0,12,0
1746598524689,BENG 196,001,957946,Engler; Adam J.,9996,0,9999,3
1746598525714,BISP 197,001,959851,Wilhelm; James E.,9998,0,9999,1
1746598526738,CAT 124RS,A01,956906,Staff,6,0,25,19
1746598527766,CAT 125RS,A01,922013,Staff,6,0,25,19
1746598528791,CLRE 250,A00,891860,Morris; Sheldon,9995,0,9999,4
1746598530843,CLRE 251R,A00,907817,Mehta; Ravindra L.,9994,0,9999,5
1746598531870,CLRE 252,A00,891864,Cuomo; Raphael Eduardo,9993,0,9999,6
1746598532895,CLRE 253,A00,891867,Vaida; Florin,9994,0,9999,5
1746598532895,CLRE 253,B00,907819,Staff,9999,0,9999,0
1746598533921,CLRE 259,A00,891868,Patel; Hemal,9998,0,9999,1
1746598534946,CLRE 260,A00,891872,Cuomo; Raphael Eduardo,9999,0,9999,0
1746598535970,CLRE 297,001,891888,Cuomo; Raphael Eduardo,9999,0,9999,0
1746598536997,CSE 191,A00,958773,Minnes Kemp; Mor Mia,9995,0,9999,4
1746598538022,CSE 197,001,959846,Minnes Kemp; Mor Mia,9990,0,9999,9
1746598539047,CSS 201S,A01,892054,Mignozzetti; Umberto,25,0,30,5
1746598540076,CSS 202S,A01,892056,Mignozzetti; Umberto,25,0,30,5
1746598541103,DSC 197,001,956898,Eldridge; Justin Matthew,9996,0,9999,3
1746598542127,DSC 297,001,958000,Mazumdar; Arya,9998,0,9999,1
1746598542127,DSC 297,002,959862,Wang; Yusu,9998,0,9999,1
1746598543158,EAP 100,A00,905686,Staff,9778,0,9999,221
1746598544183,ECE 45,A01,892618,Staff,0,0,65,65
1746598546235,ECE 111,A01,892719,Staff,6,0,65,59
1746598547259,ECE 197,001,957920,Mercier; Patrick Philip,9991,0,9999,8
1746598548289,ECON 178,A01,907814,Zhu; Ying,26,0,35,9
1746598549313,EDS 115,A00,895312,Staff,35,0,45,10
1746598550339,EDS 117,A01,895337,Staff,23,0,30,7
1746598551365,EDS 125,A00,895341,Jones; Gabrielle Anastasia,36,0,45,9
1746598552390,EDS 128A,A01,895459,Fargason; Sharon Gayle,44,0,45,1
1746598553416,EDS 128B,A01,895543,Pappas; Elizabeth,44,0,45,1
1746598554443,EDS 139,A00,897203,Pappas; Elizabeth,44,0,45,1
1746598554443,EDS 139,B00,897209,Fargason; Sharon Gayle,41,0,45,4
1746598555470,EDS 201,A00,895545,Staff,22,0,45,23
1746598556494,EDS 203,A01,895581,Halter; Christopher P.,22,0,45,23
1746598557520,EDS 204R,A01,895625,Heinzman; Erica M.,39,0,45,6
1746598557520,EDS 204R,B01,895693,Halter; Christopher P.,10,0,45,35
1746598558545,EDS 206R,A00,895694,Fargason; Sharon Gayle,1,0,30,29
1746598558545,EDS 206R,B00,895695,Choi; Bailey Miyeon,16,0,30,14
1746598559569,EDS 250,A00,895697,Hemans; Patricia Ann Benitez,22,0,45,23
1746598560599,EDS 281,A00,895701,Meyerott; Theresa Ann,1,0,15,14
1746598561628,EDS 284,A00,895736,Meyerott; Theresa Ann,1,0,15,14
1746598562654,EDS 286,A00,897210,Fine; Sarah,0,0,15,15
1746598563679,EDS 289C,A01,895770,Daly; Alan J.,1,0,15,14
1746598564704,EDS 290,A00,897211,Hofstetter; Carolyn,0,0,15,15
1746598565730,LIGM 5A,A00,896162,Fischer-Grunski; Eva K,12,0,20,8
1746598566757,LIGM 5B,A00,896260,Fischer-Grunski; Eva K,17,0,20,3
1746598567786,LIGM 5C,A00,896308,Fischer-Grunski; Eva K,18,0,20,2
1746598568811,LIIT 5AS,A00,896313,Carnelos; Chiara,18,0,20,2
1746598569836,LIIT 5BS,A00,896416,Carnelos; Chiara,20,0,20,0
1746598570864,LIIT 5CS,A00,896564,Carnelos; Chiara,20,0,20,0
1746598571892,LISP 5A,A00,896588,Munoz Sanchez; Alicia,2,0,20,18
1746598572919,LISP 5B,A00,896653,Munoz Sanchez; Alicia,7,0,20,13
1746598573945,LISP 5C,A00,896655,Munoz Sanchez; Alicia,0,1,20,20
1746598574969,MAE 197,001,957918,Kleissl; Jan,9996,0,9999,3
1746598574969,MAE 197,002,959806,Boechler; Nicholas Sebastia,9998,0,9999,1
1746598574969,MAE 197,003,959852,Mullin; Jennifer S,9998,0,9999,1
1746598575994,MATH 2,A01,957937,Staff,33,0,35,2
1746598577019,MATH 197,001,957876,Kedlaya; Kiran S.,9993,0,9999,6
1746598578046,MCWP 40,A00,892729,Duru; Nur,10,0,20,10
1746598578046,MCWP 40,B00,893304,Montejo; Carolina,14,0,20,6
1746598579088,MCWP 40R,A00,893757,Redela; Pamela Morgan,0,5,20,20
1746598580116,MCWP 50,A00,893758,Morshed; Michael James,0,0,20,20
1746598580116,MCWP 50,B00,893761,Bartulis; Jason Michael,17,0,20,3
1746598581144,MCWP 50R,A00,893766,Compas; Sean Matthew,0,1,20,20
1746598581144,MCWP 50R,B00,893769,Carter; Jennifer A,0,1,20,20
1746598581144,MCWP 50R,C00,893771,Krone; Jarret,0,3,20,20
1746598581144,MCWP 50R,D00,893772,Miller; Elizabeth Deen,0,0,20,20
1746598581144,MCWP 50R,E00,893775,Carter; Andrea L,0,1,20,20
1746598582171,MMW 11R,A01,892721,Herbst; Matthew,14,0,30,16
1746598582171,MMW 11R,A02,892722,Herbst; Matthew,0,0,0,3
1746598583196,MMW 12R,A01,892724,Herbst; Matthew,0,11,16,16
1746598583196,MMW 12R,A02,892725,Herbst; Matthew,0,10,16,16
1746598584223,MMW 13R,A01,892727,Staff,0,4,16,16
1746598584223,MMW 13R,A02,892728,Staff,0,4,16,16
1746598584223,MMW 13R,A03,958032,Staff,0,4,16,16
1746598584223,MMW 13R,A04,958033,Staff,0,4,16,16
1746598584223,MMW 13R,A05,958034,Staff,0,4,16,16
1746598585251,SIO 295LS,A00,894015,Staff,5,0,25,20
1746598586275,SIO 295S,A00,894020,Staff,5,0,25,20
1746598587301,SIOC 290S,B01,958918,Merrifield; Mark A,14,0,30,16
1746598588330,SIOC 291S,B01,958922,Gabriel; Corey John,14,0,30,16
1746598589355,SOCI 117,A01,895339,Staff,2,0,5,3
1746598590378,WES 237B,A00,894149,Staff,11,0,20,9
1746598592443,AESE 279B,A00,891859,Staff,13,0,35,22
1746598593471,AIP 197,001,891854,Vespa; Emanuel Ignacio,9999,0,9999,0
1746598594496,ANTH 289S,A00,891856,Gagneux; Pascal,12,0,12,0
1746598595523,BENG 196,001,957946,Engler; Adam J.,9996,0,9999,3
1746598596550,BISP 197,001,959851,Wilhelm; James E.,9998,0,9999,1
1746598597577,CAT 124RS,A01,956906,Staff,6,0,25,19
1746598598604,CAT 125RS,A01,922013,Staff,6,0,25,19
1746598599628,CLRE 250,A00,891860,Morris; Sheldon,9995,0,9999,4
1746598601683,CLRE 251R,A00,907817,Mehta; Ravindra L.,9994,0,9999,5
1746598602709,CLRE 252,A00,891864,Cuomo; Raphael Eduardo,9993,0,9999,6
1746598603734,CLRE 253,A00,891867,Vaida; Florin,9994,0,9999,5
1746598603734,CLRE 253,B00,907819,Staff,9999,0,9999,0
1746598604766,CLRE 259,A00,891868,Patel; Hemal,9998,0,9999,1
1746598605790,CLRE 260,A00,891872,Cuomo; Raphael Eduardo,9999,0,9999,0
1746598606817,CLRE 297,001,891888,Cuomo; Raphael Eduardo,9999,0,9999,0
1746598607845,CSE 191,A00,958773,Minnes Kemp; Mor Mia,9995,0,9999,4
1746598608872,CSE 197,001,959846,Minnes Kemp; Mor Mia,9990,0,9999,9
1746598609896,CSS 201S,A01,892054,Mignozzetti; Umberto,25,0,30,5
1746598610923,CSS 202S,A01,892056,Mignozzetti; Umberto,25,0,30,5
1746598611948,DSC 197,001,956898,Eldridge; Justin Matthew,9996,0,9999,3
1746598612974,DSC 297,001,958000,Mazumdar; Arya,9998,0,9999,1
1746598612974,DSC 297,002,959862,Wang; Yusu,9998,0,9999,1
1746598614000,EAP 100,A00,905686,Staff,9778,0,9999,221
1746598615027,ECE 45,A01,892618,Staff,0,0,65,65
1746598617075,ECE 111,A01,892719,Staff,6,0,65,59
1746598618102,ECE 197,001,957920,Mercier; Patrick Philip,9991,0,9999,8
1746598619128,ECON 178,A01,907814,Zhu; Ying,26,0,35,9
1746598620192,EDS 115,A00,895312,Staff,35,0,45,10
1746598621216,EDS 117,A01,895337,Staff,23,0,30,7
1746598622243,EDS 125,A00,895341,Jones; Gabrielle Anastasia,36,0,45,9
1746598623267,EDS 128A,A01,895459,Fargason; Sharon Gayle,44,0,45,1
1746598624292,EDS 128B,A01,895543,Pappas; Elizabeth,44,0,45,1
1746598625321,EDS 139,A00,897203,Pappas; Elizabeth,44,0,45,1
1746598625321,EDS 139,B00,897209,Fargason; Sharon Gayle,41,0,45,4
1746598626349,EDS 201,A00,895545,Staff,22,0,45,23
1746598627375,EDS 203,A01,895581,Halter; Christopher P.,22,0,45,23
1746598628401,EDS 204R,A01,895625,Heinzman; Erica M.,39,0,45,6
1746598628401,EDS 204R,B01,895693,Halter; Christopher P.,10,0,45,35
1746598629428,EDS 206R,A00,895694,Fargason; Sharon Gayle,1,0,30,29
1746598629428,EDS 206R,B00,895695,Choi; Bailey Miyeon,16,0,30,14
1746598630456,EDS 250,A00,895697,Hemans; Patricia Ann Benitez,22,0,45,23
1746598631482,EDS 281,A00,895701,Meyerott; Theresa Ann,1,0,15,14
1746598632509,EDS 284,A00,895736,Meyerott; Theresa Ann,1,0,15,14
1746598633536,EDS 286,A00,897210,Fine; Sarah,0,0,15,15
1746598634564,EDS 289C,A01,895770,Daly; Alan J.,1,0,15,14
1746598635591,EDS 290,A00,897211,Hofstetter; Carolyn,0,0,15,15
1746598636619,LIGM 5A,A00,896162,Fischer-Grunski; Eva K,12,0,20,8
1746598637649,LIGM 5B,A00,896260,Fischer-Grunski; Eva K,17,0,20,3
1746598638674,LIGM 5C,A00,896308,Fischer-Grunski; Eva K,18,0,20,2
1746598639701,LIIT 5AS,A00,896313,Carnelos; Chiara,18,0,20,2
1746598640730,LIIT 5BS,A00,896416,Carnelos; Chiara,20,0,20,0
1746598641757,LIIT 5CS,A00,896564,Carnelos; Chiara,20,0,20,0
1746598642782,LISP 5A,A00,896588,Munoz Sanchez; Alicia,2,0,20,18
1746598643809,LISP 5B,A00,896653,Munoz Sanchez; Alicia,7,0,20,13
1746598644867,LISP 5C,A00,896655,Munoz Sanchez; Alicia,0,1,20,20
1746598645892,MAE 197,001,957918,Kleissl; Jan,9996,0,9999,3
1746598645892,MAE 197,002,959806,Boechler; Nicholas Sebastia,9998,0,9999,1
1746598645892,MAE 197,003,959852,Mullin; Jennifer S,9998,0,9999,1
1746598646921,MATH 2,A01,957937,Staff,33,0,35,2
1746598647950,MATH 197,001,957876,Kedlaya; Kiran S.,9993,0,9999,6
1746598648979,MCWP 40,A00,892729,Duru; Nur,10,0,20,10
1746598648979,MCWP 40,B00,893304,Montejo; Carolina,14,0,20,6
1746598650006,MCWP 40R,A00,893757,Redela; Pamela Morgan,0,5,20,20
1746598651035,MCWP 50,A00,893758,Morshed; Michael James,0,0,20,20
1746598651035,MCWP 50,B00,893761,Bartulis; Jason Michael,17,0,20,3
1746598652063,MCWP 50R,A00,893766,Compas; Sean Matthew,0,1,20,20
1746598652063,MCWP 50R,B00,893769,Carter; Jennifer A,0,1,20,20
1746598652063,MCWP 50R,C00,893771,Krone; Jarret,0,3,20,20
1746598652063,MCWP 50R,D00,893772,Miller; Elizabeth Deen,0,0,20,20
1746598652063,MCWP 50R,E00,893775,Carter; Andrea L,0,1,20,20
1746598653088,MMW 11R,A01,892721,Herbst; Matthew,14,0,30,16
1746598653088,MMW 11R,A02,892722,Herbst; Matthew,0,0,0,3
1746598654113,MMW 12R,A01,892724,Herbst; Matthew,0,11,16,16
1746598654113,MMW 12R,A02,892725,Herbst; Matthew,0,10,16,16
1746598655140,MMW 13R,A01,892727,Staff,0,4,16,16
1746598655140,MMW 13R,A02,892728,Staff,0,4,16,16
1746598655140,MMW 13R,A03,958032,Staff,0,4,16,16
1746598655140,MMW 13R,A04,958033,Staff,0,4,16,16
1746598655140,MMW 13R,A05,958034,Staff,0,4,16,16
1746598656167,SIO 295LS,A00,894015,Staff,5,0,25,20
1746598657194,SIO 295S,A00,894020,Staff,5,0,25,20
1746598658226,SIOC 290S,B01,958918,Merrifield; Mark A,14,0,30,16
1746598659255,SIOC 291S,B01,958922,Gabriel; Corey John,14,0,30,16
1746598660281,SOCI 117,A01,895339,Staff,2,0,5,3
1746598661307,WES 237B,A00,894149,Staff,11,0,20,9
1746598663368,AESE 279B,A00,891859,Staff,13,0,35,22
1746598664400,AIP 197,001,891854,Vespa; Emanuel Ignacio,9999,0,9999,0
1746598665441,ANTH 289S,A00,891856,Gagneux; Pascal,12,0,12,0
1746598666469,BENG 196,001,957946,Engler; Adam J.,9996,0,9999,3
1746598667495,BISP 197,001,959851,Wilhelm; James E.,9998,0,9999,1
1746598668523,CAT 124RS,A01,956906,Staff,6,0,25,19
1746598669548,CAT 125RS,A01,922013,Staff,6,0,25,19
1746598670574,CLRE 250,A00,891860,Morris; Sheldon,9995,0,9999,4
1746598672630,CLRE 251R,A00,907817,Mehta; Ravindra L.,9994,0,9999,5
1746598673658,CLRE 252,A00,891864,Cuomo; Raphael Eduardo,9993,0,9999,6
1746598674683,CLRE 253,A00,891867,Vaida; Florin,9994,0,9999,5
1746598674683,CLRE 253,B00,907819,Staff,9999,0,9999,0
1746598675708,CLRE 259,A00,891868,Patel; Hemal,9998,0,9999,1
1746598676734,CLRE 260,A00,891872,Cuomo; Raphael Eduardo,9999,0,9999,0
1746598677759,CLRE 297,001,891888,Cuomo; Raphael Eduardo,9999,0,9999,0
1746598678804,CSE 191,A00,958773,Minnes Kemp; Mor Mia,9995,0,9999,4
1746598679828,CSE 197,001,959846,Minnes Kemp; Mor Mia,9990,0,9999,9
1746598680855,CSS 201S,A01,892054,Mignozzetti; Umberto,25,0,30,5
1746598681883,CSS 202S,A01,892056,Mignozzetti; Umberto,25,0,30,5
1746598682909,DSC 197,001,956898,Eldridge; Justin Matthew,9996,0,9999,3
1746598683938,DSC 297,001,958000,Mazumdar; Arya,9998,0,9999,1
1746598683938,DSC 297,002,959862,Wang; Yusu,9998,0,9999,1
1746598684963,EAP 100,A00,905686,Staff,9778,0,9999,221
1746598685994,ECE 45,A01,892618,Staff,0,0,65,65
1746598688044,ECE 111,A01,892719,Staff,6,0,65,59
1746598689072,ECE 197,001,957920,Mercier; Patrick Philip,9991,0,9999,8
1746598690099,ECON 178,A01,907814,Zhu; Ying,26,0,35,9
1746598691123,EDS 115,A00,895312,Staff,35,0,45,10
1746598692147,EDS 117,A01,895337,Staff,23,0,30,7
1746598693176,EDS 125,A00,895341,Jones; Gabrielle Anastasia,36,0,45,9
1746598694204,EDS 128A,A01,895459,Fargason; Sharon Gayle,44,0,45,1
1746598695229,EDS 128B,A01,895543,Pappas; Elizabeth,44,0,45,1
1746598696255,EDS 139,A00,897203,Pappas; Elizabeth,44,0,45,1
1746598696255,EDS 139,B00,897209,Fargason; Sharon Gayle,41,0,45,4
1746598697281,EDS 201,A00,895545,Staff,22,0,45,23
1746598698305,EDS 203,A01,895581,Halter; Christopher P.,22,0,45,23
1746598699333,EDS 204R,A01,895625,Heinzman; Erica M.,39,0,45,6
1746598699333,EDS 204R,B01,895693,Halter; Christopher P.,10,0,45,35
1746598700362,EDS 206R,A00,895694,Fargason; Sharon Gayle,1,0,30,29
1746598700362,EDS 206R,B00,895695,Choi; Bailey Miyeon,16,0,30,14
1746598701389,EDS 250,A00,895697,Hemans; Patricia Ann Benitez,22,0,45,23
1746598702423,EDS 281,A00,895701,Meyerott; Theresa Ann,1,0,15,14
1746598703446,EDS 284,A00,895736,Meyerott; Theresa Ann,1,0,15,14
1746598704471,EDS 286,A00,897210,Fine; Sarah,0,0,15,15
1746598705496,EDS 289C,A01,895770,Daly; Alan J.,1,0,15,14
1746598706522,EDS 290,A00,897211,Hofstetter; Carolyn,0,0,15,15
1746598707548,LIGM 5A,A00,896162,Fischer-Grunski; Eva K,12,0,20,8
1746598708578,LIGM 5B,A00,896260,Fischer-Grunski; Eva K,17,0,20,3
1746598709606,LIGM 5C,A00,896308,Fischer-Grunski; Eva K,18,0,20,2
1746598710635,LIIT 5AS,A00,896313,Carnelos; Chiara,18,0,20,2
1746598711658,LIIT 5BS,A00,896416,Carnelos; Chiara,20,0,20,0
1746598712690,LIIT 5CS,A00,896564,Carnelos; Chiara,20,0,20,0
1746598713718,LISP 5A,A00,896588,Munoz Sanchez; Alicia,2,0,20,18
1746598714743,LISP 5B,A00,896653,Munoz Sanchez; Alicia,7,0,20,13
1746598715768,LISP 5C,A00,896655,Munoz Sanchez; Alicia,0,1,20,20
1746598716795,MAE 197,001,957918,Kleissl; Jan,9996,0,9999,3
1746598716795,MAE 197,002,959806,Boechler; Nicholas Sebastia,9998,0,9999,1
1746598716795,MAE 197,003,959852,Mullin; Jennifer S,9998,0,9999,1
1746598717820,MATH 2,A01,957937,Staff,33,0,35,2
1746598718849,MATH 197,001,957876,Kedlaya; Kiran S.,9993,0,9999,6
1746598719874,MCWP 40,A00,892729,Duru; Nur,10,0,20,10
1746598719874,MCWP 40,B00,893304,Montejo; Carolina,14,0,20,6
1746598720899,MCWP 40R,A00,893757,Redela; Pamela Morgan,0,5,20,20
1746598721927,MCWP 50,A00,893758,Morshed; Michael James,0,0,20,20
1746598721927,MCWP 50,B00,893761,Bartulis; Jason Michael,17,0,20,3
1746598722953,MCWP 50R,A00,893766,Compas; Sean Matthew,0,1,20,20
1746598722953,MCWP 50R,B00,893769,Carter; Jennifer A,0,1,20,20
1746598722953,MCWP 50R,C00,893771,Krone; Jarret,0,3,20,20
1746598722953,MCWP 50R,D00,893772,Miller; Elizabeth Deen,0,0,20,20
1746598722953,MCWP 50R,E00,893775,Carter; Andrea L,0,1,20,20
1746598723982,MMW 11R,A01,892721,Herbst; Matthew,14,0,30,16
1746598723982,MMW 11R,A02,892722,Herbst; Matthew,0,0,0,3
1746598725009,MMW 12R,A01,892724,Herbst; Matthew,0,11,16,16
1746598725009,MMW 12R,A02,892725,Herbst; Matthew,0,10,16,16
1746598726035,MMW 13R,A01,892727,Staff,0,4,16,16
1746598726035,MMW 13R,A02,892728,Staff,0,4,16,16
1746598726035,MMW 13R,A03,958032,Staff,0,4,16,16
1746598726035,MMW 13R,A04,958033,Staff,0,4,16,16
1746598726035,MMW 13R,A05,958034,Staff,0,4,16,16
1746598727061,SIO 295LS,A00,894015,Staff,5,0,25,20
1746598728086,SIO 295S,A00,894020,Staff,5,0,25,20
1746598729112,SIOC 290S,B01,958918,Merrifield; Mark A,14,0,30,16
1746598730140,SIOC 291S,B01,958922,Gabriel; Corey John,14,0,30,16
1746598731167,SOCI 117,A01,895339,Staff,2,0,5,3
1746598732191,WES 237B,A00,894149,Staff,11,0,20,9
1746598734259,AESE 279B,A00,891859,Staff,13,0,35,22
1746598735284,AIP 197,001,891854,Vespa; Emanuel Ignacio,9999,0,9999,0
1746598736313,ANTH 289S,A00,891856,Gagneux; Pascal,12,0,12,0
1746598737338,BENG 196,001,957946,Engler; Adam J.,9996,0,9999,3
1746598738362,BISP 197,001,959851,Wilhelm; James E.,9998,0,9999,1
1746598739387,CAT 124RS,A01,956906,Staff,6,0,25,19
1746598740415,CAT 125RS,A01,922013,Staff,6,0,25,19
1746598741441,CLRE 250,A00,891860,Morris; Sheldon,9995,0,9999,4
1746598743495,CLRE 251R,A00,907817,Mehta; Ravindra L.,9994,0,9999,5
1746598744521,CLRE 252,A00,891864,Cuomo; Raphael Eduardo,9993,0,9999,6
1746598745559,CLRE 253,A00,891867,Vaida; Florin,9994,0,9999,5
1746598745559,CLRE 253,B00,907819,Staff,9999,0,9999,0
1746598746586,CLRE 259,A00,891868,Patel; Hemal,9998,0,9999,1
1746598747611,CLRE 260,A00,891872,Cuomo; Raphael Eduardo,9999,0,9999,0
1746598748636,CLRE 297,001,891888,Cuomo; Raphael Eduardo,9999,0,9999,0
1746598749660,CSE 191,A00,958773,Minnes Kemp; Mor Mia,9995,0,9999,4
1746598750684,CSE 197,001,959846,Minnes Kemp; Mor Mia,9990,0,9999,9
1746598751709,CSS 201S,A01,892054,Mignozzetti; Umberto,25,0,30,5
1746598752735,CSS 202S,A01,892056,Mignozzetti; Umberto,25,0,30,5
1746598753761,DSC 197,001,956898,Eldridge; Justin Matthew,9996,0,9999,3
1746598754788,DSC 297,001,958000,Mazumdar; Arya,9998,0,9999,1
1746598754788,DSC 297,002,959862,Wang; Yusu,9998,0,9999,1
1746598755813,EAP 100,A00,905686,Staff,9778,0,9999,221
1746598756842,ECE 45,A01,892618,Staff,0,0,65,65
1746598758893,ECE 111,A01,892719,Staff,6,0,65,59
1746598759918,ECE 197,001,957920,Mercier; Patrick Philip,9991,0,9999,8
1746598760945,ECON 178,A01,907814,Zhu; Ying,26,0,35,9
1746598761973,EDS 115,A00,895312,Staff,35,0,45,10
1746598762998,EDS 117,A01,895337,Staff,23,0,30,7
1746598764026,EDS 125,A00,895341,Jones; Gabrielle Anastasia,36,0,45,9
1746598765052,EDS 128A,A01,895459,Fargason; Sharon Gayle,44,0,45,1
1746598766081,EDS 128B,A01,895543,Pappas; Elizabeth,44,0,45,1
1746598767110,EDS 139,A00,897203,Pappas; Elizabeth,44,0,45,1
1746598767110,EDS 139,B00,897209,Fargason; Sharon Gayle,41,0,45,4
1746598768136,EDS 201,A00,895545,Staff,22,0,45,23
1746598769163,EDS 203,A01,895581,Halter; Christopher P.,22,0,45,23
1746598770189,EDS 204R,A01,895625,Heinzman; Erica M.,39,0,45,6
1746598770189,EDS 204R,B01,895693,Halter; Christopher P.,10,0,45,35
1746598771217,EDS 206R,A00,895694,Fargason; Sharon Gayle,1,0,30,29
1746598771217,EDS 206R,B00,895695,Choi; Bailey Miyeon,16,0,30,14
1746598772246,EDS 250,A00,895697,Hemans; Patricia Ann Benitez,22,0,45,23
1746598773271,EDS 281,A00,895701,Meyerott; Theresa Ann,1,0,15,14
1746598774299,EDS 284,A00,895736,Meyerott; Theresa Ann,1,0,15,14
1746598775328,EDS 286,A00,897210,Fine; Sarah,0,0,15,15
1746598776353,EDS 289C,A01,895770,Daly; Alan J.,1,0,15,14
1746598777377,EDS 290,A00,897211,Hofstetter; Carolyn,0,0,15,15
1746598778404,LIGM 5A,A00,896162,Fischer-Grunski; Eva K,12,0,20,8
1746598779435,LIGM 5B,A00,896260,Fischer-Grunski; Eva K,17,0,20,3
1746598780460,LIGM 5C,A00,896308,Fischer-Grunski; Eva K,18,0,20,2
1746598781488,LIIT 5AS,A00,896313,Carnelos; Chiara,18,0,20,2
1746598782513,LIIT 5BS,A00,896416,Carnelos; Chiara,20,0,20,0
1746598783542,LIIT 5CS,A00,896564,Carnelos; Chiara,20,0,20,0
1746598784568,LISP 5A,A00,896588,Munoz Sanchez; Alicia,2,0,20,18
1746598785597,LISP 5B,A00,896653,Munoz Sanchez; Alicia,7,0,20,13
1746598786622,LISP 5C,A00,896655,Munoz Sanchez; Alicia,0,1,20,20
1746598787649,MAE 197,001,957918,Kleissl; Jan,9996,0,9999,3
1746598787649,MAE 197,002,959806,Boechler; Nicholas Sebastia,9998,0,9999,1
1746598787649,MAE 197,003,959852,Mullin; Jennifer S,9998,0,9999,1
1746598788676,MATH 2,A01,957937,Staff,33,0,35,2
1746598789705,MATH 197,001,957876,Kedlaya; Kiran S.,9993,0,9999,6
1746598790734,MCWP 40,A00,892729,Duru; Nur,10,0,20,10
1746598790734,MCWP 40,B00,893304,Montejo; Carolina,14,0,20,6
1746598791758,MCWP 40R,A00,893757,Redela; Pamela Morgan,0,5,20,20
1746598792784,MCWP 50,A00,893758,Morshed; Michael James,0,0,20,20
1746598792784,MCWP 50,B00,893761,Bartulis; Jason Michael,17,0,20,3
1746598793810,MCWP 50R,A00,893766,Compas; Sean Matthew,0,1,20,20
1746598793810,MCWP 50R,B00,893769,Carter; Jennifer A,0,1,20,20
1746598793810,MCWP 50R,C00,893771,Krone; Jarret,0,3,20,20
1746598793810,MCWP 50R,D00,893772,Miller; Elizabeth Deen,0,0,20,20
1746598793810,MCWP 50R,E00,893775,Carter; Andrea L,0,1,20,20
1746598794836,MMW 11R,A01,892721,Herbst; Matthew,14,0,30,16
1746598794836,MMW 11R,A02,892722,Herbst; Matthew,0,0,0,3
1746598795864,MMW 12R,A01,892724,Herbst; Matthew,0,11,16,16
1746598795864,MMW 12R,A02,892725,Herbst; Matthew,0,10,16,16
1746598796890,MMW 13R,A01,892727,Staff,0,4,16,16
1746598796890,MMW 13R,A02,892728,Staff,0,4,16,16
1746598796890,MMW 13R,A03,958032,Staff,0,4,16,16
1746598796890,MMW 13R,A04,958033,Staff,0,4,16,16
1746598796890,MMW 13R,A05,958034,Staff,0,4,16,16
1746598797919,SIO 295LS,A00,894015,Staff,5,0,25,20
1746598798947,SIO 295S,A00,894020,Staff,5,0,25,20
1746598799977,SIOC 290S,B01,958918,Merrifield; Mark A,14,0,30,16
1746598801008,SIOC 291S,B01,958922,Gabriel; Corey John,14,0,30,16
1746598802034,SOCI 117,A01,895339,Staff,2,0,5,3
1746598803060,WES 237B,A00,894149,Staff,11,0,20,9
1746598805120,AESE 279B,A00,891859,Staff,13,0,35,22
1746598806146,AIP 197,001,891854,Vespa; Emanuel Ignacio,9999,0,9999,0
1746598807174,ANTH 289S,A00,891856,Gagneux; Pascal,12,0,12,0
1746598808205,BENG 196,001,957946,Engler; Adam J.,9996,0,9999,3
1746598809232,BISP 197,001,959851,Wilhelm; James E.,9998,0,9999,1
1746598810259,CAT 124RS,A01,956906,Staff,6,0,25,19
1746598811283,CAT 125RS,A01,922013,Staff,6,0,25,19
1746598812312,CLRE 250,A00,891860,Morris; Sheldon,9995,0,9999,4
1746598814363,CLRE 251R,A00,907817,Mehta; Ravindra L.,9994,0,9999,5
1746598815393,CLRE 252,A00,891864,Cuomo; Raphael Eduardo,9993,0,9999,6
1746598816419,CLRE 253,A00,891867,Vaida; Florin,9994,0,9999,5
1746598816419,CLRE 253,B00,907819,Staff,9999,0,9999,0
1746598817446,CLRE 259,A00,891868,Patel; Hemal,9998,0,9999,1
1746598818473,CLRE 260,A00,891872,Cuomo; Raphael Eduardo,9999,0,9999,0
1746598819502,CLRE 297,001,891888,Cuomo; Raphael Eduardo,9999,0,9999,0
1746598820528,CSE 191,A00,958773,Minnes Kemp; Mor Mia,9995,0,9999,4
1746598821558,CSE 197,001,959846,Minnes Kemp; Mor Mia,9990,0,9999,9
1746598822585,CSS 201S,A01,892054,Mignozzetti; Umberto,25,0,30,5
1746598823609,CSS 202S,A01,892056,Mignozzetti; Umberto,25,0,30,5
1746598824637,DSC 197,001,956898,Eldridge; Justin Matthew,9996,0,9999,3
1746598825664,DSC 297,001,958000,Mazumdar; Arya,9998,0,9999,1
1746598825664,DSC 297,002,959862,Wang; Yusu,9998,0,9999,1
1746598826692,EAP 100,A00,905686,Staff,9778,0,9999,221
1746598827723,ECE 45,A01,892618,Staff,0,0,65,65
1746598829779,ECE 111,A01,892719,Staff,6,0,65,59
1746598830804,ECE 197,001,957920,Mercier; Patrick Philip,9991,0,9999,8
1746598831831,ECON 178,A01,907814,Zhu; Ying,26,0,35,9
1746598832857,EDS 115,A00,895312,Staff,35,0,45,10
1746598833883,EDS 117,A01,895337,Staff,23,0,30,7
1746598834908,EDS 125,A00,895341,Jones; Gabrielle Anastasia,36,0,45,9
1746598835942,EDS 128A,A01,895459,Fargason; Sharon Gayle,44,0,45,1
1746598836972,EDS 128B,A01,895543,Pappas; Elizabeth,44,0,45,1
1746598837998,EDS 139,A00,897203,Pappas; Elizabeth,44,0,45,1
1746598837998,EDS 139,B00,897209,Fargason; Sharon Gayle,41,0,45,4
1746598839027,EDS 201,A00,895545,Staff,22,0,45,23
1746598840055,EDS 203,A01,895581,Halter; Christopher P.,22,0,45,23
1746598841080,EDS 204R,A01,895625,Heinzman; Erica M.,39,0,45,6
1746598841080,EDS 204R,B01,895693,Halter; Christopher P.,10,0,45,35
1746598842108,EDS 206R,A00,895694,Fargason; Sharon Gayle,1,0,30,29
1746598842108,EDS 206R,B00,895695,Choi; Bailey Miyeon,16,0,30,14
1746598843136,EDS 250,A00,895697,Hemans; Patricia Ann Benitez,22,0,45,23
1746598844161,EDS 281,A00,895701,Meyerott; Theresa Ann,1,0,15,14
1746598845189,EDS 284,A00,895736,Meyerott; Theresa Ann,1,0,15,14
1746598846214,EDS 286,A00,897210,Fine; Sarah,0,0,15,15
1746598847239,EDS 289C,A01,895770,Daly; Alan J.,1,0,15,14
1746598848266,EDS 290,A00,897211,Hofstetter; Carolyn,0,0,15,15
1746598849291,LIGM 5A,A00,896162,Fischer-Grunski; Eva K,12,0,20,8
1746598850319,LIGM 5B,A00,896260,Fischer-Grunski; Eva K,17,0,20,3
1746598851349,LIGM 5C,A00,896308,Fischer-Grunski; Eva K,18,0,20,2
1746598852382,LIIT 5AS,A00,896313,Carnelos; Chiara,18,0,20,2
1746598853409,LIIT 5BS,A00,896416,Carnelos; Chiara,20,0,20,0
1746598854439,LIIT 5CS,A00,896564,Carnelos; Chiara,20,0,20,0
1746598855464,LISP 5A,A00,896588,Munoz Sanchez; Alicia,2,0,20,18
1746598856490,LISP 5B,A00,896653,Munoz Sanchez; Alicia,7,0,20,13
1746598857518,LISP 5C,A00,896655,Munoz Sanchez; Alicia,0,1,20,20
1746598858547,MAE 197,001,957918,Kleissl; Jan,9996,0,9999,3
1746598858547,MAE 197,002,959806,Boechler; Nicholas Sebastia,9998,0,9999,1
1746598858547,MAE 197,003,959852,Mullin; Jennifer S,9998,0,9999,1
1746598859577,MATH 2,A01,957937,Staff,33,0,35,2
1746598860601,MATH 197,001,957876,Kedlaya; Kiran S.,9993,0,9999,6
1746598861628,MCWP 40,A00,892729,Duru; Nur,10,0,20,10
1746598861628,MCWP 40,B00,893304,Montejo; Carolina,14,0,20,6
1746598862656,MCWP 40R,A00,893757,Redela; Pamela Morgan,0,5,20,20
1746598863680,MCWP 50,A00,893758,Morshed; Michael James,0,0,20,20
1746598863680,MCWP 50,B00,893761,Bartulis; Jason Michael,17,0,20,3
1746598864706,MCWP 50R,A00,893766,Compas; Sean Matthew,0,1,20,20
1746598864706,MCWP 50R,B00,893769,Carter; Jennifer A,0,1,20,20
1746598864706,MCWP 50R,C00,893771,Krone; Jarret,0,3,20,20
1746598864706,MCWP 50R,D00,893772,Miller; Elizabeth Deen,0,0,20,20
1746598864706,MCWP 50R,E00,893775,Carter; Andrea L,0,1,20,20
1746598865732,MMW 11R,A01,892721,Herbst; Matthew,14,0,30,16
1746598865732,MMW 11R,A02,892722,Herbst; Matthew,0,0,0,3
1746598866762,MMW 12R,A01,892724,Herbst; Matthew,0,11,16,16
1746598866762,MMW 12R,A02,892725,Herbst; Matthew,0,10,16,16
1746598867791,MMW 13R,A01,892727,Staff,0,4,16,16
1746598867791,MMW 13R,A02,892728,Staff,0,4,16,16
1746598867791,MMW 13R,A03,958032,Staff,0,4,16,16
1746598867791,MMW 13R,A04,958033,Staff,0,4,16,16
1746598867791,MMW 13R,A05,958034,Staff,0,4,16,16
1746598868817,SIO 295LS,A00,894015,Staff,5,0,25,20
1746598869843,SIO 295S,A00,894020,Staff,5,0,25,20
1746598870870,SIOC 290S,B01,958918,Merrifield; Mark A,14,0,30,16
1746598871897,SIOC 291S,B01,958922,Gabriel; Corey John,14,0,30,16
1746598872924,SOCI 117,A01,895339,Staff,2,0,5,3
1746598873950,WES 237B,A00,894149,Staff,11,0,20,9
1746598876009,AESE 279B,A00,891859,Staff,13,0,35,22
1746598877033,AIP 197,001,891854,Vespa; Emanuel Ignacio,9999,0,9999,0
1746598878062,ANTH 289S,A00,891856,Gagneux; Pascal,12,0,12,0
1746598879090,BENG 196,001,957946,Engler; Adam J.,9996,0,9999,3
1746598880121,BISP 197,001,959851,Wilhelm; James E.,9998,0,9999,1
1746598881146,CAT 124RS,A01,956906,Staff,6,0,25,19
1746598882171,CAT 125RS,A01,922013,Staff,6,0,25,19
1746598883202,CLRE 250,A00,891860,Morris; Sheldon,9995,0,9999,4
1746598885256,CLRE 251R,A00,907817,Mehta; Ravindra L.,9994,0,9999,5
1746598886286,CLRE 252,A00,891864,Cuomo; Raphael Eduardo,9993,0,9999,6
1746598887311,CLRE 253,A00,891867,Vaida; Florin,9994,0,9999,5
1746598887311,CLRE 253,B00,907819,Staff,9999,0,9999,0
1746598888337,CLRE 259,A00,891868,Patel; Hemal,9998,0,9999,1
1746598889362,CLRE 260,A00,891872,Cuomo; Raphael Eduardo,9999,0,9999,0
1746598890393,CLRE 297,001,891888,Cuomo; Raphael Eduardo,9999,0,9999,0
1746598891419,CSE 191,A00,958773,Minnes Kemp; Mor Mia,9995,0,9999,4
1746598892444,CSE 197,001,959846,Minnes Kemp; Mor Mia,9990,0,9999,9
1746598893473,CSS 201S,A01,892054,Mignozzetti; Umberto,25,0,30,5
1746598894499,CSS 202S,A01,892056,Mignozzetti; Umberto,25,0,30,5
1746598895524,DSC 197,001,956898,Eldridge; Justin Matthew,9996,0,9999,3
1746598896549,DSC 297,001,958000,Mazumdar; Arya,9998,0,9999,1
1746598896549,DSC 297,002,959862,Wang; Yusu,9998,0,9999,1
1746598897574,EAP 100,A00,905686,Staff,9778,0,9999,221
1746598898605,ECE 45,A01,892618,Staff,0,0,65,65
1746598900659,ECE 111,A01,892719,Staff,6,0,65,59
1746598901688,ECE 197,001,957920,Mercier; Patrick Philip,9991,0,9999,8
1746598902715,ECON 178,A01,907814,Zhu; Ying,26,0,35,9
1746598903744,EDS 115,A00,895312,Staff,35,0,45,10
1746598904771,EDS 117,A01,895337,Staff,23,0,30,7
1746598905800,EDS 125,A00,895341,Jones; Gabrielle Anastasia,36,0,45,9
1746598906830,EDS 128A,A01,895459,Fargason; Sharon Gayle,44,0,45,1
1746598907859,EDS 128B,A01,895543,Pappas; Elizabeth,44,0,45,1
1746598908884,EDS 139,A00,897203,Pappas; Elizabeth,44,0,45,1
1746598908884,EDS 139,B00,897209,Fargason; Sharon Gayle,41,0,45,4
1746598909915,EDS 201,A00,895545,Staff,22,0,45,23
1746598910940,EDS 203,A01,895581,Halter; Christopher P.,22,0,45,23
1746598911972,EDS 204R,A01,895625,Heinzman; Erica M.,39,0,45,6
1746598911972,EDS 204R,B01,895693,Halter; Christopher P.,10,0,45,35
1746598912997,EDS 206R,A00,895694,Fargason; Sharon Gayle,1,0,30,29
1746598912997,EDS 206R,B00,895695,Choi; Bailey Miyeon,16,0,30,14
1746598914029,EDS 250,A00,895697,Hemans; Patricia Ann Benitez,22,0,45,23
1746598915054,EDS 281,A00,895701,Meyerott; Theresa Ann,1,0,15,14
1746598916085,EDS 284,A00,895736,Meyerott; Theresa Ann,1,0,15,14
1746598917110,EDS 286,A00,897210,Fine; Sarah,0,0,15,15
1746598918139,EDS 289C,A01,895770,Daly; Alan J.,1,0,15,14
1746598919165,EDS 290,A00,897211,Hofstetter; Carolyn,0,0,15,15
1746598920194,LIGM 5A,A00,896162,Fischer-Grunski; Eva K,12,0,20,8
1746598921225,LIGM 5B,A00,896260,Fischer-Grunski; Eva K,17,0,20,3
1746598922251,LIGM 5C,A00,896308,Fischer-Grunski; Eva K,18,0,20,2
1746598923316,LIIT 5AS,A00,896313,Carnelos; Chiara,18,0,20,2
1746598924341,LIIT 5BS,A00,896416,Carnelos; Chiara,20,0,20,0
1746598925371,LIIT 5CS,A00,896564,Carnelos; Chiara,20,0,20,0
1746598926398,LISP 5A,A00,896588,Munoz Sanchez; Alicia,2,0,20,18
1746598927427,LISP 5B,A00,896653,Munoz Sanchez; Alicia,7,0,20,13
1746598928456,LISP 5C,A00,896655,Munoz Sanchez; Alicia,0,1,20,20
1746598929482,MAE 197,001,957918,Kleissl; Jan,9996,0,9999,3
1746598929482,MAE 197,002,959806,Boechler; Nicholas Sebastia,9998,0,9999,1
1746598929482,MAE 197,003,959852,Mullin; Jennifer S,9998,0,9999,1
1746598930510,MATH 2,A01,957937,Staff,33,0,35,2
1746598931535,MATH 197,001,957876,Kedlaya; Kiran S.,9993,0,9999,6
1746598932565,MCWP 40,A00,892729,Duru; Nur,10,0,20,10
1746598932565,MCWP 40,B00,893304,Montejo; Carolina,14,0,20,6
1746598933591,MCWP 40R,A00,893757,Redela; Pamela Morgan,0,5,20,20
1746598934618,MCWP 50,A00,893758,Morshed; Michael James,0,0,20,20
1746598934618,MCWP 50,B00,893761,Bartulis; Jason Michael,17,0,20,3
1746598935644,MCWP 50R,A00,893766,Compas; Sean Matthew,0,1,20,20
1746598935644,MCWP 50R,B00,893769,Carter; Jennifer A,0,1,20,20
1746598935644,MCWP 50R,C00,893771,Krone; Jarret,0,3,20,20
1746598935644,MCWP 50R,D00,893772,Miller; Elizabeth Deen,0,0,20,20
1746598935644,MCWP 50R,E00,893775,Carter; Andrea L,0,1,20,20
1746598936669,MMW 11R,A01,892721,Herbst; Matthew,14,0,30,16
1746598936669,MMW 11R,A02,892722,Herbst; Matthew,0,0,0,3
1746598937699,MMW 12R,A01,892724,Herbst; Matthew,0,11,16,16
1746598937699,MMW 12R,A02,892725,Herbst; Matthew,0,10,16,16
1746598938726,MMW 13R,A01,892727,Staff,0,4,16,16
1746598938726,MMW 13R,A02,892728,Staff,0,4,16,16
1746598938726,MMW 13R,A03,958032,Staff,0,4,16,16
1746598938726,MMW 13R,A04,958033,Staff,0,4,16,16
1746598938726,MMW 13R,A05,958034,Staff,0,4,16,16
1746598939755,SIO 295LS,A00,894015,Staff,5,0,25,20
1746598940781,SIO 295S,A00,894020,Staff,5,0,25,20
1746598941811,SIOC 290S,B01,958918,Merrifield; Mark A,14,0,30,16
1746598942836,SIOC 291S,B01,958922,Gabriel; Corey John,14,0,30,16
1746598943879,SOCI 117,A01,895339,Staff,2,0,5,3
1746598944908,WES 237B,A00,894149,Staff,11,0,20,9
1746598946964,AESE 279B,A00,891859,Staff,13,0,35,22
1746598947992,AIP 197,001,891854,Vespa; Emanuel Ignacio,9999,0,9999,0
1746598949023,ANTH 289S,A00,891856,Gagneux; Pascal,12,0,12,0
1746598950049,BENG 196,001,957946,Engler; Adam J.,9996,0,9999,3
1746598951077,BISP 197,001,959851,Wilhelm; James E.,9998,0,9999,1
1746598952107,CAT 124RS,A01,956906,Staff,6,0,25,19
1746598953134,CAT 125RS,A01,922013,Staff,6,0,25,19
1746598954160,CLRE 250,A00,891860,Morris; Sheldon,9995,0,9999,4
1746598956212,CLRE 251R,A00,907817,Mehta; Ravindra L.,9994,0,9999,5
1746598957243,CLRE 252,A00,891864,Cuomo; Raphael Eduardo,9993,0,9999,6
1746598958274,CLRE 253,A00,891867,Vaida; Florin,9994,0,9999,5
1746598958274,CLRE 253,B00,907819,Staff,9999,0,9999,0
1746598959301,CLRE 259,A00,891868,Patel; Hemal,9998,0,9999,1
1746598960327,CLRE 260,A00,891872,Cuomo; Raphael Eduardo,9999,0,9999,0
1746598961351,CLRE 297,001,891888,Cuomo; Raphael Eduardo,9999,0,9999,0
1746598962378,CSE 191,A00,958773,Minnes Kemp; Mor Mia,9995,0,9999,4
1746598963408,CSE 197,001,959846,Minnes Kemp; Mor Mia,9990,0,9999,9
1746598964434,CSS 201S,A01,892054,Mignozzetti; Umberto,25,0,30,5
1746598965464,CSS 202S,A01,892056,Mignozzetti; Umberto,25,0,30,5
1746598966489,DSC 197,001,956898,Eldridge; Justin Matthew,9996,0,9999,3
1746598967515,DSC 297,001,958000,Mazumdar; Arya,9998,0,9999,1
1746598967515,DSC 297,002,959862,Wang; Yusu,9998,0,9999,1
1746598968544,EAP 100,A00,905686,Staff,9778,0,9999,221
1746598969575,ECE 45,A01,892618,Staff,0,0,65,65
1746598971632,ECE 111,A01,892719,Staff,6,0,65,59
1746598972662,ECE 197,001,957920,Mercier; Patrick Philip,9991,0,9999,8
1746598973690,ECON 178,A01,907814,Zhu; Ying,26,0,35,9
1746598974717,EDS 115,A00,895312,Staff,35,0,45,10
1746598975743,EDS 117,A01,895337,Staff,23,0,30,7
1746598976773,EDS 125,A00,895341,Jones; Gabrielle Anastasia,36,0,45,9
1746598977799,EDS 128A,A01,895459,Fargason; Sharon Gayle,44,0,45,1
1746598978828,EDS 128B,A01,895543,Pappas; Elizabeth,44,0,45,1
1746598979858,EDS 139,A00,897203,Pappas; Elizabeth,44,0,45,1
1746598979858,EDS 139,B00,897209,Fargason; Sharon Gayle,41,0,45,4
1746598980886,EDS 201,A00,895545,Staff,22,0,45,23
1746598981912,EDS 203,A01,895581,Halter; Christopher P.,22,0,45,23
1746598982943,EDS 204R,A01,895625,Heinzman; Erica M.,39,0,45,6
1746598982943,EDS 204R,B01,895693,Halter; Christopher P.,10,0,45,35
1746598983969,EDS 206R,A00,895694,Fargason; Sharon Gayle,1,0,30,29
1746598983969,EDS 206R,B00,895695,Choi; Bailey Miyeon,16,0,30,14
1746598984998,EDS 250,A00,895697,Hemans; Patricia Ann Benitez,22,0,45,23
1746598986027,EDS 281,A00,895701,Meyerott; Theresa Ann,1,0,15,14
1746598987051,EDS 284,A00,895736,Meyerott; Theresa Ann,1,0,15,14
1746598988077,EDS 286,A00,897210,Fine; Sarah,0,0,15,15
1746598989101,EDS 289C,A01,895770,Daly; Alan J.,1,0,15,14
1746598990130,EDS 290,A00,897211,Hofstetter; Carolyn,0,0,15,15
1746598991161,LIGM 5A,A00,896162,Fischer-Grunski; Eva K,12,0,20,8
1746598992192,LIGM 5B,A00,896260,Fischer-Grunski; Eva K,17,0,20,3
1746598993218,LIGM 5C,A00,896308,Fischer-Grunski; Eva K,18,0,20,2
1746598994247,LIIT 5AS,A00,896313,Carnelos; Chiara,18,0,20,2
1746598995271,LIIT 5BS,A00,896416,Carnelos; Chiara,20,0,20,0
1746598996299,LIIT 5CS,A00,896564,Carnelos; Chiara,20,0,20,0
1746598997325,LISP 5A,A00,896588,Munoz Sanchez; Alicia,2,0,20,18
1746598998352,LISP 5B,A00,896653,Munoz Sanchez; Alicia,7,0,20,13
1746598999376,LISP 5C,A00,896655,Munoz Sanchez; Alicia,0,1,20,20
1746599000401,MAE 197,001,957918,Kleissl; Jan,9996,0,9999,3
1746599000401,MAE 197,002,959806,Boechler; Nicholas Sebastia,9998,0,9999,1
1746599000401,MAE 197,003,959852,Mullin; Jennifer S,9998,0,9999,1
1746599001428,MATH 2,A01,957937,Staff,33,0,35,2
1746599002453,MATH 197,001,957876,Kedlaya; Kiran S.,9993,0,9999,6
1746599003480,MCWP 40,A00,892729,Duru; Nur,10,0,20,10
1746599003480,MCWP 40,B00,893304,Montejo; Carolina,14,0,20,6
1746599004509,MCWP 40R,A00,893757,Redela; Pamela Morgan,0,5,20,20
1746599005600,MCWP 50,A00,893758,Morshed; Michael James,0,0,20,20
1746599005600,MCWP 50,B00,893761,Bartulis; Jason Michael,17,0,20,3
1746599006628,MCWP 50R,A00,893766,Compas; Sean Matthew,0,1,20,20
1746599006628,MCWP 50R,B00,893769,Carter; Jennifer A,0,1,20,20
1746599006628,MCWP 50R,C00,893771,Krone; Jarret,0,3,20,20
1746599006628,MCWP 50R,D00,893772,Miller; Elizabeth Deen,0,0,20,20
1746599006628,MCWP 50R,E00,893775,Carter; Andrea L,0,1,20,20
1746599007654,MMW 11R,A01,892721,Herbst; Matthew,14,0,30,16
1746599007654,MMW 11R,A02,892722,Herbst; Matthew,0,0,0,3
1746599008681,MMW 12R,A01,892724,Herbst; Matthew,0,11,16,16
1746599008681,MMW 12R,A02,892725,Herbst; Matthew,0,10,16,16
1746599009708,MMW 13R,A01,892727,Staff,0,4,16,16
1746599009708,MMW 13R,A02,892728,Staff,0,4,16,16
1746599009708,MMW 13R,A03,958032,Staff,0,4,16,16
1746599009708,MMW 13R,A04,958033,Staff,0,4,16,16
1746599009708,MMW 13R,A05,958034,Staff,0,4,16,16
1746599010738,SIO 295LS,A00,894015,Staff,5,0,25,20
1746599011766,SIO 295S,A00,894020,Staff,5,0,25,20
1746599012792,SIOC 290S,B01,958918,Merrifield; Mark A,14,0,30,16
1746599013822,SIOC 291S,B01,958922,Gabriel; Corey John,14,0,30,16
1746599014853,SOCI 117,A01,895339,Staff,2,0,5,3
1746599015879,WES 237B,A00,894149,Staff,11,0,20,9
1746599017946,AESE 279B,A00,891859,Staff,13,0,35,22
1746599018973,AIP 197,001,891854,Vespa; Emanuel Ignacio,9999,0,9999,0
1746599020003,ANTH 289S,A00,891856,Gagneux; Pascal,12,0,12,0
1746599021028,BENG 196,001,957946,Engler; Adam J.,9996,0,9999,3
1746599022055,BISP 197,001,959851,Wilhelm; James E.,9998,0,9999,1
1746599023081,CAT 124RS,A01,956906,Staff,6,0,25,19
1746599024107,CAT 125RS,A01,922013,Staff,6,0,25,19
1746599025136,CLRE 250,A00,891860,Morris; Sheldon,9995,0,9999,4
1746599027726,CLRE 251R,A00,907817,Mehta; Ravindra L.,9994,0,9999,5
1746599028751,CLRE 252,A00,891864,Cuomo; Raphael Eduardo,9993,0,9999,6
1746599029780,CLRE 253,A00,891867,Vaida; Florin,9994,0,9999,5
1746599029780,CLRE 253,B00,907819,Staff,9999,0,9999,0
1746599030806,CLRE 259,A00,891868,Patel; Hemal,9998,0,9999,1
1746599031831,CLRE 260,A00,891872,Cuomo; Raphael Eduardo,9999,0,9999,0
1746599032860,CLRE 297,001,891888,Cuomo; Raphael Eduardo,9999,0,9999,0
1746599033889,CSE 191,A00,958773,Minnes Kemp; Mor Mia,9995,0,9999,4
1746599034915,CSE 197,001,959846,Minnes Kemp; Mor Mia,9990,0,9999,9
1746599035945,CSS 201S,A01,892054,Mignozzetti; Umberto,25,0,30,5
1746599036974,CSS 202S,A01,892056,Mignozzetti; Umberto,25,0,30,5
1746599038003,DSC 197,001,956898,Eldridge; Justin Matthew,9996,0,9999,3
1746599039028,DSC 297,001,958000,Mazumdar; Arya,9998,0,9999,1
1746599039028,DSC 297,002,959862,Wang; Yusu,9998,0,9999,1
1746599040056,EAP 100,A00,905686,Staff,9778,0,9999,221
1746599041084,ECE 45,A01,892618,Staff,0,0,65,65
1746599043144,ECE 111,A01,892719,Staff,6,0,65,59
1746599044172,ECE 197,001,957920,Mercier; Patrick Philip,9991,0,9999,8
1746599045201,ECON 178,A01,907814,Zhu; Ying,26,0,35,9
1746599046225,EDS 115,A00,895312,Staff,35,0,45,10
1746599047250,EDS 117,A01,895337,Staff,23,0,30,7
1746599048276,EDS 125,A00,895341,Jones; Gabrielle Anastasia,36,0,45,9
1746599049301,EDS 128A,A01,895459,Fargason; Sharon Gayle,44,0,45,1
1746599050327,EDS 128B,A01,895543,Pappas; Elizabeth,44,0,45,1
1746599051355,EDS 139,A00,897203,Pappas; Elizabeth,44,0,45,1
1746599051355,EDS 139,B00,897209,Fargason; Sharon Gayle,41,0,45,4
1746599052381,EDS 201,A00,895545,Staff,22,0,45,23
1746599053405,EDS 203,A01,895581,Halter; Christopher P.,22,0,45,23
1746599054430,EDS 204R,A01,895625,Heinzman; Erica M.,39,0,45,6
1746599054430,EDS 204R,B01,895693,Halter; Christopher P.,10,0,45,35
1746599055455,EDS 206R,A00,895694,Fargason; Sharon Gayle,1,0,30,29
1746599055455,EDS 206R,B00,895695,Choi; Bailey Miyeon,16,0,30,14
1746599056480,EDS 250,A00,895697,Hemans; Patricia Ann Benitez,22,0,45,23
1746599057507,EDS 281,A00,895701,Meyerott; Theresa Ann,1,0,15,14
1746599058533,EDS 284,A00,895736,Meyerott; Theresa Ann,1,0,15,14
1746599059560,EDS 286,A00,897210,Fine; Sarah,0,0,15,15
1746599060586,EDS 289C,A01,895770,Daly; Alan J.,1,0,15,14
1746599061650,EDS 290,A00,897211,Hofstetter; Carolyn,0,0,15,15
1746599062675,LIGM 5A,A00,896162,Fischer-Grunski; Eva K,12,0,20,8
1746599063701,LIGM 5B,A00,896260,Fischer-Grunski; Eva K,17,0,20,3
1746599064731,LIGM 5C,A00,896308,Fischer-Grunski; Eva K,18,0,20,2
1746599065756,LIIT 5AS,A00,896313,Carnelos; Chiara,18,0,20,2
1746599066780,LIIT 5BS,A00,896416,Carnelos; Chiara,20,0,20,0
1746599067810,LIIT 5CS,A00,896564,Carnelos; Chiara,20,0,20,0
1746599068834,LISP 5A,A00,896588,Munoz Sanchez; Alicia,2,0,20,18
1746599069863,LISP 5B,A00,896653,Munoz Sanchez; Alicia,7,0,20,13
1746599070892,LISP 5C,A00,896655,Munoz Sanchez; Alicia,0,1,20,20
1746599071917,MAE 197,001,957918,Kleissl; Jan,9996,0,9999,3
1746599071917,MAE 197,002,959806,Boechler; Nicholas Sebastia,9998,0,9999,1
1746599071917,MAE 197,003,959852,Mullin; Jennifer S,9998,0,9999,1
1746599072941,MATH 2,A01,957937,Staff,33,0,35,2
1746599073970,MATH 197,001,957876,Kedlaya; Kiran S.,9993,0,9999,6
1746599074998,MCWP 40,A00,892729,Duru; Nur,10,0,20,10
1746599074998,MCWP 40,B00,893304,Montejo; Carolina,14,0,20,6
1746599076025,MCWP 40R,A00,893757,Redela; Pamela Morgan,0,5,20,20
1746599077054,MCWP 50,A00,893758,Morshed; Michael James,0,0,20,20
1746599077054,MCWP 50,B00,893761,Bartulis; Jason Michael,17,0,20,3
1746599078084,MCWP 50R,A00,893766,Compas; Sean Matthew,0,1,20,20
1746599078084,MCWP 50R,B00,893769,Carter; Jennifer A,0,1,20,20
1746599078084,MCWP 50R,C00,893771,Krone; Jarret,0,3,20,20
1746599078084,MCWP 50R,D00,893772,Miller; Elizabeth Deen,0,0,20,20
1746599078084,MCWP 50R,E00,893775,Carter; Andrea L,0,1,20,20
1746599079114,MMW 11R,A01,892721,Herbst; Matthew,14,0,30,16
1746599079114,MMW 11R,A02,892722,Herbst; Matthew,0,0,0,3
1746599080139,MMW 12R,A01,892724,Herbst; Matthew,0,11,16,16
1746599080139,MMW 12R,A02,892725,Herbst; Matthew,0,10,16,16
1746599081165,MMW 13R,A01,892727,Staff,0,4,16,16
1746599081165,MMW 13R,A02,892728,Staff,0,4,16,16
1746599081165,MMW 13R,A03,958032,Staff,0,4,16,16
1746599081165,MMW 13R,A04,958033,Staff,0,4,16,16
1746599081165,MMW 13R,A05,958034,Staff,0,4,16,16
1746599082190,SIO 295LS,A00,894015,Staff,5,0,25,20
1746599083215,SIO 295S,A00,894020,Staff,5,0,25,20
1746599084244,SIOC 290S,B01,958918,Merrifield; Mark A,14,0,30,16
1746599085276,SIOC 291S,B01,958922,Gabriel; Corey John,14,0,30,16
1746599086302,SOCI 117,A01,895339,Staff,2,0,5,3
1746599087329,WES 237B,A00,894149,Staff,11,0,20,9
1746599089392,AESE 279B,A00,891859,Staff,13,0,35,22
1746599090623,AIP 197,001,891854,Vespa; Emanuel Ignacio,9999,0,9999,0
1746599091649,ANTH 289S,A00,891856,Gagneux; Pascal,12,0,12,0
1746599092674,BENG 196,001,957946,Engler; Adam J.,9996,0,9999,3
1746599093700,BISP 197,001,959851,Wilhelm; James E.,9998,0,9999,1
1746599094729,CAT 124RS,A01,956906,Staff,6,0,25,19
1746599095755,CAT 125RS,A01,922013,Staff,6,0,25,19
1746599096780,CLRE 250,A00,891860,Morris; Sheldon,9995,0,9999,4
1746599098838,CLRE 251R,A00,907817,Mehta; Ravindra L.,9994,0,9999,5
1746599099866,CLRE 252,A00,891864,Cuomo; Raphael Eduardo,9993,0,9999,6
1746599100894,CLRE 253,A00,891867,Vaida; Florin,9994,0,9999,5
1746599100894,CLRE 253,B00,907819,Staff,9999,0,9999,0
1746599101922,CLRE 259,A00,891868,Patel; Hemal,9998,0,9999,1
1746599102948,CLRE 260,A00,891872,Cuomo; Raphael Eduardo,9999,0,9999,0
1746599103976,CLRE 297,001,891888,Cuomo; Raphael Eduardo,9999,0,9999,0
1746599105013,CSE 191,A00,958773,Minnes Kemp; Mor Mia,9995,0,9999,4
1746599106039,CSE 197,001,959846,Minnes Kemp; Mor Mia,9990,0,9999,9
1746599107065,CSS 201S,A01,892054,Mignozzetti; Umberto,25,0,30,5
1746599108091,CSS 202S,A01,892056,Mignozzetti; Umberto,25,0,30,5
1746599109120,DSC 197,001,956898,Eldridge; Justin Matthew,9996,0,9999,3
1746599110145,DSC 297,001,958000,Mazumdar; Arya,9998,0,9999,1
1746599110145,DSC 297,002,959862,Wang; Yusu,9998,0,9999,1
1746599111172,EAP 100,A00,905686,Staff,9778,0,9999,221
1746599112201,ECE 45,A01,892618,Staff,0,0,65,65
1746599114259,ECE 111,A01,892719,Staff,6,0,65,59
1746599115287,ECE 197,001,957920,Mercier; Patrick Philip,9991,0,9999,8
1746599116315,ECON 178,A01,907814,Zhu; Ying,26,0,35,9
1746599117341,EDS 115,A00,895312,Staff,35,0,45,10
1746599118370,EDS 117,A01,895337,Staff,23,0,30,7
1746599119398,EDS 125,A00,895341,Jones; Gabrielle Anastasia,36,0,45,9
1746599120424,EDS 128A,A01,895459,Fargason; Sharon Gayle,44,0,45,1
1746599121451,EDS 128B,A01,895543,Pappas; Elizabeth,44,0,45,1
1746599122479,EDS 139,A00,897203,Pappas; Elizabeth,44,0,45,1
1746599122479,EDS 139,B00,897209,Fargason; Sharon Gayle,41,0,45,4
1746599123507,EDS 201,A00,895545,Staff,22,0,45,23
1746599124533,EDS 203,A01,895581,Halter; Christopher P.,22,0,45,23
1746599125559,EDS 204R,A01,895625,Heinzman; Erica M.,39,0,45,6
1746599125559,EDS 204R,B01,895693,Halter; Christopher P.,10,0,45,35
1746599126585,EDS 206R,A00,895694,Fargason; Sharon Gayle,1,0,30,29
1746599126585,EDS 206R,B00,895695,Choi; Bailey Miyeon,16,0,30,14
1746599127613,EDS 250,A00,895697,Hemans; Patricia Ann Benitez,22,0,45,23
1746599128640,EDS 281,A00,895701,Meyerott; Theresa Ann,1,0,15,14
1746599129664,EDS 284,A00,895736,Meyerott; Theresa Ann,1,0,15,14
1746599130693,EDS 286,A00,897210,Fine; Sarah,0,0,15,15
1746599131721,EDS 289C,A01,895770,Daly; Alan J.,1,0,15,14
1746599132750,EDS 290,A00,897211,Hofstetter; Carolyn,0,0,15,15
1746599133776,LIGM 5A,A00,896162,Fischer-Grunski; Eva K,12,0,20,8
1746599134801,LIGM 5B,A00,896260,Fischer-Grunski; Eva K,17,0,20,3
1746599135826,LIGM 5C,A00,896308,Fischer-Grunski; Eva K,18,0,20,2
1746599136852,LIIT 5AS,A00,896313,Carnelos; Chiara,18,0,20,2
1746599137880,LIIT 5BS,A00,896416,Carnelos; Chiara,20,0,20,0
1746599138908,LIIT 5CS,A00,896564,Carnelos; Chiara,20,0,20,0
1746599139937,LISP 5A,A00,896588,Munoz Sanchez; Alicia,2,0,20,18
1746599140964,LISP 5B,A00,896653,Munoz Sanchez; Alicia,7,0,20,13
1746599141993,LISP 5C,A00,896655,Munoz Sanchez; Alicia,0,1,20,20
1746599143021,MAE 197,001,957918,Kleissl; Jan,9996,0,9999,3
1746599143021,MAE 197,002,959806,Boechler; Nicholas Sebastia,9998,0,9999,1
1746599143021,MAE 197,003,959852,Mullin; Jennifer S,9998,0,9999,1
1746599144050,MATH 2,A01,957937,Staff,33,0,35,2
1746599145075,MATH 197,001,957876,Kedlaya; Kiran S.,9993,0,9999,6
1746599146100,MCWP 40,A00,892729,Duru; Nur,10,0,20,10
1746599146100,MCWP 40,B00,893304,Montejo; Carolina,14,0,20,6
1746599147129,MCWP 40R,A00,893757,Redela; Pamela Morgan,0,5,20,20
1746599148155,MCWP 50,A00,893758,Morshed; Michael James,0,0,20,20
1746599148155,MCWP 50,B00,893761,Bartulis; Jason Michael,17,0,20,3
1746599149180,MCWP 50R,A00,893766,Compas; Sean Matthew,0,1,20,20
1746599149180,MCWP 50R,B00,893769,Carter; Jennifer A,0,1,20,20
1746599149180,MCWP 50R,C00,893771,Krone; Jarret,0,3,20,20
1746599149180,MCWP 50R,D00,893772,Miller; Elizabeth Deen,0,0,20,20
1746599149180,MCWP 50R,E00,893775,Carter; Andrea L,0,1,20,20
1746599150207,MMW 11R,A01,892721,Herbst; Matthew,14,0,30,16
1746599150207,MMW 11R,A02,892722,Herbst; Matthew,0,0,0,3
1746599151234,MMW 12R,A01,892724,Herbst; Matthew,0,11,16,16
1746599151234,MMW 12R,A02,892725,Herbst; Matthew,0,10,16,16
1746599152258,MMW 13R,A01,892727,Staff,0,4,16,16
1746599152258,MMW 13R,A02,892728,Staff,0,4,16,16
1746599152258,MMW 13R,A03,958032,Staff,0,4,16,16
1746599152258,MMW 13R,A04,958033,Staff,0,4,16,16
1746599152258,MMW 13R,A05,958034,Staff,0,4,16,16
1746599153287,SIO 295LS,A00,894015,Staff,5,0,25,20
1746599154313,SIO 295S,A00,894020,Staff,5,0,25,20
1746599155343,SIOC 290S,B01,958918,Merrifield; Mark A,14,0,30,16
1746599156370,SIOC 291S,B01,958922,Gabriel; Corey John,14,0,30,16
1746599157395,SOCI 117,A01,895339,Staff,2,0,5,3
1746599158420,WES 237B,A00,894149,Staff,11,0,20,9
1746599160485,AESE 279B,A00,891859,Staff,13,0,35,22
1746599161511,AIP 197,001,891854,Vespa; Emanuel Ignacio,9999,0,9999,0
1746599162535,ANTH 289S,A00,891856,Gagneux; Pascal,12,0,12,0
1746599163564,BENG 196,001,957946,Engler; Adam J.,9996,0,9999,3
1746599164594,BISP 197,001,959851,Wilhelm; James E.,9998,0,9999,1
1746599165660,CAT 124RS,A01,956906,Staff,6,0,25,19
1746599166686,CAT 125RS,A01,922013,Staff,6,0,25,19
1746599167710,CLRE 250,A00,891860,Morris; Sheldon,9995,0,9999,4
1746599169763,CLRE 251R,A00,907817,Mehta; Ravindra L.,9994,0,9999,5
1746599170788,CLRE 252,A00,891864,Cuomo; Raphael Eduardo,9993,0,9999,6
1746599171816,CLRE 253,A00,891867,Vaida; Florin,9994,0,9999,5
1746599171816,CLRE 253,B00,907819,Staff,9999,0,9999,0
1746599172843,CLRE 259,A00,891868,Patel; Hemal,9998,0,9999,1
1746599173866,CLRE 260,A00,891872,Cuomo; Raphael Eduardo,9999,0,9999,0
1746599174895,CLRE 297,001,891888,Cuomo; Raphael Eduardo,9999,0,9999,0
1746599175920,CSE 191,A00,958773,Minnes Kemp; Mor Mia,9995,0,9999,4
1746599176946,CSE 197,001,959846,Minnes Kemp; Mor Mia,9990,0,9999,9
1746599177972,CSS 201S,A01,892054,Mignozzetti; Umberto,25,0,30,5
1746599178998,CSS 202S,A01,892056,Mignozzetti; Umberto,25,0,30,5
1746599180027,DSC 197,001,956898,Eldridge; Justin Matthew,9996,0,9999,3
1746599181057,DSC 297,001,958000,Mazumdar; Arya,9998,0,9999,1
1746599181057,DSC 297,002,959862,Wang; Yusu,9998,0,9999,1
1746599182082,EAP 100,A00,905686,Staff,9778,0,9999,221
1746599183109,ECE 45,A01,892618,Staff,0,0,65,65
1746599185161,ECE 111,A01,892719,Staff,6,0,65,59
1746599186189,ECE 197,001,957920,Mercier; Patrick Philip,9991,0,9999,8
1746599187215,ECON 178,A01,907814,Zhu; Ying,26,0,35,9
1746599188239,EDS 115,A00,895312,Staff,35,0,45,10
1746599189265,EDS 117,A01,895337,Staff,23,0,30,7
1746599190294,EDS 125,A00,895341,Jones; Gabrielle Anastasia,36,0,45,9
1746599191319,EDS 128A,A01,895459,Fargason; Sharon Gayle,44,0,45,1
1746599192347,EDS 128B,A01,895543,Pappas; Elizabeth,44,0,45,1
1746599193372,EDS 139,A00,897203,Pappas; Elizabeth,44,0,45,1
1746599193372,EDS 139,B00,897209,Fargason; Sharon Gayle,41,0,45,4
1746599194400,EDS 201,A00,895545,Staff,22,0,45,23
1746599195425,EDS 203,A01,895581,Halter; Christopher P.,22,0,45,23
1746599196451,EDS 204R,A01,895625,Heinzman; Erica M.,39,0,45,6
1746599196451,EDS 204R,B01,895693,Halter; Christopher P.,10,0,45,35
1746599197481,EDS 206R,A00,895694,Fargason; Sharon Gayle,1,0,30,29
1746599197481,EDS 206R,B00,895695,Choi; Bailey Miyeon,16,0,30,14
1746599198511,EDS 250,A00,895697,Hemans; Patricia Ann Benitez,22,0,45,23
1746599199542,EDS 281,A00,895701,Meyerott; Theresa Ann,1,0,15,14
1746599200572,EDS 284,A00,895736,Meyerott; Theresa Ann,1,0,15,14
1746599201603,EDS 286,A00,897210,Fine; Sarah,0,0,15,15
1746599202631,EDS 289C,A01,895770,Daly; Alan J.,1,0,15,14
1746599203661,EDS 290,A00,897211,Hofstetter; Carolyn,0,0,15,15
1746599204687,LIGM 5A,A00,896162,Fischer-Grunski; Eva K,12,0,20,8
1746599205714,LIGM 5B,A00,896260,Fischer-Grunski; Eva K,17,0,20,3
1746599206742,LIGM 5C,A00,896308,Fischer-Grunski; Eva K,18,0,20,2
1746599207770,LIIT 5AS,A00,896313,Carnelos; Chiara,18,0,20,2
1746599208800,LIIT 5BS,A00,896416,Carnelos; Chiara,20,0,20,0
1746599209830,LIIT 5CS,A00,896564,Carnelos; Chiara,20,0,20,0
1746599210857,LISP 5A,A00,896588,Munoz Sanchez; Alicia,2,0,20,18
1746599211888,LISP 5B,A00,896653,Munoz Sanchez; Alicia,7,0,20,13
1746599212917,LISP 5C,A00,896655,Munoz Sanchez; Alicia,0,1,20,20
1746599213944,MAE 197,001,957918,Kleissl; Jan,9996,0,9999,3
1746599213944,MAE 197,002,959806,Boechler; Nicholas Sebastia,9998,0,9999,1
1746599213944,MAE 197,003,959852,Mullin; Jennifer S,9998,0,9999,1
1746599214972,MATH 2,A01,957937,Staff,33,0,35,2
1746599216001,MATH 197,001,957876,Kedlaya; Kiran S.,9993,0,9999,6
1746599217027,MCWP 40,A00,892729,Duru; Nur,10,0,20,10
1746599217027,MCWP 40,B00,893304,Montejo; Carolina,14,0,20,6
1746599218052,MCWP 40R,A00,893757,Redela; Pamela Morgan,0,5,20,20
1746599219079,MCWP 50,A00,893758,Morshed; Michael James,0,0,20,20
1746599219079,MCWP 50,B00,893761,Bartulis; Jason Michael,17,0,20,3
1746599220105,MCWP 50R,A00,893766,Compas; Sean Matthew,0,1,20,20
1746599220105,MCWP 50R,B00,893769,Carter; Jennifer A,0,1,20,20
1746599220105,MCWP 50R,C00,893771,Krone; Jarret,0,3,20,20
1746599220105,MCWP 50R,D00,893772,Miller; Elizabeth Deen,0,0,20,20
1746599220105,MCWP 50R,E00,893775,Carter; Andrea L,0,1,20,20
1746599221135,MMW 11R,A01,892721,Herbst; Matthew,14,0,30,16
1746599221135,MMW 11R,A02,892722,Herbst; Matthew,0,0,0,3
1746599222161,MMW 12R,A01,892724,Herbst; Matthew,0,11,16,16
1746599222161,MMW 12R,A02,892725,Herbst; Matthew,0,10,16,16
1746599223190,MMW 13R,A01,892727,Staff,0,4,16,16
1746599223190,MMW 13R,A02,892728,Staff,0,4,16,16
1746599223190,MMW 13R,A03,958032,Staff,0,4,16,16
1746599223190,MMW 13R,A04,958033,Staff,0,4,16,16
1746599223190,MMW 13R,A05,958034,Staff,0,4,16,16
1746599224218,SIO 295LS,A00,894015,Staff,5,0,25,20
1746599225245,SIO 295S,A00,894020,Staff,5,0,25,20
1746599226271,SIOC 290S,B01,958918,Merrifield; Mark A,14,0,30,16
1746599227297,SIOC 291S,B01,958922,Gabriel; Corey John,14,0,30,16
1746599228324,SOCI 117,A01,895339,Staff,2,0,5,3
1746599229350,WES 237B,A00,894149,Staff,11,0,20,9
1746599231420,AESE 279B,A00,891859,Staff,13,0,35,22
1746599232449,AIP 197,001,891854,Vespa; Emanuel Ignacio,9999,0,9999,0
1746599233477,ANTH 289S,A00,891856,Gagneux; Pascal,12,0,12,0
1746599234503,BENG 196,001,957946,Engler; Adam J.,9996,0,9999,3
1746599235529,BISP 197,001,959851,Wilhelm; James E.,9998,0,9999,1
1746599236555,CAT 124RS,A01,956906,Staff,6,0,25,19
1746599237580,CAT 125RS,A01,922013,Staff,6,0,25,19
1746599238604,CLRE 250,A00,891860,Morris; Sheldon,9995,0,9999,4
1746599240657,CLRE 251R,A00,907817,Mehta; Ravindra L.,9994,0,9999,5
1746599241681,CLRE 252,A00,891864,Cuomo; Raphael Eduardo,9993,0,9999,6
1746599242707,CLRE 253,A00,891867,Vaida; Florin,9994,0,9999,5
1746599242707,CLRE 253,B00,907819,Staff,9999,0,9999,0
1746599243736,CLRE 259,A00,891868,Patel; Hemal,9998,0,9999,1
1746599244762,CLRE 260,A00,891872,Cuomo; Raphael Eduardo,9999,0,9999,0
1746599245789,CLRE 297,001,891888,Cuomo; Raphael Eduardo,9999,0,9999,0
1746599246819,CSE 191,A00,958773,Minnes Kemp; Mor Mia,9995,0,9999,4
1746599247848,CSE 197,001,959846,Minnes Kemp; Mor Mia,9990,0,9999,9
1746599248878,CSS 201S,A01,892054,Mignozzetti; Umberto,25,0,30,5
1746599249902,CSS 202S,A01,892056,Mignozzetti; Umberto,25,0,30,5
1746599250930,DSC 197,001,956898,Eldridge; Justin Matthew,9996,0,9999,3
1746599251958,DSC 297,001,958000,Mazumdar; Arya,9998,0,9999,1
1746599251958,DSC 297,002,959862,Wang; Yusu,9998,0,9999,1
1746599252985,EAP 100,A00,905686,Staff,9778,0,9999,221
1746599254014,ECE 45,A01,892618,Staff,0,0,65,65
1746599256069,ECE 111,A01,892719,Staff,6,0,65,59
1746599257093,ECE 197,001,957920,Mercier; Patrick Philip,9991,0,9999,8
1746599258123,ECON 178,A01,907814,Zhu; Ying,26,0,35,9
1746599259150,EDS 115,A00,895312,Staff,35,0,45,10
1746599260176,EDS 117,A01,895337,Staff,23,0,30,7
1746599261204,EDS 125,A00,895341,Jones; Gabrielle Anastasia,36,0,45,9
1746599262230,EDS 128A,A01,895459,Fargason; Sharon Gayle,44,0,45,1
1746599263255,EDS 128B,A01,895543,Pappas; Elizabeth,44,0,45,1
1746599264285,EDS 139,A00,897203,Pappas; Elizabeth,44,0,45,1
1746599264285,EDS 139,B00,897209,Fargason; Sharon Gayle,41,0,45,4
1746599265308,EDS 201,A00,895545,Staff,22,0,45,23
1746599266337,EDS 203,A01,895581,Halter; Christopher P.,22,0,45,23
1746599267363,EDS 204R,A01,895625,Heinzman; Erica M.,39,0,45,6
1746599267363,EDS 204R,B01,895693,Halter; Christopher P.,10,0,45,35
1746599268388,EDS 206R,A00,895694,Fargason; Sharon Gayle,1,0,30,29
1746599268388,EDS 206R,B00,895695,Choi; Bailey Miyeon,16,0,30,14
1746599269455,EDS 250,A00,895697,Hemans; Patricia Ann Benitez,22,0,45,23
1746599270484,EDS 281,A00,895701,Meyerott; Theresa Ann,1,0,15,14
1746599271511,EDS 284,A00,895736,Meyerott; Theresa Ann,1,0,15,14
1746599272540,EDS 286,A00,897210,Fine; Sarah,0,0,15,15
1746599273569,EDS 289C,A01,895770,Daly; Alan J.,1,0,15,14
1746599274599,EDS 290,A00,897211,Hofstetter; Carolyn,0,0,15,15
1746599275630,LIGM 5A,A00,896162,Fischer-Grunski; Eva K,12,0,20,8
1746599276657,LIGM 5B,A00,896260,Fischer-Grunski; Eva K,17,0,20,3
1746599277691,LIGM 5C,A00,896308,Fischer-Grunski; Eva K,18,0,20,2
1746599278716,LIIT 5AS,A00,896313,Carnelos; Chiara,18,0,20,2
1746599279743,LIIT 5BS,A00,896416,Carnelos; Chiara,20,0,20,0
1746599280769,LIIT 5CS,A00,896564,Carnelos; Chiara,20,0,20,0
1746599281793,LISP 5A,A00,896588,Munoz Sanchez; Alicia,2,0,20,18
1746599282823,LISP 5B,A00,896653,Munoz Sanchez; Alicia,7,0,20,13
1746599283849,LISP 5C,A00,896655,Munoz Sanchez; Alicia,0,1,20,20
1746599284876,MAE 197,001,957918,Kleissl; Jan,9996,0,9999,3
1746599284876,MAE 197,002,959806,Boechler; Nicholas Sebastia,9998,0,9999,1
1746599284876,MAE 197,003,959852,Mullin; Jennifer S,9998,0,9999,1
1746599285902,MATH 2,A01,957937,Staff,33,0,35,2
1746599286927,MATH 197,001,957876,Kedlaya; Kiran S.,9993,0,9999,6
1746599287954,MCWP 40,A00,892729,Duru; Nur,10,0,20,10
1746599287954,MCWP 40,B00,893304,Montejo; Carolina,14,0,20,6
1746599288979,MCWP 40R,A00,893757,Redela; Pamela Morgan,0,5,20,20
1746599290005,MCWP 50,A00,893758,Morshed; Michael James,0,0,20,20
1746599290005,MCWP 50,B00,893761,Bartulis; Jason Michael,17,0,20,3
1746599291033,MCWP 50R,A00,893766,Compas; Sean Matthew,0,1,20,20
1746599291033,MCWP 50R,B00,893769,Carter; Jennifer A,0,1,20,20
1746599291033,MCWP 50R,C00,893771,Krone; Jarret,0,3,20,20
1746599291033,MCWP 50R,D00,893772,Miller; Elizabeth Deen,0,0,20,20
1746599291033,MCWP 50R,E00,893775,Carter; Andrea L,0,1,20,20
1746599292061,MMW 11R,A01,892721,Herbst; Matthew,14,0,30,16
1746599292061,MMW 11R,A02,892722,Herbst; Matthew,0,0,0,3
1746599293089,MMW 12R,A01,892724,Herbst; Matthew,0,11,16,16
1746599293089,MMW 12R,A02,892725,Herbst; Matthew,0,10,16,16
1746599294115,MMW 13R,A01,892727,Staff,0,4,16,16
1746599294115,MMW 13R,A02,892728,Staff,0,4,16,16
1746599294115,MMW 13R,A03,958032,Staff,0,4,16,16
1746599294115,MMW 13R,A04,958033,Staff,0,4,16,16
1746599294115,MMW 13R,A05,958034,Staff,0,4,16,16
1746599295141,SIO 295LS,A00,894015,Staff,5,0,25,20
1746599296168,SIO 295S,A00,894020,Staff,5,0,25,20
1746599297199,SIOC 290S,B01,958918,Merrifield; Mark A,14,0,30,16
1746599298226,SIOC 291S,B01,958922,Gabriel; Corey John,14,0,30,16
1746599299256,SOCI 117,A01,895339,Staff,2,0,5,3
1746599300281,WES 237B,A00,894149,Staff,11,0,20,9
1746599302340,AESE 279B,A00,891859,Staff,13,0,35,22
1746599303369,AIP 197,001,891854,Vespa; Emanuel Ignacio,9999,0,9999,0
1746599304395,ANTH 289S,A00,891856,Gagneux; Pascal,12,0,12,0
1746599305419,BENG 196,001,957946,Engler; Adam J.,9996,0,9999,3
1746599306446,BISP 197,001,959851,Wilhelm; James E.,9998,0,9999,1
1746599307473,CAT 124RS,A01,956906,Staff,6,0,25,19
1746599308498,CAT 125RS,A01,922013,Staff,6,0,25,19
1746599309522,CLRE 250,A00,891860,Morris; Sheldon,9995,0,9999,4
1746599311578,CLRE 251R,A00,907817,Mehta; Ravindra L.,9994,0,9999,5
1746599312607,CLRE 252,A00,891864,Cuomo; Raphael Eduardo,9993,0,9999,6
1746599313635,CLRE 253,A00,891867,Vaida; Florin,9994,0,9999,5
1746599313635,CLRE 253,B00,907819,Staff,9999,0,9999,0
1746599314662,CLRE 259,A00,891868,Patel; Hemal,9998,0,9999,1
1746599315687,CLRE 260,A00,891872,Cuomo; Raphael Eduardo,9999,0,9999,0
1746599316715,CLRE 297,001,891888,Cuomo; Raphael Eduardo,9999,0,9999,0
1746599317744,CSE 191,A00,958773,Minnes Kemp; Mor Mia,9995,0,9999,4
1746599318768,CSE 197,001,959846,Minnes Kemp; Mor Mia,9990,0,9999,9
1746599319798,CSS 201S,A01,892054,Mignozzetti; Umberto,25,0,30,5
1746599320822,CSS 202S,A01,892056,Mignozzetti; Umberto,25,0,30,5
1746599321850,DSC 197,001,956898,Eldridge; Justin Matthew,9996,0,9999,3
1746599322878,DSC 297,001,958000,Mazumdar; Arya,9998,0,9999,1
1746599322878,DSC 297,002,959862,Wang; Yusu,9998,0,9999,1
1746599323904,EAP 100,A00,905686,Staff,9778,0,9999,221
1746599324933,ECE 45,A01,892618,Staff,0,0,65,65
1746599326984,ECE 111,A01,892719,Staff,6,0,65,59
1746599328010,ECE 197,001,957920,Mercier; Patrick Philip,9991,0,9999,8
1746599329037,ECON 178,A01,907814,Zhu; Ying,26,0,35,9
1746599330066,EDS 115,A00,895312,Staff,35,0,45,10
1746599331095,EDS 117,A01,895337,Staff,23,0,30,7
1746599332120,EDS 125,A00,895341,Jones; Gabrielle Anastasia,36,0,45,9
1746599333147,EDS 128A,A01,895459,Fargason; Sharon Gayle,44,0,45,1
1746599334177,EDS 128B,A01,895543,Pappas; Elizabeth,44,0,45,1
1746599335202,EDS 139,A00,897203,Pappas; Elizabeth,44,0,45,1
1746599335202,EDS 139,B00,897209,Fargason; Sharon Gayle,41,0,45,4
1746599336228,EDS 201,A00,895545,Staff,22,0,45,23
1746599337254,EDS 203,A01,895581,Halter; Christopher P.,22,0,45,23
1746599338280,EDS 204R,A01,895625,Heinzman; Erica M.,39,0,45,6
1746599338280,EDS 204R,B01,895693,Halter; Christopher P.,10,0,45,35
1746599339304,EDS 206R,A00,895694,Fargason; Sharon Gayle,1,0,30,29
1746599339304,EDS 206R,B00,895695,Choi; Bailey Miyeon,16,0,30,14
1746599340338,EDS 250,A00,895697,Hemans; Patricia Ann Benitez,22,0,45,23
1746599341366,EDS 281,A00,895701,Meyerott; Theresa Ann,1,0,15,14
1746599342399,EDS 284,A00,895736,Meyerott; Theresa Ann,1,0,15,14
1746599343427,EDS 286,A00,897210,Fine; Sarah,0,0,15,15
1746599344453,EDS 289C,A01,895770,Daly; Alan J.,1,0,15,14
1746599345481,EDS 290,A00,897211,Hofstetter; Carolyn,0,0,15,15
1746599346506,LIGM 5A,A00,896162,Fischer-Grunski; Eva K,12,0,20,8
1746599347531,LIGM 5B,A00,896260,Fischer-Grunski; Eva K,17,0,20,3
1746599348556,LIGM 5C,A00,896308,Fischer-Grunski; Eva K,18,0,20,2
1746599349585,LIIT 5AS,A00,896313,Carnelos; Chiara,18,0,20,2
1746599350609,LIIT 5BS,A00,896416,Carnelos; Chiara,20,0,20,0
1746599351640,LIIT 5CS,A00,896564,Carnelos; Chiara,20,0,20,0
1746599352666,LISP 5A,A00,896588,Munoz Sanchez; Alicia,2,0,20,18
1746599353690,LISP 5B,A00,896653,Munoz Sanchez; Alicia,7,0,20,13
1746599354716,LISP 5C,A00,896655,Munoz Sanchez; Alicia,0,1,20,20
1746599355741,MAE 197,001,957918,Kleissl; Jan,9996,0,9999,3
1746599355741,MAE 197,002,959806,Boechler; Nicholas Sebastia,9998,0,9999,1
1746599355741,MAE 197,003,959852,Mullin; Jennifer S,9998,0,9999,1
1746599356766,MATH 2,A01,957937,Staff,33,0,35,2
1746599357791,MATH 197,001,957876,Kedlaya; Kiran S.,9993,0,9999,6
1746599358820,MCWP 40,A00,892729,Duru; Nur,10,0,20,10
1746599358820,MCWP 40,B00,893304,Montejo; Carolina,14,0,20,6
1746599359850,MCWP 40R,A00,893757,Redela; Pamela Morgan,0,5,20,20
1746599360877,MCWP 50,A00,893758,Morshed; Michael James,0,0,20,20
1746599360877,MCWP 50,B00,893761,Bartulis; Jason Michael,17,0,20,3
1746599361902,MCWP 50R,A00,893766,Compas; Sean Matthew,0,1,20,20
1746599361902,MCWP 50R,B00,893769,Carter; Jennifer A,0,1,20,20
1746599361902,MCWP 50R,C00,893771,Krone; Jarret,0,3,20,20
1746599361902,MCWP 50R,D00,893772,Miller; Elizabeth Deen,0,0,20,20
1746599361902,MCWP 50R,E00,893775,Carter; Andrea L,0,1,20,20
1746599362926,MMW 11R,A01,892721,Herbst; Matthew,14,0,30,16
1746599362926,MMW 11R,A02,892722,Herbst; Matthew,0,0,0,3
1746599363951,MMW 12R,A01,892724,Herbst; Matthew,0,11,16,16
1746599363951,MMW 12R,A02,892725,Herbst; Matthew,0,10,16,16
1746599364975,MMW 13R,A01,892727,Staff,0,4,16,16
1746599364975,MMW 13R,A02,892728,Staff,0,4,16,16
1746599364975,MMW 13R,A03,958032,Staff,0,4,16,16
1746599364975,MMW 13R,A04,958033,Staff,0,4,16,16
1746599364975,MMW 13R,A05,958034,Staff,0,4,16,16
1746599366001,SIO 295LS,A00,894015,Staff,5,0,25,20
1746599367028,SIO 295S,A00,894020,Staff,5,0,25,20
1746599368058,SIOC 290S,B01,958918,Merrifield; Mark A,14,0,30,16
1746599369084,SIOC 291S,B01,958922,Gabriel; Corey John,14,0,30,16
1746599370108,SOCI 117,A01,895339,Staff,2,0,5,3
1746599371136,WES 237B,A00,894149,Staff,11,0,20,9
1746599373243,AESE 279B,A00,891859,Staff,13,0,35,22
1746599374271,AIP 197,001,891854,Vespa; Emanuel Ignacio,9999,0,9999,0
1746599375297,ANTH 289S,A00,891856,Gagneux; Pascal,12,0,12,0
1746599376325,BENG 196,001,957946,Engler; Adam J.,9996,0,9999,3
1746599377352,BISP 197,001,959851,Wilhelm; James E.,9998,0,9999,1
1746599378379,CAT 124RS,A01,956906,Staff,6,0,25,19
1746599379407,CAT 125RS,A01,922013,Staff,6,0,25,19
1746599380434,CLRE 250,A00,891860,Morris; Sheldon,9995,0,9999,4
1746599382485,CLRE 251R,A00,907817,Mehta; Ravindra L.,9994,0,9999,5
1746599383509,CLRE 252,A00,891864,Cuomo; Raphael Eduardo,9993,0,9999,6
1746599384539,CLRE 253,A00,891867,Vaida; Florin,9994,0,9999,5
1746599384539,CLRE 253,B00,907819,Staff,9999,0,9999,0
1746599385568,CLRE 259,A00,891868,Patel; Hemal,9998,0,9999,1
1746599386597,CLRE 260,A00,891872,Cuomo; Raphael Eduardo,9999,0,9999,0
1746599387623,CLRE 297,001,891888,Cuomo; Raphael Eduardo,9999,0,9999,0
1746599388650,CSE 191,A00,958773,Minnes Kemp; Mor Mia,9995,0,9999,4
1746599389676,CSE 197,001,959846,Minnes Kemp; Mor Mia,9990,0,9999,9
1746599390704,CSS 201S,A01,892054,Mignozzetti; Umberto,25,0,30,5
1746599391730,CSS 202S,A01,892056,Mignozzetti; Umberto,25,0,30,5
1746599392756,DSC 197,001,956898,Eldridge; Justin Matthew,9996,0,9999,3
1746599393782,DSC 297,001,958000,Mazumdar; Arya,9998,0,9999,1
1746599393782,DSC 297,002,959862,Wang; Yusu,9998,0,9999,1
1746599394809,EAP 100,A00,905686,Staff,9778,0,9999,221
1746599395836,ECE 45,A01,892618,Staff,0,0,65,65
1746599397890,ECE 111,A01,892719,Staff,6,0,65,59
1746599398915,ECE 197,001,957920,Mercier; Patrick Philip,9991,0,9999,8
1746599399946,ECON 178,A01,907814,Zhu; Ying,26,0,35,9
1746599400973,EDS 115,A00,895312,Staff,35,0,45,10
1746599401999,EDS 117,A01,895337,Staff,23,0,30,7
1746599403027,EDS 125,A00,895341,Jones; Gabrielle Anastasia,36,0,45,9
1746599404054,EDS 128A,A01,895459,Fargason; Sharon Gayle,44,0,45,1
1746599405083,EDS 128B,A01,895543,Pappas; Elizabeth,44,0,45,1
1746599406111,EDS 139,A00,897203,Pappas; Elizabeth,44,0,45,1
1746599406111,EDS 139,B00,897209,Fargason; Sharon Gayle,41,0,45,4
1746599407138,EDS 201,A00,895545,Staff,22,0,45,23
1746599408167,EDS 203,A01,895581,Halter; Christopher P.,22,0,45,23
1746599409195,EDS 204R,A01,895625,Heinzman; Erica M.,39,0,45,6
1746599409195,EDS 204R,B01,895693,Halter; Christopher P.,10,0,45,35
1746599410222,EDS 206R,A00,895694,Fargason; Sharon Gayle,1,0,30,29
1746599410222,EDS 206R,B00,895695,Choi; Bailey Miyeon,16,0,30,14
1746599411247,EDS 250,A00,895697,Hemans; Patricia Ann Benitez,22,0,45,23
1746599412272,EDS 281,A00,895701,Meyerott; Theresa Ann,1,0,15,14
1746599413298,EDS 284,A00,895736,Meyerott; Theresa Ann,1,0,15,14
1746599414325,EDS 286,A00,897210,Fine; Sarah,0,0,15,15
1746599415352,EDS 289C,A01,895770,Daly; Alan J.,1,0,15,14
1746599416376,EDS 290,A00,897211,Hofstetter; Carolyn,0,0,15,15
1746599417402,LIGM 5A,A00,896162,Fischer-Grunski; Eva K,12,0,20,8
1746599418429,LIGM 5B,A00,896260,Fischer-Grunski; Eva K,17,0,20,3
1746599419457,LIGM 5C,A00,896308,Fischer-Grunski; Eva K,18,0,20,2
1746599420483,LIIT 5AS,A00,896313,Carnelos; Chiara,18,0,20,2
1746599421510,LIIT 5BS,A00,896416,Carnelos; Chiara,20,0,20,0
1746599422535,LIIT 5CS,A00,896564,Carnelos; Chiara,20,0,20,0
1746599423561,LISP 5A,A00,896588,Munoz Sanchez; Alicia,2,0,20,18
1746599424587,LISP 5B,A00,896653,Munoz Sanchez; Alicia,7,0,20,13
1746599425614,LISP 5C,A00,896655,Munoz Sanchez; Alicia,0,1,20,20
1746599426642,MAE 197,001,957918,Kleissl; Jan,9996,0,9999,3
1746599426642,MAE 197,002,959806,Boechler; Nicholas Sebastia,9998,0,9999,1
1746599426642,MAE 197,003,959852,Mullin; Jennifer S,9998,0,9999,1
1746599427668,MATH 2,A01,957937,Staff,33,0,35,2
1746599428695,MATH 197,001,957876,Kedlaya; Kiran S.,9993,0,9999,6
1746599429721,MCWP 40,A00,892729,Duru; Nur,10,0,20,10
1746599429721,MCWP 40,B00,893304,Montejo; Carolina,14,0,20,6
1746599430747,MCWP 40R,A00,893757,Redela; Pamela Morgan,0,5,20,20
1746599431772,MCWP 50,A00,893758,Morshed; Michael James,0,0,20,20
1746599431772,MCWP 50,B00,893761,Bartulis; Jason Michael,17,0,20,3
1746599432798,MCWP 50R,A00,893766,Compas; Sean Matthew,0,1,20,20
1746599432798,MCWP 50R,B00,893769,Carter; Jennifer A,0,1,20,20
1746599432798,MCWP 50R,C00,893771,Krone; Jarret,0,3,20,20
1746599432798,MCWP 50R,D00,893772,Miller; Elizabeth Deen,0,0,20,20
1746599432798,MCWP 50R,E00,893775,Carter; Andrea L,0,1,20,20
1746599433822,MMW 11R,A01,892721,Herbst; Matthew,14,0,30,16
1746599433822,MMW 11R,A02,892722,Herbst; Matthew,0,0,0,3
1746599434853,MMW 12R,A01,892724,Herbst; Matthew,0,11,16,16
1746599434853,MMW 12R,A02,892725,Herbst; Matthew,0,10,16,16
1746599435882,MMW 13R,A01,892727,Staff,0,4,16,16
1746599435882,MMW 13R,A02,892728,Staff,0,4,16,16
1746599435882,MMW 13R,A03,958032,Staff,0,4,16,16
1746599435882,MMW 13R,A04,958033,Staff,0,4,16,16
1746599435882,MMW 13R,A05,958034,Staff,0,4,16,16
1746599436906,SIO 295LS,A00,894015,Staff,5,0,25,20
1746599437933,SIO 295S,A00,894020,Staff,5,0,25,20
1746599438965,SIOC 290S,B01,958918,Merrifield; Mark A,14,0,30,16
1746599439995,SIOC 291S,B01,958922,Gabriel; Corey John,14,0,30,16
1746599441026,SOCI 117,A01,895339,Staff,2,0,5,3
1746599442055,WES 237B,A00,894149,Staff,11,0,20,9
1746599444124,AESE 279B,A00,891859,Staff,13,0,35,22
1746599445154,AIP 197,001,891854,Vespa; Emanuel Ignacio,9999,0,9999,0
1746599446189,ANTH 289S,A00,891856,Gagneux; Pascal,12,0,12,0
1746599447215,BENG 196,001,957946,Engler; Adam J.,9996,0,9999,3
1746599448243,BISP 197,001,959851,Wilhelm; James E.,9998,0,9999,1
1746599449269,CAT 124RS,A01,956906,Staff,6,0,25,19
1746599450297,CAT 125RS,A01,922013,Staff,6,0,25,19
1746599451326,CLRE 250,A00,891860,Morris; Sheldon,9995,0,9999,4
1746599453381,CLRE 251R,A00,907817,Mehta; Ravindra L.,9994,0,9999,5
1746599454412,CLRE 252,A00,891864,Cuomo; Raphael Eduardo,9993,0,9999,6
1746599455441,CLRE 253,A00,891867,Vaida; Florin,9994,0,9999,5
1746599455441,CLRE 253,B00,907819,Staff,9999,0,9999,0
1746599456464,CLRE 259,A00,891868,Patel; Hemal,9998,0,9999,1
1746599457493,CLRE 260,A00,891872,Cuomo; Raphael Eduardo,9999,0,9999,0
1746599458519,CLRE 297,001,891888,Cuomo; Raphael Eduardo,9999,0,9999,0
1746599459545,CSE 191,A00,958773,Minnes Kemp; Mor Mia,9995,0,9999,4
1746599460570,CSE 197,001,959846,Minnes Kemp; Mor Mia,9990,0,9999,9
1746599461599,CSS 201S,A01,892054,Mignozzetti; Umberto,25,0,30,5
1746599462630,CSS 202S,A01,892056,Mignozzetti; Umberto,25,0,30,5
1746599463660,DSC 197,001,956898,Eldridge; Justin Matthew,9996,0,9999,3
1746599464689,DSC 297,001,958000,Mazumdar; Arya,9998,0,9999,1
1746599464689,DSC 297,002,959862,Wang; Yusu,9998,0,9999,1
1746599465715,EAP 100,A00,905686,Staff,9778,0,9999,221
1746599466741,ECE 45,A01,892618,Staff,0,0,65,65
1746599468799,ECE 111,A01,892719,Staff,6,0,65,59
1746599469825,ECE 197,001,957920,Mercier; Patrick Philip,9991,0,9999,8
1746599470857,ECON 178,A01,907814,Zhu; Ying,26,0,35,9
1746599471885,EDS 115,A00,895312,Staff,35,0,45,10
1746599472914,EDS 117,A01,895337,Staff,23,0,30,7
1746599473944,EDS 125,A00,895341,Jones; Gabrielle Anastasia,36,0,45,9
1746599474971,EDS 128A,A01,895459,Fargason; Sharon Gayle,44,0,45,1
1746599475997,EDS 128B,A01,895543,Pappas; Elizabeth,44,0,45,1
1746599477064,EDS 139,A00,897203,Pappas; Elizabeth,44,0,45,1
1746599477064,EDS 139,B00,897209,Fargason; Sharon Gayle,41,0,45,4
1746599478089,EDS 201,A00,895545,Staff,22,0,45,23
1746599479116,EDS 203,A01,895581,Halter; Christopher P.,22,0,45,23
1746599480142,EDS 204R,A01,895625,Heinzman; Erica M.,39,0,45,6
1746599480142,EDS 204R,B01,895693,Halter; Christopher P.,10,0,45,35
1746599481169,EDS 206R,A00,895694,Fargason; Sharon Gayle,1,0,30,29
1746599481169,EDS 206R,B00,895695,Choi; Bailey Miyeon,16,0,30,14
1746599482196,EDS 250,A00,895697,Hemans; Patricia Ann Benitez,22,0,45,23
1746599483223,EDS 281,A00,895701,Meyerott; Theresa Ann,1,0,15,14
1746599484248,EDS 284,A00,895736,Meyerott; Theresa Ann,1,0,15,14
1746599485274,EDS 286,A00,897210,Fine; Sarah,0,0,15,15
1746599486298,EDS 289C,A01,895770,Daly; Alan J.,1,0,15,14
1746599487322,EDS 290,A00,897211,Hofstetter; Carolyn,0,0,15,15
1746599488351,LIGM 5A,A00,896162,Fischer-Grunski; Eva K,12,0,20,8
1746599489376,LIGM 5B,A00,896260,Fischer-Grunski; Eva K,17,0,20,3
1746599490405,LIGM 5C,A00,896308,Fischer-Grunski; Eva K,18,0,20,2
1746599491431,LIIT 5AS,A00,896313,Carnelos; Chiara,18,0,20,2
1746599492456,LIIT 5BS,A00,896416,Carnelos; Chiara,20,0,20,0
1746599493484,LIIT 5CS,A00,896564,Carnelos; Chiara,20,0,20,0
1746599494508,LISP 5A,A00,896588,Munoz Sanchez; Alicia,2,0,20,18
1746599495534,LISP 5B,A00,896653,Munoz Sanchez; Alicia,7,0,20,13
1746599496563,LISP 5C,A00,896655,Munoz Sanchez; Alicia,0,1,20,20
1746599497593,MAE 197,001,957918,Kleissl; Jan,9996,0,9999,3
1746599497593,MAE 197,002,959806,Boechler; Nicholas Sebastia,9998,0,9999,1
1746599497593,MAE 197,003,959852,Mullin; Jennifer S,9998,0,9999,1
1746599498619,MATH 2,A01,957937,Staff,33,0,35,2
1746599499644,MATH 197,001,957876,Kedlaya; Kiran S.,9993,0,9999,6
1746599500675,MCWP 40,A00,892729,Duru; Nur,10,0,20,10
1746599500675,MCWP 40,B00,893304,Montejo; Carolina,14,0,20,6
1746599501721,MCWP 40R,A00,893757,Redela; Pamela Morgan,0,5,20,20
1746599502749,MCWP 50,A00,893758,Morshed; Michael James,0,0,20,20
1746599502749,MCWP 50,B00,893761,Bartulis; Jason Michael,17,0,20,3
1746599503778,MCWP 50R,A00,893766,Compas; Sean Matthew,0,1,20,20
1746599503778,MCWP 50R,B00,893769,Carter; Jennifer A,0,1,20,20
1746599503778,MCWP 50R,C00,893771,Krone; Jarret,0,3,20,20
1746599503778,MCWP 50R,D00,893772,Miller; Elizabeth Deen,0,0,20,20
1746599503778,MCWP 50R,E00,893775,Carter; Andrea L,0,1,20,20
1746599504803,MMW 11R,A01,892721,Herbst; Matthew,14,0,30,16
1746599504803,MMW 11R,A02,892722,Herbst; Matthew,0,0,0,3
1746599505830,MMW 12R,A01,892724,Herbst; Matthew,0,11,16,16
1746599505830,MMW 12R,A02,892725,Herbst; Matthew,0,10,16,16
1746599506856,MMW 13R,A01,892727,Staff,0,4,16,16
1746599506856,MMW 13R,A02,892728,Staff,0,4,16,16
1746599506856,MMW 13R,A03,958032,Staff,0,4,16,16
1746599506856,MMW 13R,A04,958033,Staff,0,4,16,16
1746599506856,MMW 13R,A05,958034,Staff,0,4,16,16
1746599507883,SIO 295LS,A00,894015,Staff,5,0,25,20
1746599508908,SIO 295S,A00,894020,Staff,5,0,25,20
1746599509936,SIOC 290S,B01,958918,Merrifield; Mark A,14,0,30,16
1746599510998,SIOC 291S,B01,958922,Gabriel; Corey John,14,0,30,16
1746599512022,SOCI 117,A01,895339,Staff,2,0,5,3
1746599513048,WES 237B,A00,894149,Staff,11,0,20,9
1746599515110,AESE 279B,A00,891859,Staff,13,0,35,22
1746599516134,AIP 197,001,891854,Vespa; Emanuel Ignacio,9999,0,9999,0
1746599517402,ANTH 289S,A00,891856,Gagneux; Pascal,12,0,12,0
1746599518427,BENG 196,001,957946,Engler; Adam J.,9996,0,9999,3
1746599519451,BISP 197,001,959851,Wilhelm; James E.,9998,0,9999,1
1746599520476,CAT 124RS,A01,956906,Staff,6,0,25,19
1746599521500,CAT 125RS,A01,922013,Staff,6,0,25,19
1746599522526,CLRE 250,A00,891860,Morris; Sheldon,9995,0,9999,4
1746599524579,CLRE 251R,A00,907817,Mehta; Ravindra L.,9994,0,9999,5
1746599525610,CLRE 252,A00,891864,Cuomo; Raphael Eduardo,9993,0,9999,6
1746599526636,CLRE 253,A00,891867,Vaida; Florin,9994,0,9999,5
1746599526636,CLRE 253,B00,907819,Staff,9999,0,9999,0
1746599527664,CLRE 259,A00,891868,Patel; Hemal,9998,0,9999,1
1746599528693,CLRE 260,A00,891872,Cuomo; Raphael Eduardo,9999,0,9999,0
1746599529720,CLRE 297,001,891888,Cuomo; Raphael Eduardo,9999,0,9999,0
1746599530749,CSE 191,A00,958773,Minnes Kemp; Mor Mia,9995,0,9999,4
1746599531775,CSE 197,001,959846,Minnes Kemp; Mor Mia,9990,0,9999,9
1746599532801,CSS 201S,A01,892054,Mignozzetti; Umberto,25,0,30,5
1746599533825,CSS 202S,A01,892056,Mignozzetti; Umberto,25,0,30,5
1746599534853,DSC 197,001,956898,Eldridge; Justin Matthew,9996,0,9999,3
1746599535881,DSC 297,001,958000,Mazumdar; Arya,9998,0,9999,1
1746599535881,DSC 297,002,959862,Wang; Yusu,9998,0,9999,1
1746599536910,EAP 100,A00,905686,Staff,9778,0,9999,221
1746599537935,ECE 45,A01,892618,Staff,0,0,65,65
1746599539988,ECE 111,A01,892719,Staff,6,0,65,59
1746599541013,ECE 197,001,957920,Mercier; Patrick Philip,9991,0,9999,8
1746599542040,ECON 178,A01,907814,Zhu; Ying,26,0,35,9
1746599543069,EDS 115,A00,895312,Staff,35,0,45,10
1746599544094,EDS 117,A01,895337,Staff,23,0,30,7
1746599545121,EDS 125,A00,895341,Jones; Gabrielle Anastasia,36,0,45,9
1746599546149,EDS 128A,A01,895459,Fargason; Sharon Gayle,44,0,45,1
1746599547177,EDS 128B,A01,895543,Pappas; Elizabeth,44,0,45,1
1746599548202,EDS 139,A00,897203,Pappas; Elizabeth,44,0,45,1
1746599548202,EDS 139,B00,897209,Fargason; Sharon Gayle,41,0,45,4
1746599549281,EDS 201,A00,895545,Staff,22,0,45,23
1746599550309,EDS 203,A01,895581,Halter; Christopher P.,22,0,45,23
1746599551333,EDS 204R,A01,895625,Heinzman; Erica M.,39,0,45,6
1746599551333,EDS 204R,B01,895693,Halter; Christopher P.,10,0,45,35
1746599552359,EDS 206R,A00,895694,Fargason; Sharon Gayle,1,0,30,29
1746599552359,EDS 206R,B00,895695,Choi; Bailey Miyeon,16,0,30,14
1746599553386,EDS 250,A00,895697,Hemans; Patricia Ann Benitez,22,0,45,23
1746599554409,EDS 281,A00,895701,Meyerott; Theresa Ann,1,0,15,14
1746599555435,EDS 284,A00,895736,Meyerott; Theresa Ann,1,0,15,14
1746599556460,EDS 286,A00,897210,Fine; Sarah,0,0,15,15
1746599557487,EDS 289C,A01,895770,Daly; Alan J.,1,0,15,14
1746599558514,EDS 290,A00,897211,Hofstetter; Carolyn,0,0,15,15
1746599559542,LIGM 5A,A00,896162,Fischer-Grunski; Eva K,12,0,20,8
1746599560567,LIGM 5B,A00,896260,Fischer-Grunski; Eva K,17,0,20,3
1746599561594,LIGM 5C,A00,896308,Fischer-Grunski; Eva K,18,0,20,2
1746599562620,LIIT 5AS,A00,896313,Carnelos; Chiara,18,0,20,2
1746599563649,LIIT 5BS,A00,896416,Carnelos; Chiara,20,0,20,0
1746599564674,LIIT 5CS,A00,896564,Carnelos; Chiara,20,0,20,0
1746599565699,LISP 5A,A00,896588,Munoz Sanchez; Alicia,2,0,20,18
1746599566730,LISP 5B,A00,896653,Munoz Sanchez; Alicia,7,0,20,13
1746599567756,LISP 5C,A00,896655,Munoz Sanchez; Alicia,0,1,20,20
1746599568781,MAE 197,001,957918,Kleissl; Jan,9996,0,9999,3
1746599568781,MAE 197,002,959806,Boechler; Nicholas Sebastia,9998,0,9999,1
1746599568781,MAE 197,003,959852,Mullin; Jennifer S,9998,0,9999,1
1746599569808,MATH 2,A01,957937,Staff,33,0,35,2
1746599570838,MATH 197,001,957876,Kedlaya; Kiran S.,9993,0,9999,6
1746599571863,MCWP 40,A00,892729,Duru; Nur,10,0,20,10
1746599571863,MCWP 40,B00,893304,Montejo; Carolina,14,0,20,6
1746599572888,MCWP 40R,A00,893757,Redela; Pamela Morgan,0,5,20,20
1746599573914,MCWP 50,A00,893758,Morshed; Michael James,0,0,20,20
1746599573914,MCWP 50,B00,893761,Bartulis; Jason Michael,17,0,20,3
1746599574967,MCWP 50R,A00,893766,Compas; Sean Matthew,0,1,20,20
1746599574967,MCWP 50R,B00,893769,Carter; Jennifer A,0,1,20,20
1746599574967,MCWP 50R,C00,893771,Krone; Jarret,0,3,20,20
1746599574967,MCWP 50R,D00,893772,Miller; Elizabeth Deen,0,0,20,20
1746599574967,MCWP 50R,E00,893775,Carter; Andrea L,0,1,20,20
1746599575993,MMW 11R,A01,892721,Herbst; Matthew,14,0,30,16
1746599575993,MMW 11R,A02,892722,Herbst; Matthew,0,0,0,3
1746599577019,MMW 12R,A01,892724,Herbst; Matthew,0,11,16,16
1746599577019,MMW 12R,A02,892725,Herbst; Matthew,0,10,16,16
1746599578044,MMW 13R,A01,892727,Staff,0,4,16,16
1746599578044,MMW 13R,A02,892728,Staff,0,4,16,16
1746599578044,MMW 13R,A03,958032,Staff,0,4,16,16
1746599578044,MMW 13R,A04,958033,Staff,0,4,16,16
1746599578044,MMW 13R,A05,958034,Staff,0,4,16,16
1746599579070,SIO 295LS,A00,894015,Staff,5,0,25,20
1746599580099,SIO 295S,A00,894020,Staff,5,0,25,20
1746599581128,SIOC 290S,B01,958918,Merrifield; Mark A,14,0,30,16
1746599582157,SIOC 291S,B01,958922,Gabriel; Corey John,14,0,30,16
1746599583183,SOCI 117,A01,895339,Staff,2,0,5,3
1746599584214,WES 237B,A00,894149,Staff,11,0,20,9
1746599586276,AESE 279B,A00,891859,Staff,13,0,35,22
1746599587303,AIP 197,001,891854,Vespa; Emanuel Ignacio,9999,0,9999,0
1746599588334,ANTH 289S,A00,891856,Gagneux; Pascal,12,0,12,0
1746599589362,BENG 196,001,957946,Engler; Adam J.,9996,0,9999,3
1746599590389,BISP 197,001,959851,Wilhelm; James E.,9998,0,9999,1
1746599591415,CAT 124RS,A01,956906,Staff,6,0,25,19
1746599592441,CAT 125RS,A01,922013,Staff,6,0,25,19
1746599593469,CLRE 250,A00,891860,Morris; Sheldon,9995,0,9999,4
1746599595521,CLRE 251R,A00,907817,Mehta; Ravindra L.,9994,0,9999,5
1746599596550,CLRE 252,A00,891864,Cuomo; Raphael Eduardo,9993,0,9999,6
1746599597578,CLRE 253,A00,891867,Vaida; Florin,9994,0,9999,5
1746599597578,CLRE 253,B00,907819,Staff,9999,0,9999,0
1746599598608,CLRE 259,A00,891868,Patel; Hemal,9998,0,9999,1
1746599599636,CLRE 260,A00,891872,Cuomo; Raphael Eduardo,9999,0,9999,0
1746599600661,CLRE 297,001,891888,Cuomo; Raphael Eduardo,9999,0,9999,0
1746599601687,CSE 191,A00,958773,Minnes Kemp; Mor Mia,9995,0,9999,4
1746599602714,CSE 197,001,959846,Minnes Kemp; Mor Mia,9990,0,9999,9
1746599603744,CSS 201S,A01,892054,Mignozzetti; Umberto,25,0,30,5
1746599604771,CSS 202S,A01,892056,Mignozzetti; Umberto,25,0,30,5
1746599605800,DSC 197,001,956898,Eldridge; Justin Matthew,9996,0,9999,3
1746599606828,DSC 297,001,958000,Mazumdar; Arya,9998,0,9999,1
1746599606828,DSC 297,002,959862,Wang; Yusu,9998,0,9999,1
1746599607857,EAP 100,A00,905686,Staff,9778,0,9999,221
1746599608885,ECE 45,A01,892618,Staff,0,0,65,65
1746599610941,ECE 111,A01,892719,Staff,6,0,65,59
1746599611967,ECE 197,001,957920,Mercier; Patrick Philip,9991,0,9999,8
1746599612994,ECON 178,A01,907814,Zhu; Ying,26,0,35,9
1746599614022,EDS 115,A00,895312,Staff,35,0,45,10
1746599615054,EDS 117,A01,895337,Staff,23,0,30,7
1746599616080,EDS 125,A00,895341,Jones; Gabrielle Anastasia,36,0,45,9
1746599617105,EDS 128A,A01,895459,Fargason; Sharon Gayle,44,0,45,1
1746599618136,EDS 128B,A01,895543,Pappas; Elizabeth,44,0,45,1
1746599619161,EDS 139,A00,897203,Pappas; Elizabeth,44,0,45,1
1746599619161,EDS 139,B00,897209,Fargason; Sharon Gayle,41,0,45,4
1746599620186,EDS 201,A00,895545,Staff,22,0,45,23
1746599621213,EDS 203,A01,895581,Halter; Christopher P.,22,0,45,23
1746599622239,EDS 204R,A01,895625,Heinzman; Erica M.,39,0,45,6
1746599622239,EDS 204R,B01,895693,Halter; Christopher P.,10,0,45,35
1746599623270,EDS 206R,A00,895694,Fargason; Sharon Gayle,1,0,30,29
1746599623270,EDS 206R,B00,895695,Choi; Bailey Miyeon,16,0,30,14
1746599624302,EDS 250,A00,895697,Hemans; Patricia Ann Benitez,22,0,45,23
1746599625329,EDS 281,A00,895701,Meyerott; Theresa Ann,1,0,15,14
1746599626356,EDS 284,A00,895736,Meyerott; Theresa Ann,1,0,15,14
1746599627382,EDS 286,A00,897210,Fine; Sarah,0,0,15,15
1746599628411,EDS 289C,A01,895770,Daly; Alan J.,1,0,15,14
1746599629434,EDS 290,A00,897211,Hofstetter; Carolyn,0,0,15,15
1746599630461,LIGM 5A,A00,896162,Fischer-Grunski; Eva K,12,0,20,8
1746599631487,LIGM 5B,A00,896260,Fischer-Grunski; Eva K,17,0,20,3
1746599632511,LIGM 5C,A00,896308,Fischer-Grunski; Eva K,18,0,20,2
1746599633537,LIIT 5AS,A00,896313,Carnelos; Chiara,18,0,20,2
1746599634584,LIIT 5BS,A00,896416,Carnelos; Chiara,20,0,20,0
1746599635614,LIIT 5CS,A00,896564,Carnelos; Chiara,20,0,20,0
1746599636640,LISP 5A,A00,896588,Munoz Sanchez; Alicia,2,0,20,18
1746599637688,LISP 5B,A00,896653,Munoz Sanchez; Alicia,7,0,20,13
1746599638716,LISP 5C,A00,896655,Munoz Sanchez; Alicia,0,1,20,20
1746599639742,MAE 197,001,957918,Kleissl; Jan,9996,0,9999,3
1746599639742,MAE 197,002,959806,Boechler; Nicholas Sebastia,9998,0,9999,1
1746599639742,MAE 197,003,959852,Mullin; Jennifer S,9998,0,9999,1
1746599640768,MATH 2,A01,957937,Staff,33,0,35,2
1746599641800,MATH 197,001,957876,Kedlaya; Kiran S.,9993,0,9999,6
1746599642829,MCWP 40,A00,892729,Duru; Nur,10,0,20,10
1746599642829,MCWP 40,B00,893304,Montejo; Carolina,14,0,20,6
1746599643854,MCWP 40R,A00,893757,Redela; Pamela Morgan,0,5,20,20
1746599644883,MCWP 50,A00,893758,Morshed; Michael James,0,0,20,20
1746599644883,MCWP 50,B00,893761,Bartulis; Jason Michael,17,0,20,3
1746599645913,MCWP 50R,A00,893766,Compas; Sean Matthew,0,1,20,20
1746599645913,MCWP 50R,B00,893769,Carter; Jennifer A,0,1,20,20
1746599645913,MCWP 50R,C00,893771,Krone; Jarret,0,3,20,20
1746599645913,MCWP 50R,D00,893772,Miller; Elizabeth Deen,0,0,20,20
1746599645913,MCWP 50R,E00,893775,Carter; Andrea L,0,1,20,20
1746599646940,MMW 11R,A01,892721,Herbst; Matthew,14,0,30,16
1746599646940,MMW 11R,A02,892722,Herbst; Matthew,0,0,0,3
1746599647971,MMW 12R,A01,892724,Herbst; Matthew,0,11,16,16
1746599647971,MMW 12R,A02,892725,Herbst; Matthew,0,10,16,16
1746599648998,MMW 13R,A01,892727,Staff,0,4,16,16
1746599648998,MMW 13R,A02,892728,Staff,0,4,16,16
1746599648998,MMW 13R,A03,958032,Staff,0,4,16,16
1746599648998,MMW 13R,A04,958033,Staff,0,4,16,16
1746599648998,MMW 13R,A05,958034,Staff,0,4,16,16
1746599650031,SIO 295LS,A00,894015,Staff,5,0,25,20
1746599651058,SIO 295S,A00,894020,Staff,5,0,25,20
1746599652082,SIOC 290S,B01,958918,Merrifield; Mark A,14,0,30,16
1746599653112,SIOC 291S,B01,958922,Gabriel; Corey John,14,0,30,16
1746599654137,SOCI 117,A01,895339,Staff,2,0,5,3
1746599655163,WES 237B,A00,894149,Staff,11,0,20,9
1746599657225,AESE 279B,A00,891859,Staff,13,0,35,22
1746599658248,AIP 197,001,891854,Vespa; Emanuel Ignacio,9999,0,9999,0
1746599659273,ANTH 289S,A00,891856,Gagneux; Pascal,12,0,12,0
1746599660301,BENG 196,001,957946,Engler; Adam J.,9996,0,9999,3
1746599661326,BISP 197,001,959851,Wilhelm; James E.,9998,0,9999,1
1746599662351,CAT 124RS,A01,956906,Staff,6,0,25,19
1746599663376,CAT 125RS,A01,922013,Staff,6,0,25,19
1746599664405,CLRE 250,A00,891860,Morris; Sheldon,9995,0,9999,4
1746599666488,CLRE 251R,A00,907817,Mehta; Ravindra L.,9994,0,9999,5
1746599667514,CLRE 252,A00,891864,Cuomo; Raphael Eduardo,9993,0,9999,6
1746599668542,CLRE 253,A00,891867,Vaida; Florin,9994,0,9999,5
1746599668542,CLRE 253,B00,907819,Staff,9999,0,9999,0
1746599669567,CLRE 259,A00,891868,Patel; Hemal,9998,0,9999,1
1746599670594,CLRE 260,A00,891872,Cuomo; Raphael Eduardo,9999,0,9999,0
1746599671620,CLRE 297,001,891888,Cuomo; Raphael Eduardo,9999,0,9999,0
1746599672647,CSE 191,A00,958773,Minnes Kemp; Mor Mia,9995,0,9999,4
1746599673671,CSE 197,001,959846,Minnes Kemp; Mor Mia,9990,0,9999,9
1746599674697,CSS 201S,A01,892054,Mignozzetti; Umberto,25,0,30,5
1746599675722,CSS 202S,A01,892056,Mignozzetti; Umberto,25,0,30,5
1746599676748,DSC 197,001,956898,Eldridge; Justin Matthew,9996,0,9999,3
1746599677772,DSC 297,001,958000,Mazumdar; Arya,9998,0,9999,1
1746599677772,DSC 297,002,959862,Wang; Yusu,9998,0,9999,1
1746599678797,EAP 100,A00,905686,Staff,9778,0,9999,221
1746599679825,ECE 45,A01,892618,Staff,0,0,65,65
1746599681874,ECE 111,A01,892719,Staff,6,0,65,59
1746599682900,ECE 197,001,957920,Mercier; Patrick Philip,9991,0,9999,8
1746599683929,ECON 178,A01,907814,Zhu; Ying,26,0,35,9
1746599684958,EDS 115,A00,895312,Staff,35,0,45,10
1746599685987,EDS 117,A01,895337,Staff,23,0,30,7
1746599687014,EDS 125,A00,895341,Jones; Gabrielle Anastasia,36,0,45,9
1746599688041,EDS 128A,A01,895459,Fargason; Sharon Gayle,44,0,45,1
1746599689067,EDS 128B,A01,895543,Pappas; Elizabeth,44,0,45,1
1746599690095,EDS 139,A00,897203,Pappas; Elizabeth,44,0,45,1
1746599690095,EDS 139,B00,897209,Fargason; Sharon Gayle,41,0,45,4
1746599691124,EDS 201,A00,895545,Staff,22,0,45,23
1746599692149,EDS 203,A01,895581,Halter; Christopher P.,22,0,45,23
1746599693175,EDS 204R,A01,895625,Heinzman; Erica M.,39,0,45,6
1746599693175,EDS 204R,B01,895693,Halter; Christopher P.,10,0,45,35
1746599694201,EDS 206R,A00,895694,Fargason; Sharon Gayle,1,0,30,29
1746599694201,EDS 206R,B00,895695,Choi; Bailey Miyeon,16,0,30,14
1746599695226,EDS 250,A00,895697,Hemans; Patricia Ann Benitez,22,0,45,23
1746599696255,EDS 281,A00,895701,Meyerott; Theresa Ann,1,0,15,14
1746599697282,EDS 284,A00,895736,Meyerott; Theresa Ann,1,0,15,14
1746599698309,EDS 286,A00,897210,Fine; Sarah,0,0,15,15
1746599699335,EDS 289C,A01,895770,Daly; Alan J.,1,0,15,14
1746599700364,EDS 290,A00,897211,Hofstetter; Carolyn,0,0,15,15
1746599701392,LIGM 5A,A00,896162,Fischer-Grunski; Eva K,12,0,20,8
1746599702419,LIGM 5B,A00,896260,Fischer-Grunski; Eva K,17,0,20,3
1746599703445,LIGM 5C,A00,896308,Fischer-Grunski; Eva K,18,0,20,2
1746599704470,LIIT 5AS,A00,896313,Carnelos; Chiara,18,0,20,2
1746599705496,LIIT 5BS,A00,896416,Carnelos; Chiara,20,0,20,0
1746599706523,LIIT 5CS,A00,896564,Carnelos; Chiara,20,0,20,0
1746599707554,LISP 5A,A00,896588,Munoz Sanchez; Alicia,2,0,20,18
1746599708582,LISP 5B,A00,896653,Munoz Sanchez; Alicia,7,0,20,13
1746599709612,LISP 5C,A00,896655,Munoz Sanchez; Alicia,0,1,20,20
1746599710639,MAE 197,001,957918,Kleissl; Jan,9996,0,9999,3
1746599710639,MAE 197,002,959806,Boechler; Nicholas Sebastia,9998,0,9999,1
1746599710639,MAE 197,003,959852,Mullin; Jennifer S,9998,0,9999,1
1746599711664,MATH 2,A01,957937,Staff,33,0,35,2
1746599712690,MATH 197,001,957876,Kedlaya; Kiran S.,9993,0,9999,6
1746599713720,MCWP 40,A00,892729,Duru; Nur,10,0,20,10
1746599713720,MCWP 40,B00,893304,Montejo; Carolina,14,0,20,6
1746599714745,MCWP 40R,A00,893757,Redela; Pamela Morgan,0,5,20,20
1746599715771,MCWP 50,A00,893758,Morshed; Michael James,0,0,20,20
1746599715771,MCWP 50,B00,893761,Bartulis; Jason Michael,17,0,20,3
1746599716802,MCWP 50R,A00,893766,Compas; Sean Matthew,0,1,20,20
1746599716802,MCWP 50R,B00,893769,Carter; Jennifer A,0,1,20,20
1746599716802,MCWP 50R,C00,893771,Krone; Jarret,0,3,20,20
1746599716802,MCWP 50R,D00,893772,Miller; Elizabeth Deen,0,0,20,20
1746599716802,MCWP 50R,E00,893775,Carter; Andrea L,0,1,20,20
1746599717828,MMW 11R,A01,892721,Herbst; Matthew,14,0,30,16
1746599717828,MMW 11R,A02,892722,Herbst; Matthew,0,0,0,3
1746599718854,MMW 12R,A01,892724,Herbst; Matthew,0,11,16,16
1746599718854,MMW 12R,A02,892725,Herbst; Matthew,0,10,16,16
1746599719883,MMW 13R,A01,892727,Staff,0,4,16,16
1746599719883,MMW 13R,A02,892728,Staff,0,4,16,16
1746599719883,MMW 13R,A03,958032,Staff,0,4,16,16
1746599719883,MMW 13R,A04,958033,Staff,0,4,16,16
1746599719883,MMW 13R,A05,958034,Staff,0,4,16,16
1746599720908,SIO 295LS,A00,894015,Staff,5,0,25,20
1746599721934,SIO 295S,A00,894020,Staff,5,0,25,20
1746599722960,SIOC 290S,B01,958918,Merrifield; Mark A,14,0,30,16
1746599723987,SIOC 291S,B01,958922,Gabriel; Corey John,14,0,30,16
1746599725014,SOCI 117,A01,895339,Staff,2,0,5,3
1746599726039,WES 237B,A00,894149,Staff,11,0,20,9
1746599728103,AESE 279B,A00,891859,Staff,13,0,35,22
1746599729128,AIP 197,001,891854,Vespa; Emanuel Ignacio,9999,0,9999,0
1746599730156,ANTH 289S,A00,891856,Gagneux; Pascal,12,0,12,0
1746599731183,BENG 196,001,957946,Engler; Adam J.,9996,0,9999,3
1746599732212,BISP 197,001,959851,Wilhelm; James E.,9998,0,9999,1
1746599733240,CAT 124RS,A01,956906,Staff,6,0,25,19
1746599734264,CAT 125RS,A01,922013,Staff,6,0,25,19
1746599735290,CLRE 250,A00,891860,Morris; Sheldon,9995,0,9999,4
1746599737344,CLRE 251R,A00,907817,Mehta; Ravindra L.,9994,0,9999,5
1746599738369,CLRE 252,A00,891864,Cuomo; Raphael Eduardo,9993,0,9999,6
1746599739403,CLRE 253,A00,891867,Vaida; Florin,9994,0,9999,5
1746599739403,CLRE 253,B00,907819,Staff,9999,0,9999,0
1746599740427,CLRE 259,A00,891868,Patel; Hemal,9998,0,9999,1
1746599741456,CLRE 260,A00,891872,Cuomo; Raphael Eduardo,9999,0,9999,0
1746599742480,CLRE 297,001,891888,Cuomo; Raphael Eduardo,9999,0,9999,0
1746599743506,CSE 191,A00,958773,Minnes Kemp; Mor Mia,9995,0,9999,4
1746599744533,CSE 197,001,959846,Minnes Kemp; Mor Mia,9990,0,9999,9
1746599745558,CSS 201S,A01,892054,Mignozzetti; Umberto,25,0,30,5
1746599746583,CSS 202S,A01,892056,Mignozzetti; Umberto,25,0,30,5
1746599747610,DSC 197,001,956898,Eldridge; Justin Matthew,9996,0,9999,3
1746599748634,DSC 297,001,958000,Mazumdar; Arya,9998,0,9999,1
1746599748634,DSC 297,002,959862,Wang; Yusu,9998,0,9999,1
1746599749661,EAP 100,A00,905686,Staff,9778,0,9999,221
1746599750687,ECE 45,A01,892618,Staff,0,0,65,65
1746599752742,ECE 111,A01,892719,Staff,6,0,65,59
1746599753768,ECE 197,001,957920,Mercier; Patrick Philip,9991,0,9999,8
1746599754796,ECON 178,A01,907814,Zhu; Ying,26,0,35,9
1746599755822,EDS 115,A00,895312,Staff,35,0,45,10
1746599756851,EDS 117,A01,895337,Staff,23,0,30,7
1746599757875,EDS 125,A00,895341,Jones; Gabrielle Anastasia,36,0,45,9
1746599758902,EDS 128A,A01,895459,Fargason; Sharon Gayle,44,0,45,1
1746599759931,EDS 128B,A01,895543,Pappas; Elizabeth,44,0,45,1
1746599760956,EDS 139,A00,897203,Pappas; Elizabeth,44,0,45,1
1746599760956,EDS 139,B00,897209,Fargason; Sharon Gayle,41,0,45,4
1746599761985,EDS 201,A00,895545,Staff,22,0,45,23
1746599763011,EDS 203,A01,895581,Halter; Christopher P.,22,0,45,23
1746599764040,EDS 204R,A01,895625,Heinzman; Erica M.,39,0,45,6
1746599764040,EDS 204R,B01,895693,Halter; Christopher P.,10,0,45,35
1746599765072,EDS 206R,A00,895694,Fargason; Sharon Gayle,1,0,30,29
1746599765072,EDS 206R,B00,895695,Choi; Bailey Miyeon,16,0,30,14
1746599766168,EDS 250,A00,895697,Hemans; Patricia Ann Benitez,22,0,45,23
1746599767193,EDS 281,A00,895701,Meyerott; Theresa Ann,1,0,15,14
1746599768224,EDS 284,A00,895736,Meyerott; Theresa Ann,1,0,15,14
1746599769250,EDS 286,A00,897210,Fine; Sarah,0,0,15,15
1746599770281,EDS 289C,A01,895770,Daly; Alan J.,1,0,15,14
1746599771308,EDS 290,A00,897211,Hofstetter; Carolyn,0,0,15,15
1746599772338,LIGM 5A,A00,896162,Fischer-Grunski; Eva K,12,0,20,8
1746599773367,LIGM 5B,A00,896260,Fischer-Grunski; Eva K,17,0,20,3
1746599774398,LIGM 5C,A00,896308,Fischer-Grunski; Eva K,18,0,20,2
1746599775424,LIIT 5AS,A00,896313,Carnelos; Chiara,18,0,20,2
1746599776455,LIIT 5BS,A00,896416,Carnelos; Chiara,20,0,20,0
1746599777479,LIIT 5CS,A00,896564,Carnelos; Chiara,20,0,20,0
1746599778507,LISP 5A,A00,896588,Munoz Sanchez; Alicia,2,0,20,18
1746599779535,LISP 5B,A00,896653,Munoz Sanchez; Alicia,7,0,20,13
1746599780563,LISP 5C,A00,896655,Munoz Sanchez; Alicia,0,1,20,20
1746599781589,MAE 197,001,957918,Kleissl; Jan,9996,0,9999,3
1746599781589,MAE 197,002,959806,Boechler; Nicholas Sebastia,9998,0,9999,1
1746599781589,MAE 197,003,959852,Mullin; Jennifer S,9998,0,9999,1
1746599782614,MATH 2,A01,957937,Staff,33,0,35,2
1746599783642,MATH 197,001,957876,Kedlaya; Kiran S.,9993,0,9999,6
1746599784669,MCWP 40,A00,892729,Duru; Nur,10,0,20,10
1746599784669,MCWP 40,B00,893304,Montejo; Carolina,14,0,20,6
1746599785695,MCWP 40R,A00,893757,Redela; Pamela Morgan,0,5,20,20
1746599786724,MCWP 50,A00,893758,Morshed; Michael James,0,0,20,20
1746599786724,MCWP 50,B00,893761,Bartulis; Jason Michael,17,0,20,3
1746599787748,MCWP 50R,A00,893766,Compas; Sean Matthew,0,1,20,20
1746599787748,MCWP 50R,B00,893769,Carter; Jennifer A,0,1,20,20
1746599787748,MCWP 50R,C00,893771,Krone; Jarret,0,3,20,20
1746599787748,MCWP 50R,D00,893772,Miller; Elizabeth Deen,0,0,20,20
1746599787748,MCWP 50R,E00,893775,Carter; Andrea L,0,1,20,20
1746599788774,MMW 11R,A01,892721,Herbst; Matthew,14,0,30,16
1746599788774,MMW 11R,A02,892722,Herbst; Matthew,0,0,0,3
1746599789800,MMW 12R,A01,892724,Herbst; Matthew,0,11,16,16
1746599789800,MMW 12R,A02,892725,Herbst; Matthew,0,10,16,16
1746599790829,MMW 13R,A01,892727,Staff,0,4,16,16
1746599790829,MMW 13R,A02,892728,Staff,0,4,16,16
1746599790829,MMW 13R,A03,958032,Staff,0,4,16,16
1746599790829,MMW 13R,A04,958033,Staff,0,4,16,16
1746599790829,MMW 13R,A05,958034,Staff,0,4,16,16
1746599791864,SIO 295LS,A00,894015,Staff,5,0,25,20
1746599792891,SIO 295S,A00,894020,Staff,5,0,25,20
1746599793920,SIOC 290S,B01,958918,Merrifield; Mark A,14,0,30,16
1746599794951,SIOC 291S,B01,958922,Gabriel; Corey John,14,0,30,16
1746599795978,SOCI 117,A01,895339,Staff,2,0,5,3
1746599797005,WES 237B,A00,894149,Staff,11,0,20,9
1746599799066,AESE 279B,A00,891859,Staff,13,0,35,22
1746599800094,AIP 197,001,891854,Vespa; Emanuel Ignacio,9999,0,9999,0
1746599801123,ANTH 289S,A00,891856,Gagneux; Pascal,12,0,12,0
1746599802151,BENG 196,001,957946,Engler; Adam J.,9996,0,9999,3
1746599803177,BISP 197,001,959851,Wilhelm; James E.,9998,0,9999,1
1746599804201,CAT 124RS,A01,956906,Staff,6,0,25,19
1746599805230,CAT 125RS,A01,922013,Staff,6,0,25,19
1746599806256,CLRE 250,A00,891860,Morris; Sheldon,9995,0,9999,4
1746599808310,CLRE 251R,A00,907817,Mehta; Ravindra L.,9994,0,9999,5
1746599809336,CLRE 252,A00,891864,Cuomo; Raphael Eduardo,9993,0,9999,6
1746599810365,CLRE 253,A00,891867,Vaida; Florin,9994,0,9999,5
1746599810365,CLRE 253,B00,907819,Staff,9999,0,9999,0
1746599811390,CLRE 259,A00,891868,Patel; Hemal,9998,0,9999,1
1746599812417,CLRE 260,A00,891872,Cuomo; Raphael Eduardo,9999,0,9999,0
1746599813444,CLRE 297,001,891888,Cuomo; Raphael Eduardo,9999,0,9999,0
1746599814474,CSE 191,A00,958773,Minnes Kemp; Mor Mia,9995,0,9999,4
1746599815501,CSE 197,001,959846,Minnes Kemp; Mor Mia,9990,0,9999,9
1746599816528,CSS 201S,A01,892054,Mignozzetti; Umberto,25,0,30,5
1746599817556,CSS 202S,A01,892056,Mignozzetti; Umberto,25,0,30,5
1746599818582,DSC 197,001,956898,Eldridge; Justin Matthew,9996,0,9999,3
1746599819610,DSC 297,001,958000,Mazumdar; Arya,9998,0,9999,1
1746599819610,DSC 297,002,959862,Wang; Yusu,9998,0,9999,1
1746599820638,EAP 100,A00,905686,Staff,9778,0,9999,221
1746599821666,ECE 45,A01,892618,Staff,0,0,65,65
1746599823721,ECE 111,A01,892719,Staff,6,0,65,59
1746599824750,ECE 197,001,957920,Mercier; Patrick Philip,9991,0,9999,8
1746599825776,ECON 178,A01,907814,Zhu; Ying,26,0,35,9
1746599826805,EDS 115,A00,895312,Staff,35,0,45,10
1746599827831,EDS 117,A01,895337,Staff,23,0,30,7
1746599828861,EDS 125,A00,895341,Jones; Gabrielle Anastasia,36,0,45,9
1746599829887,EDS 128A,A01,895459,Fargason; Sharon Gayle,44,0,45,1
1746599830915,EDS 128B,A01,895543,Pappas; Elizabeth,44,0,45,1
1746599831942,EDS 139,A00,897203,Pappas; Elizabeth,44,0,45,1
1746599831942,EDS 139,B00,897209,Fargason; Sharon Gayle,41,0,45,4
1746599832970,EDS 201,A00,895545,Staff,22,0,45,23
1746599833998,EDS 203,A01,895581,Halter; Christopher P.,22,0,45,23
1746599835024,EDS 204R,A01,895625,Heinzman; Erica M.,39,0,45,6
1746599835024,EDS 204R,B01,895693,Halter; Christopher P.,10,0,45,35
1746599836051,EDS 206R,A00,895694,Fargason; Sharon Gayle,1,0,30,29
1746599836051,EDS 206R,B00,895695,Choi; Bailey Miyeon,16,0,30,14
1746599837077,EDS 250,A00,895697,Hemans; Patricia Ann Benitez,22,0,45,23
1746599838102,EDS 281,A00,895701,Meyerott; Theresa Ann,1,0,15,14
1746599839130,EDS 284,A00,895736,Meyerott; Theresa Ann,1,0,15,14
1746599840159,EDS 286,A00,897210,Fine; Sarah,0,0,15,15
1746599841187,EDS 289C,A01,895770,Daly; Alan J.,1,0,15,14
1746599842212,EDS 290,A00,897211,Hofstetter; Carolyn,0,0,15,15
1746599843241,LIGM 5A,A00,896162,Fischer-Grunski; Eva K,12,0,20,8
1746599844271,LIGM 5B,A00,896260,Fischer-Grunski; Eva K,17,0,20,3
1746599845303,LIGM 5C,A00,896308,Fischer-Grunski; Eva K,18,0,20,2
1746599846329,LIIT 5AS,A00,896313,Carnelos; Chiara,18,0,20,2
1746599847358,LIIT 5BS,A00,896416,Carnelos; Chiara,20,0,20,0
1746599848384,LIIT 5CS,A00,896564,Carnelos; Chiara,20,0,20,0
1746599849410,LISP 5A,A00,896588,Munoz Sanchez; Alicia,2,0,20,18
1746599850439,LISP 5B,A00,896653,Munoz Sanchez; Alicia,7,0,20,13
1746599851465,LISP 5C,A00,896655,Munoz Sanchez; Alicia,0,1,20,20
1746599852496,MAE 197,001,957918,Kleissl; Jan,9996,0,9999,3
1746599852496,MAE 197,002,959806,Boechler; Nicholas Sebastia,9998,0,9999,1
1746599852496,MAE 197,003,959852,Mullin; Jennifer S,9998,0,9999,1
1746599853522,MATH 2,A01,957937,Staff,33,0,35,2
1746599854547,MATH 197,001,957876,Kedlaya; Kiran S.,9993,0,9999,6
1746599855574,MCWP 40,A00,892729,Duru; Nur,10,0,20,10
1746599855574,MCWP 40,B00,893304,Montejo; Carolina,14,0,20,6
1746599856601,MCWP 40R,A00,893757,Redela; Pamela Morgan,0,5,20,20
1746599857634,MCWP 50,A00,893758,Morshed; Michael James,0,0,20,20
1746599857634,MCWP 50,B00,893761,Bartulis; Jason Michael,17,0,20,3
1746599858660,MCWP 50R,A00,893766,Compas; Sean Matthew,0,1,20,20
1746599858660,MCWP 50R,B00,893769,Carter; Jennifer A,0,1,20,20
1746599858660,MCWP 50R,C00,893771,Krone; Jarret,0,3,20,20
1746599858660,MCWP 50R,D00,893772,Miller; Elizabeth Deen,0,0,20,20
1746599858660,MCWP 50R,E00,893775,Carter; Andrea L,0,1,20,20
1746599859686,MMW 11R,A01,892721,Herbst; Matthew,14,0,30,16
1746599859686,MMW 11R,A02,892722,Herbst; Matthew,0,0,0,3
1746599860716,MMW 12R,A01,892724,Herbst; Matthew,0,11,16,16
1746599860716,MMW 12R,A02,892725,Herbst; Matthew,0,10,16,16
1746599861745,MMW 13R,A01,892727,Staff,0,4,16,16
1746599861745,MMW 13R,A02,892728,Staff,0,4,16,16
1746599861745,MMW 13R,A03,958032,Staff,0,4,16,16
1746599861745,MMW 13R,A04,958033,Staff,0,4,16,16
1746599861745,MMW 13R,A05,958034,Staff,0,4,16,16
1746599862772,SIO 295LS,A00,894015,Staff,5,0,25,20
1746599863799,SIO 295S,A00,894020,Staff,5,0,25,20
1746599864832,SIOC 290S,B01,958918,Merrifield; Mark A,14,0,30,16
1746599865858,SIOC 291S,B01,958922,Gabriel; Corey John,14,0,30,16
1746599866883,SOCI 117,A01,895339,Staff,2,0,5,3
1746599867908,WES 237B,A00,894149,Staff,11,0,20,9
1746599869968,AESE 279B,A00,891859,Staff,13,0,35,22
1746599870995,AIP 197,001,891854,Vespa; Emanuel Ignacio,9999,0,9999,0
1746599872023,ANTH 289S,A00,891856,Gagneux; Pascal,12,0,12,0
1746599873050,BENG 196,001,957946,Engler; Adam J.,9996,0,9999,3
1746599874076,BISP 197,001,959851,Wilhelm; James E.,9998,0,9999,1
1746599875102,CAT 124RS,A01,956906,Staff,6,0,25,19
1746599876132,CAT 125RS,A01,922013,Staff,6,0,25,19
1746599877161,CLRE 250,A00,891860,Morris; Sheldon,9995,0,9999,4
1746599879210,CLRE 251R,A00,907817,Mehta; Ravindra L.,9994,0,9999,5
1746599880235,CLRE 252,A00,891864,Cuomo; Raphael Eduardo,9993,0,9999,6
1746599881265,CLRE 253,A00,891867,Vaida; Florin,9994,0,9999,5
1746599881265,CLRE 253,B00,907819,Staff,9999,0,9999,0
1746599882292,CLRE 259,A00,891868,Patel; Hemal,9998,0,9999,1
1746599883317,CLRE 260,A00,891872,Cuomo; Raphael Eduardo,9999,0,9999,0
1746599884345,CLRE 297,001,891888,Cuomo; Raphael Eduardo,9999,0,9999,0
1746599885372,CSE 191,A00,958773,Minnes Kemp; Mor Mia,9995,0,9999,4
1746599886400,CSE 197,001,959846,Minnes Kemp; Mor Mia,9990,0,9999,9
1746599887428,CSS 201S,A01,892054,Mignozzetti; Umberto,25,0,30,5
1746599888453,CSS 202S,A01,892056,Mignozzetti; Umberto,25,0,30,5
1746599889480,DSC 197,001,956898,Eldridge; Justin Matthew,9996,0,9999,3
1746599890509,DSC 297,001,958000,Mazumdar; Arya,9998,0,9999,1
1746599890509,DSC 297,002,959862,Wang; Yusu,9998,0,9999,1
1746599891534,EAP 100,A00,905686,Staff,9778,0,9999,221
1746599892560,ECE 45,A01,892618,Staff,0,0,65,65
1746599894613,ECE 111,A01,892719,Staff,6,0,65,59
1746599895640,ECE 197,001,957920,Mercier; Patrick Philip,9991,0,9999,8
1746599896666,ECON 178,A01,907814,Zhu; Ying,26,0,35,9
1746599897694,EDS 115,A00,895312,Staff,35,0,45,10
1746599898719,EDS 117,A01,895337,Staff,23,0,30,7
1746599899745,EDS 125,A00,895341,Jones; Gabrielle Anastasia,36,0,45,9
1746599900777,EDS 128A,A01,895459,Fargason; Sharon Gayle,44,0,45,1
1746599901805,EDS 128B,A01,895543,Pappas; Elizabeth,44,0,45,1
1746599902830,EDS 139,A00,897203,Pappas; Elizabeth,44,0,45,1
1746599902830,EDS 139,B00,897209,Fargason; Sharon Gayle,41,0,45,4
1746599903857,EDS 201,A00,895545,Staff,22,0,45,23
1746599904884,EDS 203,A01,895581,Halter; Christopher P.,22,0,45,23
1746599905915,EDS 204R,A01,895625,Heinzman; Erica M.,39,0,45,6
1746599905915,EDS 204R,B01,895693,Halter; Christopher P.,10,0,45,35
1746599906939,EDS 206R,A00,895694,Fargason; Sharon Gayle,1,0,30,29
1746599906939,EDS 206R,B00,895695,Choi; Bailey Miyeon,16,0,30,14
1746599907968,EDS 250,A00,895697,Hemans; Patricia Ann Benitez,22,0,45,23
1746599908999,EDS 281,A00,895701,Meyerott; Theresa Ann,1,0,15,14
1746599910030,EDS 284,A00,895736,Meyerott; Theresa Ann,1,0,15,14
1746599911060,EDS 286,A00,897210,Fine; Sarah,0,0,15,15
1746599912087,EDS 289C,A01,895770,Daly; Alan J.,1,0,15,14
1746599913112,EDS 290,A00,897211,Hofstetter; Carolyn,0,0,15,15
1746599914159,LIGM 5A,A00,896162,Fischer-Grunski; Eva K,12,0,20,8
1746599915185,LIGM 5B,A00,896260,Fischer-Grunski; Eva K,17,0,20,3
1746599916213,LIGM 5C,A00,896308,Fischer-Grunski; Eva K,18,0,20,2
1746599917240,LIIT 5AS,A00,896313,Carnelos; Chiara,18,0,20,2
1746599918274,LIIT 5BS,A00,896416,Carnelos; Chiara,20,0,20,0
1746599919299,LIIT 5CS,A00,896564,Carnelos; Chiara,20,0,20,0
1746599920325,LISP 5A,A00,896588,Munoz Sanchez; Alicia,2,0,20,18
1746599921352,LISP 5B,A00,896653,Munoz Sanchez; Alicia,7,0,20,13
1746599922379,LISP 5C,A00,896655,Munoz Sanchez; Alicia,0,1,20,20
1746599923405,MAE 197,001,957918,Kleissl; Jan,9996,0,9999,3
1746599923405,MAE 197,002,959806,Boechler; Nicholas Sebastia,9998,0,9999,1
1746599923405,MAE 197,003,959852,Mullin; Jennifer S,9998,0,9999,1
1746599924429,MATH 2,A01,957937,Staff,33,0,35,2
1746599925456,MATH 197,001,957876,Kedlaya; Kiran S.,9993,0,9999,6
1746599926480,MCWP 40,A00,892729,Duru; Nur,10,0,20,10
1746599926480,MCWP 40,B00,893304,Montejo; Carolina,14,0,20,6
1746599927507,MCWP 40R,A00,893757,Redela; Pamela Morgan,0,5,20,20
1746599928534,MCWP 50,A00,893758,Morshed; Michael James,0,0,20,20
1746599928534,MCWP 50,B00,893761,Bartulis; Jason Michael,17,0,20,3
1746599929562,MCWP 50R,A00,893766,Compas; Sean Matthew,0,1,20,20
1746599929562,MCWP 50R,B00,893769,Carter; Jennifer A,0,1,20,20
1746599929562,MCWP 50R,C00,893771,Krone; Jarret,0,3,20,20
1746599929562,MCWP 50R,D00,893772,Miller; Elizabeth Deen,0,0,20,20
1746599929562,MCWP 50R,E00,893775,Carter; Andrea L,0,1,20,20
1746599930590,MMW 11R,A01,892721,Herbst; Matthew,14,0,30,16
1746599930590,MMW 11R,A02,892722,Herbst; Matthew,0,0,0,3
1746599931617,MMW 12R,A01,892724,Herbst; Matthew,0,11,16,16
1746599931617,MMW 12R,A02,892725,Herbst; Matthew,0,10,16,16
1746599932645,MMW 13R,A01,892727,Staff,0,4,16,16
1746599932645,MMW 13R,A02,892728,Staff,0,4,16,16
1746599932645,MMW 13R,A03,958032,Staff,0,4,16,16
1746599932645,MMW 13R,A04,958033,Staff,0,4,16,16
1746599932645,MMW 13R,A05,958034,Staff,0,4,16,16
1746599933670,SIO 295LS,A00,894015,Staff,5,0,25,20
1746599934697,SIO 295S,A00,894020,Staff,5,0,25,20
1746599935722,SIOC 290S,B01,958918,Merrifield; Mark A,14,0,30,16
1746599936748,SIOC 291S,B01,958922,Gabriel; Corey John,14,0,30,16
1746599937772,SOCI 117,A01,895339,Staff,2,0,5,3
1746599938797,WES 237B,A00,894149,Staff,11,0,20,9
1746599940859,AESE 279B,A00,891859,Staff,13,0,35,22
1746599941897,AIP 197,001,891854,Vespa; Emanuel Ignacio,9999,0,9999,0
1746599942924,ANTH 289S,A00,891856,Gagneux; Pascal,12,0,12,0
1746599943953,BENG 196,001,957946,Engler; Adam J.,9996,0,9999,3
1746599944981,BISP 197,001,959851,Wilhelm; James E.,9998,0,9999,1
1746599946006,CAT 124RS,A01,956906,Staff,6,0,25,19
1746599947030,CAT 125RS,A01,922013,Staff,6,0,25,19
1746599948056,CLRE 250,A00,891860,Morris; Sheldon,9995,0,9999,4
1746599950109,CLRE 251R,A00,907817,Mehta; Ravindra L.,9994,0,9999,5
1746599951133,CLRE 252,A00,891864,Cuomo; Raphael Eduardo,9993,0,9999,6
1746599952162,CLRE 253,A00,891867,Vaida; Florin,9994,0,9999,5
1746599952162,CLRE 253,B00,907819,Staff,9999,0,9999,0
1746599953189,CLRE 259,A00,891868,Patel; Hemal,9998,0,9999,1
1746599954214,CLRE 260,A00,891872,Cuomo; Raphael Eduardo,9999,0,9999,0
1746599955238,CLRE 297,001,891888,Cuomo; Raphael Eduardo,9999,0,9999,0
1746599956265,CSE 191,A00,958773,Minnes Kemp; Mor Mia,9995,0,9999,4
1746599957289,CSE 197,001,959846,Minnes Kemp; Mor Mia,9990,0,9999,9
1746599958320,CSS 201S,A01,892054,Mignozzetti; Umberto,25,0,30,5
1746599959349,CSS 202S,A01,892056,Mignozzetti; Umberto,25,0,30,5
1746599960374,DSC 197,001,956898,Eldridge; Justin Matthew,9996,0,9999,3
1746599961400,DSC 297,001,958000,Mazumdar; Arya,9998,0,9999,1
1746599961400,DSC 297,002,959862,Wang; Yusu,9998,0,9999,1
1746599962428,EAP 100,A00,905686,Staff,9778,0,9999,221
1746599963518,ECE 45,A01,892618,Staff,0,0,65,65
1746599965577,ECE 111,A01,892719,Staff,6,0,65,59
1746599966604,ECE 197,001,957920,Mercier; Patrick Philip,9991,0,9999,8
1746599967633,ECON 178,A01,907814,Zhu; Ying,26,0,35,9
1746599968661,EDS 115,A00,895312,Staff,35,0,45,10
1746599969688,EDS 117,A01,895337,Staff,23,0,30,7
1746599970716,EDS 125,A00,895341,Jones; Gabrielle Anastasia,36,0,45,9
1746599971742,EDS 128A,A01,895459,Fargason; Sharon Gayle,44,0,45,1
1746599972774,EDS 128B,A01,895543,Pappas; Elizabeth,44,0,45,1
1746599973798,EDS 139,A00,897203,Pappas; Elizabeth,44,0,45,1
1746599973798,EDS 139,B00,897209,Fargason; Sharon Gayle,41,0,45,4
1746599974827,EDS 201,A00,895545,Staff,22,0,45,23
1746599975854,EDS 203,A01,895581,Halter; Christopher P.,22,0,45,23
1746599976879,EDS 204R,A01,895625,Heinzman; Erica M.,39,0,45,6
1746599976879,EDS 204R,B01,895693,Halter; Christopher P.,10,0,45,35
1746599977904,EDS 206R,A00,895694,Fargason; Sharon Gayle,1,0,30,29
1746599977904,EDS 206R,B00,895695,Choi; Bailey Miyeon,16,0,30,14
1746599978930,EDS 250,A00,895697,Hemans; Patricia Ann Benitez,22,0,45,23
1746599979955,EDS 281,A00,895701,Meyerott; Theresa Ann,1,0,15,14
1746599980979,EDS 284,A00,895736,Meyerott; Theresa Ann,1,0,15,14
1746599982005,EDS 286,A00,897210,Fine; Sarah,0,0,15,15
1746599983032,EDS 289C,A01,895770,Daly; Alan J.,1,0,15,14
1746599984061,EDS 290,A00,897211,Hofstetter; Carolyn,0,0,15,15
1746599985086,LIGM 5A,A00,896162,Fischer-Grunski; Eva K,12,0,20,8
1746599986115,LIGM 5B,A00,896260,Fischer-Grunski; Eva K,17,0,20,3
1746599987143,LIGM 5C,A00,896308,Fischer-Grunski; Eva K,18,0,20,2
1746599988171,LIIT 5AS,A00,896313,Carnelos; Chiara,18,0,20,2
1746599989198,LIIT 5BS,A00,896416,Carnelos; Chiara,20,0,20,0
1746599990225,LIIT 5CS,A00,896564,Carnelos; Chiara,20,0,20,0
1746599991250,LISP 5A,A00,896588,Munoz Sanchez; Alicia,2,0,20,18
1746599992280,LISP 5B,A00,896653,Munoz Sanchez; Alicia,7,0,20,13
1746599993306,LISP 5C,A00,896655,Munoz Sanchez; Alicia,0,1,20,20
1746599994332,MAE 197,001,957918,Kleissl; Jan,9996,0,9999,3
1746599994332,MAE 197,002,959806,Boechler; Nicholas Sebastia,9998,0,9999,1
1746599994332,MAE 197,003,959852,Mullin; Jennifer S,9998,0,9999,1
1746599995359,MATH 2,A01,957937,Staff,33,0,35,2
1746599996387,MATH 197,001,957876,Kedlaya; Kiran S.,9993,0,9999,6
1746599997413,MCWP 40,A00,892729,Duru; Nur,10,0,20,10
1746599997413,MCWP 40,B00,893304,Montejo; Carolina,14,0,20,6
1746599998442,MCWP 40R,A00,893757,Redela; Pamela Morgan,0,5,20,20
1746599999473,MCWP 50,A00,893758,Morshed; Michael James,0,0,20,20
1746599999473,MCWP 50,B00,893761,Bartulis; Jason Michael,17,0,20,3
1746600000516,MCWP 50R,A00,893766,Compas; Sean Matthew,0,1,20,20
1746600000516,MCWP 50R,B00,893769,Carter; Jennifer A,0,1,20,20
1746600000516,MCWP 50R,C00,893771,Krone; Jarret,0,3,20,20
1746600000516,MCWP 50R,D00,893772,Miller; Elizabeth Deen,0,0,20,20
1746600000516,MCWP 50R,E00,893775,Carter; Andrea L,0,1,20,20
1746600001543,MMW 11R,A01,892721,Herbst; Matthew,14,0,30,16
1746600001543,MMW 11R,A02,892722,Herbst; Matthew,0,0,0,3
1746600002583,MMW 12R,A01,892724,Herbst; Matthew,0,11,16,16
1746600002583,MMW 12R,A02,892725,Herbst; Matthew,0,10,16,16
1746600003608,MMW 13R,A01,892727,Staff,0,4,16,16
1746600003608,MMW 13R,A02,892728,Staff,0,4,16,16
1746600003608,MMW 13R,A03,958032,Staff,0,4,16,16
1746600003608,MMW 13R,A04,958033,Staff,0,4,16,16
1746600003608,MMW 13R,A05,958034,Staff,0,4,16,16
1746600004636,SIO 295LS,A00,894015,Staff,5,0,25,20
1746600005664,SIO 295S,A00,894020,Staff,5,0,25,20
1746600006690,SIOC 290S,B01,958918,Merrifield; Mark A,14,0,30,16
1746600007718,SIOC 291S,B01,958922,Gabriel; Corey John,14,0,30,16
1746600008746,SOCI 117,A01,895339,Staff,2,0,5,3
1746600009774,WES 237B,A00,894149,Staff,11,0,20,9
1746600011836,AESE 279B,A00,891859,Staff,13,0,35,22
1746600012861,AIP 197,001,891854,Vespa; Emanuel Ignacio,9999,0,9999,0
1746600013889,ANTH 289S,A00,891856,Gagneux; Pascal,12,0,12,0
1746600014915,BENG 196,001,957946,Engler; Adam J.,9996,0,9999,3
1746600015942,BISP 197,001,959851,Wilhelm; James E.,9998,0,9999,1
1746600016966,CAT 124RS,A01,956906,Staff,6,0,25,19
1746600017994,CAT 125RS,A01,922013,Staff,6,0,25,19
1746600019021,CLRE 250,A00,891860,Morris; Sheldon,9995,0,9999,4
1746600021078,CLRE 251R,A00,907817,Mehta; Ravindra L.,9994,0,9999,5
1746600022106,CLRE 252,A00,891864,Cuomo; Raphael Eduardo,9993,0,9999,6
1746600023136,CLRE 253,A00,891867,Vaida; Florin,9994,0,9999,5
1746600023136,CLRE 253,B00,907819,Staff,9999,0,9999,0
1746600024161,CLRE 259,A00,891868,Patel; Hemal,9998,0,9999,1
1746600025189,CLRE 260,A00,891872,Cuomo; Raphael Eduardo,9999,0,9999,0
1746600026215,CLRE 297,001,891888,Cuomo; Raphael Eduardo,9999,0,9999,0
1746600027239,CSE 191,A00,958773,Minnes Kemp; Mor Mia,9995,0,9999,4
1746600028270,CSE 197,001,959846,Minnes Kemp; Mor Mia,9990,0,9999,9
1746600029297,CSS 201S,A01,892054,Mignozzetti; Umberto,25,0,30,5
1746600030330,CSS 202S,A01,892056,Mignozzetti; Umberto,25,0,30,5
1746600031356,DSC 197,001,956898,Eldridge; Justin Matthew,9996,0,9999,3
1746600032383,DSC 297,001,958000,Mazumdar; Arya,9998,0,9999,1
1746600032383,DSC 297,002,959862,Wang; Yusu,9998,0,9999,1
1746600033411,EAP 100,A00,905686,Staff,9778,0,9999,221
1746600034436,ECE 45,A01,892618,Staff,0,0,65,65
1746600036491,ECE 111,A01,892719,Staff,6,0,65,59
1746600037517,ECE 197,001,957920,Mercier; Patrick Philip,9991,0,9999,8
1746600038547,ECON 178,A01,907814,Zhu; Ying,26,0,35,9
1746600039574,EDS 115,A00,895312,Staff,35,0,45,10
1746600040601,EDS 117,A01,895337,Staff,23,0,30,7
1746600041631,EDS 125,A00,895341,Jones; Gabrielle Anastasia,36,0,45,9
1746600042659,EDS 128A,A01,895459,Fargason; Sharon Gayle,44,0,45,1
1746600043687,EDS 128B,A01,895543,Pappas; Elizabeth,44,0,45,1
1746600044712,EDS 139,A00,897203,Pappas; Elizabeth,44,0,45,1
1746600044712,EDS 139,B00,897209,Fargason; Sharon Gayle,41,0,45,4
1746600045739,EDS 201,A00,895545,Staff,22,0,45,23
1746600046767,EDS 203,A01,895581,Halter; Christopher P.,22,0,45,23
1746600047793,EDS 204R,A01,895625,Heinzman; Erica M.,39,0,45,6
1746600047793,EDS 204R,B01,895693,Halter; Christopher P.,10,0,45,35
1746600048820,EDS 206R,A00,895694,Fargason; Sharon Gayle,1,0,30,29
1746600048820,EDS 206R,B00,895695,Choi; Bailey Miyeon,16,0,30,14
1746600049848,EDS 250,A00,895697,Hemans; Patricia Ann Benitez,22,0,45,23
1746600050874,EDS 281,A00,895701,Meyerott; Theresa Ann,1,0,15,14
1746600051900,EDS 284,A00,895736,Meyerott; Theresa Ann,1,0,15,14
1746600052929,EDS 286,A00,897210,Fine; Sarah,0,0,15,15
1746600053959,EDS 289C,A01,895770,Daly; Alan J.,1,0,15,14
1746600054986,EDS 290,A00,897211,Hofstetter; Carolyn,0,0,15,15
1746600056012,LIGM 5A,A00,896162,Fischer-Grunski; Eva K,12,0,20,8
1746600057036,LIGM 5B,A00,896260,Fischer-Grunski; Eva K,17,0,20,3
1746600058064,LIGM 5C,A00,896308,Fischer-Grunski; Eva K,18,0,20,2
1746600059095,LIIT 5AS,A00,896313,Carnelos; Chiara,18,0,20,2
1746600060127,LIIT 5BS,A00,896416,Carnelos; Chiara,20,0,20,0
1746600061153,LIIT 5CS,A00,896564,Carnelos; Chiara,20,0,20,0
1746600062182,LISP 5A,A00,896588,Munoz Sanchez; Alicia,2,0,20,18
1746600063209,LISP 5B,A00,896653,Munoz Sanchez; Alicia,7,0,20,13
1746600064234,LISP 5C,A00,896655,Munoz Sanchez; Alicia,0,1,20,20
1746600065261,MAE 197,001,957918,Kleissl; Jan,9996,0,9999,3
1746600065261,MAE 197,002,959806,Boechler; Nicholas Sebastia,9998,0,9999,1
1746600065261,MAE 197,003,959852,Mullin; Jennifer S,9998,0,9999,1
1746600066285,MATH 2,A01,957937,Staff,33,0,35,2
1746600067311,MATH 197,001,957876,Kedlaya; Kiran S.,9993,0,9999,6
1746600068338,MCWP 40,A00,892729,Duru; Nur,10,0,20,10
1746600068338,MCWP 40,B00,893304,Montejo; Carolina,14,0,20,6
1746600069365,MCWP 40R,A00,893757,Redela; Pamela Morgan,0,5,20,20
1746600070395,MCWP 50,A00,893758,Morshed; Michael James,0,0,20,20
1746600070395,MCWP 50,B00,893761,Bartulis; Jason Michael,17,0,20,3
1746600071423,MCWP 50R,A00,893766,Compas; Sean Matthew,0,1,20,20
1746600071423,MCWP 50R,B00,893769,Carter; Jennifer A,0,1,20,20
1746600071423,MCWP 50R,C00,893771,Krone; Jarret,0,3,20,20
1746600071423,MCWP 50R,D00,893772,Miller; Elizabeth Deen,0,0,20,20
1746600071423,MCWP 50R,E00,893775,Carter; Andrea L,0,1,20,20
1746600072448,MMW 11R,A01,892721,Herbst; Matthew,14,0,30,16
1746600072448,MMW 11R,A02,892722,Herbst; Matthew,0,0,0,3
1746600073476,MMW 12R,A01,892724,Herbst; Matthew,0,11,16,16
1746600073476,MMW 12R,A02,892725,Herbst; Matthew,0,10,16,16
1746600074505,MMW 13R,A01,892727,Staff,0,4,16,16
1746600074505,MMW 13R,A02,892728,Staff,0,4,16,16
1746600074505,MMW 13R,A03,958032,Staff,0,4,16,16
1746600074505,MMW 13R,A04,958033,Staff,0,4,16,16
1746600074505,MMW 13R,A05,958034,Staff,0,4,16,16
1746600075532,SIO 295LS,A00,894015,Staff,5,0,25,20
1746600076557,SIO 295S,A00,894020,Staff,5,0,25,20
1746600077587,SIOC 290S,B01,958918,Merrifield; Mark A,14,0,30,16
1746600078613,SIOC 291S,B01,958922,Gabriel; Corey John,14,0,30,16
1746600079639,SOCI 117,A01,895339,Staff,2,0,5,3
1746600080664,WES 237B,A00,894149,Staff,11,0,20,9
1746600082720,AESE 279B,A00,891859,Staff,13,0,35,22
1746600083750,AIP 197,001,891854,Vespa; Emanuel Ignacio,9999,0,9999,0
1746600084780,ANTH 289S,A00,891856,Gagneux; Pascal,12,0,12,0
1746600085808,BENG 196,001,957946,Engler; Adam J.,9996,0,9999,3
1746600086836,BISP 197,001,959851,Wilhelm; James E.,9998,0,9999,1
1746600087863,CAT 124RS,A01,956906,Staff,6,0,25,19
1746600088891,CAT 125RS,A01,922013,Staff,6,0,25,19
1746600089920,CLRE 250,A00,891860,Morris; Sheldon,9995,0,9999,4
1746600091976,CLRE 251R,A00,907817,Mehta; Ravindra L.,9994,0,9999,5
1746600093006,CLRE 252,A00,891864,Cuomo; Raphael Eduardo,9993,0,9999,6
1746600094033,CLRE 253,A00,891867,Vaida; Florin,9994,0,9999,5
1746600094033,CLRE 253,B00,907819,Staff,9999,0,9999,0
1746600095062,CLRE 259,A00,891868,Patel; Hemal,9998,0,9999,1
1746600096086,CLRE 260,A00,891872,Cuomo; Raphael Eduardo,9999,0,9999,0
1746600097113,CLRE 297,001,891888,Cuomo; Raphael Eduardo,9999,0,9999,0
1746600098141,CSE 191,A00,958773,Minnes Kemp; Mor Mia,9995,0,9999,4
1746600099171,CSE 197,001,959846,Minnes Kemp; Mor Mia,9990,0,9999,9
1746600100202,CSS 201S,A01,892054,Mignozzetti; Umberto,25,0,30,5
1746600101232,CSS 202S,A01,892056,Mignozzetti; Umberto,25,0,30,5
1746600102260,DSC 197,001,956898,Eldridge; Justin Matthew,9996,0,9999,3
1746600103287,DSC 297,001,958000,Mazumdar; Arya,9998,0,9999,1
1746600103287,DSC 297,002,959862,Wang; Yusu,9998,0,9999,1
1746600104316,EAP 100,A00,905686,Staff,9778,0,9999,221
1746600105346,ECE 45,A01,892618,Staff,0,0,65,65
1746600107397,ECE 111,A01,892719,Staff,6,0,65,59
1746600108426,ECE 197,001,957920,Mercier; Patrick Philip,9991,0,9999,8
1746600109456,ECON 178,A01,907814,Zhu; Ying,26,0,35,9
1746600110479,EDS 115,A00,895312,Staff,35,0,45,10
1746600111506,EDS 117,A01,895337,Staff,23,0,30,7
1746600112530,EDS 125,A00,895341,Jones; Gabrielle Anastasia,36,0,45,9
1746600113560,EDS 128A,A01,895459,Fargason; Sharon Gayle,44,0,45,1
1746600114591,EDS 128B,A01,895543,Pappas; Elizabeth,44,0,45,1
1746600115616,EDS 139,A00,897203,Pappas; Elizabeth,44,0,45,1
1746600115616,EDS 139,B00,897209,Fargason; Sharon Gayle,41,0,45,4
1746600116640,EDS 201,A00,895545,Staff,22,0,45,23
1746600117667,EDS 203,A01,895581,Halter; Christopher P.,22,0,45,23
1746600118696,EDS 204R,A01,895625,Heinzman; Erica M.,39,0,45,6
1746600118696,EDS 204R,B01,895693,Halter; Christopher P.,10,0,45,35
1746600119720,EDS 206R,A00,895694,Fargason; Sharon Gayle,1,0,30,29
1746600119720,EDS 206R,B00,895695,Choi; Bailey Miyeon,16,0,30,14
1746600120750,EDS 250,A00,895697,Hemans; Patricia Ann Benitez,22,0,45,23
1746600121774,EDS 281,A00,895701,Meyerott; Theresa Ann,1,0,15,14
1746600122802,EDS 284,A00,895736,Meyerott; Theresa Ann,1,0,15,14
1746600123830,EDS 286,A00,897210,Fine; Sarah,0,0,15,15
1746600124858,EDS 289C,A01,895770,Daly; Alan J.,1,0,15,14
1746600125886,EDS 290,A00,897211,Hofstetter; Carolyn,0,0,15,15
1746600126912,LIGM 5A,A00,896162,Fischer-Grunski; Eva K,12,0,20,8
1746600127942,LIGM 5B,A00,896260,Fischer-Grunski; Eva K,17,0,20,3
1746600128967,LIGM 5C,A00,896308,Fischer-Grunski; Eva K,18,0,20,2
1746600129998,LIIT 5AS,A00,896313,Carnelos; Chiara,18,0,20,2
1746600131027,LIIT 5BS,A00,896416,Carnelos; Chiara,20,0,20,0
1746600132052,LIIT 5CS,A00,896564,Carnelos; Chiara,20,0,20,0
1746600133080,LISP 5A,A00,896588,Munoz Sanchez; Alicia,2,0,20,18
1746600134108,LISP 5B,A00,896653,Munoz Sanchez; Alicia,7,0,20,13
1746600135133,LISP 5C,A00,896655,Munoz Sanchez; Alicia,0,1,20,20
1746600136159,MAE 197,001,957918,Kleissl; Jan,9996,0,9999,3
1746600136159,MAE 197,002,959806,Boechler; Nicholas Sebastia,9998,0,9999,1
1746600136159,MAE 197,003,959852,Mullin; Jennifer S,9998,0,9999,1
1746600137186,MATH 2,A01,957937,Staff,33,0,35,2
1746600138212,MATH 197,001,957876,Kedlaya; Kiran S.,9993,0,9999,6
1746600139240,MCWP 40,A00,892729,Duru; Nur,10,0,20,10
1746600139240,MCWP 40,B00,893304,Montejo; Carolina,14,0,20,6
1746600140263,MCWP 40R,A00,893757,Redela; Pamela Morgan,0,5,20,20
1746600141291,MCWP 50,A00,893758,Morshed; Michael James,0,0,20,20
1746600141291,MCWP 50,B00,893761,Bartulis; Jason Michael,17,0,20,3
1746600142319,MCWP 50R,A00,893766,Compas; Sean Matthew,0,1,20,20
1746600142319,MCWP 50R,B00,893769,Carter; Jennifer A,0,1,20,20
1746600142319,MCWP 50R,C00,893771,Krone; Jarret,0,3,20,20
1746600142319,MCWP 50R,D00,893772,Miller; Elizabeth Deen,0,0,20,20
1746600142319,MCWP 50R,E00,893775,Carter; Andrea L,0,1,20,20
1746600143345,MMW 11R,A01,892721,Herbst; Matthew,14,0,30,16
1746600143345,MMW 11R,A02,892722,Herbst; Matthew,0,0,0,3
1746600144371,MMW 12R,A01,892724,Herbst; Matthew,0,11,16,16
1746600144371,MMW 12R,A02,892725,Herbst; Matthew,0,10,16,16
1746600145400,MMW 13R,A01,892727,Staff,0,4,16,16
1746600145400,MMW 13R,A02,892728,Staff,0,4,16,16
1746600145400,MMW 13R,A03,958032,Staff,0,4,16,16
1746600145400,MMW 13R,A04,958033,Staff,0,4,16,16
1746600145400,MMW 13R,A05,958034,Staff,0,4,16,16
1746600146425,SIO 295LS,A00,894015,Staff,5,0,25,20
1746600147454,SIO 295S,A00,894020,Staff,5,0,25,20
1746600148480,SIOC 290S,B01,958918,Merrifield; Mark A,14,0,30,16
1746600149508,SIOC 291S,B01,958922,Gabriel; Corey John,14,0,30,16
1746600150536,SOCI 117,A01,895339,Staff,2,0,5,3
1746600151563,WES 237B,A00,894149,Staff,11,0,20,9
1746600153639,AESE 279B,A00,891859,Staff,13,0,35,22
1746600154664,AIP 197,001,891854,Vespa; Emanuel Ignacio,9999,0,9999,0
1746600155692,ANTH 289S,A00,891856,Gagneux; Pascal,12,0,12,0
1746600156721,BENG 196,001,957946,Engler; Adam J.,9996,0,9999,3
1746600157749,BISP 197,001,959851,Wilhelm; James E.,9998,0,9999,1
1746600158776,CAT 124RS,A01,956906,Staff,6,0,25,19
1746600159802,CAT 125RS,A01,922013,Staff,6,0,25,19
1746600160828,CLRE 250,A00,891860,Morris; Sheldon,9995,0,9999,4
1746600162883,CLRE 251R,A00,907817,Mehta; Ravindra L.,9994,0,9999,5
1746600163911,CLRE 252,A00,891864,Cuomo; Raphael Eduardo,9993,0,9999,6
1746600164938,CLRE 253,A00,891867,Vaida; Florin,9994,0,9999,5
1746600164938,CLRE 253,B00,907819,Staff,9999,0,9999,0
1746600165963,CLRE 259,A00,891868,Patel; Hemal,9998,0,9999,1
1746600166992,CLRE 260,A00,891872,Cuomo; Raphael Eduardo,9999,0,9999,0
1746600168017,CLRE 297,001,891888,Cuomo; Raphael Eduardo,9999,0,9999,0
1746600169043,CSE 191,A00,958773,Minnes Kemp; Mor Mia,9995,0,9999,4
1746600170068,CSE 197,001,959846,Minnes Kemp; Mor Mia,9990,0,9999,9
1746600171094,CSS 201S,A01,892054,Mignozzetti; Umberto,25,0,30,5
1746600172124,CSS 202S,A01,892056,Mignozzetti; Umberto,25,0,30,5
1746600173148,DSC 197,001,956898,Eldridge; Justin Matthew,9996,0,9999,3
1746600174175,DSC 297,001,958000,Mazumdar; Arya,9998,0,9999,1
1746600174175,DSC 297,002,959862,Wang; Yusu,9998,0,9999,1
1746600175204,EAP 100,A00,905686,Staff,9778,0,9999,221
1746600176230,ECE 45,A01,892618,Staff,0,0,65,65
1746600178282,ECE 111,A01,892719,Staff,6,0,65,59
1746600179307,ECE 197,001,957920,Mercier; Patrick Philip,9991,0,9999,8
1746600180334,ECON 178,A01,907814,Zhu; Ying,26,0,35,9
1746600181360,EDS 115,A00,895312,Staff,35,0,45,10
1746600182384,EDS 117,A01,895337,Staff,23,0,30,7
1746600183413,EDS 125,A00,895341,Jones; Gabrielle Anastasia,36,0,45,9
1746600184441,EDS 128A,A01,895459,Fargason; Sharon Gayle,44,0,45,1
1746600185468,EDS 128B,A01,895543,Pappas; Elizabeth,44,0,45,1
1746600186498,EDS 139,A00,897203,Pappas; Elizabeth,44,0,45,1
1746600186498,EDS 139,B00,897209,Fargason; Sharon Gayle,41,0,45,4
1746600187526,EDS 201,A00,895545,Staff,22,0,45,23
1746600188554,EDS 203,A01,895581,Halter; Christopher P.,22,0,45,23
1746600189584,EDS 204R,A01,895625,Heinzman; Erica M.,39,0,45,6
1746600189584,EDS 204R,B01,895693,Halter; Christopher P.,10,0,45,35
1746600190609,EDS 206R,A00,895694,Fargason; Sharon Gayle,1,0,30,29
1746600190609,EDS 206R,B00,895695,Choi; Bailey Miyeon,16,0,30,14
1746600191637,EDS 250,A00,895697,Hemans; Patricia Ann Benitez,22,0,45,23
1746600192664,EDS 281,A00,895701,Meyerott; Theresa Ann,1,0,15,14
1746600193690,EDS 284,A00,895736,Meyerott; Theresa Ann,1,0,15,14
1746600194718,EDS 286,A00,897210,Fine; Sarah,0,0,15,15
1746600195752,EDS 289C,A01,895770,Daly; Alan J.,1,0,15,14
1746600196781,EDS 290,A00,897211,Hofstetter; Carolyn,0,0,15,15
1746600197809,LIGM 5A,A00,896162,Fischer-Grunski; Eva K,12,0,20,8
1746600198839,LIGM 5B,A00,896260,Fischer-Grunski; Eva K,17,0,20,3
1746600199867,LIGM 5C,A00,896308,Fischer-Grunski; Eva K,18,0,20,2
1746600200893,LIIT 5AS,A00,896313,Carnelos; Chiara,18,0,20,2
1746600201921,LIIT 5BS,A00,896416,Carnelos; Chiara,20,0,20,0
1746600202946,LIIT 5CS,A00,896564,Carnelos; Chiara,20,0,20,0
1746600203975,LISP 5A,A00,896588,Munoz Sanchez; Alicia,2,0,20,18
1746600205002,LISP 5B,A00,896653,Munoz Sanchez; Alicia,7,0,20,13
1746600206029,LISP 5C,A00,896655,Munoz Sanchez; Alicia,0,1,20,20
1746600207057,MAE 197,001,957918,Kleissl; Jan,9996,0,9999,3
1746600207057,MAE 197,002,959806,Boechler; Nicholas Sebastia,9998,0,9999,1
1746600207057,MAE 197,003,959852,Mullin; Jennifer S,9998,0,9999,1
1746600208084,MATH 2,A01,957937,Staff,33,0,35,2
1746600209109,MATH 197,001,957876,Kedlaya; Kiran S.,9993,0,9999,6
1746600210137,MCWP 40,A00,892729,Duru; Nur,10,0,20,10
1746600210137,MCWP 40,B00,893304,Montejo; Carolina,14,0,20,6
1746600211165,MCWP 40R,A00,893757,Redela; Pamela Morgan,0,5,20,20
1746600212192,MCWP 50,A00,893758,Morshed; Michael James,0,0,20,20
1746600212192,MCWP 50,B00,893761,Bartulis; Jason Michael,17,0,20,3
1746600213220,MCWP 50R,A00,893766,Compas; Sean Matthew,0,1,20,20
1746600213220,MCWP 50R,B00,893769,Carter; Jennifer A,0,1,20,20
1746600213220,MCWP 50R,C00,893771,Krone; Jarret,0,3,20,20
1746600213220,MCWP 50R,D00,893772,Miller; Elizabeth Deen,0,0,20,20
1746600213220,MCWP 50R,E00,893775,Carter; Andrea L,0,1,20,20
1746600214244,MMW 11R,A01,892721,Herbst; Matthew,14,0,30,16
1746600214244,MMW 11R,A02,892722,Herbst; Matthew,0,0,0,3
1746600215272,MMW 12R,A01,892724,Herbst; Matthew,0,11,16,16
1746600215272,MMW 12R,A02,892725,Herbst; Matthew,0,10,16,16
1746600216302,MMW 13R,A01,892727,Staff,0,4,16,16
1746600216302,MMW 13R,A02,892728,Staff,0,4,16,16
1746600216302,MMW 13R,A03,958032,Staff,0,4,16,16
1746600216302,MMW 13R,A04,958033,Staff,0,4,16,16
1746600216302,MMW 13R,A05,958034,Staff,0,4,16,16
1746600217330,SIO 295LS,A00,894015,Staff,5,0,25,20
1746600218356,SIO 295S,A00,894020,Staff,5,0,25,20
1746600219382,SIOC 290S,B01,958918,Merrifield; Mark A,14,0,30,16
1746600220413,SIOC 291S,B01,958922,Gabriel; Corey John,14,0,30,16
1746600221440,SOCI 117,A01,895339,Staff,2,0,5,3
1746600222468,WES 237B,A00,894149,Staff,11,0,20,9
1746600224532,AESE 279B,A00,891859,Staff,13,0,35,22
1746600225556,AIP 197,001,891854,Vespa; Emanuel Ignacio,9999,0,9999,0
1746600226584,ANTH 289S,A00,891856,Gagneux; Pascal,12,0,12,0
1746600227611,BENG 196,001,957946,Engler; Adam J.,9996,0,9999,3
1746600228637,BISP 197,001,959851,Wilhelm; James E.,9998,0,9999,1
1746600229661,CAT 124RS,A01,956906,Staff,6,0,25,19
1746600230690,CAT 125RS,A01,922013,Staff,6,0,25,19
1746600231715,CLRE 250,A00,891860,Morris; Sheldon,9995,0,9999,4
1746600233769,CLRE 251R,A00,907817,Mehta; Ravindra L.,9994,0,9999,5
1746600234796,CLRE 252,A00,891864,Cuomo; Raphael Eduardo,9993,0,9999,6
1746600235826,CLRE 253,A00,891867,Vaida; Florin,9994,0,9999,5
1746600235826,CLRE 253,B00,907819,Staff,9999,0,9999,0
1746600236852,CLRE 259,A00,891868,Patel; Hemal,9998,0,9999,1
1746600237876,CLRE 260,A00,891872,Cuomo; Raphael Eduardo,9999,0,9999,0
1746600238906,CLRE 297,001,891888,Cuomo; Raphael Eduardo,9999,0,9999,0
1746600239935,CSE 191,A00,958773,Minnes Kemp; Mor Mia,9995,0,9999,4
1746600240965,CSE 197,001,959846,Minnes Kemp; Mor Mia,9990,0,9999,9
1746600241990,CSS 201S,A01,892054,Mignozzetti; Umberto,25,0,30,5
1746600243024,CSS 202S,A01,892056,Mignozzetti; Umberto,25,0,30,5
1746600244047,DSC 197,001,956898,Eldridge; Justin Matthew,9996,0,9999,3
1746600245072,DSC 297,001,958000,Mazumdar; Arya,9998,0,9999,1
1746600245072,DSC 297,002,959862,Wang; Yusu,9998,0,9999,1
1746600246097,EAP 100,A00,905686,Staff,9778,0,9999,221
1746600247124,ECE 45,A01,892618,Staff,0,0,65,65
1746600249181,ECE 111,A01,892719,Staff,6,0,65,59
1746600250205,ECE 197,001,957920,Mercier; Patrick Philip,9991,0,9999,8
1746600251234,ECON 178,A01,907814,Zhu; Ying,26,0,35,9
1746600252260,EDS 115,A00,895312,Staff,35,0,45,10
1746600253286,EDS 117,A01,895337,Staff,23,0,30,7
1746600254313,EDS 125,A00,895341,Jones; Gabrielle Anastasia,36,0,45,9
1746600255339,EDS 128A,A01,895459,Fargason; Sharon Gayle,44,0,45,1
1746600256364,EDS 128B,A01,895543,Pappas; Elizabeth,44,0,45,1
1746600257392,EDS 139,A00,897203,Pappas; Elizabeth,44,0,45,1
1746600257392,EDS 139,B00,897209,Fargason; Sharon Gayle,41,0,45,4
1746600258419,EDS 201,A00,895545,Staff,22,0,45,23
1746600259446,EDS 203,A01,895581,Halter; Christopher P.,22,0,45,23
1746600260471,EDS 204R,A01,895625,Heinzman; Erica M.,39,0,45,6
1746600260471,EDS 204R,B01,895693,Halter; Christopher P.,10,0,45,35
1746600261496,EDS 206R,A00,895694,Fargason; Sharon Gayle,1,0,30,29
1746600261496,EDS 206R,B00,895695,Choi; Bailey Miyeon,16,0,30,14
1746600262523,EDS 250,A00,895697,Hemans; Patricia Ann Benitez,22,0,45,23
1746600263551,EDS 281,A00,895701,Meyerott; Theresa Ann,1,0,15,14
1746600264575,EDS 284,A00,895736,Meyerott; Theresa Ann,1,0,15,14
1746600265603,EDS 286,A00,897210,Fine; Sarah,0,0,15,15
1746600266629,EDS 289C,A01,895770,Daly; Alan J.,1,0,15,14
1746600267659,EDS 290,A00,897211,Hofstetter; Carolyn,0,0,15,15
1746600268684,LIGM 5A,A00,896162,Fischer-Grunski; Eva K,12,0,20,8
1746600269711,LIGM 5B,A00,896260,Fischer-Grunski; Eva K,17,0,20,3
1746600270738,LIGM 5C,A00,896308,Fischer-Grunski; Eva K,18,0,20,2
1746600271766,LIIT 5AS,A00,896313,Carnelos; Chiara,18,0,20,2
1746600272797,LIIT 5BS,A00,896416,Carnelos; Chiara,20,0,20,0
1746600273822,LIIT 5CS,A00,896564,Carnelos; Chiara,20,0,20,0
1746600274849,LISP 5A,A00,896588,Munoz Sanchez; Alicia,2,0,20,18
1746600275881,LISP 5B,A00,896653,Munoz Sanchez; Alicia,7,0,20,13
1746600276907,LISP 5C,A00,896655,Munoz Sanchez; Alicia,0,1,20,20
1746600277935,MAE 197,001,957918,Kleissl; Jan,9996,0,9999,3
1746600277935,MAE 197,002,959806,Boechler; Nicholas Sebastia,9998,0,9999,1
1746600277935,MAE 197,003,959852,Mullin; Jennifer S,9998,0,9999,1
1746600278960,MATH 2,A01,957937,Staff,33,0,35,2
1746600279988,MATH 197,001,957876,Kedlaya; Kiran S.,9993,0,9999,6
1746600281013,MCWP 40,A00,892729,Duru; Nur,10,0,20,10
1746600281013,MCWP 40,B00,893304,Montejo; Carolina,14,0,20,6
1746600282041,MCWP 40R,A00,893757,Redela; Pamela Morgan,0,5,20,20
1746600283068,MCWP 50,A00,893758,Morshed; Michael James,0,0,20,20
1746600283068,MCWP 50,B00,893761,Bartulis; Jason Michael,17,0,20,3
1746600284097,MCWP 50R,A00,893766,Compas; Sean Matthew,0,1,20,20
1746600284097,MCWP 50R,B00,893769,Carter; Jennifer A,0,1,20,20
1746600284097,MCWP 50R,C00,893771,Krone; Jarret,0,3,20,20
1746600284097,MCWP 50R,D00,893772,Miller; Elizabeth Deen,0,0,20,20
1746600284097,MCWP 50R,E00,893775,Carter; Andrea L,0,1,20,20
1746600285126,MMW 11R,A01,892721,Herbst; Matthew,14,0,30,16
1746600285126,MMW 11R,A02,892722,Herbst; Matthew,0,0,0,3
1746600286155,MMW 12R,A01,892724,Herbst; Matthew,0,11,16,16
1746600286155,MMW 12R,A02,892725,Herbst; Matthew,0,10,16,16
1746600287184,MMW 13R,A01,892727,Staff,0,4,16,16
1746600287184,MMW 13R,A02,892728,Staff,0,4,16,16
1746600287184,MMW 13R,A03,958032,Staff,0,4,16,16
1746600287184,MMW 13R,A04,958033,Staff,0,4,16,16
1746600287184,MMW 13R,A05,958034,Staff,0,4,16,16
1746600288209,SIO 295LS,A00,894015,Staff,5,0,25,20
1746600289238,SIO 295S,A00,894020,Staff,5,0,25,20
1746600290264,SIOC 290S,B01,958918,Merrifield; Mark A,14,0,30,16
1746600291321,SIOC 291S,B01,958922,Gabriel; Corey John,14,0,30,16
1746600292346,SOCI 117,A01,895339,Staff,2,0,5,3
1746600293371,WES 237B,A00,894149,Staff,11,0,20,9
1746600295428,AESE 279B,A00,891859,Staff,13,0,35,22
1746600296453,AIP 197,001,891854,Vespa; Emanuel Ignacio,9999,0,9999,0
1746600297478,ANTH 289S,A00,891856,Gagneux; Pascal,12,0,12,0
1746600298502,BENG 196,001,957946,Engler; Adam J.,9996,0,9999,3
1746600299528,BISP 197,001,959851,Wilhelm; James E.,9998,0,9999,1
1746600300553,CAT 124RS,A01,956906,Staff,6,0,25,19
1746600301580,CAT 125RS,A01,922013,Staff,6,0,25,19
1746600302605,CLRE 250,A00,891860,Morris; Sheldon,9995,0,9999,4
1746600304657,CLRE 251R,A00,907817,Mehta; Ravindra L.,9994,0,9999,5
1746600305683,CLRE 252,A00,891864,Cuomo; Raphael Eduardo,9993,0,9999,6
1746600306712,CLRE 253,A00,891867,Vaida; Florin,9994,0,9999,5
1746600306712,CLRE 253,B00,907819,Staff,9999,0,9999,0
1746600307738,CLRE 259,A00,891868,Patel; Hemal,9998,0,9999,1
1746600308767,CLRE 260,A00,891872,Cuomo; Raphael Eduardo,9999,0,9999,0
1746600309793,CLRE 297,001,891888,Cuomo; Raphael Eduardo,9999,0,9999,0
1746600310818,CSE 191,A00,958773,Minnes Kemp; Mor Mia,9995,0,9999,4
1746600311847,CSE 197,001,959846,Minnes Kemp; Mor Mia,9990,0,9999,9
1746600312874,CSS 201S,A01,892054,Mignozzetti; Umberto,25,0,30,5
1746600313901,CSS 202S,A01,892056,Mignozzetti; Umberto,25,0,30,5
1746600314931,DSC 197,001,956898,Eldridge; Justin Matthew,9996,0,9999,3
1746600315961,DSC 297,001,958000,Mazumdar; Arya,9998,0,9999,1
1746600315961,DSC 297,002,959862,Wang; Yusu,9998,0,9999,1
1746600316986,EAP 100,A00,905686,Staff,9778,0,9999,221
1746600318013,ECE 45,A01,892618,Staff,0,0,65,65
1746600320069,ECE 111,A01,892719,Staff,6,0,65,59
1746600321097,ECE 197,001,957920,Mercier; Patrick Philip,9991,0,9999,8
1746600322126,ECON 178,A01,907814,Zhu; Ying,26,0,35,9
1746600323170,EDS 115,A00,895312,Staff,35,0,45,10
1746600324195,EDS 117,A01,895337,Staff,23,0,30,7
1746600325219,EDS 125,A00,895341,Jones; Gabrielle Anastasia,36,0,45,9
1746600326243,EDS 128A,A01,895459,Fargason; Sharon Gayle,44,0,45,1
1746600327269,EDS 128B,A01,895543,Pappas; Elizabeth,44,0,45,1
1746600328295,EDS 139,A00,897203,Pappas; Elizabeth,44,0,45,1
1746600328295,EDS 139,B00,897209,Fargason; Sharon Gayle,41,0,45,4
1746600329322,EDS 201,A00,895545,Staff,22,0,45,23
1746600330348,EDS 203,A01,895581,Halter; Christopher P.,22,0,45,23
1746600331374,EDS 204R,A01,895625,Heinzman; Erica M.,39,0,45,6
1746600331374,EDS 204R,B01,895693,Halter; Christopher P.,10,0,45,35
1746600332406,EDS 206R,A00,895694,Fargason; Sharon Gayle,1,0,30,29
1746600332406,EDS 206R,B00,895695,Choi; Bailey Miyeon,16,0,30,14
1746600333433,EDS 250,A00,895697,Hemans; Patricia Ann Benitez,22,0,45,23
1746600334460,EDS 281,A00,895701,Meyerott; Theresa Ann,1,0,15,14
1746600335483,EDS 284,A00,895736,Meyerott; Theresa Ann,1,0,15,14
1746600336512,EDS 286,A00,897210,Fine; Sarah,0,0,15,15
1746600337539,EDS 289C,A01,895770,Daly; Alan J.,1,0,15,14
1746600338564,EDS 290,A00,897211,Hofstetter; Carolyn,0,0,15,15
1746600339593,LIGM 5A,A00,896162,Fischer-Grunski; Eva K,12,0,20,8
1746600340623,LIGM 5B,A00,896260,Fischer-Grunski; Eva K,17,0,20,3
1746600341653,LIGM 5C,A00,896308,Fischer-Grunski; Eva K,18,0,20,2
1746600342677,LIIT 5AS,A00,896313,Carnelos; Chiara,18,0,20,2
1746600343707,LIIT 5BS,A00,896416,Carnelos; Chiara,20,0,20,0
1746600344731,LIIT 5CS,A00,896564,Carnelos; Chiara,20,0,20,0
1746600345755,LISP 5A,A00,896588,Munoz Sanchez; Alicia,2,0,20,18
1746600346781,LISP 5B,A00,896653,Munoz Sanchez; Alicia,7,0,20,13
1746600347808,LISP 5C,A00,896655,Munoz Sanchez; Alicia,0,1,20,20
1746600348837,MAE 197,001,957918,Kleissl; Jan,9996,0,9999,3
1746600348837,MAE 197,002,959806,Boechler; Nicholas Sebastia,9998,0,9999,1
1746600348837,MAE 197,003,959852,Mullin; Jennifer S,9998,0,9999,1
1746600349861,MATH 2,A01,957937,Staff,33,0,35,2
1746600350890,MATH 197,001,957876,Kedlaya; Kiran S.,9993,0,9999,6
1746600351914,MCWP 40,A00,892729,Duru; Nur,10,0,20,10
1746600351914,MCWP 40,B00,893304,Montejo; Carolina,14,0,20,6
1746600352942,MCWP 40R,A00,893757,Redela; Pamela Morgan,0,5,20,20
1746600353968,MCWP 50,A00,893758,Morshed; Michael James,0,0,20,20
1746600353968,MCWP 50,B00,893761,Bartulis; Jason Michael,17,0,20,3
1746600354994,MCWP 50R,A00,893766,Compas; Sean Matthew,0,1,20,20
1746600354994,MCWP 50R,B00,893769,Carter; Jennifer A,0,1,20,20
1746600354994,MCWP 50R,C00,893771,Krone; Jarret,0,3,20,20
1746600354994,MCWP 50R,D00,893772,Miller; Elizabeth Deen,0,0,20,20
1746600354994,MCWP 50R,E00,893775,Carter; Andrea L,0,1,20,20
1746600356022,MMW 11R,A01,892721,Herbst; Matthew,14,0,30,16
1746600356022,MMW 11R,A02,892722,Herbst; Matthew,0,0,0,3
1746600357048,MMW 12R,A01,892724,Herbst; Matthew,0,11,16,16
1746600357048,MMW 12R,A02,892725,Herbst; Matthew,0,10,16,16
1746600358074,MMW 13R,A01,892727,Staff,0,4,16,16
1746600358074,MMW 13R,A02,892728,Staff,0,4,16,16
1746600358074,MMW 13R,A03,958032,Staff,0,4,16,16
1746600358074,MMW 13R,A04,958033,Staff,0,4,16,16
1746600358074,MMW 13R,A05,958034,Staff,0,4,16,16
1746600359170,SIO 295LS,A00,894015,Staff,5,0,25,20
1746600360201,SIO 295S,A00,894020,Staff,5,0,25,20
1746600361228,SIOC 290S,B01,958918,Merrifield; Mark A,14,0,30,16
1746600362255,SIOC 291S,B01,958922,Gabriel; Corey John,14,0,30,16
1746600363288,SOCI 117,A01,895339,Staff,2,0,5,3
1746600364317,WES 237B,A00,894149,Staff,11,0,20,9
1746600366377,AESE 279B,A00,891859,Staff,13,0,35,22
1746600367403,AIP 197,001,891854,Vespa; Emanuel Ignacio,9999,0,9999,0
1746600368430,ANTH 289S,A00,891856,Gagneux; Pascal,12,0,12,0
1746600369454,BENG 196,001,957946,Engler; Adam J.,9996,0,9999,3
1746600370482,BISP 197,001,959851,Wilhelm; James E.,9998,0,9999,1
1746600371510,CAT 124RS,A01,956906,Staff,6,0,25,19
1746600372541,CAT 125RS,A01,922013,Staff,6,0,25,19
1746600373567,CLRE 250,A00,891860,Morris; Sheldon,9995,0,9999,4
1746600375620,CLRE 251R,A00,907817,Mehta; Ravindra L.,9994,0,9999,5
1746600376650,CLRE 252,A00,891864,Cuomo; Raphael Eduardo,9993,0,9999,6
1746600377675,CLRE 253,A00,891867,Vaida; Florin,9994,0,9999,5
1746600377675,CLRE 253,B00,907819,Staff,9999,0,9999,0
1746600378704,CLRE 259,A00,891868,Patel; Hemal,9998,0,9999,1
1746600379728,CLRE 260,A00,891872,Cuomo; Raphael Eduardo,9999,0,9999,0
1746600380753,CLRE 297,001,891888,Cuomo; Raphael Eduardo,9999,0,9999,0
1746600381781,CSE 191,A00,958773,Minnes Kemp; Mor Mia,9995,0,9999,4
1746600382810,CSE 197,001,959846,Minnes Kemp; Mor Mia,9990,0,9999,9
1746600383835,CSS 201S,A01,892054,Mignozzetti; Umberto,25,0,30,5
1746600384862,CSS 202S,A01,892056,Mignozzetti; Umberto,25,0,30,5
1746600385897,DSC 197,001,956898,Eldridge; Justin Matthew,9996,0,9999,3
1746600386924,DSC 297,001,958000,Mazumdar; Arya,9998,0,9999,1
1746600386924,DSC 297,002,959862,Wang; Yusu,9998,0,9999,1
1746600387947,EAP 100,A00,905686,Staff,9778,0,9999,221
1746600388977,ECE 45,A01,892618,Staff,0,0,65,65
1746600391039,ECE 111,A01,892719,Staff,6,0,65,59
1746600392063,ECE 197,001,957920,Mercier; Patrick Philip,9991,0,9999,8
1746600393092,ECON 178,A01,907814,Zhu; Ying,26,0,35,9
1746600394119,EDS 115,A00,895312,Staff,35,0,45,10
1746600395161,EDS 117,A01,895337,Staff,23,0,30,7
1746600396187,EDS 125,A00,895341,Jones; Gabrielle Anastasia,36,0,45,9
1746600397213,EDS 128A,A01,895459,Fargason; Sharon Gayle,44,0,45,1
1746600398243,EDS 128B,A01,895543,Pappas; Elizabeth,44,0,45,1
1746600399272,EDS 139,A00,897203,Pappas; Elizabeth,44,0,45,1
1746600399272,EDS 139,B00,897209,Fargason; Sharon Gayle,41,0,45,4
1746600400298,EDS 201,A00,895545,Staff,22,0,45,23
1746600401322,EDS 203,A01,895581,Halter; Christopher P.,22,0,45,23
1746600402352,EDS 204R,A01,895625,Heinzman; Erica M.,39,0,45,6
1746600402352,EDS 204R,B01,895693,Halter; Christopher P.,10,0,45,35
1746600403379,EDS 206R,A00,895694,Fargason; Sharon Gayle,1,0,30,29
1746600403379,EDS 206R,B00,895695,Choi; Bailey Miyeon,16,0,30,14
1746600404405,EDS 250,A00,895697,Hemans; Patricia Ann Benitez,22,0,45,23
1746600405430,EDS 281,A00,895701,Meyerott; Theresa Ann,1,0,15,14
1746600406455,EDS 284,A00,895736,Meyerott; Theresa Ann,1,0,15,14
1746600407479,EDS 286,A00,897210,Fine; Sarah,0,0,15,15
1746600408506,EDS 289C,A01,895770,Daly; Alan J.,1,0,15,14
1746600409531,EDS 290,A00,897211,Hofstetter; Carolyn,0,0,15,15
1746600410559,LIGM 5A,A00,896162,Fischer-Grunski; Eva K,12,0,20,8
1746600411585,LIGM 5B,A00,896260,Fischer-Grunski; Eva K,17,0,20,3
1746600412616,LIGM 5C,A00,896308,Fischer-Grunski; Eva K,18,0,20,2
1746600413641,LIIT 5AS,A00,896313,Carnelos; Chiara,18,0,20,2
1746600414665,LIIT 5BS,A00,896416,Carnelos; Chiara,20,0,20,0
1746600415693,LIIT 5CS,A00,896564,Carnelos; Chiara,20,0,20,0
1746600416719,LISP 5A,A00,896588,Munoz Sanchez; Alicia,2,0,20,18
1746600417811,LISP 5B,A00,896653,Munoz Sanchez; Alicia,7,0,20,13
1746600418836,LISP 5C,A00,896655,Munoz Sanchez; Alicia,0,1,20,20
1746600419862,MAE 197,001,957918,Kleissl; Jan,9996,0,9999,3
1746600419862,MAE 197,002,959806,Boechler; Nicholas Sebastia,9998,0,9999,1
1746600419862,MAE 197,003,959852,Mullin; Jennifer S,9998,0,9999,1
1746600420887,MATH 2,A01,957937,Staff,33,0,35,2
1746600421915,MATH 197,001,957876,Kedlaya; Kiran S.,9993,0,9999,6
1746600422944,MCWP 40,A00,892729,Duru; Nur,10,0,20,10
1746600422944,MCWP 40,B00,893304,Montejo; Carolina,14,0,20,6
1746600423972,MCWP 40R,A00,893757,Redela; Pamela Morgan,0,5,20,20
1746600424999,MCWP 50,A00,893758,Morshed; Michael James,0,0,20,20
1746600424999,MCWP 50,B00,893761,Bartulis; Jason Michael,17,0,20,3
1746600426024,MCWP 50R,A00,893766,Compas; Sean Matthew,0,1,20,20
1746600426024,MCWP 50R,B00,893769,Carter; Jennifer A,0,1,20,20
1746600426024,MCWP 50R,C00,893771,Krone; Jarret,0,3,20,20
1746600426024,MCWP 50R,D00,893772,Miller; Elizabeth Deen,0,0,20,20
1746600426024,MCWP 50R,E00,893775,Carter; Andrea L,0,1,20,20
1746600427052,MMW 11R,A01,892721,Herbst; Matthew,14,0,30,16
1746600427052,MMW 11R,A02,892722,Herbst; Matthew,0,0,0,3
1746600428077,MMW 12R,A01,892724,Herbst; Matthew,0,11,16,16
1746600428077,MMW 12R,A02,892725,Herbst; Matthew,0,10,16,16
1746600429104,MMW 13R,A01,892727,Staff,0,4,16,16
1746600429104,MMW 13R,A02,892728,Staff,0,4,16,16
1746600429104,MMW 13R,A03,958032,Staff,0,4,16,16
1746600429104,MMW 13R,A04,958033,Staff,0,4,16,16
1746600429104,MMW 13R,A05,958034,Staff,0,4,16,16
1746600430129,SIO 295LS,A00,894015,Staff,5,0,25,20
1746600431155,SIO 295S,A00,894020,Staff,5,0,25,20
1746600432185,SIOC 290S,B01,958918,Merrifield; Mark A,14,0,30,16
1746600433211,SIOC 291S,B01,958922,Gabriel; Corey John,14,0,30,16
1746600434237,SOCI 117,A01,895339,Staff,2,0,5,3
1746600435261,WES 237B,A00,894149,Staff,11,0,20,9
1746600437324,AESE 279B,A00,891859,Staff,13,0,35,22
1746600438350,AIP 197,001,891854,Vespa; Emanuel Ignacio,9999,0,9999,0
1746600439380,ANTH 289S,A00,891856,Gagneux; Pascal,12,0,12,0
1746600440405,BENG 196,001,957946,Engler; Adam J.,9996,0,9999,3
1746600441433,BISP 197,001,959851,Wilhelm; James E.,9998,0,9999,1
1746600442457,CAT 124RS,A01,956906,Staff,6,0,25,19
1746600443481,CAT 125RS,A01,922013,Staff,6,0,25,19
1746600444510,CLRE 250,A00,891860,Morris; Sheldon,9995,0,9999,4
1746600446567,CLRE 251R,A00,907817,Mehta; Ravindra L.,9994,0,9999,5
1746600447593,CLRE 252,A00,891864,Cuomo; Raphael Eduardo,9993,0,9999,6
1746600448620,CLRE 253,A00,891867,Vaida; Florin,9994,0,9999,5
1746600448620,CLRE 253,B00,907819,Staff,9999,0,9999,0
1746600449647,CLRE 259,A00,891868,Patel; Hemal,9998,0,9999,1
1746600450674,CLRE 260,A00,891872,Cuomo; Raphael Eduardo,9999,0,9999,0
1746600451699,CLRE 297,001,891888,Cuomo; Raphael Eduardo,9999,0,9999,0
1746600452726,CSE 191,A00,958773,Minnes Kemp; Mor Mia,9995,0,9999,4
1746600453752,CSE 197,001,959846,Minnes Kemp; Mor Mia,9990,0,9999,9
1746600454779,CSS 201S,A01,892054,Mignozzetti; Umberto,25,0,30,5
1746600455810,CSS 202S,A01,892056,Mignozzetti; Umberto,25,0,30,5
1746600456835,DSC 197,001,956898,Eldridge; Justin Matthew,9996,0,9999,3
1746600457860,DSC 297,001,958000,Mazumdar; Arya,9998,0,9999,1
1746600457860,DSC 297,002,959862,Wang; Yusu,9998,0,9999,1
1746600458885,EAP 100,A00,905686,Staff,9778,0,9999,221
1746600459916,ECE 45,A01,892618,Staff,0,0,65,65
1746600461968,ECE 111,A01,892719,Staff,6,0,65,59
1746600462997,ECE 197,001,957920,Mercier; Patrick Philip,9991,0,9999,8
1746600464023,ECON 178,A01,907814,Zhu; Ying,26,0,35,9
1746600465050,EDS 115,A00,895312,Staff,35,0,45,10
1746600466076,EDS 117,A01,895337,Staff,23,0,30,7
1746600467107,EDS 125,A00,895341,Jones; Gabrielle Anastasia,36,0,45,9
1746600468133,EDS 128A,A01,895459,Fargason; Sharon Gayle,44,0,45,1
1746600469158,EDS 128B,A01,895543,Pappas; Elizabeth,44,0,45,1
1746600470187,EDS 139,A00,897203,Pappas; Elizabeth,44,0,45,1
1746600470187,EDS 139,B00,897209,Fargason; Sharon Gayle,41,0,45,4
1746600471213,EDS 201,A00,895545,Staff,22,0,45,23
1746600472237,EDS 203,A01,895581,Halter; Christopher P.,22,0,45,23
1746600473263,EDS 204R,A01,895625,Heinzman; Erica M.,39,0,45,6
1746600473263,EDS 204R,B01,895693,Halter; Christopher P.,10,0,45,35
1746600474293,EDS 206R,A00,895694,Fargason; Sharon Gayle,1,0,30,29
1746600474293,EDS 206R,B00,895695,Choi; Bailey Miyeon,16,0,30,14
1746600475321,EDS 250,A00,895697,Hemans; Patricia Ann Benitez,22,0,45,23
1746600476346,EDS 281,A00,895701,Meyerott; Theresa Ann,1,0,15,14
1746600477376,EDS 284,A00,895736,Meyerott; Theresa Ann,1,0,15,14
1746600478402,EDS 286,A00,897210,Fine; Sarah,0,0,15,15
1746600479427,EDS 289C,A01,895770,Daly; Alan J.,1,0,15,14
1746600480454,EDS 290,A00,897211,Hofstetter; Carolyn,0,0,15,15
1746600481483,LIGM 5A,A00,896162,Fischer-Grunski; Eva K,12,0,20,8
1746600482513,LIGM 5B,A00,896260,Fischer-Grunski; Eva K,17,0,20,3
1746600483541,LIGM 5C,A00,896308,Fischer-Grunski; Eva K,18,0,20,2
1746600484565,LIIT 5AS,A00,896313,Carnelos; Chiara,18,0,20,2
1746600485594,LIIT 5BS,A00,896416,Carnelos; Chiara,20,0,20,0
1746600486619,LIIT 5CS,A00,896564,Carnelos; Chiara,20,0,20,0
1746600487644,LISP 5A,A00,896588,Munoz Sanchez; Alicia,2,0,20,18
1746600488673,LISP 5B,A00,896653,Munoz Sanchez; Alicia,7,0,20,13
1746600489701,LISP 5C,A00,896655,Munoz Sanchez; Alicia,0,1,20,20
1746600490727,MAE 197,001,957918,Kleissl; Jan,9996,0,9999,3
1746600490727,MAE 197,002,959806,Boechler; Nicholas Sebastia,9998,0,9999,1
1746600490727,MAE 197,003,959852,Mullin; Jennifer S,9998,0,9999,1
1746600491750,MATH 2,A01,957937,Staff,33,0,35,2
1746600492775,MATH 197,001,957876,Kedlaya; Kiran S.,9993,0,9999,6
1746600493800,MCWP 40,A00,892729,Duru; Nur,10,0,20,10
1746600493800,MCWP 40,B00,893304,Montejo; Carolina,14,0,20,6
1746600494825,MCWP 40R,A00,893757,Redela; Pamela Morgan,0,5,20,20
1746600495854,MCWP 50,A00,893758,Morshed; Michael James,0,0,20,20
1746600495854,MCWP 50,B00,893761,Bartulis; Jason Michael,17,0,20,3
1746600496880,MCWP 50R,A00,893766,Compas; Sean Matthew,0,1,20,20
1746600496880,MCWP 50R,B00,893769,Carter; Jennifer A,0,1,20,20
1746600496880,MCWP 50R,C00,893771,Krone; Jarret,0,3,20,20
1746600496880,MCWP 50R,D00,893772,Miller; Elizabeth Deen,0,0,20,20
1746600496880,MCWP 50R,E00,893775,Carter; Andrea L,0,1,20,20
1746600497909,MMW 11R,A01,892721,Herbst; Matthew,14,0,30,16
1746600497909,MMW 11R,A02,892722,Herbst; Matthew,0,0,0,3
1746600498936,MMW 12R,A01,892724,Herbst; Matthew,0,11,16,16
1746600498936,MMW 12R,A02,892725,Herbst; Matthew,0,10,16,16
1746600499961,MMW 13R,A01,892727,Staff,0,4,16,16
1746600499961,MMW 13R,A02,892728,Staff,0,4,16,16
1746600499961,MMW 13R,A03,958032,Staff,0,4,16,16
1746600499961,MMW 13R,A04,958033,Staff,0,4,16,16
1746600499961,MMW 13R,A05,958034,Staff,0,4,16,16
1746600500986,SIO 295LS,A00,894015,Staff,5,0,25,20
1746600502012,SIO 295S,A00,894020,Staff,5,0,25,20
1746600503038,SIOC 290S,B01,958918,Merrifield; Mark A,14,0,30,16
1746600504063,SIOC 291S,B01,958922,Gabriel; Corey John,14,0,30,16
1746600505090,SOCI 117,A01,895339,Staff,2,0,5,3
1746600506118,WES 237B,A00,894149,Staff,11,0,20,9
1746600508187,AESE 279B,A00,891859,Staff,13,0,35,22
1746600509212,AIP 197,001,891854,Vespa; Emanuel Ignacio,9999,0,9999,0
1746600510236,ANTH 289S,A00,891856,Gagneux; Pascal,12,0,12,0
1746600511261,BENG 196,001,957946,Engler; Adam J.,9996,0,9999,3
1746600512286,BISP 197,001,959851,Wilhelm; James E.,9998,0,9999,1
1746600513313,CAT 124RS,A01,956906,Staff,6,0,25,19
1746600514337,CAT 125RS,A01,922013,Staff,6,0,25,19
1746600515365,CLRE 250,A00,891860,Morris; Sheldon,9995,0,9999,4
1746600517415,CLRE 251R,A00,907817,Mehta; Ravindra L.,9994,0,9999,5
1746600518440,CLRE 252,A00,891864,Cuomo; Raphael Eduardo,9993,0,9999,6
1746600519464,CLRE 253,A00,891867,Vaida; Florin,9994,0,9999,5
1746600519464,CLRE 253,B00,907819,Staff,9999,0,9999,0
1746600520489,CLRE 259,A00,891868,Patel; Hemal,9998,0,9999,1
1746600521517,CLRE 260,A00,891872,Cuomo; Raphael Eduardo,9999,0,9999,0
1746600522545,CLRE 297,001,891888,Cuomo; Raphael Eduardo,9999,0,9999,0
1746600523568,CSE 191,A00,958773,Minnes Kemp; Mor Mia,9995,0,9999,4
1746600524599,CSE 197,001,959846,Minnes Kemp; Mor Mia,9990,0,9999,9
1746600525624,CSS 201S,A01,892054,Mignozzetti; Umberto,25,0,30,5
1746600526649,CSS 202S,A01,892056,Mignozzetti; Umberto,25,0,30,5
1746600527676,DSC 197,001,956898,Eldridge; Justin Matthew,9996,0,9999,3
1746600528704,DSC 297,001,958000,Mazumdar; Arya,9998,0,9999,1
1746600528704,DSC 297,002,959862,Wang; Yusu,9998,0,9999,1
1746600529731,EAP 100,A00,905686,Staff,9778,0,9999,221
1746600530759,ECE 45,A01,892618,Staff,0,0,65,65
1746600532813,ECE 111,A01,892719,Staff,6,0,65,59
1746600533837,ECE 197,001,957920,Mercier; Patrick Philip,9991,0,9999,8
1746600534862,ECON 178,A01,907814,Zhu; Ying,26,0,35,9
1746600535892,EDS 115,A00,895312,Staff,35,0,45,10
1746600536918,EDS 117,A01,895337,Staff,23,0,30,7
1746600537944,EDS 125,A00,895341,Jones; Gabrielle Anastasia,36,0,45,9
1746600538967,EDS 128A,A01,895459,Fargason; Sharon Gayle,44,0,45,1
1746600539993,EDS 128B,A01,895543,Pappas; Elizabeth,44,0,45,1
1746600541020,EDS 139,A00,897203,Pappas; Elizabeth,44,0,45,1
1746600541020,EDS 139,B00,897209,Fargason; Sharon Gayle,41,0,45,4
1746600542049,EDS 201,A00,895545,Staff,22,0,45,23
1746600543075,EDS 203,A01,895581,Halter; Christopher P.,22,0,45,23
1746600544103,EDS 204R,A01,895625,Heinzman; Erica M.,39,0,45,6
1746600544103,EDS 204R,B01,895693,Halter; Christopher P.,10,0,45,35
1746600545131,EDS 206R,A00,895694,Fargason; Sharon Gayle,1,0,30,29
1746600545131,EDS 206R,B00,895695,Choi; Bailey Miyeon,16,0,30,14
1746600546160,EDS 250,A00,895697,Hemans; Patricia Ann Benitez,22,0,45,23
1746600547188,EDS 281,A00,895701,Meyerott; Theresa Ann,1,0,15,14
1746600548215,EDS 284,A00,895736,Meyerott; Theresa Ann,1,0,15,14
1746600549239,EDS 286,A00,897210,Fine; Sarah,0,0,15,15
1746600550268,EDS 289C,A01,895770,Daly; Alan J.,1,0,15,14
1746600551292,EDS 290,A00,897211,Hofstetter; Carolyn,0,0,15,15
1746600552318,LIGM 5A,A00,896162,Fischer-Grunski; Eva K,12,0,20,8
1746600553342,LIGM 5B,A00,896260,Fischer-Grunski; Eva K,17,0,20,3
1746600554368,LIGM 5C,A00,896308,Fischer-Grunski; Eva K,18,0,20,2
1746600555395,LIIT 5AS,A00,896313,Carnelos; Chiara,18,0,20,2
1746600556423,LIIT 5BS,A00,896416,Carnelos; Chiara,20,0,20,0
1746600557471,LIIT 5CS,A00,896564,Carnelos; Chiara,20,0,20,0
1746600558500,LISP 5A,A00,896588,Munoz Sanchez; Alicia,2,0,20,18
1746600559526,LISP 5B,A00,896653,Munoz Sanchez; Alicia,7,0,20,13
1746600560552,LISP 5C,A00,896655,Munoz Sanchez; Alicia,0,1,20,20
1746600561576,MAE 197,001,957918,Kleissl; Jan,9996,0,9999,3
1746600561576,MAE 197,002,959806,Boechler; Nicholas Sebastia,9998,0,9999,1
1746600561576,MAE 197,003,959852,Mullin; Jennifer S,9998,0,9999,1
1746600562603,MATH 2,A01,957937,Staff,33,0,35,2
1746600563630,MATH 197,001,957876,Kedlaya; Kiran S.,9993,0,9999,6
1746600564655,MCWP 40,A00,892729,Duru; Nur,10,0,20,10
1746600564655,MCWP 40,B00,893304,Montejo; Carolina,14,0,20,6
1746600565683,MCWP 40R,A00,893757,Redela; Pamela Morgan,0,5,20,20
1746600566709,MCWP 50,A00,893758,Morshed; Michael James,0,0,20,20
1746600566709,MCWP 50,B00,893761,Bartulis; Jason Michael,17,0,20,3
1746600567734,MCWP 50R,A00,893766,Compas; Sean Matthew,0,1,20,20
1746600567734,MCWP 50R,B00,893769,Carter; Jennifer A,0,1,20,20
1746600567734,MCWP 50R,C00,893771,Krone; Jarret,0,3,20,20
1746600567734,MCWP 50R,D00,893772,Miller; Elizabeth Deen,0,0,20,20
1746600567734,MCWP 50R,E00,893775,Carter; Andrea L,0,1,20,20
1746600568761,MMW 11R,A01,892721,Herbst; Matthew,14,0,30,16
1746600568761,MMW 11R,A02,892722,Herbst; Matthew,0,0,0,3
1746600569788,MMW 12R,A01,892724,Herbst; Matthew,0,11,16,16
1746600569788,MMW 12R,A02,892725,Herbst; Matthew,0,10,16,16
1746600570812,MMW 13R,A01,892727,Staff,0,4,16,16
1746600570812,MMW 13R,A02,892728,Staff,0,4,16,16
1746600570812,MMW 13R,A03,958032,Staff,0,4,16,16
1746600570812,MMW 13R,A04,958033,Staff,0,4,16,16
1746600570812,MMW 13R,A05,958034,Staff,0,4,16,16
1746600571835,SIO 295LS,A00,894015,Staff,5,0,25,20
1746600572861,SIO 295S,A00,894020,Staff,5,0,25,20
1746600573886,SIOC 290S,B01,958918,Merrifield; Mark A,14,0,30,16
1746600574909,SIOC 291S,B01,958922,Gabriel; Corey John,14,0,30,16
1746600575935,SOCI 117,A01,895339,Staff,2,0,5,3
1746600576966,WES 237B,A00,894149,Staff,11,0,20,9
1746600579051,AESE 279B,A00,891859,Staff,13,0,35,22
1746600580076,AIP 197,001,891854,Vespa; Emanuel Ignacio,9999,0,9999,0
1746600581105,ANTH 289S,A00,891856,Gagneux; Pascal,12,0,12,0
1746600582132,BENG 196,001,957946,Engler; Adam J.,9996,0,9999,3
1746600583156,BISP 197,001,959851,Wilhelm; James E.,9998,0,9999,1
1746600584182,CAT 124RS,A01,956906,Staff,6,0,25,19
1746600585207,CAT 125RS,A01,922013,Staff,6,0,25,19
1746600586234,CLRE 250,A00,891860,Morris; Sheldon,9995,0,9999,4
1746600588282,CLRE 251R,A00,907817,Mehta; Ravindra L.,9994,0,9999,5
1746600589305,CLRE 252,A00,891864,Cuomo; Raphael Eduardo,9993,0,9999,6
1746600590329,CLRE 253,A00,891867,Vaida; Florin,9994,0,9999,5
1746600590329,CLRE 253,B00,907819,Staff,9999,0,9999,0
1746600591353,CLRE 259,A00,891868,Patel; Hemal,9998,0,9999,1
1746600592380,CLRE 260,A00,891872,Cuomo; Raphael Eduardo,9999,0,9999,0
1746600593410,CLRE 297,001,891888,Cuomo; Raphael Eduardo,9999,0,9999,0
1746600594435,CSE 191,A00,958773,Minnes Kemp; Mor Mia,9995,0,9999,4
1746600595460,CSE 197,001,959846,Minnes Kemp; Mor Mia,9990,0,9999,9
1746600596486,CSS 201S,A01,892054,Mignozzetti; Umberto,25,0,30,5
1746600597517,CSS 202S,A01,892056,Mignozzetti; Umberto,25,0,30,5
1746600598544,DSC 197,001,956898,Eldridge; Justin Matthew,9996,0,9999,3
1746600599574,DSC 297,001,958000,Mazumdar; Arya,9998,0,9999,1
1746600599574,DSC 297,002,959862,Wang; Yusu,9998,0,9999,1
1746600600603,EAP 100,A00,905686,Staff,9778,0,9999,221
1746600601632,ECE 45,A01,892618,Staff,0,0,65,65
1746600603687,ECE 111,A01,892719,Staff,6,0,65,59
1746600604716,ECE 197,001,957920,Mercier; Patrick Philip,9991,0,9999,8
1746600605742,ECON 178,A01,907814,Zhu; Ying,26,0,35,9
1746600606771,EDS 115,A00,895312,Staff,35,0,45,10
1746600607820,EDS 117,A01,895337,Staff,23,0,30,7
1746600608846,EDS 125,A00,895341,Jones; Gabrielle Anastasia,36,0,45,9
1746600609870,EDS 128A,A01,895459,Fargason; Sharon Gayle,44,0,45,1
1746600610895,EDS 128B,A01,895543,Pappas; Elizabeth,44,0,45,1
1746600611922,EDS 139,A00,897203,Pappas; Elizabeth,44,0,45,1
1746600611922,EDS 139,B00,897209,Fargason; Sharon Gayle,41,0,45,4
1746600612951,EDS 201,A00,895545,Staff,22,0,45,23
1746600613976,EDS 203,A01,895581,Halter; Christopher P.,22,0,45,23
1746600615005,EDS 204R,A01,895625,Heinzman; Erica M.,39,0,45,6
1746600615005,EDS 204R,B01,895693,Halter; Christopher P.,10,0,45,35
1746600616033,EDS 206R,A00,895694,Fargason; Sharon Gayle,1,0,30,29
1746600616033,EDS 206R,B00,895695,Choi; Bailey Miyeon,16,0,30,14
1746600617061,EDS 250,A00,895697,Hemans; Patricia Ann Benitez,22,0,45,23
1746600618088,EDS 281,A00,895701,Meyerott; Theresa Ann,1,0,15,14
1746600619114,EDS 284,A00,895736,Meyerott; Theresa Ann,1,0,15,14
1746600620140,EDS 286,A00,897210,Fine; Sarah,0,0,15,15
1746600621165,EDS 289C,A01,895770,Daly; Alan J.,1,0,15,14
1746600622192,EDS 290,A00,897211,Hofstetter; Carolyn,0,0,15,15
1746600623216,LIGM 5A,A00,896162,Fischer-Grunski; Eva K,12,0,20,8
1746600624262,LIGM 5B,A00,896260,Fischer-Grunski; Eva K,17,0,20,3
1746600625291,LIGM 5C,A00,896308,Fischer-Grunski; Eva K,18,0,20,2
1746600626317,LIIT 5AS,A00,896313,Carnelos; Chiara,18,0,20,2
1746600627344,LIIT 5BS,A00,896416,Carnelos; Chiara,20,0,20,0
1746600628372,LIIT 5CS,A00,896564,Carnelos; Chiara,20,0,20,0
1746600629400,LISP 5A,A00,896588,Munoz Sanchez; Alicia,2,0,20,18
1746600630429,LISP 5B,A00,896653,Munoz Sanchez; Alicia,7,0,20,13
1746600631453,LISP 5C,A00,896655,Munoz Sanchez; Alicia,0,1,20,20
1746600632479,MAE 197,001,957918,Kleissl; Jan,9996,0,9999,3
1746600632479,MAE 197,002,959806,Boechler; Nicholas Sebastia,9998,0,9999,1
1746600632479,MAE 197,003,959852,Mullin; Jennifer S,9998,0,9999,1
1746600633502,MATH 2,A01,957937,Staff,33,0,35,2
1746600634529,MATH 197,001,957876,Kedlaya; Kiran S.,9993,0,9999,6
1746600635555,MCWP 40,A00,892729,Duru; Nur,10,0,20,10
1746600635555,MCWP 40,B00,893304,Montejo; Carolina,14,0,20,6
1746600636579,MCWP 40R,A00,893757,Redela; Pamela Morgan,0,5,20,20
1746600637608,MCWP 50,A00,893758,Morshed; Michael James,0,0,20,20
1746600637608,MCWP 50,B00,893761,Bartulis; Jason Michael,17,0,20,3
1746600638635,MCWP 50R,A00,893766,Compas; Sean Matthew,0,1,20,20
1746600638635,MCWP 50R,B00,893769,Carter; Jennifer A,0,1,20,20
1746600638635,MCWP 50R,C00,893771,Krone; Jarret,0,3,20,20
1746600638635,MCWP 50R,D00,893772,Miller; Elizabeth Deen,0,0,20,20
1746600638635,MCWP 50R,E00,893775,Carter; Andrea L,0,1,20,20
1746600639661,MMW 11R,A01,892721,Herbst; Matthew,14,0,30,16
1746600639661,MMW 11R,A02,892722,Herbst; Matthew,0,0,0,3
1746600640686,MMW 12R,A01,892724,Herbst; Matthew,0,11,16,16
1746600640686,MMW 12R,A02,892725,Herbst; Matthew,0,10,16,16
1746600641711,MMW 13R,A01,892727,Staff,0,4,16,16
1746600641711,MMW 13R,A02,892728,Staff,0,4,16,16
1746600641711,MMW 13R,A03,958032,Staff,0,4,16,16
1746600641711,MMW 13R,A04,958033,Staff,0,4,16,16
1746600641711,MMW 13R,A05,958034,Staff,0,4,16,16
1746600642737,SIO 295LS,A00,894015,Staff,5,0,25,20
1746600643765,SIO 295S,A00,894020,Staff,5,0,25,20
1746600644791,SIOC 290S,B01,958918,Merrifield; Mark A,14,0,30,16
1746600645818,SIOC 291S,B01,958922,Gabriel; Corey John,14,0,30,16
1746600646842,SOCI 117,A01,895339,Staff,2,0,5,3
1746600647870,WES 237B,A00,894149,Staff,11,0,20,9
1746600649924,AESE 279B,A00,891859,Staff,13,0,35,22
1746600650949,AIP 197,001,891854,Vespa; Emanuel Ignacio,9999,0,9999,0
1746600651978,ANTH 289S,A00,891856,Gagneux; Pascal,12,0,12,0
1746600653008,BENG 196,001,957946,Engler; Adam J.,9996,0,9999,3
1746600654034,BISP 197,001,959851,Wilhelm; James E.,9998,0,9999,1
1746600655064,CAT 124RS,A01,956906,Staff,6,0,25,19
1746600656089,CAT 125RS,A01,922013,Staff,6,0,25,19
1746600657113,CLRE 250,A00,891860,Morris; Sheldon,9995,0,9999,4
1746600659166,CLRE 251R,A00,907817,Mehta; Ravindra L.,9994,0,9999,5
1746600660193,CLRE 252,A00,891864,Cuomo; Raphael Eduardo,9993,0,9999,6
1746600661219,CLRE 253,A00,891867,Vaida; Florin,9994,0,9999,5
1746600661219,CLRE 253,B00,907819,Staff,9999,0,9999,0
1746600662247,CLRE 259,A00,891868,Patel; Hemal,9998,0,9999,1
1746600663277,CLRE 260,A00,891872,Cuomo; Raphael Eduardo,9999,0,9999,0
1746600664304,CLRE 297,001,891888,Cuomo; Raphael Eduardo,9999,0,9999,0
1746600665329,CSE 191,A00,958773,Minnes Kemp; Mor Mia,9995,0,9999,4
1746600666357,CSE 197,001,959846,Minnes Kemp; Mor Mia,9990,0,9999,9
1746600667381,CSS 201S,A01,892054,Mignozzetti; Umberto,25,0,30,5
1746600668408,CSS 202S,A01,892056,Mignozzetti; Umberto,25,0,30,5
1746600669437,DSC 197,001,956898,Eldridge; Justin Matthew,9996,0,9999,3
1746600670460,DSC 297,001,958000,Mazumdar; Arya,9998,0,9999,1
1746600670460,DSC 297,002,959862,Wang; Yusu,9998,0,9999,1
1746600671486,EAP 100,A00,905686,Staff,9778,0,9999,221
1746600672515,ECE 45,A01,892618,Staff,0,0,65,65
1746600674567,ECE 111,A01,892719,Staff,6,0,65,59
1746600675590,ECE 197,001,957920,Mercier; Patrick Philip,9991,0,9999,8
1746600676619,ECON 178,A01,907814,Zhu; Ying,26,0,35,9
1746600677646,EDS 115,A00,895312,Staff,35,0,45,10
1746600678673,EDS 117,A01,895337,Staff,23,0,30,7
1746600679698,EDS 125,A00,895341,Jones; Gabrielle Anastasia,36,0,45,9
1746600680725,EDS 128A,A01,895459,Fargason; Sharon Gayle,44,0,45,1
1746600681755,EDS 128B,A01,895543,Pappas; Elizabeth,44,0,45,1
1746600682782,EDS 139,A00,897203,Pappas; Elizabeth,44,0,45,1
1746600682782,EDS 139,B00,897209,Fargason; Sharon Gayle,41,0,45,4
1746600683810,EDS 201,A00,895545,Staff,22,0,45,23
1746600684836,EDS 203,A01,895581,Halter; Christopher P.,22,0,45,23
1746600685861,EDS 204R,A01,895625,Heinzman; Erica M.,39,0,45,6
1746600685861,EDS 204R,B01,895693,Halter; Christopher P.,10,0,45,35
1746600686887,EDS 206R,A00,895694,Fargason; Sharon Gayle,1,0,30,29
1746600686887,EDS 206R,B00,895695,Choi; Bailey Miyeon,16,0,30,14
1746600687913,EDS 250,A00,895697,Hemans; Patricia Ann Benitez,22,0,45,23
1746600688940,EDS 281,A00,895701,Meyerott; Theresa Ann,1,0,15,14
1746600689967,EDS 284,A00,895736,Meyerott; Theresa Ann,1,0,15,14
1746600690992,EDS 286,A00,897210,Fine; Sarah,0,0,15,15
1746600692020,EDS 289C,A01,895770,Daly; Alan J.,1,0,15,14
1746600693050,EDS 290,A00,897211,Hofstetter; Carolyn,0,0,15,15
1746600694079,LIGM 5A,A00,896162,Fischer-Grunski; Eva K,12,0,20,8
1746600695106,LIGM 5B,A00,896260,Fischer-Grunski; Eva K,17,0,20,3
1746600696133,LIGM 5C,A00,896308,Fischer-Grunski; Eva K,18,0,20,2
1746600697163,LIIT 5AS,A00,896313,Carnelos; Chiara,18,0,20,2
1746600698192,LIIT 5BS,A00,896416,Carnelos; Chiara,20,0,20,0
1746600699219,LIIT 5CS,A00,896564,Carnelos; Chiara,20,0,20,0
1746600700244,LISP 5A,A00,896588,Munoz Sanchez; Alicia,2,0,20,18
1746600701274,LISP 5B,A00,896653,Munoz Sanchez; Alicia,7,0,20,13
1746600702299,LISP 5C,A00,896655,Munoz Sanchez; Alicia,0,1,20,20
1746600703324,MAE 197,001,957918,Kleissl; Jan,9996,0,9999,3
1746600703324,MAE 197,002,959806,Boechler; Nicholas Sebastia,9998,0,9999,1
1746600703324,MAE 197,003,959852,Mullin; Jennifer S,9998,0,9999,1
1746600704353,MATH 2,A01,957937,Staff,33,0,35,2
1746600705380,MATH 197,001,957876,Kedlaya; Kiran S.,9993,0,9999,6
1746600706404,MCWP 40,A00,892729,Duru; Nur,10,0,20,10
1746600706404,MCWP 40,B00,893304,Montejo; Carolina,14,0,20,6
1746600707430,MCWP 40R,A00,893757,Redela; Pamela Morgan,0,5,20,20
1746600708459,MCWP 50,A00,893758,Morshed; Michael James,0,0,20,20
1746600708459,MCWP 50,B00,893761,Bartulis; Jason Michael,17,0,20,3
1746600709487,MCWP 50R,A00,893766,Compas; Sean Matthew,0,1,20,20
1746600709487,MCWP 50R,B00,893769,Carter; Jennifer A,0,1,20,20
1746600709487,MCWP 50R,C00,893771,Krone; Jarret,0,3,20,20
1746600709487,MCWP 50R,D00,893772,Miller; Elizabeth Deen,0,0,20,20
1746600709487,MCWP 50R,E00,893775,Carter; Andrea L,0,1,20,20
1746600710512,MMW 11R,A01,892721,Herbst; Matthew,14,0,30,16
1746600710512,MMW 11R,A02,892722,Herbst; Matthew,0,0,0,3
1746600711541,MMW 12R,A01,892724,Herbst; Matthew,0,11,16,16
1746600711541,MMW 12R,A02,892725,Herbst; Matthew,0,10,16,16
1746600712567,MMW 13R,A01,892727,Staff,0,4,16,16
1746600712567,MMW 13R,A02,892728,Staff,0,4,16,16
1746600712567,MMW 13R,A03,958032,Staff,0,4,16,16
1746600712567,MMW 13R,A04,958033,Staff,0,4,16,16
1746600712567,MMW 13R,A05,958034,Staff,0,4,16,16
1746600713595,SIO 295LS,A00,894015,Staff,5,0,25,20
1746600714624,SIO 295S,A00,894020,Staff,5,0,25,20
1746600715651,SIOC 290S,B01,958918,Merrifield; Mark A,14,0,30,16
1746600716683,SIOC 291S,B01,958922,Gabriel; Corey John,14,0,30,16
1746600717713,SOCI 117,A01,895339,Staff,2,0,5,3
1746600718741,WES 237B,A00,894149,Staff,11,0,20,9
1746600720807,AESE 279B,A00,891859,Staff,13,0,35,22
1746600721835,AIP 197,001,891854,Vespa; Emanuel Ignacio,9999,0,9999,0
1746600722866,ANTH 289S,A00,891856,Gagneux; Pascal,12,0,12,0
1746600723892,BENG 196,001,957946,Engler; Adam J.,9996,0,9999,3
1746600724918,BISP 197,001,959851,Wilhelm; James E.,9998,0,9999,1
1746600725945,CAT 124RS,A01,956906,Staff,6,0,25,19
1746600726970,CAT 125RS,A01,922013,Staff,6,0,25,19
1746600727999,CLRE 250,A00,891860,Morris; Sheldon,9995,0,9999,4
1746600730057,CLRE 251R,A00,907817,Mehta; Ravindra L.,9994,0,9999,5
1746600731087,CLRE 252,A00,891864,Cuomo; Raphael Eduardo,9993,0,9999,6
1746600732112,CLRE 253,A00,891867,Vaida; Florin,9994,0,9999,5
1746600732112,CLRE 253,B00,907819,Staff,9999,0,9999,0
1746600733139,CLRE 259,A00,891868,Patel; Hemal,9998,0,9999,1
1746600734164,CLRE 260,A00,891872,Cuomo; Raphael Eduardo,9999,0,9999,0
1746600735193,CLRE 297,001,891888,Cuomo; Raphael Eduardo,9999,0,9999,0
1746600736221,CSE 191,A00,958773,Minnes Kemp; Mor Mia,9995,0,9999,4
1746600737246,CSE 197,001,959846,Minnes Kemp; Mor Mia,9990,0,9999,9
1746600738271,CSS 201S,A01,892054,Mignozzetti; Umberto,25,0,30,5
1746600739299,CSS 202S,A01,892056,Mignozzetti; Umberto,25,0,30,5
1746600740324,DSC 197,001,956898,Eldridge; Justin Matthew,9996,0,9999,3
1746600741356,DSC 297,001,958000,Mazumdar; Arya,9998,0,9999,1
1746600741356,DSC 297,002,959862,Wang; Yusu,9998,0,9999,1
1746600742382,EAP 100,A00,905686,Staff,9778,0,9999,221
1746600743409,ECE 45,A01,892618,Staff,0,0,65,65
1746600745464,ECE 111,A01,892719,Staff,6,0,65,59
1746600746490,ECE 197,001,957920,Mercier; Patrick Philip,9991,0,9999,8
1746600747515,ECON 178,A01,907814,Zhu; Ying,26,0,35,9
1746600748542,EDS 115,A00,895312,Staff,35,0,45,10
1746600749571,EDS 117,A01,895337,Staff,23,0,30,7
1746600750596,EDS 125,A00,895341,Jones; Gabrielle Anastasia,36,0,45,9
1746600751622,EDS 128A,A01,895459,Fargason; Sharon Gayle,44,0,45,1
1746600752647,EDS 128B,A01,895543,Pappas; Elizabeth,44,0,45,1
1746600753678,EDS 139,A00,897203,Pappas; Elizabeth,44,0,45,1
1746600753678,EDS 139,B00,897209,Fargason; Sharon Gayle,41,0,45,4
1746600754707,EDS 201,A00,895545,Staff,22,0,45,23
1746600755733,EDS 203,A01,895581,Halter; Christopher P.,22,0,45,23
1746600756758,EDS 204R,A01,895625,Heinzman; Erica M.,39,0,45,6
1746600756758,EDS 204R,B01,895693,Halter; Christopher P.,10,0,45,35
1746600757787,EDS 206R,A00,895694,Fargason; Sharon Gayle,1,0,30,29
1746600757787,EDS 206R,B00,895695,Choi; Bailey Miyeon,16,0,30,14
1746600758812,EDS 250,A00,895697,Hemans; Patricia Ann Benitez,22,0,45,23
1746600759843,EDS 281,A00,895701,Meyerott; Theresa Ann,1,0,15,14
1746600760868,EDS 284,A00,895736,Meyerott; Theresa Ann,1,0,15,14
1746600761897,EDS 286,A00,897210,Fine; Sarah,0,0,15,15
1746600762924,EDS 289C,A01,895770,Daly; Alan J.,1,0,15,14
1746600763951,EDS 290,A00,897211,Hofstetter; Carolyn,0,0,15,15
1746600764986,LIGM 5A,A00,896162,Fischer-Grunski; Eva K,12,0,20,8
1746600766017,LIGM 5B,A00,896260,Fischer-Grunski; Eva K,17,0,20,3
1746600767042,LIGM 5C,A00,896308,Fischer-Grunski; Eva K,18,0,20,2
1746600768068,LIIT 5AS,A00,896313,Carnelos; Chiara,18,0,20,2
1746600769097,LIIT 5BS,A00,896416,Carnelos; Chiara,20,0,20,0
1746600770128,LIIT 5CS,A00,896564,Carnelos; Chiara,20,0,20,0
1746600771154,LISP 5A,A00,896588,Munoz Sanchez; Alicia,2,0,20,18
1746600772182,LISP 5B,A00,896653,Munoz Sanchez; Alicia,7,0,20,13
1746600773207,LISP 5C,A00,896655,Munoz Sanchez; Alicia,0,1,20,20
1746600774233,MAE 197,001,957918,Kleissl; Jan,9996,0,9999,3
1746600774233,MAE 197,002,959806,Boechler; Nicholas Sebastia,9998,0,9999,1
1746600774233,MAE 197,003,959852,Mullin; Jennifer S,9998,0,9999,1
1746600775260,MATH 2,A01,957937,Staff,33,0,35,2
1746600776287,MATH 197,001,957876,Kedlaya; Kiran S.,9993,0,9999,6
1746600777315,MCWP 40,A00,892729,Duru; Nur,10,0,20,10
1746600777315,MCWP 40,B00,893304,Montejo; Carolina,14,0,20,6
1746600778339,MCWP 40R,A00,893757,Redela; Pamela Morgan,0,5,20,20
1746600779367,MCWP 50,A00,893758,Morshed; Michael James,0,0,20,20
1746600779367,MCWP 50,B00,893761,Bartulis; Jason Michael,17,0,20,3
1746600780396,MCWP 50R,A00,893766,Compas; Sean Matthew,0,1,20,20
1746600780396,MCWP 50R,B00,893769,Carter; Jennifer A,0,1,20,20
1746600780396,MCWP 50R,C00,893771,Krone; Jarret,0,3,20,20
1746600780396,MCWP 50R,D00,893772,Miller; Elizabeth Deen,0,0,20,20
1746600780396,MCWP 50R,E00,893775,Carter; Andrea L,0,1,20,20
1746600781425,MMW 11R,A01,892721,Herbst; Matthew,14,0,30,16
1746600781425,MMW 11R,A02,892722,Herbst; Matthew,0,0,0,3
1746600782451,MMW 12R,A01,892724,Herbst; Matthew,0,11,16,16
1746600782451,MMW 12R,A02,892725,Herbst; Matthew,0,10,16,16
1746600783480,MMW 13R,A01,892727,Staff,0,4,16,16
1746600783480,MMW 13R,A02,892728,Staff,0,4,16,16
1746600783480,MMW 13R,A03,958032,Staff,0,4,16,16
1746600783480,MMW 13R,A04,958033,Staff,0,4,16,16
1746600783480,MMW 13R,A05,958034,Staff,0,4,16,16
1746600784509,SIO 295LS,A00,894015,Staff,5,0,25,20
1746600785537,SIO 295S,A00,894020,Staff,5,0,25,20
1746600786562,SIOC 290S,B01,958918,Merrifield; Mark A,14,0,30,16
1746600787590,SIOC 291S,B01,958922,Gabriel; Corey John,14,0,30,16
1746600788615,SOCI 117,A01,895339,Staff,2,0,5,3
1746600789640,WES 237B,A00,894149,Staff,11,0,20,9
1746600791703,AESE 279B,A00,891859,Staff,13,0,35,22
1746600792732,AIP 197,001,891854,Vespa; Emanuel Ignacio,9999,0,9999,0
1746600793758,ANTH 289S,A00,891856,Gagneux; Pascal,12,0,12,0
1746600794788,BENG 196,001,957946,Engler; Adam J.,9996,0,9999,3
1746600795816,BISP 197,001,959851,Wilhelm; James E.,9998,0,9999,1
1746600796844,CAT 124RS,A01,956906,Staff,6,0,25,19
1746600797873,CAT 125RS,A01,922013,Staff,6,0,25,19
1746600798899,CLRE 250,A00,891860,Morris; Sheldon,9995,0,9999,4
1746600800959,CLRE 251R,A00,907817,Mehta; Ravindra L.,9994,0,9999,5
1746600801986,CLRE 252,A00,891864,Cuomo; Raphael Eduardo,9993,0,9999,6
1746600803015,CLRE 253,A00,891867,Vaida; Florin,9994,0,9999,5
1746600803015,CLRE 253,B00,907819,Staff,9999,0,9999,0
1746600804040,CLRE 259,A00,891868,Patel; Hemal,9998,0,9999,1
1746600805065,CLRE 260,A00,891872,Cuomo; Raphael Eduardo,9999,0,9999,0
1746600806090,CLRE 297,001,891888,Cuomo; Raphael Eduardo,9999,0,9999,0
1746600807115,CSE 191,A00,958773,Minnes Kemp; Mor Mia,9995,0,9999,4
1746600808142,CSE 197,001,959846,Minnes Kemp; Mor Mia,9990,0,9999,9
1746600809171,CSS 201S,A01,892054,Mignozzetti; Umberto,25,0,30,5
1746600810198,CSS 202S,A01,892056,Mignozzetti; Umberto,25,0,30,5
1746600811226,DSC 197,001,956898,Eldridge; Justin Matthew,9996,0,9999,3
1746600812256,DSC 297,001,958000,Mazumdar; Arya,9998,0,9999,1
1746600812256,DSC 297,002,959862,Wang; Yusu,9998,0,9999,1
1746600813285,EAP 100,A00,905686,Staff,9778,0,9999,221
1746600814318,ECE 45,A01,892618,Staff,0,0,65,65
1746600816442,ECE 111,A01,892719,Staff,6,0,65,59
1746600817466,ECE 197,001,957920,Mercier; Patrick Philip,9991,0,9999,8
1746600818492,ECON 178,A01,907814,Zhu; Ying,26,0,35,9
1746600819519,EDS 115,A00,895312,Staff,35,0,45,10
1746600820548,EDS 117,A01,895337,Staff,23,0,30,7
1746600821574,EDS 125,A00,895341,Jones; Gabrielle Anastasia,36,0,45,9
1746600822602,EDS 128A,A01,895459,Fargason; Sharon Gayle,44,0,45,1
1746600823626,EDS 128B,A01,895543,Pappas; Elizabeth,44,0,45,1
1746600824655,EDS 139,A00,897203,Pappas; Elizabeth,44,0,45,1
1746600824655,EDS 139,B00,897209,Fargason; Sharon Gayle,41,0,45,4
1746600825682,EDS 201,A00,895545,Staff,22,0,45,23
1746600826709,EDS 203,A01,895581,Halter; Christopher P.,22,0,45,23
1746600827739,EDS 204R,A01,895625,Heinzman; Erica M.,39,0,45,6
1746600827739,EDS 204R,B01,895693,Halter; Christopher P.,10,0,45,35
1746600828764,EDS 206R,A00,895694,Fargason; Sharon Gayle,1,0,30,29
1746600828764,EDS 206R,B00,895695,Choi; Bailey Miyeon,16,0,30,14
1746600829790,EDS 250,A00,895697,Hemans; Patricia Ann Benitez,22,0,45,23
1746600830816,EDS 281,A00,895701,Meyerott; Theresa Ann,1,0,15,14
1746600831841,EDS 284,A00,895736,Meyerott; Theresa Ann,1,0,15,14
1746600832867,EDS 286,A00,897210,Fine; Sarah,0,0,15,15
1746600833892,EDS 289C,A01,895770,Daly; Alan J.,1,0,15,14
1746600834918,EDS 290,A00,897211,Hofstetter; Carolyn,0,0,15,15
1746600835944,LIGM 5A,A00,896162,Fischer-Grunski; Eva K,12,0,20,8
1746600836971,LIGM 5B,A00,896260,Fischer-Grunski; Eva K,17,0,20,3
1746600837997,LIGM 5C,A00,896308,Fischer-Grunski; Eva K,18,0,20,2
1746600839024,LIIT 5AS,A00,896313,Carnelos; Chiara,18,0,20,2
1746600840056,LIIT 5BS,A00,896416,Carnelos; Chiara,20,0,20,0
1746600841082,LIIT 5CS,A00,896564,Carnelos; Chiara,20,0,20,0
1746600842110,LISP 5A,A00,896588,Munoz Sanchez; Alicia,2,0,20,18
1746600843169,LISP 5B,A00,896653,Munoz Sanchez; Alicia,7,0,20,13
1746600844196,LISP 5C,A00,896655,Munoz Sanchez; Alicia,0,1,20,20
1746600845221,MAE 197,001,957918,Kleissl; Jan,9996,0,9999,3
1746600845221,MAE 197,002,959806,Boechler; Nicholas Sebastia,9998,0,9999,1
1746600845221,MAE 197,003,959852,Mullin; Jennifer S,9998,0,9999,1
1746600846248,MATH 2,A01,957937,Staff,33,0,35,2
1746600847274,MATH 197,001,957876,Kedlaya; Kiran S.,9993,0,9999,6
1746600848300,MCWP 40,A00,892729,Duru; Nur,10,0,20,10
1746600848300,MCWP 40,B00,893304,Montejo; Carolina,14,0,20,6
1746600849325,MCWP 40R,A00,893757,Redela; Pamela Morgan,0,5,20,20
1746600850351,MCWP 50,A00,893758,Morshed; Michael James,0,0,20,20
1746600850351,MCWP 50,B00,893761,Bartulis; Jason Michael,17,0,20,3
1746600851377,MCWP 50R,A00,893766,Compas; Sean Matthew,0,1,20,20
1746600851377,MCWP 50R,B00,893769,Carter; Jennifer A,0,1,20,20
1746600851377,MCWP 50R,C00,893771,Krone; Jarret,0,3,20,20
1746600851377,MCWP 50R,D00,893772,Miller; Elizabeth Deen,0,0,20,20
1746600851377,MCWP 50R,E00,893775,Carter; Andrea L,0,1,20,20
1746600852407,MMW 11R,A01,892721,Herbst; Matthew,14,0,30,16
1746600852407,MMW 11R,A02,892722,Herbst; Matthew,0,0,0,3
1746600853433,MMW 12R,A01,892724,Herbst; Matthew,0,11,16,16
1746600853433,MMW 12R,A02,892725,Herbst; Matthew,0,10,16,16
1746600854462,MMW 13R,A01,892727,Staff,0,4,16,16
1746600854462,MMW 13R,A02,892728,Staff,0,4,16,16
1746600854462,MMW 13R,A03,958032,Staff,0,4,16,16
1746600854462,MMW 13R,A04,958033,Staff,0,4,16,16
1746600854462,MMW 13R,A05,958034,Staff,0,4,16,16
1746600855492,SIO 295LS,A00,894015,Staff,5,0,25,20
1746600856518,SIO 295S,A00,894020,Staff,5,0,25,20
1746600857545,SIOC 290S,B01,958918,Merrifield; Mark A,14,0,30,16
1746600858577,SIOC 291S,B01,958922,Gabriel; Corey John,14,0,30,16
1746600859602,SOCI 117,A01,895339,Staff,2,0,5,3
1746600860627,WES 237B,A00,894149,Staff,11,0,20,9
1746600862703,AESE 279B,A00,891859,Staff,13,0,35,22
1746600863728,AIP 197,001,891854,Vespa; Emanuel Ignacio,9999,0,9999,0
1746600864753,ANTH 289S,A00,891856,Gagneux; Pascal,12,0,12,0
1746600865777,BENG 196,001,957946,Engler; Adam J.,9996,0,9999,3
1746600866806,BISP 197,001,959851,Wilhelm; James E.,9998,0,9999,1
1746600867831,CAT 124RS,A01,956906,Staff,6,0,25,19
1746600868861,CAT 125RS,A01,922013,Staff,6,0,25,19
1746600869886,CLRE 250,A00,891860,Morris; Sheldon,9995,0,9999,4
1746600871945,CLRE 251R,A00,907817,Mehta; Ravindra L.,9994,0,9999,5
1746600872973,CLRE 252,A00,891864,Cuomo; Raphael Eduardo,9993,0,9999,6
1746600874000,CLRE 253,A00,891867,Vaida; Florin,9994,0,9999,5
1746600874000,CLRE 253,B00,907819,Staff,9999,0,9999,0
1746600875031,CLRE 259,A00,891868,Patel; Hemal,9998,0,9999,1
1746600876057,CLRE 260,A00,891872,Cuomo; Raphael Eduardo,9999,0,9999,0
1746600877088,CLRE 297,001,891888,Cuomo; Raphael Eduardo,9999,0,9999,0
1746600878112,CSE 191,A00,958773,Minnes Kemp; Mor Mia,9995,0,9999,4
1746600879140,CSE 197,001,959846,Minnes Kemp; Mor Mia,9990,0,9999,9
1746600880171,CSS 201S,A01,892054,Mignozzetti; Umberto,25,0,30,5
1746600881196,CSS 202S,A01,892056,Mignozzetti; Umberto,25,0,30,5
1746600882221,DSC 197,001,956898,Eldridge; Justin Matthew,9996,0,9999,3
1746600883251,DSC 297,001,958000,Mazumdar; Arya,9998,0,9999,1
1746600883251,DSC 297,002,959862,Wang; Yusu,9998,0,9999,1
1746600884280,EAP 100,A00,905686,Staff,9778,0,9999,221
1746600885314,ECE 45,A01,892618,Staff,0,0,65,65
1746600887367,ECE 111,A01,892719,Staff,6,0,65,59
1746600888397,ECE 197,001,957920,Mercier; Patrick Philip,9991,0,9999,8
1746600889421,ECON 178,A01,907814,Zhu; Ying,26,0,35,9
1746600890448,EDS 115,A00,895312,Staff,35,0,45,10
1746600891476,EDS 117,A01,895337,Staff,23,0,30,7
1746600892502,EDS 125,A00,895341,Jones; Gabrielle Anastasia,36,0,45,9
1746600893527,EDS 128A,A01,895459,Fargason; Sharon Gayle,44,0,45,1
1746600894556,EDS 128B,A01,895543,Pappas; Elizabeth,44,0,45,1
1746600895580,EDS 139,A00,897203,Pappas; Elizabeth,44,0,45,1
1746600895580,EDS 139,B00,897209,Fargason; Sharon Gayle,41,0,45,4
1746600896605,EDS 201,A00,895545,Staff,22,0,45,23
1746600897633,EDS 203,A01,895581,Halter; Christopher P.,22,0,45,23
1746600898668,EDS 204R,A01,895625,Heinzman; Erica M.,39,0,45,6
1746600898668,EDS 204R,B01,895693,Halter; Christopher P.,10,0,45,35
1746600899693,EDS 206R,A00,895694,Fargason; Sharon Gayle,1,0,30,29
1746600899693,EDS 206R,B00,895695,Choi; Bailey Miyeon,16,0,30,14
1746600900725,EDS 250,A00,895697,Hemans; Patricia Ann Benitez,22,0,45,23
1746600901753,EDS 281,A00,895701,Meyerott; Theresa Ann,1,0,15,14
1746600902778,EDS 284,A00,895736,Meyerott; Theresa Ann,1,0,15,14
1746600903806,EDS 286,A00,897210,Fine; Sarah,0,0,15,15
1746600904830,EDS 289C,A01,895770,Daly; Alan J.,1,0,15,14
1746600905876,EDS 290,A00,897211,Hofstetter; Carolyn,0,0,15,15
1746600906901,LIGM 5A,A00,896162,Fischer-Grunski; Eva K,12,0,20,8
1746600907926,LIGM 5B,A00,896260,Fischer-Grunski; Eva K,17,0,20,3
1746600908951,LIGM 5C,A00,896308,Fischer-Grunski; Eva K,18,0,20,2
1746600910031,LIIT 5AS,A00,896313,Carnelos; Chiara,18,0,20,2
1746600911057,LIIT 5BS,A00,896416,Carnelos; Chiara,20,0,20,0
1746600912089,LIIT 5CS,A00,896564,Carnelos; Chiara,20,0,20,0
1746600913123,LISP 5A,A00,896588,Munoz Sanchez; Alicia,2,0,20,18
1746600914153,LISP 5B,A00,896653,Munoz Sanchez; Alicia,7,0,20,13
1746600915177,LISP 5C,A00,896655,Munoz Sanchez; Alicia,0,1,20,20
1746600916210,MAE 197,001,957918,Kleissl; Jan,9996,0,9999,3
1746600916210,MAE 197,002,959806,Boechler; Nicholas Sebastia,9998,0,9999,1
1746600916210,MAE 197,003,959852,Mullin; Jennifer S,9998,0,9999,1
1746600917239,MATH 2,A01,957937,Staff,33,0,35,2
1746600918268,MATH 197,001,957876,Kedlaya; Kiran S.,9993,0,9999,6
1746600919297,MCWP 40,A00,892729,Duru; Nur,10,0,20,10
1746600919297,MCWP 40,B00,893304,Montejo; Carolina,14,0,20,6
1746600920323,MCWP 40R,A00,893757,Redela; Pamela Morgan,0,5,20,20
1746600921355,MCWP 50,A00,893758,Morshed; Michael James,0,0,20,20
1746600921355,MCWP 50,B00,893761,Bartulis; Jason Michael,17,0,20,3
1746600922388,MCWP 50R,A00,893766,Compas; Sean Matthew,0,1,20,20
1746600922388,MCWP 50R,B00,893769,Carter; Jennifer A,0,1,20,20
1746600922388,MCWP 50R,C00,893771,Krone; Jarret,0,3,20,20
1746600922388,MCWP 50R,D00,893772,Miller; Elizabeth Deen,0,0,20,20
1746600922388,MCWP 50R,E00,893775,Carter; Andrea L,0,1,20,20
1746600923413,MMW 11R,A01,892721,Herbst; Matthew,14,0,30,16
1746600923413,MMW 11R,A02,892722,Herbst; Matthew,0,0,0,3
1746600924443,MMW 12R,A01,892724,Herbst; Matthew,0,11,16,16
1746600924443,MMW 12R,A02,892725,Herbst; Matthew,0,10,16,16
1746600925471,MMW 13R,A01,892727,Staff,0,4,16,16
1746600925471,MMW 13R,A02,892728,Staff,0,4,16,16
1746600925471,MMW 13R,A03,958032,Staff,0,4,16,16
1746600925471,MMW 13R,A04,958033,Staff,0,4,16,16
1746600925471,MMW 13R,A05,958034,Staff,0,4,16,16
1746600926500,SIO 295LS,A00,894015,Staff,5,0,25,20
1746600927528,SIO 295S,A00,894020,Staff,5,0,25,20
1746600928562,SIOC 290S,B01,958918,Merrifield; Mark A,14,0,30,16
1746600929590,SIOC 291S,B01,958922,Gabriel; Corey John,14,0,30,16
1746600930617,SOCI 117,A01,895339,Staff,2,0,5,3
1746600931645,WES 237B,A00,894149,Staff,11,0,20,9
1746600933705,AESE 279B,A00,891859,Staff,13,0,35,22
1746600934731,AIP 197,001,891854,Vespa; Emanuel Ignacio,9999,0,9999,0
1746600935758,ANTH 289S,A00,891856,Gagneux; Pascal,12,0,12,0
1746600936823,BENG 196,001,957946,Engler; Adam J.,9996,0,9999,3
1746600937856,BISP 197,001,959851,Wilhelm; James E.,9998,0,9999,1
1746600938883,CAT 124RS,A01,956906,Staff,6,0,25,19
1746600939910,CAT 125RS,A01,922013,Staff,6,0,25,19
1746600940936,CLRE 250,A00,891860,Morris; Sheldon,9995,0,9999,4
1746600942993,CLRE 251R,A00,907817,Mehta; Ravindra L.,9994,0,9999,5
1746600944019,CLRE 252,A00,891864,Cuomo; Raphael Eduardo,9993,0,9999,6
1746600945043,CLRE 253,A00,891867,Vaida; Florin,9994,0,9999,5
1746600945043,CLRE 253,B00,907819,Staff,9999,0,9999,0
1746600946070,CLRE 259,A00,891868,Patel; Hemal,9998,0,9999,1
1746600947099,CLRE 260,A00,891872,Cuomo; Raphael Eduardo,9999,0,9999,0
1746600948128,CLRE 297,001,891888,Cuomo; Raphael Eduardo,9999,0,9999,0
1746600949153,CSE 191,A00,958773,Minnes Kemp; Mor Mia,9995,0,9999,4
1746600950179,CSE 197,001,959846,Minnes Kemp; Mor Mia,9990,0,9999,9
1746600951204,CSS 201S,A01,892054,Mignozzetti; Umberto,25,0,30,5
1746600952232,CSS 202S,A01,892056,Mignozzetti; Umberto,25,0,30,5
1746600953261,DSC 197,001,956898,Eldridge; Justin Matthew,9996,0,9999,3
1746600954287,DSC 297,001,958000,Mazumdar; Arya,9998,0,9999,1
1746600954287,DSC 297,002,959862,Wang; Yusu,9998,0,9999,1
1746600955314,EAP 100,A00,905686,Staff,9778,0,9999,221
1746600956339,ECE 45,A01,892618,Staff,0,0,65,65
1746600958396,ECE 111,A01,892719,Staff,6,0,65,59
1746600959425,ECE 197,001,957920,Mercier; Patrick Philip,9991,0,9999,8
1746600960454,ECON 178,A01,907814,Zhu; Ying,26,0,35,9
1746600961481,EDS 115,A00,895312,Staff,35,0,45,10
1746600962508,EDS 117,A01,895337,Staff,23,0,30,7
1746600963535,EDS 125,A00,895341,Jones; Gabrielle Anastasia,36,0,45,9
1746600964562,EDS 128A,A01,895459,Fargason; Sharon Gayle,44,0,45,1
1746600965593,EDS 128B,A01,895543,Pappas; Elizabeth,44,0,45,1
1746600966620,EDS 139,A00,897203,Pappas; Elizabeth,44,0,45,1
1746600966620,EDS 139,B00,897209,Fargason; Sharon Gayle,41,0,45,4
1746600967647,EDS 201,A00,895545,Staff,22,0,45,23
1746600968674,EDS 203,A01,895581,Halter; Christopher P.,22,0,45,23
1746600969702,EDS 204R,A01,895625,Heinzman; Erica M.,39,0,45,6
1746600969702,EDS 204R,B01,895693,Halter; Christopher P.,10,0,45,35
1746600970731,EDS 206R,A00,895694,Fargason; Sharon Gayle,1,0,30,29
1746600970731,EDS 206R,B00,895695,Choi; Bailey Miyeon,16,0,30,14
1746600971758,EDS 250,A00,895697,Hemans; Patricia Ann Benitez,22,0,45,23
1746600972784,EDS 281,A00,895701,Meyerott; Theresa Ann,1,0,15,14
1746600973812,EDS 284,A00,895736,Meyerott; Theresa Ann,1,0,15,14
1746600974838,EDS 286,A00,897210,Fine; Sarah,0,0,15,15
1746600975862,EDS 289C,A01,895770,Daly; Alan J.,1,0,15,14
1746600976891,EDS 290,A00,897211,Hofstetter; Carolyn,0,0,15,15
1746600977921,LIGM 5A,A00,896162,Fischer-Grunski; Eva K,12,0,20,8
1746600978947,LIGM 5B,A00,896260,Fischer-Grunski; Eva K,17,0,20,3
1746600979975,LIGM 5C,A00,896308,Fischer-Grunski; Eva K,18,0,20,2
1746600981002,LIIT 5AS,A00,896313,Carnelos; Chiara,18,0,20,2
1746600982028,LIIT 5BS,A00,896416,Carnelos; Chiara,20,0,20,0
1746600983057,LIIT 5CS,A00,896564,Carnelos; Chiara,20,0,20,0
1746600984087,LISP 5A,A00,896588,Munoz Sanchez; Alicia,2,0,20,18
1746600985111,LISP 5B,A00,896653,Munoz Sanchez; Alicia,7,0,20,13
1746600986139,LISP 5C,A00,896655,Munoz Sanchez; Alicia,0,1,20,20
1746600987165,MAE 197,001,957918,Kleissl; Jan,9996,0,9999,3
1746600987165,MAE 197,002,959806,Boechler; Nicholas Sebastia,9998,0,9999,1
1746600987165,MAE 197,003,959852,Mullin; Jennifer S,9998,0,9999,1
1746600988191,MATH 2,A01,957937,Staff,33,0,35,2
1746600989221,MATH 197,001,957876,Kedlaya; Kiran S.,9993,0,9999,6
1746600990247,MCWP 40,A00,892729,Duru; Nur,10,0,20,10
1746600990247,MCWP 40,B00,893304,Montejo; Carolina,14,0,20,6
1746600991278,MCWP 40R,A00,893757,Redela; Pamela Morgan,0,5,20,20
1746600992303,MCWP 50,A00,893758,Morshed; Michael James,0,0,20,20
1746600992303,MCWP 50,B00,893761,Bartulis; Jason Michael,17,0,20,3
1746600993339,MCWP 50R,A00,893766,Compas; Sean Matthew,0,1,20,20
1746600993339,MCWP 50R,B00,893769,Carter; Jennifer A,0,1,20,20
1746600993339,MCWP 50R,C00,893771,Krone; Jarret,0,3,20,20
1746600993339,MCWP 50R,D00,893772,Miller; Elizabeth Deen,0,0,20,20
1746600993339,MCWP 50R,E00,893775,Carter; Andrea L,0,1,20,20
1746600994367,MMW 11R,A01,892721,Herbst; Matthew,14,0,30,16
1746600994367,MMW 11R,A02,892722,Herbst; Matthew,0,0,0,3
1746600995396,MMW 12R,A01,892724,Herbst; Matthew,0,11,16,16
1746600995396,MMW 12R,A02,892725,Herbst; Matthew,0,10,16,16
1746600996424,MMW 13R,A01,892727,Staff,0,4,16,16
1746600996424,MMW 13R,A02,892728,Staff,0,4,16,16
1746600996424,MMW 13R,A03,958032,Staff,0,4,16,16
1746600996424,MMW 13R,A04,958033,Staff,0,4,16,16
1746600996424,MMW 13R,A05,958034,Staff,0,4,16,16
1746600997449,SIO 295LS,A00,894015,Staff,5,0,25,20
1746600998474,SIO 295S,A00,894020,Staff,5,0,25,20
1746600999498,SIOC 290S,B01,958918,Merrifield; Mark A,14,0,30,16
1746601000530,SIOC 291S,B01,958922,Gabriel; Corey John,14,0,30,16
1746601001555,SOCI 117,A01,895339,Staff,2,0,5,3
1746601002581,WES 237B,A00,894149,Staff,11,0,20,9
1746601004646,AESE 279B,A00,891859,Staff,13,0,35,22
1746601005671,AIP 197,001,891854,Vespa; Emanuel Ignacio,9999,0,9999,0
1746601006696,ANTH 289S,A00,891856,Gagneux; Pascal,12,0,12,0
1746601007722,BENG 196,001,957946,Engler; Adam J.,9996,0,9999,3
1746601008751,BISP 197,001,959851,Wilhelm; James E.,9998,0,9999,1
1746601009776,CAT 124RS,A01,956906,Staff,6,0,25,19
1746601010799,CAT 125RS,A01,922013,Staff,6,0,25,19
1746601011825,CLRE 250,A00,891860,Morris; Sheldon,9995,0,9999,4
1746601013879,CLRE 251R,A00,907817,Mehta; Ravindra L.,9994,0,9999,5
1746601014905,CLRE 252,A00,891864,Cuomo; Raphael Eduardo,9993,0,9999,6
1746601015934,CLRE 253,A00,891867,Vaida; Florin,9994,0,9999,5
1746601015934,CLRE 253,B00,907819,Staff,9999,0,9999,0
1746601016960,CLRE 259,A00,891868,Patel; Hemal,9998,0,9999,1
1746601017987,CLRE 260,A00,891872,Cuomo; Raphael Eduardo,9999,0,9999,0
1746601019051,CLRE 297,001,891888,Cuomo; Raphael Eduardo,9999,0,9999,0
1746601020078,CSE 191,A00,958773,Minnes Kemp; Mor Mia,9995,0,9999,4
1746601021106,CSE 197,001,959846,Minnes Kemp; Mor Mia,9990,0,9999,9
1746601022135,CSS 201S,A01,892054,Mignozzetti; Umberto,25,0,30,5
1746601023166,CSS 202S,A01,892056,Mignozzetti; Umberto,25,0,30,5
1746601024191,DSC 197,001,956898,Eldridge; Justin Matthew,9996,0,9999,3
1746601025218,DSC 297,001,958000,Mazumdar; Arya,9998,0,9999,1
1746601025218,DSC 297,002,959862,Wang; Yusu,9998,0,9999,1
1746601026246,EAP 100,A00,905686,Staff,9778,0,9999,221
1746601027276,ECE 45,A01,892618,Staff,0,0,65,65
1746601029329,ECE 111,A01,892719,Staff,6,0,65,59
1746601030354,ECE 197,001,957920,Mercier; Patrick Philip,9991,0,9999,8
1746601031383,ECON 178,A01,907814,Zhu; Ying,26,0,35,9
1746601032408,EDS 115,A00,895312,Staff,35,0,45,10
1746601033432,EDS 117,A01,895337,Staff,23,0,30,7
1746601034457,EDS 125,A00,895341,Jones; Gabrielle Anastasia,36,0,45,9
1746601035483,EDS 128A,A01,895459,Fargason; Sharon Gayle,44,0,45,1
1746601036507,EDS 128B,A01,895543,Pappas; Elizabeth,44,0,45,1
1746601037532,EDS 139,A00,897203,Pappas; Elizabeth,44,0,45,1
1746601037532,EDS 139,B00,897209,Fargason; Sharon Gayle,41,0,45,4
1746601038557,EDS 201,A00,895545,Staff,22,0,45,23
1746601039586,EDS 203,A01,895581,Halter; Christopher P.,22,0,45,23
1746601040621,EDS 204R,A01,895625,Heinzman; Erica M.,39,0,45,6
1746601040621,EDS 204R,B01,895693,Halter; Christopher P.,10,0,45,35
1746601041647,EDS 206R,A00,895694,Fargason; Sharon Gayle,1,0,30,29
1746601041647,EDS 206R,B00,895695,Choi; Bailey Miyeon,16,0,30,14
1746601042676,EDS 250,A00,895697,Hemans; Patricia Ann Benitez,22,0,45,23
1746601043704,EDS 281,A00,895701,Meyerott; Theresa Ann,1,0,15,14
1746601044734,EDS 284,A00,895736,Meyerott; Theresa Ann,1,0,15,14
1746601045761,EDS 286,A00,897210,Fine; Sarah,0,0,15,15
1746601046788,EDS 289C,A01,895770,Daly; Alan J.,1,0,15,14
1746601047815,EDS 290,A00,897211,Hofstetter; Carolyn,0,0,15,15
1746601048841,LIGM 5A,A00,896162,Fischer-Grunski; Eva K,12,0,20,8
1746601049868,LIGM 5B,A00,896260,Fischer-Grunski; Eva K,17,0,20,3
1746601050894,LIGM 5C,A00,896308,Fischer-Grunski; Eva K,18,0,20,2
1746601051920,LIIT 5AS,A00,896313,Carnelos; Chiara,18,0,20,2
1746601052949,LIIT 5BS,A00,896416,Carnelos; Chiara,20,0,20,0
1746601053974,LIIT 5CS,A00,896564,Carnelos; Chiara,20,0,20,0
1746601055000,LISP 5A,A00,896588,Munoz Sanchez; Alicia,2,0,20,18
1746601056026,LISP 5B,A00,896653,Munoz Sanchez; Alicia,7,0,20,13
1746601057055,LISP 5C,A00,896655,Munoz Sanchez; Alicia,0,1,20,20
1746601058081,MAE 197,001,957918,Kleissl; Jan,9996,0,9999,3
1746601058081,MAE 197,002,959806,Boechler; Nicholas Sebastia,9998,0,9999,1
1746601058081,MAE 197,003,959852,Mullin; Jennifer S,9998,0,9999,1
1746601059110,MATH 2,A01,957937,Staff,33,0,35,2
1746601060135,MATH 197,001,957876,Kedlaya; Kiran S.,9993,0,9999,6
1746601061165,MCWP 40,A00,892729,Duru; Nur,10,0,20,10
1746601061165,MCWP 40,B00,893304,Montejo; Carolina,14,0,20,6
1746601062191,MCWP 40R,A00,893757,Redela; Pamela Morgan,0,5,20,20
1746601063220,MCWP 50,A00,893758,Morshed; Michael James,0,0,20,20
1746601063220,MCWP 50,B00,893761,Bartulis; Jason Michael,17,0,20,3
1746601064252,MCWP 50R,A00,893766,Compas; Sean Matthew,0,1,20,20
1746601064252,MCWP 50R,B00,893769,Carter; Jennifer A,0,1,20,20
1746601064252,MCWP 50R,C00,893771,Krone; Jarret,0,3,20,20
1746601064252,MCWP 50R,D00,893772,Miller; Elizabeth Deen,0,0,20,20
1746601064252,MCWP 50R,E00,893775,Carter; Andrea L,0,1,20,20
1746601065278,MMW 11R,A01,892721,Herbst; Matthew,14,0,30,16
1746601065278,MMW 11R,A02,892722,Herbst; Matthew,0,0,0,3
1746601066314,MMW 12R,A01,892724,Herbst; Matthew,0,11,16,16
1746601066314,MMW 12R,A02,892725,Herbst; Matthew,0,10,16,16
1746601067341,MMW 13R,A01,892727,Staff,0,4,16,16
1746601067341,MMW 13R,A02,892728,Staff,0,4,16,16
1746601067341,MMW 13R,A03,958032,Staff,0,4,16,16
1746601067341,MMW 13R,A04,958033,Staff,0,4,16,16
1746601067341,MMW 13R,A05,958034,Staff,0,4,16,16
1746601068368,SIO 295LS,A00,894015,Staff,5,0,25,20
1746601069397,SIO 295S,A00,894020,Staff,5,0,25,20
1746601070426,SIOC 290S,B01,958918,Merrifield; Mark A,14,0,30,16
1746601071458,SIOC 291S,B01,958922,Gabriel; Corey John,14,0,30,16
1746601072481,SOCI 117,A01,895339,Staff,2,0,5,3
1746601073508,WES 237B,A00,894149,Staff,11,0,20,9
1746601075563,AESE 279B,A00,891859,Staff,13,0,35,22
1746601076588,AIP 197,001,891854,Vespa; Emanuel Ignacio,9999,0,9999,0
1746601077613,ANTH 289S,A00,891856,Gagneux; Pascal,12,0,12,0
1746601078641,BENG 196,001,957946,Engler; Adam J.,9996,0,9999,3
1746601079666,BISP 197,001,959851,Wilhelm; James E.,9998,0,9999,1
1746601080692,CAT 124RS,A01,956906,Staff,6,0,25,19
1746601081718,CAT 125RS,A01,922013,Staff,6,0,25,19
1746601082744,CLRE 250,A00,891860,Morris; Sheldon,9995,0,9999,4
1746601084796,CLRE 251R,A00,907817,Mehta; Ravindra L.,9994,0,9999,5
1746601085822,CLRE 252,A00,891864,Cuomo; Raphael Eduardo,9993,0,9999,6
1746601086848,CLRE 253,A00,891867,Vaida; Florin,9994,0,9999,5
1746601086848,CLRE 253,B00,907819,Staff,9999,0,9999,0
1746601087872,CLRE 259,A00,891868,Patel; Hemal,9998,0,9999,1
1746601088898,CLRE 260,A00,891872,Cuomo; Raphael Eduardo,9999,0,9999,0
1746601089926,CLRE 297,001,891888,Cuomo; Raphael Eduardo,9999,0,9999,0
1746601090951,CSE 191,A00,958773,Minnes Kemp; Mor Mia,9995,0,9999,4
1746601091977,CSE 197,001,959846,Minnes Kemp; Mor Mia,9990,0,9999,9
1746601093004,CSS 201S,A01,892054,Mignozzetti; Umberto,25,0,30,5
1746601094030,CSS 202S,A01,892056,Mignozzetti; Umberto,25,0,30,5
1746601095058,DSC 197,001,956898,Eldridge; Justin Matthew,9996,0,9999,3
1746601096083,DSC 297,001,958000,Mazumdar; Arya,9998,0,9999,1
1746601096083,DSC 297,002,959862,Wang; Yusu,9998,0,9999,1
1746601097110,EAP 100,A00,905686,Staff,9778,0,9999,221
1746601098139,ECE 45,A01,892618,Staff,0,0,65,65
1746601100189,ECE 111,A01,892719,Staff,6,0,65,59
1746601101215,ECE 197,001,957920,Mercier; Patrick Philip,9991,0,9999,8
1746601102240,ECON 178,A01,907814,Zhu; Ying,26,0,35,9
1746601103267,EDS 115,A00,895312,Staff,35,0,45,10
1746601104292,EDS 117,A01,895337,Staff,23,0,30,7
1746601105317,EDS 125,A00,895341,Jones; Gabrielle Anastasia,36,0,45,9
1746601106343,EDS 128A,A01,895459,Fargason; Sharon Gayle,44,0,45,1
1746601107373,EDS 128B,A01,895543,Pappas; Elizabeth,44,0,45,1
1746601108398,EDS 139,A00,897203,Pappas; Elizabeth,44,0,45,1
1746601108398,EDS 139,B00,897209,Fargason; Sharon Gayle,41,0,45,4
1746601109424,EDS 201,A00,895545,Staff,22,0,45,23
1746601110453,EDS 203,A01,895581,Halter; Christopher P.,22,0,45,23
1746601111482,EDS 204R,A01,895625,Heinzman; Erica M.,39,0,45,6
1746601111482,EDS 204R,B01,895693,Halter; Christopher P.,10,0,45,35
1746601112513,EDS 206R,A00,895694,Fargason; Sharon Gayle,1,0,30,29
1746601112513,EDS 206R,B00,895695,Choi; Bailey Miyeon,16,0,30,14
1746601113537,EDS 250,A00,895697,Hemans; Patricia Ann Benitez,22,0,45,23
1746601114564,EDS 281,A00,895701,Meyerott; Theresa Ann,1,0,15,14
1746601115594,EDS 284,A00,895736,Meyerott; Theresa Ann,1,0,15,14
1746601116621,EDS 286,A00,897210,Fine; Sarah,0,0,15,15
1746601117651,EDS 289C,A01,895770,Daly; Alan J.,1,0,15,14
1746601118678,EDS 290,A00,897211,Hofstetter; Carolyn,0,0,15,15
1746601119707,LIGM 5A,A00,896162,Fischer-Grunski; Eva K,12,0,20,8
1746601120736,LIGM 5B,A00,896260,Fischer-Grunski; Eva K,17,0,20,3
1746601121762,LIGM 5C,A00,896308,Fischer-Grunski; Eva K,18,0,20,2
1746601122832,LIIT 5AS,A00,896313,Carnelos; Chiara,18,0,20,2
1746601123860,LIIT 5BS,A00,896416,Carnelos; Chiara,20,0,20,0
1746601124887,LIIT 5CS,A00,896564,Carnelos; Chiara,20,0,20,0
1746601125916,LISP 5A,A00,896588,Munoz Sanchez; Alicia,2,0,20,18
1746601126943,LISP 5B,A00,896653,Munoz Sanchez; Alicia,7,0,20,13
1746601127968,LISP 5C,A00,896655,Munoz Sanchez; Alicia,0,1,20,20
1746601128995,MAE 197,001,957918,Kleissl; Jan,9996,0,9999,3
1746601128995,MAE 197,002,959806,Boechler; Nicholas Sebastia,9998,0,9999,1
1746601128995,MAE 197,003,959852,Mullin; Jennifer S,9998,0,9999,1
1746601130026,MATH 2,A01,957937,Staff,33,0,35,2
1746601131052,MATH 197,001,957876,Kedlaya; Kiran S.,9993,0,9999,6
1746601132078,MCWP 40,A00,892729,Duru; Nur,10,0,20,10
1746601132078,MCWP 40,B00,893304,Montejo; Carolina,14,0,20,6
1746601133109,MCWP 40R,A00,893757,Redela; Pamela Morgan,0,5,20,20
1746601134137,MCWP 50,A00,893758,Morshed; Michael James,0,0,20,20
1746601134137,MCWP 50,B00,893761,Bartulis; Jason Michael,17,0,20,3
1746601135162,MCWP 50R,A00,893766,Compas; Sean Matthew,0,1,20,20
1746601135162,MCWP 50R,B00,893769,Carter; Jennifer A,0,1,20,20
1746601135162,MCWP 50R,C00,893771,Krone; Jarret,0,3,20,20
1746601135162,MCWP 50R,D00,893772,Miller; Elizabeth Deen,0,0,20,20
1746601135162,MCWP 50R,E00,893775,Carter; Andrea L,0,1,20,20
1746601136188,MMW 11R,A01,892721,Herbst; Matthew,14,0,30,16
1746601136188,MMW 11R,A02,892722,Herbst; Matthew,0,0,0,3
1746601137215,MMW 12R,A01,892724,Herbst; Matthew,0,11,16,16
1746601137215,MMW 12R,A02,892725,Herbst; Matthew,0,10,16,16
1746601138242,MMW 13R,A01,892727,Staff,0,4,16,16
1746601138242,MMW 13R,A02,892728,Staff,0,4,16,16
1746601138242,MMW 13R,A03,958032,Staff,0,4,16,16
1746601138242,MMW 13R,A04,958033,Staff,0,4,16,16
1746601138242,MMW 13R,A05,958034,Staff,0,4,16,16
1746601139268,SIO 295LS,A00,894015,Staff,5,0,25,20
1746601140293,SIO 295S,A00,894020,Staff,5,0,25,20
1746601141319,SIOC 290S,B01,958918,Merrifield; Mark A,14,0,30,16
1746601142349,SIOC 291S,B01,958922,Gabriel; Corey John,14,0,30,16
1746601143377,SOCI 117,A01,895339,Staff,2,0,5,3
1746601144404,WES 237B,A00,894149,Staff,11,0,20,9
1746601146466,AESE 279B,A00,891859,Staff,13,0,35,22
1746601147491,AIP 197,001,891854,Vespa; Emanuel Ignacio,9999,0,9999,0
1746601148516,ANTH 289S,A00,891856,Gagneux; Pascal,12,0,12,0
1746601149542,BENG 196,001,957946,Engler; Adam J.,9996,0,9999,3
1746601150570,BISP 197,001,959851,Wilhelm; James E.,9998,0,9999,1
1746601151597,CAT 124RS,A01,956906,Staff,6,0,25,19
1746601152622,CAT 125RS,A01,922013,Staff,6,0,25,19
1746601153647,CLRE 250,A00,891860,Morris; Sheldon,9995,0,9999,4
1746601155704,CLRE 251R,A00,907817,Mehta; Ravindra L.,9994,0,9999,5
1746601156729,CLRE 252,A00,891864,Cuomo; Raphael Eduardo,9993,0,9999,6
1746601157755,CLRE 253,A00,891867,Vaida; Florin,9994,0,9999,5
1746601157755,CLRE 253,B00,907819,Staff,9999,0,9999,0
1746601158784,CLRE 259,A00,891868,Patel; Hemal,9998,0,9999,1
1746601159808,CLRE 260,A00,891872,Cuomo; Raphael Eduardo,9999,0,9999,0
1746601160835,CLRE 297,001,891888,Cuomo; Raphael Eduardo,9999,0,9999,0
1746601161861,CSE 191,A00,958773,Minnes Kemp; Mor Mia,9995,0,9999,4
1746601162886,CSE 197,001,959846,Minnes Kemp; Mor Mia,9990,0,9999,9
1746601163918,CSS 201S,A01,892054,Mignozzetti; Umberto,25,0,30,5
1746601164949,CSS 202S,A01,892056,Mignozzetti; Umberto,25,0,30,5
1746601165978,DSC 197,001,956898,Eldridge; Justin Matthew,9996,0,9999,3
1746601167004,DSC 297,001,958000,Mazumdar; Arya,9998,0,9999,1
1746601167004,DSC 297,002,959862,Wang; Yusu,9998,0,9999,1
1746601168031,EAP 100,A00,905686,Staff,9778,0,9999,221
1746601169059,ECE 45,A01,892618,Staff,0,0,65,65
1746601171111,ECE 111,A01,892719,Staff,6,0,65,59
1746601172136,ECE 197,001,957920,Mercier; Patrick Philip,9991,0,9999,8
1746601173163,ECON 178,A01,907814,Zhu; Ying,26,0,35,9
1746601174188,EDS 115,A00,895312,Staff,35,0,45,10
1746601175215,EDS 117,A01,895337,Staff,23,0,30,7
1746601176239,EDS 125,A00,895341,Jones; Gabrielle Anastasia,36,0,45,9
1746601177265,EDS 128A,A01,895459,Fargason; Sharon Gayle,44,0,45,1
1746601178293,EDS 128B,A01,895543,Pappas; Elizabeth,44,0,45,1
1746601179323,EDS 139,A00,897203,Pappas; Elizabeth,44,0,45,1
1746601179323,EDS 139,B00,897209,Fargason; Sharon Gayle,41,0,45,4
1746601180348,EDS 201,A00,895545,Staff,22,0,45,23
1746601181375,EDS 203,A01,895581,Halter; Christopher P.,22,0,45,23
1746601182401,EDS 204R,A01,895625,Heinzman; Erica M.,39,0,45,6
1746601182401,EDS 204R,B01,895693,Halter; Christopher P.,10,0,45,35
1746601183428,EDS 206R,A00,895694,Fargason; Sharon Gayle,1,0,30,29
1746601183428,EDS 206R,B00,895695,Choi; Bailey Miyeon,16,0,30,14
1746601184454,EDS 250,A00,895697,Hemans; Patricia Ann Benitez,22,0,45,23
1746601185480,EDS 281,A00,895701,Meyerott; Theresa Ann,1,0,15,14
1746601186508,EDS 284,A00,895736,Meyerott; Theresa Ann,1,0,15,14
1746601187532,EDS 286,A00,897210,Fine; Sarah,0,0,15,15
1746601188559,EDS 289C,A01,895770,Daly; Alan J.,1,0,15,14
1746601189588,EDS 290,A00,897211,Hofstetter; Carolyn,0,0,15,15
1746601190615,LIGM 5A,A00,896162,Fischer-Grunski; Eva K,12,0,20,8
1746601191644,LIGM 5B,A00,896260,Fischer-Grunski; Eva K,17,0,20,3
1746601192673,LIGM 5C,A00,896308,Fischer-Grunski; Eva K,18,0,20,2
1746601193700,LIIT 5AS,A00,896313,Carnelos; Chiara,18,0,20,2
1746601194727,LIIT 5BS,A00,896416,Carnelos; Chiara,20,0,20,0
1746601195755,LIIT 5CS,A00,896564,Carnelos; Chiara,20,0,20,0
1746601196781,LISP 5A,A00,896588,Munoz Sanchez; Alicia,2,0,20,18
1746601197808,LISP 5B,A00,896653,Munoz Sanchez; Alicia,7,0,20,13
1746601198838,LISP 5C,A00,896655,Munoz Sanchez; Alicia,0,1,20,20
1746601199864,MAE 197,001,957918,Kleissl; Jan,9996,0,9999,3
1746601199864,MAE 197,002,959806,Boechler; Nicholas Sebastia,9998,0,9999,1
1746601199864,MAE 197,003,959852,Mullin; Jennifer S,9998,0,9999,1
1746601200891,MATH 2,A01,957937,Staff,33,0,35,2
1746601201916,MATH 197,001,957876,Kedlaya; Kiran S.,9993,0,9999,6
1746601202942,MCWP 40,A00,892729,Duru; Nur,10,0,20,10
1746601202942,MCWP 40,B00,893304,Montejo; Carolina,14,0,20,6
1746601203970,MCWP 40R,A00,893757,Redela; Pamela Morgan,0,5,20,20
1746601204996,MCWP 50,A00,893758,Morshed; Michael James,0,0,20,20
1746601204996,MCWP 50,B00,893761,Bartulis; Jason Michael,17,0,20,3
1746601206025,MCWP 50R,A00,893766,Compas; Sean Matthew,0,1,20,20
1746601206025,MCWP 50R,B00,893769,Carter; Jennifer A,0,1,20,20
1746601206025,MCWP 50R,C00,893771,Krone; Jarret,0,3,20,20
1746601206025,MCWP 50R,D00,893772,Miller; Elizabeth Deen,0,0,20,20
1746601206025,MCWP 50R,E00,893775,Carter; Andrea L,0,1,20,20
1746601207052,MMW 11R,A01,892721,Herbst; Matthew,14,0,30,16
1746601207052,MMW 11R,A02,892722,Herbst; Matthew,0,0,0,3
1746601208082,MMW 12R,A01,892724,Herbst; Matthew,0,11,16,16
1746601208082,MMW 12R,A02,892725,Herbst; Matthew,0,10,16,16
1746601209109,MMW 13R,A01,892727,Staff,0,4,16,16
1746601209109,MMW 13R,A02,892728,Staff,0,4,16,16
1746601209109,MMW 13R,A03,958032,Staff,0,4,16,16
1746601209109,MMW 13R,A04,958033,Staff,0,4,16,16
1746601209109,MMW 13R,A05,958034,Staff,0,4,16,16
1746601210140,SIO 295LS,A00,894015,Staff,5,0,25,20
1746601211168,SIO 295S,A00,894020,Staff,5,0,25,20
1746601212199,SIOC 290S,B01,958918,Merrifield; Mark A,14,0,30,16
1746601213225,SIOC 291S,B01,958922,Gabriel; Corey John,14,0,30,16
1746601214251,SOCI 117,A01,895339,Staff,2,0,5,3
1746601215280,WES 237B,A00,894149,Staff,11,0,20,9
1746601217351,AESE 279B,A00,891859,Staff,13,0,35,22
1746601218377,AIP 197,001,891854,Vespa; Emanuel Ignacio,9999,0,9999,0
1746601219404,ANTH 289S,A00,891856,Gagneux; Pascal,12,0,12,0
1746601220434,BENG 196,001,957946,Engler; Adam J.,9996,0,9999,3
1746601221463,BISP 197,001,959851,Wilhelm; James E.,9998,0,9999,1
1746601222488,CAT 124RS,A01,956906,Staff,6,0,25,19
1746601223515,CAT 125RS,A01,922013,Staff,6,0,25,19
1746601224545,CLRE 250,A00,891860,Morris; Sheldon,9995,0,9999,4
1746601226652,CLRE 251R,A00,907817,Mehta; Ravindra L.,9994,0,9999,5
1746601227681,CLRE 252,A00,891864,Cuomo; Raphael Eduardo,9993,0,9999,6
1746601228707,CLRE 253,A00,891867,Vaida; Florin,9994,0,9999,5
1746601228707,CLRE 253,B00,907819,Staff,9999,0,9999,0
1746601229731,CLRE 259,A00,891868,Patel; Hemal,9998,0,9999,1
1746601230757,CLRE 260,A00,891872,Cuomo; Raphael Eduardo,9999,0,9999,0
1746601231785,CLRE 297,001,891888,Cuomo; Raphael Eduardo,9999,0,9999,0
1746601232810,CSE 191,A00,958773,Minnes Kemp; Mor Mia,9995,0,9999,4
1746601233838,CSE 197,001,959846,Minnes Kemp; Mor Mia,9990,0,9999,9
1746601234864,CSS 201S,A01,892054,Mignozzetti; Umberto,25,0,30,5
1746601235890,CSS 202S,A01,892056,Mignozzetti; Umberto,25,0,30,5
1746601236918,DSC 197,001,956898,Eldridge; Justin Matthew,9996,0,9999,3
1746601237947,DSC 297,001,958000,Mazumdar; Arya,9998,0,9999,1
1746601237947,DSC 297,002,959862,Wang; Yusu,9998,0,9999,1
1746601238977,EAP 100,A00,905686,Staff,9778,0,9999,221
1746601240005,ECE 45,A01,892618,Staff,0,0,65,65
1746601242057,ECE 111,A01,892719,Staff,6,0,65,59
1746601243088,ECE 197,001,957920,Mercier; Patrick Philip,9991,0,9999,8
1746601244112,ECON 178,A01,907814,Zhu; Ying,26,0,35,9
1746601245142,EDS 115,A00,895312,Staff,35,0,45,10
1746601246167,EDS 117,A01,895337,Staff,23,0,30,7
1746601247195,EDS 125,A00,895341,Jones; Gabrielle Anastasia,36,0,45,9
1746601248221,EDS 128A,A01,895459,Fargason; Sharon Gayle,44,0,45,1
1746601249249,EDS 128B,A01,895543,Pappas; Elizabeth,44,0,45,1
1746601250279,EDS 139,A00,897203,Pappas; Elizabeth,44,0,45,1
1746601250279,EDS 139,B00,897209,Fargason; Sharon Gayle,41,0,45,4
1746601251306,EDS 201,A00,895545,Staff,22,0,45,23
1746601252331,EDS 203,A01,895581,Halter; Christopher P.,22,0,45,23
1746601253356,EDS 204R,A01,895625,Heinzman; Erica M.,39,0,45,6
1746601253356,EDS 204R,B01,895693,Halter; Christopher P.,10,0,45,35
1746601254385,EDS 206R,A00,895694,Fargason; Sharon Gayle,1,0,30,29
1746601254385,EDS 206R,B00,895695,Choi; Bailey Miyeon,16,0,30,14
1746601255410,EDS 250,A00,895697,Hemans; Patricia Ann Benitez,22,0,45,23
1746601256436,EDS 281,A00,895701,Meyerott; Theresa Ann,1,0,15,14
1746601257461,EDS 284,A00,895736,Meyerott; Theresa Ann,1,0,15,14
1746601258485,EDS 286,A00,897210,Fine; Sarah,0,0,15,15
1746601259537,EDS 289C,A01,895770,Daly; Alan J.,1,0,15,14
1746601260570,EDS 290,A00,897211,Hofstetter; Carolyn,0,0,15,15
1746601261596,LIGM 5A,A00,896162,Fischer-Grunski; Eva K,12,0,20,8
1746601262625,LIGM 5B,A00,896260,Fischer-Grunski; Eva K,17,0,20,3
1746601263658,LIGM 5C,A00,896308,Fischer-Grunski; Eva K,18,0,20,2
1746601264691,LIIT 5AS,A00,896313,Carnelos; Chiara,18,0,20,2
1746601265717,LIIT 5BS,A00,896416,Carnelos; Chiara,20,0,20,0
1746601266746,LIIT 5CS,A00,896564,Carnelos; Chiara,20,0,20,0
1746601267775,LISP 5A,A00,896588,Munoz Sanchez; Alicia,2,0,20,18
1746601268804,LISP 5B,A00,896653,Munoz Sanchez; Alicia,7,0,20,13
1746601269836,LISP 5C,A00,896655,Munoz Sanchez; Alicia,0,1,20,20
1746601270861,MAE 197,001,957918,Kleissl; Jan,9996,0,9999,3
1746601270861,MAE 197,002,959806,Boechler; Nicholas Sebastia,9998,0,9999,1
1746601270861,MAE 197,003,959852,Mullin; Jennifer S,9998,0,9999,1
1746601271892,MATH 2,A01,957937,Staff,33,0,35,2
1746601272919,MATH 197,001,957876,Kedlaya; Kiran S.,9993,0,9999,6
1746601273948,MCWP 40,A00,892729,Duru; Nur,10,0,20,10
1746601273948,MCWP 40,B00,893304,Montejo; Carolina,14,0,20,6
1746601274975,MCWP 40R,A00,893757,Redela; Pamela Morgan,0,5,20,20
1746601276003,MCWP 50,A00,893758,Morshed; Michael James,0,0,20,20
1746601276003,MCWP 50,B00,893761,Bartulis; Jason Michael,17,0,20,3
1746601277032,MCWP 50R,A00,893766,Compas; Sean Matthew,0,1,20,20
1746601277032,MCWP 50R,B00,893769,Carter; Jennifer A,0,1,20,20
1746601277032,MCWP 50R,C00,893771,Krone; Jarret,0,3,20,20
1746601277032,MCWP 50R,D00,893772,Miller; Elizabeth Deen,0,0,20,20
1746601277032,MCWP 50R,E00,893775,Carter; Andrea L,0,1,20,20
1746601278074,MMW 11R,A01,892721,Herbst; Matthew,14,0,30,16
1746601278074,MMW 11R,A02,892722,Herbst; Matthew,0,0,0,3
1746601279102,MMW 12R,A01,892724,Herbst; Matthew,0,11,16,16
1746601279102,MMW 12R,A02,892725,Herbst; Matthew,0,10,16,16
1746601280129,MMW 13R,A01,892727,Staff,0,4,16,16
1746601280129,MMW 13R,A02,892728,Staff,0,4,16,16
1746601280129,MMW 13R,A03,958032,Staff,0,4,16,16
1746601280129,MMW 13R,A04,958033,Staff,0,4,16,16
1746601280129,MMW 13R,A05,958034,Staff,0,4,16,16
1746601281220,SIO 295LS,A00,894015,Staff,5,0,25,20
1746601282245,SIO 295S,A00,894020,Staff,5,0,25,20
1746601283534,SIOC 290S,B01,958918,Merrifield; Mark A,14,0,30,16
1746601284562,SIOC 291S,B01,958922,Gabriel; Corey John,14,0,30,16
1746601285663,SOCI 117,A01,895339,Staff,2,0,5,3
1746601286793,WES 237B,A00,894149,Staff,11,0,20,9
1746601290355,AESE 279B,A00,891859,Staff,13,0,35,22
1746601291380,AIP 197,001,891854,Vespa; Emanuel Ignacio,9999,0,9999,0
1746601292408,ANTH 289S,A00,891856,Gagneux; Pascal,12,0,12,0
1746601293434,BENG 196,001,957946,Engler; Adam J.,9996,0,9999,3
1746601294462,BISP 197,001,959851,Wilhelm; James E.,9998,0,9999,1
1746601295719,CAT 124RS,A01,956906,Staff,6,0,25,19
1746601296751,CAT 125RS,A01,922013,Staff,6,0,25,19
1746601297778,CLRE 250,A00,891860,Morris; Sheldon,9995,0,9999,4
1746601299831,CLRE 251R,A00,907817,Mehta; Ravindra L.,9994,0,9999,5
1746601300865,CLRE 252,A00,891864,Cuomo; Raphael Eduardo,9993,0,9999,6
1746601301890,CLRE 253,A00,891867,Vaida; Florin,9994,0,9999,5
1746601301890,CLRE 253,B00,907819,Staff,9999,0,9999,0
1746601302916,CLRE 259,A00,891868,Patel; Hemal,9998,0,9999,1
1746601303944,CLRE 260,A00,891872,Cuomo; Raphael Eduardo,9999,0,9999,0
1746601304970,CLRE 297,001,891888,Cuomo; Raphael Eduardo,9999,0,9999,0
1746601306005,CSE 191,A00,958773,Minnes Kemp; Mor Mia,9995,0,9999,4
1746601307033,CSE 197,001,959846,Minnes Kemp; Mor Mia,9990,0,9999,9
1746601308064,CSS 201S,A01,892054,Mignozzetti; Umberto,25,0,30,5
1746601309098,CSS 202S,A01,892056,Mignozzetti; Umberto,25,0,30,5
1746601310128,DSC 197,001,956898,Eldridge; Justin Matthew,9996,0,9999,3
1746601311153,DSC 297,001,958000,Mazumdar; Arya,9998,0,9999,1
1746601311153,DSC 297,002,959862,Wang; Yusu,9998,0,9999,1
1746601312181,EAP 100,A00,905686,Staff,9778,0,9999,221
1746601313212,ECE 45,A01,892618,Staff,0,0,65,65
1746601315268,ECE 111,A01,892719,Staff,6,0,65,59
1746601316296,ECE 197,001,957920,Mercier; Patrick Philip,9991,0,9999,8
1746601317323,ECON 178,A01,907814,Zhu; Ying,26,0,35,9
1746601318350,EDS 115,A00,895312,Staff,35,0,45,10
1746601319375,EDS 117,A01,895337,Staff,23,0,30,7
1746601320405,EDS 125,A00,895341,Jones; Gabrielle Anastasia,36,0,45,9
1746601321436,EDS 128A,A01,895459,Fargason; Sharon Gayle,44,0,45,1
1746601322464,EDS 128B,A01,895543,Pappas; Elizabeth,44,0,45,1
1746601323491,EDS 139,A00,897203,Pappas; Elizabeth,44,0,45,1
1746601323491,EDS 139,B00,897209,Fargason; Sharon Gayle,41,0,45,4
1746601324525,EDS 201,A00,895545,Staff,22,0,45,23
1746601325551,EDS 203,A01,895581,Halter; Christopher P.,22,0,45,23
1746601326590,EDS 204R,A01,895625,Heinzman; Erica M.,39,0,45,6
1746601326590,EDS 204R,B01,895693,Halter; Christopher P.,10,0,45,35
1746601327614,EDS 206R,A00,895694,Fargason; Sharon Gayle,1,0,30,29
1746601327614,EDS 206R,B00,895695,Choi; Bailey Miyeon,16,0,30,14
1746601328640,EDS 250,A00,895697,Hemans; Patricia Ann Benitez,22,0,45,23
1746601329671,EDS 281,A00,895701,Meyerott; Theresa Ann,1,0,15,14
1746601330705,EDS 284,A00,895736,Meyerott; Theresa Ann,1,0,15,14
1746601331736,EDS 286,A00,897210,Fine; Sarah,0,0,15,15
1746601332763,EDS 289C,A01,895770,Daly; Alan J.,1,0,15,14
1746601333796,EDS 290,A00,897211,Hofstetter; Carolyn,0,0,15,15
1746601334823,LIGM 5A,A00,896162,Fischer-Grunski; Eva K,12,0,20,8
1746601335850,LIGM 5B,A00,896260,Fischer-Grunski; Eva K,17,0,20,3
1746601336881,LIGM 5C,A00,896308,Fischer-Grunski; Eva K,18,0,20,2
1746601337912,LIIT 5AS,A00,896313,Carnelos; Chiara,18,0,20,2
1746601338978,LIIT 5BS,A00,896416,Carnelos; Chiara,20,0,20,0
1746601340005,LIIT 5CS,A00,896564,Carnelos; Chiara,20,0,20,0
1746601341032,LISP 5A,A00,896588,Munoz Sanchez; Alicia,2,0,20,18
1746601342064,LISP 5B,A00,896653,Munoz Sanchez; Alicia,7,0,20,13
1746601343091,LISP 5C,A00,896655,Munoz Sanchez; Alicia,0,1,20,20
1746601344116,MAE 197,001,957918,Kleissl; Jan,9996,0,9999,3
1746601344116,MAE 197,002,959806,Boechler; Nicholas Sebastia,9998,0,9999,1
1746601344116,MAE 197,003,959852,Mullin; Jennifer S,9998,0,9999,1
1746601345147,MATH 2,A01,957937,Staff,33,0,35,2
1746601346170,MATH 197,001,957876,Kedlaya; Kiran S.,9993,0,9999,6
1746601347196,MCWP 40,A00,892729,Duru; Nur,10,0,20,10
1746601347196,MCWP 40,B00,893304,Montejo; Carolina,14,0,20,6
1746601348222,MCWP 40R,A00,893757,Redela; Pamela Morgan,0,5,20,20
1746601349251,MCWP 50,A00,893758,Morshed; Michael James,0,0,20,20
1746601349251,MCWP 50,B00,893761,Bartulis; Jason Michael,17,0,20,3
1746601350281,MCWP 50R,A00,893766,Compas; Sean Matthew,0,1,20,20
1746601350281,MCWP 50R,B00,893769,Carter; Jennifer A,0,1,20,20
1746601350281,MCWP 50R,C00,893771,Krone; Jarret,0,3,20,20
1746601350281,MCWP 50R,D00,893772,Miller; Elizabeth Deen,0,0,20,20
1746601350281,MCWP 50R,E00,893775,Carter; Andrea L,0,1,20,20
1746601351308,MMW 11R,A01,892721,Herbst; Matthew,14,0,30,16
1746601351308,MMW 11R,A02,892722,Herbst; Matthew,0,0,0,3
1746601352338,MMW 12R,A01,892724,Herbst; Matthew,0,11,16,16
1746601352338,MMW 12R,A02,892725,Herbst; Matthew,0,10,16,16
1746601353367,MMW 13R,A01,892727,Staff,0,4,16,16
1746601353367,MMW 13R,A02,892728,Staff,0,4,16,16
1746601353367,MMW 13R,A03,958032,Staff,0,4,16,16
1746601353367,MMW 13R,A04,958033,Staff,0,4,16,16
1746601353367,MMW 13R,A05,958034,Staff,0,4,16,16
1746601354391,SIO 295LS,A00,894015,Staff,5,0,25,20
1746601355418,SIO 295S,A00,894020,Staff,5,0,25,20
1746601356449,SIOC 290S,B01,958918,Merrifield; Mark A,14,0,30,16
1746601357481,SIOC 291S,B01,958922,Gabriel; Corey John,14,0,30,16
1746601358512,SOCI 117,A01,895339,Staff,2,0,5,3
1746601359539,WES 237B,A00,894149,Staff,11,0,20,9
1746601361617,AESE 279B,A00,891859,Staff,13,0,35,22
1746601362644,AIP 197,001,891854,Vespa; Emanuel Ignacio,9999,0,9999,0
1746601363673,ANTH 289S,A00,891856,Gagneux; Pascal,12,0,12,0
1746601364700,BENG 196,001,957946,Engler; Adam J.,9996,0,9999,3
1746601365728,BISP 197,001,959851,Wilhelm; James E.,9998,0,9999,1
1746601366757,CAT 124RS,A01,956906,Staff,6,0,25,19
1746601367782,CAT 125RS,A01,922013,Staff,6,0,25,19
1746601368808,CLRE 250,A00,891860,Morris; Sheldon,9995,0,9999,4
1746601370864,CLRE 251R,A00,907817,Mehta; Ravindra L.,9994,0,9999,5
1746601371894,CLRE 252,A00,891864,Cuomo; Raphael Eduardo,9993,0,9999,6
1746601372918,CLRE 253,A00,891867,Vaida; Florin,9994,0,9999,5
1746601372918,CLRE 253,B00,907819,Staff,9999,0,9999,0
1746601373946,CLRE 259,A00,891868,Patel; Hemal,9998,0,9999,1
1746601374973,CLRE 260,A00,891872,Cuomo; Raphael Eduardo,9999,0,9999,0
1746601375999,CLRE 297,001,891888,Cuomo; Raphael Eduardo,9999,0,9999,0
1746601377024,CSE 191,A00,958773,Minnes Kemp; Mor Mia,9995,0,9999,4
1746601378049,CSE 197,001,959846,Minnes Kemp; Mor Mia,9990,0,9999,9
1746601379075,CSS 201S,A01,892054,Mignozzetti; Umberto,25,0,30,5
1746601380115,CSS 202S,A01,892056,Mignozzetti; Umberto,25,0,30,5
1746601381146,DSC 197,001,956898,Eldridge; Justin Matthew,9996,0,9999,3
1746601382175,DSC 297,001,958000,Mazumdar; Arya,9998,0,9999,1
1746601382175,DSC 297,002,959862,Wang; Yusu,9998,0,9999,1
1746601383200,EAP 100,A00,905686,Staff,9778,0,9999,221
1746601384225,ECE 45,A01,892618,Staff,0,0,65,65
1746601386274,ECE 111,A01,892719,Staff,6,0,65,59
1746601387302,ECE 197,001,957920,Mercier; Patrick Philip,9991,0,9999,8
1746601388331,ECON 178,A01,907814,Zhu; Ying,26,0,35,9
1746601389361,EDS 115,A00,895312,Staff,35,0,45,10
1746601390390,EDS 117,A01,895337,Staff,23,0,30,7
1746601391420,EDS 125,A00,895341,Jones; Gabrielle Anastasia,36,0,45,9
1746601392454,EDS 128A,A01,895459,Fargason; Sharon Gayle,44,0,45,1
1746601393483,EDS 128B,A01,895543,Pappas; Elizabeth,44,0,45,1
1746601394510,EDS 139,A00,897203,Pappas; Elizabeth,44,0,45,1
1746601394510,EDS 139,B00,897209,Fargason; Sharon Gayle,41,0,45,4
1746601395537,EDS 201,A00,895545,Staff,22,0,45,23
1746601396562,EDS 203,A01,895581,Halter; Christopher P.,22,0,45,23
1746601397586,EDS 204R,A01,895625,Heinzman; Erica M.,39,0,45,6
1746601397586,EDS 204R,B01,895693,Halter; Christopher P.,10,0,45,35
1746601398616,EDS 206R,A00,895694,Fargason; Sharon Gayle,1,0,30,29
1746601398616,EDS 206R,B00,895695,Choi; Bailey Miyeon,16,0,30,14
1746601399641,EDS 250,A00,895697,Hemans; Patricia Ann Benitez,22,0,45,23
1746601400666,EDS 281,A00,895701,Meyerott; Theresa Ann,1,0,15,14
1746601401694,EDS 284,A00,895736,Meyerott; Theresa Ann,1,0,15,14
1746601402719,EDS 286,A00,897210,Fine; Sarah,0,0,15,15
1746601403747,EDS 289C,A01,895770,Daly; Alan J.,1,0,15,14
1746601404774,EDS 290,A00,897211,Hofstetter; Carolyn,0,0,15,15
1746601405801,LIGM 5A,A00,896162,Fischer-Grunski; Eva K,12,0,20,8
1746601406832,LIGM 5B,A00,896260,Fischer-Grunski; Eva K,17,0,20,3
1746601407862,LIGM 5C,A00,896308,Fischer-Grunski; Eva K,18,0,20,2
1746601408889,LIIT 5AS,A00,896313,Carnelos; Chiara,18,0,20,2
1746601409919,LIIT 5BS,A00,896416,Carnelos; Chiara,20,0,20,0
1746601410943,LIIT 5CS,A00,896564,Carnelos; Chiara,20,0,20,0
1746601411970,LISP 5A,A00,896588,Munoz Sanchez; Alicia,2,0,20,18
1746601412996,LISP 5B,A00,896653,Munoz Sanchez; Alicia,7,0,20,13
1746601414022,LISP 5C,A00,896655,Munoz Sanchez; Alicia,0,1,20,20
1746601415049,MAE 197,001,957918,Kleissl; Jan,9996,0,9999,3
1746601415049,MAE 197,002,959806,Boechler; Nicholas Sebastia,9998,0,9999,1
1746601415049,MAE 197,003,959852,Mullin; Jennifer S,9998,0,9999,1
1746601416080,MATH 2,A01,957937,Staff,33,0,35,2
1746601417105,MATH 197,001,957876,Kedlaya; Kiran S.,9993,0,9999,6
1746601418131,MCWP 40,A00,892729,Duru; Nur,10,0,20,10
1746601418131,MCWP 40,B00,893304,Montejo; Carolina,14,0,20,6
1746601419157,MCWP 40R,A00,893757,Redela; Pamela Morgan,0,5,20,20
1746601420187,MCWP 50,A00,893758,Morshed; Michael James,0,0,20,20
1746601420187,MCWP 50,B00,893761,Bartulis; Jason Michael,17,0,20,3
1746601421221,MCWP 50R,A00,893766,Compas; Sean Matthew,0,1,20,20
1746601421221,MCWP 50R,B00,893769,Carter; Jennifer A,0,1,20,20
1746601421221,MCWP 50R,C00,893771,Krone; Jarret,0,3,20,20
1746601421221,MCWP 50R,D00,893772,Miller; Elizabeth Deen,0,0,20,20
1746601421221,MCWP 50R,E00,893775,Carter; Andrea L,0,1,20,20
1746601422248,MMW 11R,A01,892721,Herbst; Matthew,14,0,30,16
1746601422248,MMW 11R,A02,892722,Herbst; Matthew,0,0,0,3
1746601423276,MMW 12R,A01,892724,Herbst; Matthew,0,11,16,16
1746601423276,MMW 12R,A02,892725,Herbst; Matthew,0,10,16,16
1746601424306,MMW 13R,A01,892727,Staff,0,4,16,16
1746601424306,MMW 13R,A02,892728,Staff,0,4,16,16
1746601424306,MMW 13R,A03,958032,Staff,0,4,16,16
1746601424306,MMW 13R,A04,958033,Staff,0,4,16,16
1746601424306,MMW 13R,A05,958034,Staff,0,4,16,16
1746601425330,SIO 295LS,A00,894015,Staff,5,0,25,20
1746601426357,SIO 295S,A00,894020,Staff,5,0,25,20
1746601427382,SIOC 290S,B01,958918,Merrifield; Mark A,14,0,30,16
1746601428409,SIOC 291S,B01,958922,Gabriel; Corey John,14,0,30,16
1746601429435,SOCI 117,A01,895339,Staff,2,0,5,3
1746601430462,WES 237B,A00,894149,Staff,11,0,20,9
1746601432526,AESE 279B,A00,891859,Staff,13,0,35,22
1746601433557,AIP 197,001,891854,Vespa; Emanuel Ignacio,9999,0,9999,0
1746601434586,ANTH 289S,A00,891856,Gagneux; Pascal,12,0,12,0
1746601435611,BENG 196,001,957946,Engler; Adam J.,9996,0,9999,3
1746601436637,BISP 197,001,959851,Wilhelm; James E.,9998,0,9999,1
1746601437663,CAT 124RS,A01,956906,Staff,6,0,25,19
1746601438689,CAT 125RS,A01,922013,Staff,6,0,25,19
1746601439715,CLRE 250,A00,891860,Morris; Sheldon,9995,0,9999,4
1746601441768,CLRE 251R,A00,907817,Mehta; Ravindra L.,9994,0,9999,5
1746601442796,CLRE 252,A00,891864,Cuomo; Raphael Eduardo,9993,0,9999,6
1746601443866,CLRE 253,A00,891867,Vaida; Florin,9994,0,9999,5
1746601443866,CLRE 253,B00,907819,Staff,9999,0,9999,0
1746601444892,CLRE 259,A00,891868,Patel; Hemal,9998,0,9999,1
1746601445919,CLRE 260,A00,891872,Cuomo; Raphael Eduardo,9999,0,9999,0
1746601446945,CLRE 297,001,891888,Cuomo; Raphael Eduardo,9999,0,9999,0
1746601447973,CSE 191,A00,958773,Minnes Kemp; Mor Mia,9995,0,9999,4
1746601449002,CSE 197,001,959846,Minnes Kemp; Mor Mia,9990,0,9999,9
1746601450028,CSS 201S,A01,892054,Mignozzetti; Umberto,25,0,30,5
1746601451052,CSS 202S,A01,892056,Mignozzetti; Umberto,25,0,30,5
1746601452080,DSC 197,001,956898,Eldridge; Justin Matthew,9996,0,9999,3
1746601453108,DSC 297,001,958000,Mazumdar; Arya,9998,0,9999,1
1746601453108,DSC 297,002,959862,Wang; Yusu,9998,0,9999,1
1746601454136,EAP 100,A00,905686,Staff,9778,0,9999,221
1746601455164,ECE 45,A01,892618,Staff,0,0,65,65
1746601457220,ECE 111,A01,892719,Staff,6,0,65,59
1746601458243,ECE 197,001,957920,Mercier; Patrick Philip,9991,0,9999,8
1746601459269,ECON 178,A01,907814,Zhu; Ying,26,0,35,9
1746601460295,EDS 115,A00,895312,Staff,35,0,45,10
1746601461321,EDS 117,A01,895337,Staff,23,0,30,7
1746601462346,EDS 125,A00,895341,Jones; Gabrielle Anastasia,36,0,45,9
1746601463382,EDS 128A,A01,895459,Fargason; Sharon Gayle,44,0,45,1
1746601464411,EDS 128B,A01,895543,Pappas; Elizabeth,44,0,45,1
1746601465435,EDS 139,A00,897203,Pappas; Elizabeth,44,0,45,1
1746601465435,EDS 139,B00,897209,Fargason; Sharon Gayle,41,0,45,4
1746601466463,EDS 201,A00,895545,Staff,22,0,45,23
1746601467487,EDS 203,A01,895581,Halter; Christopher P.,22,0,45,23
1746601468512,EDS 204R,A01,895625,Heinzman; Erica M.,39,0,45,6
1746601468512,EDS 204R,B01,895693,Halter; Christopher P.,10,0,45,35
1746601469541,EDS 206R,A00,895694,Fargason; Sharon Gayle,1,0,30,29
1746601469541,EDS 206R,B00,895695,Choi; Bailey Miyeon,16,0,30,14
1746601470568,EDS 250,A00,895697,Hemans; Patricia Ann Benitez,22,0,45,23
1746601471593,EDS 281,A00,895701,Meyerott; Theresa Ann,1,0,15,14
1746601472623,EDS 284,A00,895736,Meyerott; Theresa Ann,1,0,15,14
1746601473647,EDS 286,A00,897210,Fine; Sarah,0,0,15,15
1746601474672,EDS 289C,A01,895770,Daly; Alan J.,1,0,15,14
1746601475699,EDS 290,A00,897211,Hofstetter; Carolyn,0,0,15,15
1746601476730,LIGM 5A,A00,896162,Fischer-Grunski; Eva K,12,0,20,8
1746601477757,LIGM 5B,A00,896260,Fischer-Grunski; Eva K,17,0,20,3
1746601478781,LIGM 5C,A00,896308,Fischer-Grunski; Eva K,18,0,20,2
1746601479807,LIIT 5AS,A00,896313,Carnelos; Chiara,18,0,20,2
1746601480845,LIIT 5BS,A00,896416,Carnelos; Chiara,20,0,20,0
1746601481871,LIIT 5CS,A00,896564,Carnelos; Chiara,20,0,20,0
1746601482896,LISP 5A,A00,896588,Munoz Sanchez; Alicia,2,0,20,18
1746601483923,LISP 5B,A00,896653,Munoz Sanchez; Alicia,7,0,20,13
1746601484949,LISP 5C,A00,896655,Munoz Sanchez; Alicia,0,1,20,20
1746601485977,MAE 197,001,957918,Kleissl; Jan,9996,0,9999,3
1746601485977,MAE 197,002,959806,Boechler; Nicholas Sebastia,9998,0,9999,1
1746601485977,MAE 197,003,959852,Mullin; Jennifer S,9998,0,9999,1
1746601487002,MATH 2,A01,957937,Staff,33,0,35,2
1746601488027,MATH 197,001,957876,Kedlaya; Kiran S.,9993,0,9999,6
1746601489053,MCWP 40,A00,892729,Duru; Nur,10,0,20,10
1746601489053,MCWP 40,B00,893304,Montejo; Carolina,14,0,20,6
1746601490078,MCWP 40R,A00,893757,Redela; Pamela Morgan,0,5,20,20
1746601491107,MCWP 50,A00,893758,Morshed; Michael James,0,0,20,20
1746601491107,MCWP 50,B00,893761,Bartulis; Jason Michael,17,0,20,3
1746601492132,MCWP 50R,A00,893766,Compas; Sean Matthew,0,1,20,20
1746601492132,MCWP 50R,B00,893769,Carter; Jennifer A,0,1,20,20
1746601492132,MCWP 50R,C00,893771,Krone; Jarret,0,3,20,20
1746601492132,MCWP 50R,D00,893772,Miller; Elizabeth Deen,0,0,20,20
1746601492132,MCWP 50R,E00,893775,Carter; Andrea L,0,1,20,20
1746601493161,MMW 11R,A01,892721,Herbst; Matthew,14,0,30,16
1746601493161,MMW 11R,A02,892722,Herbst; Matthew,0,0,0,3
1746601494186,MMW 12R,A01,892724,Herbst; Matthew,0,11,16,16
1746601494186,MMW 12R,A02,892725,Herbst; Matthew,0,10,16,16
1746601495213,MMW 13R,A01,892727,Staff,0,4,16,16
1746601495213,MMW 13R,A02,892728,Staff,0,4,16,16
1746601495213,MMW 13R,A03,958032,Staff,0,4,16,16
1746601495213,MMW 13R,A04,958033,Staff,0,4,16,16
1746601495213,MMW 13R,A05,958034,Staff,0,4,16,16
1746601496240,SIO 295LS,A00,894015,Staff,5,0,25,20
1746601497268,SIO 295S,A00,894020,Staff,5,0,25,20
1746601498298,SIOC 290S,B01,958918,Merrifield; Mark A,14,0,30,16
1746601499325,SIOC 291S,B01,958922,Gabriel; Corey John,14,0,30,16
1746601500354,SOCI 117,A01,895339,Staff,2,0,5,3
1746601501380,WES 237B,A00,894149,Staff,11,0,20,9
1746601503454,AESE 279B,A00,891859,Staff,13,0,35,22
1746601504482,AIP 197,001,891854,Vespa; Emanuel Ignacio,9999,0,9999,0
1746601505508,ANTH 289S,A00,891856,Gagneux; Pascal,12,0,12,0
1746601506535,BENG 196,001,957946,Engler; Adam J.,9996,0,9999,3
1746601507563,BISP 197,001,959851,Wilhelm; James E.,9998,0,9999,1
1746601508590,CAT 124RS,A01,956906,Staff,6,0,25,19
1746601509616,CAT 125RS,A01,922013,Staff,6,0,25,19
1746601510643,CLRE 250,A00,891860,Morris; Sheldon,9995,0,9999,4
1746601512701,CLRE 251R,A00,907817,Mehta; Ravindra L.,9994,0,9999,5
1746601513728,CLRE 252,A00,891864,Cuomo; Raphael Eduardo,9993,0,9999,6
1746601514752,CLRE 253,A00,891867,Vaida; Florin,9994,0,9999,5
1746601514752,CLRE 253,B00,907819,Staff,9999,0,9999,0
1746601515849,CLRE 259,A00,891868,Patel; Hemal,9998,0,9999,1
1746601516878,CLRE 260,A00,891872,Cuomo; Raphael Eduardo,9999,0,9999,0
1746601517903,CLRE 297,001,891888,Cuomo; Raphael Eduardo,9999,0,9999,0
1746601518931,CSE 191,A00,958773,Minnes Kemp; Mor Mia,9995,0,9999,4
1746601519956,CSE 197,001,959846,Minnes Kemp; Mor Mia,9990,0,9999,9
1746601520981,CSS 201S,A01,892054,Mignozzetti; Umberto,25,0,30,5
1746601522007,CSS 202S,A01,892056,Mignozzetti; Umberto,25,0,30,5
1746601523036,DSC 197,001,956898,Eldridge; Justin Matthew,9996,0,9999,3
1746601524062,DSC 297,001,958000,Mazumdar; Arya,9998,0,9999,1
1746601524062,DSC 297,002,959862,Wang; Yusu,9998,0,9999,1
1746601525088,EAP 100,A00,905686,Staff,9778,0,9999,221
1746601526116,ECE 45,A01,892618,Staff,0,0,65,65
1746601528169,ECE 111,A01,892719,Staff,6,0,65,59
1746601529195,ECE 197,001,957920,Mercier; Patrick Philip,9991,0,9999,8
1746601530224,ECON 178,A01,907814,Zhu; Ying,26,0,35,9
1746601531250,EDS 115,A00,895312,Staff,35,0,45,10
1746601532279,EDS 117,A01,895337,Staff,23,0,30,7
1746601533305,EDS 125,A00,895341,Jones; Gabrielle Anastasia,36,0,45,9
1746601534332,EDS 128A,A01,895459,Fargason; Sharon Gayle,44,0,45,1
1746601535365,EDS 128B,A01,895543,Pappas; Elizabeth,44,0,45,1
1746601536390,EDS 139,A00,897203,Pappas; Elizabeth,44,0,45,1
1746601536390,EDS 139,B00,897209,Fargason; Sharon Gayle,41,0,45,4
1746601537417,EDS 201,A00,895545,Staff,22,0,45,23
1746601538442,EDS 203,A01,895581,Halter; Christopher P.,22,0,45,23
1746601539472,EDS 204R,A01,895625,Heinzman; Erica M.,39,0,45,6
1746601539472,EDS 204R,B01,895693,Halter; Christopher P.,10,0,45,35
1746601540500,EDS 206R,A00,895694,Fargason; Sharon Gayle,1,0,30,29
1746601540500,EDS 206R,B00,895695,Choi; Bailey Miyeon,16,0,30,14
1746601541528,EDS 250,A00,895697,Hemans; Patricia Ann Benitez,22,0,45,23
1746601542555,EDS 281,A00,895701,Meyerott; Theresa Ann,1,0,15,14
1746601543584,EDS 284,A00,895736,Meyerott; Theresa Ann,1,0,15,14
1746601544610,EDS 286,A00,897210,Fine; Sarah,0,0,15,15
1746601545635,EDS 289C,A01,895770,Daly; Alan J.,1,0,15,14
1746601546662,EDS 290,A00,897211,Hofstetter; Carolyn,0,0,15,15
1746601547689,LIGM 5A,A00,896162,Fischer-Grunski; Eva K,12,0,20,8
1746601548716,LIGM 5B,A00,896260,Fischer-Grunski; Eva K,17,0,20,3
1746601549746,LIGM 5C,A00,896308,Fischer-Grunski; Eva K,18,0,20,2
1746601550776,LIIT 5AS,A00,896313,Carnelos; Chiara,18,0,20,2
1746601551802,LIIT 5BS,A00,896416,Carnelos; Chiara,20,0,20,0
1746601552833,LIIT 5CS,A00,896564,Carnelos; Chiara,20,0,20,0
1746601553860,LISP 5A,A00,896588,Munoz Sanchez; Alicia,2,0,20,18
1746601554890,LISP 5B,A00,896653,Munoz Sanchez; Alicia,7,0,20,13
1746601555917,LISP 5C,A00,896655,Munoz Sanchez; Alicia,0,1,20,20
1746601556945,MAE 197,001,957918,Kleissl; Jan,9996,0,9999,3
1746601556945,MAE 197,002,959806,Boechler; Nicholas Sebastia,9998,0,9999,1
1746601556945,MAE 197,003,959852,Mullin; Jennifer S,9998,0,9999,1
1746601557973,MATH 2,A01,957937,Staff,33,0,35,2
1746601559003,MATH 197,001,957876,Kedlaya; Kiran S.,9993,0,9999,6
1746601560056,MCWP 40,A00,892729,Duru; Nur,10,0,20,10
1746601560056,MCWP 40,B00,893304,Montejo; Carolina,14,0,20,6
1746601561082,MCWP 40R,A00,893757,Redela; Pamela Morgan,0,5,20,20
1746601562111,MCWP 50,A00,893758,Morshed; Michael James,0,0,20,20
1746601562111,MCWP 50,B00,893761,Bartulis; Jason Michael,17,0,20,3
1746601563142,MCWP 50R,A00,893766,Compas; Sean Matthew,0,1,20,20
1746601563142,MCWP 50R,B00,893769,Carter; Jennifer A,0,1,20,20
1746601563142,MCWP 50R,C00,893771,Krone; Jarret,0,3,20,20
1746601563142,MCWP 50R,D00,893772,Miller; Elizabeth Deen,0,0,20,20
1746601563142,MCWP 50R,E00,893775,Carter; Andrea L,0,1,20,20
1746601564171,MMW 11R,A01,892721,Herbst; Matthew,14,0,30,16
1746601564171,MMW 11R,A02,892722,Herbst; Matthew,0,0,0,3
1746601565199,MMW 12R,A01,892724,Herbst; Matthew,0,11,16,16
1746601565199,MMW 12R,A02,892725,Herbst; Matthew,0,10,16,16
1746601566232,MMW 13R,A01,892727,Staff,0,4,16,16
1746601566232,MMW 13R,A02,892728,Staff,0,4,16,16
1746601566232,MMW 13R,A03,958032,Staff,0,4,16,16
1746601566232,MMW 13R,A04,958033,Staff,0,4,16,16
1746601566232,MMW 13R,A05,958034,Staff,0,4,16,16
1746601567261,SIO 295LS,A00,894015,Staff,5,0,25,20
1746601568287,SIO 295S,A00,894020,Staff,5,0,25,20
1746601569319,SIOC 290S,B01,958918,Merrifield; Mark A,14,0,30,16
1746601570352,SIOC 291S,B01,958922,Gabriel; Corey John,14,0,30,16
1746601571384,SOCI 117,A01,895339,Staff,2,0,5,3
1746601572424,WES 237B,A00,894149,Staff,11,0,20,9
1746601574513,AESE 279B,A00,891859,Staff,13,0,35,22
1746601575539,AIP 197,001,891854,Vespa; Emanuel Ignacio,9999,0,9999,0
1746601576565,ANTH 289S,A00,891856,Gagneux; Pascal,12,0,12,0
1746601577592,BENG 196,001,957946,Engler; Adam J.,9996,0,9999,3
1746601578617,BISP 197,001,959851,Wilhelm; James E.,9998,0,9999,1
1746601579646,CAT 124RS,A01,956906,Staff,6,0,25,19
1746601580671,CAT 125RS,A01,922013,Staff,6,0,25,19
1746601581726,CLRE 250,A00,891860,Morris; Sheldon,9995,0,9999,4
1746601583792,CLRE 251R,A00,907817,Mehta; Ravindra L.,9994,0,9999,5
1746601584821,CLRE 252,A00,891864,Cuomo; Raphael Eduardo,9993,0,9999,6
1746601585850,CLRE 253,A00,891867,Vaida; Florin,9994,0,9999,5
1746601585850,CLRE 253,B00,907819,Staff,9999,0,9999,0
1746601586879,CLRE 259,A00,891868,Patel; Hemal,9998,0,9999,1
1746601587905,CLRE 260,A00,891872,Cuomo; Raphael Eduardo,9999,0,9999,0
1746601588933,CLRE 297,001,891888,Cuomo; Raphael Eduardo,9999,0,9999,0
1746601589959,CSE 191,A00,958773,Minnes Kemp; Mor Mia,9995,0,9999,4
1746601590984,CSE 197,001,959846,Minnes Kemp; Mor Mia,9990,0,9999,9
1746601592015,CSS 201S,A01,892054,Mignozzetti; Umberto,25,0,30,5
1746601593040,CSS 202S,A01,892056,Mignozzetti; Umberto,25,0,30,5
1746601594071,DSC 197,001,956898,Eldridge; Justin Matthew,9996,0,9999,3
1746601595096,DSC 297,001,958000,Mazumdar; Arya,9998,0,9999,1
1746601595096,DSC 297,002,959862,Wang; Yusu,9998,0,9999,1
1746601596121,EAP 100,A00,905686,Staff,9778,0,9999,221
1746601597152,ECE 45,A01,892618,Staff,0,0,65,65
1746601599206,ECE 111,A01,892719,Staff,6,0,65,59
1746601600233,ECE 197,001,957920,Mercier; Patrick Philip,9991,0,9999,8
1746601601258,ECON 178,A01,907814,Zhu; Ying,26,0,35,9
1746601602283,EDS 115,A00,895312,Staff,35,0,45,10
1746601603311,EDS 117,A01,895337,Staff,23,0,30,7
1746601604337,EDS 125,A00,895341,Jones; Gabrielle Anastasia,36,0,45,9
1746601605363,EDS 128A,A01,895459,Fargason; Sharon Gayle,44,0,45,1
1746601606388,EDS 128B,A01,895543,Pappas; Elizabeth,44,0,45,1
1746601607413,EDS 139,A00,897203,Pappas; Elizabeth,44,0,45,1
1746601607413,EDS 139,B00,897209,Fargason; Sharon Gayle,41,0,45,4
1746601608439,EDS 201,A00,895545,Staff,22,0,45,23
1746601609467,EDS 203,A01,895581,Halter; Christopher P.,22,0,45,23
1746601610494,EDS 204R,A01,895625,Heinzman; Erica M.,39,0,45,6
1746601610494,EDS 204R,B01,895693,Halter; Christopher P.,10,0,45,35
1746601611521,EDS 206R,A00,895694,Fargason; Sharon Gayle,1,0,30,29
1746601611521,EDS 206R,B00,895695,Choi; Bailey Miyeon,16,0,30,14
1746601612546,EDS 250,A00,895697,Hemans; Patricia Ann Benitez,22,0,45,23
1746601613573,EDS 281,A00,895701,Meyerott; Theresa Ann,1,0,15,14
1746601614599,EDS 284,A00,895736,Meyerott; Theresa Ann,1,0,15,14
1746601615624,EDS 286,A00,897210,Fine; Sarah,0,0,15,15
1746601616655,EDS 289C,A01,895770,Daly; Alan J.,1,0,15,14
1746601617681,EDS 290,A00,897211,Hofstetter; Carolyn,0,0,15,15
1746601618707,LIGM 5A,A00,896162,Fischer-Grunski; Eva K,12,0,20,8
1746601619734,LIGM 5B,A00,896260,Fischer-Grunski; Eva K,17,0,20,3
1746601620766,LIGM 5C,A00,896308,Fischer-Grunski; Eva K,18,0,20,2
1746601621796,LIIT 5AS,A00,896313,Carnelos; Chiara,18,0,20,2
1746601622826,LIIT 5BS,A00,896416,Carnelos; Chiara,20,0,20,0
1746601623850,LIIT 5CS,A00,896564,Carnelos; Chiara,20,0,20,0
1746601624878,LISP 5A,A00,896588,Munoz Sanchez; Alicia,2,0,20,18
1746601625905,LISP 5B,A00,896653,Munoz Sanchez; Alicia,7,0,20,13
1746601626929,LISP 5C,A00,896655,Munoz Sanchez; Alicia,0,1,20,20
1746601627952,MAE 197,001,957918,Kleissl; Jan,9996,0,9999,3
1746601627952,MAE 197,002,959806,Boechler; Nicholas Sebastia,9998,0,9999,1
1746601627952,MAE 197,003,959852,Mullin; Jennifer S,9998,0,9999,1
1746601628978,MATH 2,A01,957937,Staff,33,0,35,2
1746601630004,MATH 197,001,957876,Kedlaya; Kiran S.,9993,0,9999,6
1746601631030,MCWP 40,A00,892729,Duru; Nur,10,0,20,10
1746601631030,MCWP 40,B00,893304,Montejo; Carolina,14,0,20,6
1746601632055,MCWP 40R,A00,893757,Redela; Pamela Morgan,0,5,20,20
1746601633081,MCWP 50,A00,893758,Morshed; Michael James,0,0,20,20
1746601633081,MCWP 50,B00,893761,Bartulis; Jason Michael,17,0,20,3
1746601634107,MCWP 50R,A00,893766,Compas; Sean Matthew,0,1,20,20
1746601634107,MCWP 50R,B00,893769,Carter; Jennifer A,0,1,20,20
1746601634107,MCWP 50R,C00,893771,Krone; Jarret,0,3,20,20
1746601634107,MCWP 50R,D00,893772,Miller; Elizabeth Deen,0,0,20,20
1746601634107,MCWP 50R,E00,893775,Carter; Andrea L,0,1,20,20
1746601635132,MMW 11R,A01,892721,Herbst; Matthew,14,0,30,16
1746601635132,MMW 11R,A02,892722,Herbst; Matthew,0,0,0,3
1746601636156,MMW 12R,A01,892724,Herbst; Matthew,0,11,16,16
1746601636156,MMW 12R,A02,892725,Herbst; Matthew,0,10,16,16
1746601637182,MMW 13R,A01,892727,Staff,0,4,16,16
1746601637182,MMW 13R,A02,892728,Staff,0,4,16,16
1746601637182,MMW 13R,A03,958032,Staff,0,4,16,16
1746601637182,MMW 13R,A04,958033,Staff,0,4,16,16
1746601637182,MMW 13R,A05,958034,Staff,0,4,16,16
1746601638208,SIO 295LS,A00,894015,Staff,5,0,25,20
1746601639233,SIO 295S,A00,894020,Staff,5,0,25,20
1746601640262,SIOC 290S,B01,958918,Merrifield; Mark A,14,0,30,16
1746601641286,SIOC 291S,B01,958922,Gabriel; Corey John,14,0,30,16
1746601642312,SOCI 117,A01,895339,Staff,2,0,5,3
1746601643338,WES 237B,A00,894149,Staff,11,0,20,9
1746601645401,AESE 279B,A00,891859,Staff,13,0,35,22
1746601646429,AIP 197,001,891854,Vespa; Emanuel Ignacio,9999,0,9999,0
1746601647458,ANTH 289S,A00,891856,Gagneux; Pascal,12,0,12,0
1746601648482,BENG 196,001,957946,Engler; Adam J.,9996,0,9999,3
1746601649512,BISP 197,001,959851,Wilhelm; James E.,9998,0,9999,1
1746601650541,CAT 124RS,A01,956906,Staff,6,0,25,19
1746601651567,CAT 125RS,A01,922013,Staff,6,0,25,19
1746601652595,CLRE 250,A00,891860,Morris; Sheldon,9995,0,9999,4
1746601654647,CLRE 251R,A00,907817,Mehta; Ravindra L.,9994,0,9999,5
1746601655673,CLRE 252,A00,891864,Cuomo; Raphael Eduardo,9993,0,9999,6
1746601656703,CLRE 253,A00,891867,Vaida; Florin,9994,0,9999,5
1746601656703,CLRE 253,B00,907819,Staff,9999,0,9999,0
1746601657732,CLRE 259,A00,891868,Patel; Hemal,9998,0,9999,1
1746601658756,CLRE 260,A00,891872,Cuomo; Raphael Eduardo,9999,0,9999,0
1746601659800,CLRE 297,001,891888,Cuomo; Raphael Eduardo,9999,0,9999,0
1746601660828,CSE 191,A00,958773,Minnes Kemp; Mor Mia,9995,0,9999,4
1746601661854,CSE 197,001,959846,Minnes Kemp; Mor Mia,9990,0,9999,9
1746601662883,CSS 201S,A01,892054,Mignozzetti; Umberto,25,0,30,5
1746601663910,CSS 202S,A01,892056,Mignozzetti; Umberto,25,0,30,5
1746601664941,DSC 197,001,956898,Eldridge; Justin Matthew,9996,0,9999,3
1746601665968,DSC 297,001,958000,Mazumdar; Arya,9998,0,9999,1
1746601665968,DSC 297,002,959862,Wang; Yusu,9998,0,9999,1
1746601666994,EAP 100,A00,905686,Staff,9778,0,9999,221
1746601668021,ECE 45,A01,892618,Staff,0,0,65,65
1746601670077,ECE 111,A01,892719,Staff,6,0,65,59
1746601671104,ECE 197,001,957920,Mercier; Patrick Philip,9991,0,9999,8
1746601672132,ECON 178,A01,907814,Zhu; Ying,26,0,35,9
1746601673161,EDS 115,A00,895312,Staff,35,0,45,10
1746601674188,EDS 117,A01,895337,Staff,23,0,30,7
1746601675217,EDS 125,A00,895341,Jones; Gabrielle Anastasia,36,0,45,9
1746601676243,EDS 128A,A01,895459,Fargason; Sharon Gayle,44,0,45,1
1746601677268,EDS 128B,A01,895543,Pappas; Elizabeth,44,0,45,1
1746601678294,EDS 139,A00,897203,Pappas; Elizabeth,44,0,45,1
1746601678294,EDS 139,B00,897209,Fargason; Sharon Gayle,41,0,45,4
1746601679322,EDS 201,A00,895545,Staff,22,0,45,23
1746601680349,EDS 203,A01,895581,Halter; Christopher P.,22,0,45,23
1746601681379,EDS 204R,A01,895625,Heinzman; Erica M.,39,0,45,6
1746601681379,EDS 204R,B01,895693,Halter; Christopher P.,10,0,45,35
1746601682416,EDS 206R,A00,895694,Fargason; Sharon Gayle,1,0,30,29
1746601682416,EDS 206R,B00,895695,Choi; Bailey Miyeon,16,0,30,14
1746601683446,EDS 250,A00,895697,Hemans; Patricia Ann Benitez,22,0,45,23
1746601684471,EDS 281,A00,895701,Meyerott; Theresa Ann,1,0,15,14
1746601685496,EDS 284,A00,895736,Meyerott; Theresa Ann,1,0,15,14
1746601686525,EDS 286,A00,897210,Fine; Sarah,0,0,15,15
1746601687551,EDS 289C,A01,895770,Daly; Alan J.,1,0,15,14
1746601688577,EDS 290,A00,897211,Hofstetter; Carolyn,0,0,15,15
1746601689604,LIGM 5A,A00,896162,Fischer-Grunski; Eva K,12,0,20,8
1746601690628,LIGM 5B,A00,896260,Fischer-Grunski; Eva K,17,0,20,3
1746601691658,LIGM 5C,A00,896308,Fischer-Grunski; Eva K,18,0,20,2
1746601692686,LIIT 5AS,A00,896313,Carnelos; Chiara,18,0,20,2
1746601693712,LIIT 5BS,A00,896416,Carnelos; Chiara,20,0,20,0
1746601694744,LIIT 5CS,A00,896564,Carnelos; Chiara,20,0,20,0
1746601695775,LISP 5A,A00,896588,Munoz Sanchez; Alicia,2,0,20,18
1746601696807,LISP 5B,A00,896653,Munoz Sanchez; Alicia,7,0,20,13
1746601697833,LISP 5C,A00,896655,Munoz Sanchez; Alicia,0,1,20,20
1746601698863,MAE 197,001,957918,Kleissl; Jan,9996,0,9999,3
1746601698863,MAE 197,002,959806,Boechler; Nicholas Sebastia,9998,0,9999,1
1746601698863,MAE 197,003,959852,Mullin; Jennifer S,9998,0,9999,1
1746601699889,MATH 2,A01,957937,Staff,33,0,35,2
1746601700917,MATH 197,001,957876,Kedlaya; Kiran S.,9993,0,9999,6
1746601701942,MCWP 40,A00,892729,Duru; Nur,10,0,20,10
1746601701942,MCWP 40,B00,893304,Montejo; Carolina,14,0,20,6
1746601702972,MCWP 40R,A00,893757,Redela; Pamela Morgan,0,5,20,20
1746601704002,MCWP 50,A00,893758,Morshed; Michael James,0,0,20,20
1746601704002,MCWP 50,B00,893761,Bartulis; Jason Michael,16,0,20,4
1746601705029,MCWP 50R,A00,893766,Compas; Sean Matthew,0,1,20,20
1746601705029,MCWP 50R,B00,893769,Carter; Jennifer A,0,1,20,20
1746601705029,MCWP 50R,C00,893771,Krone; Jarret,0,3,20,20
1746601705029,MCWP 50R,D00,893772,Miller; Elizabeth Deen,0,0,20,20
1746601705029,MCWP 50R,E00,893775,Carter; Andrea L,0,1,20,20
1746601706058,MMW 11R,A01,892721,Herbst; Matthew,14,0,30,16
1746601706058,MMW 11R,A02,892722,Herbst; Matthew,0,0,0,3
1746601707084,MMW 12R,A01,892724,Herbst; Matthew,0,11,16,16
1746601707084,MMW 12R,A02,892725,Herbst; Matthew,0,10,16,16
1746601708109,MMW 13R,A01,892727,Staff,0,4,16,16
1746601708109,MMW 13R,A02,892728,Staff,0,4,16,16
1746601708109,MMW 13R,A03,958032,Staff,0,4,16,16
1746601708109,MMW 13R,A04,958033,Staff,0,4,16,16
1746601708109,MMW 13R,A05,958034,Staff,0,4,16,16
1746601709139,SIO 295LS,A00,894015,Staff,5,0,25,20
1746601710166,SIO 295S,A00,894020,Staff,5,0,25,20
1746601711197,SIOC 290S,B01,958918,Merrifield; Mark A,14,0,30,16
1746601712223,SIOC 291S,B01,958922,Gabriel; Corey John,14,0,30,16
1746601713252,SOCI 117,A01,895339,Staff,2,0,5,3
1746601714278,WES 237B,A00,894149,Staff,11,0,20,9
1746601716346,AESE 279B,A00,891859,Staff,13,0,35,22
1746601717373,AIP 197,001,891854,Vespa; Emanuel Ignacio,9999,0,9999,0
1746601718399,ANTH 289S,A00,891856,Gagneux; Pascal,12,0,12,0
1746601719425,BENG 196,001,957946,Engler; Adam J.,9996,0,9999,3
1746601720453,BISP 197,001,959851,Wilhelm; James E.,9998,0,9999,1
1746601721478,CAT 124RS,A01,956906,Staff,6,0,25,19
1746601722542,CAT 125RS,A01,922013,Staff,6,0,25,19
1746601723571,CLRE 250,A00,891860,Morris; Sheldon,9995,0,9999,4
1746601725622,CLRE 251R,A00,907817,Mehta; Ravindra L.,9994,0,9999,5
1746601726649,CLRE 252,A00,891864,Cuomo; Raphael Eduardo,9993,0,9999,6
1746601727675,CLRE 253,A00,891867,Vaida; Florin,9994,0,9999,5
1746601727675,CLRE 253,B00,907819,Staff,9999,0,9999,0
1746601728701,CLRE 259,A00,891868,Patel; Hemal,9998,0,9999,1
1746601729727,CLRE 260,A00,891872,Cuomo; Raphael Eduardo,9999,0,9999,0
1746601730753,CLRE 297,001,891888,Cuomo; Raphael Eduardo,9999,0,9999,0
1746601731783,CSE 191,A00,958773,Minnes Kemp; Mor Mia,9995,0,9999,4
1746601732809,CSE 197,001,959846,Minnes Kemp; Mor Mia,9990,0,9999,9
1746601733839,CSS 201S,A01,892054,Mignozzetti; Umberto,25,0,30,5
1746601734870,CSS 202S,A01,892056,Mignozzetti; Umberto,25,0,30,5
1746601735897,DSC 197,001,956898,Eldridge; Justin Matthew,9996,0,9999,3
1746601736931,DSC 297,001,958000,Mazumdar; Arya,9998,0,9999,1
1746601736931,DSC 297,002,959862,Wang; Yusu,9998,0,9999,1
1746601737957,EAP 100,A00,905686,Staff,9778,0,9999,221
1746601738991,ECE 45,A01,892618,Staff,0,0,65,65
1746601741065,ECE 111,A01,892719,Staff,6,0,65,59
1746601742093,ECE 197,001,957920,Mercier; Patrick Philip,9991,0,9999,8
1746601743124,ECON 178,A01,907814,Zhu; Ying,26,0,35,9
1746601744149,EDS 115,A00,895312,Staff,35,0,45,10
1746601745179,EDS 117,A01,895337,Staff,23,0,30,7
1746601746204,EDS 125,A00,895341,Jones; Gabrielle Anastasia,36,0,45,9
1746601747235,EDS 128A,A01,895459,Fargason; Sharon Gayle,44,0,45,1
1746601748263,EDS 128B,A01,895543,Pappas; Elizabeth,44,0,45,1
1746601749292,EDS 139,A00,897203,Pappas; Elizabeth,44,0,45,1
1746601749292,EDS 139,B00,897209,Fargason; Sharon Gayle,41,0,45,4
1746601750320,EDS 201,A00,895545,Staff,22,0,45,23
1746601751349,EDS 203,A01,895581,Halter; Christopher P.,22,0,45,23
1746601752376,EDS 204R,A01,895625,Heinzman; Erica M.,39,0,45,6
1746601752376,EDS 204R,B01,895693,Halter; Christopher P.,10,0,45,35
1746601753402,EDS 206R,A00,895694,Fargason; Sharon Gayle,1,0,30,29
1746601753402,EDS 206R,B00,895695,Choi; Bailey Miyeon,16,0,30,14
1746601754430,EDS 250,A00,895697,Hemans; Patricia Ann Benitez,22,0,45,23
1746601755456,EDS 281,A00,895701,Meyerott; Theresa Ann,1,0,15,14
1746601756483,EDS 284,A00,895736,Meyerott; Theresa Ann,1,0,15,14
1746601757509,EDS 286,A00,897210,Fine; Sarah,0,0,15,15
1746601758534,EDS 289C,A01,895770,Daly; Alan J.,1,0,15,14
1746601759614,EDS 290,A00,897211,Hofstetter; Carolyn,0,0,15,15
1746601760640,LIGM 5A,A00,896162,Fischer-Grunski; Eva K,12,0,20,8
1746601761670,LIGM 5B,A00,896260,Fischer-Grunski; Eva K,17,0,20,3
1746601762695,LIGM 5C,A00,896308,Fischer-Grunski; Eva K,18,0,20,2
1746601763726,LIIT 5AS,A00,896313,Carnelos; Chiara,18,0,20,2
1746601764755,LIIT 5BS,A00,896416,Carnelos; Chiara,20,0,20,0
1746601765780,LIIT 5CS,A00,896564,Carnelos; Chiara,20,0,20,0
1746601766811,LISP 5A,A00,896588,Munoz Sanchez; Alicia,2,0,20,18
1746601767835,LISP 5B,A00,896653,Munoz Sanchez; Alicia,7,0,20,13
1746601768862,LISP 5C,A00,896655,Munoz Sanchez; Alicia,0,1,20,20
1746601769887,MAE 197,001,957918,Kleissl; Jan,9996,0,9999,3
1746601769887,MAE 197,002,959806,Boechler; Nicholas Sebastia,9998,0,9999,1
1746601769887,MAE 197,003,959852,Mullin; Jennifer S,9998,0,9999,1
1746601770914,MATH 2,A01,957937,Staff,33,0,35,2
1746601771942,MATH 197,001,957876,Kedlaya; Kiran S.,9993,0,9999,6
1746601772969,MCWP 40,A00,892729,Duru; Nur,10,0,20,10
1746601772969,MCWP 40,B00,893304,Montejo; Carolina,14,0,20,6
1746601774003,MCWP 40R,A00,893757,Redela; Pamela Morgan,0,5,20,20
1746601775027,MCWP 50,A00,893758,Morshed; Michael James,0,0,20,20
1746601775027,MCWP 50,B00,893761,Bartulis; Jason Michael,16,0,20,4
1746601776053,MCWP 50R,A00,893766,Compas; Sean Matthew,0,1,20,20
1746601776053,MCWP 50R,B00,893769,Carter; Jennifer A,0,1,20,20
1746601776053,MCWP 50R,C00,893771,Krone; Jarret,0,3,20,20
1746601776053,MCWP 50R,D00,893772,Miller; Elizabeth Deen,0,0,20,20
1746601776053,MCWP 50R,E00,893775,Carter; Andrea L,0,1,20,20
1746601777078,MMW 11R,A01,892721,Herbst; Matthew,14,0,30,16
1746601777078,MMW 11R,A02,892722,Herbst; Matthew,0,0,0,3
1746601778103,MMW 12R,A01,892724,Herbst; Matthew,0,11,16,16
1746601778103,MMW 12R,A02,892725,Herbst; Matthew,0,10,16,16
1746601779131,MMW 13R,A01,892727,Staff,0,4,16,16
1746601779131,MMW 13R,A02,892728,Staff,0,4,16,16
1746601779131,MMW 13R,A03,958032,Staff,0,4,16,16
1746601779131,MMW 13R,A04,958033,Staff,0,4,16,16
1746601779131,MMW 13R,A05,958034,Staff,0,4,16,16
1746601780160,SIO 295LS,A00,894015,Staff,5,0,25,20
1746601781187,SIO 295S,A00,894020,Staff,5,0,25,20
1746601782217,SIOC 290S,B01,958918,Merrifield; Mark A,14,0,30,16
1746601783245,SIOC 291S,B01,958922,Gabriel; Corey John,14,0,30,16
1746601784272,SOCI 117,A01,895339,Staff,2,0,5,3
1746601785297,WES 237B,A00,894149,Staff,11,0,20,9
1746601787362,AESE 279B,A00,891859,Staff,13,0,35,22
1746601788401,AIP 197,001,891854,Vespa; Emanuel Ignacio,9999,0,9999,0
1746601789430,ANTH 289S,A00,891856,Gagneux; Pascal,12,0,12,0
1746601790458,BENG 196,001,957946,Engler; Adam J.,9996,0,9999,3
1746601791482,BISP 197,001,959851,Wilhelm; James E.,9998,0,9999,1
1746601792524,CAT 124RS,A01,956906,Staff,6,0,25,19
1746601793548,CAT 125RS,A01,922013,Staff,6,0,25,19
1746601794580,CLRE 250,A00,891860,Morris; Sheldon,9995,0,9999,4
1746601796634,CLRE 251R,A00,907817,Mehta; Ravindra L.,9994,0,9999,5
1746601797660,CLRE 252,A00,891864,Cuomo; Raphael Eduardo,9993,0,9999,6
1746601798686,CLRE 253,A00,891867,Vaida; Florin,9994,0,9999,5
1746601798686,CLRE 253,B00,907819,Staff,9999,0,9999,0
1746601799712,CLRE 259,A00,891868,Patel; Hemal,9998,0,9999,1
1746601800739,CLRE 260,A00,891872,Cuomo; Raphael Eduardo,9999,0,9999,0
1746601801765,CLRE 297,001,891888,Cuomo; Raphael Eduardo,9999,0,9999,0
1746601802792,CSE 191,A00,958773,Minnes Kemp; Mor Mia,9995,0,9999,4
1746601803818,CSE 197,001,959846,Minnes Kemp; Mor Mia,9990,0,9999,9
1746601804845,CSS 201S,A01,892054,Mignozzetti; Umberto,25,0,30,5
1746601805876,CSS 202S,A01,892056,Mignozzetti; Umberto,25,0,30,5
1746601806905,DSC 197,001,956898,Eldridge; Justin Matthew,9996,0,9999,3
1746601807932,DSC 297,001,958000,Mazumdar; Arya,9998,0,9999,1
1746601807932,DSC 297,002,959862,Wang; Yusu,9998,0,9999,1
1746601808958,EAP 100,A00,905686,Staff,9778,0,9999,221
1746601809987,ECE 45,A01,892618,Staff,0,0,65,65
1746601812040,ECE 111,A01,892719,Staff,6,0,65,59
1746601813065,ECE 197,001,957920,Mercier; Patrick Philip,9991,0,9999,8
1746601814094,ECON 178,A01,907814,Zhu; Ying,26,0,35,9
1746601815121,EDS 115,A00,895312,Staff,35,0,45,10
1746601816148,EDS 117,A01,895337,Staff,23,0,30,7
1746601817178,EDS 125,A00,895341,Jones; Gabrielle Anastasia,36,0,45,9
1746601818204,EDS 128A,A01,895459,Fargason; Sharon Gayle,44,0,45,1
1746601819230,EDS 128B,A01,895543,Pappas; Elizabeth,44,0,45,1
1746601820256,EDS 139,A00,897203,Pappas; Elizabeth,44,0,45,1
1746601820256,EDS 139,B00,897209,Fargason; Sharon Gayle,41,0,45,4
1746601821285,EDS 201,A00,895545,Staff,22,0,45,23
1746601822313,EDS 203,A01,895581,Halter; Christopher P.,22,0,45,23
1746601823338,EDS 204R,A01,895625,Heinzman; Erica M.,39,0,45,6
1746601823338,EDS 204R,B01,895693,Halter; Christopher P.,10,0,45,35
1746601824364,EDS 206R,A00,895694,Fargason; Sharon Gayle,1,0,30,29
1746601824364,EDS 206R,B00,895695,Choi; Bailey Miyeon,16,0,30,14
1746601825391,EDS 250,A00,895697,Hemans; Patricia Ann Benitez,22,0,45,23
1746601826420,EDS 281,A00,895701,Meyerott; Theresa Ann,1,0,15,14
1746601827446,EDS 284,A00,895736,Meyerott; Theresa Ann,1,0,15,14
1746601828470,EDS 286,A00,897210,Fine; Sarah,0,0,15,15
1746601829495,EDS 289C,A01,895770,Daly; Alan J.,1,0,15,14
1746601830522,EDS 290,A00,897211,Hofstetter; Carolyn,0,0,15,15
1746601831549,LIGM 5A,A00,896162,Fischer-Grunski; Eva K,12,0,20,8
1746601832576,LIGM 5B,A00,896260,Fischer-Grunski; Eva K,17,0,20,3
1746601833603,LIGM 5C,A00,896308,Fischer-Grunski; Eva K,18,0,20,2
1746601834632,LIIT 5AS,A00,896313,Carnelos; Chiara,18,0,20,2
1746601835659,LIIT 5BS,A00,896416,Carnelos; Chiara,20,0,20,0
1746601836684,LIIT 5CS,A00,896564,Carnelos; Chiara,20,0,20,0
1746601837771,LISP 5A,A00,896588,Munoz Sanchez; Alicia,2,0,20,18
1746601838797,LISP 5B,A00,896653,Munoz Sanchez; Alicia,7,0,20,13
1746601839823,LISP 5C,A00,896655,Munoz Sanchez; Alicia,0,1,20,20
1746601840857,MAE 197,001,957918,Kleissl; Jan,9996,0,9999,3
1746601840857,MAE 197,002,959806,Boechler; Nicholas Sebastia,9998,0,9999,1
1746601840857,MAE 197,003,959852,Mullin; Jennifer S,9998,0,9999,1
1746601841887,MATH 2,A01,957937,Staff,33,0,35,2
1746601842914,MATH 197,001,957876,Kedlaya; Kiran S.,9993,0,9999,6
1746601843946,MCWP 40,A00,892729,Duru; Nur,10,0,20,10
1746601843946,MCWP 40,B00,893304,Montejo; Carolina,14,0,20,6
1746601844973,MCWP 40R,A00,893757,Redela; Pamela Morgan,0,5,20,20
1746601845999,MCWP 50,A00,893758,Morshed; Michael James,0,0,20,20
1746601845999,MCWP 50,B00,893761,Bartulis; Jason Michael,16,0,20,4
1746601847026,MCWP 50R,A00,893766,Compas; Sean Matthew,0,1,20,20
1746601847026,MCWP 50R,B00,893769,Carter; Jennifer A,0,1,20,20
1746601847026,MCWP 50R,C00,893771,Krone; Jarret,0,3,20,20
1746601847026,MCWP 50R,D00,893772,Miller; Elizabeth Deen,0,0,20,20
1746601847026,MCWP 50R,E00,893775,Carter; Andrea L,0,1,20,20
1746601848051,MMW 11R,A01,892721,Herbst; Matthew,14,0,30,16
1746601848051,MMW 11R,A02,892722,Herbst; Matthew,0,0,0,3
1746601849076,MMW 12R,A01,892724,Herbst; Matthew,0,11,16,16
1746601849076,MMW 12R,A02,892725,Herbst; Matthew,0,10,16,16
1746601850102,MMW 13R,A01,892727,Staff,0,4,16,16
1746601850102,MMW 13R,A02,892728,Staff,0,4,16,16
1746601850102,MMW 13R,A03,958032,Staff,0,4,16,16
1746601850102,MMW 13R,A04,958033,Staff,0,4,16,16
1746601850102,MMW 13R,A05,958034,Staff,0,4,16,16
1746601851128,SIO 295LS,A00,894015,Staff,5,0,25,20
1746601852154,SIO 295S,A00,894020,Staff,5,0,25,20
1746601853183,SIOC 290S,B01,958918,Merrifield; Mark A,14,0,30,16
1746601854208,SIOC 291S,B01,958922,Gabriel; Corey John,14,0,30,16
1746601855235,SOCI 117,A01,895339,Staff,2,0,5,3
1746601856263,WES 237B,A00,894149,Staff,11,0,20,9
1746601858363,AESE 279B,A00,891859,Staff,13,0,35,22
1746601859422,AIP 197,001,891854,Vespa; Emanuel Ignacio,9999,0,9999,0
1746601860448,ANTH 289S,A00,891856,Gagneux; Pascal,12,0,12,0
1746601861477,BENG 196,001,957946,Engler; Adam J.,9996,0,9999,3
1746601862509,BISP 197,001,959851,Wilhelm; James E.,9998,0,9999,1
1746601863535,CAT 124RS,A01,956906,Staff,6,0,25,19
1746601864562,CAT 125RS,A01,922013,Staff,6,0,25,19
1746601865588,CLRE 250,A00,891860,Morris; Sheldon,9995,0,9999,4
1746601867652,CLRE 251R,A00,907817,Mehta; Ravindra L.,9994,0,9999,5
1746601868680,CLRE 252,A00,891864,Cuomo; Raphael Eduardo,9993,0,9999,6
1746601869710,CLRE 253,A00,891867,Vaida; Florin,9994,0,9999,5
1746601869710,CLRE 253,B00,907819,Staff,9999,0,9999,0
1746601870737,CLRE 259,A00,891868,Patel; Hemal,9998,0,9999,1
1746601871766,CLRE 260,A00,891872,Cuomo; Raphael Eduardo,9999,0,9999,0
1746601872792,CLRE 297,001,891888,Cuomo; Raphael Eduardo,9999,0,9999,0
1746601873820,CSE 191,A00,958773,Minnes Kemp; Mor Mia,9995,0,9999,4
1746601874847,CSE 197,001,959846,Minnes Kemp; Mor Mia,9990,0,9999,9
1746601875873,CSS 201S,A01,892054,Mignozzetti; Umberto,25,0,30,5
1746601876900,CSS 202S,A01,892056,Mignozzetti; Umberto,25,0,30,5
1746601877924,DSC 197,001,956898,Eldridge; Justin Matthew,9996,0,9999,3
1746601878952,DSC 297,001,958000,Mazumdar; Arya,9998,0,9999,1
1746601878952,DSC 297,002,959862,Wang; Yusu,9998,0,9999,1
1746601879987,EAP 100,A00,905686,Staff,9778,0,9999,221
1746601881014,ECE 45,A01,892618,Staff,0,0,65,65
1746601883069,ECE 111,A01,892719,Staff,6,0,65,59
1746601884097,ECE 197,001,957920,Mercier; Patrick Philip,9991,0,9999,8
1746601885124,ECON 178,A01,907814,Zhu; Ying,26,0,35,9
1746601886150,EDS 115,A00,895312,Staff,35,0,45,10
1746601887176,EDS 117,A01,895337,Staff,23,0,30,7
1746601888203,EDS 125,A00,895341,Jones; Gabrielle Anastasia,36,0,45,9
1746601889230,EDS 128A,A01,895459,Fargason; Sharon Gayle,44,0,45,1
1746601890256,EDS 128B,A01,895543,Pappas; Elizabeth,44,0,45,1
1746601891283,EDS 139,A00,897203,Pappas; Elizabeth,44,0,45,1
1746601891283,EDS 139,B00,897209,Fargason; Sharon Gayle,41,0,45,4
1746601892309,EDS 201,A00,895545,Staff,22,0,45,23
1746601893336,EDS 203,A01,895581,Halter; Christopher P.,22,0,45,23
1746601894360,EDS 204R,A01,895625,Heinzman; Erica M.,39,0,45,6
1746601894360,EDS 204R,B01,895693,Halter; Christopher P.,10,0,45,35
1746601895388,EDS 206R,A00,895694,Fargason; Sharon Gayle,1,0,30,29
1746601895388,EDS 206R,B00,895695,Choi; Bailey Miyeon,16,0,30,14
1746601896415,EDS 250,A00,895697,Hemans; Patricia Ann Benitez,22,0,45,23
1746601897446,EDS 281,A00,895701,Meyerott; Theresa Ann,1,0,15,14
1746601898471,EDS 284,A00,895736,Meyerott; Theresa Ann,1,0,15,14
1746601899497,EDS 286,A00,897210,Fine; Sarah,0,0,15,15
1746601900526,EDS 289C,A01,895770,Daly; Alan J.,1,0,15,14
1746601901551,EDS 290,A00,897211,Hofstetter; Carolyn,0,0,15,15
1746601902585,LIGM 5A,A00,896162,Fischer-Grunski; Eva K,12,0,20,8
1746601903615,LIGM 5B,A00,896260,Fischer-Grunski; Eva K,17,0,20,3
1746601904641,LIGM 5C,A00,896308,Fischer-Grunski; Eva K,18,0,20,2
1746601905666,LIIT 5AS,A00,896313,Carnelos; Chiara,18,0,20,2
1746601906693,LIIT 5BS,A00,896416,Carnelos; Chiara,20,0,20,0
1746601907723,LIIT 5CS,A00,896564,Carnelos; Chiara,20,0,20,0
1746601908756,LISP 5A,A00,896588,Munoz Sanchez; Alicia,2,0,20,18
1746601909786,LISP 5B,A00,896653,Munoz Sanchez; Alicia,7,0,20,13
1746601910812,LISP 5C,A00,896655,Munoz Sanchez; Alicia,0,1,20,20
1746601911839,MAE 197,001,957918,Kleissl; Jan,9996,0,9999,3
1746601911839,MAE 197,002,959806,Boechler; Nicholas Sebastia,9998,0,9999,1
1746601911839,MAE 197,003,959852,Mullin; Jennifer S,9998,0,9999,1
1746601912866,MATH 2,A01,957937,Staff,33,0,35,2
1746601913895,MATH 197,001,957876,Kedlaya; Kiran S.,9993,0,9999,6
1746601914925,MCWP 40,A00,892729,Duru; Nur,10,0,20,10
1746601914925,MCWP 40,B00,893304,Montejo; Carolina,14,0,20,6
1746601915957,MCWP 40R,A00,893757,Redela; Pamela Morgan,0,5,20,20
1746601916990,MCWP 50,A00,893758,Morshed; Michael James,0,0,20,20
1746601916990,MCWP 50,B00,893761,Bartulis; Jason Michael,16,0,20,4
1746601918015,MCWP 50R,A00,893766,Compas; Sean Matthew,0,1,20,20
1746601918015,MCWP 50R,B00,893769,Carter; Jennifer A,0,1,20,20
1746601918015,MCWP 50R,C00,893771,Krone; Jarret,0,3,20,20
1746601918015,MCWP 50R,D00,893772,Miller; Elizabeth Deen,0,0,20,20
1746601918015,MCWP 50R,E00,893775,Carter; Andrea L,0,1,20,20
1746601919041,MMW 11R,A01,892721,Herbst; Matthew,14,0,30,16
1746601919041,MMW 11R,A02,892722,Herbst; Matthew,0,0,0,3
1746601920066,MMW 12R,A01,892724,Herbst; Matthew,0,11,16,16
1746601920066,MMW 12R,A02,892725,Herbst; Matthew,0,10,16,16
1746601921091,MMW 13R,A01,892727,Staff,0,4,16,16
1746601921091,MMW 13R,A02,892728,Staff,0,4,16,16
1746601921091,MMW 13R,A03,958032,Staff,0,4,16,16
1746601921091,MMW 13R,A04,958033,Staff,0,4,16,16
1746601921091,MMW 13R,A05,958034,Staff,0,4,16,16
1746601922123,SIO 295LS,A00,894015,Staff,5,0,25,20
1746601923151,SIO 295S,A00,894020,Staff,5,0,25,20
1746601924178,SIOC 290S,B01,958918,Merrifield; Mark A,14,0,30,16
1746601925204,SIOC 291S,B01,958922,Gabriel; Corey John,14,0,30,16
1746601926233,SOCI 117,A01,895339,Staff,2,0,5,3
1746601927258,WES 237B,A00,894149,Staff,11,0,20,9
1746601929323,AESE 279B,A00,891859,Staff,13,0,35,22
1746601930354,AIP 197,001,891854,Vespa; Emanuel Ignacio,9999,0,9999,0
1746601931381,ANTH 289S,A00,891856,Gagneux; Pascal,12,0,12,0
1746601932415,BENG 196,001,957946,Engler; Adam J.,9996,0,9999,3
1746601933444,BISP 197,001,959851,Wilhelm; James E.,9998,0,9999,1
1746601934469,CAT 124RS,A01,956906,Staff,6,0,25,19
1746601935495,CAT 125RS,A01,922013,Staff,6,0,25,19
1746601936521,CLRE 250,A00,891860,Morris; Sheldon,9995,0,9999,4
1746601938580,CLRE 251R,A00,907817,Mehta; Ravindra L.,9994,0,9999,5
1746601939613,CLRE 252,A00,891864,Cuomo; Raphael Eduardo,9993,0,9999,6
1746601940645,CLRE 253,A00,891867,Vaida; Florin,9994,0,9999,5
1746601940645,CLRE 253,B00,907819,Staff,9999,0,9999,0
1746601941711,CLRE 259,A00,891868,Patel; Hemal,9998,0,9999,1
1746601942739,CLRE 260,A00,891872,Cuomo; Raphael Eduardo,9999,0,9999,0
1746601943768,CLRE 297,001,891888,Cuomo; Raphael Eduardo,9999,0,9999,0
1746601944794,CSE 191,A00,958773,Minnes Kemp; Mor Mia,9995,0,9999,4
1746601945824,CSE 197,001,959846,Minnes Kemp; Mor Mia,9990,0,9999,9
1746601946861,CSS 201S,A01,892054,Mignozzetti; Umberto,25,0,30,5
1746601947887,CSS 202S,A01,892056,Mignozzetti; Umberto,25,0,30,5
1746601948913,DSC 197,001,956898,Eldridge; Justin Matthew,9996,0,9999,3
1746601949951,DSC 297,001,958000,Mazumdar; Arya,9998,0,9999,1
1746601949951,DSC 297,002,959862,Wang; Yusu,9998,0,9999,1
1746601950983,EAP 100,A00,905686,Staff,9778,0,9999,221
1746601952015,ECE 45,A01,892618,Staff,0,0,65,65
1746601954073,ECE 111,A01,892719,Staff,6,0,65,59
1746601955105,ECE 197,001,957920,Mercier; Patrick Philip,9991,0,9999,8
1746601956132,ECON 178,A01,907814,Zhu; Ying,26,0,35,9
1746601957164,EDS 115,A00,895312,Staff,35,0,45,10
1746601958194,EDS 117,A01,895337,Staff,23,0,30,7
1746601959226,EDS 125,A00,895341,Jones; Gabrielle Anastasia,36,0,45,9
1746601960262,EDS 128A,A01,895459,Fargason; Sharon Gayle,44,0,45,1
1746601961293,EDS 128B,A01,895543,Pappas; Elizabeth,44,0,45,1
1746601962321,EDS 139,A00,897203,Pappas; Elizabeth,44,0,45,1
1746601962321,EDS 139,B00,897209,Fargason; Sharon Gayle,41,0,45,4
1746601963356,EDS 201,A00,895545,Staff,22,0,45,23
1746601964393,EDS 203,A01,895581,Halter; Christopher P.,22,0,45,23
1746601965422,EDS 204R,A01,895625,Heinzman; Erica M.,39,0,45,6
1746601965422,EDS 204R,B01,895693,Halter; Christopher P.,10,0,45,35
1746601966455,EDS 206R,A00,895694,Fargason; Sharon Gayle,1,0,30,29
1746601966455,EDS 206R,B00,895695,Choi; Bailey Miyeon,16,0,30,14
1746601967487,EDS 250,A00,895697,Hemans; Patricia Ann Benitez,22,0,45,23
1746601968517,EDS 281,A00,895701,Meyerott; Theresa Ann,1,0,15,14
1746601969549,EDS 284,A00,895736,Meyerott; Theresa Ann,1,0,15,14
1746601970581,EDS 286,A00,897210,Fine; Sarah,0,0,15,15
1746601971611,EDS 289C,A01,895770,Daly; Alan J.,1,0,15,14
1746601972646,EDS 290,A00,897211,Hofstetter; Carolyn,0,0,15,15
1746601973682,LIGM 5A,A00,896162,Fischer-Grunski; Eva K,12,0,20,8
1746601974710,LIGM 5B,A00,896260,Fischer-Grunski; Eva K,17,0,20,3
1746601975736,LIGM 5C,A00,896308,Fischer-Grunski; Eva K,18,0,20,2
1746601976764,LIIT 5AS,A00,896313,Carnelos; Chiara,18,0,20,2
1746601977792,LIIT 5BS,A00,896416,Carnelos; Chiara,20,0,20,0
1746601978825,LIIT 5CS,A00,896564,Carnelos; Chiara,20,0,20,0
1746601979860,LISP 5A,A00,896588,Munoz Sanchez; Alicia,2,0,20,18
1746601980892,LISP 5B,A00,896653,Munoz Sanchez; Alicia,7,0,20,13
1746601981927,LISP 5C,A00,896655,Munoz Sanchez; Alicia,0,1,20,20
1746601982960,MAE 197,001,957918,Kleissl; Jan,9996,0,9999,3
1746601982960,MAE 197,002,959806,Boechler; Nicholas Sebastia,9998,0,9999,1
1746601982960,MAE 197,003,959852,Mullin; Jennifer S,9998,0,9999,1
1746601983991,MATH 2,A01,957937,Staff,33,0,35,2
1746601985030,MATH 197,001,957876,Kedlaya; Kiran S.,9993,0,9999,6
1746601986063,MCWP 40,A00,892729,Duru; Nur,10,0,20,10
1746601986063,MCWP 40,B00,893304,Montejo; Carolina,14,0,20,6
1746601987123,MCWP 40R,A00,893757,Redela; Pamela Morgan,0,5,20,20
1746601988150,MCWP 50,A00,893758,Morshed; Michael James,0,0,20,20
1746601988150,MCWP 50,B00,893761,Bartulis; Jason Michael,16,0,20,4
1746601989177,MCWP 50R,A00,893766,Compas; Sean Matthew,0,1,20,20
1746601989177,MCWP 50R,B00,893769,Carter; Jennifer A,0,1,20,20
1746601989177,MCWP 50R,C00,893771,Krone; Jarret,0,3,20,20
1746601989177,MCWP 50R,D00,893772,Miller; Elizabeth Deen,0,0,20,20
1746601989177,MCWP 50R,E00,893775,Carter; Andrea L,0,1,20,20
1746601990207,MMW 11R,A01,892721,Herbst; Matthew,14,0,30,16
1746601990207,MMW 11R,A02,892722,Herbst; Matthew,0,0,0,3
1746601991237,MMW 12R,A01,892724,Herbst; Matthew,0,11,16,16
1746601991237,MMW 12R,A02,892725,Herbst; Matthew,0,10,16,16
1746601992267,MMW 13R,A01,892727,Staff,0,4,16,16
1746601992267,MMW 13R,A02,892728,Staff,0,4,16,16
1746601992267,MMW 13R,A03,958032,Staff,0,4,16,16
1746601992267,MMW 13R,A04,958033,Staff,0,4,16,16
1746601992267,MMW 13R,A05,958034,Staff,0,4,16,16
1746601993297,SIO 295LS,A00,894015,Staff,5,0,25,20
1746601994332,SIO 295S,A00,894020,Staff,5,0,25,20
1746601995358,SIOC 290S,B01,958918,Merrifield; Mark A,14,0,30,16
1746601996388,SIOC 291S,B01,958922,Gabriel; Corey John,14,0,30,16
1746601997413,SOCI 117,A01,895339,Staff,2,0,5,3
1746601998448,WES 237B,A00,894149,Staff,11,0,20,9
1746602000536,AESE 279B,A00,891859,Staff,13,0,35,22
1746602001563,AIP 197,001,891854,Vespa; Emanuel Ignacio,9999,0,9999,0
1746602002594,ANTH 289S,A00,891856,Gagneux; Pascal,12,0,12,0
1746602003647,BENG 196,001,957946,Engler; Adam J.,9996,0,9999,3
1746602004679,BISP 197,001,959851,Wilhelm; James E.,9998,0,9999,1
1746602005717,CAT 124RS,A01,956906,Staff,6,0,25,19
1746602006745,CAT 125RS,A01,922013,Staff,6,0,25,19
1746602007782,CLRE 250,A00,891860,Morris; Sheldon,9995,0,9999,4
1746602009846,CLRE 251R,A00,907817,Mehta; Ravindra L.,9994,0,9999,5
1746602010873,CLRE 252,A00,891864,Cuomo; Raphael Eduardo,9993,0,9999,6
1746602011917,CLRE 253,A00,891867,Vaida; Florin,9994,0,9999,5
1746602011917,CLRE 253,B00,907819,Staff,9999,0,9999,0
1746602012950,CLRE 259,A00,891868,Patel; Hemal,9998,0,9999,1
1746602013983,CLRE 260,A00,891872,Cuomo; Raphael Eduardo,9999,0,9999,0
1746602015012,CLRE 297,001,891888,Cuomo; Raphael Eduardo,9999,0,9999,0
1746602016048,CSE 191,A00,958773,Minnes Kemp; Mor Mia,9995,0,9999,4
1746602017073,CSE 197,001,959846,Minnes Kemp; Mor Mia,9990,0,9999,9
1746602018102,CSS 201S,A01,892054,Mignozzetti; Umberto,25,0,30,5
1746602019133,CSS 202S,A01,892056,Mignozzetti; Umberto,25,0,30,5
1746602020159,DSC 197,001,956898,Eldridge; Justin Matthew,9996,0,9999,3
1746602021185,DSC 297,001,958000,Mazumdar; Arya,9998,0,9999,1
1746602021185,DSC 297,002,959862,Wang; Yusu,9998,0,9999,1
1746602022215,EAP 100,A00,905686,Staff,9778,0,9999,221
1746602023250,ECE 45,A01,892618,Staff,0,0,65,65
1746602025309,ECE 111,A01,892719,Staff,6,0,65,59
1746602026333,ECE 197,001,957920,Mercier; Patrick Philip,9991,0,9999,8
1746602027359,ECON 178,A01,907814,Zhu; Ying,26,0,35,9
1746602028387,EDS 115,A00,895312,Staff,35,0,45,10
1746602029417,EDS 117,A01,895337,Staff,23,0,30,7
1746602030441,EDS 125,A00,895341,Jones; Gabrielle Anastasia,36,0,45,9
1746602031468,EDS 128A,A01,895459,Fargason; Sharon Gayle,44,0,45,1
1746602032497,EDS 128B,A01,895543,Pappas; Elizabeth,44,0,45,1
1746602033525,EDS 139,A00,897203,Pappas; Elizabeth,44,0,45,1
1746602033525,EDS 139,B00,897209,Fargason; Sharon Gayle,41,0,45,4
1746602034549,EDS 201,A00,895545,Staff,22,0,45,23
1746602035576,EDS 203,A01,895581,Halter; Christopher P.,22,0,45,23
1746602036608,EDS 204R,A01,895625,Heinzman; Erica M.,39,0,45,6
1746602036608,EDS 204R,B01,895693,Halter; Christopher P.,10,0,45,35
1746602037639,EDS 206R,A00,895694,Fargason; Sharon Gayle,1,0,30,29
1746602037639,EDS 206R,B00,895695,Choi; Bailey Miyeon,16,0,30,14
1746602038667,EDS 250,A00,895697,Hemans; Patricia Ann Benitez,22,0,45,23
1746602039699,EDS 281,A00,895701,Meyerott; Theresa Ann,1,0,15,14
1746602040727,EDS 284,A00,895736,Meyerott; Theresa Ann,1,0,15,14
1746602041753,EDS 286,A00,897210,Fine; Sarah,0,0,15,15
1746602042782,EDS 289C,A01,895770,Daly; Alan J.,1,0,15,14
1746602043808,EDS 290,A00,897211,Hofstetter; Carolyn,0,0,15,15
1746602044837,LIGM 5A,A00,896162,Fischer-Grunski; Eva K,12,0,20,8
1746602045864,LIGM 5B,A00,896260,Fischer-Grunski; Eva K,17,0,20,3
1746602046896,LIGM 5C,A00,896308,Fischer-Grunski; Eva K,18,0,20,2
1746602047927,LIIT 5AS,A00,896313,Carnelos; Chiara,18,0,20,2
1746602048955,LIIT 5BS,A00,896416,Carnelos; Chiara,20,0,20,0
1746602049991,LIIT 5CS,A00,896564,Carnelos; Chiara,20,0,20,0
1746602051018,LISP 5A,A00,896588,Munoz Sanchez; Alicia,2,0,20,18
1746602052045,LISP 5B,A00,896653,Munoz Sanchez; Alicia,7,0,20,13
1746602053072,LISP 5C,A00,896655,Munoz Sanchez; Alicia,0,1,20,20
1746602054108,MAE 197,001,957918,Kleissl; Jan,9996,0,9999,3
1746602054108,MAE 197,002,959806,Boechler; Nicholas Sebastia,9998,0,9999,1
1746602054108,MAE 197,003,959852,Mullin; Jennifer S,9998,0,9999,1
1746602055134,MATH 2,A01,957937,Staff,33,0,35,2
1746602056161,MATH 197,001,957876,Kedlaya; Kiran S.,9993,0,9999,6
1746602057187,MCWP 40,A00,892729,Duru; Nur,10,0,20,10
1746602057187,MCWP 40,B00,893304,Montejo; Carolina,14,0,20,6
1746602058217,MCWP 40R,A00,893757,Redela; Pamela Morgan,0,5,20,20
1746602059249,MCWP 50,A00,893758,Morshed; Michael James,0,0,20,20
1746602059249,MCWP 50,B00,893761,Bartulis; Jason Michael,16,0,20,4
1746602060277,MCWP 50R,A00,893766,Compas; Sean Matthew,0,1,20,20
1746602060277,MCWP 50R,B00,893769,Carter; Jennifer A,0,1,20,20
1746602060277,MCWP 50R,C00,893771,Krone; Jarret,0,3,20,20
1746602060277,MCWP 50R,D00,893772,Miller; Elizabeth Deen,0,0,20,20
1746602060277,MCWP 50R,E00,893775,Carter; Andrea L,0,1,20,20
1746602061308,MMW 11R,A01,892721,Herbst; Matthew,14,0,30,16
1746602061308,MMW 11R,A02,892722,Herbst; Matthew,0,0,0,3
1746602062335,MMW 12R,A01,892724,Herbst; Matthew,0,11,16,16
1746602062335,MMW 12R,A02,892725,Herbst; Matthew,0,10,16,16
1746602063367,MMW 13R,A01,892727,Staff,0,4,16,16
1746602063367,MMW 13R,A02,892728,Staff,0,4,16,16
1746602063367,MMW 13R,A03,958032,Staff,0,4,16,16
1746602063367,MMW 13R,A04,958033,Staff,0,4,16,16
1746602063367,MMW 13R,A05,958034,Staff,0,4,16,16
1746602064392,SIO 295LS,A00,894015,Staff,5,0,25,20
1746602065418,SIO 295S,A00,894020,Staff,5,0,25,20
1746602066445,SIOC 290S,B01,958918,Merrifield; Mark A,14,0,30,16
1746602067473,SIOC 291S,B01,958922,Gabriel; Corey John,14,0,30,16
1746602068502,SOCI 117,A01,895339,Staff,2,0,5,3
1746602069526,WES 237B,A00,894149,Staff,11,0,20,9
1746602071587,AESE 279B,A00,891859,Staff,13,0,35,22
1746602072614,AIP 197,001,891854,Vespa; Emanuel Ignacio,9999,0,9999,0
1746602073639,ANTH 289S,A00,891856,Gagneux; Pascal,12,0,12,0
1746602074668,BENG 196,001,957946,Engler; Adam J.,9996,0,9999,3
1746602075699,BISP 197,001,959851,Wilhelm; James E.,9998,0,9999,1
1746602076732,CAT 124RS,A01,956906,Staff,6,0,25,19
1746602077762,CAT 125RS,A01,922013,Staff,6,0,25,19
1746602078789,CLRE 250,A00,891860,Morris; Sheldon,9995,0,9999,4
1746602080841,CLRE 251R,A00,907817,Mehta; Ravindra L.,9994,0,9999,5
1746602081866,CLRE 252,A00,891864,Cuomo; Raphael Eduardo,9993,0,9999,6
1746602082893,CLRE 253,A00,891867,Vaida; Florin,9994,0,9999,5
1746602082893,CLRE 253,B00,907819,Staff,9999,0,9999,0
1746602083922,CLRE 259,A00,891868,Patel; Hemal,9998,0,9999,1
1746602084952,CLRE 260,A00,891872,Cuomo; Raphael Eduardo,9999,0,9999,0
1746602085979,CLRE 297,001,891888,Cuomo; Raphael Eduardo,9999,0,9999,0
1746602087006,CSE 191,A00,958773,Minnes Kemp; Mor Mia,9995,0,9999,4
1746602088031,CSE 197,001,959846,Minnes Kemp; Mor Mia,9990,0,9999,9
1746602089063,CSS 201S,A01,892054,Mignozzetti; Umberto,25,0,30,5
1746602090103,CSS 202S,A01,892056,Mignozzetti; Umberto,25,0,30,5
1746602091135,DSC 197,001,956898,Eldridge; Justin Matthew,9996,0,9999,3
1746602092162,DSC 297,001,958000,Mazumdar; Arya,9998,0,9999,1
1746602092162,DSC 297,002,959862,Wang; Yusu,9998,0,9999,1
1746602093193,EAP 100,A00,905686,Staff,9778,0,9999,221
1746602094224,ECE 45,A01,892618,Staff,0,0,65,65
1746602096281,ECE 111,A01,892719,Staff,6,0,65,59
1746602097307,ECE 197,001,957920,Mercier; Patrick Philip,9991,0,9999,8
1746602098336,ECON 178,A01,907814,Zhu; Ying,26,0,35,9
1746602099373,EDS 115,A00,895312,Staff,35,0,45,10
1746602100399,EDS 117,A01,895337,Staff,23,0,30,7
1746602101429,EDS 125,A00,895341,Jones; Gabrielle Anastasia,36,0,45,9
1746602102458,EDS 128A,A01,895459,Fargason; Sharon Gayle,44,0,45,1
1746602103485,EDS 128B,A01,895543,Pappas; Elizabeth,44,0,45,1
1746602104512,EDS 139,A00,897203,Pappas; Elizabeth,44,0,45,1
1746602104512,EDS 139,B00,897209,Fargason; Sharon Gayle,41,0,45,4
1746602105539,EDS 201,A00,895545,Staff,22,0,45,23
1746602106572,EDS 203,A01,895581,Halter; Christopher P.,22,0,45,23
1746602107605,EDS 204R,A01,895625,Heinzman; Erica M.,39,0,45,6
1746602107605,EDS 204R,B01,895693,Halter; Christopher P.,10,0,45,35
1746602108633,EDS 206R,A00,895694,Fargason; Sharon Gayle,1,0,30,29
1746602108633,EDS 206R,B00,895695,Choi; Bailey Miyeon,16,0,30,14
1746602109659,EDS 250,A00,895697,Hemans; Patricia Ann Benitez,22,0,45,23
1746602110687,EDS 281,A00,895701,Meyerott; Theresa Ann,1,0,15,14
1746602111718,EDS 284,A00,895736,Meyerott; Theresa Ann,1,0,15,14
1746602112750,EDS 286,A00,897210,Fine; Sarah,0,0,15,15
1746602113779,EDS 289C,A01,895770,Daly; Alan J.,1,0,15,14
1746602114817,EDS 290,A00,897211,Hofstetter; Carolyn,0,0,15,15
1746602115887,LIGM 5A,A00,896162,Fischer-Grunski; Eva K,12,0,20,8
1746602116924,LIGM 5B,A00,896260,Fischer-Grunski; Eva K,17,0,20,3
1746602117955,LIGM 5C,A00,896308,Fischer-Grunski; Eva K,18,0,20,2
1746602118982,LIIT 5AS,A00,896313,Carnelos; Chiara,18,0,20,2
1746602120010,LIIT 5BS,A00,896416,Carnelos; Chiara,20,0,20,0
1746602121041,LIIT 5CS,A00,896564,Carnelos; Chiara,20,0,20,0
1746602122070,LISP 5A,A00,896588,Munoz Sanchez; Alicia,2,0,20,18
1746602123098,LISP 5B,A00,896653,Munoz Sanchez; Alicia,7,0,20,13
1746602124133,LISP 5C,A00,896655,Munoz Sanchez; Alicia,0,1,20,20
1746602125163,MAE 197,001,957918,Kleissl; Jan,9996,0,9999,3
1746602125163,MAE 197,002,959806,Boechler; Nicholas Sebastia,9998,0,9999,1
1746602125163,MAE 197,003,959852,Mullin; Jennifer S,9998,0,9999,1
1746602126192,MATH 2,A01,957937,Staff,33,0,35,2
1746602127223,MATH 197,001,957876,Kedlaya; Kiran S.,9993,0,9999,6
1746602128252,MCWP 40,A00,892729,Duru; Nur,10,0,20,10
1746602128252,MCWP 40,B00,893304,Montejo; Carolina,14,0,20,6
1746602129279,MCWP 40R,A00,893757,Redela; Pamela Morgan,0,5,20,20
1746602130305,MCWP 50,A00,893758,Morshed; Michael James,0,0,20,20
1746602130305,MCWP 50,B00,893761,Bartulis; Jason Michael,16,0,20,4
1746602131330,MCWP 50R,A00,893766,Compas; Sean Matthew,0,1,20,20
1746602131330,MCWP 50R,B00,893769,Carter; Jennifer A,0,1,20,20
1746602131330,MCWP 50R,C00,893771,Krone; Jarret,0,3,20,20
1746602131330,MCWP 50R,D00,893772,Miller; Elizabeth Deen,0,0,20,20
1746602131330,MCWP 50R,E00,893775,Carter; Andrea L,0,1,20,20
1746602132360,MMW 11R,A01,892721,Herbst; Matthew,14,0,30,16
1746602132360,MMW 11R,A02,892722,Herbst; Matthew,0,0,0,3
1746602133386,MMW 12R,A01,892724,Herbst; Matthew,0,11,16,16
1746602133386,MMW 12R,A02,892725,Herbst; Matthew,0,10,16,16
1746602134418,MMW 13R,A01,892727,Staff,0,4,16,16
1746602134418,MMW 13R,A02,892728,Staff,0,4,16,16
1746602134418,MMW 13R,A03,958032,Staff,0,4,16,16
1746602134418,MMW 13R,A04,958033,Staff,0,4,16,16
1746602134418,MMW 13R,A05,958034,Staff,0,4,16,16
1746602135447,SIO 295LS,A00,894015,Staff,5,0,25,20
1746602136478,SIO 295S,A00,894020,Staff,5,0,25,20
1746602137508,SIOC 290S,B01,958918,Merrifield; Mark A,14,0,30,16
1746602138538,SIOC 291S,B01,958922,Gabriel; Corey John,14,0,30,16
1746602139565,SOCI 117,A01,895339,Staff,2,0,5,3
1746602140594,WES 237B,A00,894149,Staff,11,0,20,9
1746602142664,AESE 279B,A00,891859,Staff,13,0,35,22
1746602143689,AIP 197,001,891854,Vespa; Emanuel Ignacio,9999,0,9999,0
1746602144719,ANTH 289S,A00,891856,Gagneux; Pascal,12,0,12,0
1746602145746,BENG 196,001,957946,Engler; Adam J.,9996,0,9999,3
1746602146773,BISP 197,001,959851,Wilhelm; James E.,9998,0,9999,1
1746602147802,CAT 124RS,A01,956906,Staff,6,0,25,19
1746602148833,CAT 125RS,A01,922013,Staff,6,0,25,19
1746602149879,CLRE 250,A00,891860,Morris; Sheldon,9995,0,9999,4
1746602151937,CLRE 251R,A00,907817,Mehta; Ravindra L.,9994,0,9999,5
1746602152966,CLRE 252,A00,891864,Cuomo; Raphael Eduardo,9993,0,9999,6
1746602154001,CLRE 253,A00,891867,Vaida; Florin,9994,0,9999,5
1746602154001,CLRE 253,B00,907819,Staff,9999,0,9999,0
1746602155038,CLRE 259,A00,891868,Patel; Hemal,9998,0,9999,1
1746602156064,CLRE 260,A00,891872,Cuomo; Raphael Eduardo,9999,0,9999,0
1746602157090,CLRE 297,001,891888,Cuomo; Raphael Eduardo,9999,0,9999,0
1746602158116,CSE 191,A00,958773,Minnes Kemp; Mor Mia,9995,0,9999,4
1746602159225,CSE 197,001,959846,Minnes Kemp; Mor Mia,9990,0,9999,9
1746602160258,CSS 201S,A01,892054,Mignozzetti; Umberto,25,0,30,5
1746602161290,CSS 202S,A01,892056,Mignozzetti; Umberto,25,0,30,5
1746602162330,DSC 197,001,956898,Eldridge; Justin Matthew,9996,0,9999,3
1746602163364,DSC 297,001,958000,Mazumdar; Arya,9998,0,9999,1
1746602163364,DSC 297,002,959862,Wang; Yusu,9998,0,9999,1
1746602164391,EAP 100,A00,905686,Staff,9778,0,9999,221
1746602165424,ECE 45,A01,892618,Staff,0,0,65,65
1746602167479,ECE 111,A01,892719,Staff,6,0,65,59
1746602168510,ECE 197,001,957920,Mercier; Patrick Philip,9991,0,9999,8
1746602169541,ECON 178,A01,907814,Zhu; Ying,26,0,35,9
1746602170567,EDS 115,A00,895312,Staff,35,0,45,10
1746602171594,EDS 117,A01,895337,Staff,23,0,30,7
1746602172620,EDS 125,A00,895341,Jones; Gabrielle Anastasia,36,0,45,9
1746602173646,EDS 128A,A01,895459,Fargason; Sharon Gayle,44,0,45,1
1746602174673,EDS 128B,A01,895543,Pappas; Elizabeth,44,0,45,1
1746602175701,EDS 139,A00,897203,Pappas; Elizabeth,44,0,45,1
1746602175701,EDS 139,B00,897209,Fargason; Sharon Gayle,41,0,45,4
1746602176724,EDS 201,A00,895545,Staff,22,0,45,23
1746602177753,EDS 203,A01,895581,Halter; Christopher P.,22,0,45,23
1746602178785,EDS 204R,A01,895625,Heinzman; Erica M.,39,0,45,6
1746602178785,EDS 204R,B01,895693,Halter; Christopher P.,10,0,45,35
1746602179809,EDS 206R,A00,895694,Fargason; Sharon Gayle,1,0,30,29
1746602179809,EDS 206R,B00,895695,Choi; Bailey Miyeon,16,0,30,14
1746602180838,EDS 250,A00,895697,Hemans; Patricia Ann Benitez,22,0,45,23
1746602181864,EDS 281,A00,895701,Meyerott; Theresa Ann,1,0,15,14
1746602182893,EDS 284,A00,895736,Meyerott; Theresa Ann,1,0,15,14
1746602183920,EDS 286,A00,897210,Fine; Sarah,0,0,15,15
1746602184948,EDS 289C,A01,895770,Daly; Alan J.,1,0,15,14
1746602185976,EDS 290,A00,897211,Hofstetter; Carolyn,0,0,15,15
1746602187007,LIGM 5A,A00,896162,Fischer-Grunski; Eva K,12,0,20,8
1746602188034,LIGM 5B,A00,896260,Fischer-Grunski; Eva K,17,0,20,3
1746602189062,LIGM 5C,A00,896308,Fischer-Grunski; Eva K,18,0,20,2
1746602190093,LIIT 5AS,A00,896313,Carnelos; Chiara,18,0,20,2
1746602191121,LIIT 5BS,A00,896416,Carnelos; Chiara,20,0,20,0
1746602192148,LIIT 5CS,A00,896564,Carnelos; Chiara,20,0,20,0
1746602193181,LISP 5A,A00,896588,Munoz Sanchez; Alicia,2,0,20,18
1746602194206,LISP 5B,A00,896653,Munoz Sanchez; Alicia,7,0,20,13
1746602195237,LISP 5C,A00,896655,Munoz Sanchez; Alicia,0,1,20,20
1746602196267,MAE 197,001,957918,Kleissl; Jan,9996,0,9999,3
1746602196267,MAE 197,002,959806,Boechler; Nicholas Sebastia,9998,0,9999,1
1746602196267,MAE 197,003,959852,Mullin; Jennifer S,9998,0,9999,1
1746602197292,MATH 2,A01,957937,Staff,33,0,35,2
1746602198317,MATH 197,001,957876,Kedlaya; Kiran S.,9993,0,9999,6
1746602199349,MCWP 40,A00,892729,Duru; Nur,10,0,20,10
1746602199349,MCWP 40,B00,893304,Montejo; Carolina,14,0,20,6
1746602200373,MCWP 40R,A00,893757,Redela; Pamela Morgan,0,5,20,20
1746602201398,MCWP 50,A00,893758,Morshed; Michael James,0,0,20,20
1746602201398,MCWP 50,B00,893761,Bartulis; Jason Michael,16,0,20,4
1746602202429,MCWP 50R,A00,893766,Compas; Sean Matthew,0,1,20,20
1746602202429,MCWP 50R,B00,893769,Carter; Jennifer A,0,1,20,20
1746602202429,MCWP 50R,C00,893771,Krone; Jarret,0,3,20,20
1746602202429,MCWP 50R,D00,893772,Miller; Elizabeth Deen,0,0,20,20
1746602202429,MCWP 50R,E00,893775,Carter; Andrea L,0,1,20,20
1746602203454,MMW 11R,A01,892721,Herbst; Matthew,14,0,30,16
1746602203454,MMW 11R,A02,892722,Herbst; Matthew,0,0,0,3
1746602204484,MMW 12R,A01,892724,Herbst; Matthew,0,11,16,16
1746602204484,MMW 12R,A02,892725,Herbst; Matthew,0,10,16,16
1746602205513,MMW 13R,A01,892727,Staff,0,4,16,16
1746602205513,MMW 13R,A02,892728,Staff,0,4,16,16
1746602205513,MMW 13R,A03,958032,Staff,0,4,16,16
1746602205513,MMW 13R,A04,958033,Staff,0,4,16,16
1746602205513,MMW 13R,A05,958034,Staff,0,4,16,16
1746602206537,SIO 295LS,A00,894015,Staff,5,0,25,20
1746602207563,SIO 295S,A00,894020,Staff,5,0,25,20
1746602208594,SIOC 290S,B01,958918,Merrifield; Mark A,14,0,30,16
1746602209619,SIOC 291S,B01,958922,Gabriel; Corey John,14,0,30,16
1746602210645,SOCI 117,A01,895339,Staff,2,0,5,3
1746602211675,WES 237B,A00,894149,Staff,11,0,20,9
1746602213763,AESE 279B,A00,891859,Staff,13,0,35,22
1746602214789,AIP 197,001,891854,Vespa; Emanuel Ignacio,9999,0,9999,0
1746602215827,ANTH 289S,A00,891856,Gagneux; Pascal,12,0,12,0
1746602216856,BENG 196,001,957946,Engler; Adam J.,9996,0,9999,3
1746602217885,BISP 197,001,959851,Wilhelm; James E.,9998,0,9999,1
1746602218916,CAT 124RS,A01,956906,Staff,6,0,25,19
1746602220001,CAT 125RS,A01,922013,Staff,6,0,25,19
1746602221025,CLRE 250,A00,891860,Morris; Sheldon,9995,0,9999,4
1746602223080,CLRE 251R,A00,907817,Mehta; Ravindra L.,9994,0,9999,5
1746602224106,CLRE 252,A00,891864,Cuomo; Raphael Eduardo,9993,0,9999,6
1746602225132,CLRE 253,A00,891867,Vaida; Florin,9994,0,9999,5
1746602225132,CLRE 253,B00,907819,Staff,9999,0,9999,0
1746602226163,CLRE 259,A00,891868,Patel; Hemal,9998,0,9999,1
1746602227192,CLRE 260,A00,891872,Cuomo; Raphael Eduardo,9999,0,9999,0
1746602228217,CLRE 297,001,891888,Cuomo; Raphael Eduardo,9999,0,9999,0
1746602229247,CSE 191,A00,958773,Minnes Kemp; Mor Mia,9995,0,9999,4
1746602230277,CSE 197,001,959846,Minnes Kemp; Mor Mia,9990,0,9999,9
1746602231302,CSS 201S,A01,892054,Mignozzetti; Umberto,25,0,30,5
1746602232330,CSS 202S,A01,892056,Mignozzetti; Umberto,25,0,30,5
1746602233358,DSC 197,001,956898,Eldridge; Justin Matthew,9996,0,9999,3
1746602234389,DSC 297,001,958000,Mazumdar; Arya,9998,0,9999,1
1746602234389,DSC 297,002,959862,Wang; Yusu,9998,0,9999,1
1746602235416,EAP 100,A00,905686,Staff,9778,0,9999,221
1746602236441,ECE 45,A01,892618,Staff,0,0,65,65
1746602238494,ECE 111,A01,892719,Staff,6,0,65,59
1746602239518,ECE 197,001,957920,Mercier; Patrick Philip,9991,0,9999,8
1746602240549,ECON 178,A01,907814,Zhu; Ying,26,0,35,9
1746602241576,EDS 115,A00,895312,Staff,35,0,45,10
1746602242602,EDS 117,A01,895337,Staff,23,0,30,7
1746602243627,EDS 125,A00,895341,Jones; Gabrielle Anastasia,36,0,45,9
1746602244656,EDS 128A,A01,895459,Fargason; Sharon Gayle,44,0,45,1
1746602245682,EDS 128B,A01,895543,Pappas; Elizabeth,44,0,45,1
1746602246709,EDS 139,A00,897203,Pappas; Elizabeth,44,0,45,1
1746602246709,EDS 139,B00,897209,Fargason; Sharon Gayle,41,0,45,4
1746602247735,EDS 201,A00,895545,Staff,22,0,45,23
1746602248765,EDS 203,A01,895581,Halter; Christopher P.,22,0,45,23
1746602249790,EDS 204R,A01,895625,Heinzman; Erica M.,39,0,45,6
1746602249790,EDS 204R,B01,895693,Halter; Christopher P.,10,0,45,35
1746602250817,EDS 206R,A00,895694,Fargason; Sharon Gayle,1,0,30,29
1746602250817,EDS 206R,B00,895695,Choi; Bailey Miyeon,16,0,30,14
1746602251848,EDS 250,A00,895697,Hemans; Patricia Ann Benitez,22,0,45,23
1746602252873,EDS 281,A00,895701,Meyerott; Theresa Ann,1,0,15,14
1746602253899,EDS 284,A00,895736,Meyerott; Theresa Ann,1,0,15,14
1746602254928,EDS 286,A00,897210,Fine; Sarah,0,0,15,15
1746602255957,EDS 289C,A01,895770,Daly; Alan J.,1,0,15,14
1746602256984,EDS 290,A00,897211,Hofstetter; Carolyn,0,0,15,15
1746602258011,LIGM 5A,A00,896162,Fischer-Grunski; Eva K,12,0,20,8
1746602259042,LIGM 5B,A00,896260,Fischer-Grunski; Eva K,17,0,20,3
1746602260067,LIGM 5C,A00,896308,Fischer-Grunski; Eva K,18,0,20,2
1746602261093,LIIT 5AS,A00,896313,Carnelos; Chiara,18,0,20,2
1746602262126,LIIT 5BS,A00,896416,Carnelos; Chiara,20,0,20,0
1746602263158,LIIT 5CS,A00,896564,Carnelos; Chiara,20,0,20,0
1746602264187,LISP 5A,A00,896588,Munoz Sanchez; Alicia,2,0,20,18
1746602265217,LISP 5B,A00,896653,Munoz Sanchez; Alicia,7,0,20,13
1746602266243,LISP 5C,A00,896655,Munoz Sanchez; Alicia,0,1,20,20
1746602267271,MAE 197,001,957918,Kleissl; Jan,9996,0,9999,3
1746602267271,MAE 197,002,959806,Boechler; Nicholas Sebastia,9998,0,9999,1
1746602267271,MAE 197,003,959852,Mullin; Jennifer S,9998,0,9999,1
1746602268302,MATH 2,A01,957937,Staff,33,0,35,2
1746602269327,MATH 197,001,957876,Kedlaya; Kiran S.,9993,0,9999,6
1746602270353,MCWP 40,A00,892729,Duru; Nur,10,0,20,10
1746602270353,MCWP 40,B00,893304,Montejo; Carolina,14,0,20,6
1746602271379,MCWP 40R,A00,893757,Redela; Pamela Morgan,0,5,20,20
1746602272416,MCWP 50,A00,893758,Morshed; Michael James,0,0,20,20
1746602272416,MCWP 50,B00,893761,Bartulis; Jason Michael,16,0,20,4
1746602273449,MCWP 50R,A00,893766,Compas; Sean Matthew,0,1,20,20
1746602273449,MCWP 50R,B00,893769,Carter; Jennifer A,0,1,20,20
1746602273449,MCWP 50R,C00,893771,Krone; Jarret,0,3,20,20
1746602273449,MCWP 50R,D00,893772,Miller; Elizabeth Deen,0,0,20,20
1746602273449,MCWP 50R,E00,893775,Carter; Andrea L,0,1,20,20
1746602274475,MMW 11R,A01,892721,Herbst; Matthew,14,0,30,16
1746602274475,MMW 11R,A02,892722,Herbst; Matthew,0,0,0,3
1746602275504,MMW 12R,A01,892724,Herbst; Matthew,0,11,16,16
1746602275504,MMW 12R,A02,892725,Herbst; Matthew,0,10,16,16
1746602276533,MMW 13R,A01,892727,Staff,0,4,16,16
1746602276533,MMW 13R,A02,892728,Staff,0,4,16,16
1746602276533,MMW 13R,A03,958032,Staff,0,4,16,16
1746602276533,MMW 13R,A04,958033,Staff,0,4,16,16
1746602276533,MMW 13R,A05,958034,Staff,0,4,16,16
1746602277562,SIO 295LS,A00,894015,Staff,5,0,25,20
1746602278593,SIO 295S,A00,894020,Staff,5,0,25,20
1746602279622,SIOC 290S,B01,958918,Merrifield; Mark A,14,0,30,16
1746602280649,SIOC 291S,B01,958922,Gabriel; Corey John,14,0,30,16
1746602281677,SOCI 117,A01,895339,Staff,2,0,5,3
1746602282703,WES 237B,A00,894149,Staff,11,0,20,9
1746602284792,AESE 279B,A00,891859,Staff,13,0,35,22
1746602285822,AIP 197,001,891854,Vespa; Emanuel Ignacio,9999,0,9999,0
1746602286849,ANTH 289S,A00,891856,Gagneux; Pascal,12,0,12,0
1746602287875,BENG 196,001,957946,Engler; Adam J.,9996,0,9999,3
1746602288905,BISP 197,001,959851,Wilhelm; James E.,9998,0,9999,1
1746602289935,CAT 124RS,A01,956906,Staff,6,0,25,19
1746602290962,CAT 125RS,A01,922013,Staff,6,0,25,19
1746602291991,CLRE 250,A00,891860,Morris; Sheldon,9995,0,9999,4
1746602294047,CLRE 251R,A00,907817,Mehta; Ravindra L.,9994,0,9999,5
1746602295072,CLRE 252,A00,891864,Cuomo; Raphael Eduardo,9993,0,9999,6
1746602296102,CLRE 253,A00,891867,Vaida; Florin,9994,0,9999,5
1746602296102,CLRE 253,B00,907819,Staff,9999,0,9999,0
1746602297128,CLRE 259,A00,891868,Patel; Hemal,9998,0,9999,1
1746602298153,CLRE 260,A00,891872,Cuomo; Raphael Eduardo,9999,0,9999,0
1746602299178,CLRE 297,001,891888,Cuomo; Raphael Eduardo,9999,0,9999,0
1746602300207,CSE 191,A00,958773,Minnes Kemp; Mor Mia,9995,0,9999,4
1746602301234,CSE 197,001,959846,Minnes Kemp; Mor Mia,9990,0,9999,9
1746602302261,CSS 201S,A01,892054,Mignozzetti; Umberto,25,0,30,5
1746602303291,CSS 202S,A01,892056,Mignozzetti; Umberto,25,0,30,5
1746602304317,DSC 197,001,956898,Eldridge; Justin Matthew,9996,0,9999,3
1746602305347,DSC 297,001,958000,Mazumdar; Arya,9998,0,9999,1
1746602305347,DSC 297,002,959862,Wang; Yusu,9998,0,9999,1
1746602306403,EAP 100,A00,905686,Staff,9778,0,9999,221
1746602307430,ECE 45,A01,892618,Staff,0,0,65,65
1746602309488,ECE 111,A01,892719,Staff,6,0,65,59
1746602310512,ECE 197,001,957920,Mercier; Patrick Philip,9991,0,9999,8
1746602311541,ECON 178,A01,907814,Zhu; Ying,26,0,35,9
1746602312568,EDS 115,A00,895312,Staff,35,0,45,10
1746602313595,EDS 117,A01,895337,Staff,23,0,30,7
1746602314621,EDS 125,A00,895341,Jones; Gabrielle Anastasia,36,0,45,9
1746602315646,EDS 128A,A01,895459,Fargason; Sharon Gayle,44,0,45,1
1746602316673,EDS 128B,A01,895543,Pappas; Elizabeth,44,0,45,1
1746602317699,EDS 139,A00,897203,Pappas; Elizabeth,44,0,45,1
1746602317699,EDS 139,B00,897209,Fargason; Sharon Gayle,41,0,45,4
1746602318725,EDS 201,A00,895545,Staff,22,0,45,23
1746602319753,EDS 203,A01,895581,Halter; Christopher P.,22,0,45,23
1746602320779,EDS 204R,A01,895625,Heinzman; Erica M.,39,0,45,6
1746602320779,EDS 204R,B01,895693,Halter; Christopher P.,10,0,45,35
1746602321804,EDS 206R,A00,895694,Fargason; Sharon Gayle,1,0,30,29
1746602321804,EDS 206R,B00,895695,Choi; Bailey Miyeon,16,0,30,14
1746602322829,EDS 250,A00,895697,Hemans; Patricia Ann Benitez,22,0,45,23
1746602323860,EDS 281,A00,895701,Meyerott; Theresa Ann,1,0,15,14
1746602324885,EDS 284,A00,895736,Meyerott; Theresa Ann,1,0,15,14
1746602325909,EDS 286,A00,897210,Fine; Sarah,0,0,15,15
1746602326936,EDS 289C,A01,895770,Daly; Alan J.,1,0,15,14
1746602327963,EDS 290,A00,897211,Hofstetter; Carolyn,0,0,15,15
1746602328990,LIGM 5A,A00,896162,Fischer-Grunski; Eva K,12,0,20,8
1746602330027,LIGM 5B,A00,896260,Fischer-Grunski; Eva K,17,0,20,3
1746602331053,LIGM 5C,A00,896308,Fischer-Grunski; Eva K,18,0,20,2
1746602332081,LIIT 5AS,A00,896313,Carnelos; Chiara,18,0,20,2
1746602333108,LIIT 5BS,A00,896416,Carnelos; Chiara,20,0,20,0
1746602334137,LIIT 5CS,A00,896564,Carnelos; Chiara,20,0,20,0
1746602335163,LISP 5A,A00,896588,Munoz Sanchez; Alicia,2,0,20,18
1746602336188,LISP 5B,A00,896653,Munoz Sanchez; Alicia,7,0,20,13
1746602337218,LISP 5C,A00,896655,Munoz Sanchez; Alicia,0,1,20,20
1746602338243,MAE 197,001,957918,Kleissl; Jan,9996,0,9999,3
1746602338243,MAE 197,002,959806,Boechler; Nicholas Sebastia,9998,0,9999,1
1746602338243,MAE 197,003,959852,Mullin; Jennifer S,9998,0,9999,1
1746602339274,MATH 2,A01,957937,Staff,33,0,35,2
1746602340304,MATH 197,001,957876,Kedlaya; Kiran S.,9993,0,9999,6
1746602341333,MCWP 40,A00,892729,Duru; Nur,10,0,20,10
1746602341333,MCWP 40,B00,893304,Montejo; Carolina,14,0,20,6
1746602342366,MCWP 40R,A00,893757,Redela; Pamela Morgan,0,5,20,20
1746602343392,MCWP 50,A00,893758,Morshed; Michael James,0,0,20,20
1746602343392,MCWP 50,B00,893761,Bartulis; Jason Michael,16,0,20,4
1746602344418,MCWP 50R,A00,893766,Compas; Sean Matthew,0,1,20,20
1746602344418,MCWP 50R,B00,893769,Carter; Jennifer A,0,1,20,20
1746602344418,MCWP 50R,C00,893771,Krone; Jarret,0,3,20,20
1746602344418,MCWP 50R,D00,893772,Miller; Elizabeth Deen,0,0,20,20
1746602344418,MCWP 50R,E00,893775,Carter; Andrea L,0,1,20,20
1746602345453,MMW 11R,A01,892721,Herbst; Matthew,14,0,30,16
1746602345453,MMW 11R,A02,892722,Herbst; Matthew,0,0,0,3
1746602346477,MMW 12R,A01,892724,Herbst; Matthew,0,11,16,16
1746602346477,MMW 12R,A02,892725,Herbst; Matthew,0,10,16,16
1746602347504,MMW 13R,A01,892727,Staff,0,4,16,16
1746602347504,MMW 13R,A02,892728,Staff,0,4,16,16
1746602347504,MMW 13R,A03,958032,Staff,0,4,16,16
1746602347504,MMW 13R,A04,958033,Staff,0,4,16,16
1746602347504,MMW 13R,A05,958034,Staff,0,4,16,16
1746602348531,SIO 295LS,A00,894015,Staff,5,0,25,20
1746602349560,SIO 295S,A00,894020,Staff,5,0,25,20
1746602350586,SIOC 290S,B01,958918,Merrifield; Mark A,14,0,30,16
1746602351611,SIOC 291S,B01,958922,Gabriel; Corey John,14,0,30,16
1746602352636,SOCI 117,A01,895339,Staff,2,0,5,3
1746602353662,WES 237B,A00,894149,Staff,11,0,20,9
1746602355734,AESE 279B,A00,891859,Staff,13,0,35,22
1746602356759,AIP 197,001,891854,Vespa; Emanuel Ignacio,9999,0,9999,0
1746602357784,ANTH 289S,A00,891856,Gagneux; Pascal,12,0,12,0
1746602358809,BENG 196,001,957946,Engler; Adam J.,9996,0,9999,3
1746602359839,BISP 197,001,959851,Wilhelm; James E.,9998,0,9999,1
1746602360865,CAT 124RS,A01,956906,Staff,6,0,25,19
1746602361890,CAT 125RS,A01,922013,Staff,6,0,25,19
1746602362917,CLRE 250,A00,891860,Morris; Sheldon,9995,0,9999,4
1746602364968,CLRE 251R,A00,907817,Mehta; Ravindra L.,9994,0,9999,5
1746602366003,CLRE 252,A00,891864,Cuomo; Raphael Eduardo,9993,0,9999,6
1746602367028,CLRE 253,A00,891867,Vaida; Florin,9994,0,9999,5
1746602367028,CLRE 253,B00,907819,Staff,9999,0,9999,0
1746602368054,CLRE 259,A00,891868,Patel; Hemal,9998,0,9999,1
1746602369082,CLRE 260,A00,891872,Cuomo; Raphael Eduardo,9999,0,9999,0
1746602370107,CLRE 297,001,891888,Cuomo; Raphael Eduardo,9999,0,9999,0
1746602371135,CSE 191,A00,958773,Minnes Kemp; Mor Mia,9995,0,9999,4
1746602372160,CSE 197,001,959846,Minnes Kemp; Mor Mia,9990,0,9999,9
1746602373186,CSS 201S,A01,892054,Mignozzetti; Umberto,25,0,30,5
1746602374213,CSS 202S,A01,892056,Mignozzetti; Umberto,25,0,30,5
1746602375241,DSC 197,001,956898,Eldridge; Justin Matthew,9996,0,9999,3
1746602376269,DSC 297,001,958000,Mazumdar; Arya,9998,0,9999,1
1746602376269,DSC 297,002,959862,Wang; Yusu,9998,0,9999,1
1746602377296,EAP 100,A00,905686,Staff,9778,0,9999,221
1746602378323,ECE 45,A01,892618,Staff,0,0,65,65
1746602380380,ECE 111,A01,892719,Staff,6,0,65,59
1746602381406,ECE 197,001,957920,Mercier; Patrick Philip,9991,0,9999,8
1746602382432,ECON 178,A01,907814,Zhu; Ying,26,0,35,9
1746602383464,EDS 115,A00,895312,Staff,35,0,45,10
1746602384492,EDS 117,A01,895337,Staff,23,0,30,7
1746602385544,EDS 125,A00,895341,Jones; Gabrielle Anastasia,36,0,45,9
1746602386571,EDS 128A,A01,895459,Fargason; Sharon Gayle,44,0,45,1
1746602387595,EDS 128B,A01,895543,Pappas; Elizabeth,44,0,45,1
1746602388624,EDS 139,A00,897203,Pappas; Elizabeth,44,0,45,1
1746602388624,EDS 139,B00,897209,Fargason; Sharon Gayle,41,0,45,4
1746602389650,EDS 201,A00,895545,Staff,22,0,45,23
1746602390677,EDS 203,A01,895581,Halter; Christopher P.,22,0,45,23
1746602391703,EDS 204R,A01,895625,Heinzman; Erica M.,39,0,45,6
1746602391703,EDS 204R,B01,895693,Halter; Christopher P.,10,0,45,35
1746602392731,EDS 206R,A00,895694,Fargason; Sharon Gayle,1,0,30,29
1746602392731,EDS 206R,B00,895695,Choi; Bailey Miyeon,16,0,30,14
1746602393764,EDS 250,A00,895697,Hemans; Patricia Ann Benitez,22,0,45,23
1746602394789,EDS 281,A00,895701,Meyerott; Theresa Ann,1,0,15,14
1746602395815,EDS 284,A00,895736,Meyerott; Theresa Ann,1,0,15,14
1746602396841,EDS 286,A00,897210,Fine; Sarah,0,0,15,15
1746602397868,EDS 289C,A01,895770,Daly; Alan J.,1,0,15,14
1746602398894,EDS 290,A00,897211,Hofstetter; Carolyn,0,0,15,15
1746602399923,LIGM 5A,A00,896162,Fischer-Grunski; Eva K,12,0,20,8
1746602400949,LIGM 5B,A00,896260,Fischer-Grunski; Eva K,17,0,20,3
1746602401977,LIGM 5C,A00,896308,Fischer-Grunski; Eva K,18,0,20,2
1746602403007,LIIT 5AS,A00,896313,Carnelos; Chiara,18,0,20,2
1746602404037,LIIT 5BS,A00,896416,Carnelos; Chiara,20,0,20,0
1746602405063,LIIT 5CS,A00,896564,Carnelos; Chiara,20,0,20,0
1746602406093,LISP 5A,A00,896588,Munoz Sanchez; Alicia,2,0,20,18
1746602407119,LISP 5B,A00,896653,Munoz Sanchez; Alicia,7,0,20,13
1746602408147,LISP 5C,A00,896655,Munoz Sanchez; Alicia,0,1,20,20
1746602409174,MAE 197,001,957918,Kleissl; Jan,9996,0,9999,3
1746602409174,MAE 197,002,959806,Boechler; Nicholas Sebastia,9998,0,9999,1
1746602409174,MAE 197,003,959852,Mullin; Jennifer S,9998,0,9999,1
1746602410203,MATH 2,A01,957937,Staff,33,0,35,2
1746602411234,MATH 197,001,957876,Kedlaya; Kiran S.,9993,0,9999,6
1746602412259,MCWP 40,A00,892729,Duru; Nur,10,0,20,10
1746602412259,MCWP 40,B00,893304,Montejo; Carolina,14,0,20,6
1746602413284,MCWP 40R,A00,893757,Redela; Pamela Morgan,0,5,20,20
1746602414314,MCWP 50,A00,893758,Morshed; Michael James,0,0,20,20
1746602414314,MCWP 50,B00,893761,Bartulis; Jason Michael,16,0,20,4
1746602415868,MCWP 50R,A00,893766,Compas; Sean Matthew,0,1,20,20
1746602415868,MCWP 50R,B00,893769,Carter; Jennifer A,0,1,20,20
1746602415868,MCWP 50R,C00,893771,Krone; Jarret,0,3,20,20
1746602415868,MCWP 50R,D00,893772,Miller; Elizabeth Deen,0,0,20,20
1746602415868,MCWP 50R,E00,893775,Carter; Andrea L,0,1,20,20
1746602416897,MMW 11R,A01,892721,Herbst; Matthew,14,0,30,16
1746602416897,MMW 11R,A02,892722,Herbst; Matthew,0,0,0,3
1746602417925,MMW 12R,A01,892724,Herbst; Matthew,0,11,16,16
1746602417925,MMW 12R,A02,892725,Herbst; Matthew,0,10,16,16
1746602418952,MMW 13R,A01,892727,Staff,0,4,16,16
1746602418952,MMW 13R,A02,892728,Staff,0,4,16,16
1746602418952,MMW 13R,A03,958032,Staff,0,4,16,16
1746602418952,MMW 13R,A04,958033,Staff,0,4,16,16
1746602418952,MMW 13R,A05,958034,Staff,0,4,16,16
1746602419990,SIO 295LS,A00,894015,Staff,5,0,25,20
1746602421018,SIO 295S,A00,894020,Staff,5,0,25,20
1746602422046,SIOC 290S,B01,958918,Merrifield; Mark A,14,0,30,16
1746602423075,SIOC 291S,B01,958922,Gabriel; Corey John,14,0,30,16
1746602424099,SOCI 117,A01,895339,Staff,2,0,5,3
1746602425128,WES 237B,A00,894149,Staff,11,0,20,9
1746602427198,AESE 279B,A00,891859,Staff,13,0,35,22
1746602428223,AIP 197,001,891854,Vespa; Emanuel Ignacio,9999,0,9999,0
1746602429248,ANTH 289S,A00,891856,Gagneux; Pascal,12,0,12,0
1746602430274,BENG 196,001,957946,Engler; Adam J.,9996,0,9999,3
1746602431300,BISP 197,001,959851,Wilhelm; James E.,9998,0,9999,1
1746602432325,CAT 124RS,A01,956906,Staff,6,0,25,19
1746602433351,CAT 125RS,A01,922013,Staff,6,0,25,19
1746602434375,CLRE 250,A00,891860,Morris; Sheldon,9995,0,9999,4
1746602436429,CLRE 251R,A00,907817,Mehta; Ravindra L.,9994,0,9999,5
1746602438030,CLRE 252,A00,891864,Cuomo; Raphael Eduardo,9993,0,9999,6
1746602439056,CLRE 253,A00,891867,Vaida; Florin,9994,0,9999,5
1746602439056,CLRE 253,B00,907819,Staff,9999,0,9999,0
1746602440082,CLRE 259,A00,891868,Patel; Hemal,9998,0,9999,1
1746602441108,CLRE 260,A00,891872,Cuomo; Raphael Eduardo,9999,0,9999,0
1746602442135,CLRE 297,001,891888,Cuomo; Raphael Eduardo,9999,0,9999,0
1746602443162,CSE 191,A00,958773,Minnes Kemp; Mor Mia,9995,0,9999,4
1746602444199,CSE 197,001,959846,Minnes Kemp; Mor Mia,9990,0,9999,9
1746602445229,CSS 201S,A01,892054,Mignozzetti; Umberto,25,0,30,5
1746602446255,CSS 202S,A01,892056,Mignozzetti; Umberto,25,0,30,5
1746602447280,DSC 197,001,956898,Eldridge; Justin Matthew,9996,0,9999,3
1746602448308,DSC 297,001,958000,Mazumdar; Arya,9998,0,9999,1
1746602448308,DSC 297,002,959862,Wang; Yusu,9998,0,9999,1
1746602449337,EAP 100,A00,905686,Staff,9778,0,9999,221
1746602450369,ECE 45,A01,892618,Staff,0,0,65,65
1746602452423,ECE 111,A01,892719,Staff,6,0,65,59
1746602453453,ECE 197,001,957920,Mercier; Patrick Philip,9991,0,9999,8
1746602454481,ECON 178,A01,907814,Zhu; Ying,26,0,35,9
1746602455510,EDS 115,A00,895312,Staff,35,0,45,10
1746602456536,EDS 117,A01,895337,Staff,23,0,30,7
1746602457564,EDS 125,A00,895341,Jones; Gabrielle Anastasia,36,0,45,9
1746602458592,EDS 128A,A01,895459,Fargason; Sharon Gayle,44,0,45,1
1746602459622,EDS 128B,A01,895543,Pappas; Elizabeth,44,0,45,1
1746602460648,EDS 139,A00,897203,Pappas; Elizabeth,44,0,45,1
1746602460648,EDS 139,B00,897209,Fargason; Sharon Gayle,41,0,45,4
1746602461675,EDS 201,A00,895545,Staff,22,0,45,23
1746602462705,EDS 203,A01,895581,Halter; Christopher P.,22,0,45,23
1746602463734,EDS 204R,A01,895625,Heinzman; Erica M.,39,0,45,6
1746602463734,EDS 204R,B01,895693,Halter; Christopher P.,10,0,45,35
1746602464762,EDS 206R,A00,895694,Fargason; Sharon Gayle,1,0,30,29
1746602464762,EDS 206R,B00,895695,Choi; Bailey Miyeon,16,0,30,14
1746602465787,EDS 250,A00,895697,Hemans; Patricia Ann Benitez,22,0,45,23
1746602466814,EDS 281,A00,895701,Meyerott; Theresa Ann,1,0,15,14
1746602467839,EDS 284,A00,895736,Meyerott; Theresa Ann,1,0,15,14
1746602468865,EDS 286,A00,897210,Fine; Sarah,0,0,15,15
1746602469896,EDS 289C,A01,895770,Daly; Alan J.,1,0,15,14
1746602470925,EDS 290,A00,897211,Hofstetter; Carolyn,0,0,15,15
1746602471951,LIGM 5A,A00,896162,Fischer-Grunski; Eva K,12,0,20,8
1746602472981,LIGM 5B,A00,896260,Fischer-Grunski; Eva K,17,0,20,3
1746602474010,LIGM 5C,A00,896308,Fischer-Grunski; Eva K,18,0,20,2
1746602475041,LIIT 5AS,A00,896313,Carnelos; Chiara,18,0,20,2
1746602476069,LIIT 5BS,A00,896416,Carnelos; Chiara,20,0,20,0
1746602477094,LIIT 5CS,A00,896564,Carnelos; Chiara,20,0,20,0
1746602478123,LISP 5A,A00,896588,Munoz Sanchez; Alicia,2,0,20,18
1746602479152,LISP 5B,A00,896653,Munoz Sanchez; Alicia,7,0,20,13
1746602480178,LISP 5C,A00,896655,Munoz Sanchez; Alicia,0,1,20,20
1746602481204,MAE 197,001,957918,Kleissl; Jan,9996,0,9999,3
1746602481204,MAE 197,002,959806,Boechler; Nicholas Sebastia,9998,0,9999,1
1746602481204,MAE 197,003,959852,Mullin; Jennifer S,9998,0,9999,1
1746602482234,MATH 2,A01,957937,Staff,33,0,35,2
1746602483264,MATH 197,001,957876,Kedlaya; Kiran S.,9993,0,9999,6
1746602484295,MCWP 40,A00,892729,Duru; Nur,10,0,20,10
1746602484295,MCWP 40,B00,893304,Montejo; Carolina,14,0,20,6
1746602485323,MCWP 40R,A00,893757,Redela; Pamela Morgan,0,5,20,20
1746602486351,MCWP 50,A00,893758,Morshed; Michael James,0,0,20,20
1746602486351,MCWP 50,B00,893761,Bartulis; Jason Michael,16,0,20,4
1746602487381,MCWP 50R,A00,893766,Compas; Sean Matthew,0,1,20,20
1746602487381,MCWP 50R,B00,893769,Carter; Jennifer A,0,1,20,20
1746602487381,MCWP 50R,C00,893771,Krone; Jarret,0,3,20,20
1746602487381,MCWP 50R,D00,893772,Miller; Elizabeth Deen,0,0,20,20
1746602487381,MCWP 50R,E00,893775,Carter; Andrea L,0,1,20,20
1746602488445,MMW 11R,A01,892721,Herbst; Matthew,14,0,30,16
1746602488445,MMW 11R,A02,892722,Herbst; Matthew,0,0,0,3
1746602489470,MMW 12R,A01,892724,Herbst; Matthew,0,11,16,16
1746602489470,MMW 12R,A02,892725,Herbst; Matthew,0,10,16,16
1746602490499,MMW 13R,A01,892727,Staff,0,4,16,16
1746602490499,MMW 13R,A02,892728,Staff,0,4,16,16
1746602490499,MMW 13R,A03,958032,Staff,0,4,16,16
1746602490499,MMW 13R,A04,958033,Staff,0,4,16,16
1746602490499,MMW 13R,A05,958034,Staff,0,4,16,16
1746602491527,SIO 295LS,A00,894015,Staff,5,0,25,20
1746602492554,SIO 295S,A00,894020,Staff,5,0,25,20
1746602493582,SIOC 290S,B01,958918,Merrifield; Mark A,14,0,30,16
1746602494610,SIOC 291S,B01,958922,Gabriel; Corey John,14,0,30,16
1746602495639,SOCI 117,A01,895339,Staff,2,0,5,3
1746602496663,WES 237B,A00,894149,Staff,11,0,20,9
1746602498732,AESE 279B,A00,891859,Staff,13,0,35,22
1746602499758,AIP 197,001,891854,Vespa; Emanuel Ignacio,9999,0,9999,0
1746602500785,ANTH 289S,A00,891856,Gagneux; Pascal,12,0,12,0
1746602501811,BENG 196,001,957946,Engler; Adam J.,9996,0,9999,3
1746602502836,BISP 197,001,959851,Wilhelm; James E.,9998,0,9999,1
1746602503864,CAT 124RS,A01,956906,Staff,6,0,25,19
1746602504890,CAT 125RS,A01,922013,Staff,6,0,25,19
1746602505919,CLRE 250,A00,891860,Morris; Sheldon,9995,0,9999,4
1746602507973,CLRE 251R,A00,907817,Mehta; Ravindra L.,9994,0,9999,5
1746602509000,CLRE 252,A00,891864,Cuomo; Raphael Eduardo,9993,0,9999,6
1746602510035,CLRE 253,A00,891867,Vaida; Florin,9994,0,9999,5
1746602510035,CLRE 253,B00,907819,Staff,9999,0,9999,0
1746602511062,CLRE 259,A00,891868,Patel; Hemal,9998,0,9999,1
1746602512090,CLRE 260,A00,891872,Cuomo; Raphael Eduardo,9999,0,9999,0
1746602513116,CLRE 297,001,891888,Cuomo; Raphael Eduardo,9999,0,9999,0
1746602514144,CSE 191,A00,958773,Minnes Kemp; Mor Mia,9995,0,9999,4
1746602515170,CSE 197,001,959846,Minnes Kemp; Mor Mia,9990,0,9999,9
1746602516195,CSS 201S,A01,892054,Mignozzetti; Umberto,25,0,30,5
1746602517223,CSS 202S,A01,892056,Mignozzetti; Umberto,25,0,30,5
1746602518252,DSC 197,001,956898,Eldridge; Justin Matthew,9996,0,9999,3
1746602519282,DSC 297,001,958000,Mazumdar; Arya,9998,0,9999,1
1746602519282,DSC 297,002,959862,Wang; Yusu,9998,0,9999,1
1746602520308,EAP 100,A00,905686,Staff,9778,0,9999,221
1746602521338,ECE 45,A01,892618,Staff,0,0,65,65
1746602523418,ECE 111,A01,892719,Staff,6,0,65,59
1746602524441,ECE 197,001,957920,Mercier; Patrick Philip,9991,0,9999,8
1746602525468,ECON 178,A01,907814,Zhu; Ying,26,0,35,9
1746602526494,EDS 115,A00,895312,Staff,35,0,45,10
1746602527544,EDS 117,A01,895337,Staff,23,0,30,7
1746602528575,EDS 125,A00,895341,Jones; Gabrielle Anastasia,36,0,45,9
1746602529601,EDS 128A,A01,895459,Fargason; Sharon Gayle,44,0,45,1
1746602530629,EDS 128B,A01,895543,Pappas; Elizabeth,44,0,45,1
1746602531654,EDS 139,A00,897203,Pappas; Elizabeth,44,0,45,1
1746602531654,EDS 139,B00,897209,Fargason; Sharon Gayle,41,0,45,4
1746602532679,EDS 201,A00,895545,Staff,22,0,45,23
1746602533706,EDS 203,A01,895581,Halter; Christopher P.,22,0,45,23
1746602534736,EDS 204R,A01,895625,Heinzman; Erica M.,39,0,45,6
1746602534736,EDS 204R,B01,895693,Halter; Christopher P.,10,0,45,35
1746602535765,EDS 206R,A00,895694,Fargason; Sharon Gayle,1,0,30,29
1746602535765,EDS 206R,B00,895695,Choi; Bailey Miyeon,16,0,30,14
1746602536792,EDS 250,A00,895697,Hemans; Patricia Ann Benitez,22,0,45,23
1746602537818,EDS 281,A00,895701,Meyerott; Theresa Ann,1,0,15,14
1746602538846,EDS 284,A00,895736,Meyerott; Theresa Ann,1,0,15,14
1746602539873,EDS 286,A00,897210,Fine; Sarah,0,0,15,15
1746602540900,EDS 289C,A01,895770,Daly; Alan J.,1,0,15,14
1746602541927,EDS 290,A00,897211,Hofstetter; Carolyn,0,0,15,15
1746602542953,LIGM 5A,A00,896162,Fischer-Grunski; Eva K,12,0,20,8
1746602543983,LIGM 5B,A00,896260,Fischer-Grunski; Eva K,17,0,20,3
1746602545010,LIGM 5C,A00,896308,Fischer-Grunski; Eva K,18,0,20,2
1746602546036,LIIT 5AS,A00,896313,Carnelos; Chiara,18,0,20,2
1746602547062,LIIT 5BS,A00,896416,Carnelos; Chiara,20,0,20,0
1746602548092,LIIT 5CS,A00,896564,Carnelos; Chiara,20,0,20,0
1746602549119,LISP 5A,A00,896588,Munoz Sanchez; Alicia,2,0,20,18
1746602550145,LISP 5B,A00,896653,Munoz Sanchez; Alicia,7,0,20,13
1746602551172,LISP 5C,A00,896655,Munoz Sanchez; Alicia,0,1,20,20
1746602552201,MAE 197,001,957918,Kleissl; Jan,9996,0,9999,3
1746602552201,MAE 197,002,959806,Boechler; Nicholas Sebastia,9998,0,9999,1
1746602552201,MAE 197,003,959852,Mullin; Jennifer S,9998,0,9999,1
1746602553228,MATH 2,A01,957937,Staff,33,0,35,2
1746602554258,MATH 197,001,957876,Kedlaya; Kiran S.,9993,0,9999,6
1746602555284,MCWP 40,A00,892729,Duru; Nur,10,0,20,10
1746602555284,MCWP 40,B00,893304,Montejo; Carolina,14,0,20,6
1746602556309,MCWP 40R,A00,893757,Redela; Pamela Morgan,0,5,20,20
1746602557335,MCWP 50,A00,893758,Morshed; Michael James,0,0,20,20
1746602557335,MCWP 50,B00,893761,Bartulis; Jason Michael,16,0,20,4
1746602558361,MCWP 50R,A00,893766,Compas; Sean Matthew,0,1,20,20
1746602558361,MCWP 50R,B00,893769,Carter; Jennifer A,0,1,20,20
1746602558361,MCWP 50R,C00,893771,Krone; Jarret,0,3,20,20
1746602558361,MCWP 50R,D00,893772,Miller; Elizabeth Deen,0,0,20,20
1746602558361,MCWP 50R,E00,893775,Carter; Andrea L,0,1,20,20
1746602559389,MMW 11R,A01,892721,Herbst; Matthew,14,0,30,16
1746602559389,MMW 11R,A02,892722,Herbst; Matthew,0,0,0,3
1746602560415,MMW 12R,A01,892724,Herbst; Matthew,0,11,16,16
1746602560415,MMW 12R,A02,892725,Herbst; Matthew,0,10,16,16
1746602561443,MMW 13R,A01,892727,Staff,0,4,16,16
1746602561443,MMW 13R,A02,892728,Staff,0,4,16,16
1746602561443,MMW 13R,A03,958032,Staff,0,4,16,16
1746602561443,MMW 13R,A04,958033,Staff,0,4,16,16
1746602561443,MMW 13R,A05,958034,Staff,0,4,16,16
1746602562468,SIO 295LS,A00,894015,Staff,5,0,25,20
1746602563494,SIO 295S,A00,894020,Staff,5,0,25,20
1746602564521,SIOC 290S,B01,958918,Merrifield; Mark A,14,0,30,16
1746602565549,SIOC 291S,B01,958922,Gabriel; Corey John,14,0,30,16
1746602566575,SOCI 117,A01,895339,Staff,2,0,5,3
1746602567600,WES 237B,A00,894149,Staff,11,0,20,9
1746602569670,AESE 279B,A00,891859,Staff,13,0,35,22
1746602570695,AIP 197,001,891854,Vespa; Emanuel Ignacio,9999,0,9999,0
1746602571721,ANTH 289S,A00,891856,Gagneux; Pascal,12,0,12,0
1746602572745,BENG 196,001,957946,Engler; Adam J.,9996,0,9999,3
1746602573771,BISP 197,001,959851,Wilhelm; James E.,9998,0,9999,1
1746602574835,CAT 124RS,A01,956906,Staff,6,0,25,19
1746602575860,CAT 125RS,A01,922013,Staff,6,0,25,19
1746602576886,CLRE 250,A00,891860,Morris; Sheldon,9995,0,9999,4
1746602578940,CLRE 251R,A00,907817,Mehta; Ravindra L.,9994,0,9999,5
1746602579966,CLRE 252,A00,891864,Cuomo; Raphael Eduardo,9993,0,9999,6
1746602580996,CLRE 253,A00,891867,Vaida; Florin,9994,0,9999,5
1746602580996,CLRE 253,B00,907819,Staff,9999,0,9999,0
1746602582023,CLRE 259,A00,891868,Patel; Hemal,9998,0,9999,1
1746602583049,CLRE 260,A00,891872,Cuomo; Raphael Eduardo,9999,0,9999,0
1746602584077,CLRE 297,001,891888,Cuomo; Raphael Eduardo,9999,0,9999,0
1746602585104,CSE 191,A00,958773,Minnes Kemp; Mor Mia,9995,0,9999,4
1746602586136,CSE 197,001,959846,Minnes Kemp; Mor Mia,9990,0,9999,9
1746602587167,CSS 201S,A01,892054,Mignozzetti; Umberto,25,0,30,5
1746602588196,CSS 202S,A01,892056,Mignozzetti; Umberto,25,0,30,5
1746602589222,DSC 197,001,956898,Eldridge; Justin Matthew,9996,0,9999,3
1746602590246,DSC 297,001,958000,Mazumdar; Arya,9998,0,9999,1
1746602590246,DSC 297,002,959862,Wang; Yusu,9998,0,9999,1
1746602591274,EAP 100,A00,905686,Staff,9778,0,9999,221
1746602592306,ECE 45,A01,892618,Staff,0,0,65,65
1746602594357,ECE 111,A01,892719,Staff,6,0,65,59
1746602595382,ECE 197,001,957920,Mercier; Patrick Philip,9991,0,9999,8
1746602596407,ECON 178,A01,907814,Zhu; Ying,26,0,35,9
1746602597433,EDS 115,A00,895312,Staff,35,0,45,10
1746602598459,EDS 117,A01,895337,Staff,23,0,30,7
1746602599486,EDS 125,A00,895341,Jones; Gabrielle Anastasia,36,0,45,9
1746602600511,EDS 128A,A01,895459,Fargason; Sharon Gayle,44,0,45,1
1746602601541,EDS 128B,A01,895543,Pappas; Elizabeth,44,0,45,1
1746602602565,EDS 139,A00,897203,Pappas; Elizabeth,44,0,45,1
1746602602565,EDS 139,B00,897209,Fargason; Sharon Gayle,41,0,45,4
1746602603593,EDS 201,A00,895545,Staff,22,0,45,23
1746602604617,EDS 203,A01,895581,Halter; Christopher P.,22,0,45,23
1746602605641,EDS 204R,A01,895625,Heinzman; Erica M.,39,0,45,6
1746602605641,EDS 204R,B01,895693,Halter; Christopher P.,10,0,45,35
1746602606670,EDS 206R,A00,895694,Fargason; Sharon Gayle,1,0,30,29
1746602606670,EDS 206R,B00,895695,Choi; Bailey Miyeon,16,0,30,14
1746602607697,EDS 250,A00,895697,Hemans; Patricia Ann Benitez,22,0,45,23
1746602608725,EDS 281,A00,895701,Meyerott; Theresa Ann,1,0,15,14
1746602609750,EDS 284,A00,895736,Meyerott; Theresa Ann,1,0,15,14
1746602610781,EDS 286,A00,897210,Fine; Sarah,0,0,15,15
1746602611807,EDS 289C,A01,895770,Daly; Alan J.,1,0,15,14
1746602612834,EDS 290,A00,897211,Hofstetter; Carolyn,0,0,15,15
1746602613864,LIGM 5A,A00,896162,Fischer-Grunski; Eva K,12,0,20,8
1746602614893,LIGM 5B,A00,896260,Fischer-Grunski; Eva K,17,0,20,3
1746602615920,LIGM 5C,A00,896308,Fischer-Grunski; Eva K,18,0,20,2
1746602616965,LIIT 5AS,A00,896313,Carnelos; Chiara,18,0,20,2
1746602617994,LIIT 5BS,A00,896416,Carnelos; Chiara,20,0,20,0
1746602619023,LIIT 5CS,A00,896564,Carnelos; Chiara,20,0,20,0
1746602620049,LISP 5A,A00,896588,Munoz Sanchez; Alicia,2,0,20,18
1746602621075,LISP 5B,A00,896653,Munoz Sanchez; Alicia,7,0,20,13
1746602622103,LISP 5C,A00,896655,Munoz Sanchez; Alicia,0,1,20,20
1746602623132,MAE 197,001,957918,Kleissl; Jan,9996,0,9999,3
1746602623132,MAE 197,002,959806,Boechler; Nicholas Sebastia,9998,0,9999,1
1746602623132,MAE 197,003,959852,Mullin; Jennifer S,9998,0,9999,1
1746602624159,MATH 2,A01,957937,Staff,33,0,35,2
1746602625185,MATH 197,001,957876,Kedlaya; Kiran S.,9993,0,9999,6
1746602626213,MCWP 40,A00,892729,Duru; Nur,10,0,20,10
1746602626213,MCWP 40,B00,893304,Montejo; Carolina,14,0,20,6
1746602627244,MCWP 40R,A00,893757,Redela; Pamela Morgan,0,5,20,20
1746602628274,MCWP 50,A00,893758,Morshed; Michael James,0,0,20,20
1746602628274,MCWP 50,B00,893761,Bartulis; Jason Michael,16,0,20,4
1746602629307,MCWP 50R,A00,893766,Compas; Sean Matthew,0,1,20,20
1746602629307,MCWP 50R,B00,893769,Carter; Jennifer A,0,1,20,20
1746602629307,MCWP 50R,C00,893771,Krone; Jarret,0,3,20,20
1746602629307,MCWP 50R,D00,893772,Miller; Elizabeth Deen,0,0,20,20
1746602629307,MCWP 50R,E00,893775,Carter; Andrea L,0,1,20,20
1746602630333,MMW 11R,A01,892721,Herbst; Matthew,14,0,30,16
1746602630333,MMW 11R,A02,892722,Herbst; Matthew,0,0,0,3
1746602631361,MMW 12R,A01,892724,Herbst; Matthew,0,11,16,16
1746602631361,MMW 12R,A02,892725,Herbst; Matthew,0,10,16,16
1746602632387,MMW 13R,A01,892727,Staff,0,4,16,16
1746602632387,MMW 13R,A02,892728,Staff,0,4,16,16
1746602632387,MMW 13R,A03,958032,Staff,0,4,16,16
1746602632387,MMW 13R,A04,958033,Staff,0,4,16,16
1746602632387,MMW 13R,A05,958034,Staff,0,4,16,16
1746602633414,SIO 295LS,A00,894015,Staff,5,0,25,20
1746602634440,SIO 295S,A00,894020,Staff,5,0,25,20
1746602635474,SIOC 290S,B01,958918,Merrifield; Mark A,14,0,30,16
1746602636509,SIOC 291S,B01,958922,Gabriel; Corey John,14,0,30,16
1746602637540,SOCI 117,A01,895339,Staff,2,0,5,3
1746602638570,WES 237B,A00,894149,Staff,11,0,20,9
1746602640645,AESE 279B,A00,891859,Staff,13,0,35,22
1746602641672,AIP 197,001,891854,Vespa; Emanuel Ignacio,9999,0,9999,0
1746602642703,ANTH 289S,A00,891856,Gagneux; Pascal,12,0,12,0
1746602643730,BENG 196,001,957946,Engler; Adam J.,9996,0,9999,3
1746602644756,BISP 197,001,959851,Wilhelm; James E.,9998,0,9999,1
1746602645783,CAT 124RS,A01,956906,Staff,6,0,25,19
1746602646811,CAT 125RS,A01,922013,Staff,6,0,25,19
1746602647841,CLRE 250,A00,891860,Morris; Sheldon,9995,0,9999,4
1746602649894,CLRE 251R,A00,907817,Mehta; Ravindra L.,9994,0,9999,5
1746602650921,CLRE 252,A00,891864,Cuomo; Raphael Eduardo,9993,0,9999,6
1746602651947,CLRE 253,A00,891867,Vaida; Florin,9994,0,9999,5
1746602651947,CLRE 253,B00,907819,Staff,9999,0,9999,0
1746602652977,CLRE 259,A00,891868,Patel; Hemal,9998,0,9999,1
1746602654004,CLRE 260,A00,891872,Cuomo; Raphael Eduardo,9999,0,9999,0
1746602655035,CLRE 297,001,891888,Cuomo; Raphael Eduardo,9999,0,9999,0
1746602656067,CSE 191,A00,958773,Minnes Kemp; Mor Mia,9995,0,9999,4
1746602657097,CSE 197,001,959846,Minnes Kemp; Mor Mia,9990,0,9999,9
1746602658124,CSS 201S,A01,892054,Mignozzetti; Umberto,25,0,30,5
1746602659151,CSS 202S,A01,892056,Mignozzetti; Umberto,25,0,30,5
1746602660177,DSC 197,001,956898,Eldridge; Justin Matthew,9996,0,9999,3
1746602661209,DSC 297,001,958000,Mazumdar; Arya,9998,0,9999,1
1746602661209,DSC 297,002,959862,Wang; Yusu,9998,0,9999,1
1746602662235,EAP 100,A00,905686,Staff,9778,0,9999,221
1746602663270,ECE 45,A01,892618,Staff,0,0,65,65
1746602665333,ECE 111,A01,892719,Staff,6,0,65,59
1746602666360,ECE 197,001,957920,Mercier; Patrick Philip,9991,0,9999,8
1746602667387,ECON 178,A01,907814,Zhu; Ying,26,0,35,9
1746602668412,EDS 115,A00,895312,Staff,35,0,45,10
1746602669439,EDS 117,A01,895337,Staff,23,0,30,7
1746602670466,EDS 125,A00,895341,Jones; Gabrielle Anastasia,36,0,45,9
1746602671499,EDS 128A,A01,895459,Fargason; Sharon Gayle,44,0,45,1
1746602672526,EDS 128B,A01,895543,Pappas; Elizabeth,44,0,45,1
1746602673556,EDS 139,A00,897203,Pappas; Elizabeth,44,0,45,1
1746602673556,EDS 139,B00,897209,Fargason; Sharon Gayle,41,0,45,4
1746602674586,EDS 201,A00,895545,Staff,22,0,45,23
1746602675613,EDS 203,A01,895581,Halter; Christopher P.,22,0,45,23
1746602676639,EDS 204R,A01,895625,Heinzman; Erica M.,39,0,45,6
1746602676639,EDS 204R,B01,895693,Halter; Christopher P.,10,0,45,35
1746602677671,EDS 206R,A00,895694,Fargason; Sharon Gayle,1,0,30,29
1746602677671,EDS 206R,B00,895695,Choi; Bailey Miyeon,16,0,30,14
1746602678701,EDS 250,A00,895697,Hemans; Patricia Ann Benitez,22,0,45,23
1746602679729,EDS 281,A00,895701,Meyerott; Theresa Ann,1,0,15,14
1746602680758,EDS 284,A00,895736,Meyerott; Theresa Ann,1,0,15,14
1746602681785,EDS 286,A00,897210,Fine; Sarah,0,0,15,15
1746602682811,EDS 289C,A01,895770,Daly; Alan J.,1,0,15,14
1746602683841,EDS 290,A00,897211,Hofstetter; Carolyn,0,0,15,15
1746602684871,LIGM 5A,A00,896162,Fischer-Grunski; Eva K,12,0,20,8
1746602685901,LIGM 5B,A00,896260,Fischer-Grunski; Eva K,17,0,20,3
1746602686981,LIGM 5C,A00,896308,Fischer-Grunski; Eva K,18,0,20,2
1746602688013,LIIT 5AS,A00,896313,Carnelos; Chiara,18,0,20,2
1746602689040,LIIT 5BS,A00,896416,Carnelos; Chiara,20,0,20,0
1746602690065,LIIT 5CS,A00,896564,Carnelos; Chiara,20,0,20,0
1746602691092,LISP 5A,A00,896588,Munoz Sanchez; Alicia,2,0,20,18
1746602692124,LISP 5B,A00,896653,Munoz Sanchez; Alicia,7,0,20,13
1746602693151,LISP 5C,A00,896655,Munoz Sanchez; Alicia,0,1,20,20
1746602694189,MAE 197,001,957918,Kleissl; Jan,9996,0,9999,3
1746602694189,MAE 197,002,959806,Boechler; Nicholas Sebastia,9998,0,9999,1
1746602694189,MAE 197,003,959852,Mullin; Jennifer S,9998,0,9999,1
1746602695215,MATH 2,A01,957937,Staff,33,0,35,2
1746602696242,MATH 197,001,957876,Kedlaya; Kiran S.,9993,0,9999,6
1746602697268,MCWP 40,A00,892729,Duru; Nur,10,0,20,10
1746602697268,MCWP 40,B00,893304,Montejo; Carolina,14,0,20,6
1746602698299,MCWP 40R,A00,893757,Redela; Pamela Morgan,0,5,20,20
1746602699332,MCWP 50,A00,893758,Morshed; Michael James,0,0,20,20
1746602699332,MCWP 50,B00,893761,Bartulis; Jason Michael,16,0,20,4
1746602700364,MCWP 50R,A00,893766,Compas; Sean Matthew,0,1,20,20
1746602700364,MCWP 50R,B00,893769,Carter; Jennifer A,0,1,20,20
1746602700364,MCWP 50R,C00,893771,Krone; Jarret,0,3,20,20
1746602700364,MCWP 50R,D00,893772,Miller; Elizabeth Deen,0,0,20,20
1746602700364,MCWP 50R,E00,893775,Carter; Andrea L,0,1,20,20
1746602701390,MMW 11R,A01,892721,Herbst; Matthew,14,0,30,16
1746602701390,MMW 11R,A02,892722,Herbst; Matthew,0,0,0,3
1746602702417,MMW 12R,A01,892724,Herbst; Matthew,0,11,16,16
1746602702417,MMW 12R,A02,892725,Herbst; Matthew,0,10,16,16
1746602703447,MMW 13R,A01,892727,Staff,0,4,16,16
1746602703447,MMW 13R,A02,892728,Staff,0,4,16,16
1746602703447,MMW 13R,A03,958032,Staff,0,4,16,16
1746602703447,MMW 13R,A04,958033,Staff,0,4,16,16
1746602703447,MMW 13R,A05,958034,Staff,0,4,16,16
1746602704473,SIO 295LS,A00,894015,Staff,5,0,25,20
1746602705500,SIO 295S,A00,894020,Staff,5,0,25,20
1746602706536,SIOC 290S,B01,958918,Merrifield; Mark A,14,0,30,16
1746602707564,SIOC 291S,B01,958922,Gabriel; Corey John,14,0,30,16
1746602708591,SOCI 117,A01,895339,Staff,2,0,5,3
1746602709621,WES 237B,A00,894149,Staff,11,0,20,9
1746602711900,AESE 279B,A00,891859,Staff,13,0,35,22
1746602712927,AIP 197,001,891854,Vespa; Emanuel Ignacio,9999,0,9999,0
1746602713955,ANTH 289S,A00,891856,Gagneux; Pascal,12,0,12,0
1746602714983,BENG 196,001,957946,Engler; Adam J.,9996,0,9999,3
1746602716011,BISP 197,001,959851,Wilhelm; James E.,9998,0,9999,1
1746602717041,CAT 124RS,A01,956906,Staff,6,0,25,19
1746602718066,CAT 125RS,A01,922013,Staff,6,0,25,19
1746602719092,CLRE 250,A00,891860,Morris; Sheldon,9995,0,9999,4
1746602721150,CLRE 251R,A00,907817,Mehta; Ravindra L.,9994,0,9999,5
1746602722175,CLRE 252,A00,891864,Cuomo; Raphael Eduardo,9993,0,9999,6
1746602723202,CLRE 253,A00,891867,Vaida; Florin,9994,0,9999,5
1746602723202,CLRE 253,B00,907819,Staff,9999,0,9999,0
1746602724228,CLRE 259,A00,891868,Patel; Hemal,9998,0,9999,1
1746602725254,CLRE 260,A00,891872,Cuomo; Raphael Eduardo,9999,0,9999,0
1746602726280,CLRE 297,001,891888,Cuomo; Raphael Eduardo,9999,0,9999,0
1746602727307,CSE 191,A00,958773,Minnes Kemp; Mor Mia,9995,0,9999,4
1746602728333,CSE 197,001,959846,Minnes Kemp; Mor Mia,9990,0,9999,9
1746602729361,CSS 201S,A01,892054,Mignozzetti; Umberto,25,0,30,5
1746602730387,CSS 202S,A01,892056,Mignozzetti; Umberto,25,0,30,5
1746602731415,DSC 197,001,956898,Eldridge; Justin Matthew,9996,0,9999,3
1746602732441,DSC 297,001,958000,Mazumdar; Arya,9998,0,9999,1
1746602732441,DSC 297,002,959862,Wang; Yusu,9998,0,9999,1
1746602733468,EAP 100,A00,905686,Staff,9778,0,9999,221
1746602734496,ECE 45,A01,892618,Staff,0,0,65,65
1746602736549,ECE 111,A01,892719,Staff,6,0,65,59
1746602737577,ECE 197,001,957920,Mercier; Patrick Philip,9991,0,9999,8
1746602738602,ECON 178,A01,907814,Zhu; Ying,26,0,35,9
1746602739631,EDS 115,A00,895312,Staff,35,0,45,10
1746602740657,EDS 117,A01,895337,Staff,23,0,30,7
1746602741684,EDS 125,A00,895341,Jones; Gabrielle Anastasia,36,0,45,9
1746602742714,EDS 128A,A01,895459,Fargason; Sharon Gayle,44,0,45,1
1746602743741,EDS 128B,A01,895543,Pappas; Elizabeth,44,0,45,1
1746602744768,EDS 139,A00,897203,Pappas; Elizabeth,44,0,45,1
1746602744768,EDS 139,B00,897209,Fargason; Sharon Gayle,41,0,45,4
1746602745796,EDS 201,A00,895545,Staff,22,0,45,23
1746602746826,EDS 203,A01,895581,Halter; Christopher P.,22,0,45,23
1746602747856,EDS 204R,A01,895625,Heinzman; Erica M.,39,0,45,6
1746602747856,EDS 204R,B01,895693,Halter; Christopher P.,10,0,45,35
1746602748884,EDS 206R,A00,895694,Fargason; Sharon Gayle,1,0,30,29
1746602748884,EDS 206R,B00,895695,Choi; Bailey Miyeon,16,0,30,14
1746602749909,EDS 250,A00,895697,Hemans; Patricia Ann Benitez,22,0,45,23
1746602750935,EDS 281,A00,895701,Meyerott; Theresa Ann,1,0,15,14
1746602751964,EDS 284,A00,895736,Meyerott; Theresa Ann,1,0,15,14
1746602752991,EDS 286,A00,897210,Fine; Sarah,0,0,15,15
1746602754022,EDS 289C,A01,895770,Daly; Alan J.,1,0,15,14
1746602755048,EDS 290,A00,897211,Hofstetter; Carolyn,0,0,15,15
1746602756076,LIGM 5A,A00,896162,Fischer-Grunski; Eva K,12,0,20,8
1746602757102,LIGM 5B,A00,896260,Fischer-Grunski; Eva K,17,0,20,3
1746602758133,LIGM 5C,A00,896308,Fischer-Grunski; Eva K,18,0,20,2
1746602759159,LIIT 5AS,A00,896313,Carnelos; Chiara,18,0,20,2
1746602760191,LIIT 5BS,A00,896416,Carnelos; Chiara,20,0,20,0
1746602761220,LIIT 5CS,A00,896564,Carnelos; Chiara,20,0,20,0
1746602762252,LISP 5A,A00,896588,Munoz Sanchez; Alicia,2,0,20,18
1746602763278,LISP 5B,A00,896653,Munoz Sanchez; Alicia,7,0,20,13
1746602764305,LISP 5C,A00,896655,Munoz Sanchez; Alicia,0,1,20,20
1746602765336,MAE 197,001,957918,Kleissl; Jan,9996,0,9999,3
1746602765336,MAE 197,002,959806,Boechler; Nicholas Sebastia,9998,0,9999,1
1746602765336,MAE 197,003,959852,Mullin; Jennifer S,9998,0,9999,1
1746602766360,MATH 2,A01,957937,Staff,33,0,35,2
1746602767387,MATH 197,001,957876,Kedlaya; Kiran S.,9993,0,9999,6
1746602768413,MCWP 40,A00,892729,Duru; Nur,10,0,20,10
1746602768413,MCWP 40,B00,893304,Montejo; Carolina,14,0,20,6
1746602769444,MCWP 40R,A00,893757,Redela; Pamela Morgan,0,5,20,20
1746602770470,MCWP 50,A00,893758,Morshed; Michael James,0,0,20,20
1746602770470,MCWP 50,B00,893761,Bartulis; Jason Michael,16,0,20,4
1746602771495,MCWP 50R,A00,893766,Compas; Sean Matthew,0,1,20,20
1746602771495,MCWP 50R,B00,893769,Carter; Jennifer A,0,1,20,20
1746602771495,MCWP 50R,C00,893771,Krone; Jarret,0,3,20,20
1746602771495,MCWP 50R,D00,893772,Miller; Elizabeth Deen,0,0,20,20
1746602771495,MCWP 50R,E00,893775,Carter; Andrea L,0,1,20,20
1746602772525,MMW 11R,A01,892721,Herbst; Matthew,14,0,30,16
1746602772525,MMW 11R,A02,892722,Herbst; Matthew,0,0,0,3
1746602773550,MMW 12R,A01,892724,Herbst; Matthew,0,11,16,16
1746602773550,MMW 12R,A02,892725,Herbst; Matthew,0,10,16,16
1746602774580,MMW 13R,A01,892727,Staff,0,4,16,16
1746602774580,MMW 13R,A02,892728,Staff,0,4,16,16
1746602774580,MMW 13R,A03,958032,Staff,0,4,16,16
1746602774580,MMW 13R,A04,958033,Staff,0,4,16,16
1746602774580,MMW 13R,A05,958034,Staff,0,4,16,16
1746602775607,SIO 295LS,A00,894015,Staff,5,0,25,20
1746602776633,SIO 295S,A00,894020,Staff,5,0,25,20
1746602777659,SIOC 290S,B01,958918,Merrifield; Mark A,14,0,30,16
1746602778691,SIOC 291S,B01,958922,Gabriel; Corey John,14,0,30,16
1746602779717,SOCI 117,A01,895339,Staff,2,0,5,3
1746602780744,WES 237B,A00,894149,Staff,11,0,20,9
1746602782808,AESE 279B,A00,891859,Staff,13,0,35,22
1746602783835,AIP 197,001,891854,Vespa; Emanuel Ignacio,9999,0,9999,0
1746602784866,ANTH 289S,A00,891856,Gagneux; Pascal,12,0,12,0
1746602785906,BENG 196,001,957946,Engler; Adam J.,9996,0,9999,3
1746602786932,BISP 197,001,959851,Wilhelm; James E.,9998,0,9999,1
1746602787961,CAT 124RS,A01,956906,Staff,6,0,25,19
1746602788990,CAT 125RS,A01,922013,Staff,6,0,25,19
1746602790021,CLRE 250,A00,891860,Morris; Sheldon,9995,0,9999,4
1746602792115,CLRE 251R,A00,907817,Mehta; Ravindra L.,9994,0,9999,5
1746602793141,CLRE 252,A00,891864,Cuomo; Raphael Eduardo,9993,0,9999,6
1746602794167,CLRE 253,A00,891867,Vaida; Florin,9994,0,9999,5
1746602794167,CLRE 253,B00,907819,Staff,9999,0,9999,0
1746602795193,CLRE 259,A00,891868,Patel; Hemal,9998,0,9999,1
1746602796221,CLRE 260,A00,891872,Cuomo; Raphael Eduardo,9999,0,9999,0
1746602797246,CLRE 297,001,891888,Cuomo; Raphael Eduardo,9999,0,9999,0
1746602798273,CSE 191,A00,958773,Minnes Kemp; Mor Mia,9995,0,9999,4
1746602799299,CSE 197,001,959846,Minnes Kemp; Mor Mia,9990,0,9999,9
1746602800324,CSS 201S,A01,892054,Mignozzetti; Umberto,25,0,30,5
1746602801355,CSS 202S,A01,892056,Mignozzetti; Umberto,25,0,30,5
1746602802383,DSC 197,001,956898,Eldridge; Justin Matthew,9996,0,9999,3
1746602803409,DSC 297,001,958000,Mazumdar; Arya,9998,0,9999,1
1746602803409,DSC 297,002,959862,Wang; Yusu,9998,0,9999,1
1746602804437,EAP 100,A00,905686,Staff,9778,0,9999,221
1746602805470,ECE 45,A01,892618,Staff,0,0,65,65
1746602807524,ECE 111,A01,892719,Staff,6,0,65,59
1746602808551,ECE 197,001,957920,Mercier; Patrick Philip,9991,0,9999,8
1746602809583,ECON 178,A01,907814,Zhu; Ying,26,0,35,9
1746602810613,EDS 115,A00,895312,Staff,35,0,45,10
1746602811639,EDS 117,A01,895337,Staff,23,0,30,7
1746602812665,EDS 125,A00,895341,Jones; Gabrielle Anastasia,36,0,45,9
1746602813692,EDS 128A,A01,895459,Fargason; Sharon Gayle,44,0,45,1
1746602814719,EDS 128B,A01,895543,Pappas; Elizabeth,44,0,45,1
1746602815744,EDS 139,A00,897203,Pappas; Elizabeth,44,0,45,1
1746602815744,EDS 139,B00,897209,Fargason; Sharon Gayle,41,0,45,4
1746602816771,EDS 201,A00,895545,Staff,22,0,45,23
1746602817796,EDS 203,A01,895581,Halter; Christopher P.,22,0,45,23
1746602818826,EDS 204R,A01,895625,Heinzman; Erica M.,39,0,45,6
1746602818826,EDS 204R,B01,895693,Halter; Christopher P.,10,0,45,35
1746602819853,EDS 206R,A00,895694,Fargason; Sharon Gayle,1,0,30,29
1746602819853,EDS 206R,B00,895695,Choi; Bailey Miyeon,16,0,30,14
1746602820882,EDS 250,A00,895697,Hemans; Patricia Ann Benitez,22,0,45,23
1746602821907,EDS 281,A00,895701,Meyerott; Theresa Ann,1,0,15,14
1746602822931,EDS 284,A00,895736,Meyerott; Theresa Ann,1,0,15,14
1746602823961,EDS 286,A00,897210,Fine; Sarah,0,0,15,15
1746602825003,EDS 289C,A01,895770,Daly; Alan J.,1,0,15,14
1746602826028,EDS 290,A00,897211,Hofstetter; Carolyn,0,0,15,15
1746602827057,LIGM 5A,A00,896162,Fischer-Grunski; Eva K,12,0,20,8
1746602828083,LIGM 5B,A00,896260,Fischer-Grunski; Eva K,17,0,20,3
1746602829109,LIGM 5C,A00,896308,Fischer-Grunski; Eva K,18,0,20,2
1746602830140,LIIT 5AS,A00,896313,Carnelos; Chiara,18,0,20,2
1746602831170,LIIT 5BS,A00,896416,Carnelos; Chiara,20,0,20,0
1746602832197,LIIT 5CS,A00,896564,Carnelos; Chiara,20,0,20,0
1746602833223,LISP 5A,A00,896588,Munoz Sanchez; Alicia,2,0,20,18
1746602834248,LISP 5B,A00,896653,Munoz Sanchez; Alicia,7,0,20,13
1746602835274,LISP 5C,A00,896655,Munoz Sanchez; Alicia,0,1,20,20
1746602836299,MAE 197,001,957918,Kleissl; Jan,9996,0,9999,3
1746602836299,MAE 197,002,959806,Boechler; Nicholas Sebastia,9998,0,9999,1
1746602836299,MAE 197,003,959852,Mullin; Jennifer S,9998,0,9999,1
1746602837326,MATH 2,A01,957937,Staff,33,0,35,2
1746602838355,MATH 197,001,957876,Kedlaya; Kiran S.,9993,0,9999,6
1746602839380,MCWP 40,A00,892729,Duru; Nur,10,0,20,10
1746602839380,MCWP 40,B00,893304,Montejo; Carolina,14,0,20,6
1746602840408,MCWP 40R,A00,893757,Redela; Pamela Morgan,0,5,20,20
1746602841432,MCWP 50,A00,893758,Morshed; Michael James,0,0,20,20
1746602841432,MCWP 50,B00,893761,Bartulis; Jason Michael,16,0,20,4
1746602842460,MCWP 50R,A00,893766,Compas; Sean Matthew,0,1,20,20
1746602842460,MCWP 50R,B00,893769,Carter; Jennifer A,0,1,20,20
1746602842460,MCWP 50R,C00,893771,Krone; Jarret,0,3,20,20
1746602842460,MCWP 50R,D00,893772,Miller; Elizabeth Deen,0,0,20,20
1746602842460,MCWP 50R,E00,893775,Carter; Andrea L,0,1,20,20
1746602843490,MMW 11R,A01,892721,Herbst; Matthew,14,0,30,16
1746602843490,MMW 11R,A02,892722,Herbst; Matthew,0,0,0,3
1746602844519,MMW 12R,A01,892724,Herbst; Matthew,0,11,16,16
1746602844519,MMW 12R,A02,892725,Herbst; Matthew,0,10,16,16
1746602845547,MMW 13R,A01,892727,Staff,0,4,16,16
1746602845547,MMW 13R,A02,892728,Staff,0,4,16,16
1746602845547,MMW 13R,A03,958032,Staff,0,4,16,16
1746602845547,MMW 13R,A04,958033,Staff,0,4,16,16
1746602845547,MMW 13R,A05,958034,Staff,0,4,16,16
1746602846579,SIO 295LS,A00,894015,Staff,5,0,25,20
1746602847607,SIO 295S,A00,894020,Staff,5,0,25,20
1746602848641,SIOC 290S,B01,958918,Merrifield; Mark A,14,0,30,16
1746602849667,SIOC 291S,B01,958922,Gabriel; Corey John,14,0,30,16
1746602850695,SOCI 117,A01,895339,Staff,2,0,5,3
1746602851721,WES 237B,A00,894149,Staff,11,0,20,9
1746602853783,AESE 279B,A00,891859,Staff,13,0,35,22
1746602854809,AIP 197,001,891854,Vespa; Emanuel Ignacio,9999,0,9999,0
1746602855838,ANTH 289S,A00,891856,Gagneux; Pascal,12,0,12,0
1746602856863,BENG 196,001,957946,Engler; Adam J.,9996,0,9999,3
1746602857888,BISP 197,001,959851,Wilhelm; James E.,9998,0,9999,1
1746602858911,CAT 124RS,A01,956906,Staff,6,0,25,19
1746602859942,CAT 125RS,A01,922013,Staff,6,0,25,19
1746602860974,CLRE 250,A00,891860,Morris; Sheldon,9995,0,9999,4
1746602863030,CLRE 251R,A00,907817,Mehta; Ravindra L.,9994,0,9999,5
1746602864060,CLRE 252,A00,891864,Cuomo; Raphael Eduardo,9993,0,9999,6
1746602865087,CLRE 253,A00,891867,Vaida; Florin,9994,0,9999,5
1746602865087,CLRE 253,B00,907819,Staff,9999,0,9999,0
1746602866117,CLRE 259,A00,891868,Patel; Hemal,9998,0,9999,1
1746602867142,CLRE 260,A00,891872,Cuomo; Raphael Eduardo,9999,0,9999,0
1746602868170,CLRE 297,001,891888,Cuomo; Raphael Eduardo,9999,0,9999,0
1746602869201,CSE 191,A00,958773,Minnes Kemp; Mor Mia,9995,0,9999,4
1746602870228,CSE 197,001,959846,Minnes Kemp; Mor Mia,9990,0,9999,9
1746602871257,CSS 201S,A01,892054,Mignozzetti; Umberto,25,0,30,5
1746602872288,CSS 202S,A01,892056,Mignozzetti; Umberto,25,0,30,5
1746602873315,DSC 197,001,956898,Eldridge; Justin Matthew,9996,0,9999,3
1746602874345,DSC 297,001,958000,Mazumdar; Arya,9998,0,9999,1
1746602874345,DSC 297,002,959862,Wang; Yusu,9998,0,9999,1
1746602875371,EAP 100,A00,905686,Staff,9778,0,9999,221
1746602876398,ECE 45,A01,892618,Staff,0,0,65,65
1746602878450,ECE 111,A01,892719,Staff,6,0,65,59
1746602879476,ECE 197,001,957920,Mercier; Patrick Philip,9991,0,9999,8
1746602880509,ECON 178,A01,907814,Zhu; Ying,26,0,35,9
1746602881538,EDS 115,A00,895312,Staff,35,0,45,10
1746602882567,EDS 117,A01,895337,Staff,23,0,30,7
1746602883605,EDS 125,A00,895341,Jones; Gabrielle Anastasia,36,0,45,9
1746602884633,EDS 128A,A01,895459,Fargason; Sharon Gayle,44,0,45,1
1746602885663,EDS 128B,A01,895543,Pappas; Elizabeth,44,0,45,1
1746602886691,EDS 139,A00,897203,Pappas; Elizabeth,44,0,45,1
1746602886691,EDS 139,B00,897209,Fargason; Sharon Gayle,41,0,45,4
1746602887720,EDS 201,A00,895545,Staff,22,0,45,23
1746602888750,EDS 203,A01,895581,Halter; Christopher P.,22,0,45,23
1746602889775,EDS 204R,A01,895625,Heinzman; Erica M.,39,0,45,6
1746602889775,EDS 204R,B01,895693,Halter; Christopher P.,10,0,45,35
1746602890805,EDS 206R,A00,895694,Fargason; Sharon Gayle,1,0,30,29
1746602890805,EDS 206R,B00,895695,Choi; Bailey Miyeon,16,0,30,14
1746602891830,EDS 250,A00,895697,Hemans; Patricia Ann Benitez,22,0,45,23
1746602892858,EDS 281,A00,895701,Meyerott; Theresa Ann,1,0,15,14
1746602893884,EDS 284,A00,895736,Meyerott; Theresa Ann,1,0,15,14
1746602894958,EDS 286,A00,897210,Fine; Sarah,0,0,15,15
1746602896542,EDS 289C,A01,895770,Daly; Alan J.,1,0,15,14
1746602897573,EDS 290,A00,897211,Hofstetter; Carolyn,0,0,15,15
1746602898608,LIGM 5A,A00,896162,Fischer-Grunski; Eva K,12,0,20,8
1746602899635,LIGM 5B,A00,896260,Fischer-Grunski; Eva K,17,0,20,3
1746602900661,LIGM 5C,A00,896308,Fischer-Grunski; Eva K,18,0,20,2
1746602901690,LIIT 5AS,A00,896313,Carnelos; Chiara,18,0,20,2
1746602902720,LIIT 5BS,A00,896416,Carnelos; Chiara,20,0,20,0
1746602903746,LIIT 5CS,A00,896564,Carnelos; Chiara,20,0,20,0
1746602904778,LISP 5A,A00,896588,Munoz Sanchez; Alicia,2,0,20,18
1746602905805,LISP 5B,A00,896653,Munoz Sanchez; Alicia,7,0,20,13
1746602906834,LISP 5C,A00,896655,Munoz Sanchez; Alicia,0,1,20,20
1746602907860,MAE 197,001,957918,Kleissl; Jan,9996,0,9999,3
1746602907860,MAE 197,002,959806,Boechler; Nicholas Sebastia,9998,0,9999,1
1746602907860,MAE 197,003,959852,Mullin; Jennifer S,9998,0,9999,1
1746602908889,MATH 2,A01,957937,Staff,33,0,35,2
1746602909918,MATH 197,001,957876,Kedlaya; Kiran S.,9993,0,9999,6
1746602910948,MCWP 40,A00,892729,Duru; Nur,10,0,20,10
1746602910948,MCWP 40,B00,893304,Montejo; Carolina,14,0,20,6
1746602911975,MCWP 40R,A00,893757,Redela; Pamela Morgan,0,5,20,20
1746602913002,MCWP 50,A00,893758,Morshed; Michael James,0,0,20,20
1746602913002,MCWP 50,B00,893761,Bartulis; Jason Michael,16,0,20,4
1746602914028,MCWP 50R,A00,893766,Compas; Sean Matthew,0,1,20,20
1746602914028,MCWP 50R,B00,893769,Carter; Jennifer A,0,1,20,20
1746602914028,MCWP 50R,C00,893771,Krone; Jarret,0,3,20,20
1746602914028,MCWP 50R,D00,893772,Miller; Elizabeth Deen,0,0,20,20
1746602914028,MCWP 50R,E00,893775,Carter; Andrea L,0,1,20,20
1746602915055,MMW 11R,A01,892721,Herbst; Matthew,14,0,30,16
1746602915055,MMW 11R,A02,892722,Herbst; Matthew,0,0,0,3
1746602916081,MMW 12R,A01,892724,Herbst; Matthew,0,11,16,16
1746602916081,MMW 12R,A02,892725,Herbst; Matthew,0,10,16,16
1746602917109,MMW 13R,A01,892727,Staff,0,4,16,16
1746602917109,MMW 13R,A02,892728,Staff,0,4,16,16
1746602917109,MMW 13R,A03,958032,Staff,0,4,16,16
1746602917109,MMW 13R,A04,958033,Staff,0,4,16,16
1746602917109,MMW 13R,A05,958034,Staff,0,4,16,16
1746602918135,SIO 295LS,A00,894015,Staff,5,0,25,20
1746602919164,SIO 295S,A00,894020,Staff,5,0,25,20
1746602920195,SIOC 290S,B01,958918,Merrifield; Mark A,14,0,30,16
1746602921261,SIOC 291S,B01,958922,Gabriel; Corey John,14,0,30,16
1746602922287,SOCI 117,A01,895339,Staff,2,0,5,3
1746602923312,WES 237B,A00,894149,Staff,11,0,20,9
1746602925384,AESE 279B,A00,891859,Staff,13,0,35,22
1746602926413,AIP 197,001,891854,Vespa; Emanuel Ignacio,9999,0,9999,0
1746602927444,ANTH 289S,A00,891856,Gagneux; Pascal,12,0,12,0
1746602928472,BENG 196,001,957946,Engler; Adam J.,9996,0,9999,3
1746602929497,BISP 197,001,959851,Wilhelm; James E.,9998,0,9999,1
1746602930525,CAT 124RS,A01,956906,Staff,6,0,25,19
1746602931551,CAT 125RS,A01,922013,Staff,6,0,25,19
1746602932579,CLRE 250,A00,891860,Morris; Sheldon,9995,0,9999,4
1746602934633,CLRE 251R,A00,907817,Mehta; Ravindra L.,9994,0,9999,5
1746602935663,CLRE 252,A00,891864,Cuomo; Raphael Eduardo,9993,0,9999,6
1746602936690,CLRE 253,A00,891867,Vaida; Florin,9994,0,9999,5
1746602936690,CLRE 253,B00,907819,Staff,9999,0,9999,0
1746602937717,CLRE 259,A00,891868,Patel; Hemal,9998,0,9999,1
1746602938746,CLRE 260,A00,891872,Cuomo; Raphael Eduardo,9999,0,9999,0
1746602939772,CLRE 297,001,891888,Cuomo; Raphael Eduardo,9999,0,9999,0
1746602940802,CSE 191,A00,958773,Minnes Kemp; Mor Mia,9995,0,9999,4
1746602941827,CSE 197,001,959846,Minnes Kemp; Mor Mia,9990,0,9999,9
1746602942859,CSS 201S,A01,892054,Mignozzetti; Umberto,25,0,30,5
1746602943884,CSS 202S,A01,892056,Mignozzetti; Umberto,25,0,30,5
1746602944910,DSC 197,001,956898,Eldridge; Justin Matthew,9996,0,9999,3
1746602945936,DSC 297,001,958000,Mazumdar; Arya,9998,0,9999,1
1746602945936,DSC 297,002,959862,Wang; Yusu,9998,0,9999,1
1746602946965,EAP 100,A00,905686,Staff,9778,0,9999,221
1746602947992,ECE 45,A01,892618,Staff,0,0,65,65
1746602950048,ECE 111,A01,892719,Staff,6,0,65,59
1746602951073,ECE 197,001,957920,Mercier; Patrick Philip,9991,0,9999,8
1746602952100,ECON 178,A01,907814,Zhu; Ying,26,0,35,9
1746602953126,EDS 115,A00,895312,Staff,35,0,45,10
1746602954156,EDS 117,A01,895337,Staff,23,0,30,7
1746602955182,EDS 125,A00,895341,Jones; Gabrielle Anastasia,36,0,45,9
1746602956210,EDS 128A,A01,895459,Fargason; Sharon Gayle,44,0,45,1
1746602957239,EDS 128B,A01,895543,Pappas; Elizabeth,44,0,45,1
1746602958263,EDS 139,A00,897203,Pappas; Elizabeth,44,0,45,1
1746602958263,EDS 139,B00,897209,Fargason; Sharon Gayle,41,0,45,4
1746602959287,EDS 201,A00,895545,Staff,22,0,45,23
1746602960315,EDS 203,A01,895581,Halter; Christopher P.,22,0,45,23
1746602961341,EDS 204R,A01,895625,Heinzman; Erica M.,39,0,45,6
1746602961341,EDS 204R,B01,895693,Halter; Christopher P.,10,0,45,35
1746602962373,EDS 206R,A00,895694,Fargason; Sharon Gayle,1,0,30,29
1746602962373,EDS 206R,B00,895695,Choi; Bailey Miyeon,16,0,30,14
1746602963402,EDS 250,A00,895697,Hemans; Patricia Ann Benitez,22,0,45,23
1746602964429,EDS 281,A00,895701,Meyerott; Theresa Ann,1,0,15,14
1746602965459,EDS 284,A00,895736,Meyerott; Theresa Ann,1,0,15,14
1746602966485,EDS 286,A00,897210,Fine; Sarah,0,0,15,15
1746602967512,EDS 289C,A01,895770,Daly; Alan J.,1,0,15,14
1746602968538,EDS 290,A00,897211,Hofstetter; Carolyn,0,0,15,15
1746602969566,LIGM 5A,A00,896162,Fischer-Grunski; Eva K,12,0,20,8
1746602970593,LIGM 5B,A00,896260,Fischer-Grunski; Eva K,17,0,20,3
1746602971620,LIGM 5C,A00,896308,Fischer-Grunski; Eva K,18,0,20,2
1746602972650,LIIT 5AS,A00,896313,Carnelos; Chiara,18,0,20,2
1746602973675,LIIT 5BS,A00,896416,Carnelos; Chiara,20,0,20,0
1746602974705,LIIT 5CS,A00,896564,Carnelos; Chiara,20,0,20,0
1746602975734,LISP 5A,A00,896588,Munoz Sanchez; Alicia,2,0,20,18
1746602976760,LISP 5B,A00,896653,Munoz Sanchez; Alicia,7,0,20,13
1746602977786,LISP 5C,A00,896655,Munoz Sanchez; Alicia,0,1,20,20
1746602978816,MAE 197,001,957918,Kleissl; Jan,9996,0,9999,3
1746602978816,MAE 197,002,959806,Boechler; Nicholas Sebastia,9998,0,9999,1
1746602978816,MAE 197,003,959852,Mullin; Jennifer S,9998,0,9999,1
1746602979846,MATH 2,A01,957937,Staff,33,0,35,2
1746602980871,MATH 197,001,957876,Kedlaya; Kiran S.,9993,0,9999,6
1746602981902,MCWP 40,A00,892729,Duru; Nur,10,0,20,10
1746602981902,MCWP 40,B00,893304,Montejo; Carolina,14,0,20,6
1746602982930,MCWP 40R,A00,893757,Redela; Pamela Morgan,0,5,20,20
1746602983955,MCWP 50,A00,893758,Morshed; Michael James,0,0,20,20
1746602983955,MCWP 50,B00,893761,Bartulis; Jason Michael,16,0,20,4
1746602984996,MCWP 50R,A00,893766,Compas; Sean Matthew,0,1,20,20
1746602984996,MCWP 50R,B00,893769,Carter; Jennifer A,0,1,20,20
1746602984996,MCWP 50R,C00,893771,Krone; Jarret,0,3,20,20
1746602984996,MCWP 50R,D00,893772,Miller; Elizabeth Deen,0,0,20,20
1746602984996,MCWP 50R,E00,893775,Carter; Andrea L,0,1,20,20
1746602986021,MMW 11R,A01,892721,Herbst; Matthew,14,0,30,16
1746602986021,MMW 11R,A02,892722,Herbst; Matthew,0,0,0,3
1746602987046,MMW 12R,A01,892724,Herbst; Matthew,0,11,16,16
1746602987046,MMW 12R,A02,892725,Herbst; Matthew,0,10,16,16
1746602988075,MMW 13R,A01,892727,Staff,0,4,16,16
1746602988075,MMW 13R,A02,892728,Staff,0,4,16,16
1746602988075,MMW 13R,A03,958032,Staff,0,4,16,16
1746602988075,MMW 13R,A04,958033,Staff,0,4,16,16
1746602988075,MMW 13R,A05,958034,Staff,0,4,16,16
1746602989100,SIO 295LS,A00,894015,Staff,5,0,25,20
1746602990124,SIO 295S,A00,894020,Staff,5,0,25,20
1746602991151,SIOC 290S,B01,958918,Merrifield; Mark A,14,0,30,16
1746602992182,SIOC 291S,B01,958922,Gabriel; Corey John,14,0,30,16
1746602993207,SOCI 117,A01,895339,Staff,2,0,5,3
1746602994236,WES 237B,A00,894149,Staff,11,0,20,9
1746602996302,AESE 279B,A00,891859,Staff,13,0,35,22
1746602997327,AIP 197,001,891854,Vespa; Emanuel Ignacio,9999,0,9999,0
1746602998351,ANTH 289S,A00,891856,Gagneux; Pascal,12,0,12,0
1746602999378,BENG 196,001,957946,Engler; Adam J.,9996,0,9999,3
1746603000403,BISP 197,001,959851,Wilhelm; James E.,9998,0,9999,1
1746603001430,CAT 124RS,A01,956906,Staff,6,0,25,19
1746603002461,CAT 125RS,A01,922013,Staff,6,0,25,19
1746603003492,CLRE 250,A00,891860,Morris; Sheldon,9995,0,9999,4
1746603005550,CLRE 251R,A00,907817,Mehta; Ravindra L.,9994,0,9999,5
1746603006576,CLRE 252,A00,891864,Cuomo; Raphael Eduardo,9993,0,9999,6
1746603007601,CLRE 253,A00,891867,Vaida; Florin,9994,0,9999,5
1746603007601,CLRE 253,B00,907819,Staff,9999,0,9999,0
1746603008627,CLRE 259,A00,891868,Patel; Hemal,9998,0,9999,1
1746603009653,CLRE 260,A00,891872,Cuomo; Raphael Eduardo,9999,0,9999,0
1746603010679,CLRE 297,001,891888,Cuomo; Raphael Eduardo,9999,0,9999,0
1746603011708,CSE 191,A00,958773,Minnes Kemp; Mor Mia,9995,0,9999,4
1746603012735,CSE 197,001,959846,Minnes Kemp; Mor Mia,9990,0,9999,9
1746603013766,CSS 201S,A01,892054,Mignozzetti; Umberto,25,0,30,5
1746603014794,CSS 202S,A01,892056,Mignozzetti; Umberto,25,0,30,5
1746603015823,DSC 197,001,956898,Eldridge; Justin Matthew,9996,0,9999,3
1746603016853,DSC 297,001,958000,Mazumdar; Arya,9998,0,9999,1
1746603016853,DSC 297,002,959862,Wang; Yusu,9998,0,9999,1
1746603017879,EAP 100,A00,905686,Staff,9778,0,9999,221
1746603018906,ECE 45,A01,892618,Staff,0,0,65,65
1746603020958,ECE 111,A01,892719,Staff,6,0,65,59
1746603021982,ECE 197,001,957920,Mercier; Patrick Philip,9991,0,9999,8
1746603023010,ECON 178,A01,907814,Zhu; Ying,26,0,35,9
1746603024038,EDS 115,A00,895312,Staff,35,0,45,10
1746603025064,EDS 117,A01,895337,Staff,23,0,30,7
1746603026088,EDS 125,A00,895341,Jones; Gabrielle Anastasia,36,0,45,9
1746603027117,EDS 128A,A01,895459,Fargason; Sharon Gayle,44,0,45,1
1746603028142,EDS 128B,A01,895543,Pappas; Elizabeth,44,0,45,1
1746603029168,EDS 139,A00,897203,Pappas; Elizabeth,44,0,45,1
1746603029168,EDS 139,B00,897209,Fargason; Sharon Gayle,41,0,45,4
1746603030197,EDS 201,A00,895545,Staff,22,0,45,23
1746603031223,EDS 203,A01,895581,Halter; Christopher P.,22,0,45,23
1746603032251,EDS 204R,A01,895625,Heinzman; Erica M.,39,0,45,6
1746603032251,EDS 204R,B01,895693,Halter; Christopher P.,10,0,45,35
1746603033280,EDS 206R,A00,895694,Fargason; Sharon Gayle,1,0,30,29
1746603033280,EDS 206R,B00,895695,Choi; Bailey Miyeon,16,0,30,14
1746603034305,EDS 250,A00,895697,Hemans; Patricia Ann Benitez,22,0,45,23
1746603035334,EDS 281,A00,895701,Meyerott; Theresa Ann,1,0,15,14
1746603036359,EDS 284,A00,895736,Meyerott; Theresa Ann,1,0,15,14
1746603037383,EDS 286,A00,897210,Fine; Sarah,0,0,15,15
1746603038407,EDS 289C,A01,895770,Daly; Alan J.,1,0,15,14
1746603039433,EDS 290,A00,897211,Hofstetter; Carolyn,0,0,15,15
1746603040460,LIGM 5A,A00,896162,Fischer-Grunski; Eva K,12,0,20,8
1746603041490,LIGM 5B,A00,896260,Fischer-Grunski; Eva K,17,0,20,3
1746603042520,LIGM 5C,A00,896308,Fischer-Grunski; Eva K,18,0,20,2
1746603043549,LIIT 5AS,A00,896313,Carnelos; Chiara,18,0,20,2
1746603044579,LIIT 5BS,A00,896416,Carnelos; Chiara,20,0,20,0
1746603045603,LIIT 5CS,A00,896564,Carnelos; Chiara,20,0,20,0
1746603046632,LISP 5A,A00,896588,Munoz Sanchez; Alicia,2,0,20,18
1746603047661,LISP 5B,A00,896653,Munoz Sanchez; Alicia,7,0,20,13
1746603048689,LISP 5C,A00,896655,Munoz Sanchez; Alicia,0,1,20,20
1746603049728,MAE 197,001,957918,Kleissl; Jan,9996,0,9999,3
1746603049728,MAE 197,002,959806,Boechler; Nicholas Sebastia,9998,0,9999,1
1746603049728,MAE 197,003,959852,Mullin; Jennifer S,9998,0,9999,1
1746603050757,MATH 2,A01,957937,Staff,33,0,35,2
1746603051788,MATH 197,001,957876,Kedlaya; Kiran S.,9993,0,9999,6
1746603052814,MCWP 40,A00,892729,Duru; Nur,10,0,20,10
1746603052814,MCWP 40,B00,893304,Montejo; Carolina,14,0,20,6
1746603053842,MCWP 40R,A00,893757,Redela; Pamela Morgan,0,5,20,20
1746603054869,MCWP 50,A00,893758,Morshed; Michael James,0,0,20,20
1746603054869,MCWP 50,B00,893761,Bartulis; Jason Michael,16,0,20,4
1746603055899,MCWP 50R,A00,893766,Compas; Sean Matthew,0,1,20,20
1746603055899,MCWP 50R,B00,893769,Carter; Jennifer A,0,1,20,20
1746603055899,MCWP 50R,C00,893771,Krone; Jarret,0,3,20,20
1746603055899,MCWP 50R,D00,893772,Miller; Elizabeth Deen,0,0,20,20
1746603055899,MCWP 50R,E00,893775,Carter; Andrea L,0,1,20,20
1746603056926,MMW 11R,A01,892721,Herbst; Matthew,14,0,30,16
1746603056926,MMW 11R,A02,892722,Herbst; Matthew,0,0,0,3
1746603057952,MMW 12R,A01,892724,Herbst; Matthew,0,11,16,16
1746603057952,MMW 12R,A02,892725,Herbst; Matthew,0,10,16,16
1746603058981,MMW 13R,A01,892727,Staff,0,4,16,16
1746603058981,MMW 13R,A02,892728,Staff,0,4,16,16
1746603058981,MMW 13R,A03,958032,Staff,0,4,16,16
1746603058981,MMW 13R,A04,958033,Staff,0,4,16,16
1746603058981,MMW 13R,A05,958034,Staff,0,4,16,16
1746603060007,SIO 295LS,A00,894015,Staff,5,0,25,20
1746603061036,SIO 295S,A00,894020,Staff,5,0,25,20
1746603062063,SIOC 290S,B01,958918,Merrifield; Mark A,14,0,30,16
1746603063092,SIOC 291S,B01,958922,Gabriel; Corey John,14,0,30,16
1746603064117,SOCI 117,A01,895339,Staff,2,0,5,3
1746603065143,WES 237B,A00,894149,Staff,11,0,20,9
1746603067221,AESE 279B,A00,891859,Staff,13,0,35,22
1746603068247,AIP 197,001,891854,Vespa; Emanuel Ignacio,9999,0,9999,0
1746603069275,ANTH 289S,A00,891856,Gagneux; Pascal,12,0,12,0
1746603070305,BENG 196,001,957946,Engler; Adam J.,9996,0,9999,3
1746603071334,BISP 197,001,959851,Wilhelm; James E.,9998,0,9999,1
1746603072357,CAT 124RS,A01,956906,Staff,6,0,25,19
1746603073382,CAT 125RS,A01,922013,Staff,6,0,25,19
1746603074407,CLRE 250,A00,891860,Morris; Sheldon,9995,0,9999,4
1746603076460,CLRE 251R,A00,907817,Mehta; Ravindra L.,9994,0,9999,5
1746603077487,CLRE 252,A00,891864,Cuomo; Raphael Eduardo,9993,0,9999,6
1746603078519,CLRE 253,A00,891867,Vaida; Florin,9994,0,9999,5
1746603078519,CLRE 253,B00,907819,Staff,9999,0,9999,0
1746603079545,CLRE 259,A00,891868,Patel; Hemal,9998,0,9999,1
1746603080571,CLRE 260,A00,891872,Cuomo; Raphael Eduardo,9999,0,9999,0
1746603081596,CLRE 297,001,891888,Cuomo; Raphael Eduardo,9999,0,9999,0
1746603082629,CSE 191,A00,958773,Minnes Kemp; Mor Mia,9995,0,9999,4
1746603083658,CSE 197,001,959846,Minnes Kemp; Mor Mia,9990,0,9999,9
1746603084685,CSS 201S,A01,892054,Mignozzetti; Umberto,25,0,30,5
1746603085709,CSS 202S,A01,892056,Mignozzetti; Umberto,25,0,30,5
1746603086736,DSC 197,001,956898,Eldridge; Justin Matthew,9996,0,9999,3
1746603087763,DSC 297,001,958000,Mazumdar; Arya,9998,0,9999,1
1746603087763,DSC 297,002,959862,Wang; Yusu,9998,0,9999,1
1746603088791,EAP 100,A00,905686,Staff,9778,0,9999,221
1746603089826,ECE 45,A01,892618,Staff,0,0,65,65
1746603091879,ECE 111,A01,892719,Staff,6,0,65,59
1746603092906,ECE 197,001,957920,Mercier; Patrick Philip,9991,0,9999,8
1746603093934,ECON 178,A01,907814,Zhu; Ying,26,0,35,9
1746603094961,EDS 115,A00,895312,Staff,35,0,45,10
1746603095991,EDS 117,A01,895337,Staff,23,0,30,7
1746603097015,EDS 125,A00,895341,Jones; Gabrielle Anastasia,36,0,45,9
1746603098041,EDS 128A,A01,895459,Fargason; Sharon Gayle,44,0,45,1
1746603099070,EDS 128B,A01,895543,Pappas; Elizabeth,44,0,45,1
1746603100103,EDS 139,A00,897203,Pappas; Elizabeth,44,0,45,1
1746603100103,EDS 139,B00,897209,Fargason; Sharon Gayle,41,0,45,4
1746603101129,EDS 201,A00,895545,Staff,22,0,45,23
1746603102159,EDS 203,A01,895581,Halter; Christopher P.,22,0,45,23
1746603103188,EDS 204R,A01,895625,Heinzman; Erica M.,39,0,45,6
1746603103188,EDS 204R,B01,895693,Halter; Christopher P.,10,0,45,35
1746603104219,EDS 206R,A00,895694,Fargason; Sharon Gayle,1,0,30,29
1746603104219,EDS 206R,B00,895695,Choi; Bailey Miyeon,16,0,30,14
1746603105252,EDS 250,A00,895697,Hemans; Patricia Ann Benitez,22,0,45,23
1746603106278,EDS 281,A00,895701,Meyerott; Theresa Ann,1,0,15,14
1746603107309,EDS 284,A00,895736,Meyerott; Theresa Ann,1,0,15,14
1746603108335,EDS 286,A00,897210,Fine; Sarah,0,0,15,15
1746603109366,EDS 289C,A01,895770,Daly; Alan J.,1,0,15,14
1746603110396,EDS 290,A00,897211,Hofstetter; Carolyn,0,0,15,15
1746603111421,LIGM 5A,A00,896162,Fischer-Grunski; Eva K,12,0,20,8
1746603112447,LIGM 5B,A00,896260,Fischer-Grunski; Eva K,17,0,20,3
1746603113474,LIGM 5C,A00,896308,Fischer-Grunski; Eva K,18,0,20,2
1746603114500,LIIT 5AS,A00,896313,Carnelos; Chiara,18,0,20,2
1746603115527,LIIT 5BS,A00,896416,Carnelos; Chiara,20,0,20,0
1746603116559,LIIT 5CS,A00,896564,Carnelos; Chiara,20,0,20,0
1746603117584,LISP 5A,A00,896588,Munoz Sanchez; Alicia,2,0,20,18
1746603118619,LISP 5B,A00,896653,Munoz Sanchez; Alicia,7,0,20,13
1746603119648,LISP 5C,A00,896655,Munoz Sanchez; Alicia,0,1,20,20
1746603120679,MAE 197,001,957918,Kleissl; Jan,9996,0,9999,3
1746603120679,MAE 197,002,959806,Boechler; Nicholas Sebastia,9998,0,9999,1
1746603120679,MAE 197,003,959852,Mullin; Jennifer S,9998,0,9999,1
1746603121711,MATH 2,A01,957937,Staff,33,0,35,2
1746603122739,MATH 197,001,957876,Kedlaya; Kiran S.,9993,0,9999,6
1746603123771,MCWP 40,A00,892729,Duru; Nur,10,0,20,10
1746603123771,MCWP 40,B00,893304,Montejo; Carolina,14,0,20,6
1746603124806,MCWP 40R,A00,893757,Redela; Pamela Morgan,0,5,20,20
1746603125835,MCWP 50,A00,893758,Morshed; Michael James,0,0,20,20
1746603125835,MCWP 50,B00,893761,Bartulis; Jason Michael,16,0,20,4
1746603126862,MCWP 50R,A00,893766,Compas; Sean Matthew,0,1,20,20
1746603126862,MCWP 50R,B00,893769,Carter; Jennifer A,0,1,20,20
1746603126862,MCWP 50R,C00,893771,Krone; Jarret,0,3,20,20
1746603126862,MCWP 50R,D00,893772,Miller; Elizabeth Deen,0,0,20,20
1746603126862,MCWP 50R,E00,893775,Carter; Andrea L,0,1,20,20
1746603127892,MMW 11R,A01,892721,Herbst; Matthew,14,0,30,16
1746603127892,MMW 11R,A02,892722,Herbst; Matthew,0,0,0,3
1746603128916,MMW 12R,A01,892724,Herbst; Matthew,0,11,16,16
1746603128916,MMW 12R,A02,892725,Herbst; Matthew,0,10,16,16
1746603129943,MMW 13R,A01,892727,Staff,0,4,16,16
1746603129943,MMW 13R,A02,892728,Staff,0,4,16,16
1746603129943,MMW 13R,A03,958032,Staff,0,4,16,16
1746603129943,MMW 13R,A04,958033,Staff,0,4,16,16
1746603129943,MMW 13R,A05,958034,Staff,0,4,16,16
1746603130972,SIO 295LS,A00,894015,Staff,5,0,25,20
1746603132003,SIO 295S,A00,894020,Staff,5,0,25,20
1746603133029,SIOC 290S,B01,958918,Merrifield; Mark A,14,0,30,16
1746603134077,SIOC 291S,B01,958922,Gabriel; Corey John,14,0,30,16
1746603135105,SOCI 117,A01,895339,Staff,2,0,5,3
1746603136137,WES 237B,A00,894149,Staff,11,0,20,9
1746603138250,AESE 279B,A00,891859,Staff,13,0,35,22
1746603139279,AIP 197,001,891854,Vespa; Emanuel Ignacio,9999,0,9999,0
1746603140309,ANTH 289S,A00,891856,Gagneux; Pascal,12,0,12,0
1746603141335,BENG 196,001,957946,Engler; Adam J.,9996,0,9999,3
1746603142359,BISP 197,001,959851,Wilhelm; James E.,9998,0,9999,1
1746603143384,CAT 124RS,A01,956906,Staff,6,0,25,19
1746603144409,CAT 125RS,A01,922013,Staff,6,0,25,19
1746603145444,CLRE 250,A00,891860,Morris; Sheldon,9995,0,9999,4
1746603147499,CLRE 251R,A00,907817,Mehta; Ravindra L.,9994,0,9999,5
1746603148525,CLRE 252,A00,891864,Cuomo; Raphael Eduardo,9993,0,9999,6
1746603149552,CLRE 253,A00,891867,Vaida; Florin,9994,0,9999,5
1746603149552,CLRE 253,B00,907819,Staff,9999,0,9999,0
1746603150582,CLRE 259,A00,891868,Patel; Hemal,9998,0,9999,1
1746603151609,CLRE 260,A00,891872,Cuomo; Raphael Eduardo,9999,0,9999,0
1746603152634,CLRE 297,001,891888,Cuomo; Raphael Eduardo,9999,0,9999,0
1746603153664,CSE 191,A00,958773,Minnes Kemp; Mor Mia,9995,0,9999,4
1746603154692,CSE 197,001,959846,Minnes Kemp; Mor Mia,9990,0,9999,9
1746603155721,CSS 201S,A01,892054,Mignozzetti; Umberto,25,0,30,5
1746603156746,CSS 202S,A01,892056,Mignozzetti; Umberto,25,0,30,5
1746603157774,DSC 197,001,956898,Eldridge; Justin Matthew,9996,0,9999,3
1746603158807,DSC 297,001,958000,Mazumdar; Arya,9998,0,9999,1
1746603158807,DSC 297,002,959862,Wang; Yusu,9998,0,9999,1
1746603159833,EAP 100,A00,905686,Staff,9778,0,9999,221
1746603160862,ECE 45,A01,892618,Staff,0,0,65,65
1746603162916,ECE 111,A01,892719,Staff,6,0,65,59
1746603163945,ECE 197,001,957920,Mercier; Patrick Philip,9991,0,9999,8
1746603164972,ECON 178,A01,907814,Zhu; Ying,26,0,35,9
1746603165996,EDS 115,A00,895312,Staff,35,0,45,10
1746603167028,EDS 117,A01,895337,Staff,23,0,30,7
1746603168053,EDS 125,A00,895341,Jones; Gabrielle Anastasia,36,0,45,9
1746603169088,EDS 128A,A01,895459,Fargason; Sharon Gayle,44,0,45,1
1746603170120,EDS 128B,A01,895543,Pappas; Elizabeth,44,0,45,1
1746603171149,EDS 139,A00,897203,Pappas; Elizabeth,44,0,45,1
1746603171149,EDS 139,B00,897209,Fargason; Sharon Gayle,41,0,45,4
1746603172174,EDS 201,A00,895545,Staff,22,0,45,23
1746603173206,EDS 203,A01,895581,Halter; Christopher P.,22,0,45,23
1746603174233,EDS 204R,A01,895625,Heinzman; Erica M.,39,0,45,6
1746603174233,EDS 204R,B01,895693,Halter; Christopher P.,10,0,45,35
1746603175265,EDS 206R,A00,895694,Fargason; Sharon Gayle,1,0,30,29
1746603175265,EDS 206R,B00,895695,Choi; Bailey Miyeon,16,0,30,14
1746603176292,EDS 250,A00,895697,Hemans; Patricia Ann Benitez,22,0,45,23
1746603177319,EDS 281,A00,895701,Meyerott; Theresa Ann,1,0,15,14
1746603178346,EDS 284,A00,895736,Meyerott; Theresa Ann,1,0,15,14
1746603179377,EDS 286,A00,897210,Fine; Sarah,0,0,15,15
1746603180406,EDS 289C,A01,895770,Daly; Alan J.,1,0,15,14
1746603181434,EDS 290,A00,897211,Hofstetter; Carolyn,0,0,15,15
1746603182461,LIGM 5A,A00,896162,Fischer-Grunski; Eva K,12,0,20,8
1746603183488,LIGM 5B,A00,896260,Fischer-Grunski; Eva K,17,0,20,3
1746603184514,LIGM 5C,A00,896308,Fischer-Grunski; Eva K,18,0,20,2
1746603185541,LIIT 5AS,A00,896313,Carnelos; Chiara,18,0,20,2
1746603186574,LIIT 5BS,A00,896416,Carnelos; Chiara,20,0,20,0
1746603187601,LIIT 5CS,A00,896564,Carnelos; Chiara,20,0,20,0
1746603188642,LISP 5A,A00,896588,Munoz Sanchez; Alicia,2,0,20,18
1746603189669,LISP 5B,A00,896653,Munoz Sanchez; Alicia,7,0,20,13
1746603190697,LISP 5C,A00,896655,Munoz Sanchez; Alicia,0,1,20,20
1746603191733,MAE 197,001,957918,Kleissl; Jan,9996,0,9999,3
1746603191733,MAE 197,002,959806,Boechler; Nicholas Sebastia,9998,0,9999,1
1746603191733,MAE 197,003,959852,Mullin; Jennifer S,9998,0,9999,1
1746603192758,MATH 2,A01,957937,Staff,33,0,35,2
1746603193785,MATH 197,001,957876,Kedlaya; Kiran S.,9993,0,9999,6
1746603194825,MCWP 40,A00,892729,Duru; Nur,10,0,20,10
1746603194825,MCWP 40,B00,893304,Montejo; Carolina,14,0,20,6
1746603195851,MCWP 40R,A00,893757,Redela; Pamela Morgan,0,5,20,20
1746603196881,MCWP 50,A00,893758,Morshed; Michael James,0,0,20,20
1746603196881,MCWP 50,B00,893761,Bartulis; Jason Michael,16,0,20,4
1746603197910,MCWP 50R,A00,893766,Compas; Sean Matthew,0,1,20,20
1746603197910,MCWP 50R,B00,893769,Carter; Jennifer A,0,1,20,20
1746603197910,MCWP 50R,C00,893771,Krone; Jarret,0,3,20,20
1746603197910,MCWP 50R,D00,893772,Miller; Elizabeth Deen,0,0,20,20
1746603197910,MCWP 50R,E00,893775,Carter; Andrea L,0,1,20,20
1746603198944,MMW 11R,A01,892721,Herbst; Matthew,14,0,30,16
1746603198944,MMW 11R,A02,892722,Herbst; Matthew,0,0,0,3
1746603199970,MMW 12R,A01,892724,Herbst; Matthew,0,11,16,16
1746603199970,MMW 12R,A02,892725,Herbst; Matthew,0,10,16,16
1746603200998,MMW 13R,A01,892727,Staff,0,4,16,16
1746603200998,MMW 13R,A02,892728,Staff,0,4,16,16
1746603200998,MMW 13R,A03,958032,Staff,0,4,16,16
1746603200998,MMW 13R,A04,958033,Staff,0,4,16,16
1746603200998,MMW 13R,A05,958034,Staff,0,4,16,16
1746603202023,SIO 295LS,A00,894015,Staff,5,0,25,20
1746603203055,SIO 295S,A00,894020,Staff,5,0,25,20
1746603204083,SIOC 290S,B01,958918,Merrifield; Mark A,14,0,30,16
1746603205120,SIOC 291S,B01,958922,Gabriel; Corey John,14,0,30,16
1746603206148,SOCI 117,A01,895339,Staff,2,0,5,3
1746603207174,WES 237B,A00,894149,Staff,11,0,20,9
1746603209268,AESE 279B,A00,891859,Staff,13,0,35,22
1746603210295,AIP 197,001,891854,Vespa; Emanuel Ignacio,9999,0,9999,0
1746603211325,ANTH 289S,A00,891856,Gagneux; Pascal,12,0,12,0
1746603212354,BENG 196,001,957946,Engler; Adam J.,9996,0,9999,3
1746603213382,BISP 197,001,959851,Wilhelm; James E.,9998,0,9999,1
1746603214413,CAT 124RS,A01,956906,Staff,6,0,25,19
1746603215441,CAT 125RS,A01,922013,Staff,6,0,25,19
1746603216472,CLRE 250,A00,891860,Morris; Sheldon,9995,0,9999,4
1746603218550,CLRE 251R,A00,907817,Mehta; Ravindra L.,9994,0,9999,5
1746603219596,CLRE 252,A00,891864,Cuomo; Raphael Eduardo,9993,0,9999,6
1746603220632,CLRE 253,A00,891867,Vaida; Florin,9994,0,9999,5
1746603220632,CLRE 253,B00,907819,Staff,9999,0,9999,0
1746603221667,CLRE 259,A00,891868,Patel; Hemal,9998,0,9999,1
1746603222692,CLRE 260,A00,891872,Cuomo; Raphael Eduardo,9999,0,9999,0
1746603223718,CLRE 297,001,891888,Cuomo; Raphael Eduardo,9999,0,9999,0
1746603224754,CSE 191,A00,958773,Minnes Kemp; Mor Mia,9995,0,9999,4
1746603225780,CSE 197,001,959846,Minnes Kemp; Mor Mia,9990,0,9999,9
1746603226807,CSS 201S,A01,892054,Mignozzetti; Umberto,25,0,30,5
1746603227840,CSS 202S,A01,892056,Mignozzetti; Umberto,25,0,30,5
1746603228869,DSC 197,001,956898,Eldridge; Justin Matthew,9996,0,9999,3
1746603229897,DSC 297,001,958000,Mazumdar; Arya,9998,0,9999,1
1746603229897,DSC 297,002,959862,Wang; Yusu,9998,0,9999,1
1746603230925,EAP 100,A00,905686,Staff,9778,0,9999,221
1746603231951,ECE 45,A01,892618,Staff,0,0,65,65
1746603234010,ECE 111,A01,892719,Staff,6,0,65,59
1746603235042,ECE 197,001,957920,Mercier; Patrick Philip,9991,0,9999,8
1746603236067,ECON 178,A01,907814,Zhu; Ying,26,0,35,9
1746603237094,EDS 115,A00,895312,Staff,35,0,45,10
1746603238121,EDS 117,A01,895337,Staff,23,0,30,7
1746603239159,EDS 125,A00,895341,Jones; Gabrielle Anastasia,36,0,45,9
1746603240185,EDS 128A,A01,895459,Fargason; Sharon Gayle,44,0,45,1
1746603241209,EDS 128B,A01,895543,Pappas; Elizabeth,44,0,45,1
1746603242237,EDS 139,A00,897203,Pappas; Elizabeth,44,0,45,1
1746603242237,EDS 139,B00,897209,Fargason; Sharon Gayle,41,0,45,4
1746603243263,EDS 201,A00,895545,Staff,22,0,45,23
1746603244289,EDS 203,A01,895581,Halter; Christopher P.,22,0,45,23
1746603245325,EDS 204R,A01,895625,Heinzman; Erica M.,39,0,45,6
1746603245325,EDS 204R,B01,895693,Halter; Christopher P.,10,0,45,35
1746603246351,EDS 206R,A00,895694,Fargason; Sharon Gayle,1,0,30,29
1746603246351,EDS 206R,B00,895695,Choi; Bailey Miyeon,16,0,30,14
1746603247383,EDS 250,A00,895697,Hemans; Patricia Ann Benitez,22,0,45,23
1746603248409,EDS 281,A00,895701,Meyerott; Theresa Ann,1,0,15,14
1746603249437,EDS 284,A00,895736,Meyerott; Theresa Ann,1,0,15,14
1746603250469,EDS 286,A00,897210,Fine; Sarah,0,0,15,15
1746603251496,EDS 289C,A01,895770,Daly; Alan J.,1,0,15,14
1746603252522,EDS 290,A00,897211,Hofstetter; Carolyn,0,0,15,15
1746603253560,LIGM 5A,A00,896162,Fischer-Grunski; Eva K,12,0,20,8
1746603254591,LIGM 5B,A00,896260,Fischer-Grunski; Eva K,17,0,20,3
1746603255617,LIGM 5C,A00,896308,Fischer-Grunski; Eva K,18,0,20,2
1746603256644,LIIT 5AS,A00,896313,Carnelos; Chiara,18,0,20,2
1746603257673,LIIT 5BS,A00,896416,Carnelos; Chiara,20,0,20,0
1746603258699,LIIT 5CS,A00,896564,Carnelos; Chiara,20,0,20,0
1746603259728,LISP 5A,A00,896588,Munoz Sanchez; Alicia,2,0,20,18
1746603260755,LISP 5B,A00,896653,Munoz Sanchez; Alicia,7,0,20,13
1746603261785,LISP 5C,A00,896655,Munoz Sanchez; Alicia,0,1,20,20
1746603262820,MAE 197,001,957918,Kleissl; Jan,9996,0,9999,3
1746603262820,MAE 197,002,959806,Boechler; Nicholas Sebastia,9998,0,9999,1
1746603262820,MAE 197,003,959852,Mullin; Jennifer S,9998,0,9999,1
1746603263853,MATH 2,A01,957937,Staff,33,0,35,2
1746603264890,MATH 197,001,957876,Kedlaya; Kiran S.,9993,0,9999,6
1746603265922,MCWP 40,A00,892729,Duru; Nur,10,0,20,10
1746603265922,MCWP 40,B00,893304,Montejo; Carolina,14,0,20,6
1746603266950,MCWP 40R,A00,893757,Redela; Pamela Morgan,0,5,20,20
1746603267982,MCWP 50,A00,893758,Morshed; Michael James,0,0,20,20
1746603267982,MCWP 50,B00,893761,Bartulis; Jason Michael,16,0,20,4
1746603269012,MCWP 50R,A00,893766,Compas; Sean Matthew,0,1,20,20
1746603269012,MCWP 50R,B00,893769,Carter; Jennifer A,0,1,20,20
1746603269012,MCWP 50R,C00,893771,Krone; Jarret,0,3,20,20
1746603269012,MCWP 50R,D00,893772,Miller; Elizabeth Deen,0,0,20,20
1746603269012,MCWP 50R,E00,893775,Carter; Andrea L,0,1,20,20
1746603270043,MMW 11R,A01,892721,Herbst; Matthew,14,0,30,16
1746603270043,MMW 11R,A02,892722,Herbst; Matthew,0,0,0,3
1746603271071,MMW 12R,A01,892724,Herbst; Matthew,0,11,16,16
1746603271071,MMW 12R,A02,892725,Herbst; Matthew,0,10,16,16
1746603272101,MMW 13R,A01,892727,Staff,0,4,16,16
1746603272101,MMW 13R,A02,892728,Staff,0,4,16,16
1746603272101,MMW 13R,A03,958032,Staff,0,4,16,16
1746603272101,MMW 13R,A04,958033,Staff,0,4,16,16
1746603272101,MMW 13R,A05,958034,Staff,0,4,16,16
1746603273128,SIO 295LS,A00,894015,Staff,5,0,25,20
1746603274158,SIO 295S,A00,894020,Staff,5,0,25,20
1746603275200,SIOC 290S,B01,958918,Merrifield; Mark A,14,0,30,16
1746603276228,SIOC 291S,B01,958922,Gabriel; Corey John,14,0,30,16
1746603277260,SOCI 117,A01,895339,Staff,2,0,5,3
1746603278288,WES 237B,A00,894149,Staff,11,0,20,9
1746603280381,AESE 279B,A00,891859,Staff,13,0,35,22
1746603281406,AIP 197,001,891854,Vespa; Emanuel Ignacio,9999,0,9999,0
1746603282453,ANTH 289S,A00,891856,Gagneux; Pascal,12,0,12,0
1746603283481,BENG 196,001,957946,Engler; Adam J.,9996,0,9999,3
1746603284506,BISP 197,001,959851,Wilhelm; James E.,9998,0,9999,1
1746603285533,CAT 124RS,A01,956906,Staff,6,0,25,19
1746603286561,CAT 125RS,A01,922013,Staff,6,0,25,19
1746603287593,CLRE 250,A00,891860,Morris; Sheldon,9995,0,9999,4
1746603289651,CLRE 251R,A00,907817,Mehta; Ravindra L.,9994,0,9999,5
1746603290678,CLRE 252,A00,891864,Cuomo; Raphael Eduardo,9993,0,9999,6
1746603291707,CLRE 253,A00,891867,Vaida; Florin,9994,0,9999,5
1746603291707,CLRE 253,B00,907819,Staff,9999,0,9999,0
1746603292736,CLRE 259,A00,891868,Patel; Hemal,9998,0,9999,1
1746603293771,CLRE 260,A00,891872,Cuomo; Raphael Eduardo,9999,0,9999,0
1746603294795,CLRE 297,001,891888,Cuomo; Raphael Eduardo,9999,0,9999,0
1746603295824,CSE 191,A00,958773,Minnes Kemp; Mor Mia,9995,0,9999,4
1746603296850,CSE 197,001,959846,Minnes Kemp; Mor Mia,9990,0,9999,9
1746603297877,CSS 201S,A01,892054,Mignozzetti; Umberto,25,0,30,5
1746603298905,CSS 202S,A01,892056,Mignozzetti; Umberto,25,0,30,5
1746603299938,DSC 197,001,956898,Eldridge; Justin Matthew,9996,0,9999,3
1746603300970,DSC 297,001,958000,Mazumdar; Arya,9998,0,9999,1
1746603300970,DSC 297,002,959862,Wang; Yusu,9998,0,9999,1
1746603301998,EAP 100,A00,905686,Staff,9778,0,9999,221
1746603303029,ECE 45,A01,892618,Staff,0,0,65,65
1746603305092,ECE 111,A01,892719,Staff,6,0,65,59
1746603306119,ECE 197,001,957920,Mercier; Patrick Philip,9991,0,9999,8
1746603307152,ECON 178,A01,907814,Zhu; Ying,26,0,35,9
1746603308179,EDS 115,A00,895312,Staff,35,0,45,10
1746603309208,EDS 117,A01,895337,Staff,23,0,30,7
1746603310234,EDS 125,A00,895341,Jones; Gabrielle Anastasia,36,0,45,9
1746603311265,EDS 128A,A01,895459,Fargason; Sharon Gayle,44,0,45,1
1746603312291,EDS 128B,A01,895543,Pappas; Elizabeth,44,0,45,1
1746603313319,EDS 139,A00,897203,Pappas; Elizabeth,44,0,45,1
1746603313319,EDS 139,B00,897209,Fargason; Sharon Gayle,41,0,45,4
1746603314352,EDS 201,A00,895545,Staff,22,0,45,23
1746603315383,EDS 203,A01,895581,Halter; Christopher P.,22,0,45,23
1746603316415,EDS 204R,A01,895625,Heinzman; Erica M.,39,0,45,6
1746603316415,EDS 204R,B01,895693,Halter; Christopher P.,10,0,45,35
1746603317447,EDS 206R,A00,895694,Fargason; Sharon Gayle,1,0,30,29
1746603317447,EDS 206R,B00,895695,Choi; Bailey Miyeon,16,0,30,14
1746603318476,EDS 250,A00,895697,Hemans; Patricia Ann Benitez,22,0,45,23
1746603319507,EDS 281,A00,895701,Meyerott; Theresa Ann,1,0,15,14
1746603320539,EDS 284,A00,895736,Meyerott; Theresa Ann,1,0,15,14
1746603321564,EDS 286,A00,897210,Fine; Sarah,0,0,15,15
1746603322591,EDS 289C,A01,895770,Daly; Alan J.,1,0,15,14
1746603323623,EDS 290,A00,897211,Hofstetter; Carolyn,0,0,15,15
1746603324658,LIGM 5A,A00,896162,Fischer-Grunski; Eva K,12,0,20,8
1746603325686,LIGM 5B,A00,896260,Fischer-Grunski; Eva K,17,0,20,3
1746603326713,LIGM 5C,A00,896308,Fischer-Grunski; Eva K,18,0,20,2
1746603327746,LIIT 5AS,A00,896313,Carnelos; Chiara,18,0,20,2
1746603328772,LIIT 5BS,A00,896416,Carnelos; Chiara,20,0,20,0
1746603329806,LIIT 5CS,A00,896564,Carnelos; Chiara,20,0,20,0
1746603330831,LISP 5A,A00,896588,Munoz Sanchez; Alicia,2,0,20,18
1746603331857,LISP 5B,A00,896653,Munoz Sanchez; Alicia,7,0,20,13
1746603332884,LISP 5C,A00,896655,Munoz Sanchez; Alicia,0,1,20,20
1746603333926,MAE 197,001,957918,Kleissl; Jan,9996,0,9999,3
1746603333926,MAE 197,002,959806,Boechler; Nicholas Sebastia,9998,0,9999,1
1746603333926,MAE 197,003,959852,Mullin; Jennifer S,9998,0,9999,1
1746603334956,MATH 2,A01,957937,Staff,33,0,35,2
1746603335984,MATH 197,001,957876,Kedlaya; Kiran S.,9993,0,9999,6
1746603337013,MCWP 40,A00,892729,Duru; Nur,10,0,20,10
1746603337013,MCWP 40,B00,893304,Montejo; Carolina,14,0,20,6
1746603338039,MCWP 40R,A00,893757,Redela; Pamela Morgan,0,5,20,20
1746603339069,MCWP 50,A00,893758,Morshed; Michael James,0,0,20,20
1746603339069,MCWP 50,B00,893761,Bartulis; Jason Michael,16,0,20,4
1746603340099,MCWP 50R,A00,893766,Compas; Sean Matthew,0,1,20,20
1746603340099,MCWP 50R,B00,893769,Carter; Jennifer A,0,1,20,20
1746603340099,MCWP 50R,C00,893771,Krone; Jarret,0,3,20,20
1746603340099,MCWP 50R,D00,893772,Miller; Elizabeth Deen,0,0,20,20
1746603340099,MCWP 50R,E00,893775,Carter; Andrea L,0,1,20,20
1746603341131,MMW 11R,A01,892721,Herbst; Matthew,14,0,30,16
1746603341131,MMW 11R,A02,892722,Herbst; Matthew,0,0,0,3
1746603342158,MMW 12R,A01,892724,Herbst; Matthew,0,11,16,16
1746603342158,MMW 12R,A02,892725,Herbst; Matthew,0,10,16,16
1746603343186,MMW 13R,A01,892727,Staff,0,4,16,16
1746603343186,MMW 13R,A02,892728,Staff,0,4,16,16
1746603343186,MMW 13R,A03,958032,Staff,0,4,16,16
1746603343186,MMW 13R,A04,958033,Staff,0,4,16,16
1746603343186,MMW 13R,A05,958034,Staff,0,4,16,16
1746603344218,SIO 295LS,A00,894015,Staff,5,0,25,20
1746603345243,SIO 295S,A00,894020,Staff,5,0,25,20
1746603346284,SIOC 290S,B01,958918,Merrifield; Mark A,14,0,30,16
1746603347318,SIOC 291S,B01,958922,Gabriel; Corey John,14,0,30,16
1746603348345,SOCI 117,A01,895339,Staff,2,0,5,3
1746603349371,WES 237B,A00,894149,Staff,11,0,20,9
1746603351456,AESE 279B,A00,891859,Staff,13,0,35,22
1746603352485,AIP 197,001,891854,Vespa; Emanuel Ignacio,9999,0,9999,0
1746603353513,ANTH 289S,A00,891856,Gagneux; Pascal,12,0,12,0
1746603354548,BENG 196,001,957946,Engler; Adam J.,9996,0,9999,3
1746603355574,BISP 197,001,959851,Wilhelm; James E.,9998,0,9999,1
1746603356606,CAT 124RS,A01,956906,Staff,6,0,25,19
1746603357635,CAT 125RS,A01,922013,Staff,6,0,25,19
1746603358662,CLRE 250,A00,891860,Morris; Sheldon,9995,0,9999,4
1746603360719,CLRE 251R,A00,907817,Mehta; Ravindra L.,9994,0,9999,5
1746603361746,CLRE 252,A00,891864,Cuomo; Raphael Eduardo,9993,0,9999,6
1746603362773,CLRE 253,A00,891867,Vaida; Florin,9994,0,9999,5
1746603362773,CLRE 253,B00,907819,Staff,9999,0,9999,0
1746603363803,CLRE 259,A00,891868,Patel; Hemal,9998,0,9999,1
1746603364832,CLRE 260,A00,891872,Cuomo; Raphael Eduardo,9999,0,9999,0
1746603365859,CLRE 297,001,891888,Cuomo; Raphael Eduardo,9999,0,9999,0
1746603366888,CSE 191,A00,958773,Minnes Kemp; Mor Mia,9995,0,9999,4
1746603367917,CSE 197,001,959846,Minnes Kemp; Mor Mia,9990,0,9999,9
1746603368948,CSS 201S,A01,892054,Mignozzetti; Umberto,25,0,30,5
1746603369998,CSS 202S,A01,892056,Mignozzetti; Umberto,25,0,30,5
1746603371025,DSC 197,001,956898,Eldridge; Justin Matthew,9996,0,9999,3
1746603372050,DSC 297,001,958000,Mazumdar; Arya,9998,0,9999,1
1746603372050,DSC 297,002,959862,Wang; Yusu,9998,0,9999,1
1746603373080,EAP 100,A00,905686,Staff,9778,0,9999,221
1746603374110,ECE 45,A01,892618,Staff,0,0,65,65
1746603376176,ECE 111,A01,892719,Staff,6,0,65,59
1746603377201,ECE 197,001,957920,Mercier; Patrick Philip,9991,0,9999,8
1746603378230,ECON 178,A01,907814,Zhu; Ying,26,0,35,9
1746603379260,EDS 115,A00,895312,Staff,35,0,45,10
1746603380287,EDS 117,A01,895337,Staff,23,0,30,7
1746603381315,EDS 125,A00,895341,Jones; Gabrielle Anastasia,36,0,45,9
1746603382357,EDS 128A,A01,895459,Fargason; Sharon Gayle,44,0,45,1
1746603383384,EDS 128B,A01,895543,Pappas; Elizabeth,44,0,45,1
1746603384415,EDS 139,A00,897203,Pappas; Elizabeth,44,0,45,1
1746603384415,EDS 139,B00,897209,Fargason; Sharon Gayle,41,0,45,4
1746603385447,EDS 201,A00,895545,Staff,22,0,45,23
1746603386483,EDS 203,A01,895581,Halter; Christopher P.,22,0,45,23
1746603387512,EDS 204R,A01,895625,Heinzman; Erica M.,39,0,45,6
1746603387512,EDS 204R,B01,895693,Halter; Christopher P.,10,0,45,35
1746603388550,EDS 206R,A00,895694,Fargason; Sharon Gayle,1,0,30,29
1746603388550,EDS 206R,B00,895695,Choi; Bailey Miyeon,16,0,30,14
1746603389584,EDS 250,A00,895697,Hemans; Patricia Ann Benitez,22,0,45,23
1746603390617,EDS 281,A00,895701,Meyerott; Theresa Ann,1,0,15,14
1746603391645,EDS 284,A00,895736,Meyerott; Theresa Ann,1,0,15,14
1746603392675,EDS 286,A00,897210,Fine; Sarah,0,0,15,15
1746603393701,EDS 289C,A01,895770,Daly; Alan J.,1,0,15,14
1746603394728,EDS 290,A00,897211,Hofstetter; Carolyn,0,0,15,15
1746603395756,LIGM 5A,A00,896162,Fischer-Grunski; Eva K,12,0,20,8
1746603396781,LIGM 5B,A00,896260,Fischer-Grunski; Eva K,17,0,20,3
1746603397811,LIGM 5C,A00,896308,Fischer-Grunski; Eva K,18,0,20,2
1746603398843,LIIT 5AS,A00,896313,Carnelos; Chiara,18,0,20,2
1746603399870,LIIT 5BS,A00,896416,Carnelos; Chiara,20,0,20,0
1746603400897,LIIT 5CS,A00,896564,Carnelos; Chiara,20,0,20,0
1746603401928,LISP 5A,A00,896588,Munoz Sanchez; Alicia,2,0,20,18
1746603402958,LISP 5B,A00,896653,Munoz Sanchez; Alicia,7,0,20,13
1746603403990,LISP 5C,A00,896655,Munoz Sanchez; Alicia,0,1,20,20
1746603405034,MAE 197,001,957918,Kleissl; Jan,9996,0,9999,3
1746603405034,MAE 197,002,959806,Boechler; Nicholas Sebastia,9998,0,9999,1
1746603405034,MAE 197,003,959852,Mullin; Jennifer S,9998,0,9999,1
1746603406068,MATH 2,A01,957937,Staff,33,0,35,2
1746603407100,MATH 197,001,957876,Kedlaya; Kiran S.,9993,0,9999,6
1746603408128,MCWP 40,A00,892729,Duru; Nur,10,0,20,10
1746603408128,MCWP 40,B00,893304,Montejo; Carolina,14,0,20,6
1746603409157,MCWP 40R,A00,893757,Redela; Pamela Morgan,0,5,20,20
1746603410183,MCWP 50,A00,893758,Morshed; Michael James,0,0,20,20
1746603410183,MCWP 50,B00,893761,Bartulis; Jason Michael,16,0,20,4
1746603411214,MCWP 50R,A00,893766,Compas; Sean Matthew,0,1,20,20
1746603411214,MCWP 50R,B00,893769,Carter; Jennifer A,0,1,20,20
1746603411214,MCWP 50R,C00,893771,Krone; Jarret,0,3,20,20
1746603411214,MCWP 50R,D00,893772,Miller; Elizabeth Deen,0,0,20,20
1746603411214,MCWP 50R,E00,893775,Carter; Andrea L,0,1,20,20
1746603412241,MMW 11R,A01,892721,Herbst; Matthew,14,0,30,16
1746603412241,MMW 11R,A02,892722,Herbst; Matthew,0,0,0,3
1746603413267,MMW 12R,A01,892724,Herbst; Matthew,0,11,16,16
1746603413267,MMW 12R,A02,892725,Herbst; Matthew,0,10,16,16
1746603414295,MMW 13R,A01,892727,Staff,0,4,16,16
1746603414295,MMW 13R,A02,892728,Staff,0,4,16,16
1746603414295,MMW 13R,A03,958032,Staff,0,4,16,16
1746603414295,MMW 13R,A04,958033,Staff,0,4,16,16
1746603414295,MMW 13R,A05,958034,Staff,0,4,16,16
1746603415324,SIO 295LS,A00,894015,Staff,5,0,25,20
1746603416348,SIO 295S,A00,894020,Staff,5,0,25,20
1746603417385,SIOC 290S,B01,958918,Merrifield; Mark A,14,0,30,16
1746603418411,SIOC 291S,B01,958922,Gabriel; Corey John,14,0,30,16
1746603419444,SOCI 117,A01,895339,Staff,2,0,5,3
1746603420469,WES 237B,A00,894149,Staff,11,0,20,9
1746603422600,AESE 279B,A00,891859,Staff,13,0,35,22
1746603423630,AIP 197,001,891854,Vespa; Emanuel Ignacio,9999,0,9999,0
1746603424656,ANTH 289S,A00,891856,Gagneux; Pascal,12,0,12,0
1746603425684,BENG 196,001,957946,Engler; Adam J.,9996,0,9999,3
1746603426712,BISP 197,001,959851,Wilhelm; James E.,9998,0,9999,1
1746603427738,CAT 124RS,A01,956906,Staff,6,0,25,19
1746603428775,CAT 125RS,A01,922013,Staff,6,0,25,19
1746603429801,CLRE 250,A00,891860,Morris; Sheldon,9995,0,9999,4
1746603431862,CLRE 251R,A00,907817,Mehta; Ravindra L.,9994,0,9999,5
1746603432889,CLRE 252,A00,891864,Cuomo; Raphael Eduardo,9993,0,9999,6
1746603433923,CLRE 253,A00,891867,Vaida; Florin,9994,0,9999,5
1746603433923,CLRE 253,B00,907819,Staff,9999,0,9999,0
1746603434949,CLRE 259,A00,891868,Patel; Hemal,9998,0,9999,1
1746603435975,CLRE 260,A00,891872,Cuomo; Raphael Eduardo,9999,0,9999,0
1746603437002,CLRE 297,001,891888,Cuomo; Raphael Eduardo,9999,0,9999,0
1746603438034,CSE 191,A00,958773,Minnes Kemp; Mor Mia,9995,0,9999,4
1746603439060,CSE 197,001,959846,Minnes Kemp; Mor Mia,9990,0,9999,9
1746603440086,CSS 201S,A01,892054,Mignozzetti; Umberto,25,0,30,5
1746603441119,CSS 202S,A01,892056,Mignozzetti; Umberto,25,0,30,5
1746603442147,DSC 197,001,956898,Eldridge; Justin Matthew,9996,0,9999,3
1746603443179,DSC 297,001,958000,Mazumdar; Arya,9998,0,9999,1
1746603443179,DSC 297,002,959862,Wang; Yusu,9998,0,9999,1
1746603444205,EAP 100,A00,905686,Staff,9778,0,9999,221
1746603445233,ECE 45,A01,892618,Staff,0,0,65,65
1746603447285,ECE 111,A01,892719,Staff,6,0,65,59
1746603448316,ECE 197,001,957920,Mercier; Patrick Philip,9991,0,9999,8
1746603449346,ECON 178,A01,907814,Zhu; Ying,26,0,35,9
1746603450373,EDS 115,A00,895312,Staff,35,0,45,10
1746603451403,EDS 117,A01,895337,Staff,23,0,30,7
1746603452433,EDS 125,A00,895341,Jones; Gabrielle Anastasia,36,0,45,9
1746603453458,EDS 128A,A01,895459,Fargason; Sharon Gayle,44,0,45,1
1746603454482,EDS 128B,A01,895543,Pappas; Elizabeth,44,0,45,1
1746603455513,EDS 139,A00,897203,Pappas; Elizabeth,44,0,45,1
1746603455513,EDS 139,B00,897209,Fargason; Sharon Gayle,41,0,45,4
1746603456539,EDS 201,A00,895545,Staff,22,0,45,23
1746603457624,EDS 203,A01,895581,Halter; Christopher P.,22,0,45,23
1746603458656,EDS 204R,A01,895625,Heinzman; Erica M.,39,0,45,6
1746603458656,EDS 204R,B01,895693,Halter; Christopher P.,10,0,45,35
1746603459688,EDS 206R,A00,895694,Fargason; Sharon Gayle,1,0,30,29
1746603459688,EDS 206R,B00,895695,Choi; Bailey Miyeon,16,0,30,14
1746603460721,EDS 250,A00,895697,Hemans; Patricia Ann Benitez,22,0,45,23
1746603461747,EDS 281,A00,895701,Meyerott; Theresa Ann,1,0,15,14
1746603462775,EDS 284,A00,895736,Meyerott; Theresa Ann,1,0,15,14
1746603463808,EDS 286,A00,897210,Fine; Sarah,0,0,15,15
1746603464841,EDS 289C,A01,895770,Daly; Alan J.,1,0,15,14
1746603465879,EDS 290,A00,897211,Hofstetter; Carolyn,0,0,15,15
1746603466906,LIGM 5A,A00,896162,Fischer-Grunski; Eva K,12,0,20,8
1746603467937,LIGM 5B,A00,896260,Fischer-Grunski; Eva K,17,0,20,3
1746603468963,LIGM 5C,A00,896308,Fischer-Grunski; Eva K,18,0,20,2
1746603469992,LIIT 5AS,A00,896313,Carnelos; Chiara,18,0,20,2
1746603471018,LIIT 5BS,A00,896416,Carnelos; Chiara,20,0,20,0
1746603472047,LIIT 5CS,A00,896564,Carnelos; Chiara,20,0,20,0
1746603473078,LISP 5A,A00,896588,Munoz Sanchez; Alicia,2,0,20,18
1746603474109,LISP 5B,A00,896653,Munoz Sanchez; Alicia,7,0,20,13
1746603475139,LISP 5C,A00,896655,Munoz Sanchez; Alicia,0,1,20,20
1746603476176,MAE 197,001,957918,Kleissl; Jan,9996,0,9999,3
1746603476176,MAE 197,002,959806,Boechler; Nicholas Sebastia,9998,0,9999,1
1746603476176,MAE 197,003,959852,Mullin; Jennifer S,9998,0,9999,1
1746603477201,MATH 2,A01,957937,Staff,33,0,35,2
1746603478231,MATH 197,001,957876,Kedlaya; Kiran S.,9993,0,9999,6
1746603479269,MCWP 40,A00,892729,Duru; Nur,10,0,20,10
1746603479269,MCWP 40,B00,893304,Montejo; Carolina,14,0,20,6
1746603480297,MCWP 40R,A00,893757,Redela; Pamela Morgan,0,5,20,20
1746603481347,MCWP 50,A00,893758,Morshed; Michael James,0,0,20,20
1746603481347,MCWP 50,B00,893761,Bartulis; Jason Michael,16,0,20,4
1746603482385,MCWP 50R,A00,893766,Compas; Sean Matthew,0,1,20,20
1746603482385,MCWP 50R,B00,893769,Carter; Jennifer A,0,1,20,20
1746603482385,MCWP 50R,C00,893771,Krone; Jarret,0,3,20,20
1746603482385,MCWP 50R,D00,893772,Miller; Elizabeth Deen,0,0,20,20
1746603482385,MCWP 50R,E00,893775,Carter; Andrea L,0,1,20,20
1746603483411,MMW 11R,A01,892721,Herbst; Matthew,14,0,30,16
1746603483411,MMW 11R,A02,892722,Herbst; Matthew,0,0,0,3
1746603484438,MMW 12R,A01,892724,Herbst; Matthew,0,11,16,16
1746603484438,MMW 12R,A02,892725,Herbst; Matthew,0,10,16,16
1746603485465,MMW 13R,A01,892727,Staff,0,4,16,16
1746603485465,MMW 13R,A02,892728,Staff,0,4,16,16
1746603485465,MMW 13R,A03,958032,Staff,0,4,16,16
1746603485465,MMW 13R,A04,958033,Staff,0,4,16,16
1746603485465,MMW 13R,A05,958034,Staff,0,4,16,16
1746603486492,SIO 295LS,A00,894015,Staff,5,0,25,20
1746603487518,SIO 295S,A00,894020,Staff,5,0,25,20
1746603488548,SIOC 290S,B01,958918,Merrifield; Mark A,14,0,30,16
1746603489592,SIOC 291S,B01,958922,Gabriel; Corey John,14,0,30,16
1746603490620,SOCI 117,A01,895339,Staff,2,0,5,3
1746603491650,WES 237B,A00,894149,Staff,11,0,20,9
1746603493782,AESE 279B,A00,891859,Staff,13,0,35,22
1746603494837,AIP 197,001,891854,Vespa; Emanuel Ignacio,9999,0,9999,0
1746603495864,ANTH 289S,A00,891856,Gagneux; Pascal,12,0,12,0
1746603496901,BENG 196,001,957946,Engler; Adam J.,9996,0,9999,3
1746603497929,BISP 197,001,959851,Wilhelm; James E.,9998,0,9999,1
1746603498955,CAT 124RS,A01,956906,Staff,6,0,25,19
1746603499985,CAT 125RS,A01,922013,Staff,6,0,25,19
1746603501013,CLRE 250,A00,891860,Morris; Sheldon,9995,0,9999,4
1746603503073,CLRE 251R,A00,907817,Mehta; Ravindra L.,9994,0,9999,5
1746603504102,CLRE 252,A00,891864,Cuomo; Raphael Eduardo,9993,0,9999,6
1746603505128,CLRE 253,A00,891867,Vaida; Florin,9994,0,9999,5
1746603505128,CLRE 253,B00,907819,Staff,9999,0,9999,0
1746603506157,CLRE 259,A00,891868,Patel; Hemal,9998,0,9999,1
1746603507183,CLRE 260,A00,891872,Cuomo; Raphael Eduardo,9999,0,9999,0
1746603508212,CLRE 297,001,891888,Cuomo; Raphael Eduardo,9999,0,9999,0
1746603509239,CSE 191,A00,958773,Minnes Kemp; Mor Mia,9995,0,9999,4
1746603510269,CSE 197,001,959846,Minnes Kemp; Mor Mia,9990,0,9999,9
1746603511309,CSS 201S,A01,892054,Mignozzetti; Umberto,25,0,30,5
1746603512343,CSS 202S,A01,892056,Mignozzetti; Umberto,25,0,30,5
1746603513370,DSC 197,001,956898,Eldridge; Justin Matthew,9996,0,9999,3
1746603514397,DSC 297,001,958000,Mazumdar; Arya,9998,0,9999,1
1746603514397,DSC 297,002,959862,Wang; Yusu,9998,0,9999,1
1746603515424,EAP 100,A00,905686,Staff,9778,0,9999,221
1746603516454,ECE 45,A01,892618,Staff,0,0,65,65
1746603518515,ECE 111,A01,892719,Staff,6,0,65,59
1746603519545,ECE 197,001,957920,Mercier; Patrick Philip,9991,0,9999,8
1746603520579,ECON 178,A01,907814,Zhu; Ying,26,0,35,9
1746603521605,EDS 115,A00,895312,Staff,35,0,45,10
1746603522637,EDS 117,A01,895337,Staff,23,0,30,7
1746603523669,EDS 125,A00,895341,Jones; Gabrielle Anastasia,36,0,45,9
1746603524700,EDS 128A,A01,895459,Fargason; Sharon Gayle,44,0,45,1
1746603525728,EDS 128B,A01,895543,Pappas; Elizabeth,44,0,45,1
1746603526762,EDS 139,A00,897203,Pappas; Elizabeth,44,0,45,1
1746603526762,EDS 139,B00,897209,Fargason; Sharon Gayle,41,0,45,4
1746603527792,EDS 201,A00,895545,Staff,22,0,45,23
1746603528823,EDS 203,A01,895581,Halter; Christopher P.,22,0,45,23
1746603529852,EDS 204R,A01,895625,Heinzman; Erica M.,39,0,45,6
1746603529852,EDS 204R,B01,895693,Halter; Christopher P.,10,0,45,35
1746603530880,EDS 206R,A00,895694,Fargason; Sharon Gayle,1,0,30,29
1746603530880,EDS 206R,B00,895695,Choi; Bailey Miyeon,16,0,30,14
1746603531906,EDS 250,A00,895697,Hemans; Patricia Ann Benitez,22,0,45,23
1746603532937,EDS 281,A00,895701,Meyerott; Theresa Ann,1,0,15,14
1746603533963,EDS 284,A00,895736,Meyerott; Theresa Ann,1,0,15,14
1746603534992,EDS 286,A00,897210,Fine; Sarah,0,0,15,15
1746603536019,EDS 289C,A01,895770,Daly; Alan J.,1,0,15,14
1746603537046,EDS 290,A00,897211,Hofstetter; Carolyn,0,0,15,15
1746603538075,LIGM 5A,A00,896162,Fischer-Grunski; Eva K,12,0,20,8
1746603539106,LIGM 5B,A00,896260,Fischer-Grunski; Eva K,17,0,20,3
1746603540137,LIGM 5C,A00,896308,Fischer-Grunski; Eva K,18,0,20,2
1746603541168,LIIT 5AS,A00,896313,Carnelos; Chiara,18,0,20,2
1746603542193,LIIT 5BS,A00,896416,Carnelos; Chiara,20,0,20,0
1746603543225,LIIT 5CS,A00,896564,Carnelos; Chiara,20,0,20,0
1746603544261,LISP 5A,A00,896588,Munoz Sanchez; Alicia,2,0,20,18
1746603545288,LISP 5B,A00,896653,Munoz Sanchez; Alicia,7,0,20,13
1746603546318,LISP 5C,A00,896655,Munoz Sanchez; Alicia,0,1,20,20
1746603547361,MAE 197,001,957918,Kleissl; Jan,9996,0,9999,3
1746603547361,MAE 197,002,959806,Boechler; Nicholas Sebastia,9998,0,9999,1
1746603547361,MAE 197,003,959852,Mullin; Jennifer S,9998,0,9999,1
1746603548389,MATH 2,A01,957937,Staff,33,0,35,2
1746603549416,MATH 197,001,957876,Kedlaya; Kiran S.,9993,0,9999,6
1746603550446,MCWP 40,A00,892729,Duru; Nur,10,0,20,10
1746603550446,MCWP 40,B00,893304,Montejo; Carolina,14,0,20,6
1746603551475,MCWP 40R,A00,893757,Redela; Pamela Morgan,0,5,20,20
1746603552506,MCWP 50,A00,893758,Morshed; Michael James,0,0,20,20
1746603552506,MCWP 50,B00,893761,Bartulis; Jason Michael,16,0,20,4
1746603553536,MCWP 50R,A00,893766,Compas; Sean Matthew,0,1,20,20
1746603553536,MCWP 50R,B00,893769,Carter; Jennifer A,0,1,20,20
1746603553536,MCWP 50R,C00,893771,Krone; Jarret,0,3,20,20
1746603553536,MCWP 50R,D00,893772,Miller; Elizabeth Deen,0,0,20,20
1746603553536,MCWP 50R,E00,893775,Carter; Andrea L,0,1,20,20
1746603554563,MMW 11R,A01,892721,Herbst; Matthew,14,0,30,16
1746603554563,MMW 11R,A02,892722,Herbst; Matthew,0,0,0,3
1746603555591,MMW 12R,A01,892724,Herbst; Matthew,0,11,16,16
1746603555591,MMW 12R,A02,892725,Herbst; Matthew,0,10,16,16
1746603556621,MMW 13R,A01,892727,Staff,0,4,16,16
1746603556621,MMW 13R,A02,892728,Staff,0,4,16,16
1746603556621,MMW 13R,A03,958032,Staff,0,4,16,16
1746603556621,MMW 13R,A04,958033,Staff,0,4,16,16
1746603556621,MMW 13R,A05,958034,Staff,0,4,16,16
1746603557650,SIO 295LS,A00,894015,Staff,5,0,25,20
1746603558679,SIO 295S,A00,894020,Staff,5,0,25,20
1746603559710,SIOC 290S,B01,958918,Merrifield; Mark A,14,0,30,16
1746603560739,SIOC 291S,B01,958922,Gabriel; Corey John,14,0,30,16
1746603561804,SOCI 117,A01,895339,Staff,2,0,5,3
1746603562834,WES 237B,A00,894149,Staff,11,0,20,9
1746603564969,AESE 279B,A00,891859,Staff,13,0,35,22
1746603566005,AIP 197,001,891854,Vespa; Emanuel Ignacio,9999,0,9999,0
1746603567039,ANTH 289S,A00,891856,Gagneux; Pascal,12,0,12,0
1746603568069,BENG 196,001,957946,Engler; Adam J.,9996,0,9999,3
1746603569101,BISP 197,001,959851,Wilhelm; James E.,9998,0,9999,1
1746603570130,CAT 124RS,A01,956906,Staff,6,0,25,19
1746603571159,CAT 125RS,A01,922013,Staff,6,0,25,19
1746603572185,CLRE 250,A00,891860,Morris; Sheldon,9995,0,9999,4
1746603574243,CLRE 251R,A00,907817,Mehta; Ravindra L.,9994,0,9999,5
1746603575269,CLRE 252,A00,891864,Cuomo; Raphael Eduardo,9993,0,9999,6
1746603576297,CLRE 253,A00,891867,Vaida; Florin,9994,0,9999,5
1746603576297,CLRE 253,B00,907819,Staff,9999,0,9999,0
1746603577327,CLRE 259,A00,891868,Patel; Hemal,9998,0,9999,1
1746603578353,CLRE 260,A00,891872,Cuomo; Raphael Eduardo,9999,0,9999,0
1746603579381,CLRE 297,001,891888,Cuomo; Raphael Eduardo,9999,0,9999,0
1746603580413,CSE 191,A00,958773,Minnes Kemp; Mor Mia,9995,0,9999,4
1746603581441,CSE 197,001,959846,Minnes Kemp; Mor Mia,9990,0,9999,9
1746603582480,CSS 201S,A01,892054,Mignozzetti; Umberto,25,0,30,5
1746603583510,CSS 202S,A01,892056,Mignozzetti; Umberto,25,0,30,5
1746603584538,DSC 197,001,956898,Eldridge; Justin Matthew,9996,0,9999,3
1746603585566,DSC 297,001,958000,Mazumdar; Arya,9998,0,9999,1
1746603585566,DSC 297,002,959862,Wang; Yusu,9998,0,9999,1
1746603586594,EAP 100,A00,905686,Staff,9778,0,9999,221
1746603587621,ECE 45,A01,892618,Staff,0,0,65,65
1746603589676,ECE 111,A01,892719,Staff,6,0,65,59
1746603590706,ECE 197,001,957920,Mercier; Patrick Philip,9991,0,9999,8
1746603591739,ECON 178,A01,907814,Zhu; Ying,26,0,35,9
1746603592770,EDS 115,A00,895312,Staff,35,0,45,10
1746603593797,EDS 117,A01,895337,Staff,23,0,30,7
1746603594831,EDS 125,A00,895341,Jones; Gabrielle Anastasia,36,0,45,9
1746603595858,EDS 128A,A01,895459,Fargason; Sharon Gayle,44,0,45,1
1746603596886,EDS 128B,A01,895543,Pappas; Elizabeth,44,0,45,1
1746603597913,EDS 139,A00,897203,Pappas; Elizabeth,44,0,45,1
1746603597913,EDS 139,B00,897209,Fargason; Sharon Gayle,41,0,45,4
1746603598941,EDS 201,A00,895545,Staff,22,0,45,23
1746603599966,EDS 203,A01,895581,Halter; Christopher P.,22,0,45,23
1746603601000,EDS 204R,A01,895625,Heinzman; Erica M.,39,0,45,6
1746603601000,EDS 204R,B01,895693,Halter; Christopher P.,10,0,45,35
1746603602029,EDS 206R,A00,895694,Fargason; Sharon Gayle,1,0,30,29
1746603602029,EDS 206R,B00,895695,Choi; Bailey Miyeon,16,0,30,14
1746603603056,EDS 250,A00,895697,Hemans; Patricia Ann Benitez,22,0,45,23
1746603604087,EDS 281,A00,895701,Meyerott; Theresa Ann,1,0,15,14
1746603605115,EDS 284,A00,895736,Meyerott; Theresa Ann,1,0,15,14
1746603606142,EDS 286,A00,897210,Fine; Sarah,0,0,15,15
1746603607173,EDS 289C,A01,895770,Daly; Alan J.,1,0,15,14
1746603608200,EDS 290,A00,897211,Hofstetter; Carolyn,0,0,15,15
1746603609235,LIGM 5A,A00,896162,Fischer-Grunski; Eva K,12,0,20,8
1746603610262,LIGM 5B,A00,896260,Fischer-Grunski; Eva K,17,0,20,3
1746603611290,LIGM 5C,A00,896308,Fischer-Grunski; Eva K,18,0,20,2
1746603612316,LIIT 5AS,A00,896313,Carnelos; Chiara,18,0,20,2
1746603613352,LIIT 5BS,A00,896416,Carnelos; Chiara,20,0,20,0
1746603614379,LIIT 5CS,A00,896564,Carnelos; Chiara,20,0,20,0
1746603615411,LISP 5A,A00,896588,Munoz Sanchez; Alicia,2,0,20,18
1746603616437,LISP 5B,A00,896653,Munoz Sanchez; Alicia,7,0,20,13
1746603617466,LISP 5C,A00,896655,Munoz Sanchez; Alicia,0,1,20,20
1746603618495,MAE 197,001,957918,Kleissl; Jan,9996,0,9999,3
1746603618495,MAE 197,002,959806,Boechler; Nicholas Sebastia,9998,0,9999,1
1746603618495,MAE 197,003,959852,Mullin; Jennifer S,9998,0,9999,1
1746603619522,MATH 2,A01,957937,Staff,33,0,35,2
1746603620554,MATH 197,001,957876,Kedlaya; Kiran S.,9993,0,9999,6
1746603621588,MCWP 40,A00,892729,Duru; Nur,10,0,20,10
1746603621588,MCWP 40,B00,893304,Montejo; Carolina,14,0,20,6
1746603622616,MCWP 40R,A00,893757,Redela; Pamela Morgan,0,5,20,20
1746603623654,MCWP 50,A00,893758,Morshed; Michael James,0,0,20,20
1746603623654,MCWP 50,B00,893761,Bartulis; Jason Michael,16,0,20,4
1746603624683,MCWP 50R,A00,893766,Compas; Sean Matthew,0,1,20,20
1746603624683,MCWP 50R,B00,893769,Carter; Jennifer A,0,1,20,20
1746603624683,MCWP 50R,C00,893771,Krone; Jarret,0,3,20,20
1746603624683,MCWP 50R,D00,893772,Miller; Elizabeth Deen,0,0,20,20
1746603624683,MCWP 50R,E00,893775,Carter; Andrea L,0,1,20,20
1746603625720,MMW 11R,A01,892721,Herbst; Matthew,14,0,30,16
1746603625720,MMW 11R,A02,892722,Herbst; Matthew,0,0,0,3
1746603626748,MMW 12R,A01,892724,Herbst; Matthew,0,11,16,16
1746603626748,MMW 12R,A02,892725,Herbst; Matthew,0,10,16,16
1746603627775,MMW 13R,A01,892727,Staff,0,4,16,16
1746603627775,MMW 13R,A02,892728,Staff,0,4,16,16
1746603627775,MMW 13R,A03,958032,Staff,0,4,16,16
1746603627775,MMW 13R,A04,958033,Staff,0,4,16,16
1746603627775,MMW 13R,A05,958034,Staff,0,4,16,16
1746603628803,SIO 295LS,A00,894015,Staff,5,0,25,20
1746603629833,SIO 295S,A00,894020,Staff,5,0,25,20
1746603630872,SIOC 290S,B01,958918,Merrifield; Mark A,14,0,30,16
1746603631902,SIOC 291S,B01,958922,Gabriel; Corey John,14,0,30,16
1746603632929,SOCI 117,A01,895339,Staff,2,0,5,3
1746603633955,WES 237B,A00,894149,Staff,11,0,20,9
1746603636153,AESE 279B,A00,891859,Staff,13,0,35,22
1746603637188,AIP 197,001,891854,Vespa; Emanuel Ignacio,9999,0,9999,0
1746603638219,ANTH 289S,A00,891856,Gagneux; Pascal,12,0,12,0
1746603639245,BENG 196,001,957946,Engler; Adam J.,9996,0,9999,3
1746603640277,BISP 197,001,959851,Wilhelm; James E.,9998,0,9999,1
1746603641303,CAT 124RS,A01,956906,Staff,6,0,25,19
1746603642333,CAT 125RS,A01,922013,Staff,6,0,25,19
1746603643362,CLRE 250,A00,891860,Morris; Sheldon,9995,0,9999,4
1746603645426,CLRE 251R,A00,907817,Mehta; Ravindra L.,9994,0,9999,5
1746603646452,CLRE 252,A00,891864,Cuomo; Raphael Eduardo,9993,0,9999,6
1746603647480,CLRE 253,A00,891867,Vaida; Florin,9994,0,9999,5
1746603647480,CLRE 253,B00,907819,Staff,9999,0,9999,0
1746603648512,CLRE 259,A00,891868,Patel; Hemal,9998,0,9999,1
1746603649542,CLRE 260,A00,891872,Cuomo; Raphael Eduardo,9999,0,9999,0
1746603650567,CLRE 297,001,891888,Cuomo; Raphael Eduardo,9999,0,9999,0
1746603651601,CSE 191,A00,958773,Minnes Kemp; Mor Mia,9995,0,9999,4
1746603652627,CSE 197,001,959846,Minnes Kemp; Mor Mia,9990,0,9999,9
1746603653654,CSS 201S,A01,892054,Mignozzetti; Umberto,25,0,30,5
1746603654691,CSS 202S,A01,892056,Mignozzetti; Umberto,25,0,30,5
1746603655719,DSC 197,001,956898,Eldridge; Justin Matthew,9996,0,9999,3
1746603656753,DSC 297,001,958000,Mazumdar; Arya,9998,0,9999,1
1746603656753,DSC 297,002,959862,Wang; Yusu,9998,0,9999,1
1746603657779,EAP 100,A00,905686,Staff,9778,0,9999,221
1746603658818,ECE 45,A01,892618,Staff,0,0,65,65
1746603660871,ECE 111,A01,892719,Staff,6,0,65,59
1746603661902,ECE 197,001,957920,Mercier; Patrick Philip,9991,0,9999,8
1746603662933,ECON 178,A01,907814,Zhu; Ying,26,0,35,9
1746603663959,EDS 115,A00,895312,Staff,35,0,45,10
1746603664987,EDS 117,A01,895337,Staff,23,0,30,7
1746603666021,EDS 125,A00,895341,Jones; Gabrielle Anastasia,36,0,45,9
1746603667048,EDS 128A,A01,895459,Fargason; Sharon Gayle,44,0,45,1
1746603668076,EDS 128B,A01,895543,Pappas; Elizabeth,44,0,45,1
1746603669103,EDS 139,A00,897203,Pappas; Elizabeth,44,0,45,1
1746603669103,EDS 139,B00,897209,Fargason; Sharon Gayle,41,0,45,4
1746603670130,EDS 201,A00,895545,Staff,22,0,45,23
1746603671160,EDS 203,A01,895581,Halter; Christopher P.,22,0,45,23
1746603672187,EDS 204R,A01,895625,Heinzman; Erica M.,39,0,45,6
1746603672187,EDS 204R,B01,895693,Halter; Christopher P.,10,0,45,35
1746603673274,EDS 206R,A00,895694,Fargason; Sharon Gayle,1,0,30,29
1746603673274,EDS 206R,B00,895695,Choi; Bailey Miyeon,16,0,30,14
1746603674305,EDS 250,A00,895697,Hemans; Patricia Ann Benitez,22,0,45,23
1746603675332,EDS 281,A00,895701,Meyerott; Theresa Ann,1,0,15,14
1746603676358,EDS 284,A00,895736,Meyerott; Theresa Ann,1,0,15,14
1746603677385,EDS 286,A00,897210,Fine; Sarah,0,0,15,15
1746603678418,EDS 289C,A01,895770,Daly; Alan J.,1,0,15,14
1746603679445,EDS 290,A00,897211,Hofstetter; Carolyn,0,0,15,15
1746603680474,LIGM 5A,A00,896162,Fischer-Grunski; Eva K,12,0,20,8
1746603681501,LIGM 5B,A00,896260,Fischer-Grunski; Eva K,17,0,20,3
1746603682534,LIGM 5C,A00,896308,Fischer-Grunski; Eva K,18,0,20,2
1746603683581,LIIT 5AS,A00,896313,Carnelos; Chiara,18,0,20,2
1746603684614,LIIT 5BS,A00,896416,Carnelos; Chiara,20,0,20,0
1746603685642,LIIT 5CS,A00,896564,Carnelos; Chiara,20,0,20,0
1746603686670,LISP 5A,A00,896588,Munoz Sanchez; Alicia,2,0,20,18
1746603687704,LISP 5B,A00,896653,Munoz Sanchez; Alicia,7,0,20,13
1746603688732,LISP 5C,A00,896655,Munoz Sanchez; Alicia,0,1,20,20
1746603689775,MAE 197,001,957918,Kleissl; Jan,9996,0,9999,3
1746603689775,MAE 197,002,959806,Boechler; Nicholas Sebastia,9998,0,9999,1
1746603689775,MAE 197,003,959852,Mullin; Jennifer S,9998,0,9999,1
1746603690801,MATH 2,A01,957937,Staff,33,0,35,2
1746603691828,MATH 197,001,957876,Kedlaya; Kiran S.,9993,0,9999,6
1746603692857,MCWP 40,A00,892729,Duru; Nur,10,0,20,10
1746603692857,MCWP 40,B00,893304,Montejo; Carolina,14,0,20,6
1746603693886,MCWP 40R,A00,893757,Redela; Pamela Morgan,0,5,20,20
1746603694917,MCWP 50,A00,893758,Morshed; Michael James,0,0,20,20
1746603694917,MCWP 50,B00,893761,Bartulis; Jason Michael,16,0,20,4
1746603695947,MCWP 50R,A00,893766,Compas; Sean Matthew,0,1,20,20
1746603695947,MCWP 50R,B00,893769,Carter; Jennifer A,0,1,20,20
1746603695947,MCWP 50R,C00,893771,Krone; Jarret,0,3,20,20
1746603695947,MCWP 50R,D00,893772,Miller; Elizabeth Deen,0,0,20,20
1746603695947,MCWP 50R,E00,893775,Carter; Andrea L,0,1,20,20
1746603696982,MMW 11R,A01,892721,Herbst; Matthew,14,0,30,16
1746603696982,MMW 11R,A02,892722,Herbst; Matthew,0,0,0,3
1746603698010,MMW 12R,A01,892724,Herbst; Matthew,0,11,16,16
1746603698010,MMW 12R,A02,892725,Herbst; Matthew,0,10,16,16
1746603699043,MMW 13R,A01,892727,Staff,0,4,16,16
1746603699043,MMW 13R,A02,892728,Staff,0,4,16,16
1746603699043,MMW 13R,A03,958032,Staff,0,4,16,16
1746603699043,MMW 13R,A04,958033,Staff,0,4,16,16
1746603699043,MMW 13R,A05,958034,Staff,0,4,16,16
1746603700070,SIO 295LS,A00,894015,Staff,5,0,25,20
1746603701098,SIO 295S,A00,894020,Staff,5,0,25,20
1746603702130,SIOC 290S,B01,958918,Merrifield; Mark A,14,0,30,16
1746603703159,SIOC 291S,B01,958922,Gabriel; Corey John,14,0,30,16
1746603704192,SOCI 117,A01,895339,Staff,2,0,5,3
1746603705219,WES 237B,A00,894149,Staff,11,0,20,9
1746603707348,AESE 279B,A00,891859,Staff,13,0,35,22
1746603708375,AIP 197,001,891854,Vespa; Emanuel Ignacio,9999,0,9999,0
1746603709403,ANTH 289S,A00,891856,Gagneux; Pascal,12,0,12,0
1746603710430,BENG 196,001,957946,Engler; Adam J.,9996,0,9999,3
1746603711459,BISP 197,001,959851,Wilhelm; James E.,9998,0,9999,1
1746603712488,CAT 124RS,A01,956906,Staff,6,0,25,19
1746603713515,CAT 125RS,A01,922013,Staff,6,0,25,19
1746603714544,CLRE 250,A00,891860,Morris; Sheldon,9995,0,9999,4
1746603716602,CLRE 251R,A00,907817,Mehta; Ravindra L.,9994,0,9999,5
1746603717631,CLRE 252,A00,891864,Cuomo; Raphael Eduardo,9993,0,9999,6
1746603718659,CLRE 253,A00,891867,Vaida; Florin,9994,0,9999,5
1746603718659,CLRE 253,B00,907819,Staff,9999,0,9999,0
1746603719690,CLRE 259,A00,891868,Patel; Hemal,9998,0,9999,1
1746603720716,CLRE 260,A00,891872,Cuomo; Raphael Eduardo,9999,0,9999,0
1746603721744,CLRE 297,001,891888,Cuomo; Raphael Eduardo,9999,0,9999,0
1746603722779,CSE 191,A00,958773,Minnes Kemp; Mor Mia,9995,0,9999,4
1746603723807,CSE 197,001,959846,Minnes Kemp; Mor Mia,9990,0,9999,9
1746603724846,CSS 201S,A01,892054,Mignozzetti; Umberto,25,0,30,5
1746603725873,CSS 202S,A01,892056,Mignozzetti; Umberto,25,0,30,5
1746603726908,DSC 197,001,956898,Eldridge; Justin Matthew,9996,0,9999,3
1746603727936,DSC 297,001,958000,Mazumdar; Arya,9998,0,9999,1
1746603727936,DSC 297,002,959862,Wang; Yusu,9998,0,9999,1
1746603728961,EAP 100,A00,905686,Staff,9778,0,9999,221
1746603730011,ECE 45,A01,892618,Staff,0,0,65,65
1746603732062,ECE 111,A01,892719,Staff,6,0,65,59
1746603733088,ECE 197,001,957920,Mercier; Patrick Philip,9991,0,9999,8
1746603734116,ECON 178,A01,907814,Zhu; Ying,26,0,35,9
1746603735144,EDS 115,A00,895312,Staff,35,0,45,10
1746603736171,EDS 117,A01,895337,Staff,23,0,30,7
1746603737198,EDS 125,A00,895341,Jones; Gabrielle Anastasia,36,0,45,9
1746603738231,EDS 128A,A01,895459,Fargason; Sharon Gayle,44,0,45,1
1746603739257,EDS 128B,A01,895543,Pappas; Elizabeth,44,0,45,1
1746603740288,EDS 139,A00,897203,Pappas; Elizabeth,44,0,45,1
1746603740288,EDS 139,B00,897209,Fargason; Sharon Gayle,41,0,45,4
1746603741314,EDS 201,A00,895545,Staff,22,0,45,23
1746603742342,EDS 203,A01,895581,Halter; Christopher P.,22,0,45,23
1746603743377,EDS 204R,A01,895625,Heinzman; Erica M.,39,0,45,6
1746603743377,EDS 204R,B01,895693,Halter; Christopher P.,10,0,45,35
1746603744405,EDS 206R,A00,895694,Fargason; Sharon Gayle,1,0,30,29
1746603744405,EDS 206R,B00,895695,Choi; Bailey Miyeon,16,0,30,14
1746603745432,EDS 250,A00,895697,Hemans; Patricia Ann Benitez,22,0,45,23
1746603746463,EDS 281,A00,895701,Meyerott; Theresa Ann,1,0,15,14
1746603747488,EDS 284,A00,895736,Meyerott; Theresa Ann,1,0,15,14
1746603748516,EDS 286,A00,897210,Fine; Sarah,0,0,15,15
1746603749548,EDS 289C,A01,895770,Daly; Alan J.,1,0,15,14
1746603750574,EDS 290,A00,897211,Hofstetter; Carolyn,0,0,15,15
1746603751614,LIGM 5A,A00,896162,Fischer-Grunski; Eva K,12,0,20,8
1746603752641,LIGM 5B,A00,896260,Fischer-Grunski; Eva K,17,0,20,3
1746603753673,LIGM 5C,A00,896308,Fischer-Grunski; Eva K,18,0,20,2
1746603754705,LIIT 5AS,A00,896313,Carnelos; Chiara,18,0,20,2
1746603755736,LIIT 5BS,A00,896416,Carnelos; Chiara,20,0,20,0
1746603756764,LIIT 5CS,A00,896564,Carnelos; Chiara,20,0,20,0
1746603757805,LISP 5A,A00,896588,Munoz Sanchez; Alicia,2,0,20,18
1746603758841,LISP 5B,A00,896653,Munoz Sanchez; Alicia,7,0,20,13
1746603759869,LISP 5C,A00,896655,Munoz Sanchez; Alicia,0,1,20,20
1746603760909,MAE 197,001,957918,Kleissl; Jan,9996,0,9999,3
1746603760909,MAE 197,002,959806,Boechler; Nicholas Sebastia,9998,0,9999,1
1746603760909,MAE 197,003,959852,Mullin; Jennifer S,9998,0,9999,1
1746603761944,MATH 2,A01,957937,Staff,33,0,35,2
1746603763037,MATH 197,001,957876,Kedlaya; Kiran S.,9993,0,9999,6
1746603764067,MCWP 40,A00,892729,Duru; Nur,10,0,20,10
1746603764067,MCWP 40,B00,893304,Montejo; Carolina,14,0,20,6
1746603765103,MCWP 40R,A00,893757,Redela; Pamela Morgan,0,5,20,20
1746603766137,MCWP 50,A00,893758,Morshed; Michael James,0,0,20,20
1746603766137,MCWP 50,B00,893761,Bartulis; Jason Michael,16,0,20,4
1746603767168,MCWP 50R,A00,893766,Compas; Sean Matthew,0,1,20,20
1746603767168,MCWP 50R,B00,893769,Carter; Jennifer A,0,1,20,20
1746603767168,MCWP 50R,C00,893771,Krone; Jarret,0,3,20,20
1746603767168,MCWP 50R,D00,893772,Miller; Elizabeth Deen,0,0,20,20
1746603767168,MCWP 50R,E00,893775,Carter; Andrea L,0,1,20,20
1746603768196,MMW 11R,A01,892721,Herbst; Matthew,14,0,30,16
1746603768196,MMW 11R,A02,892722,Herbst; Matthew,0,0,0,3
1746603769226,MMW 12R,A01,892724,Herbst; Matthew,0,11,16,16
1746603769226,MMW 12R,A02,892725,Herbst; Matthew,0,10,16,16
1746603770259,MMW 13R,A01,892727,Staff,0,4,16,16
1746603770259,MMW 13R,A02,892728,Staff,0,4,16,16
1746603770259,MMW 13R,A03,958032,Staff,0,4,16,16
1746603770259,MMW 13R,A04,958033,Staff,0,4,16,16
1746603770259,MMW 13R,A05,958034,Staff,0,4,16,16
1746603771288,SIO 295LS,A00,894015,Staff,5,0,25,20
1746603772312,SIO 295S,A00,894020,Staff,5,0,25,20
1746603773352,SIOC 290S,B01,958918,Merrifield; Mark A,14,0,30,16
1746603774385,SIOC 291S,B01,958922,Gabriel; Corey John,14,0,30,16
1746603775412,SOCI 117,A01,895339,Staff,2,0,5,3
1746603776438,WES 237B,A00,894149,Staff,11,0,20,9
1746603778568,AESE 279B,A00,891859,Staff,13,0,35,22
1746603779600,AIP 197,001,891854,Vespa; Emanuel Ignacio,9999,0,9999,0
1746603780632,ANTH 289S,A00,891856,Gagneux; Pascal,12,0,12,0
1746603781659,BENG 196,001,957946,Engler; Adam J.,9996,0,9999,3
1746603782687,BISP 197,001,959851,Wilhelm; James E.,9998,0,9999,1
1746603783711,CAT 124RS,A01,956906,Staff,6,0,25,19
1746603784736,CAT 125RS,A01,922013,Staff,6,0,25,19
1746603785763,CLRE 250,A00,891860,Morris; Sheldon,9995,0,9999,4
1746603787822,CLRE 251R,A00,907817,Mehta; Ravindra L.,9994,0,9999,5
1746603788849,CLRE 252,A00,891864,Cuomo; Raphael Eduardo,9993,0,9999,6
1746603789879,CLRE 253,A00,891867,Vaida; Florin,9994,0,9999,5
1746603789879,CLRE 253,B00,907819,Staff,9999,0,9999,0
1746603790911,CLRE 259,A00,891868,Patel; Hemal,9998,0,9999,1
1746603791936,CLRE 260,A00,891872,Cuomo; Raphael Eduardo,9999,0,9999,0
1746603792963,CLRE 297,001,891888,Cuomo; Raphael Eduardo,9999,0,9999,0
1746603793991,CSE 191,A00,958773,Minnes Kemp; Mor Mia,9995,0,9999,4
1746603795018,CSE 197,001,959846,Minnes Kemp; Mor Mia,9990,0,9999,9
1746603796047,CSS 201S,A01,892054,Mignozzetti; Umberto,25,0,30,5
1746603797078,CSS 202S,A01,892056,Mignozzetti; Umberto,25,0,30,5
1746603798109,DSC 197,001,956898,Eldridge; Justin Matthew,9996,0,9999,3
1746603799135,DSC 297,001,958000,Mazumdar; Arya,9998,0,9999,1
1746603799135,DSC 297,002,959862,Wang; Yusu,9998,0,9999,1
1746603800164,EAP 100,A00,905686,Staff,9778,0,9999,221
1746603801194,ECE 45,A01,892618,Staff,0,0,65,65
1746603803254,ECE 111,A01,892719,Staff,6,0,65,59
1746603804286,ECE 197,001,957920,Mercier; Patrick Philip,9991,0,9999,8
1746603805321,ECON 178,A01,907814,Zhu; Ying,26,0,35,9
1746603806355,EDS 115,A00,895312,Staff,35,0,45,10
1746603807382,EDS 117,A01,895337,Staff,23,0,30,7
1746603808408,EDS 125,A00,895341,Jones; Gabrielle Anastasia,36,0,45,9
1746603809435,EDS 128A,A01,895459,Fargason; Sharon Gayle,44,0,45,1
1746603810460,EDS 128B,A01,895543,Pappas; Elizabeth,44,0,45,1
1746603811490,EDS 139,A00,897203,Pappas; Elizabeth,44,0,45,1
1746603811490,EDS 139,B00,897209,Fargason; Sharon Gayle,41,0,45,4
1746603812518,EDS 201,A00,895545,Staff,22,0,45,23
1746603813555,EDS 203,A01,895581,Halter; Christopher P.,22,0,45,23
1746603814589,EDS 204R,A01,895625,Heinzman; Erica M.,39,0,45,6
1746603814589,EDS 204R,B01,895693,Halter; Christopher P.,10,0,45,35
1746603815621,EDS 206R,A00,895694,Fargason; Sharon Gayle,1,0,30,29
1746603815621,EDS 206R,B00,895695,Choi; Bailey Miyeon,16,0,30,14
1746603816651,EDS 250,A00,895697,Hemans; Patricia Ann Benitez,22,0,45,23
1746603817678,EDS 281,A00,895701,Meyerott; Theresa Ann,1,0,15,14
1746603818707,EDS 284,A00,895736,Meyerott; Theresa Ann,1,0,15,14
1746603819737,EDS 286,A00,897210,Fine; Sarah,0,0,15,15
1746603820766,EDS 289C,A01,895770,Daly; Alan J.,1,0,15,14
1746603821796,EDS 290,A00,897211,Hofstetter; Carolyn,0,0,15,15
1746603822825,LIGM 5A,A00,896162,Fischer-Grunski; Eva K,12,0,20,8
1746603823854,LIGM 5B,A00,896260,Fischer-Grunski; Eva K,17,0,20,3
1746603824884,LIGM 5C,A00,896308,Fischer-Grunski; Eva K,18,0,20,2
1746603825912,LIIT 5AS,A00,896313,Carnelos; Chiara,18,0,20,2
1746603826939,LIIT 5BS,A00,896416,Carnelos; Chiara,20,0,20,0
1746603827966,LIIT 5CS,A00,896564,Carnelos; Chiara,20,0,20,0
1746603828999,LISP 5A,A00,896588,Munoz Sanchez; Alicia,2,0,20,18
1746603830035,LISP 5B,A00,896653,Munoz Sanchez; Alicia,7,0,20,13
1746603831059,LISP 5C,A00,896655,Munoz Sanchez; Alicia,0,1,20,20
1746603832096,MAE 197,001,957918,Kleissl; Jan,9996,0,9999,3
1746603832096,MAE 197,002,959806,Boechler; Nicholas Sebastia,9998,0,9999,1
1746603832096,MAE 197,003,959852,Mullin; Jennifer S,9998,0,9999,1
1746603833141,MATH 2,A01,957937,Staff,33,0,35,2
1746603834167,MATH 197,001,957876,Kedlaya; Kiran S.,9993,0,9999,6
1746603835197,MCWP 40,A00,892729,Duru; Nur,10,0,20,10
1746603835197,MCWP 40,B00,893304,Montejo; Carolina,14,0,20,6
1746603836225,MCWP 40R,A00,893757,Redela; Pamela Morgan,0,5,20,20
1746603837259,MCWP 50,A00,893758,Morshed; Michael James,0,0,20,20
1746603837259,MCWP 50,B00,893761,Bartulis; Jason Michael,16,0,20,4
1746603838286,MCWP 50R,A00,893766,Compas; Sean Matthew,0,1,20,20
1746603838286,MCWP 50R,B00,893769,Carter; Jennifer A,0,1,20,20
1746603838286,MCWP 50R,C00,893771,Krone; Jarret,0,3,20,20
1746603838286,MCWP 50R,D00,893772,Miller; Elizabeth Deen,0,0,20,20
1746603838286,MCWP 50R,E00,893775,Carter; Andrea L,0,1,20,20
1746603839314,MMW 11R,A01,892721,Herbst; Matthew,14,0,30,16
1746603839314,MMW 11R,A02,892722,Herbst; Matthew,0,0,0,3
1746603840339,MMW 12R,A01,892724,Herbst; Matthew,0,11,16,16
1746603840339,MMW 12R,A02,892725,Herbst; Matthew,0,10,16,16
1746603841370,MMW 13R,A01,892727,Staff,0,4,16,16
1746603841370,MMW 13R,A02,892728,Staff,0,4,16,16
1746603841370,MMW 13R,A03,958032,Staff,0,4,16,16
1746603841370,MMW 13R,A04,958033,Staff,0,4,16,16
1746603841370,MMW 13R,A05,958034,Staff,0,4,16,16
1746603842415,SIO 295LS,A00,894015,Staff,5,0,25,20
1746603843442,SIO 295S,A00,894020,Staff,5,0,25,20
1746603844478,SIOC 290S,B01,958918,Merrifield; Mark A,14,0,30,16
1746603845505,SIOC 291S,B01,958922,Gabriel; Corey John,14,0,30,16
1746603846532,SOCI 117,A01,895339,Staff,2,0,5,3
1746603847559,WES 237B,A00,894149,Staff,11,0,20,9
1746603849639,AESE 279B,A00,891859,Staff,13,0,35,22
1746603850664,AIP 197,001,891854,Vespa; Emanuel Ignacio,9999,0,9999,0
1746603851695,ANTH 289S,A00,891856,Gagneux; Pascal,12,0,12,0
1746603852720,BENG 196,001,957946,Engler; Adam J.,9996,0,9999,3
1746603853750,BISP 197,001,959851,Wilhelm; James E.,9998,0,9999,1
1746603854777,CAT 124RS,A01,956906,Staff,6,0,25,19
1746603855812,CAT 125RS,A01,922013,Staff,6,0,25,19
1746603856845,CLRE 250,A00,891860,Morris; Sheldon,9995,0,9999,4
1746603858897,CLRE 251R,A00,907817,Mehta; Ravindra L.,9994,0,9999,5
1746603859927,CLRE 252,A00,891864,Cuomo; Raphael Eduardo,9993,0,9999,6
1746603860952,CLRE 253,A00,891867,Vaida; Florin,9994,0,9999,5
1746603860952,CLRE 253,B00,907819,Staff,9999,0,9999,0
1746603861980,CLRE 259,A00,891868,Patel; Hemal,9998,0,9999,1
1746603863006,CLRE 260,A00,891872,Cuomo; Raphael Eduardo,9999,0,9999,0
1746603864031,CLRE 297,001,891888,Cuomo; Raphael Eduardo,9999,0,9999,0
1746603865057,CSE 191,A00,958773,Minnes Kemp; Mor Mia,9995,0,9999,4
1746603866087,CSE 197,001,959846,Minnes Kemp; Mor Mia,9990,0,9999,9
1746603867122,CSS 201S,A01,892054,Mignozzetti; Umberto,25,0,30,5
1746603868152,CSS 202S,A01,892056,Mignozzetti; Umberto,25,0,30,5
1746603869180,DSC 197,001,956898,Eldridge; Justin Matthew,9996,0,9999,3
1746603870209,DSC 297,001,958000,Mazumdar; Arya,9998,0,9999,1
1746603870209,DSC 297,002,959862,Wang; Yusu,9998,0,9999,1
1746603871237,EAP 100,A00,905686,Staff,9778,0,9999,221
1746603872268,ECE 45,A01,892618,Staff,0,0,65,65
1746603874323,ECE 111,A01,892719,Staff,6,0,65,59
1746603875349,ECE 197,001,957920,Mercier; Patrick Philip,9991,0,9999,8
1746603876378,ECON 178,A01,907814,Zhu; Ying,26,0,35,9
1746603877404,EDS 115,A00,895312,Staff,35,0,45,10
1746603878434,EDS 117,A01,895337,Staff,23,0,30,7
1746603879463,EDS 125,A00,895341,Jones; Gabrielle Anastasia,36,0,45,9
1746603880489,EDS 128A,A01,895459,Fargason; Sharon Gayle,44,0,45,1
1746603881517,EDS 128B,A01,895543,Pappas; Elizabeth,44,0,45,1
1746603882544,EDS 139,A00,897203,Pappas; Elizabeth,44,0,45,1
1746603882544,EDS 139,B00,897209,Fargason; Sharon Gayle,41,0,45,4
1746603883570,EDS 201,A00,895545,Staff,22,0,45,23
1746603884597,EDS 203,A01,895581,Halter; Christopher P.,22,0,45,23
1746603885630,EDS 204R,A01,895625,Heinzman; Erica M.,39,0,45,6
1746603885630,EDS 204R,B01,895693,Halter; Christopher P.,10,0,45,35
1746603886656,EDS 206R,A00,895694,Fargason; Sharon Gayle,1,0,30,29
1746603886656,EDS 206R,B00,895695,Choi; Bailey Miyeon,16,0,30,14
1746603887683,EDS 250,A00,895697,Hemans; Patricia Ann Benitez,22,0,45,23
1746603888710,EDS 281,A00,895701,Meyerott; Theresa Ann,1,0,15,14
1746603889740,EDS 284,A00,895736,Meyerott; Theresa Ann,1,0,15,14
1746603890766,EDS 286,A00,897210,Fine; Sarah,0,0,15,15
1746603891793,EDS 289C,A01,895770,Daly; Alan J.,1,0,15,14
1746603892819,EDS 290,A00,897211,Hofstetter; Carolyn,0,0,15,15
1746603893855,LIGM 5A,A00,896162,Fischer-Grunski; Eva K,12,0,20,8
1746603894880,LIGM 5B,A00,896260,Fischer-Grunski; Eva K,17,0,20,3
1746603895911,LIGM 5C,A00,896308,Fischer-Grunski; Eva K,18,0,20,2
1746603896940,LIIT 5AS,A00,896313,Carnelos; Chiara,18,0,20,2
1746603897965,LIIT 5BS,A00,896416,Carnelos; Chiara,20,0,20,0
1746603898997,LIIT 5CS,A00,896564,Carnelos; Chiara,20,0,20,0
1746603900024,LISP 5A,A00,896588,Munoz Sanchez; Alicia,2,0,20,18
1746603901053,LISP 5B,A00,896653,Munoz Sanchez; Alicia,7,0,20,13
1746603902084,LISP 5C,A00,896655,Munoz Sanchez; Alicia,0,1,20,20
1746603903120,MAE 197,001,957918,Kleissl; Jan,9996,0,9999,3
1746603903120,MAE 197,002,959806,Boechler; Nicholas Sebastia,9998,0,9999,1
1746603903120,MAE 197,003,959852,Mullin; Jennifer S,9998,0,9999,1
1746603904146,MATH 2,A01,957937,Staff,33,0,35,2
1746603905174,MATH 197,001,957876,Kedlaya; Kiran S.,9993,0,9999,6
1746603906203,MCWP 40,A00,892729,Duru; Nur,10,0,20,10
1746603906203,MCWP 40,B00,893304,Montejo; Carolina,14,0,20,6
1746603907231,MCWP 40R,A00,893757,Redela; Pamela Morgan,0,5,20,20
1746603908259,MCWP 50,A00,893758,Morshed; Michael James,0,0,20,20
1746603908259,MCWP 50,B00,893761,Bartulis; Jason Michael,16,0,20,4
1746603909289,MCWP 50R,A00,893766,Compas; Sean Matthew,0,1,20,20
1746603909289,MCWP 50R,B00,893769,Carter; Jennifer A,0,1,20,20
1746603909289,MCWP 50R,C00,893771,Krone; Jarret,0,3,20,20
1746603909289,MCWP 50R,D00,893772,Miller; Elizabeth Deen,0,0,20,20
1746603909289,MCWP 50R,E00,893775,Carter; Andrea L,0,1,20,20
1746603910321,MMW 11R,A01,892721,Herbst; Matthew,14,0,30,16
1746603910321,MMW 11R,A02,892722,Herbst; Matthew,0,0,0,3
1746603911351,MMW 12R,A01,892724,Herbst; Matthew,0,11,16,16
1746603911351,MMW 12R,A02,892725,Herbst; Matthew,0,10,16,16
1746603912382,MMW 13R,A01,892727,Staff,0,4,16,16
1746603912382,MMW 13R,A02,892728,Staff,0,4,16,16
1746603912382,MMW 13R,A03,958032,Staff,0,4,16,16
1746603912382,MMW 13R,A04,958033,Staff,0,4,16,16
1746603912382,MMW 13R,A05,958034,Staff,0,4,16,16
1746603913406,SIO 295LS,A00,894015,Staff,5,0,25,20
1746603914440,SIO 295S,A00,894020,Staff,5,0,25,20
1746603915475,SIOC 290S,B01,958918,Merrifield; Mark A,14,0,30,16
1746603916510,SIOC 291S,B01,958922,Gabriel; Corey John,14,0,30,16
1746603917536,SOCI 117,A01,895339,Staff,2,0,5,3
1746603918580,WES 237B,A00,894149,Staff,11,0,20,9
1746603920715,AESE 279B,A00,891859,Staff,13,0,35,22
1746603921743,AIP 197,001,891854,Vespa; Emanuel Ignacio,9999,0,9999,0
1746603922769,ANTH 289S,A00,891856,Gagneux; Pascal,12,0,12,0
1746603923797,BENG 196,001,957946,Engler; Adam J.,9996,0,9999,3
1746603924825,BISP 197,001,959851,Wilhelm; James E.,9998,0,9999,1
1746603925853,CAT 124RS,A01,956906,Staff,6,0,25,19
1746603926881,CAT 125RS,A01,922013,Staff,6,0,25,19
1746603927910,CLRE 250,A00,891860,Morris; Sheldon,9995,0,9999,4
1746603929968,CLRE 251R,A00,907817,Mehta; Ravindra L.,9994,0,9999,5
1746603930995,CLRE 252,A00,891864,Cuomo; Raphael Eduardo,9993,0,9999,6
1746603932025,CLRE 253,A00,891867,Vaida; Florin,9994,0,9999,5
1746603932025,CLRE 253,B00,907819,Staff,9999,0,9999,0
1746603933050,CLRE 259,A00,891868,Patel; Hemal,9998,0,9999,1
1746603934077,CLRE 260,A00,891872,Cuomo; Raphael Eduardo,9999,0,9999,0
1746603935106,CLRE 297,001,891888,Cuomo; Raphael Eduardo,9999,0,9999,0
1746603936134,CSE 191,A00,958773,Minnes Kemp; Mor Mia,9995,0,9999,4
1746603937166,CSE 197,001,959846,Minnes Kemp; Mor Mia,9990,0,9999,9
1746603938200,CSS 201S,A01,892054,Mignozzetti; Umberto,25,0,30,5
1746603939233,CSS 202S,A01,892056,Mignozzetti; Umberto,25,0,30,5
1746603940261,DSC 197,001,956898,Eldridge; Justin Matthew,9996,0,9999,3
1746603941289,DSC 297,001,958000,Mazumdar; Arya,9998,0,9999,1
1746603941289,DSC 297,002,959862,Wang; Yusu,9998,0,9999,1
1746603942320,EAP 100,A00,905686,Staff,9778,0,9999,221
1746603943347,ECE 45,A01,892618,Staff,0,0,65,65
1746603945399,ECE 111,A01,892719,Staff,6,0,65,59
1746603946426,ECE 197,001,957920,Mercier; Patrick Philip,9991,0,9999,8
1746603947453,ECON 178,A01,907814,Zhu; Ying,26,0,35,9
1746603948479,EDS 115,A00,895312,Staff,35,0,45,10
1746603949508,EDS 117,A01,895337,Staff,23,0,30,7
1746603950536,EDS 125,A00,895341,Jones; Gabrielle Anastasia,36,0,45,9
1746603951565,EDS 128A,A01,895459,Fargason; Sharon Gayle,44,0,45,1
1746603952600,EDS 128B,A01,895543,Pappas; Elizabeth,44,0,45,1
1746603953629,EDS 139,A00,897203,Pappas; Elizabeth,44,0,45,1
1746603953629,EDS 139,B00,897209,Fargason; Sharon Gayle,41,0,45,4
1746603954661,EDS 201,A00,895545,Staff,22,0,45,23
1746603955689,EDS 203,A01,895581,Halter; Christopher P.,22,0,45,23
1746603956718,EDS 204R,A01,895625,Heinzman; Erica M.,39,0,45,6
1746603956718,EDS 204R,B01,895693,Halter; Christopher P.,10,0,45,35
1746603957750,EDS 206R,A00,895694,Fargason; Sharon Gayle,1,0,30,29
1746603957750,EDS 206R,B00,895695,Choi; Bailey Miyeon,16,0,30,14
1746603958779,EDS 250,A00,895697,Hemans; Patricia Ann Benitez,22,0,45,23
1746603959805,EDS 281,A00,895701,Meyerott; Theresa Ann,1,0,15,14
1746603960834,EDS 284,A00,895736,Meyerott; Theresa Ann,1,0,15,14
1746603961862,EDS 286,A00,897210,Fine; Sarah,0,0,15,15
1746603962891,EDS 289C,A01,895770,Daly; Alan J.,1,0,15,14
1746603963917,EDS 290,A00,897211,Hofstetter; Carolyn,0,0,15,15
1746603964953,LIGM 5A,A00,896162,Fischer-Grunski; Eva K,12,0,20,8
1746603965985,LIGM 5B,A00,896260,Fischer-Grunski; Eva K,17,0,20,3
1746603967015,LIGM 5C,A00,896308,Fischer-Grunski; Eva K,18,0,20,2
1746603968043,LIIT 5AS,A00,896313,Carnelos; Chiara,18,0,20,2
1746603969069,LIIT 5BS,A00,896416,Carnelos; Chiara,20,0,20,0
1746603970102,LIIT 5CS,A00,896564,Carnelos; Chiara,20,0,20,0
1746603971132,LISP 5A,A00,896588,Munoz Sanchez; Alicia,2,0,20,18
1746603972159,LISP 5B,A00,896653,Munoz Sanchez; Alicia,7,0,20,13
1746603973187,LISP 5C,A00,896655,Munoz Sanchez; Alicia,0,1,20,20
1746603974222,MAE 197,001,957918,Kleissl; Jan,9996,0,9999,3
1746603974222,MAE 197,002,959806,Boechler; Nicholas Sebastia,9998,0,9999,1
1746603974222,MAE 197,003,959852,Mullin; Jennifer S,9998,0,9999,1
1746603975248,MATH 2,A01,957937,Staff,33,0,35,2
1746603976276,MATH 197,001,957876,Kedlaya; Kiran S.,9993,0,9999,6
1746603977341,MCWP 40,A00,892729,Duru; Nur,10,0,20,10
1746603977341,MCWP 40,B00,893304,Montejo; Carolina,14,0,20,6
1746603978372,MCWP 40R,A00,893757,Redela; Pamela Morgan,0,5,20,20
1746603979399,MCWP 50,A00,893758,Morshed; Michael James,0,0,20,20
1746603979399,MCWP 50,B00,893761,Bartulis; Jason Michael,16,0,20,4
1746603980432,MCWP 50R,A00,893766,Compas; Sean Matthew,0,1,20,20
1746603980432,MCWP 50R,B00,893769,Carter; Jennifer A,0,1,20,20
1746603980432,MCWP 50R,C00,893771,Krone; Jarret,0,3,20,20
1746603980432,MCWP 50R,D00,893772,Miller; Elizabeth Deen,0,0,20,20
1746603980432,MCWP 50R,E00,893775,Carter; Andrea L,0,1,20,20
1746603981464,MMW 11R,A01,892721,Herbst; Matthew,14,0,30,16
1746603981464,MMW 11R,A02,892722,Herbst; Matthew,0,0,0,3
1746603982490,MMW 12R,A01,892724,Herbst; Matthew,0,11,16,16
1746603982490,MMW 12R,A02,892725,Herbst; Matthew,0,10,16,16
1746603983518,MMW 13R,A01,892727,Staff,0,4,16,16
1746603983518,MMW 13R,A02,892728,Staff,0,4,16,16
1746603983518,MMW 13R,A03,958032,Staff,0,4,16,16
1746603983518,MMW 13R,A04,958033,Staff,0,4,16,16
1746603983518,MMW 13R,A05,958034,Staff,0,4,16,16
1746603984550,SIO 295LS,A00,894015,Staff,5,0,25,20
1746603985580,SIO 295S,A00,894020,Staff,5,0,25,20
1746603986615,SIOC 290S,B01,958918,Merrifield; Mark A,14,0,30,16
1746603987644,SIOC 291S,B01,958922,Gabriel; Corey John,14,0,30,16
1746603988673,SOCI 117,A01,895339,Staff,2,0,5,3
1746603989698,WES 237B,A00,894149,Staff,11,0,20,9
1746603991784,AESE 279B,A00,891859,Staff,13,0,35,22
1746603992811,AIP 197,001,891854,Vespa; Emanuel Ignacio,9999,0,9999,0
1746603993838,ANTH 289S,A00,891856,Gagneux; Pascal,12,0,12,0
1746603994870,BENG 196,001,957946,Engler; Adam J.,9996,0,9999,3
1746603995900,BISP 197,001,959851,Wilhelm; James E.,9998,0,9999,1
1746603996925,CAT 124RS,A01,956906,Staff,6,0,25,19
1746603997955,CAT 125RS,A01,922013,Staff,6,0,25,19
1746603998985,CLRE 250,A00,891860,Morris; Sheldon,9995,0,9999,4
1746604001046,CLRE 251R,A00,907817,Mehta; Ravindra L.,9994,0,9999,5
1746604002077,CLRE 252,A00,891864,Cuomo; Raphael Eduardo,9993,0,9999,6
1746604003107,CLRE 253,A00,891867,Vaida; Florin,9994,0,9999,5
1746604003107,CLRE 253,B00,907819,Staff,9999,0,9999,0
1746604004135,CLRE 259,A00,891868,Patel; Hemal,9998,0,9999,1
1746604005159,CLRE 260,A00,891872,Cuomo; Raphael Eduardo,9999,0,9999,0
1746604006184,CLRE 297,001,891888,Cuomo; Raphael Eduardo,9999,0,9999,0
1746604007211,CSE 191,A00,958773,Minnes Kemp; Mor Mia,9995,0,9999,4
1746604008240,CSE 197,001,959846,Minnes Kemp; Mor Mia,9990,0,9999,9
1746604009274,CSS 201S,A01,892054,Mignozzetti; Umberto,25,0,30,5
1746604010300,CSS 202S,A01,892056,Mignozzetti; Umberto,25,0,30,5
1746604011327,DSC 197,001,956898,Eldridge; Justin Matthew,9996,0,9999,3
1746604012357,DSC 297,001,958000,Mazumdar; Arya,9998,0,9999,1
1746604012357,DSC 297,002,959862,Wang; Yusu,9998,0,9999,1
1746604013383,EAP 100,A00,905686,Staff,9778,0,9999,221
1746604014414,ECE 45,A01,892618,Staff,0,0,65,65
1746604016471,ECE 111,A01,892719,Staff,6,0,65,59
1746604017499,ECE 197,001,957920,Mercier; Patrick Philip,9991,0,9999,8
1746604018526,ECON 178,A01,907814,Zhu; Ying,26,0,35,9
1746604019551,EDS 115,A00,895312,Staff,35,0,45,10
1746604020580,EDS 117,A01,895337,Staff,23,0,30,7
1746604021608,EDS 125,A00,895341,Jones; Gabrielle Anastasia,36,0,45,9
1746604022641,EDS 128A,A01,895459,Fargason; Sharon Gayle,44,0,45,1
1746604023673,EDS 128B,A01,895543,Pappas; Elizabeth,44,0,45,1
1746604024700,EDS 139,A00,897203,Pappas; Elizabeth,44,0,45,1
1746604024700,EDS 139,B00,897209,Fargason; Sharon Gayle,41,0,45,4
1746604025732,EDS 201,A00,895545,Staff,22,0,45,23
1746604026758,EDS 203,A01,895581,Halter; Christopher P.,22,0,45,23
1746604027785,EDS 204R,A01,895625,Heinzman; Erica M.,39,0,45,6
1746604027785,EDS 204R,B01,895693,Halter; Christopher P.,10,0,45,35
1746604028810,EDS 206R,A00,895694,Fargason; Sharon Gayle,1,0,30,29
1746604028810,EDS 206R,B00,895695,Choi; Bailey Miyeon,16,0,30,14
1746604029837,EDS 250,A00,895697,Hemans; Patricia Ann Benitez,22,0,45,23
1746604030869,EDS 281,A00,895701,Meyerott; Theresa Ann,1,0,15,14
1746604031900,EDS 284,A00,895736,Meyerott; Theresa Ann,1,0,15,14
1746604032927,EDS 286,A00,897210,Fine; Sarah,0,0,15,15
1746604033953,EDS 289C,A01,895770,Daly; Alan J.,1,0,15,14
1746604034983,EDS 290,A00,897211,Hofstetter; Carolyn,0,0,15,15
1746604036018,LIGM 5A,A00,896162,Fischer-Grunski; Eva K,12,0,20,8
1746604037045,LIGM 5B,A00,896260,Fischer-Grunski; Eva K,17,0,20,3
1746604038073,LIGM 5C,A00,896308,Fischer-Grunski; Eva K,18,0,20,2
1746604039105,LIIT 5AS,A00,896313,Carnelos; Chiara,18,0,20,2
1746604040139,LIIT 5BS,A00,896416,Carnelos; Chiara,20,0,20,0
1746604041170,LIIT 5CS,A00,896564,Carnelos; Chiara,20,0,20,0
1746604042197,LISP 5A,A00,896588,Munoz Sanchez; Alicia,2,0,20,18
1746604043223,LISP 5B,A00,896653,Munoz Sanchez; Alicia,7,0,20,13
1746604044251,LISP 5C,A00,896655,Munoz Sanchez; Alicia,0,1,20,20
1746604045287,MAE 197,001,957918,Kleissl; Jan,9996,0,9999,3
1746604045287,MAE 197,002,959806,Boechler; Nicholas Sebastia,9998,0,9999,1
1746604045287,MAE 197,003,959852,Mullin; Jennifer S,9998,0,9999,1
1746604046318,MATH 2,A01,957937,Staff,33,0,35,2
1746604047351,MATH 197,001,957876,Kedlaya; Kiran S.,9993,0,9999,6
1746604048383,MCWP 40,A00,892729,Duru; Nur,10,0,20,10
1746604048383,MCWP 40,B00,893304,Montejo; Carolina,14,0,20,6
1746604049411,MCWP 40R,A00,893757,Redela; Pamela Morgan,0,5,20,20
1746604050443,MCWP 50,A00,893758,Morshed; Michael James,0,0,20,20
1746604050443,MCWP 50,B00,893761,Bartulis; Jason Michael,16,0,20,4
1746604051472,MCWP 50R,A00,893766,Compas; Sean Matthew,0,1,20,20
1746604051472,MCWP 50R,B00,893769,Carter; Jennifer A,0,1,20,20
1746604051472,MCWP 50R,C00,893771,Krone; Jarret,0,3,20,20
1746604051472,MCWP 50R,D00,893772,Miller; Elizabeth Deen,0,0,20,20
1746604051472,MCWP 50R,E00,893775,Carter; Andrea L,0,1,20,20
1746604052503,MMW 11R,A01,892721,Herbst; Matthew,14,0,30,16
1746604052503,MMW 11R,A02,892722,Herbst; Matthew,0,0,0,3
1746604053532,MMW 12R,A01,892724,Herbst; Matthew,0,11,16,16
1746604053532,MMW 12R,A02,892725,Herbst; Matthew,0,10,16,16
1746604054562,MMW 13R,A01,892727,Staff,0,4,16,16
1746604054562,MMW 13R,A02,892728,Staff,0,4,16,16
1746604054562,MMW 13R,A03,958032,Staff,0,4,16,16
1746604054562,MMW 13R,A04,958033,Staff,0,4,16,16
1746604054562,MMW 13R,A05,958034,Staff,0,4,16,16
1746604055589,SIO 295LS,A00,894015,Staff,5,0,25,20
1746604056614,SIO 295S,A00,894020,Staff,5,0,25,20
1746604057647,SIOC 290S,B01,958918,Merrifield; Mark A,14,0,30,16
1746604058701,SIOC 291S,B01,958922,Gabriel; Corey John,14,0,30,16
1746604059730,SOCI 117,A01,895339,Staff,2,0,5,3
1746604060759,WES 237B,A00,894149,Staff,11,0,20,9
1746604062835,AESE 279B,A00,891859,Staff,13,0,35,22
1746604063867,AIP 197,001,891854,Vespa; Emanuel Ignacio,9999,0,9999,0
1746604064894,ANTH 289S,A00,891856,Gagneux; Pascal,12,0,12,0
1746604065925,BENG 196,001,957946,Engler; Adam J.,9996,0,9999,3
1746604066951,BISP 197,001,959851,Wilhelm; James E.,9998,0,9999,1
1746604067980,CAT 124RS,A01,956906,Staff,6,0,25,19
1746604069006,CAT 125RS,A01,922013,Staff,6,0,25,19
1746604070033,CLRE 250,A00,891860,Morris; Sheldon,9995,0,9999,4
1746604072087,CLRE 251R,A00,907817,Mehta; Ravindra L.,9994,0,9999,5
1746604073115,CLRE 252,A00,891864,Cuomo; Raphael Eduardo,9993,0,9999,6
1746604074143,CLRE 253,A00,891867,Vaida; Florin,9994,0,9999,5
1746604074143,CLRE 253,B00,907819,Staff,9999,0,9999,0
1746604075173,CLRE 259,A00,891868,Patel; Hemal,9998,0,9999,1
1746604076199,CLRE 260,A00,891872,Cuomo; Raphael Eduardo,9999,0,9999,0
1746604077229,CLRE 297,001,891888,Cuomo; Raphael Eduardo,9999,0,9999,0
1746604078258,CSE 191,A00,958773,Minnes Kemp; Mor Mia,9995,0,9999,4
1746604079285,CSE 197,001,959846,Minnes Kemp; Mor Mia,9990,0,9999,9
1746604080313,CSS 201S,A01,892054,Mignozzetti; Umberto,25,0,30,5
1746604081384,CSS 202S,A01,892056,Mignozzetti; Umberto,25,0,30,5
1746604082419,DSC 197,001,956898,Eldridge; Justin Matthew,9996,0,9999,3
1746604083447,DSC 297,001,958000,Mazumdar; Arya,9998,0,9999,1
1746604083447,DSC 297,002,959862,Wang; Yusu,9998,0,9999,1
1746604084473,EAP 100,A00,905686,Staff,9778,0,9999,221
1746604085503,ECE 45,A01,892618,Staff,0,0,65,65
1746604087556,ECE 111,A01,892719,Staff,6,0,65,59
1746604088587,ECE 197,001,957920,Mercier; Patrick Philip,9991,0,9999,8
1746604089621,ECON 178,A01,907814,Zhu; Ying,26,0,35,9
1746604090647,EDS 115,A00,895312,Staff,35,0,45,10
1746604091673,EDS 117,A01,895337,Staff,23,0,30,7
1746604092699,EDS 125,A00,895341,Jones; Gabrielle Anastasia,36,0,45,9
1746604093728,EDS 128A,A01,895459,Fargason; Sharon Gayle,44,0,45,1
1746604094768,EDS 128B,A01,895543,Pappas; Elizabeth,44,0,45,1
1746604095798,EDS 139,A00,897203,Pappas; Elizabeth,44,0,45,1
1746604095798,EDS 139,B00,897209,Fargason; Sharon Gayle,41,0,45,4
1746604096824,EDS 201,A00,895545,Staff,22,0,45,23
1746604097851,EDS 203,A01,895581,Halter; Christopher P.,22,0,45,23
1746604098881,EDS 204R,A01,895625,Heinzman; Erica M.,39,0,45,6
1746604098881,EDS 204R,B01,895693,Halter; Christopher P.,10,0,45,35
1746604099910,EDS 206R,A00,895694,Fargason; Sharon Gayle,1,0,30,29
1746604099910,EDS 206R,B00,895695,Choi; Bailey Miyeon,16,0,30,14
1746604100938,EDS 250,A00,895697,Hemans; Patricia Ann Benitez,22,0,45,23
1746604101965,EDS 281,A00,895701,Meyerott; Theresa Ann,1,0,15,14
1746604102994,EDS 284,A00,895736,Meyerott; Theresa Ann,1,0,15,14
1746604104021,EDS 286,A00,897210,Fine; Sarah,0,0,15,15
1746604105055,EDS 289C,A01,895770,Daly; Alan J.,1,0,15,14
1746604106081,EDS 290,A00,897211,Hofstetter; Carolyn,0,0,15,15
1746604107110,LIGM 5A,A00,896162,Fischer-Grunski; Eva K,12,0,20,8
1746604108138,LIGM 5B,A00,896260,Fischer-Grunski; Eva K,17,0,20,3
1746604109170,LIGM 5C,A00,896308,Fischer-Grunski; Eva K,18,0,20,2
1746604110203,LIIT 5AS,A00,896313,Carnelos; Chiara,18,0,20,2
1746604111230,LIIT 5BS,A00,896416,Carnelos; Chiara,20,0,20,0
1746604112259,LIIT 5CS,A00,896564,Carnelos; Chiara,20,0,20,0
1746604113292,LISP 5A,A00,896588,Munoz Sanchez; Alicia,2,0,20,18
1746604114324,LISP 5B,A00,896653,Munoz Sanchez; Alicia,7,0,20,13
1746604115350,LISP 5C,A00,896655,Munoz Sanchez; Alicia,0,1,20,20
1746604116380,MAE 197,001,957918,Kleissl; Jan,9996,0,9999,3
1746604116380,MAE 197,002,959806,Boechler; Nicholas Sebastia,9998,0,9999,1
1746604116380,MAE 197,003,959852,Mullin; Jennifer S,9998,0,9999,1
1746604117410,MATH 2,A01,957937,Staff,33,0,35,2
1746604118439,MATH 197,001,957876,Kedlaya; Kiran S.,9993,0,9999,6
1746604119469,MCWP 40,A00,892729,Duru; Nur,10,0,20,10
1746604119469,MCWP 40,B00,893304,Montejo; Carolina,14,0,20,6
1746604120495,MCWP 40R,A00,893757,Redela; Pamela Morgan,0,5,20,20
1746604121523,MCWP 50,A00,893758,Morshed; Michael James,0,0,20,20
1746604121523,MCWP 50,B00,893761,Bartulis; Jason Michael,16,0,20,4
1746604122551,MCWP 50R,A00,893766,Compas; Sean Matthew,0,1,20,20
1746604122551,MCWP 50R,B00,893769,Carter; Jennifer A,0,1,20,20
1746604122551,MCWP 50R,C00,893771,Krone; Jarret,0,3,20,20
1746604122551,MCWP 50R,D00,893772,Miller; Elizabeth Deen,0,0,20,20
1746604122551,MCWP 50R,E00,893775,Carter; Andrea L,0,1,20,20
1746604123578,MMW 11R,A01,892721,Herbst; Matthew,14,0,30,16
1746604123578,MMW 11R,A02,892722,Herbst; Matthew,0,0,0,3
1746604124608,MMW 12R,A01,892724,Herbst; Matthew,0,11,16,16
1746604124608,MMW 12R,A02,892725,Herbst; Matthew,0,10,16,16
1746604125636,MMW 13R,A01,892727,Staff,0,4,16,16
1746604125636,MMW 13R,A02,892728,Staff,0,4,16,16
1746604125636,MMW 13R,A03,958032,Staff,0,4,16,16
1746604125636,MMW 13R,A04,958033,Staff,0,4,16,16
1746604125636,MMW 13R,A05,958034,Staff,0,4,16,16
1746604126666,SIO 295LS,A00,894015,Staff,5,0,25,20
1746604127695,SIO 295S,A00,894020,Staff,5,0,25,20
1746604128724,SIOC 290S,B01,958918,Merrifield; Mark A,14,0,30,16
1746604129753,SIOC 291S,B01,958922,Gabriel; Corey John,14,0,30,16
1746604130780,SOCI 117,A01,895339,Staff,2,0,5,3
1746604131807,WES 237B,A00,894149,Staff,11,0,20,9
1746604133924,AESE 279B,A00,891859,Staff,13,0,35,22
1746604134951,AIP 197,001,891854,Vespa; Emanuel Ignacio,9999,0,9999,0
1746604135978,ANTH 289S,A00,891856,Gagneux; Pascal,12,0,12,0
1746604137006,BENG 196,001,957946,Engler; Adam J.,9996,0,9999,3
1746604138032,BISP 197,001,959851,Wilhelm; James E.,9998,0,9999,1
1746604139075,CAT 124RS,A01,956906,Staff,6,0,25,19
1746604140102,CAT 125RS,A01,922013,Staff,6,0,25,19
1746604141133,CLRE 250,A00,891860,Morris; Sheldon,9995,0,9999,4
1746604143189,CLRE 251R,A00,907817,Mehta; Ravindra L.,9994,0,9999,5
1746604144215,CLRE 252,A00,891864,Cuomo; Raphael Eduardo,9993,0,9999,6
1746604145240,CLRE 253,A00,891867,Vaida; Florin,9994,0,9999,5
1746604145240,CLRE 253,B00,907819,Staff,9999,0,9999,0
1746604146270,CLRE 259,A00,891868,Patel; Hemal,9998,0,9999,1
1746604147296,CLRE 260,A00,891872,Cuomo; Raphael Eduardo,9999,0,9999,0
1746604148324,CLRE 297,001,891888,Cuomo; Raphael Eduardo,9999,0,9999,0
1746604149358,CSE 191,A00,958773,Minnes Kemp; Mor Mia,9995,0,9999,4
1746604150385,CSE 197,001,959846,Minnes Kemp; Mor Mia,9990,0,9999,9
1746604151415,CSS 201S,A01,892054,Mignozzetti; Umberto,25,0,30,5
1746604152443,CSS 202S,A01,892056,Mignozzetti; Umberto,25,0,30,5
1746604153472,DSC 197,001,956898,Eldridge; Justin Matthew,9996,0,9999,3
1746604154500,DSC 297,001,958000,Mazumdar; Arya,9998,0,9999,1
1746604154500,DSC 297,002,959862,Wang; Yusu,9998,0,9999,1
1746604155527,EAP 100,A00,905686,Staff,9778,0,9999,221
1746604156557,ECE 45,A01,892618,Staff,0,0,65,65
1746604158615,ECE 111,A01,892719,Staff,6,0,65,59
1746604159643,ECE 197,001,957920,Mercier; Patrick Philip,9991,0,9999,8
1746604160677,ECON 178,A01,907814,Zhu; Ying,26,0,35,9
1746604161707,EDS 115,A00,895312,Staff,35,0,45,10
1746604162735,EDS 117,A01,895337,Staff,23,0,30,7
1746604163767,EDS 125,A00,895341,Jones; Gabrielle Anastasia,36,0,45,9
1746604164794,EDS 128A,A01,895459,Fargason; Sharon Gayle,44,0,45,1
1746604165826,EDS 128B,A01,895543,Pappas; Elizabeth,44,0,45,1
1746604166855,EDS 139,A00,897203,Pappas; Elizabeth,44,0,45,1
1746604166855,EDS 139,B00,897209,Fargason; Sharon Gayle,41,0,45,4
1746604167882,EDS 201,A00,895545,Staff,22,0,45,23
1746604168913,EDS 203,A01,895581,Halter; Christopher P.,22,0,45,23
1746604169941,EDS 204R,A01,895625,Heinzman; Erica M.,39,0,45,6
1746604169941,EDS 204R,B01,895693,Halter; Christopher P.,10,0,45,35
1746604170973,EDS 206R,A00,895694,Fargason; Sharon Gayle,1,0,30,29
1746604170973,EDS 206R,B00,895695,Choi; Bailey Miyeon,16,0,30,14
1746604172006,EDS 250,A00,895697,Hemans; Patricia Ann Benitez,22,0,45,23
1746604173032,EDS 281,A00,895701,Meyerott; Theresa Ann,1,0,15,14
1746604174060,EDS 284,A00,895736,Meyerott; Theresa Ann,1,0,15,14
1746604175088,EDS 286,A00,897210,Fine; Sarah,0,0,15,15
1746604176116,EDS 289C,A01,895770,Daly; Alan J.,1,0,15,14
1746604177144,EDS 290,A00,897211,Hofstetter; Carolyn,0,0,15,15
1746604178179,LIGM 5A,A00,896162,Fischer-Grunski; Eva K,12,0,20,8
1746604179205,LIGM 5B,A00,896260,Fischer-Grunski; Eva K,17,0,20,3
1746604180232,LIGM 5C,A00,896308,Fischer-Grunski; Eva K,18,0,20,2
1746604181259,LIIT 5AS,A00,896313,Carnelos; Chiara,18,0,20,2
1746604182287,LIIT 5BS,A00,896416,Carnelos; Chiara,20,0,20,0
1746604183317,LIIT 5CS,A00,896564,Carnelos; Chiara,20,0,20,0
1746604184352,LISP 5A,A00,896588,Munoz Sanchez; Alicia,2,0,20,18
1746604185419,LISP 5B,A00,896653,Munoz Sanchez; Alicia,7,0,20,13
1746604186446,LISP 5C,A00,896655,Munoz Sanchez; Alicia,0,1,20,20
1746604187473,MAE 197,001,957918,Kleissl; Jan,9996,0,9999,3
1746604187473,MAE 197,002,959806,Boechler; Nicholas Sebastia,9998,0,9999,1
1746604187473,MAE 197,003,959852,Mullin; Jennifer S,9998,0,9999,1
1746604188501,MATH 2,A01,957937,Staff,33,0,35,2
1746604189531,MATH 197,001,957876,Kedlaya; Kiran S.,9993,0,9999,6
1746604190561,MCWP 40,A00,892729,Duru; Nur,10,0,20,10
1746604190561,MCWP 40,B00,893304,Montejo; Carolina,14,0,20,6
1746604191589,MCWP 40R,A00,893757,Redela; Pamela Morgan,0,5,20,20
1746604192621,MCWP 50,A00,893758,Morshed; Michael James,0,0,20,20
1746604192621,MCWP 50,B00,893761,Bartulis; Jason Michael,16,0,20,4
1746604193650,MCWP 50R,A00,893766,Compas; Sean Matthew,0,1,20,20
1746604193650,MCWP 50R,B00,893769,Carter; Jennifer A,0,1,20,20
1746604193650,MCWP 50R,C00,893771,Krone; Jarret,0,3,20,20
1746604193650,MCWP 50R,D00,893772,Miller; Elizabeth Deen,0,0,20,20
1746604193650,MCWP 50R,E00,893775,Carter; Andrea L,0,1,20,20
1746604194678,MMW 11R,A01,892721,Herbst; Matthew,14,0,30,16
1746604194678,MMW 11R,A02,892722,Herbst; Matthew,0,0,0,3
1746604195705,MMW 12R,A01,892724,Herbst; Matthew,0,11,16,16
1746604195705,MMW 12R,A02,892725,Herbst; Matthew,0,10,16,16
1746604196732,MMW 13R,A01,892727,Staff,0,4,16,16
1746604196732,MMW 13R,A02,892728,Staff,0,4,16,16
1746604196732,MMW 13R,A03,958032,Staff,0,4,16,16
1746604196732,MMW 13R,A04,958033,Staff,0,4,16,16
1746604196732,MMW 13R,A05,958034,Staff,0,4,16,16
1746604197760,SIO 295LS,A00,894015,Staff,5,0,25,20
1746604198793,SIO 295S,A00,894020,Staff,5,0,25,20
1746604199829,SIOC 290S,B01,958918,Merrifield; Mark A,14,0,30,16
1746604200866,SIOC 291S,B01,958922,Gabriel; Corey John,14,0,30,16
1746604201902,SOCI 117,A01,895339,Staff,2,0,5,3
1746604202929,WES 237B,A00,894149,Staff,11,0,20,9
1746604205021,AESE 279B,A00,891859,Staff,13,0,35,22
1746604206052,AIP 197,001,891854,Vespa; Emanuel Ignacio,9999,0,9999,0
1746604207078,ANTH 289S,A00,891856,Gagneux; Pascal,12,0,12,0
1746604208105,BENG 196,001,957946,Engler; Adam J.,9996,0,9999,3
1746604209133,BISP 197,001,959851,Wilhelm; James E.,9998,0,9999,1
1746604210162,CAT 124RS,A01,956906,Staff,6,0,25,19
1746604211189,CAT 125RS,A01,922013,Staff,6,0,25,19
1746604212216,CLRE 250,A00,891860,Morris; Sheldon,9995,0,9999,4
1746604214276,CLRE 251R,A00,907817,Mehta; Ravindra L.,9994,0,9999,5
1746604215305,CLRE 252,A00,891864,Cuomo; Raphael Eduardo,9993,0,9999,6
1746604216332,CLRE 253,A00,891867,Vaida; Florin,9994,0,9999,5
1746604216332,CLRE 253,B00,907819,Staff,9999,0,9999,0
1746604217358,CLRE 259,A00,891868,Patel; Hemal,9998,0,9999,1
1746604218387,CLRE 260,A00,891872,Cuomo; Raphael Eduardo,9999,0,9999,0
1746604219414,CLRE 297,001,891888,Cuomo; Raphael Eduardo,9999,0,9999,0
1746604220444,CSE 191,A00,958773,Minnes Kemp; Mor Mia,9995,0,9999,4
1746604221472,CSE 197,001,959846,Minnes Kemp; Mor Mia,9990,0,9999,9
1746604222499,CSS 201S,A01,892054,Mignozzetti; Umberto,25,0,30,5
1746604223529,CSS 202S,A01,892056,Mignozzetti; Umberto,25,0,30,5
1746604224560,DSC 197,001,956898,Eldridge; Justin Matthew,9996,0,9999,3
1746604225591,DSC 297,001,958000,Mazumdar; Arya,9998,0,9999,1
1746604225591,DSC 297,002,959862,Wang; Yusu,9998,0,9999,1
1746604226620,EAP 100,A00,905686,Staff,9778,0,9999,221
1746604227656,ECE 45,A01,892618,Staff,0,0,65,65
1746604229713,ECE 111,A01,892719,Staff,6,0,65,59
1746604230741,ECE 197,001,957920,Mercier; Patrick Philip,9991,0,9999,8
1746604231771,ECON 178,A01,907814,Zhu; Ying,26,0,35,9
1746604232805,EDS 115,A00,895312,Staff,35,0,45,10
1746604233834,EDS 117,A01,895337,Staff,23,0,30,7
1746604234861,EDS 125,A00,895341,Jones; Gabrielle Anastasia,36,0,45,9
1746604235889,EDS 128A,A01,895459,Fargason; Sharon Gayle,44,0,45,1
1746604236920,EDS 128B,A01,895543,Pappas; Elizabeth,44,0,45,1
1746604237947,EDS 139,A00,897203,Pappas; Elizabeth,44,0,45,1
1746604237947,EDS 139,B00,897209,Fargason; Sharon Gayle,41,0,45,4
1746604238975,EDS 201,A00,895545,Staff,22,0,45,23
1746604240018,EDS 203,A01,895581,Halter; Christopher P.,22,0,45,23
1746604241046,EDS 204R,A01,895625,Heinzman; Erica M.,39,0,45,6
1746604241046,EDS 204R,B01,895693,Halter; Christopher P.,10,0,45,35
1746604242079,EDS 206R,A00,895694,Fargason; Sharon Gayle,1,0,30,29
1746604242079,EDS 206R,B00,895695,Choi; Bailey Miyeon,16,0,30,14
1746604243108,EDS 250,A00,895697,Hemans; Patricia Ann Benitez,22,0,45,23
1746604244138,EDS 281,A00,895701,Meyerott; Theresa Ann,1,0,15,14
1746604245164,EDS 284,A00,895736,Meyerott; Theresa Ann,1,0,15,14
1746604246191,EDS 286,A00,897210,Fine; Sarah,0,0,15,15
1746604247217,EDS 289C,A01,895770,Daly; Alan J.,1,0,15,14
1746604248247,EDS 290,A00,897211,Hofstetter; Carolyn,0,0,15,15
1746604249284,LIGM 5A,A00,896162,Fischer-Grunski; Eva K,12,0,20,8
1746604250311,LIGM 5B,A00,896260,Fischer-Grunski; Eva K,17,0,20,3
1746604251339,LIGM 5C,A00,896308,Fischer-Grunski; Eva K,18,0,20,2
1746604252364,LIIT 5AS,A00,896313,Carnelos; Chiara,18,0,20,2
1746604253388,LIIT 5BS,A00,896416,Carnelos; Chiara,20,0,20,0
1746604254415,LIIT 5CS,A00,896564,Carnelos; Chiara,20,0,20,0
1746604255440,LISP 5A,A00,896588,Munoz Sanchez; Alicia,2,0,20,18
1746604256470,LISP 5B,A00,896653,Munoz Sanchez; Alicia,7,0,20,13
1746604257520,LISP 5C,A00,896655,Munoz Sanchez; Alicia,0,1,20,20
1746604258554,MAE 197,001,957918,Kleissl; Jan,9996,0,9999,3
1746604258554,MAE 197,002,959806,Boechler; Nicholas Sebastia,9998,0,9999,1
1746604258554,MAE 197,003,959852,Mullin; Jennifer S,9998,0,9999,1
1746604259580,MATH 2,A01,957937,Staff,33,0,35,2
1746604260607,MATH 197,001,957876,Kedlaya; Kiran S.,9993,0,9999,6
1746604261642,MCWP 40,A00,892729,Duru; Nur,10,0,20,10
1746604261642,MCWP 40,B00,893304,Montejo; Carolina,14,0,20,6
1746604262673,MCWP 40R,A00,893757,Redela; Pamela Morgan,0,5,20,20
1746604263699,MCWP 50,A00,893758,Morshed; Michael James,0,0,20,20
1746604263699,MCWP 50,B00,893761,Bartulis; Jason Michael,16,0,20,4
1746604264734,MCWP 50R,A00,893766,Compas; Sean Matthew,0,1,20,20
1746604264734,MCWP 50R,B00,893769,Carter; Jennifer A,0,1,20,20
1746604264734,MCWP 50R,C00,893771,Krone; Jarret,0,3,20,20
1746604264734,MCWP 50R,D00,893772,Miller; Elizabeth Deen,0,0,20,20
1746604264734,MCWP 50R,E00,893775,Carter; Andrea L,0,1,20,20
1746604265766,MMW 11R,A01,892721,Herbst; Matthew,14,0,30,16
1746604265766,MMW 11R,A02,892722,Herbst; Matthew,0,0,0,3
1746604266792,MMW 12R,A01,892724,Herbst; Matthew,0,11,16,16
1746604266792,MMW 12R,A02,892725,Herbst; Matthew,0,10,16,16
1746604267823,MMW 13R,A01,892727,Staff,0,4,16,16
1746604267823,MMW 13R,A02,892728,Staff,0,4,16,16
1746604267823,MMW 13R,A03,958032,Staff,0,4,16,16
1746604267823,MMW 13R,A04,958033,Staff,0,4,16,16
1746604267823,MMW 13R,A05,958034,Staff,0,4,16,16
1746604268865,SIO 295LS,A00,894015,Staff,5,0,25,20
1746604269890,SIO 295S,A00,894020,Staff,5,0,25,20
1746604270920,SIOC 290S,B01,958918,Merrifield; Mark A,14,0,30,16
1746604271948,SIOC 291S,B01,958922,Gabriel; Corey John,14,0,30,16
1746604272974,SOCI 117,A01,895339,Staff,2,0,5,3
1746604273999,WES 237B,A00,894149,Staff,11,0,20,9
1746604276085,AESE 279B,A00,891859,Staff,13,0,35,22
1746604277112,AIP 197,001,891854,Vespa; Emanuel Ignacio,9999,0,9999,0
1746604278142,ANTH 289S,A00,891856,Gagneux; Pascal,12,0,12,0
1746604279167,BENG 196,001,957946,Engler; Adam J.,9996,0,9999,3
1746604280192,BISP 197,001,959851,Wilhelm; James E.,9998,0,9999,1
1746604281221,CAT 124RS,A01,956906,Staff,6,0,25,19
1746604282249,CAT 125RS,A01,922013,Staff,6,0,25,19
1746604283290,CLRE 250,A00,891860,Morris; Sheldon,9995,0,9999,4
1746604285348,CLRE 251R,A00,907817,Mehta; Ravindra L.,9994,0,9999,5
1746604286374,CLRE 252,A00,891864,Cuomo; Raphael Eduardo,9993,0,9999,6
1746604287404,CLRE 253,A00,891867,Vaida; Florin,9994,0,9999,5
1746604287404,CLRE 253,B00,907819,Staff,9999,0,9999,0
1746604288432,CLRE 259,A00,891868,Patel; Hemal,9998,0,9999,1
1746604289458,CLRE 260,A00,891872,Cuomo; Raphael Eduardo,9999,0,9999,0
1746604290485,CLRE 297,001,891888,Cuomo; Raphael Eduardo,9999,0,9999,0
1746604291512,CSE 191,A00,958773,Minnes Kemp; Mor Mia,9995,0,9999,4
1746604292541,CSE 197,001,959846,Minnes Kemp; Mor Mia,9990,0,9999,9
1746604293569,CSS 201S,A01,892054,Mignozzetti; Umberto,25,0,30,5
1746604294602,CSS 202S,A01,892056,Mignozzetti; Umberto,25,0,30,5
1746604295630,DSC 197,001,956898,Eldridge; Justin Matthew,9996,0,9999,3
1746604296656,DSC 297,001,958000,Mazumdar; Arya,9998,0,9999,1
1746604296656,DSC 297,002,959862,Wang; Yusu,9998,0,9999,1
1746604297682,EAP 100,A00,905686,Staff,9778,0,9999,221
1746604298716,ECE 45,A01,892618,Staff,0,0,65,65
1746604300770,ECE 111,A01,892719,Staff,6,0,65,59
1746604301796,ECE 197,001,957920,Mercier; Patrick Philip,9991,0,9999,8
1746604302830,ECON 178,A01,907814,Zhu; Ying,26,0,35,9
1746604303856,EDS 115,A00,895312,Staff,35,0,45,10
1746604304885,EDS 117,A01,895337,Staff,23,0,30,7
1746604305912,EDS 125,A00,895341,Jones; Gabrielle Anastasia,36,0,45,9
1746604306938,EDS 128A,A01,895459,Fargason; Sharon Gayle,44,0,45,1
1746604307967,EDS 128B,A01,895543,Pappas; Elizabeth,44,0,45,1
1746604308993,EDS 139,A00,897203,Pappas; Elizabeth,44,0,45,1
1746604308993,EDS 139,B00,897209,Fargason; Sharon Gayle,41,0,45,4
1746604310030,EDS 201,A00,895545,Staff,22,0,45,23
1746604311057,EDS 203,A01,895581,Halter; Christopher P.,22,0,45,23
1746604312082,EDS 204R,A01,895625,Heinzman; Erica M.,39,0,45,6
1746604312082,EDS 204R,B01,895693,Halter; Christopher P.,10,0,45,35
1746604313110,EDS 206R,A00,895694,Fargason; Sharon Gayle,1,0,30,29
1746604313110,EDS 206R,B00,895695,Choi; Bailey Miyeon,16,0,30,14
1746604314139,EDS 250,A00,895697,Hemans; Patricia Ann Benitez,22,0,45,23
1746604315165,EDS 281,A00,895701,Meyerott; Theresa Ann,1,0,15,14
1746604316191,EDS 284,A00,895736,Meyerott; Theresa Ann,1,0,15,14
1746604317216,EDS 286,A00,897210,Fine; Sarah,0,0,15,15
1746604318242,EDS 289C,A01,895770,Daly; Alan J.,1,0,15,14
1746604319268,EDS 290,A00,897211,Hofstetter; Carolyn,0,0,15,15
1746604320294,LIGM 5A,A00,896162,Fischer-Grunski; Eva K,12,0,20,8
1746604321325,LIGM 5B,A00,896260,Fischer-Grunski; Eva K,17,0,20,3
1746604322352,LIGM 5C,A00,896308,Fischer-Grunski; Eva K,18,0,20,2
1746604323384,LIIT 5AS,A00,896313,Carnelos; Chiara,18,0,20,2
1746604324409,LIIT 5BS,A00,896416,Carnelos; Chiara,20,0,20,0
1746604325436,LIIT 5CS,A00,896564,Carnelos; Chiara,20,0,20,0
1746604326468,LISP 5A,A00,896588,Munoz Sanchez; Alicia,2,0,20,18
1746604327495,LISP 5B,A00,896653,Munoz Sanchez; Alicia,7,0,20,13
1746604328526,LISP 5C,A00,896655,Munoz Sanchez; Alicia,0,1,20,20
1746604329554,MAE 197,001,957918,Kleissl; Jan,9996,0,9999,3
1746604329554,MAE 197,002,959806,Boechler; Nicholas Sebastia,9998,0,9999,1
1746604329554,MAE 197,003,959852,Mullin; Jennifer S,9998,0,9999,1
1746604330583,MATH 2,A01,957937,Staff,33,0,35,2
1746604331610,MATH 197,001,957876,Kedlaya; Kiran S.,9993,0,9999,6
1746604332638,MCWP 40,A00,892729,Duru; Nur,10,0,20,10
1746604332638,MCWP 40,B00,893304,Montejo; Carolina,14,0,20,6
1746604333663,MCWP 40R,A00,893757,Redela; Pamela Morgan,0,5,20,20
1746604334694,MCWP 50,A00,893758,Morshed; Michael James,0,0,20,20
1746604334694,MCWP 50,B00,893761,Bartulis; Jason Michael,16,0,20,4
1746604335723,MCWP 50R,A00,893766,Compas; Sean Matthew,0,1,20,20
1746604335723,MCWP 50R,B00,893769,Carter; Jennifer A,0,1,20,20
1746604335723,MCWP 50R,C00,893771,Krone; Jarret,0,3,20,20
1746604335723,MCWP 50R,D00,893772,Miller; Elizabeth Deen,0,0,20,20
1746604335723,MCWP 50R,E00,893775,Carter; Andrea L,0,1,20,20
1746604336749,MMW 11R,A01,892721,Herbst; Matthew,14,0,30,16
1746604336749,MMW 11R,A02,892722,Herbst; Matthew,0,0,0,3
1746604337775,MMW 12R,A01,892724,Herbst; Matthew,0,11,16,16
1746604337775,MMW 12R,A02,892725,Herbst; Matthew,0,10,16,16
1746604338806,MMW 13R,A01,892727,Staff,0,4,16,16
1746604338806,MMW 13R,A02,892728,Staff,0,4,16,16
1746604338806,MMW 13R,A03,958032,Staff,0,4,16,16
1746604338806,MMW 13R,A04,958033,Staff,0,4,16,16
1746604338806,MMW 13R,A05,958034,Staff,0,4,16,16
1746604339831,SIO 295LS,A00,894015,Staff,5,0,25,20
1746604340858,SIO 295S,A00,894020,Staff,5,0,25,20
1746604341891,SIOC 290S,B01,958918,Merrifield; Mark A,14,0,30,16
1746604342920,SIOC 291S,B01,958922,Gabriel; Corey John,14,0,30,16
1746604343955,SOCI 117,A01,895339,Staff,2,0,5,3
1746604344980,WES 237B,A00,894149,Staff,11,0,20,9
1746604347059,AESE 279B,A00,891859,Staff,13,0,35,22
1746604348088,AIP 197,001,891854,Vespa; Emanuel Ignacio,9999,0,9999,0
1746604349118,ANTH 289S,A00,891856,Gagneux; Pascal,12,0,12,0
1746604350143,BENG 196,001,957946,Engler; Adam J.,9996,0,9999,3
1746604351175,BISP 197,001,959851,Wilhelm; James E.,9998,0,9999,1
1746604352203,CAT 124RS,A01,956906,Staff,6,0,25,19
1746604353232,CAT 125RS,A01,922013,Staff,6,0,25,19
1746604354259,CLRE 250,A00,891860,Morris; Sheldon,9995,0,9999,4
1746604356315,CLRE 251R,A00,907817,Mehta; Ravindra L.,9994,0,9999,5
1746604357345,CLRE 252,A00,891864,Cuomo; Raphael Eduardo,9993,0,9999,6
1746604358373,CLRE 253,A00,891867,Vaida; Florin,9994,0,9999,5
1746604358373,CLRE 253,B00,907819,Staff,9999,0,9999,0
1746604359399,CLRE 259,A00,891868,Patel; Hemal,9998,0,9999,1
1746604360426,CLRE 260,A00,891872,Cuomo; Raphael Eduardo,9999,0,9999,0
1746604361451,CLRE 297,001,891888,Cuomo; Raphael Eduardo,9999,0,9999,0
1746604362478,CSE 191,A00,958773,Minnes Kemp; Mor Mia,9995,0,9999,4
1746604363504,CSE 197,001,959846,Minnes Kemp; Mor Mia,9990,0,9999,9
1746604364536,CSS 201S,A01,892054,Mignozzetti; Umberto,25,0,30,5
1746604365570,CSS 202S,A01,892056,Mignozzetti; Umberto,25,0,30,5
1746604366597,DSC 197,001,956898,Eldridge; Justin Matthew,9996,0,9999,3
1746604367628,DSC 297,001,958000,Mazumdar; Arya,9998,0,9999,1
1746604367628,DSC 297,002,959862,Wang; Yusu,9998,0,9999,1
1746604368654,EAP 100,A00,905686,Staff,9778,0,9999,221
1746604369682,ECE 45,A01,892618,Staff,0,0,65,65
1746604371736,ECE 111,A01,892719,Staff,6,0,65,59
1746604372768,ECE 197,001,957920,Mercier; Patrick Philip,9991,0,9999,8
1746604373794,ECON 178,A01,907814,Zhu; Ying,26,0,35,9
1746604374824,EDS 115,A00,895312,Staff,35,0,45,10
1746604375852,EDS 117,A01,895337,Staff,23,0,30,7
1746604376883,EDS 125,A00,895341,Jones; Gabrielle Anastasia,36,0,45,9
1746604377909,EDS 128A,A01,895459,Fargason; Sharon Gayle,44,0,45,1
1746604378937,EDS 128B,A01,895543,Pappas; Elizabeth,44,0,45,1
1746604379966,EDS 139,A00,897203,Pappas; Elizabeth,44,0,45,1
1746604379966,EDS 139,B00,897209,Fargason; Sharon Gayle,41,0,45,4
1746604380993,EDS 201,A00,895545,Staff,22,0,45,23
1746604382023,EDS 203,A01,895581,Halter; Christopher P.,22,0,45,23
1746604383057,EDS 204R,A01,895625,Heinzman; Erica M.,39,0,45,6
1746604383057,EDS 204R,B01,895693,Halter; Christopher P.,10,0,45,35
1746604384089,EDS 206R,A00,895694,Fargason; Sharon Gayle,1,0,30,29
1746604384089,EDS 206R,B00,895695,Choi; Bailey Miyeon,16,0,30,14
1746604385115,EDS 250,A00,895697,Hemans; Patricia Ann Benitez,22,0,45,23
1746604386140,EDS 281,A00,895701,Meyerott; Theresa Ann,1,0,15,14
1746604387164,EDS 284,A00,895736,Meyerott; Theresa Ann,1,0,15,14
1746604388191,EDS 286,A00,897210,Fine; Sarah,0,0,15,15
1746604389220,EDS 289C,A01,895770,Daly; Alan J.,1,0,15,14
1746604390245,EDS 290,A00,897211,Hofstetter; Carolyn,0,0,15,15
1746604391273,LIGM 5A,A00,896162,Fischer-Grunski; Eva K,12,0,20,8
1746604392301,LIGM 5B,A00,896260,Fischer-Grunski; Eva K,17,0,20,3
1746604393329,LIGM 5C,A00,896308,Fischer-Grunski; Eva K,18,0,20,2
1746604394355,LIIT 5AS,A00,896313,Carnelos; Chiara,18,0,20,2
1746604395379,LIIT 5BS,A00,896416,Carnelos; Chiara,20,0,20,0
1746604396405,LIIT 5CS,A00,896564,Carnelos; Chiara,20,0,20,0
1746604397436,LISP 5A,A00,896588,Munoz Sanchez; Alicia,2,0,20,18
1746604398466,LISP 5B,A00,896653,Munoz Sanchez; Alicia,7,0,20,13
1746604399499,LISP 5C,A00,896655,Munoz Sanchez; Alicia,0,1,20,20
1746604400526,MAE 197,001,957918,Kleissl; Jan,9996,0,9999,3
1746604400526,MAE 197,002,959806,Boechler; Nicholas Sebastia,9998,0,9999,1
1746604400526,MAE 197,003,959852,Mullin; Jennifer S,9998,0,9999,1
1746604401552,MATH 2,A01,957937,Staff,33,0,35,2
1746604402581,MATH 197,001,957876,Kedlaya; Kiran S.,9993,0,9999,6
1746604403608,MCWP 40,A00,892729,Duru; Nur,10,0,20,10
1746604403608,MCWP 40,B00,893304,Montejo; Carolina,14,0,20,6
1746604404646,MCWP 40R,A00,893757,Redela; Pamela Morgan,0,5,20,20
1746604405673,MCWP 50,A00,893758,Morshed; Michael James,0,0,20,20
1746604405673,MCWP 50,B00,893761,Bartulis; Jason Michael,16,0,20,4
1746604406702,MCWP 50R,A00,893766,Compas; Sean Matthew,0,1,20,20
1746604406702,MCWP 50R,B00,893769,Carter; Jennifer A,0,1,20,20
1746604406702,MCWP 50R,C00,893771,Krone; Jarret,0,3,20,20
1746604406702,MCWP 50R,D00,893772,Miller; Elizabeth Deen,0,0,20,20
1746604406702,MCWP 50R,E00,893775,Carter; Andrea L,0,1,20,20
1746604407729,MMW 11R,A01,892721,Herbst; Matthew,14,0,30,16
1746604407729,MMW 11R,A02,892722,Herbst; Matthew,0,0,0,3
1746604408755,MMW 12R,A01,892724,Herbst; Matthew,0,11,16,16
1746604408755,MMW 12R,A02,892725,Herbst; Matthew,0,10,16,16
1746604409782,MMW 13R,A01,892727,Staff,0,4,16,16
1746604409782,MMW 13R,A02,892728,Staff,0,4,16,16
1746604409782,MMW 13R,A03,958032,Staff,0,4,16,16
1746604409782,MMW 13R,A04,958033,Staff,0,4,16,16
1746604409782,MMW 13R,A05,958034,Staff,0,4,16,16
1746604410813,SIO 295LS,A00,894015,Staff,5,0,25,20
1746604411881,SIO 295S,A00,894020,Staff,5,0,25,20
1746604412910,SIOC 290S,B01,958918,Merrifield; Mark A,14,0,30,16
1746604413943,SIOC 291S,B01,958922,Gabriel; Corey John,14,0,30,16
1746604414971,SOCI 117,A01,895339,Staff,2,0,5,3
1746604415997,WES 237B,A00,894149,Staff,11,0,20,9
1746604418101,AESE 279B,A00,891859,Staff,13,0,35,22
1746604419127,AIP 197,001,891854,Vespa; Emanuel Ignacio,9999,0,9999,0
1746604420154,ANTH 289S,A00,891856,Gagneux; Pascal,12,0,12,0
1746604421181,BENG 196,001,957946,Engler; Adam J.,9996,0,9999,3
1746604422211,BISP 197,001,959851,Wilhelm; James E.,9998,0,9999,1
1746604423236,CAT 124RS,A01,956906,Staff,6,0,25,19
1746604424262,CAT 125RS,A01,922013,Staff,6,0,25,19
1746604425288,CLRE 250,A00,891860,Morris; Sheldon,9995,0,9999,4
1746604427348,CLRE 251R,A00,907817,Mehta; Ravindra L.,9994,0,9999,5
1746604428374,CLRE 252,A00,891864,Cuomo; Raphael Eduardo,9993,0,9999,6
1746604429400,CLRE 253,A00,891867,Vaida; Florin,9994,0,9999,5
1746604429400,CLRE 253,B00,907819,Staff,9999,0,9999,0
1746604430427,CLRE 259,A00,891868,Patel; Hemal,9998,0,9999,1
1746604431454,CLRE 260,A00,891872,Cuomo; Raphael Eduardo,9999,0,9999,0
1746604432480,CLRE 297,001,891888,Cuomo; Raphael Eduardo,9999,0,9999,0
1746604433512,CSE 191,A00,958773,Minnes Kemp; Mor Mia,9995,0,9999,4
1746604434538,CSE 197,001,959846,Minnes Kemp; Mor Mia,9990,0,9999,9
1746604435565,CSS 201S,A01,892054,Mignozzetti; Umberto,25,0,30,5
1746604436592,CSS 202S,A01,892056,Mignozzetti; Umberto,25,0,30,5
1746604437618,DSC 197,001,956898,Eldridge; Justin Matthew,9996,0,9999,3
1746604438650,DSC 297,001,958000,Mazumdar; Arya,9998,0,9999,1
1746604438650,DSC 297,002,959862,Wang; Yusu,9998,0,9999,1
1746604439677,EAP 100,A00,905686,Staff,9778,0,9999,221
1746604440704,ECE 45,A01,892618,Staff,0,0,65,65
1746604442756,ECE 111,A01,892719,Staff,6,0,65,59
1746604443787,ECE 197,001,957920,Mercier; Patrick Philip,9991,0,9999,8
1746604444818,ECON 178,A01,907814,Zhu; Ying,26,0,35,9
1746604445843,EDS 115,A00,895312,Staff,35,0,45,10
1746604446871,EDS 117,A01,895337,Staff,23,0,30,7
1746604447900,EDS 125,A00,895341,Jones; Gabrielle Anastasia,36,0,45,9
1746604448934,EDS 128A,A01,895459,Fargason; Sharon Gayle,44,0,45,1
1746604449970,EDS 128B,A01,895543,Pappas; Elizabeth,44,0,45,1
1746604450996,EDS 139,A00,897203,Pappas; Elizabeth,44,0,45,1
1746604450996,EDS 139,B00,897209,Fargason; Sharon Gayle,41,0,45,4
1746604452026,EDS 201,A00,895545,Staff,22,0,45,23
1746604453056,EDS 203,A01,895581,Halter; Christopher P.,22,0,45,23
1746604454084,EDS 204R,A01,895625,Heinzman; Erica M.,39,0,45,6
1746604454084,EDS 204R,B01,895693,Halter; Christopher P.,10,0,45,35
1746604455110,EDS 206R,A00,895694,Fargason; Sharon Gayle,1,0,30,29
1746604455110,EDS 206R,B00,895695,Choi; Bailey Miyeon,16,0,30,14
1746604456142,EDS 250,A00,895697,Hemans; Patricia Ann Benitez,22,0,45,23
1746604457167,EDS 281,A00,895701,Meyerott; Theresa Ann,1,0,15,14
1746604458196,EDS 284,A00,895736,Meyerott; Theresa Ann,1,0,15,14
1746604459223,EDS 286,A00,897210,Fine; Sarah,0,0,15,15
1746604460248,EDS 289C,A01,895770,Daly; Alan J.,1,0,15,14
1746604461276,EDS 290,A00,897211,Hofstetter; Carolyn,0,0,15,15
1746604462309,LIGM 5A,A00,896162,Fischer-Grunski; Eva K,12,0,20,8
1746604463337,LIGM 5B,A00,896260,Fischer-Grunski; Eva K,17,0,20,3
1746604464363,LIGM 5C,A00,896308,Fischer-Grunski; Eva K,18,0,20,2
1746604465389,LIIT 5AS,A00,896313,Carnelos; Chiara,18,0,20,2
1746604466416,LIIT 5BS,A00,896416,Carnelos; Chiara,20,0,20,0
1746604467442,LIIT 5CS,A00,896564,Carnelos; Chiara,20,0,20,0
1746604468475,LISP 5A,A00,896588,Munoz Sanchez; Alicia,2,0,20,18
1746604469505,LISP 5B,A00,896653,Munoz Sanchez; Alicia,7,0,20,13
1746604470536,LISP 5C,A00,896655,Munoz Sanchez; Alicia,0,1,20,20
1746604471568,MAE 197,001,957918,Kleissl; Jan,9996,0,9999,3
1746604471568,MAE 197,002,959806,Boechler; Nicholas Sebastia,9998,0,9999,1
1746604471568,MAE 197,003,959852,Mullin; Jennifer S,9998,0,9999,1
1746604472593,MATH 2,A01,957937,Staff,33,0,35,2
1746604473622,MATH 197,001,957876,Kedlaya; Kiran S.,9993,0,9999,6
1746604474651,MCWP 40,A00,892729,Duru; Nur,10,0,20,10
1746604474651,MCWP 40,B00,893304,Montejo; Carolina,14,0,20,6
1746604475680,MCWP 40R,A00,893757,Redela; Pamela Morgan,0,5,20,20
1746604476705,MCWP 50,A00,893758,Morshed; Michael James,0,0,20,20
1746604476705,MCWP 50,B00,893761,Bartulis; Jason Michael,16,0,20,4
1746604477732,MCWP 50R,A00,893766,Compas; Sean Matthew,0,1,20,20
1746604477732,MCWP 50R,B00,893769,Carter; Jennifer A,0,1,20,20
1746604477732,MCWP 50R,C00,893771,Krone; Jarret,0,3,20,20
1746604477732,MCWP 50R,D00,893772,Miller; Elizabeth Deen,0,0,20,20
1746604477732,MCWP 50R,E00,893775,Carter; Andrea L,0,1,20,20
1746604478763,MMW 11R,A01,892721,Herbst; Matthew,14,0,30,16
1746604478763,MMW 11R,A02,892722,Herbst; Matthew,0,0,0,3
1746604479787,MMW 12R,A01,892724,Herbst; Matthew,0,11,16,16
1746604479787,MMW 12R,A02,892725,Herbst; Matthew,0,10,16,16
1746604480820,MMW 13R,A01,892727,Staff,0,4,16,16
1746604480820,MMW 13R,A02,892728,Staff,0,4,16,16
1746604480820,MMW 13R,A03,958032,Staff,0,4,16,16
1746604480820,MMW 13R,A04,958033,Staff,0,4,16,16
1746604480820,MMW 13R,A05,958034,Staff,0,4,16,16
1746604481849,SIO 295LS,A00,894015,Staff,5,0,25,20
1746604482873,SIO 295S,A00,894020,Staff,5,0,25,20
1746604483914,SIOC 290S,B01,958918,Merrifield; Mark A,14,0,30,16
1746604484939,SIOC 291S,B01,958922,Gabriel; Corey John,14,0,30,16
1746604485988,SOCI 117,A01,895339,Staff,2,0,5,3
1746604487055,WES 237B,A00,894149,Staff,11,0,20,9
1746604489165,AESE 279B,A00,891859,Staff,13,0,35,22
1746604490190,AIP 197,001,891854,Vespa; Emanuel Ignacio,9999,0,9999,0
1746604491236,ANTH 289S,A00,891856,Gagneux; Pascal,12,0,12,0
1746604492261,BENG 196,001,957946,Engler; Adam J.,9996,0,9999,3
1746604493288,BISP 197,001,959851,Wilhelm; James E.,9998,0,9999,1
1746604494312,CAT 124RS,A01,956906,Staff,6,0,25,19
1746604495344,CAT 125RS,A01,922013,Staff,6,0,25,19
1746604496402,CLRE 250,A00,891860,Morris; Sheldon,9995,0,9999,4
1746604498458,CLRE 251R,A00,907817,Mehta; Ravindra L.,9994,0,9999,5
1746604499490,CLRE 252,A00,891864,Cuomo; Raphael Eduardo,9993,0,9999,6
1746604500515,CLRE 253,A00,891867,Vaida; Florin,9994,0,9999,5
1746604500515,CLRE 253,B00,907819,Staff,9999,0,9999,0
1746604501540,CLRE 259,A00,891868,Patel; Hemal,9998,0,9999,1
1746604502565,CLRE 260,A00,891872,Cuomo; Raphael Eduardo,9999,0,9999,0
1746604503599,CLRE 297,001,891888,Cuomo; Raphael Eduardo,9999,0,9999,0
1746604504627,CSE 191,A00,958773,Minnes Kemp; Mor Mia,9995,0,9999,4
1746604505678,CSE 197,001,959846,Minnes Kemp; Mor Mia,9990,0,9999,9
1746604506706,CSS 201S,A01,892054,Mignozzetti; Umberto,25,0,30,5
1746604507732,CSS 202S,A01,892056,Mignozzetti; Umberto,25,0,30,5
1746604508757,DSC 197,001,956898,Eldridge; Justin Matthew,9996,0,9999,3
1746604509804,DSC 297,001,958000,Mazumdar; Arya,9998,0,9999,1
1746604509804,DSC 297,002,959862,Wang; Yusu,9998,0,9999,1
1746604510830,EAP 100,A00,905686,Staff,9778,0,9999,221
1746604511866,ECE 45,A01,892618,Staff,0,0,65,65
1746604513934,ECE 111,A01,892719,Staff,6,0,65,59
1746604514978,ECE 197,001,957920,Mercier; Patrick Philip,9991,0,9999,8
1746604516135,ECON 178,A01,907814,Zhu; Ying,26,0,35,9
1746604517161,EDS 115,A00,895312,Staff,35,0,45,10
1746604518190,EDS 117,A01,895337,Staff,23,0,30,7
1746604519218,EDS 125,A00,895341,Jones; Gabrielle Anastasia,36,0,45,9
1746604520247,EDS 128A,A01,895459,Fargason; Sharon Gayle,44,0,45,1
1746604521276,EDS 128B,A01,895543,Pappas; Elizabeth,44,0,45,1
1746604522303,EDS 139,A00,897203,Pappas; Elizabeth,44,0,45,1
1746604522303,EDS 139,B00,897209,Fargason; Sharon Gayle,41,0,45,4
1746604523330,EDS 201,A00,895545,Staff,22,0,45,23
1746604524356,EDS 203,A01,895581,Halter; Christopher P.,22,0,45,23
1746604525384,EDS 204R,A01,895625,Heinzman; Erica M.,39,0,45,6
1746604525384,EDS 204R,B01,895693,Halter; Christopher P.,10,0,45,35
1746604526410,EDS 206R,A00,895694,Fargason; Sharon Gayle,1,0,30,29
1746604526410,EDS 206R,B00,895695,Choi; Bailey Miyeon,16,0,30,14
1746604527437,EDS 250,A00,895697,Hemans; Patricia Ann Benitez,22,0,45,23
1746604528462,EDS 281,A00,895701,Meyerott; Theresa Ann,1,0,15,14
1746604529493,EDS 284,A00,895736,Meyerott; Theresa Ann,1,0,15,14
1746604530523,EDS 286,A00,897210,Fine; Sarah,0,0,15,15
1746604531550,EDS 289C,A01,895770,Daly; Alan J.,1,0,15,14
1746604532578,EDS 290,A00,897211,Hofstetter; Carolyn,0,0,15,15
1746604533606,LIGM 5A,A00,896162,Fischer-Grunski; Eva K,12,0,20,8
1746604534634,LIGM 5B,A00,896260,Fischer-Grunski; Eva K,17,0,20,3
1746604535666,LIGM 5C,A00,896308,Fischer-Grunski; Eva K,18,0,20,2
1746604536697,LIIT 5AS,A00,896313,Carnelos; Chiara,18,0,20,2
1746604537722,LIIT 5BS,A00,896416,Carnelos; Chiara,20,0,20,0
1746604538749,LIIT 5CS,A00,896564,Carnelos; Chiara,20,0,20,0
1746604539781,LISP 5A,A00,896588,Munoz Sanchez; Alicia,2,0,20,18
1746604540810,LISP 5B,A00,896653,Munoz Sanchez; Alicia,7,0,20,13
1746604541836,LISP 5C,A00,896655,Munoz Sanchez; Alicia,0,1,20,20
1746604542867,MAE 197,001,957918,Kleissl; Jan,9996,0,9999,3
1746604542867,MAE 197,002,959806,Boechler; Nicholas Sebastia,9998,0,9999,1
1746604542867,MAE 197,003,959852,Mullin; Jennifer S,9998,0,9999,1
1746604543896,MATH 2,A01,957937,Staff,33,0,35,2
1746604544923,MATH 197,001,957876,Kedlaya; Kiran S.,9993,0,9999,6
1746604545954,MCWP 40,A00,892729,Duru; Nur,10,0,20,10
1746604545954,MCWP 40,B00,893304,Montejo; Carolina,14,0,20,6
1746604546978,MCWP 40R,A00,893757,Redela; Pamela Morgan,0,5,20,20
1746604548006,MCWP 50,A00,893758,Morshed; Michael James,0,0,20,20
1746604548006,MCWP 50,B00,893761,Bartulis; Jason Michael,16,0,20,4
1746604549074,MCWP 50R,A00,893766,Compas; Sean Matthew,0,1,20,20
1746604549074,MCWP 50R,B00,893769,Carter; Jennifer A,0,1,20,20
1746604549074,MCWP 50R,C00,893771,Krone; Jarret,0,3,20,20
1746604549074,MCWP 50R,D00,893772,Miller; Elizabeth Deen,0,0,20,20
1746604549074,MCWP 50R,E00,893775,Carter; Andrea L,0,1,20,20
1746604550103,MMW 11R,A01,892721,Herbst; Matthew,14,0,30,16
1746604550103,MMW 11R,A02,892722,Herbst; Matthew,0,0,0,3
1746604551129,MMW 12R,A01,892724,Herbst; Matthew,0,11,16,16
1746604551129,MMW 12R,A02,892725,Herbst; Matthew,0,10,16,16
1746604552160,MMW 13R,A01,892727,Staff,0,4,16,16
1746604552160,MMW 13R,A02,892728,Staff,0,4,16,16
1746604552160,MMW 13R,A03,958032,Staff,0,4,16,16
1746604552160,MMW 13R,A04,958033,Staff,0,4,16,16
1746604552160,MMW 13R,A05,958034,Staff,0,4,16,16
1746604553187,SIO 295LS,A00,894015,Staff,5,0,25,20
1746604554215,SIO 295S,A00,894020,Staff,5,0,25,20
1746604555242,SIOC 290S,B01,958918,Merrifield; Mark A,14,0,30,16
1746604556275,SIOC 291S,B01,958922,Gabriel; Corey John,14,0,30,16
1746604557306,SOCI 117,A01,895339,Staff,2,0,5,3
1746604558331,WES 237B,A00,894149,Staff,11,0,20,9
1746604560418,AESE 279B,A00,891859,Staff,13,0,35,22
1746604561448,AIP 197,001,891854,Vespa; Emanuel Ignacio,9999,0,9999,0
1746604562475,ANTH 289S,A00,891856,Gagneux; Pascal,12,0,12,0
1746604563507,BENG 196,001,957946,Engler; Adam J.,9996,0,9999,3
1746604564532,BISP 197,001,959851,Wilhelm; James E.,9998,0,9999,1
1746604565559,CAT 124RS,A01,956906,Staff,6,0,25,19
1746604566587,CAT 125RS,A01,922013,Staff,6,0,25,19
1746604567613,CLRE 250,A00,891860,Morris; Sheldon,9995,0,9999,4
1746604569669,CLRE 251R,A00,907817,Mehta; Ravindra L.,9994,0,9999,5
1746604570698,CLRE 252,A00,891864,Cuomo; Raphael Eduardo,9993,0,9999,6
1746604571725,CLRE 253,A00,891867,Vaida; Florin,9994,0,9999,5
1746604571725,CLRE 253,B00,907819,Staff,9999,0,9999,0
1746604572751,CLRE 259,A00,891868,Patel; Hemal,9998,0,9999,1
1746604573778,CLRE 260,A00,891872,Cuomo; Raphael Eduardo,9999,0,9999,0
1746604574804,CLRE 297,001,891888,Cuomo; Raphael Eduardo,9999,0,9999,0
1746604575833,CSE 191,A00,958773,Minnes Kemp; Mor Mia,9995,0,9999,4
1746604576860,CSE 197,001,959846,Minnes Kemp; Mor Mia,9990,0,9999,9
1746604577896,CSS 201S,A01,892054,Mignozzetti; Umberto,25,0,30,5
1746604578921,CSS 202S,A01,892056,Mignozzetti; Umberto,25,0,30,5
1746604579949,DSC 197,001,956898,Eldridge; Justin Matthew,9996,0,9999,3
1746604580983,DSC 297,001,958000,Mazumdar; Arya,9998,0,9999,1
1746604580983,DSC 297,002,959862,Wang; Yusu,9998,0,9999,1
1746604582013,EAP 100,A00,905686,Staff,9778,0,9999,221
1746604583046,ECE 45,A01,892618,Staff,0,0,65,65
1746604585104,ECE 111,A01,892719,Staff,6,0,65,59
1746604586130,ECE 197,001,957920,Mercier; Patrick Philip,9991,0,9999,8
1746604587162,ECON 178,A01,907814,Zhu; Ying,26,0,35,9
1746604588188,EDS 115,A00,895312,Staff,35,0,45,10
1746604589215,EDS 117,A01,895337,Staff,23,0,30,7
1746604590249,EDS 125,A00,895341,Jones; Gabrielle Anastasia,36,0,45,9
1746604591274,EDS 128A,A01,895459,Fargason; Sharon Gayle,44,0,45,1
1746604592308,EDS 128B,A01,895543,Pappas; Elizabeth,44,0,45,1
1746604593337,EDS 139,A00,897203,Pappas; Elizabeth,44,0,45,1
1746604593337,EDS 139,B00,897209,Fargason; Sharon Gayle,41,0,45,4
1746604594362,EDS 201,A00,895545,Staff,22,0,45,23
1746604595391,EDS 203,A01,895581,Halter; Christopher P.,22,0,45,23
1746604596420,EDS 204R,A01,895625,Heinzman; Erica M.,39,0,45,6
1746604596420,EDS 204R,B01,895693,Halter; Christopher P.,10,0,45,35
1746604597446,EDS 206R,A00,895694,Fargason; Sharon Gayle,1,0,30,29
1746604597446,EDS 206R,B00,895695,Choi; Bailey Miyeon,16,0,30,14
1746604598473,EDS 250,A00,895697,Hemans; Patricia Ann Benitez,22,0,45,23
1746604599505,EDS 281,A00,895701,Meyerott; Theresa Ann,1,0,15,14
1746604600532,EDS 284,A00,895736,Meyerott; Theresa Ann,1,0,15,14
1746604601562,EDS 286,A00,897210,Fine; Sarah,0,0,15,15
1746604602589,EDS 289C,A01,895770,Daly; Alan J.,1,0,15,14
1746604603620,EDS 290,A00,897211,Hofstetter; Carolyn,0,0,15,15
1746604604654,LIGM 5A,A00,896162,Fischer-Grunski; Eva K,12,0,20,8
1746604605681,LIGM 5B,A00,896260,Fischer-Grunski; Eva K,17,0,20,3
1746604606706,LIGM 5C,A00,896308,Fischer-Grunski; Eva K,18,0,20,2
1746604607732,LIIT 5AS,A00,896313,Carnelos; Chiara,18,0,20,2
1746604608765,LIIT 5BS,A00,896416,Carnelos; Chiara,20,0,20,0
1746604609798,LIIT 5CS,A00,896564,Carnelos; Chiara,20,0,20,0
1746604610824,LISP 5A,A00,896588,Munoz Sanchez; Alicia,2,0,20,18
1746604611850,LISP 5B,A00,896653,Munoz Sanchez; Alicia,7,0,20,13
1746604612881,LISP 5C,A00,896655,Munoz Sanchez; Alicia,0,1,20,20
1746604613916,MAE 197,001,957918,Kleissl; Jan,9996,0,9999,3
1746604613916,MAE 197,002,959806,Boechler; Nicholas Sebastia,9998,0,9999,1
1746604613916,MAE 197,003,959852,Mullin; Jennifer S,9998,0,9999,1
1746604614950,MATH 2,A01,957937,Staff,33,0,35,2
1746604615974,MATH 197,001,957876,Kedlaya; Kiran S.,9993,0,9999,6
1746604617004,MCWP 40,A00,892729,Duru; Nur,10,0,20,10
1746604617004,MCWP 40,B00,893304,Montejo; Carolina,14,0,20,6
1746604618034,MCWP 40R,A00,893757,Redela; Pamela Morgan,0,5,20,20
1746604619060,MCWP 50,A00,893758,Morshed; Michael James,0,0,20,20
1746604619060,MCWP 50,B00,893761,Bartulis; Jason Michael,16,0,20,4
1746604620139,MCWP 50R,A00,893766,Compas; Sean Matthew,0,1,20,20
1746604620139,MCWP 50R,B00,893769,Carter; Jennifer A,0,1,20,20
1746604620139,MCWP 50R,C00,893771,Krone; Jarret,0,3,20,20
1746604620139,MCWP 50R,D00,893772,Miller; Elizabeth Deen,0,0,20,20
1746604620139,MCWP 50R,E00,893775,Carter; Andrea L,0,1,20,20
1746604621166,MMW 11R,A01,892721,Herbst; Matthew,14,0,30,16
1746604621166,MMW 11R,A02,892722,Herbst; Matthew,0,0,0,3
1746604622193,MMW 12R,A01,892724,Herbst; Matthew,0,11,16,16
1746604622193,MMW 12R,A02,892725,Herbst; Matthew,0,10,16,16
1746604623219,MMW 13R,A01,892727,Staff,0,4,16,16
1746604623219,MMW 13R,A02,892728,Staff,0,4,16,16
1746604623219,MMW 13R,A03,958032,Staff,0,4,16,16
1746604623219,MMW 13R,A04,958033,Staff,0,4,16,16
1746604623219,MMW 13R,A05,958034,Staff,0,4,16,16
1746604624244,SIO 295LS,A00,894015,Staff,5,0,25,20
1746604625276,SIO 295S,A00,894020,Staff,5,0,25,20
1746604626306,SIOC 290S,B01,958918,Merrifield; Mark A,14,0,30,16
1746604627339,SIOC 291S,B01,958922,Gabriel; Corey John,14,0,30,16
1746604628365,SOCI 117,A01,895339,Staff,2,0,5,3
1746604629391,WES 237B,A00,894149,Staff,11,0,20,9
1746604631469,AESE 279B,A00,891859,Staff,13,0,35,22
1746604632497,AIP 197,001,891854,Vespa; Emanuel Ignacio,9999,0,9999,0
1746604633523,ANTH 289S,A00,891856,Gagneux; Pascal,12,0,12,0
1746604634550,BENG 196,001,957946,Engler; Adam J.,9996,0,9999,3
1746604635580,BISP 197,001,959851,Wilhelm; James E.,9998,0,9999,1
1746604636610,CAT 124RS,A01,956906,Staff,6,0,25,19
1746604637636,CAT 125RS,A01,922013,Staff,6,0,25,19
1746604638662,CLRE 250,A00,891860,Morris; Sheldon,9995,0,9999,4
1746604640716,CLRE 251R,A00,907817,Mehta; Ravindra L.,9994,0,9999,5
1746604641797,CLRE 252,A00,891864,Cuomo; Raphael Eduardo,9993,0,9999,6
1746604642828,CLRE 253,A00,891867,Vaida; Florin,9994,0,9999,5
1746604642828,CLRE 253,B00,907819,Staff,9999,0,9999,0
1746604643855,CLRE 259,A00,891868,Patel; Hemal,9998,0,9999,1
1746604644884,CLRE 260,A00,891872,Cuomo; Raphael Eduardo,9999,0,9999,0
1746604645916,CLRE 297,001,891888,Cuomo; Raphael Eduardo,9999,0,9999,0
1746604646943,CSE 191,A00,958773,Minnes Kemp; Mor Mia,9995,0,9999,4
1746604647979,CSE 197,001,959846,Minnes Kemp; Mor Mia,9990,0,9999,9
1746604649015,CSS 201S,A01,892054,Mignozzetti; Umberto,25,0,30,5
1746604650043,CSS 202S,A01,892056,Mignozzetti; Umberto,25,0,30,5
1746604651074,DSC 197,001,956898,Eldridge; Justin Matthew,9996,0,9999,3
1746604652103,DSC 297,001,958000,Mazumdar; Arya,9998,0,9999,1
1746604652103,DSC 297,002,959862,Wang; Yusu,9998,0,9999,1
1746604653136,EAP 100,A00,905686,Staff,9778,0,9999,221
1746604654171,ECE 45,A01,892618,Staff,0,0,65,65
1746604656226,ECE 111,A01,892719,Staff,6,0,65,59
1746604657260,ECE 197,001,957920,Mercier; Patrick Philip,9991,0,9999,8
1746604658287,ECON 178,A01,907814,Zhu; Ying,26,0,35,9
1746604659313,EDS 115,A00,895312,Staff,35,0,45,10
1746604660346,EDS 117,A01,895337,Staff,23,0,30,7
1746604661379,EDS 125,A00,895341,Jones; Gabrielle Anastasia,36,0,45,9
1746604662406,EDS 128A,A01,895459,Fargason; Sharon Gayle,44,0,45,1
1746604663439,EDS 128B,A01,895543,Pappas; Elizabeth,44,0,45,1
1746604664471,EDS 139,A00,897203,Pappas; Elizabeth,44,0,45,1
1746604664471,EDS 139,B00,897209,Fargason; Sharon Gayle,41,0,45,4
1746604665504,EDS 201,A00,895545,Staff,22,0,45,23
1746604666534,EDS 203,A01,895581,Halter; Christopher P.,22,0,45,23
1746604667560,EDS 204R,A01,895625,Heinzman; Erica M.,39,0,45,6
1746604667560,EDS 204R,B01,895693,Halter; Christopher P.,10,0,45,35
1746604668591,EDS 206R,A00,895694,Fargason; Sharon Gayle,1,0,30,29
1746604668591,EDS 206R,B00,895695,Choi; Bailey Miyeon,16,0,30,14
1746604669618,EDS 250,A00,895697,Hemans; Patricia Ann Benitez,22,0,45,23
1746604670644,EDS 281,A00,895701,Meyerott; Theresa Ann,1,0,15,14
1746604671673,EDS 284,A00,895736,Meyerott; Theresa Ann,1,0,15,14
1746604672698,EDS 286,A00,897210,Fine; Sarah,0,0,15,15
1746604673736,EDS 289C,A01,895770,Daly; Alan J.,1,0,15,14
1746604674770,EDS 290,A00,897211,Hofstetter; Carolyn,0,0,15,15
1746604675798,LIGM 5A,A00,896162,Fischer-Grunski; Eva K,12,0,20,8
1746604676829,LIGM 5B,A00,896260,Fischer-Grunski; Eva K,17,0,20,3
1746604677856,LIGM 5C,A00,896308,Fischer-Grunski; Eva K,18,0,20,2
1746604678889,LIIT 5AS,A00,896313,Carnelos; Chiara,18,0,20,2
1746604679918,LIIT 5BS,A00,896416,Carnelos; Chiara,20,0,20,0
1746604680947,LIIT 5CS,A00,896564,Carnelos; Chiara,20,0,20,0
1746604681974,LISP 5A,A00,896588,Munoz Sanchez; Alicia,2,0,20,18
1746604683003,LISP 5B,A00,896653,Munoz Sanchez; Alicia,7,0,20,13
1746604684030,LISP 5C,A00,896655,Munoz Sanchez; Alicia,0,1,20,20
1746604685056,MAE 197,001,957918,Kleissl; Jan,9996,0,9999,3
1746604685056,MAE 197,002,959806,Boechler; Nicholas Sebastia,9998,0,9999,1
1746604685056,MAE 197,003,959852,Mullin; Jennifer S,9998,0,9999,1
1746604686082,MATH 2,A01,957937,Staff,33,0,35,2
1746604687108,MATH 197,001,957876,Kedlaya; Kiran S.,9993,0,9999,6
1746604688140,MCWP 40,A00,892729,Duru; Nur,10,0,20,10
1746604688140,MCWP 40,B00,893304,Montejo; Carolina,14,0,20,6
1746604689168,MCWP 40R,A00,893757,Redela; Pamela Morgan,0,5,20,20
1746604690201,MCWP 50,A00,893758,Morshed; Michael James,0,0,20,20
1746604690201,MCWP 50,B00,893761,Bartulis; Jason Michael,16,0,20,4
1746604691234,MCWP 50R,A00,893766,Compas; Sean Matthew,0,1,20,20
1746604691234,MCWP 50R,B00,893769,Carter; Jennifer A,0,1,20,20
1746604691234,MCWP 50R,C00,893771,Krone; Jarret,0,3,20,20
1746604691234,MCWP 50R,D00,893772,Miller; Elizabeth Deen,0,0,20,20
1746604691234,MCWP 50R,E00,893775,Carter; Andrea L,0,1,20,20
1746604692260,MMW 11R,A01,892721,Herbst; Matthew,14,0,30,16
1746604692260,MMW 11R,A02,892722,Herbst; Matthew,0,0,0,3
1746604693286,MMW 12R,A01,892724,Herbst; Matthew,0,11,16,16
1746604693286,MMW 12R,A02,892725,Herbst; Matthew,0,10,16,16
1746604694317,MMW 13R,A01,892727,Staff,0,4,16,16
1746604694317,MMW 13R,A02,892728,Staff,0,4,16,16
1746604694317,MMW 13R,A03,958032,Staff,0,4,16,16
1746604694317,MMW 13R,A04,958033,Staff,0,4,16,16
1746604694317,MMW 13R,A05,958034,Staff,0,4,16,16
1746604695344,SIO 295LS,A00,894015,Staff,5,0,25,20
1746604696371,SIO 295S,A00,894020,Staff,5,0,25,20
1746604697402,SIOC 290S,B01,958918,Merrifield; Mark A,14,0,30,16
1746604698428,SIOC 291S,B01,958922,Gabriel; Corey John,14,0,30,16
1746604699454,SOCI 117,A01,895339,Staff,2,0,5,3
1746604700483,WES 237B,A00,894149,Staff,11,0,20,9
1746604702556,AESE 279B,A00,891859,Staff,13,0,35,22
1746604703586,AIP 197,001,891854,Vespa; Emanuel Ignacio,9999,0,9999,0
1746604704616,ANTH 289S,A00,891856,Gagneux; Pascal,12,0,12,0
1746604705645,BENG 196,001,957946,Engler; Adam J.,9996,0,9999,3
1746604706675,BISP 197,001,959851,Wilhelm; James E.,9998,0,9999,1
1746604707703,CAT 124RS,A01,956906,Staff,6,0,25,19
1746604708732,CAT 125RS,A01,922013,Staff,6,0,25,19
1746604709757,CLRE 250,A00,891860,Morris; Sheldon,9995,0,9999,4
1746604711808,CLRE 251R,A00,907817,Mehta; Ravindra L.,9994,0,9999,5
1746604712835,CLRE 252,A00,891864,Cuomo; Raphael Eduardo,9993,0,9999,6
1746604713864,CLRE 253,A00,891867,Vaida; Florin,9994,0,9999,5
1746604713864,CLRE 253,B00,907819,Staff,9999,0,9999,0
1746604714893,CLRE 259,A00,891868,Patel; Hemal,9998,0,9999,1
1746604715919,CLRE 260,A00,891872,Cuomo; Raphael Eduardo,9999,0,9999,0
1746604716946,CLRE 297,001,891888,Cuomo; Raphael Eduardo,9999,0,9999,0
1746604717978,CSE 191,A00,958773,Minnes Kemp; Mor Mia,9995,0,9999,4
1746604719007,CSE 197,001,959846,Minnes Kemp; Mor Mia,9990,0,9999,9
1746604720035,CSS 201S,A01,892054,Mignozzetti; Umberto,25,0,30,5
1746604721067,CSS 202S,A01,892056,Mignozzetti; Umberto,25,0,30,5
1746604722095,DSC 197,001,956898,Eldridge; Justin Matthew,9996,0,9999,3
1746604723124,DSC 297,001,958000,Mazumdar; Arya,9998,0,9999,1
1746604723124,DSC 297,002,959862,Wang; Yusu,9998,0,9999,1
1746604724152,EAP 100,A00,905686,Staff,9778,0,9999,221
1746604725183,ECE 45,A01,892618,Staff,0,0,65,65
1746604727242,ECE 111,A01,892719,Staff,6,0,65,59
1746604728268,ECE 197,001,957920,Mercier; Patrick Philip,9991,0,9999,8
1746604729297,ECON 178,A01,907814,Zhu; Ying,26,0,35,9
1746604730322,EDS 115,A00,895312,Staff,35,0,45,10
1746604731348,EDS 117,A01,895337,Staff,23,0,30,7
1746604732378,EDS 125,A00,895341,Jones; Gabrielle Anastasia,36,0,45,9
1746604733410,EDS 128A,A01,895459,Fargason; Sharon Gayle,44,0,45,1
1746604734436,EDS 128B,A01,895543,Pappas; Elizabeth,44,0,45,1
1746604735462,EDS 139,A00,897203,Pappas; Elizabeth,44,0,45,1
1746604735462,EDS 139,B00,897209,Fargason; Sharon Gayle,41,0,45,4
1746604736489,EDS 201,A00,895545,Staff,22,0,45,23
1746604737514,EDS 203,A01,895581,Halter; Christopher P.,22,0,45,23
1746604738543,EDS 204R,A01,895625,Heinzman; Erica M.,39,0,45,6
1746604738543,EDS 204R,B01,895693,Halter; Christopher P.,10,0,45,35
1746604739572,EDS 206R,A00,895694,Fargason; Sharon Gayle,1,0,30,29
1746604739572,EDS 206R,B00,895695,Choi; Bailey Miyeon,16,0,30,14
1746604740602,EDS 250,A00,895697,Hemans; Patricia Ann Benitez,22,0,45,23
1746604741628,EDS 281,A00,895701,Meyerott; Theresa Ann,1,0,15,14
1746604742653,EDS 284,A00,895736,Meyerott; Theresa Ann,1,0,15,14
1746604743680,EDS 286,A00,897210,Fine; Sarah,0,0,15,15
1746604744710,EDS 289C,A01,895770,Daly; Alan J.,1,0,15,14
1746604745742,EDS 290,A00,897211,Hofstetter; Carolyn,0,0,15,15
1746604746770,LIGM 5A,A00,896162,Fischer-Grunski; Eva K,12,0,20,8
1746604747799,LIGM 5B,A00,896260,Fischer-Grunski; Eva K,17,0,20,3
1746604748826,LIGM 5C,A00,896308,Fischer-Grunski; Eva K,18,0,20,2
1746604749853,LIIT 5AS,A00,896313,Carnelos; Chiara,18,0,20,2
1746604750880,LIIT 5BS,A00,896416,Carnelos; Chiara,20,0,20,0
1746604751906,LIIT 5CS,A00,896564,Carnelos; Chiara,20,0,20,0
1746604752933,LISP 5A,A00,896588,Munoz Sanchez; Alicia,2,0,20,18
1746604753961,LISP 5B,A00,896653,Munoz Sanchez; Alicia,7,0,20,13
1746604755007,LISP 5C,A00,896655,Munoz Sanchez; Alicia,0,1,20,20
1746604756044,MAE 197,001,957918,Kleissl; Jan,9996,0,9999,3
1746604756044,MAE 197,002,959806,Boechler; Nicholas Sebastia,9998,0,9999,1
1746604756044,MAE 197,003,959852,Mullin; Jennifer S,9998,0,9999,1
1746604757071,MATH 2,A01,957937,Staff,33,0,35,2
1746604758104,MATH 197,001,957876,Kedlaya; Kiran S.,9993,0,9999,6
1746604759136,MCWP 40,A00,892729,Duru; Nur,10,0,20,10
1746604759136,MCWP 40,B00,893304,Montejo; Carolina,14,0,20,6
1746604760170,MCWP 40R,A00,893757,Redela; Pamela Morgan,0,5,20,20
1746604761205,MCWP 50,A00,893758,Morshed; Michael James,0,0,20,20
1746604761205,MCWP 50,B00,893761,Bartulis; Jason Michael,16,0,20,4
1746604762242,MCWP 50R,A00,893766,Compas; Sean Matthew,0,1,20,20
1746604762242,MCWP 50R,B00,893769,Carter; Jennifer A,0,1,20,20
1746604762242,MCWP 50R,C00,893771,Krone; Jarret,0,3,20,20
1746604762242,MCWP 50R,D00,893772,Miller; Elizabeth Deen,0,0,20,20
1746604762242,MCWP 50R,E00,893775,Carter; Andrea L,0,1,20,20
1746604763270,MMW 11R,A01,892721,Herbst; Matthew,14,0,30,16
1746604763270,MMW 11R,A02,892722,Herbst; Matthew,0,0,0,3
1746604764295,MMW 12R,A01,892724,Herbst; Matthew,0,11,16,16
1746604764295,MMW 12R,A02,892725,Herbst; Matthew,0,10,16,16
1746604765335,MMW 13R,A01,892727,Staff,0,4,16,16
1746604765335,MMW 13R,A02,892728,Staff,0,4,16,16
1746604765335,MMW 13R,A03,958032,Staff,0,4,16,16
1746604765335,MMW 13R,A04,958033,Staff,0,4,16,16
1746604765335,MMW 13R,A05,958034,Staff,0,4,16,16
1746604766368,SIO 295LS,A00,894015,Staff,5,0,25,20
1746604767401,SIO 295S,A00,894020,Staff,5,0,25,20
1746604768437,SIOC 290S,B01,958918,Merrifield; Mark A,14,0,30,16
1746604769466,SIOC 291S,B01,958922,Gabriel; Corey John,14,0,30,16
1746604770498,SOCI 117,A01,895339,Staff,2,0,5,3
1746604771533,WES 237B,A00,894149,Staff,11,0,20,9
1746604773709,AESE 279B,A00,891859,Staff,13,0,35,22
1746604774797,AIP 197,001,891854,Vespa; Emanuel Ignacio,9999,0,9999,0
1746604775834,ANTH 289S,A00,891856,Gagneux; Pascal,12,0,12,0
1746604776870,BENG 196,001,957946,Engler; Adam J.,9996,0,9999,3
1746604777897,BISP 197,001,959851,Wilhelm; James E.,9998,0,9999,1
1746604778928,CAT 124RS,A01,956906,Staff,6,0,25,19
1746604780026,CAT 125RS,A01,922013,Staff,6,0,25,19
1746604781053,CLRE 250,A00,891860,Morris; Sheldon,9995,0,9999,4
1746604783109,CLRE 251R,A00,907817,Mehta; Ravindra L.,9994,0,9999,5
1746604784134,CLRE 252,A00,891864,Cuomo; Raphael Eduardo,9993,0,9999,6
1746604785160,CLRE 253,A00,891867,Vaida; Florin,9994,0,9999,5
1746604785160,CLRE 253,B00,907819,Staff,9999,0,9999,0
1746604786240,CLRE 259,A00,891868,Patel; Hemal,9998,0,9999,1
1746604787267,CLRE 260,A00,891872,Cuomo; Raphael Eduardo,9999,0,9999,0
1746604788293,CLRE 297,001,891888,Cuomo; Raphael Eduardo,9999,0,9999,0
1746604789327,CSE 191,A00,958773,Minnes Kemp; Mor Mia,9995,0,9999,4
1746604790358,CSE 197,001,959846,Minnes Kemp; Mor Mia,9990,0,9999,9
1746604791388,CSS 201S,A01,892054,Mignozzetti; Umberto,25,0,30,5
1746604792430,CSS 202S,A01,892056,Mignozzetti; Umberto,25,0,30,5
1746604793462,DSC 197,001,956898,Eldridge; Justin Matthew,9996,0,9999,3
1746604794494,DSC 297,001,958000,Mazumdar; Arya,9998,0,9999,1
1746604794494,DSC 297,002,959862,Wang; Yusu,9998,0,9999,1
1746604795519,EAP 100,A00,905686,Staff,9778,0,9999,221
1746604796550,ECE 45,A01,892618,Staff,0,0,65,65
1746604798668,ECE 111,A01,892719,Staff,6,0,65,59
1746604799696,ECE 197,001,957920,Mercier; Patrick Philip,9991,0,9999,8
1746604800724,ECON 178,A01,907814,Zhu; Ying,26,0,35,9
1746604801752,EDS 115,A00,895312,Staff,35,0,45,10
1746604802779,EDS 117,A01,895337,Staff,23,0,30,7
1746604803811,EDS 125,A00,895341,Jones; Gabrielle Anastasia,36,0,45,9
1746604804843,EDS 128A,A01,895459,Fargason; Sharon Gayle,44,0,45,1
1746604805875,EDS 128B,A01,895543,Pappas; Elizabeth,44,0,45,1
1746604806900,EDS 139,A00,897203,Pappas; Elizabeth,44,0,45,1
1746604806900,EDS 139,B00,897209,Fargason; Sharon Gayle,41,0,45,4
1746604807931,EDS 201,A00,895545,Staff,22,0,45,23
1746604808960,EDS 203,A01,895581,Halter; Christopher P.,22,0,45,23
1746604809988,EDS 204R,A01,895625,Heinzman; Erica M.,39,0,45,6
1746604809988,EDS 204R,B01,895693,Halter; Christopher P.,10,0,45,35
1746604811018,EDS 206R,A00,895694,Fargason; Sharon Gayle,1,0,30,29
1746604811018,EDS 206R,B00,895695,Choi; Bailey Miyeon,16,0,30,14
1746604812044,EDS 250,A00,895697,Hemans; Patricia Ann Benitez,22,0,45,23
1746604813076,EDS 281,A00,895701,Meyerott; Theresa Ann,1,0,15,14
1746604814109,EDS 284,A00,895736,Meyerott; Theresa Ann,1,0,15,14
1746604815137,EDS 286,A00,897210,Fine; Sarah,0,0,15,15
1746604816166,EDS 289C,A01,895770,Daly; Alan J.,1,0,15,14
1746604817197,EDS 290,A00,897211,Hofstetter; Carolyn,0,0,15,15
1746604818249,LIGM 5A,A00,896162,Fischer-Grunski; Eva K,12,0,20,8
1746604819286,LIGM 5B,A00,896260,Fischer-Grunski; Eva K,17,0,20,3
1746604820312,LIGM 5C,A00,896308,Fischer-Grunski; Eva K,18,0,20,2
1746604822356,LIIT 5AS,A00,896313,Carnelos; Chiara,18,0,20,2
1746604823386,LIIT 5BS,A00,896416,Carnelos; Chiara,20,0,20,0
1746604824413,LIIT 5CS,A00,896564,Carnelos; Chiara,20,0,20,0
1746604825441,LISP 5A,A00,896588,Munoz Sanchez; Alicia,2,0,20,18
1746604826474,LISP 5B,A00,896653,Munoz Sanchez; Alicia,7,0,20,13
1746604827502,LISP 5C,A00,896655,Munoz Sanchez; Alicia,0,1,20,20
1746604828533,MAE 197,001,957918,Kleissl; Jan,9996,0,9999,3
1746604828533,MAE 197,002,959806,Boechler; Nicholas Sebastia,9998,0,9999,1
1746604828533,MAE 197,003,959852,Mullin; Jennifer S,9998,0,9999,1
1746604829562,MATH 2,A01,957937,Staff,33,0,35,2
1746604830589,MATH 197,001,957876,Kedlaya; Kiran S.,9993,0,9999,6
1746604831619,MCWP 40,A00,892729,Duru; Nur,10,0,20,10
1746604831619,MCWP 40,B00,893304,Montejo; Carolina,14,0,20,6
1746604832650,MCWP 40R,A00,893757,Redela; Pamela Morgan,0,5,20,20
1746604833677,MCWP 50,A00,893758,Morshed; Michael James,0,0,20,20
1746604833677,MCWP 50,B00,893761,Bartulis; Jason Michael,16,0,20,4
1746604834707,MCWP 50R,A00,893766,Compas; Sean Matthew,0,1,20,20
1746604834707,MCWP 50R,B00,893769,Carter; Jennifer A,0,1,20,20
1746604834707,MCWP 50R,C00,893771,Krone; Jarret,0,3,20,20
1746604834707,MCWP 50R,D00,893772,Miller; Elizabeth Deen,0,0,20,20
1746604834707,MCWP 50R,E00,893775,Carter; Andrea L,0,1,20,20
1746604835740,MMW 11R,A01,892721,Herbst; Matthew,14,0,30,16
1746604835740,MMW 11R,A02,892722,Herbst; Matthew,0,0,0,3
1746604836766,MMW 12R,A01,892724,Herbst; Matthew,0,11,16,16
1746604836766,MMW 12R,A02,892725,Herbst; Matthew,0,10,16,16
1746604837794,MMW 13R,A01,892727,Staff,0,4,16,16
1746604837794,MMW 13R,A02,892728,Staff,0,4,16,16
1746604837794,MMW 13R,A03,958032,Staff,0,4,16,16
1746604837794,MMW 13R,A04,958033,Staff,0,4,16,16
1746604837794,MMW 13R,A05,958034,Staff,0,4,16,16
1746604838823,SIO 295LS,A00,894015,Staff,5,0,25,20
1746604839850,SIO 295S,A00,894020,Staff,5,0,25,20
1746604840888,SIOC 290S,B01,958918,Merrifield; Mark A,14,0,30,16
1746604841927,SIOC 291S,B01,958922,Gabriel; Corey John,14,0,30,16
1746604842954,SOCI 117,A01,895339,Staff,2,0,5,3
1746604843983,WES 237B,A00,894149,Staff,11,0,20,9
1746604846173,AESE 279B,A00,891859,Staff,13,0,35,22
1746604847200,AIP 197,001,891854,Vespa; Emanuel Ignacio,9999,0,9999,0
1746604848226,ANTH 289S,A00,891856,Gagneux; Pascal,12,0,12,0
1746604849295,BENG 196,001,957946,Engler; Adam J.,9996,0,9999,3
1746604850322,BISP 197,001,959851,Wilhelm; James E.,9998,0,9999,1
1746604851349,CAT 124RS,A01,956906,Staff,6,0,25,19
1746604852379,CAT 125RS,A01,922013,Staff,6,0,25,19
1746604853410,CLRE 250,A00,891860,Morris; Sheldon,9995,0,9999,4
1746604855469,CLRE 251R,A00,907817,Mehta; Ravindra L.,9994,0,9999,5
1746604856501,CLRE 252,A00,891864,Cuomo; Raphael Eduardo,9993,0,9999,6
1746604857532,CLRE 253,A00,891867,Vaida; Florin,9994,0,9999,5
1746604857532,CLRE 253,B00,907819,Staff,9999,0,9999,0
1746604858558,CLRE 259,A00,891868,Patel; Hemal,9998,0,9999,1
1746604859586,CLRE 260,A00,891872,Cuomo; Raphael Eduardo,9999,0,9999,0
1746604860625,CLRE 297,001,891888,Cuomo; Raphael Eduardo,9999,0,9999,0
1746604861662,CSE 191,A00,958773,Minnes Kemp; Mor Mia,9995,0,9999,4
1746604862693,CSE 197,001,959846,Minnes Kemp; Mor Mia,9990,0,9999,9
1746604863721,CSS 201S,A01,892054,Mignozzetti; Umberto,25,0,30,5
1746604864787,CSS 202S,A01,892056,Mignozzetti; Umberto,25,0,30,5
1746604865819,DSC 197,001,956898,Eldridge; Justin Matthew,9996,0,9999,3
1746604866852,DSC 297,001,958000,Mazumdar; Arya,9998,0,9999,1
1746604866852,DSC 297,002,959862,Wang; Yusu,9998,0,9999,1
1746604867879,EAP 100,A00,905686,Staff,9778,0,9999,221
1746604868915,ECE 45,A01,892618,Staff,0,0,65,65
1746604870980,ECE 111,A01,892719,Staff,6,0,65,59
1746604872020,ECE 197,001,957920,Mercier; Patrick Philip,9991,0,9999,8
1746604873048,ECON 178,A01,907814,Zhu; Ying,26,0,35,9
1746604874082,EDS 115,A00,895312,Staff,35,0,45,10
1746604875117,EDS 117,A01,895337,Staff,23,0,30,7
1746604876143,EDS 125,A00,895341,Jones; Gabrielle Anastasia,36,0,45,9
1746604877174,EDS 128A,A01,895459,Fargason; Sharon Gayle,44,0,45,1
1746604878205,EDS 128B,A01,895543,Pappas; Elizabeth,44,0,45,1
1746604879240,EDS 139,A00,897203,Pappas; Elizabeth,44,0,45,1
1746604879240,EDS 139,B00,897209,Fargason; Sharon Gayle,41,0,45,4
1746604880270,EDS 201,A00,895545,Staff,22,0,45,23
1746604881296,EDS 203,A01,895581,Halter; Christopher P.,22,0,45,23
1746604882329,EDS 204R,A01,895625,Heinzman; Erica M.,39,0,45,6
1746604882329,EDS 204R,B01,895693,Halter; Christopher P.,10,0,45,35
1746604883360,EDS 206R,A00,895694,Fargason; Sharon Gayle,1,0,30,29
1746604883360,EDS 206R,B00,895695,Choi; Bailey Miyeon,16,0,30,14
1746604884405,EDS 250,A00,895697,Hemans; Patricia Ann Benitez,22,0,45,23
1746604885437,EDS 281,A00,895701,Meyerott; Theresa Ann,1,0,15,14
1746604886462,EDS 284,A00,895736,Meyerott; Theresa Ann,1,0,15,14
1746604887490,EDS 286,A00,897210,Fine; Sarah,0,0,15,15
1746604888624,EDS 289C,A01,895770,Daly; Alan J.,1,0,15,14
1746604889652,EDS 290,A00,897211,Hofstetter; Carolyn,0,0,15,15
1746604890688,LIGM 5A,A00,896162,Fischer-Grunski; Eva K,12,0,20,8
1746604891745,LIGM 5B,A00,896260,Fischer-Grunski; Eva K,17,0,20,3
1746604892795,LIGM 5C,A00,896308,Fischer-Grunski; Eva K,18,0,20,2
1746604893830,LIIT 5AS,A00,896313,Carnelos; Chiara,18,0,20,2
1746604894861,LIIT 5BS,A00,896416,Carnelos; Chiara,20,0,20,0
1746604895888,LIIT 5CS,A00,896564,Carnelos; Chiara,20,0,20,0
1746604896914,LISP 5A,A00,896588,Munoz Sanchez; Alicia,2,0,20,18
1746604897943,LISP 5B,A00,896653,Munoz Sanchez; Alicia,7,0,20,13
1746604898974,LISP 5C,A00,896655,Munoz Sanchez; Alicia,0,1,20,20
1746604900003,MAE 197,001,957918,Kleissl; Jan,9996,0,9999,3
1746604900003,MAE 197,002,959806,Boechler; Nicholas Sebastia,9998,0,9999,1
1746604900003,MAE 197,003,959852,Mullin; Jennifer S,9998,0,9999,1
1746604901036,MATH 2,A01,957937,Staff,33,0,35,2
1746604902061,MATH 197,001,957876,Kedlaya; Kiran S.,9993,0,9999,6
1746604903091,MCWP 40,A00,892729,Duru; Nur,10,0,20,10
1746604903091,MCWP 40,B00,893304,Montejo; Carolina,14,0,20,6
1746604904122,MCWP 40R,A00,893757,Redela; Pamela Morgan,0,5,20,20
1746604905149,MCWP 50,A00,893758,Morshed; Michael James,0,0,20,20
1746604905149,MCWP 50,B00,893761,Bartulis; Jason Michael,16,0,20,4
1746604906186,MCWP 50R,A00,893766,Compas; Sean Matthew,0,1,20,20
1746604906186,MCWP 50R,B00,893769,Carter; Jennifer A,0,1,20,20
1746604906186,MCWP 50R,C00,893771,Krone; Jarret,0,3,20,20
1746604906186,MCWP 50R,D00,893772,Miller; Elizabeth Deen,0,0,20,20
1746604906186,MCWP 50R,E00,893775,Carter; Andrea L,0,1,20,20
1746604907218,MMW 11R,A01,892721,Herbst; Matthew,14,0,30,16
1746604907218,MMW 11R,A02,892722,Herbst; Matthew,0,0,0,3
1746604908244,MMW 12R,A01,892724,Herbst; Matthew,0,11,16,16
1746604908244,MMW 12R,A02,892725,Herbst; Matthew,0,10,16,16
1746604909273,MMW 13R,A01,892727,Staff,0,4,16,16
1746604909273,MMW 13R,A02,892728,Staff,0,4,16,16
1746604909273,MMW 13R,A03,958032,Staff,0,4,16,16
1746604909273,MMW 13R,A04,958033,Staff,0,4,16,16
1746604909273,MMW 13R,A05,958034,Staff,0,4,16,16
1746604910301,SIO 295LS,A00,894015,Staff,5,0,25,20
1746604911331,SIO 295S,A00,894020,Staff,5,0,25,20
1746604912370,SIOC 290S,B01,958918,Merrifield; Mark A,14,0,30,16
1746604913404,SIOC 291S,B01,958922,Gabriel; Corey John,14,0,30,16
1746604914437,SOCI 117,A01,895339,Staff,2,0,5,3
1746604915467,WES 237B,A00,894149,Staff,11,0,20,9
1746604917564,AESE 279B,A00,891859,Staff,13,0,35,22
1746604918592,AIP 197,001,891854,Vespa; Emanuel Ignacio,9999,0,9999,0
1746604919624,ANTH 289S,A00,891856,Gagneux; Pascal,12,0,12,0
1746604920655,BENG 196,001,957946,Engler; Adam J.,9996,0,9999,3
1746604921687,BISP 197,001,959851,Wilhelm; James E.,9998,0,9999,1
1746604922715,CAT 124RS,A01,956906,Staff,6,0,25,19
1746604923741,CAT 125RS,A01,922013,Staff,6,0,25,19
1746604924778,CLRE 250,A00,891860,Morris; Sheldon,9995,0,9999,4
1746604926832,CLRE 251R,A00,907817,Mehta; Ravindra L.,9994,0,9999,5
1746604927861,CLRE 252,A00,891864,Cuomo; Raphael Eduardo,9993,0,9999,6
1746604928889,CLRE 253,A00,891867,Vaida; Florin,9994,0,9999,5
1746604928889,CLRE 253,B00,907819,Staff,9999,0,9999,0
1746604929919,CLRE 259,A00,891868,Patel; Hemal,9998,0,9999,1
1746604930946,CLRE 260,A00,891872,Cuomo; Raphael Eduardo,9999,0,9999,0
1746604931980,CLRE 297,001,891888,Cuomo; Raphael Eduardo,9999,0,9999,0
1746604933011,CSE 191,A00,958773,Minnes Kemp; Mor Mia,9995,0,9999,4
1746604934040,CSE 197,001,959846,Minnes Kemp; Mor Mia,9990,0,9999,9
1746604935070,CSS 201S,A01,892054,Mignozzetti; Umberto,25,0,30,5
1746604936098,CSS 202S,A01,892056,Mignozzetti; Umberto,25,0,30,5
1746604937127,DSC 197,001,956898,Eldridge; Justin Matthew,9996,0,9999,3
1746604938167,DSC 297,001,958000,Mazumdar; Arya,9998,0,9999,1
1746604938167,DSC 297,002,959862,Wang; Yusu,9998,0,9999,1
1746604939193,EAP 100,A00,905686,Staff,9778,0,9999,221
1746604940220,ECE 45,A01,892618,Staff,0,0,65,65
1746604942281,ECE 111,A01,892719,Staff,6,0,65,59
1746604943310,ECE 197,001,957920,Mercier; Patrick Philip,9991,0,9999,8
1746604944346,ECON 178,A01,907814,Zhu; Ying,26,0,35,9
1746604945377,EDS 115,A00,895312,Staff,35,0,45,10
1746604946409,EDS 117,A01,895337,Staff,23,0,30,7
1746604947436,EDS 125,A00,895341,Jones; Gabrielle Anastasia,36,0,45,9
1746604948468,EDS 128A,A01,895459,Fargason; Sharon Gayle,44,0,45,1
1746604949497,EDS 128B,A01,895543,Pappas; Elizabeth,44,0,45,1
1746604950523,EDS 139,A00,897203,Pappas; Elizabeth,44,0,45,1
1746604950523,EDS 139,B00,897209,Fargason; Sharon Gayle,41,0,45,4
1746604951552,EDS 201,A00,895545,Staff,22,0,45,23
1746604952583,EDS 203,A01,895581,Halter; Christopher P.,22,0,45,23
1746604953616,EDS 204R,A01,895625,Heinzman; Erica M.,39,0,45,6
1746604953616,EDS 204R,B01,895693,Halter; Christopher P.,10,0,45,35
1746604954641,EDS 206R,A00,895694,Fargason; Sharon Gayle,1,0,30,29
1746604954641,EDS 206R,B00,895695,Choi; Bailey Miyeon,16,0,30,14
1746604955674,EDS 250,A00,895697,Hemans; Patricia Ann Benitez,22,0,45,23
1746604956700,EDS 281,A00,895701,Meyerott; Theresa Ann,1,0,15,14
1746604957731,EDS 284,A00,895736,Meyerott; Theresa Ann,1,0,15,14
1746604958759,EDS 286,A00,897210,Fine; Sarah,0,0,15,15
1746604959786,EDS 289C,A01,895770,Daly; Alan J.,1,0,15,14
1746604960816,EDS 290,A00,897211,Hofstetter; Carolyn,0,0,15,15
1746604961845,LIGM 5A,A00,896162,Fischer-Grunski; Eva K,12,0,20,8
1746604962878,LIGM 5B,A00,896260,Fischer-Grunski; Eva K,17,0,20,3
1746604963904,LIGM 5C,A00,896308,Fischer-Grunski; Eva K,18,0,20,2
1746604964934,LIIT 5AS,A00,896313,Carnelos; Chiara,18,0,20,2
1746604965961,LIIT 5BS,A00,896416,Carnelos; Chiara,20,0,20,0
1746604966987,LIIT 5CS,A00,896564,Carnelos; Chiara,20,0,20,0
1746604968019,LISP 5A,A00,896588,Munoz Sanchez; Alicia,2,0,20,18
1746604969085,LISP 5B,A00,896653,Munoz Sanchez; Alicia,7,0,20,13
1746604970111,LISP 5C,A00,896655,Munoz Sanchez; Alicia,0,1,20,20
1746604971139,MAE 197,001,957918,Kleissl; Jan,9996,0,9999,3
1746604971139,MAE 197,002,959806,Boechler; Nicholas Sebastia,9998,0,9999,1
1746604971139,MAE 197,003,959852,Mullin; Jennifer S,9998,0,9999,1
1746604972170,MATH 2,A01,957937,Staff,33,0,35,2
1746604973198,MATH 197,001,957876,Kedlaya; Kiran S.,9993,0,9999,6
1746604974225,MCWP 40,A00,892729,Duru; Nur,10,0,20,10
1746604974225,MCWP 40,B00,893304,Montejo; Carolina,14,0,20,6
1746604975256,MCWP 40R,A00,893757,Redela; Pamela Morgan,0,5,20,20
1746604976283,MCWP 50,A00,893758,Morshed; Michael James,0,0,20,20
1746604976283,MCWP 50,B00,893761,Bartulis; Jason Michael,16,0,20,4
1746604977319,MCWP 50R,A00,893766,Compas; Sean Matthew,0,1,20,20
1746604977319,MCWP 50R,B00,893769,Carter; Jennifer A,0,1,20,20
1746604977319,MCWP 50R,C00,893771,Krone; Jarret,0,3,20,20
1746604977319,MCWP 50R,D00,893772,Miller; Elizabeth Deen,0,0,20,20
1746604977319,MCWP 50R,E00,893775,Carter; Andrea L,0,1,20,20
1746604978356,MMW 11R,A01,892721,Herbst; Matthew,14,0,30,16
1746604978356,MMW 11R,A02,892722,Herbst; Matthew,0,0,0,3
1746604979411,MMW 12R,A01,892724,Herbst; Matthew,0,11,16,16
1746604979411,MMW 12R,A02,892725,Herbst; Matthew,0,10,16,16
1746604980440,MMW 13R,A01,892727,Staff,0,4,16,16
1746604980440,MMW 13R,A02,892728,Staff,0,4,16,16
1746604980440,MMW 13R,A03,958032,Staff,0,4,16,16
1746604980440,MMW 13R,A04,958033,Staff,0,4,16,16
1746604980440,MMW 13R,A05,958034,Staff,0,4,16,16
1746604981470,SIO 295LS,A00,894015,Staff,5,0,25,20
1746604982495,SIO 295S,A00,894020,Staff,5,0,25,20
1746604983524,SIOC 290S,B01,958918,Merrifield; Mark A,14,0,30,16
1746604984551,SIOC 291S,B01,958922,Gabriel; Corey John,14,0,30,16
1746604985585,SOCI 117,A01,895339,Staff,2,0,5,3
1746604986610,WES 237B,A00,894149,Staff,11,0,20,9
1746604988731,AESE 279B,A00,891859,Staff,13,0,35,22
1746604989766,AIP 197,001,891854,Vespa; Emanuel Ignacio,9999,0,9999,0
1746604990798,ANTH 289S,A00,891856,Gagneux; Pascal,12,0,12,0
1746604991826,BENG 196,001,957946,Engler; Adam J.,9996,0,9999,3
1746604992858,BISP 197,001,959851,Wilhelm; James E.,9998,0,9999,1
1746604993884,CAT 124RS,A01,956906,Staff,6,0,25,19
1746604994914,CAT 125RS,A01,922013,Staff,6,0,25,19
1746604995942,CLRE 250,A00,891860,Morris; Sheldon,9995,0,9999,4
1746604998008,CLRE 251R,A00,907817,Mehta; Ravindra L.,9994,0,9999,5
1746604999035,CLRE 252,A00,891864,Cuomo; Raphael Eduardo,9993,0,9999,6
1746605000072,CLRE 253,A00,891867,Vaida; Florin,9994,0,9999,5
1746605000072,CLRE 253,B00,907819,Staff,9999,0,9999,0
1746605001101,CLRE 259,A00,891868,Patel; Hemal,9998,0,9999,1
1746605002134,CLRE 260,A00,891872,Cuomo; Raphael Eduardo,9999,0,9999,0
1746605003162,CLRE 297,001,891888,Cuomo; Raphael Eduardo,9999,0,9999,0
1746605004189,CSE 191,A00,958773,Minnes Kemp; Mor Mia,9995,0,9999,4
1746605005217,CSE 197,001,959846,Minnes Kemp; Mor Mia,9990,0,9999,9
1746605006247,CSS 201S,A01,892054,Mignozzetti; Umberto,25,0,30,5
1746605007274,CSS 202S,A01,892056,Mignozzetti; Umberto,25,0,30,5
1746605008306,DSC 197,001,956898,Eldridge; Justin Matthew,9996,0,9999,3
1746605009334,DSC 297,001,958000,Mazumdar; Arya,9998,0,9999,1
1746605009334,DSC 297,002,959862,Wang; Yusu,9998,0,9999,1
1746605010364,EAP 100,A00,905686,Staff,9778,0,9999,221
1746605011397,ECE 45,A01,892618,Staff,0,0,65,65
1746605013454,ECE 111,A01,892719,Staff,6,0,65,59
1746605014480,ECE 197,001,957920,Mercier; Patrick Philip,9991,0,9999,8
1746605015507,ECON 178,A01,907814,Zhu; Ying,26,0,35,9
1746605016537,EDS 115,A00,895312,Staff,35,0,45,10
1746605017563,EDS 117,A01,895337,Staff,23,0,30,7
1746605018589,EDS 125,A00,895341,Jones; Gabrielle Anastasia,36,0,45,9
1746605019621,EDS 128A,A01,895459,Fargason; Sharon Gayle,44,0,45,1
1746605020645,EDS 128B,A01,895543,Pappas; Elizabeth,44,0,45,1
1746605021678,EDS 139,A00,897203,Pappas; Elizabeth,44,0,45,1
1746605021678,EDS 139,B00,897209,Fargason; Sharon Gayle,41,0,45,4
1746605022705,EDS 201,A00,895545,Staff,22,0,45,23
1746605023735,EDS 203,A01,895581,Halter; Christopher P.,22,0,45,23
1746605024762,EDS 204R,A01,895625,Heinzman; Erica M.,39,0,45,6
1746605024762,EDS 204R,B01,895693,Halter; Christopher P.,10,0,45,35
1746605025793,EDS 206R,A00,895694,Fargason; Sharon Gayle,1,0,30,29
1746605025793,EDS 206R,B00,895695,Choi; Bailey Miyeon,16,0,30,14
1746605026820,EDS 250,A00,895697,Hemans; Patricia Ann Benitez,22,0,45,23
1746605027846,EDS 281,A00,895701,Meyerott; Theresa Ann,1,0,15,14
1746605028882,EDS 284,A00,895736,Meyerott; Theresa Ann,1,0,15,14
1746605029910,EDS 286,A00,897210,Fine; Sarah,0,0,15,15
1746605030937,EDS 289C,A01,895770,Daly; Alan J.,1,0,15,14
1746605031966,EDS 290,A00,897211,Hofstetter; Carolyn,0,0,15,15
1746605032993,LIGM 5A,A00,896162,Fischer-Grunski; Eva K,12,0,20,8
1746605034020,LIGM 5B,A00,896260,Fischer-Grunski; Eva K,17,0,20,3
1746605035055,LIGM 5C,A00,896308,Fischer-Grunski; Eva K,18,0,20,2
1746605036128,LIIT 5AS,A00,896313,Carnelos; Chiara,18,0,20,2
1746605037160,LIIT 5BS,A00,896416,Carnelos; Chiara,20,0,20,0
1746605038186,LIIT 5CS,A00,896564,Carnelos; Chiara,20,0,20,0
1746605039226,LISP 5A,A00,896588,Munoz Sanchez; Alicia,2,0,20,18
1746605040263,LISP 5B,A00,896653,Munoz Sanchez; Alicia,7,0,20,13
1746605041291,LISP 5C,A00,896655,Munoz Sanchez; Alicia,0,1,20,20
1746605042349,MAE 197,001,957918,Kleissl; Jan,9996,0,9999,3
1746605042349,MAE 197,002,959806,Boechler; Nicholas Sebastia,9998,0,9999,1
1746605042349,MAE 197,003,959852,Mullin; Jennifer S,9998,0,9999,1
1746605043383,MATH 2,A01,957937,Staff,33,0,35,2
1746605044409,MATH 197,001,957876,Kedlaya; Kiran S.,9993,0,9999,6
1746605045446,MCWP 40,A00,892729,Duru; Nur,10,0,20,10
1746605045446,MCWP 40,B00,893304,Montejo; Carolina,14,0,20,6
1746605046476,MCWP 40R,A00,893757,Redela; Pamela Morgan,0,5,20,20
1746605047502,MCWP 50,A00,893758,Morshed; Michael James,0,0,20,20
1746605047502,MCWP 50,B00,893761,Bartulis; Jason Michael,16,0,20,4
1746605048540,MCWP 50R,A00,893766,Compas; Sean Matthew,0,1,20,20
1746605048540,MCWP 50R,B00,893769,Carter; Jennifer A,0,1,20,20
1746605048540,MCWP 50R,C00,893771,Krone; Jarret,0,3,20,20
1746605048540,MCWP 50R,D00,893772,Miller; Elizabeth Deen,0,0,20,20
1746605048540,MCWP 50R,E00,893775,Carter; Andrea L,0,1,20,20
1746605049566,MMW 11R,A01,892721,Herbst; Matthew,14,0,30,16
1746605049566,MMW 11R,A02,892722,Herbst; Matthew,0,0,0,3
1746605050599,MMW 12R,A01,892724,Herbst; Matthew,0,11,16,16
1746605050599,MMW 12R,A02,892725,Herbst; Matthew,0,10,16,16
1746605051634,MMW 13R,A01,892727,Staff,0,4,16,16
1746605051634,MMW 13R,A02,892728,Staff,0,4,16,16
1746605051634,MMW 13R,A03,958032,Staff,0,4,16,16
1746605051634,MMW 13R,A04,958033,Staff,0,4,16,16
1746605051634,MMW 13R,A05,958034,Staff,0,4,16,16
1746605052660,SIO 295LS,A00,894015,Staff,5,0,25,20
1746605053685,SIO 295S,A00,894020,Staff,5,0,25,20
1746605054722,SIOC 290S,B01,958918,Merrifield; Mark A,14,0,30,16
1746605055756,SIOC 291S,B01,958922,Gabriel; Corey John,14,0,30,16
1746605056783,SOCI 117,A01,895339,Staff,2,0,5,3
1746605057814,WES 237B,A00,894149,Staff,11,0,20,9
1746605059897,AESE 279B,A00,891859,Staff,13,0,35,22
1746605060927,AIP 197,001,891854,Vespa; Emanuel Ignacio,9999,0,9999,0
1746605061961,ANTH 289S,A00,891856,Gagneux; Pascal,12,0,12,0
1746605062987,BENG 196,001,957946,Engler; Adam J.,9996,0,9999,3
1746605064012,BISP 197,001,959851,Wilhelm; James E.,9998,0,9999,1
1746605065045,CAT 124RS,A01,956906,Staff,6,0,25,19
1746605066074,CAT 125RS,A01,922013,Staff,6,0,25,19
1746605067109,CLRE 250,A00,891860,Morris; Sheldon,9995,0,9999,4
1746605069165,CLRE 251R,A00,907817,Mehta; Ravindra L.,9994,0,9999,5
1746605070196,CLRE 252,A00,891864,Cuomo; Raphael Eduardo,9993,0,9999,6
1746605071228,CLRE 253,A00,891867,Vaida; Florin,9994,0,9999,5
1746605071228,CLRE 253,B00,907819,Staff,9999,0,9999,0
1746605072256,CLRE 259,A00,891868,Patel; Hemal,9998,0,9999,1
1746605073322,CLRE 260,A00,891872,Cuomo; Raphael Eduardo,9999,0,9999,0
1746605074347,CLRE 297,001,891888,Cuomo; Raphael Eduardo,9999,0,9999,0
1746605075375,CSE 191,A00,958773,Minnes Kemp; Mor Mia,9995,0,9999,4
1746605076403,CSE 197,001,959846,Minnes Kemp; Mor Mia,9990,0,9999,9
1746605077436,CSS 201S,A01,892054,Mignozzetti; Umberto,25,0,30,5
1746605078470,CSS 202S,A01,892056,Mignozzetti; Umberto,25,0,30,5
1746605079498,DSC 197,001,956898,Eldridge; Justin Matthew,9996,0,9999,3
1746605080528,DSC 297,001,958000,Mazumdar; Arya,9998,0,9999,1
1746605080528,DSC 297,002,959862,Wang; Yusu,9998,0,9999,1
1746605081555,EAP 100,A00,905686,Staff,9778,0,9999,221
1746605082585,ECE 45,A01,892618,Staff,0,0,65,65
1746605084642,ECE 111,A01,892719,Staff,6,0,65,59
1746605085677,ECE 197,001,957920,Mercier; Patrick Philip,9991,0,9999,8
1746605086707,ECON 178,A01,907814,Zhu; Ying,26,0,35,9
1746605087735,EDS 115,A00,895312,Staff,35,0,45,10
1746605088762,EDS 117,A01,895337,Staff,23,0,30,7
1746605089789,EDS 125,A00,895341,Jones; Gabrielle Anastasia,36,0,45,9
1746605090819,EDS 128A,A01,895459,Fargason; Sharon Gayle,44,0,45,1
1746605091854,EDS 128B,A01,895543,Pappas; Elizabeth,44,0,45,1
1746605092881,EDS 139,A00,897203,Pappas; Elizabeth,44,0,45,1
1746605092881,EDS 139,B00,897209,Fargason; Sharon Gayle,41,0,45,4
1746605093910,EDS 201,A00,895545,Staff,22,0,45,23
1746605094939,EDS 203,A01,895581,Halter; Christopher P.,22,0,45,23
1746605095967,EDS 204R,A01,895625,Heinzman; Erica M.,39,0,45,6
1746605095967,EDS 204R,B01,895693,Halter; Christopher P.,10,0,45,35
1746605096994,EDS 206R,A00,895694,Fargason; Sharon Gayle,1,0,30,29
1746605096994,EDS 206R,B00,895695,Choi; Bailey Miyeon,16,0,30,14
1746605098029,EDS 250,A00,895697,Hemans; Patricia Ann Benitez,22,0,45,23
1746605099055,EDS 281,A00,895701,Meyerott; Theresa Ann,1,0,15,14
1746605100083,EDS 284,A00,895736,Meyerott; Theresa Ann,1,0,15,14
1746605101113,EDS 286,A00,897210,Fine; Sarah,0,0,15,15
1746605102143,EDS 289C,A01,895770,Daly; Alan J.,1,0,15,14
1746605103169,EDS 290,A00,897211,Hofstetter; Carolyn,0,0,15,15
1746605104197,LIGM 5A,A00,896162,Fischer-Grunski; Eva K,12,0,20,8
1746605105224,LIGM 5B,A00,896260,Fischer-Grunski; Eva K,17,0,20,3
1746605106259,LIGM 5C,A00,896308,Fischer-Grunski; Eva K,18,0,20,2
1746605107293,LIIT 5AS,A00,896313,Carnelos; Chiara,18,0,20,2
1746605108321,LIIT 5BS,A00,896416,Carnelos; Chiara,20,0,20,0
1746605109347,LIIT 5CS,A00,896564,Carnelos; Chiara,20,0,20,0
1746605110380,LISP 5A,A00,896588,Munoz Sanchez; Alicia,2,0,20,18
1746605111411,LISP 5B,A00,896653,Munoz Sanchez; Alicia,7,0,20,13
1746605112439,LISP 5C,A00,896655,Munoz Sanchez; Alicia,0,1,20,20
1746605113473,MAE 197,001,957918,Kleissl; Jan,9996,0,9999,3
1746605113473,MAE 197,002,959806,Boechler; Nicholas Sebastia,9998,0,9999,1
1746605113473,MAE 197,003,959852,Mullin; Jennifer S,9998,0,9999,1
1746605114502,MATH 2,A01,957937,Staff,33,0,35,2
1746605115534,MATH 197,001,957876,Kedlaya; Kiran S.,9993,0,9999,6
1746605116562,MCWP 40,A00,892729,Duru; Nur,10,0,20,10
1746605116562,MCWP 40,B00,893304,Montejo; Carolina,14,0,20,6
1746605117589,MCWP 40R,A00,893757,Redela; Pamela Morgan,0,5,20,20
1746605118623,MCWP 50,A00,893758,Morshed; Michael James,0,0,20,20
1746605118623,MCWP 50,B00,893761,Bartulis; Jason Michael,16,0,20,4
1746605119652,MCWP 50R,A00,893766,Compas; Sean Matthew,0,1,20,20
1746605119652,MCWP 50R,B00,893769,Carter; Jennifer A,0,1,20,20
1746605119652,MCWP 50R,C00,893771,Krone; Jarret,0,3,20,20
1746605119652,MCWP 50R,D00,893772,Miller; Elizabeth Deen,0,0,20,20
1746605119652,MCWP 50R,E00,893775,Carter; Andrea L,0,1,20,20
1746605120689,MMW 11R,A01,892721,Herbst; Matthew,14,0,30,16
1746605120689,MMW 11R,A02,892722,Herbst; Matthew,0,0,0,3
1746605121718,MMW 12R,A01,892724,Herbst; Matthew,0,11,16,16
1746605121718,MMW 12R,A02,892725,Herbst; Matthew,0,10,16,16
1746605122744,MMW 13R,A01,892727,Staff,0,4,16,16
1746605122744,MMW 13R,A02,892728,Staff,0,4,16,16
1746605122744,MMW 13R,A03,958032,Staff,0,4,16,16
1746605122744,MMW 13R,A04,958033,Staff,0,4,16,16
1746605122744,MMW 13R,A05,958034,Staff,0,4,16,16
1746605123775,SIO 295LS,A00,894015,Staff,5,0,25,20
1746605124801,SIO 295S,A00,894020,Staff,5,0,25,20
1746605125830,SIOC 290S,B01,958918,Merrifield; Mark A,14,0,30,16
1746605126858,SIOC 291S,B01,958922,Gabriel; Corey John,14,0,30,16
1746605127891,SOCI 117,A01,895339,Staff,2,0,5,3
1746605128919,WES 237B,A00,894149,Staff,11,0,20,9
1746605131016,AESE 279B,A00,891859,Staff,13,0,35,22
1746605132045,AIP 197,001,891854,Vespa; Emanuel Ignacio,9999,0,9999,0
1746605133073,ANTH 289S,A00,891856,Gagneux; Pascal,12,0,12,0
1746605134099,BENG 196,001,957946,Engler; Adam J.,9996,0,9999,3
1746605135126,BISP 197,001,959851,Wilhelm; James E.,9998,0,9999,1
1746605136155,CAT 124RS,A01,956906,Staff,6,0,25,19
1746605137194,CAT 125RS,A01,922013,Staff,6,0,25,19
1746605138221,CLRE 250,A00,891860,Morris; Sheldon,9995,0,9999,4
1746605140276,CLRE 251R,A00,907817,Mehta; Ravindra L.,9994,0,9999,5
1746605141309,CLRE 252,A00,891864,Cuomo; Raphael Eduardo,9993,0,9999,6
1746605142337,CLRE 253,A00,891867,Vaida; Florin,9994,0,9999,5
1746605142337,CLRE 253,B00,907819,Staff,9999,0,9999,0
1746605143368,CLRE 259,A00,891868,Patel; Hemal,9998,0,9999,1
1746605144394,CLRE 260,A00,891872,Cuomo; Raphael Eduardo,9999,0,9999,0
1746605145421,CLRE 297,001,891888,Cuomo; Raphael Eduardo,9999,0,9999,0
1746605146448,CSE 191,A00,958773,Minnes Kemp; Mor Mia,9995,0,9999,4
1746605147479,CSE 197,001,959846,Minnes Kemp; Mor Mia,9990,0,9999,9
1746605148505,CSS 201S,A01,892054,Mignozzetti; Umberto,25,0,30,5
1746605149530,CSS 202S,A01,892056,Mignozzetti; Umberto,25,0,30,5
1746605150563,DSC 197,001,956898,Eldridge; Justin Matthew,9996,0,9999,3
1746605151602,DSC 297,001,958000,Mazumdar; Arya,9998,0,9999,1
1746605151602,DSC 297,002,959862,Wang; Yusu,9998,0,9999,1
1746605152636,EAP 100,A00,905686,Staff,9778,0,9999,221
1746605153698,ECE 45,A01,892618,Staff,0,0,65,65
1746605155755,ECE 111,A01,892719,Staff,6,0,65,59
1746605156781,ECE 197,001,957920,Mercier; Patrick Philip,9991,0,9999,8
1746605157809,ECON 178,A01,907814,Zhu; Ying,26,0,35,9
1746605158836,EDS 115,A00,895312,Staff,35,0,45,10
1746605159864,EDS 117,A01,895337,Staff,23,0,30,7
1746605160890,EDS 125,A00,895341,Jones; Gabrielle Anastasia,36,0,45,9
1746605161917,EDS 128A,A01,895459,Fargason; Sharon Gayle,44,0,45,1
1746605162947,EDS 128B,A01,895543,Pappas; Elizabeth,44,0,45,1
1746605163974,EDS 139,A00,897203,Pappas; Elizabeth,44,0,45,1
1746605163974,EDS 139,B00,897209,Fargason; Sharon Gayle,41,0,45,4
1746605165012,EDS 201,A00,895545,Staff,22,0,45,23
1746605166038,EDS 203,A01,895581,Halter; Christopher P.,22,0,45,23
1746605167070,EDS 204R,A01,895625,Heinzman; Erica M.,39,0,45,6
1746605167070,EDS 204R,B01,895693,Halter; Christopher P.,10,0,45,35
1746605168100,EDS 206R,A00,895694,Fargason; Sharon Gayle,1,0,30,29
1746605168100,EDS 206R,B00,895695,Choi; Bailey Miyeon,16,0,30,14
1746605169126,EDS 250,A00,895697,Hemans; Patricia Ann Benitez,22,0,45,23
1746605170156,EDS 281,A00,895701,Meyerott; Theresa Ann,1,0,15,14
1746605171187,EDS 284,A00,895736,Meyerott; Theresa Ann,1,0,15,14
1746605172213,EDS 286,A00,897210,Fine; Sarah,0,0,15,15
1746605173246,EDS 289C,A01,895770,Daly; Alan J.,1,0,15,14
1746605174276,EDS 290,A00,897211,Hofstetter; Carolyn,0,0,15,15
1746605175305,LIGM 5A,A00,896162,Fischer-Grunski; Eva K,12,0,20,8
1746605176332,LIGM 5B,A00,896260,Fischer-Grunski; Eva K,17,0,20,3
1746605177399,LIGM 5C,A00,896308,Fischer-Grunski; Eva K,18,0,20,2
1746605178433,LIIT 5AS,A00,896313,Carnelos; Chiara,18,0,20,2
1746605179462,LIIT 5BS,A00,896416,Carnelos; Chiara,20,0,20,0
1746605180495,LIIT 5CS,A00,896564,Carnelos; Chiara,20,0,20,0
1746605181523,LISP 5A,A00,896588,Munoz Sanchez; Alicia,2,0,20,18
1746605182551,LISP 5B,A00,896653,Munoz Sanchez; Alicia,7,0,20,13
1746605183581,LISP 5C,A00,896655,Munoz Sanchez; Alicia,0,1,20,20
1746605184610,MAE 197,001,957918,Kleissl; Jan,9996,0,9999,3
1746605184610,MAE 197,002,959806,Boechler; Nicholas Sebastia,9998,0,9999,1
1746605184610,MAE 197,003,959852,Mullin; Jennifer S,9998,0,9999,1
1746605185636,MATH 2,A01,957937,Staff,33,0,35,2
1746605186666,MATH 197,001,957876,Kedlaya; Kiran S.,9993,0,9999,6
1746605187700,MCWP 40,A00,892729,Duru; Nur,10,0,20,10
1746605187700,MCWP 40,B00,893304,Montejo; Carolina,14,0,20,6
1746605188729,MCWP 40R,A00,893757,Redela; Pamela Morgan,0,5,20,20
1746605189772,MCWP 50,A00,893758,Morshed; Michael James,0,0,20,20
1746605189772,MCWP 50,B00,893761,Bartulis; Jason Michael,16,0,20,4
1746605190809,MCWP 50R,A00,893766,Compas; Sean Matthew,0,1,20,20
1746605190809,MCWP 50R,B00,893769,Carter; Jennifer A,0,1,20,20
1746605190809,MCWP 50R,C00,893771,Krone; Jarret,0,3,20,20
1746605190809,MCWP 50R,D00,893772,Miller; Elizabeth Deen,0,0,20,20
1746605190809,MCWP 50R,E00,893775,Carter; Andrea L,0,1,20,20
1746605191845,MMW 11R,A01,892721,Herbst; Matthew,14,0,30,16
1746605191845,MMW 11R,A02,892722,Herbst; Matthew,0,0,0,3
1746605192874,MMW 12R,A01,892724,Herbst; Matthew,0,11,16,16
1746605192874,MMW 12R,A02,892725,Herbst; Matthew,0,10,16,16
1746605193910,MMW 13R,A01,892727,Staff,0,4,16,16
1746605193910,MMW 13R,A02,892728,Staff,0,4,16,16
1746605193910,MMW 13R,A03,958032,Staff,0,4,16,16
1746605193910,MMW 13R,A04,958033,Staff,0,4,16,16
1746605193910,MMW 13R,A05,958034,Staff,0,4,16,16
1746605194943,SIO 295LS,A00,894015,Staff,5,0,25,20
1746605195975,SIO 295S,A00,894020,Staff,5,0,25,20
1746605197005,SIOC 290S,B01,958918,Merrifield; Mark A,14,0,30,16
1746605198040,SIOC 291S,B01,958922,Gabriel; Corey John,14,0,30,16
1746605199068,SOCI 117,A01,895339,Staff,2,0,5,3
1746605200096,WES 237B,A00,894149,Staff,11,0,20,9
1746605202185,AESE 279B,A00,891859,Staff,13,0,35,22
1746605203221,AIP 197,001,891854,Vespa; Emanuel Ignacio,9999,0,9999,0
1746605204255,ANTH 289S,A00,891856,Gagneux; Pascal,12,0,12,0
1746605205282,BENG 196,001,957946,Engler; Adam J.,9996,0,9999,3
1746605206308,BISP 197,001,959851,Wilhelm; James E.,9998,0,9999,1
1746605207334,CAT 124RS,A01,956906,Staff,6,0,25,19
1746605208371,CAT 125RS,A01,922013,Staff,6,0,25,19
1746605209404,CLRE 250,A00,891860,Morris; Sheldon,9995,0,9999,4
1746605211467,CLRE 251R,A00,907817,Mehta; Ravindra L.,9994,0,9999,5
1746605212497,CLRE 252,A00,891864,Cuomo; Raphael Eduardo,9993,0,9999,6
1746605213523,CLRE 253,A00,891867,Vaida; Florin,9994,0,9999,5
1746605213523,CLRE 253,B00,907819,Staff,9999,0,9999,0
1746605214554,CLRE 259,A00,891868,Patel; Hemal,9998,0,9999,1
1746605215588,CLRE 260,A00,891872,Cuomo; Raphael Eduardo,9999,0,9999,0
1746605216617,CLRE 297,001,891888,Cuomo; Raphael Eduardo,9999,0,9999,0
1746605217648,CSE 191,A00,958773,Minnes Kemp; Mor Mia,9995,0,9999,4
1746605218674,CSE 197,001,959846,Minnes Kemp; Mor Mia,9990,0,9999,9
1746605219709,CSS 201S,A01,892054,Mignozzetti; Umberto,25,0,30,5
1746605220736,CSS 202S,A01,892056,Mignozzetti; Umberto,25,0,30,5
1746605221770,DSC 197,001,956898,Eldridge; Justin Matthew,9996,0,9999,3
1746605222803,DSC 297,001,958000,Mazumdar; Arya,9998,0,9999,1
1746605222803,DSC 297,002,959862,Wang; Yusu,9998,0,9999,1
1746605223835,EAP 100,A00,905686,Staff,9778,0,9999,221
1746605224872,ECE 45,A01,892618,Staff,0,0,65,65
1746605226930,ECE 111,A01,892719,Staff,6,0,65,59
1746605227961,ECE 197,001,957920,Mercier; Patrick Philip,9991,0,9999,8
1746605228991,ECON 178,A01,907814,Zhu; Ying,26,0,35,9
1746605230022,EDS 115,A00,895312,Staff,35,0,45,10
1746605231055,EDS 117,A01,895337,Staff,23,0,30,7
1746605232081,EDS 125,A00,895341,Jones; Gabrielle Anastasia,36,0,45,9
1746605233108,EDS 128A,A01,895459,Fargason; Sharon Gayle,44,0,45,1
1746605234135,EDS 128B,A01,895543,Pappas; Elizabeth,44,0,45,1
1746605235166,EDS 139,A00,897203,Pappas; Elizabeth,44,0,45,1
1746605235166,EDS 139,B00,897209,Fargason; Sharon Gayle,41,0,45,4
1746605236197,EDS 201,A00,895545,Staff,22,0,45,23
1746605237222,EDS 203,A01,895581,Halter; Christopher P.,22,0,45,23
1746605238250,EDS 204R,A01,895625,Heinzman; Erica M.,39,0,45,6
1746605238250,EDS 204R,B01,895693,Halter; Christopher P.,10,0,45,35
1746605239276,EDS 206R,A00,895694,Fargason; Sharon Gayle,1,0,30,29
1746605239276,EDS 206R,B00,895695,Choi; Bailey Miyeon,16,0,30,14
1746605240306,EDS 250,A00,895697,Hemans; Patricia Ann Benitez,22,0,45,23
1746605241330,EDS 281,A00,895701,Meyerott; Theresa Ann,1,0,15,14
1746605242355,EDS 284,A00,895736,Meyerott; Theresa Ann,1,0,15,14
1746605243383,EDS 286,A00,897210,Fine; Sarah,0,0,15,15
1746605244410,EDS 289C,A01,895770,Daly; Alan J.,1,0,15,14
1746605245435,EDS 290,A00,897211,Hofstetter; Carolyn,0,0,15,15
1746605246467,LIGM 5A,A00,896162,Fischer-Grunski; Eva K,12,0,20,8
1746605247493,LIGM 5B,A00,896260,Fischer-Grunski; Eva K,17,0,20,3
1746605248520,LIGM 5C,A00,896308,Fischer-Grunski; Eva K,18,0,20,2
1746605249550,LIIT 5AS,A00,896313,Carnelos; Chiara,18,0,20,2
1746605250581,LIIT 5BS,A00,896416,Carnelos; Chiara,20,0,20,0
1746605251607,LIIT 5CS,A00,896564,Carnelos; Chiara,20,0,20,0
1746605252635,LISP 5A,A00,896588,Munoz Sanchez; Alicia,2,0,20,18
1746605253664,LISP 5B,A00,896653,Munoz Sanchez; Alicia,7,0,20,13
1746605254694,LISP 5C,A00,896655,Munoz Sanchez; Alicia,0,1,20,20
1746605255727,MAE 197,001,957918,Kleissl; Jan,9996,0,9999,3
1746605255727,MAE 197,002,959806,Boechler; Nicholas Sebastia,9998,0,9999,1
1746605255727,MAE 197,003,959852,Mullin; Jennifer S,9998,0,9999,1
1746605256758,MATH 2,A01,957937,Staff,33,0,35,2
1746605257789,MATH 197,001,957876,Kedlaya; Kiran S.,9993,0,9999,6
1746605258825,MCWP 40,A00,892729,Duru; Nur,10,0,20,10
1746605258825,MCWP 40,B00,893304,Montejo; Carolina,14,0,20,6
1746605259853,MCWP 40R,A00,893757,Redela; Pamela Morgan,0,5,20,20
1746605260887,MCWP 50,A00,893758,Morshed; Michael James,0,0,20,20
1746605260887,MCWP 50,B00,893761,Bartulis; Jason Michael,16,0,20,4
1746605261923,MCWP 50R,A00,893766,Compas; Sean Matthew,0,1,20,20
1746605261923,MCWP 50R,B00,893769,Carter; Jennifer A,0,1,20,20
1746605261923,MCWP 50R,C00,893771,Krone; Jarret,0,3,20,20
1746605261923,MCWP 50R,D00,893772,Miller; Elizabeth Deen,0,0,20,20
1746605261923,MCWP 50R,E00,893775,Carter; Andrea L,0,1,20,20
1746605262949,MMW 11R,A01,892721,Herbst; Matthew,14,0,30,16
1746605262949,MMW 11R,A02,892722,Herbst; Matthew,0,0,0,3
1746605263976,MMW 12R,A01,892724,Herbst; Matthew,0,11,16,16
1746605263976,MMW 12R,A02,892725,Herbst; Matthew,0,10,16,16
1746605265004,MMW 13R,A01,892727,Staff,0,4,16,16
1746605265004,MMW 13R,A02,892728,Staff,0,4,16,16
1746605265004,MMW 13R,A03,958032,Staff,0,4,16,16
1746605265004,MMW 13R,A04,958033,Staff,0,4,16,16
1746605265004,MMW 13R,A05,958034,Staff,0,4,16,16
1746605266033,SIO 295LS,A00,894015,Staff,5,0,25,20
1746605267064,SIO 295S,A00,894020,Staff,5,0,25,20
1746605268092,SIOC 290S,B01,958918,Merrifield; Mark A,14,0,30,16
1746605269127,SIOC 291S,B01,958922,Gabriel; Corey John,14,0,30,16
1746605270158,SOCI 117,A01,895339,Staff,2,0,5,3
1746605271185,WES 237B,A00,894149,Staff,11,0,20,9
1746605273267,AESE 279B,A00,891859,Staff,13,0,35,22
1746605274295,AIP 197,001,891854,Vespa; Emanuel Ignacio,9999,0,9999,0
1746605275320,ANTH 289S,A00,891856,Gagneux; Pascal,12,0,12,0
1746605276345,BENG 196,001,957946,Engler; Adam J.,9996,0,9999,3
1746605277372,BISP 197,001,959851,Wilhelm; James E.,9998,0,9999,1
1746605278397,CAT 124RS,A01,956906,Staff,6,0,25,19
1746605279425,CAT 125RS,A01,922013,Staff,6,0,25,19
1746605280452,CLRE 250,A00,891860,Morris; Sheldon,9995,0,9999,4
1746605282511,CLRE 251R,A00,907817,Mehta; Ravindra L.,9994,0,9999,5
1746605283538,CLRE 252,A00,891864,Cuomo; Raphael Eduardo,9993,0,9999,6
1746605284566,CLRE 253,A00,891867,Vaida; Florin,9994,0,9999,5
1746605284566,CLRE 253,B00,907819,Staff,9999,0,9999,0
1746605285594,CLRE 259,A00,891868,Patel; Hemal,9998,0,9999,1
1746605286624,CLRE 260,A00,891872,Cuomo; Raphael Eduardo,9999,0,9999,0
1746605287654,CLRE 297,001,891888,Cuomo; Raphael Eduardo,9999,0,9999,0
1746605288680,CSE 191,A00,958773,Minnes Kemp; Mor Mia,9995,0,9999,4
1746605289705,CSE 197,001,959846,Minnes Kemp; Mor Mia,9990,0,9999,9
1746605290733,CSS 201S,A01,892054,Mignozzetti; Umberto,25,0,30,5
1746605291759,CSS 202S,A01,892056,Mignozzetti; Umberto,25,0,30,5
1746605292790,DSC 197,001,956898,Eldridge; Justin Matthew,9996,0,9999,3
1746605293817,DSC 297,001,958000,Mazumdar; Arya,9998,0,9999,1
1746605293817,DSC 297,002,959862,Wang; Yusu,9998,0,9999,1
1746605294843,EAP 100,A00,905686,Staff,9778,0,9999,221
1746605295877,ECE 45,A01,892618,Staff,0,0,65,65
1746605297940,ECE 111,A01,892719,Staff,6,0,65,59
1746605298966,ECE 197,001,957920,Mercier; Patrick Philip,9991,0,9999,8
1746605300014,ECON 178,A01,907814,Zhu; Ying,26,0,35,9
1746605301044,EDS 115,A00,895312,Staff,35,0,45,10
1746605302072,EDS 117,A01,895337,Staff,23,0,30,7
1746605303103,EDS 125,A00,895341,Jones; Gabrielle Anastasia,36,0,45,9
1746605304131,EDS 128A,A01,895459,Fargason; Sharon Gayle,44,0,45,1
1746605305159,EDS 128B,A01,895543,Pappas; Elizabeth,44,0,45,1
1746605306186,EDS 139,A00,897203,Pappas; Elizabeth,44,0,45,1
1746605306186,EDS 139,B00,897209,Fargason; Sharon Gayle,41,0,45,4
1746605307211,EDS 201,A00,895545,Staff,22,0,45,23
1746605308240,EDS 203,A01,895581,Halter; Christopher P.,22,0,45,23
1746605309268,EDS 204R,A01,895625,Heinzman; Erica M.,39,0,45,6
1746605309268,EDS 204R,B01,895693,Halter; Christopher P.,10,0,45,35
1746605310296,EDS 206R,A00,895694,Fargason; Sharon Gayle,1,0,30,29
1746605310296,EDS 206R,B00,895695,Choi; Bailey Miyeon,16,0,30,14
1746605311323,EDS 250,A00,895697,Hemans; Patricia Ann Benitez,22,0,45,23
1746605312354,EDS 281,A00,895701,Meyerott; Theresa Ann,1,0,15,14
1746605313380,EDS 284,A00,895736,Meyerott; Theresa Ann,1,0,15,14
1746605314409,EDS 286,A00,897210,Fine; Sarah,0,0,15,15
1746605315439,EDS 289C,A01,895770,Daly; Alan J.,1,0,15,14
1746605316469,EDS 290,A00,897211,Hofstetter; Carolyn,0,0,15,15
1746605317497,LIGM 5A,A00,896162,Fischer-Grunski; Eva K,12,0,20,8
1746605318525,LIGM 5B,A00,896260,Fischer-Grunski; Eva K,17,0,20,3
1746605319552,LIGM 5C,A00,896308,Fischer-Grunski; Eva K,18,0,20,2
1746605320587,LIIT 5AS,A00,896313,Carnelos; Chiara,18,0,20,2
1746605321614,LIIT 5BS,A00,896416,Carnelos; Chiara,20,0,20,0
1746605322641,LIIT 5CS,A00,896564,Carnelos; Chiara,20,0,20,0
1746605323672,LISP 5A,A00,896588,Munoz Sanchez; Alicia,2,0,20,18
1746605324705,LISP 5B,A00,896653,Munoz Sanchez; Alicia,7,0,20,13
1746605325733,LISP 5C,A00,896655,Munoz Sanchez; Alicia,0,1,20,20
1746605326765,MAE 197,001,957918,Kleissl; Jan,9996,0,9999,3
1746605326765,MAE 197,002,959806,Boechler; Nicholas Sebastia,9998,0,9999,1
1746605326765,MAE 197,003,959852,Mullin; Jennifer S,9998,0,9999,1
1746605327792,MATH 2,A01,957937,Staff,33,0,35,2
1746605328823,MATH 197,001,957876,Kedlaya; Kiran S.,9993,0,9999,6
1746605329851,MCWP 40,A00,892729,Duru; Nur,10,0,20,10
1746605329851,MCWP 40,B00,893304,Montejo; Carolina,14,0,20,6
1746605330880,MCWP 40R,A00,893757,Redela; Pamela Morgan,0,5,20,20
1746605331910,MCWP 50,A00,893758,Morshed; Michael James,0,0,20,20
1746605331910,MCWP 50,B00,893761,Bartulis; Jason Michael,16,0,20,4
1746605332939,MCWP 50R,A00,893766,Compas; Sean Matthew,0,1,20,20
1746605332939,MCWP 50R,B00,893769,Carter; Jennifer A,0,1,20,20
1746605332939,MCWP 50R,C00,893771,Krone; Jarret,0,3,20,20
1746605332939,MCWP 50R,D00,893772,Miller; Elizabeth Deen,0,0,20,20
1746605332939,MCWP 50R,E00,893775,Carter; Andrea L,0,1,20,20
1746605333969,MMW 11R,A01,892721,Herbst; Matthew,14,0,30,16
1746605333969,MMW 11R,A02,892722,Herbst; Matthew,0,0,0,3
1746605335009,MMW 12R,A01,892724,Herbst; Matthew,0,11,16,16
1746605335009,MMW 12R,A02,892725,Herbst; Matthew,0,10,16,16
1746605336034,MMW 13R,A01,892727,Staff,0,4,16,16
1746605336034,MMW 13R,A02,892728,Staff,0,4,16,16
1746605336034,MMW 13R,A03,958032,Staff,0,4,16,16
1746605336034,MMW 13R,A04,958033,Staff,0,4,16,16
1746605336034,MMW 13R,A05,958034,Staff,0,4,16,16
1746605337064,SIO 295LS,A00,894015,Staff,5,0,25,20
1746605338094,SIO 295S,A00,894020,Staff,5,0,25,20
1746605339137,SIOC 290S,B01,958918,Merrifield; Mark A,14,0,30,16
1746605340169,SIOC 291S,B01,958922,Gabriel; Corey John,14,0,30,16
1746605341193,SOCI 117,A01,895339,Staff,2,0,5,3
1746605342220,WES 237B,A00,894149,Staff,11,0,20,9
1746605344289,AESE 279B,A00,891859,Staff,13,0,35,22
1746605345315,AIP 197,001,891854,Vespa; Emanuel Ignacio,9999,0,9999,0
1746605346342,ANTH 289S,A00,891856,Gagneux; Pascal,12,0,12,0
1746605347366,BENG 196,001,957946,Engler; Adam J.,9996,0,9999,3
1746605348395,BISP 197,001,959851,Wilhelm; James E.,9998,0,9999,1
1746605349425,CAT 124RS,A01,956906,Staff,6,0,25,19
1746605350452,CAT 125RS,A01,922013,Staff,6,0,25,19
1746605351485,CLRE 250,A00,891860,Morris; Sheldon,9995,0,9999,4
1746605353542,CLRE 251R,A00,907817,Mehta; Ravindra L.,9994,0,9999,5
1746605354568,CLRE 252,A00,891864,Cuomo; Raphael Eduardo,9993,0,9999,6
1746605355601,CLRE 253,A00,891867,Vaida; Florin,9994,0,9999,5
1746605355601,CLRE 253,B00,907819,Staff,9999,0,9999,0
1746605356627,CLRE 259,A00,891868,Patel; Hemal,9998,0,9999,1
1746605357659,CLRE 260,A00,891872,Cuomo; Raphael Eduardo,9999,0,9999,0
1746605358686,CLRE 297,001,891888,Cuomo; Raphael Eduardo,9999,0,9999,0
1746605359712,CSE 191,A00,958773,Minnes Kemp; Mor Mia,9995,0,9999,4
1746605360737,CSE 197,001,959846,Minnes Kemp; Mor Mia,9990,0,9999,9
1746605361766,CSS 201S,A01,892054,Mignozzetti; Umberto,25,0,30,5
1746605362793,CSS 202S,A01,892056,Mignozzetti; Umberto,25,0,30,5
1746605363819,DSC 197,001,956898,Eldridge; Justin Matthew,9996,0,9999,3
1746605364848,DSC 297,001,958000,Mazumdar; Arya,9998,0,9999,1
1746605364848,DSC 297,002,959862,Wang; Yusu,9998,0,9999,1
1746605365874,EAP 100,A00,905686,Staff,9778,0,9999,221
1746605366907,ECE 45,A01,892618,Staff,0,0,65,65
1746605368959,ECE 111,A01,892719,Staff,6,0,65,59
1746605369988,ECE 197,001,957920,Mercier; Patrick Philip,9991,0,9999,8
1746605371014,ECON 178,A01,907814,Zhu; Ying,26,0,35,9
1746605372040,EDS 115,A00,895312,Staff,35,0,45,10
1746605373069,EDS 117,A01,895337,Staff,23,0,30,7
1746605374094,EDS 125,A00,895341,Jones; Gabrielle Anastasia,36,0,45,9
1746605375120,EDS 128A,A01,895459,Fargason; Sharon Gayle,44,0,45,1
1746605376152,EDS 128B,A01,895543,Pappas; Elizabeth,44,0,45,1
1746605377179,EDS 139,A00,897203,Pappas; Elizabeth,44,0,45,1
1746605377179,EDS 139,B00,897209,Fargason; Sharon Gayle,41,0,45,4
1746605378207,EDS 201,A00,895545,Staff,22,0,45,23
1746605379239,EDS 203,A01,895581,Halter; Christopher P.,22,0,45,23
1746605380270,EDS 204R,A01,895625,Heinzman; Erica M.,39,0,45,6
1746605380270,EDS 204R,B01,895693,Halter; Christopher P.,10,0,45,35
1746605381297,EDS 206R,A00,895694,Fargason; Sharon Gayle,1,0,30,29
1746605381297,EDS 206R,B00,895695,Choi; Bailey Miyeon,16,0,30,14
1746605382324,EDS 250,A00,895697,Hemans; Patricia Ann Benitez,22,0,45,23
1746605383349,EDS 281,A00,895701,Meyerott; Theresa Ann,1,0,15,14
1746605384378,EDS 284,A00,895736,Meyerott; Theresa Ann,1,0,15,14
1746605385408,EDS 286,A00,897210,Fine; Sarah,0,0,15,15
1746605386436,EDS 289C,A01,895770,Daly; Alan J.,1,0,15,14
1746605387463,EDS 290,A00,897211,Hofstetter; Carolyn,0,0,15,15
1746605388492,LIGM 5A,A00,896162,Fischer-Grunski; Eva K,12,0,20,8
1746605389520,LIGM 5B,A00,896260,Fischer-Grunski; Eva K,17,0,20,3
1746605390546,LIGM 5C,A00,896308,Fischer-Grunski; Eva K,18,0,20,2
1746605391573,LIIT 5AS,A00,896313,Carnelos; Chiara,18,0,20,2
1746605392600,LIIT 5BS,A00,896416,Carnelos; Chiara,20,0,20,0
1746605393626,LIIT 5CS,A00,896564,Carnelos; Chiara,20,0,20,0
1746605394659,LISP 5A,A00,896588,Munoz Sanchez; Alicia,2,0,20,18
1746605395691,LISP 5B,A00,896653,Munoz Sanchez; Alicia,7,0,20,13
1746605396720,LISP 5C,A00,896655,Munoz Sanchez; Alicia,0,1,20,20
1746605397748,MAE 197,001,957918,Kleissl; Jan,9996,0,9999,3
1746605397748,MAE 197,002,959806,Boechler; Nicholas Sebastia,9998,0,9999,1
1746605397748,MAE 197,003,959852,Mullin; Jennifer S,9998,0,9999,1
1746605398774,MATH 2,A01,957937,Staff,33,0,35,2
1746605399800,MATH 197,001,957876,Kedlaya; Kiran S.,9993,0,9999,6
1746605400832,MCWP 40,A00,892729,Duru; Nur,10,0,20,10
1746605400832,MCWP 40,B00,893304,Montejo; Carolina,14,0,20,6
1746605401864,MCWP 40R,A00,893757,Redela; Pamela Morgan,0,5,20,20
1746605402896,MCWP 50,A00,893758,Morshed; Michael James,0,0,20,20
1746605402896,MCWP 50,B00,893761,Bartulis; Jason Michael,16,0,20,4
1746605403924,MCWP 50R,A00,893766,Compas; Sean Matthew,0,1,20,20
1746605403924,MCWP 50R,B00,893769,Carter; Jennifer A,0,1,20,20
1746605403924,MCWP 50R,C00,893771,Krone; Jarret,0,3,20,20
1746605403924,MCWP 50R,D00,893772,Miller; Elizabeth Deen,0,0,20,20
1746605403924,MCWP 50R,E00,893775,Carter; Andrea L,0,1,20,20
1746605404960,MMW 11R,A01,892721,Herbst; Matthew,14,0,30,16
1746605404960,MMW 11R,A02,892722,Herbst; Matthew,0,0,0,3
1746605405990,MMW 12R,A01,892724,Herbst; Matthew,0,11,16,16
1746605405990,MMW 12R,A02,892725,Herbst; Matthew,0,10,16,16
1746605407018,MMW 13R,A01,892727,Staff,0,4,16,16
1746605407018,MMW 13R,A02,892728,Staff,0,4,16,16
1746605407018,MMW 13R,A03,958032,Staff,0,4,16,16
1746605407018,MMW 13R,A04,958033,Staff,0,4,16,16
1746605407018,MMW 13R,A05,958034,Staff,0,4,16,16
1746605408050,SIO 295LS,A00,894015,Staff,5,0,25,20
1746605409076,SIO 295S,A00,894020,Staff,5,0,25,20
1746605410111,SIOC 290S,B01,958918,Merrifield; Mark A,14,0,30,16
1746605411139,SIOC 291S,B01,958922,Gabriel; Corey John,14,0,30,16
1746605412170,SOCI 117,A01,895339,Staff,2,0,5,3
1746605413196,WES 237B,A00,894149,Staff,11,0,20,9
1746605415287,AESE 279B,A00,891859,Staff,13,0,35,22
1746605416319,AIP 197,001,891854,Vespa; Emanuel Ignacio,9999,0,9999,0
1746605417345,ANTH 289S,A00,891856,Gagneux; Pascal,12,0,12,0
1746605418371,BENG 196,001,957946,Engler; Adam J.,9996,0,9999,3
1746605419396,BISP 197,001,959851,Wilhelm; James E.,9998,0,9999,1
1746605420423,CAT 124RS,A01,956906,Staff,6,0,25,19
1746605421448,CAT 125RS,A01,922013,Staff,6,0,25,19
1746605422474,CLRE 250,A00,891860,Morris; Sheldon,9995,0,9999,4
1746605424539,CLRE 251R,A00,907817,Mehta; Ravindra L.,9994,0,9999,5
1746605425567,CLRE 252,A00,891864,Cuomo; Raphael Eduardo,9993,0,9999,6
1746605426592,CLRE 253,A00,891867,Vaida; Florin,9994,0,9999,5
1746605426592,CLRE 253,B00,907819,Staff,9999,0,9999,0
1746605427618,CLRE 259,A00,891868,Patel; Hemal,9998,0,9999,1
1746605428645,CLRE 260,A00,891872,Cuomo; Raphael Eduardo,9999,0,9999,0
1746605429680,CLRE 297,001,891888,Cuomo; Raphael Eduardo,9999,0,9999,0
1746605430712,CSE 191,A00,958773,Minnes Kemp; Mor Mia,9995,0,9999,4
1746605431737,CSE 197,001,959846,Minnes Kemp; Mor Mia,9990,0,9999,9
1746605432771,CSS 201S,A01,892054,Mignozzetti; Umberto,25,0,30,5
1746605433799,CSS 202S,A01,892056,Mignozzetti; Umberto,25,0,30,5
1746605434829,DSC 197,001,956898,Eldridge; Justin Matthew,9996,0,9999,3
1746605435860,DSC 297,001,958000,Mazumdar; Arya,9998,0,9999,1
1746605435860,DSC 297,002,959862,Wang; Yusu,9998,0,9999,1
1746605436888,EAP 100,A00,905686,Staff,9778,0,9999,221
1746605437924,ECE 45,A01,892618,Staff,0,0,65,65
1746605439996,ECE 111,A01,892719,Staff,6,0,65,59
1746605441022,ECE 197,001,957920,Mercier; Patrick Philip,9991,0,9999,8
1746605442049,ECON 178,A01,907814,Zhu; Ying,26,0,35,9
1746605443075,EDS 115,A00,895312,Staff,35,0,45,10
1746605444105,EDS 117,A01,895337,Staff,23,0,30,7
1746605445130,EDS 125,A00,895341,Jones; Gabrielle Anastasia,36,0,45,9
1746605446161,EDS 128A,A01,895459,Fargason; Sharon Gayle,44,0,45,1
1746605447231,EDS 128B,A01,895543,Pappas; Elizabeth,44,0,45,1
1746605448257,EDS 139,A00,897203,Pappas; Elizabeth,44,0,45,1
1746605448257,EDS 139,B00,897209,Fargason; Sharon Gayle,41,0,45,4
1746605449286,EDS 201,A00,895545,Staff,22,0,45,23
1746605450319,EDS 203,A01,895581,Halter; Christopher P.,22,0,45,23
1746605451351,EDS 204R,A01,895625,Heinzman; Erica M.,39,0,45,6
1746605451351,EDS 204R,B01,895693,Halter; Christopher P.,10,0,45,35
1746605452379,EDS 206R,A00,895694,Fargason; Sharon Gayle,1,0,30,29
1746605452379,EDS 206R,B00,895695,Choi; Bailey Miyeon,16,0,30,14
1746605453407,EDS 250,A00,895697,Hemans; Patricia Ann Benitez,22,0,45,23
1746605454440,EDS 281,A00,895701,Meyerott; Theresa Ann,1,0,15,14
1746605455466,EDS 284,A00,895736,Meyerott; Theresa Ann,1,0,15,14
1746605456493,EDS 286,A00,897210,Fine; Sarah,0,0,15,15
1746605457522,EDS 289C,A01,895770,Daly; Alan J.,1,0,15,14
1746605458553,EDS 290,A00,897211,Hofstetter; Carolyn,0,0,15,15
1746605459580,LIGM 5A,A00,896162,Fischer-Grunski; Eva K,12,0,20,8
1746605460607,LIGM 5B,A00,896260,Fischer-Grunski; Eva K,17,0,20,3
1746605461636,LIGM 5C,A00,896308,Fischer-Grunski; Eva K,18,0,20,2
1746605462673,LIIT 5AS,A00,896313,Carnelos; Chiara,18,0,20,2
1746605463699,LIIT 5BS,A00,896416,Carnelos; Chiara,20,0,20,0
1746605464728,LIIT 5CS,A00,896564,Carnelos; Chiara,20,0,20,0
1746605465761,LISP 5A,A00,896588,Munoz Sanchez; Alicia,2,0,20,18
1746605466791,LISP 5B,A00,896653,Munoz Sanchez; Alicia,7,0,20,13
1746605467818,LISP 5C,A00,896655,Munoz Sanchez; Alicia,0,1,20,20
1746605468847,MAE 197,001,957918,Kleissl; Jan,9996,0,9999,3
1746605468847,MAE 197,002,959806,Boechler; Nicholas Sebastia,9998,0,9999,1
1746605468847,MAE 197,003,959852,Mullin; Jennifer S,9998,0,9999,1
1746605469876,MATH 2,A01,957937,Staff,33,0,35,2
1746605470903,MATH 197,001,957876,Kedlaya; Kiran S.,9993,0,9999,6
1746605471934,MCWP 40,A00,892729,Duru; Nur,10,0,20,10
1746605471934,MCWP 40,B00,893304,Montejo; Carolina,14,0,20,6
1746605472967,MCWP 40R,A00,893757,Redela; Pamela Morgan,0,5,20,20
1746605473998,MCWP 50,A00,893758,Morshed; Michael James,0,0,20,20
1746605473998,MCWP 50,B00,893761,Bartulis; Jason Michael,16,0,20,4
1746605475039,MCWP 50R,A00,893766,Compas; Sean Matthew,0,1,20,20
1746605475039,MCWP 50R,B00,893769,Carter; Jennifer A,0,1,20,20
1746605475039,MCWP 50R,C00,893771,Krone; Jarret,0,3,20,20
1746605475039,MCWP 50R,D00,893772,Miller; Elizabeth Deen,0,0,20,20
1746605475039,MCWP 50R,E00,893775,Carter; Andrea L,0,1,20,20
1746605476067,MMW 11R,A01,892721,Herbst; Matthew,14,0,30,16
1746605476067,MMW 11R,A02,892722,Herbst; Matthew,0,0,0,3
1746605477094,MMW 12R,A01,892724,Herbst; Matthew,0,11,16,16
1746605477094,MMW 12R,A02,892725,Herbst; Matthew,0,10,16,16
1746605478123,MMW 13R,A01,892727,Staff,0,4,16,16
1746605478123,MMW 13R,A02,892728,Staff,0,4,16,16
1746605478123,MMW 13R,A03,958032,Staff,0,4,16,16
1746605478123,MMW 13R,A04,958033,Staff,0,4,16,16
1746605478123,MMW 13R,A05,958034,Staff,0,4,16,16
1746605479155,SIO 295LS,A00,894015,Staff,5,0,25,20
1746605480185,SIO 295S,A00,894020,Staff,5,0,25,20
1746605481214,SIOC 290S,B01,958918,Merrifield; Mark A,14,0,30,16
1746605482247,SIOC 291S,B01,958922,Gabriel; Corey John,14,0,30,16
1746605483272,SOCI 117,A01,895339,Staff,2,0,5,3
1746605484300,WES 237B,A00,894149,Staff,11,0,20,9
1746605486374,AESE 279B,A00,891859,Staff,13,0,35,22
1746605487400,AIP 197,001,891854,Vespa; Emanuel Ignacio,9999,0,9999,0
1746605488432,ANTH 289S,A00,891856,Gagneux; Pascal,12,0,12,0
1746605489458,BENG 196,001,957946,Engler; Adam J.,9996,0,9999,3
1746605490489,BISP 197,001,959851,Wilhelm; James E.,9998,0,9999,1
1746605491516,CAT 124RS,A01,956906,Staff,6,0,25,19
1746605492543,CAT 125RS,A01,922013,Staff,6,0,25,19
1746605493578,CLRE 250,A00,891860,Morris; Sheldon,9995,0,9999,4
1746605495632,CLRE 251R,A00,907817,Mehta; Ravindra L.,9994,0,9999,5
1746605496658,CLRE 252,A00,891864,Cuomo; Raphael Eduardo,9993,0,9999,6
1746605497687,CLRE 253,A00,891867,Vaida; Florin,9994,0,9999,5
1746605497687,CLRE 253,B00,907819,Staff,9999,0,9999,0
1746605498717,CLRE 259,A00,891868,Patel; Hemal,9998,0,9999,1
1746605499750,CLRE 260,A00,891872,Cuomo; Raphael Eduardo,9999,0,9999,0
1746605500780,CLRE 297,001,891888,Cuomo; Raphael Eduardo,9999,0,9999,0
1746605501807,CSE 191,A00,958773,Minnes Kemp; Mor Mia,9995,0,9999,4
1746605502836,CSE 197,001,959846,Minnes Kemp; Mor Mia,9990,0,9999,9
1746605503868,CSS 201S,A01,892054,Mignozzetti; Umberto,25,0,30,5
1746605504895,CSS 202S,A01,892056,Mignozzetti; Umberto,25,0,30,5
1746605505923,DSC 197,001,956898,Eldridge; Justin Matthew,9996,0,9999,3
1746605506950,DSC 297,001,958000,Mazumdar; Arya,9998,0,9999,1
1746605506950,DSC 297,002,959862,Wang; Yusu,9998,0,9999,1
1746605507983,EAP 100,A00,905686,Staff,9778,0,9999,221
1746605509012,ECE 45,A01,892618,Staff,0,0,65,65
1746605511063,ECE 111,A01,892719,Staff,6,0,65,59
1746605512091,ECE 197,001,957920,Mercier; Patrick Philip,9991,0,9999,8
1746605513122,ECON 178,A01,907814,Zhu; Ying,26,0,35,9
1746605514149,EDS 115,A00,895312,Staff,35,0,45,10
1746605515179,EDS 117,A01,895337,Staff,23,0,30,7
1746605516206,EDS 125,A00,895341,Jones; Gabrielle Anastasia,36,0,45,9
1746605517238,EDS 128A,A01,895459,Fargason; Sharon Gayle,44,0,45,1
1746605518268,EDS 128B,A01,895543,Pappas; Elizabeth,44,0,45,1
1746605519299,EDS 139,A00,897203,Pappas; Elizabeth,44,0,45,1
1746605519299,EDS 139,B00,897209,Fargason; Sharon Gayle,41,0,45,4
1746605520326,EDS 201,A00,895545,Staff,22,0,45,23
1746605521354,EDS 203,A01,895581,Halter; Christopher P.,22,0,45,23
1746605522399,EDS 204R,A01,895625,Heinzman; Erica M.,39,0,45,6
1746605522399,EDS 204R,B01,895693,Halter; Christopher P.,10,0,45,35
1746605523427,EDS 206R,A00,895694,Fargason; Sharon Gayle,1,0,30,29
1746605523427,EDS 206R,B00,895695,Choi; Bailey Miyeon,16,0,30,14
1746605524453,EDS 250,A00,895697,Hemans; Patricia Ann Benitez,22,0,45,23
1746605525483,EDS 281,A00,895701,Meyerott; Theresa Ann,1,0,15,14
1746605526515,EDS 284,A00,895736,Meyerott; Theresa Ann,1,0,15,14
1746605527545,EDS 286,A00,897210,Fine; Sarah,0,0,15,15
1746605528574,EDS 289C,A01,895770,Daly; Alan J.,1,0,15,14
1746605529602,EDS 290,A00,897211,Hofstetter; Carolyn,0,0,15,15
1746605530633,LIGM 5A,A00,896162,Fischer-Grunski; Eva K,12,0,20,8
1746605531664,LIGM 5B,A00,896260,Fischer-Grunski; Eva K,17,0,20,3
1746605532696,LIGM 5C,A00,896308,Fischer-Grunski; Eva K,18,0,20,2
1746605533724,LIIT 5AS,A00,896313,Carnelos; Chiara,18,0,20,2
1746605534751,LIIT 5BS,A00,896416,Carnelos; Chiara,20,0,20,0
1746605535778,LIIT 5CS,A00,896564,Carnelos; Chiara,20,0,20,0
1746605536813,LISP 5A,A00,896588,Munoz Sanchez; Alicia,2,0,20,18
1746605537840,LISP 5B,A00,896653,Munoz Sanchez; Alicia,7,0,20,13
1746605538868,LISP 5C,A00,896655,Munoz Sanchez; Alicia,0,1,20,20
1746605539893,MAE 197,001,957918,Kleissl; Jan,9996,0,9999,3
1746605539893,MAE 197,002,959806,Boechler; Nicholas Sebastia,9998,0,9999,1
1746605539893,MAE 197,003,959852,Mullin; Jennifer S,9998,0,9999,1
1746605540919,MATH 2,A01,957937,Staff,33,0,35,2
1746605541948,MATH 197,001,957876,Kedlaya; Kiran S.,9993,0,9999,6
1746605542984,MCWP 40,A00,892729,Duru; Nur,10,0,20,10
1746605542984,MCWP 40,B00,893304,Montejo; Carolina,14,0,20,6
1746605544016,MCWP 40R,A00,893757,Redela; Pamela Morgan,0,5,20,20
1746605545042,MCWP 50,A00,893758,Morshed; Michael James,0,0,20,20
1746605545042,MCWP 50,B00,893761,Bartulis; Jason Michael,16,0,20,4
1746605546069,MCWP 50R,A00,893766,Compas; Sean Matthew,0,1,20,20
1746605546069,MCWP 50R,B00,893769,Carter; Jennifer A,0,1,20,20
1746605546069,MCWP 50R,C00,893771,Krone; Jarret,0,3,20,20
1746605546069,MCWP 50R,D00,893772,Miller; Elizabeth Deen,0,0,20,20
1746605546069,MCWP 50R,E00,893775,Carter; Andrea L,0,1,20,20
1746605547100,MMW 11R,A01,892721,Herbst; Matthew,14,0,30,16
1746605547100,MMW 11R,A02,892722,Herbst; Matthew,0,0,0,3
1746605548130,MMW 12R,A01,892724,Herbst; Matthew,0,11,16,16
1746605548130,MMW 12R,A02,892725,Herbst; Matthew,0,10,16,16
1746605549158,MMW 13R,A01,892727,Staff,0,4,16,16
1746605549158,MMW 13R,A02,892728,Staff,0,4,16,16
1746605549158,MMW 13R,A03,958032,Staff,0,4,16,16
1746605549158,MMW 13R,A04,958033,Staff,0,4,16,16
1746605549158,MMW 13R,A05,958034,Staff,0,4,16,16
1746605550188,SIO 295LS,A00,894015,Staff,5,0,25,20
1746605551213,SIO 295S,A00,894020,Staff,5,0,25,20
1746605552249,SIOC 290S,B01,958918,Merrifield; Mark A,14,0,30,16
1746605553276,SIOC 291S,B01,958922,Gabriel; Corey John,14,0,30,16
1746605554303,SOCI 117,A01,895339,Staff,2,0,5,3
1746605555332,WES 237B,A00,894149,Staff,11,0,20,9
1746605557411,AESE 279B,A00,891859,Staff,13,0,35,22
1746605558442,AIP 197,001,891854,Vespa; Emanuel Ignacio,9999,0,9999,0
1746605559468,ANTH 289S,A00,891856,Gagneux; Pascal,12,0,12,0
1746605560494,BENG 196,001,957946,Engler; Adam J.,9996,0,9999,3
1746605561522,BISP 197,001,959851,Wilhelm; James E.,9998,0,9999,1
1746605562553,CAT 124RS,A01,956906,Staff,6,0,25,19
1746605563579,CAT 125RS,A01,922013,Staff,6,0,25,19
1746605564610,CLRE 250,A00,891860,Morris; Sheldon,9995,0,9999,4
1746605566672,CLRE 251R,A00,907817,Mehta; Ravindra L.,9994,0,9999,5
1746605567697,CLRE 252,A00,891864,Cuomo; Raphael Eduardo,9993,0,9999,6
1746605568738,CLRE 253,A00,891867,Vaida; Florin,9994,0,9999,5
1746605568738,CLRE 253,B00,907819,Staff,9999,0,9999,0
1746605569812,CLRE 259,A00,891868,Patel; Hemal,9998,0,9999,1
1746605570839,CLRE 260,A00,891872,Cuomo; Raphael Eduardo,9999,0,9999,0
1746605571867,CLRE 297,001,891888,Cuomo; Raphael Eduardo,9999,0,9999,0
1746605572896,CSE 191,A00,958773,Minnes Kemp; Mor Mia,9995,0,9999,4
1746605573920,CSE 197,001,959846,Minnes Kemp; Mor Mia,9990,0,9999,9
1746605574954,CSS 201S,A01,892054,Mignozzetti; Umberto,25,0,30,5
1746605575984,CSS 202S,A01,892056,Mignozzetti; Umberto,25,0,30,5
1746605577013,DSC 197,001,956898,Eldridge; Justin Matthew,9996,0,9999,3
1746605578045,DSC 297,001,958000,Mazumdar; Arya,9998,0,9999,1
1746605578045,DSC 297,002,959862,Wang; Yusu,9998,0,9999,1
1746605579075,EAP 100,A00,905686,Staff,9778,0,9999,221
1746605580107,ECE 45,A01,892618,Staff,0,0,65,65
1746605582165,ECE 111,A01,892719,Staff,6,0,65,59
1746605583193,ECE 197,001,957920,Mercier; Patrick Philip,9991,0,9999,8
1746605584221,ECON 178,A01,907814,Zhu; Ying,26,0,35,9
1746605585249,EDS 115,A00,895312,Staff,35,0,45,10
1746605586278,EDS 117,A01,895337,Staff,23,0,30,7
1746605587303,EDS 125,A00,895341,Jones; Gabrielle Anastasia,36,0,45,9
1746605588331,EDS 128A,A01,895459,Fargason; Sharon Gayle,44,0,45,1
1746605589358,EDS 128B,A01,895543,Pappas; Elizabeth,44,0,45,1
1746605590383,EDS 139,A00,897203,Pappas; Elizabeth,44,0,45,1
1746605590383,EDS 139,B00,897209,Fargason; Sharon Gayle,41,0,45,4
1746605591410,EDS 201,A00,895545,Staff,22,0,45,23
1746605592441,EDS 203,A01,895581,Halter; Christopher P.,22,0,45,23
1746605593467,EDS 204R,A01,895625,Heinzman; Erica M.,39,0,45,6
1746605593467,EDS 204R,B01,895693,Halter; Christopher P.,10,0,45,35
1746605594493,EDS 206R,A00,895694,Fargason; Sharon Gayle,1,0,30,29
1746605594493,EDS 206R,B00,895695,Choi; Bailey Miyeon,16,0,30,14
1746605595520,EDS 250,A00,895697,Hemans; Patricia Ann Benitez,22,0,45,23
1746605596547,EDS 281,A00,895701,Meyerott; Theresa Ann,1,0,15,14
1746605597576,EDS 284,A00,895736,Meyerott; Theresa Ann,1,0,15,14
1746605598608,EDS 286,A00,897210,Fine; Sarah,0,0,15,15
1746605599636,EDS 289C,A01,895770,Daly; Alan J.,1,0,15,14
1746605600664,EDS 290,A00,897211,Hofstetter; Carolyn,0,0,15,15
1746605601691,LIGM 5A,A00,896162,Fischer-Grunski; Eva K,12,0,20,8
1746605602721,LIGM 5B,A00,896260,Fischer-Grunski; Eva K,17,0,20,3
1746605603748,LIGM 5C,A00,896308,Fischer-Grunski; Eva K,18,0,20,2
1746605604774,LIIT 5AS,A00,896313,Carnelos; Chiara,18,0,20,2
1746605605802,LIIT 5BS,A00,896416,Carnelos; Chiara,20,0,20,0
1746605606829,LIIT 5CS,A00,896564,Carnelos; Chiara,20,0,20,0
1746605607857,LISP 5A,A00,896588,Munoz Sanchez; Alicia,2,0,20,18
1746605608886,LISP 5B,A00,896653,Munoz Sanchez; Alicia,7,0,20,13
1746605609912,LISP 5C,A00,896655,Munoz Sanchez; Alicia,0,1,20,20
1746605610937,MAE 197,001,957918,Kleissl; Jan,9996,0,9999,3
1746605610937,MAE 197,002,959806,Boechler; Nicholas Sebastia,9998,0,9999,1
1746605610937,MAE 197,003,959852,Mullin; Jennifer S,9998,0,9999,1
1746605611966,MATH 2,A01,957937,Staff,33,0,35,2
1746605612994,MATH 197,001,957876,Kedlaya; Kiran S.,9993,0,9999,6
1746605614024,MCWP 40,A00,892729,Duru; Nur,10,0,20,10
1746605614024,MCWP 40,B00,893304,Montejo; Carolina,14,0,20,6
1746605615057,MCWP 40R,A00,893757,Redela; Pamela Morgan,0,5,20,20
1746605616084,MCWP 50,A00,893758,Morshed; Michael James,0,0,20,20
1746605616084,MCWP 50,B00,893761,Bartulis; Jason Michael,16,0,20,4
1746605617114,MCWP 50R,A00,893766,Compas; Sean Matthew,0,1,20,20
1746605617114,MCWP 50R,B00,893769,Carter; Jennifer A,0,1,20,20
1746605617114,MCWP 50R,C00,893771,Krone; Jarret,0,3,20,20
1746605617114,MCWP 50R,D00,893772,Miller; Elizabeth Deen,0,0,20,20
1746605617114,MCWP 50R,E00,893775,Carter; Andrea L,0,1,20,20
1746605618141,MMW 11R,A01,892721,Herbst; Matthew,14,0,30,16
1746605618141,MMW 11R,A02,892722,Herbst; Matthew,0,0,0,3
1746605619169,MMW 12R,A01,892724,Herbst; Matthew,0,11,16,16
1746605619169,MMW 12R,A02,892725,Herbst; Matthew,0,10,16,16
1746605620199,MMW 13R,A01,892727,Staff,0,4,16,16
1746605620199,MMW 13R,A02,892728,Staff,0,4,16,16
1746605620199,MMW 13R,A03,958032,Staff,0,4,16,16
1746605620199,MMW 13R,A04,958033,Staff,0,4,16,16
1746605620199,MMW 13R,A05,958034,Staff,0,4,16,16
1746605621230,SIO 295LS,A00,894015,Staff,5,0,25,20
1746605622258,SIO 295S,A00,894020,Staff,5,0,25,20
1746605623291,SIOC 290S,B01,958918,Merrifield; Mark A,14,0,30,16
1746605624318,SIOC 291S,B01,958922,Gabriel; Corey John,14,0,30,16
1746605625343,SOCI 117,A01,895339,Staff,2,0,5,3
1746605626369,WES 237B,A00,894149,Staff,11,0,20,9
1746605628448,AESE 279B,A00,891859,Staff,13,0,35,22
1746605629477,AIP 197,001,891854,Vespa; Emanuel Ignacio,9999,0,9999,0
1746605630504,ANTH 289S,A00,891856,Gagneux; Pascal,12,0,12,0
1746605631529,BENG 196,001,957946,Engler; Adam J.,9996,0,9999,3
1746605632558,BISP 197,001,959851,Wilhelm; James E.,9998,0,9999,1
1746605633588,CAT 124RS,A01,956906,Staff,6,0,25,19
1746605634618,CAT 125RS,A01,922013,Staff,6,0,25,19
1746605635647,CLRE 250,A00,891860,Morris; Sheldon,9995,0,9999,4
1746605637703,CLRE 251R,A00,907817,Mehta; Ravindra L.,9994,0,9999,5
1746605638729,CLRE 252,A00,891864,Cuomo; Raphael Eduardo,9993,0,9999,6
1746605639764,CLRE 253,A00,891867,Vaida; Florin,9994,0,9999,5
1746605639764,CLRE 253,B00,907819,Staff,9999,0,9999,0
1746605640796,CLRE 259,A00,891868,Patel; Hemal,9998,0,9999,1
1746605641821,CLRE 260,A00,891872,Cuomo; Raphael Eduardo,9999,0,9999,0
1746605642847,CLRE 297,001,891888,Cuomo; Raphael Eduardo,9999,0,9999,0
1746605643873,CSE 191,A00,958773,Minnes Kemp; Mor Mia,9995,0,9999,4
1746605644899,CSE 197,001,959846,Minnes Kemp; Mor Mia,9990,0,9999,9
1746605645933,CSS 201S,A01,892054,Mignozzetti; Umberto,25,0,30,5
1746605646961,CSS 202S,A01,892056,Mignozzetti; Umberto,25,0,30,5
1746605647988,DSC 197,001,956898,Eldridge; Justin Matthew,9996,0,9999,3
1746605649020,DSC 297,001,958000,Mazumdar; Arya,9998,0,9999,1
1746605649020,DSC 297,002,959862,Wang; Yusu,9998,0,9999,1
1746605650052,EAP 100,A00,905686,Staff,9778,0,9999,221
1746605651079,ECE 45,A01,892618,Staff,0,0,65,65
1746605653133,ECE 111,A01,892719,Staff,6,0,65,59
1746605654160,ECE 197,001,957920,Mercier; Patrick Philip,9991,0,9999,8
1746605655185,ECON 178,A01,907814,Zhu; Ying,26,0,35,9
1746605656214,EDS 115,A00,895312,Staff,35,0,45,10
1746605657242,EDS 117,A01,895337,Staff,23,0,30,7
1746605658269,EDS 125,A00,895341,Jones; Gabrielle Anastasia,36,0,45,9
1746605659297,EDS 128A,A01,895459,Fargason; Sharon Gayle,44,0,45,1
1746605660328,EDS 128B,A01,895543,Pappas; Elizabeth,44,0,45,1
1746605661358,EDS 139,A00,897203,Pappas; Elizabeth,44,0,45,1
1746605661358,EDS 139,B00,897209,Fargason; Sharon Gayle,41,0,45,4
1746605662387,EDS 201,A00,895545,Staff,22,0,45,23
1746605663415,EDS 203,A01,895581,Halter; Christopher P.,22,0,45,23
1746605664442,EDS 204R,A01,895625,Heinzman; Erica M.,39,0,45,6
1746605664442,EDS 204R,B01,895693,Halter; Christopher P.,10,0,45,35
1746605665468,EDS 206R,A00,895694,Fargason; Sharon Gayle,1,0,30,29
1746605665468,EDS 206R,B00,895695,Choi; Bailey Miyeon,16,0,30,14
1746605666496,EDS 250,A00,895697,Hemans; Patricia Ann Benitez,22,0,45,23
1746605667523,EDS 281,A00,895701,Meyerott; Theresa Ann,1,0,15,14
1746605668550,EDS 284,A00,895736,Meyerott; Theresa Ann,1,0,15,14
1746605669576,EDS 286,A00,897210,Fine; Sarah,0,0,15,15
1746605670603,EDS 289C,A01,895770,Daly; Alan J.,1,0,15,14
1746605671633,EDS 290,A00,897211,Hofstetter; Carolyn,0,0,15,15
1746605672660,LIGM 5A,A00,896162,Fischer-Grunski; Eva K,12,0,20,8
1746605673687,LIGM 5B,A00,896260,Fischer-Grunski; Eva K,17,0,20,3
1746605674715,LIGM 5C,A00,896308,Fischer-Grunski; Eva K,18,0,20,2
1746605675747,LIIT 5AS,A00,896313,Carnelos; Chiara,18,0,20,2
1746605676780,LIIT 5BS,A00,896416,Carnelos; Chiara,20,0,20,0
1746605677811,LIIT 5CS,A00,896564,Carnelos; Chiara,20,0,20,0
1746605678838,LISP 5A,A00,896588,Munoz Sanchez; Alicia,2,0,20,18
1746605679872,LISP 5B,A00,896653,Munoz Sanchez; Alicia,7,0,20,13
1746605680902,LISP 5C,A00,896655,Munoz Sanchez; Alicia,0,1,20,20
1746605681931,MAE 197,001,957918,Kleissl; Jan,9996,0,9999,3
1746605681931,MAE 197,002,959806,Boechler; Nicholas Sebastia,9998,0,9999,1
1746605681931,MAE 197,003,959852,Mullin; Jennifer S,9998,0,9999,1
1746605682959,MATH 2,A01,957937,Staff,33,0,35,2
1746605683986,MATH 197,001,957876,Kedlaya; Kiran S.,9993,0,9999,6
1746605685026,MCWP 40,A00,892729,Duru; Nur,10,0,20,10
1746605685026,MCWP 40,B00,893304,Montejo; Carolina,14,0,20,6
1746605686053,MCWP 40R,A00,893757,Redela; Pamela Morgan,0,5,20,20
1746605687085,MCWP 50,A00,893758,Morshed; Michael James,0,0,20,20
1746605687085,MCWP 50,B00,893761,Bartulis; Jason Michael,16,0,20,4
1746605688114,MCWP 50R,A00,893766,Compas; Sean Matthew,0,1,20,20
1746605688114,MCWP 50R,B00,893769,Carter; Jennifer A,0,1,20,20
1746605688114,MCWP 50R,C00,893771,Krone; Jarret,0,3,20,20
1746605688114,MCWP 50R,D00,893772,Miller; Elizabeth Deen,0,0,20,20
1746605688114,MCWP 50R,E00,893775,Carter; Andrea L,0,1,20,20
1746605689143,MMW 11R,A01,892721,Herbst; Matthew,14,0,30,16
1746605689143,MMW 11R,A02,892722,Herbst; Matthew,0,0,0,3
1746605690170,MMW 12R,A01,892724,Herbst; Matthew,0,11,16,16
1746605690170,MMW 12R,A02,892725,Herbst; Matthew,0,10,16,16
1746605691199,MMW 13R,A01,892727,Staff,0,4,16,16
1746605691199,MMW 13R,A02,892728,Staff,0,4,16,16
1746605691199,MMW 13R,A03,958032,Staff,0,4,16,16
1746605691199,MMW 13R,A04,958033,Staff,0,4,16,16
1746605691199,MMW 13R,A05,958034,Staff,0,4,16,16
1746605692231,SIO 295LS,A00,894015,Staff,5,0,25,20
1746605693258,SIO 295S,A00,894020,Staff,5,0,25,20
1746605694286,SIOC 290S,B01,958918,Merrifield; Mark A,14,0,30,16
1746605695313,SIOC 291S,B01,958922,Gabriel; Corey John,14,0,30,16
1746605696339,SOCI 117,A01,895339,Staff,2,0,5,3
1746605697371,WES 237B,A00,894149,Staff,11,0,20,9
1746605699444,AESE 279B,A00,891859,Staff,13,0,35,22
1746605700471,AIP 197,001,891854,Vespa; Emanuel Ignacio,9999,0,9999,0
1746605701503,ANTH 289S,A00,891856,Gagneux; Pascal,12,0,12,0
1746605702535,BENG 196,001,957946,Engler; Adam J.,9996,0,9999,3
1746605703562,BISP 197,001,959851,Wilhelm; James E.,9998,0,9999,1
1746605704589,CAT 124RS,A01,956906,Staff,6,0,25,19
1746605705619,CAT 125RS,A01,922013,Staff,6,0,25,19
1746605706646,CLRE 250,A00,891860,Morris; Sheldon,9995,0,9999,4
1746605708702,CLRE 251R,A00,907817,Mehta; Ravindra L.,9994,0,9999,5
1746605709734,CLRE 252,A00,891864,Cuomo; Raphael Eduardo,9993,0,9999,6
1746605710760,CLRE 253,A00,891867,Vaida; Florin,9994,0,9999,5
1746605710760,CLRE 253,B00,907819,Staff,9999,0,9999,0
1746605711787,CLRE 259,A00,891868,Patel; Hemal,9998,0,9999,1
1746605712818,CLRE 260,A00,891872,Cuomo; Raphael Eduardo,9999,0,9999,0
1746605713845,CLRE 297,001,891888,Cuomo; Raphael Eduardo,9999,0,9999,0
1746605714876,CSE 191,A00,958773,Minnes Kemp; Mor Mia,9995,0,9999,4
1746605715904,CSE 197,001,959846,Minnes Kemp; Mor Mia,9990,0,9999,9
1746605716930,CSS 201S,A01,892054,Mignozzetti; Umberto,25,0,30,5
1746605717961,CSS 202S,A01,892056,Mignozzetti; Umberto,25,0,30,5
1746605718987,DSC 197,001,956898,Eldridge; Justin Matthew,9996,0,9999,3
1746605720027,DSC 297,001,958000,Mazumdar; Arya,9998,0,9999,1
1746605720027,DSC 297,002,959862,Wang; Yusu,9998,0,9999,1
1746605721057,EAP 100,A00,905686,Staff,9778,0,9999,221
1746605722090,ECE 45,A01,892618,Staff,0,0,65,65
1746605724148,ECE 111,A01,892719,Staff,6,0,65,59
1746605725175,ECE 197,001,957920,Mercier; Patrick Philip,9991,0,9999,8
1746605726207,ECON 178,A01,907814,Zhu; Ying,26,0,35,9
1746605727235,EDS 115,A00,895312,Staff,35,0,45,10
1746605728264,EDS 117,A01,895337,Staff,23,0,30,7
1746605729293,EDS 125,A00,895341,Jones; Gabrielle Anastasia,36,0,45,9
1746605730325,EDS 128A,A01,895459,Fargason; Sharon Gayle,44,0,45,1
1746605731351,EDS 128B,A01,895543,Pappas; Elizabeth,44,0,45,1
1746605732377,EDS 139,A00,897203,Pappas; Elizabeth,44,0,45,1
1746605732377,EDS 139,B00,897209,Fargason; Sharon Gayle,41,0,45,4
1746605733403,EDS 201,A00,895545,Staff,22,0,45,23
1746605734428,EDS 203,A01,895581,Halter; Christopher P.,22,0,45,23
1746605735458,EDS 204R,A01,895625,Heinzman; Erica M.,39,0,45,6
1746605735458,EDS 204R,B01,895693,Halter; Christopher P.,10,0,45,35
1746605736490,EDS 206R,A00,895694,Fargason; Sharon Gayle,1,0,30,29
1746605736490,EDS 206R,B00,895695,Choi; Bailey Miyeon,16,0,30,14
1746605737514,EDS 250,A00,895697,Hemans; Patricia Ann Benitez,22,0,45,23
1746605738540,EDS 281,A00,895701,Meyerott; Theresa Ann,1,0,15,14
1746605739569,EDS 284,A00,895736,Meyerott; Theresa Ann,1,0,15,14
1746605740595,EDS 286,A00,897210,Fine; Sarah,0,0,15,15
1746605741623,EDS 289C,A01,895770,Daly; Alan J.,1,0,15,14
1746605742650,EDS 290,A00,897211,Hofstetter; Carolyn,0,0,15,15
1746605743678,LIGM 5A,A00,896162,Fischer-Grunski; Eva K,12,0,20,8
1746605744705,LIGM 5B,A00,896260,Fischer-Grunski; Eva K,17,0,20,3
1746605745730,LIGM 5C,A00,896308,Fischer-Grunski; Eva K,18,0,20,2
1746605746757,LIIT 5AS,A00,896313,Carnelos; Chiara,18,0,20,2
1746605747787,LIIT 5BS,A00,896416,Carnelos; Chiara,20,0,20,0
1746605748817,LIIT 5CS,A00,896564,Carnelos; Chiara,20,0,20,0
1746605749843,LISP 5A,A00,896588,Munoz Sanchez; Alicia,2,0,20,18
1746605750874,LISP 5B,A00,896653,Munoz Sanchez; Alicia,7,0,20,13
1746605751902,LISP 5C,A00,896655,Munoz Sanchez; Alicia,0,1,20,20
1746605752926,MAE 197,001,957918,Kleissl; Jan,9996,0,9999,3
1746605752926,MAE 197,002,959806,Boechler; Nicholas Sebastia,9998,0,9999,1
1746605752926,MAE 197,003,959852,Mullin; Jennifer S,9998,0,9999,1
1746605753955,MATH 2,A01,957937,Staff,33,0,35,2
1746605754982,MATH 197,001,957876,Kedlaya; Kiran S.,9993,0,9999,6
1746605756015,MCWP 40,A00,892729,Duru; Nur,10,0,20,10
1746605756015,MCWP 40,B00,893304,Montejo; Carolina,14,0,20,6
1746605757041,MCWP 40R,A00,893757,Redela; Pamela Morgan,0,5,20,20
1746605758068,MCWP 50,A00,893758,Morshed; Michael James,0,0,20,20
1746605758068,MCWP 50,B00,893761,Bartulis; Jason Michael,16,0,20,4
1746605759284,MCWP 50R,A00,893766,Compas; Sean Matthew,0,1,20,20
1746605759284,MCWP 50R,B00,893769,Carter; Jennifer A,0,1,20,20
1746605759284,MCWP 50R,C00,893771,Krone; Jarret,0,3,20,20
1746605759284,MCWP 50R,D00,893772,Miller; Elizabeth Deen,0,0,20,20
1746605759284,MCWP 50R,E00,893775,Carter; Andrea L,0,1,20,20
1746605760310,MMW 11R,A01,892721,Herbst; Matthew,14,0,30,16
1746605760310,MMW 11R,A02,892722,Herbst; Matthew,0,0,0,3
1746605761336,MMW 12R,A01,892724,Herbst; Matthew,0,11,16,16
1746605761336,MMW 12R,A02,892725,Herbst; Matthew,0,10,16,16
1746605762365,MMW 13R,A01,892727,Staff,0,4,16,16
1746605762365,MMW 13R,A02,892728,Staff,0,4,16,16
1746605762365,MMW 13R,A03,958032,Staff,0,4,16,16
1746605762365,MMW 13R,A04,958033,Staff,0,4,16,16
1746605762365,MMW 13R,A05,958034,Staff,0,4,16,16
1746605763391,SIO 295LS,A00,894015,Staff,5,0,25,20
1746605764423,SIO 295S,A00,894020,Staff,5,0,25,20
1746605765451,SIOC 290S,B01,958918,Merrifield; Mark A,14,0,30,16
1746605766485,SIOC 291S,B01,958922,Gabriel; Corey John,14,0,30,16
1746605767511,SOCI 117,A01,895339,Staff,2,0,5,3
1746605768536,WES 237B,A00,894149,Staff,11,0,20,9
1746605770605,AESE 279B,A00,891859,Staff,13,0,35,22
1746605771632,AIP 197,001,891854,Vespa; Emanuel Ignacio,9999,0,9999,0
1746605772659,ANTH 289S,A00,891856,Gagneux; Pascal,12,0,12,0
1746605773689,BENG 196,001,957946,Engler; Adam J.,9996,0,9999,3
1746605774716,BISP 197,001,959851,Wilhelm; James E.,9998,0,9999,1
1746605775748,CAT 124RS,A01,956906,Staff,6,0,25,19
1746605776776,CAT 125RS,A01,922013,Staff,6,0,25,19
1746605777803,CLRE 250,A00,891860,Morris; Sheldon,9995,0,9999,4
1746605779869,CLRE 251R,A00,907817,Mehta; Ravindra L.,9994,0,9999,5
1746605780896,CLRE 252,A00,891864,Cuomo; Raphael Eduardo,9993,0,9999,6
1746605781930,CLRE 253,A00,891867,Vaida; Florin,9994,0,9999,5
1746605781930,CLRE 253,B00,907819,Staff,9999,0,9999,0
1746605782961,CLRE 259,A00,891868,Patel; Hemal,9998,0,9999,1
1746605783988,CLRE 260,A00,891872,Cuomo; Raphael Eduardo,9999,0,9999,0
1746605785016,CLRE 297,001,891888,Cuomo; Raphael Eduardo,9999,0,9999,0
1746605786043,CSE 191,A00,958773,Minnes Kemp; Mor Mia,9995,0,9999,4
1746605787070,CSE 197,001,959846,Minnes Kemp; Mor Mia,9990,0,9999,9
1746605788097,CSS 201S,A01,892054,Mignozzetti; Umberto,25,0,30,5
1746605789123,CSS 202S,A01,892056,Mignozzetti; Umberto,25,0,30,5
1746605790155,DSC 197,001,956898,Eldridge; Justin Matthew,9996,0,9999,3
1746605791184,DSC 297,001,958000,Mazumdar; Arya,9998,0,9999,1
1746605791184,DSC 297,002,959862,Wang; Yusu,9998,0,9999,1
1746605792217,EAP 100,A00,905686,Staff,9778,0,9999,221
1746605793250,ECE 45,A01,892618,Staff,0,0,65,65
1746605795306,ECE 111,A01,892719,Staff,6,0,65,59
1746605796333,ECE 197,001,957920,Mercier; Patrick Philip,9991,0,9999,8
1746605797363,ECON 178,A01,907814,Zhu; Ying,26,0,35,9
1746605798389,EDS 115,A00,895312,Staff,35,0,45,10
1746605799419,EDS 117,A01,895337,Staff,23,0,30,7
1746605800445,EDS 125,A00,895341,Jones; Gabrielle Anastasia,36,0,45,9
1746605801470,EDS 128A,A01,895459,Fargason; Sharon Gayle,44,0,45,1
1746605802498,EDS 128B,A01,895543,Pappas; Elizabeth,44,0,45,1
1746605803523,EDS 139,A00,897203,Pappas; Elizabeth,44,0,45,1
1746605803523,EDS 139,B00,897209,Fargason; Sharon Gayle,41,0,45,4
1746605804549,EDS 201,A00,895545,Staff,22,0,45,23
1746605805580,EDS 203,A01,895581,Halter; Christopher P.,22,0,45,23
1746605806609,EDS 204R,A01,895625,Heinzman; Erica M.,39,0,45,6
1746605806609,EDS 204R,B01,895693,Halter; Christopher P.,10,0,45,35
1746605807634,EDS 206R,A00,895694,Fargason; Sharon Gayle,1,0,30,29
1746605807634,EDS 206R,B00,895695,Choi; Bailey Miyeon,16,0,30,14
1746605808660,EDS 250,A00,895697,Hemans; Patricia Ann Benitez,22,0,45,23
1746605809691,EDS 281,A00,895701,Meyerott; Theresa Ann,1,0,15,14
1746605810718,EDS 284,A00,895736,Meyerott; Theresa Ann,1,0,15,14
1746605811742,EDS 286,A00,897210,Fine; Sarah,0,0,15,15
1746605812773,EDS 289C,A01,895770,Daly; Alan J.,1,0,15,14
1746605813803,EDS 290,A00,897211,Hofstetter; Carolyn,0,0,15,15
1746605814832,LIGM 5A,A00,896162,Fischer-Grunski; Eva K,12,0,20,8
1746605815864,LIGM 5B,A00,896260,Fischer-Grunski; Eva K,17,0,20,3
1746605816890,LIGM 5C,A00,896308,Fischer-Grunski; Eva K,18,0,20,2
1746605817917,LIIT 5AS,A00,896313,Carnelos; Chiara,18,0,20,2
1746605818944,LIIT 5BS,A00,896416,Carnelos; Chiara,20,0,20,0
1746605819971,LIIT 5CS,A00,896564,Carnelos; Chiara,20,0,20,0
1746605821000,LISP 5A,A00,896588,Munoz Sanchez; Alicia,2,0,20,18
1746605822028,LISP 5B,A00,896653,Munoz Sanchez; Alicia,7,0,20,13
1746605823058,LISP 5C,A00,896655,Munoz Sanchez; Alicia,0,1,20,20
1746605824085,MAE 197,001,957918,Kleissl; Jan,9996,0,9999,3
1746605824085,MAE 197,002,959806,Boechler; Nicholas Sebastia,9998,0,9999,1
1746605824085,MAE 197,003,959852,Mullin; Jennifer S,9998,0,9999,1
1746605825112,MATH 2,A01,957937,Staff,33,0,35,2
1746605826145,MATH 197,001,957876,Kedlaya; Kiran S.,9993,0,9999,6
1746605827170,MCWP 40,A00,892729,Duru; Nur,10,0,20,10
1746605827170,MCWP 40,B00,893304,Montejo; Carolina,14,0,20,6
1746605828195,MCWP 40R,A00,893757,Redela; Pamela Morgan,0,5,20,20
1746605829223,MCWP 50,A00,893758,Morshed; Michael James,0,0,20,20
1746605829223,MCWP 50,B00,893761,Bartulis; Jason Michael,16,0,20,4
1746605830256,MCWP 50R,A00,893766,Compas; Sean Matthew,0,1,20,20
1746605830256,MCWP 50R,B00,893769,Carter; Jennifer A,0,1,20,20
1746605830256,MCWP 50R,C00,893771,Krone; Jarret,0,3,20,20
1746605830256,MCWP 50R,D00,893772,Miller; Elizabeth Deen,0,0,20,20
1746605830256,MCWP 50R,E00,893775,Carter; Andrea L,0,1,20,20
1746605831284,MMW 11R,A01,892721,Herbst; Matthew,14,0,30,16
1746605831284,MMW 11R,A02,892722,Herbst; Matthew,0,0,0,3
1746605832315,MMW 12R,A01,892724,Herbst; Matthew,0,11,16,16
1746605832315,MMW 12R,A02,892725,Herbst; Matthew,0,10,16,16
1746605833342,MMW 13R,A01,892727,Staff,0,4,16,16
1746605833342,MMW 13R,A02,892728,Staff,0,4,16,16
1746605833342,MMW 13R,A03,958032,Staff,0,4,16,16
1746605833342,MMW 13R,A04,958033,Staff,0,4,16,16
1746605833342,MMW 13R,A05,958034,Staff,0,4,16,16
1746605834367,SIO 295LS,A00,894015,Staff,5,0,25,20
1746605835393,SIO 295S,A00,894020,Staff,5,0,25,20
1746605836423,SIOC 290S,B01,958918,Merrifield; Mark A,14,0,30,16
1746605837451,SIOC 291S,B01,958922,Gabriel; Corey John,14,0,30,16
1746605838478,SOCI 117,A01,895339,Staff,2,0,5,3
1746605839505,WES 237B,A00,894149,Staff,11,0,20,9
1746605841570,AESE 279B,A00,891859,Staff,13,0,35,22
1746605842600,AIP 197,001,891854,Vespa; Emanuel Ignacio,9999,0,9999,0
1746605843625,ANTH 289S,A00,891856,Gagneux; Pascal,12,0,12,0
1746605844652,BENG 196,001,957946,Engler; Adam J.,9996,0,9999,3
1746605845676,BISP 197,001,959851,Wilhelm; James E.,9998,0,9999,1
1746605846702,CAT 124RS,A01,956906,Staff,6,0,25,19
1746605847728,CAT 125RS,A01,922013,Staff,6,0,25,19
1746605848758,CLRE 250,A00,891860,Morris; Sheldon,9995,0,9999,4
1746605850811,CLRE 251R,A00,907817,Mehta; Ravindra L.,9994,0,9999,5
1746605851836,CLRE 252,A00,891864,Cuomo; Raphael Eduardo,9993,0,9999,6
1746605852864,CLRE 253,A00,891867,Vaida; Florin,9994,0,9999,5
1746605852864,CLRE 253,B00,907819,Staff,9999,0,9999,0
1746605853891,CLRE 259,A00,891868,Patel; Hemal,9998,0,9999,1
1746605854917,CLRE 260,A00,891872,Cuomo; Raphael Eduardo,9999,0,9999,0
1746605855944,CLRE 297,001,891888,Cuomo; Raphael Eduardo,9999,0,9999,0
1746605856974,CSE 191,A00,958773,Minnes Kemp; Mor Mia,9995,0,9999,4
1746605858001,CSE 197,001,959846,Minnes Kemp; Mor Mia,9990,0,9999,9
1746605859029,CSS 201S,A01,892054,Mignozzetti; Umberto,25,0,30,5
1746605860062,CSS 202S,A01,892056,Mignozzetti; Umberto,25,0,30,5
1746605861088,DSC 197,001,956898,Eldridge; Justin Matthew,9996,0,9999,3
1746605862117,DSC 297,001,958000,Mazumdar; Arya,9998,0,9999,1
1746605862117,DSC 297,002,959862,Wang; Yusu,9998,0,9999,1
1746605863184,EAP 100,A00,905686,Staff,9778,0,9999,221
1746605864215,ECE 45,A01,892618,Staff,0,0,65,65
1746605866268,ECE 111,A01,892719,Staff,6,0,65,59
1746605867297,ECE 197,001,957920,Mercier; Patrick Philip,9991,0,9999,8
1746605868323,ECON 178,A01,907814,Zhu; Ying,26,0,35,9
1746605869349,EDS 115,A00,895312,Staff,35,0,45,10
1746605870377,EDS 117,A01,895337,Staff,23,0,30,7
1746605871406,EDS 125,A00,895341,Jones; Gabrielle Anastasia,36,0,45,9
1746605872435,EDS 128A,A01,895459,Fargason; Sharon Gayle,44,0,45,1
1746605873464,EDS 128B,A01,895543,Pappas; Elizabeth,44,0,45,1
1746605874491,EDS 139,A00,897203,Pappas; Elizabeth,44,0,45,1
1746605874491,EDS 139,B00,897209,Fargason; Sharon Gayle,41,0,45,4
1746605875516,EDS 201,A00,895545,Staff,22,0,45,23
1746605876544,EDS 203,A01,895581,Halter; Christopher P.,22,0,45,23
1746605877571,EDS 204R,A01,895625,Heinzman; Erica M.,39,0,45,6
1746605877571,EDS 204R,B01,895693,Halter; Christopher P.,10,0,45,35
1746605878599,EDS 206R,A00,895694,Fargason; Sharon Gayle,1,0,30,29
1746605878599,EDS 206R,B00,895695,Choi; Bailey Miyeon,16,0,30,14
1746605879626,EDS 250,A00,895697,Hemans; Patricia Ann Benitez,22,0,45,23
1746605880655,EDS 281,A00,895701,Meyerott; Theresa Ann,1,0,15,14
1746605881682,EDS 284,A00,895736,Meyerott; Theresa Ann,1,0,15,14
1746605882711,EDS 286,A00,897210,Fine; Sarah,0,0,15,15
1746605883737,EDS 289C,A01,895770,Daly; Alan J.,1,0,15,14
1746605884762,EDS 290,A00,897211,Hofstetter; Carolyn,0,0,15,15
1746605885793,LIGM 5A,A00,896162,Fischer-Grunski; Eva K,12,0,20,8
1746605886820,LIGM 5B,A00,896260,Fischer-Grunski; Eva K,17,0,20,3
1746605887850,LIGM 5C,A00,896308,Fischer-Grunski; Eva K,18,0,20,2
1746605888875,LIIT 5AS,A00,896313,Carnelos; Chiara,18,0,20,2
1746605889901,LIIT 5BS,A00,896416,Carnelos; Chiara,20,0,20,0
1746605890929,LIIT 5CS,A00,896564,Carnelos; Chiara,20,0,20,0
1746605891959,LISP 5A,A00,896588,Munoz Sanchez; Alicia,2,0,20,18
1746605892985,LISP 5B,A00,896653,Munoz Sanchez; Alicia,7,0,20,13
1746605894016,LISP 5C,A00,896655,Munoz Sanchez; Alicia,0,1,20,20
1746605895040,MAE 197,001,957918,Kleissl; Jan,9996,0,9999,3
1746605895040,MAE 197,002,959806,Boechler; Nicholas Sebastia,9998,0,9999,1
1746605895040,MAE 197,003,959852,Mullin; Jennifer S,9998,0,9999,1
1746605896067,MATH 2,A01,957937,Staff,33,0,35,2
1746605897092,MATH 197,001,957876,Kedlaya; Kiran S.,9993,0,9999,6
1746605898120,MCWP 40,A00,892729,Duru; Nur,10,0,20,10
1746605898120,MCWP 40,B00,893304,Montejo; Carolina,14,0,20,6
1746605899146,MCWP 40R,A00,893757,Redela; Pamela Morgan,0,5,20,20
1746605900176,MCWP 50,A00,893758,Morshed; Michael James,0,0,20,20
1746605900176,MCWP 50,B00,893761,Bartulis; Jason Michael,16,0,20,4
1746605901202,MCWP 50R,A00,893766,Compas; Sean Matthew,0,1,20,20
1746605901202,MCWP 50R,B00,893769,Carter; Jennifer A,0,1,20,20
1746605901202,MCWP 50R,C00,893771,Krone; Jarret,0,3,20,20
1746605901202,MCWP 50R,D00,893772,Miller; Elizabeth Deen,0,0,20,20
1746605901202,MCWP 50R,E00,893775,Carter; Andrea L,0,1,20,20
1746605902229,MMW 11R,A01,892721,Herbst; Matthew,14,0,30,16
1746605902229,MMW 11R,A02,892722,Herbst; Matthew,0,0,0,3
1746605903256,MMW 12R,A01,892724,Herbst; Matthew,0,11,16,16
1746605903256,MMW 12R,A02,892725,Herbst; Matthew,0,10,16,16
1746605904286,MMW 13R,A01,892727,Staff,0,4,16,16
1746605904286,MMW 13R,A02,892728,Staff,0,4,16,16
1746605904286,MMW 13R,A03,958032,Staff,0,4,16,16
1746605904286,MMW 13R,A04,958033,Staff,0,4,16,16
1746605904286,MMW 13R,A05,958034,Staff,0,4,16,16
1746605905315,SIO 295LS,A00,894015,Staff,5,0,25,20
1746605906349,SIO 295S,A00,894020,Staff,5,0,25,20
1746605907377,SIOC 290S,B01,958918,Merrifield; Mark A,14,0,30,16
1746605908405,SIOC 291S,B01,958922,Gabriel; Corey John,14,0,30,16
1746605909433,SOCI 117,A01,895339,Staff,2,0,5,3
1746605910462,WES 237B,A00,894149,Staff,11,0,20,9
1746605912536,AESE 279B,A00,891859,Staff,13,0,35,22
1746605913562,AIP 197,001,891854,Vespa; Emanuel Ignacio,9999,0,9999,0
1746605914586,ANTH 289S,A00,891856,Gagneux; Pascal,12,0,12,0
1746605915613,BENG 196,001,957946,Engler; Adam J.,9996,0,9999,3
1746605916641,BISP 197,001,959851,Wilhelm; James E.,9998,0,9999,1
1746605917667,CAT 124RS,A01,956906,Staff,6,0,25,19
1746605918696,CAT 125RS,A01,922013,Staff,6,0,25,19
1746605919722,CLRE 250,A00,891860,Morris; Sheldon,9995,0,9999,4
1746605921779,CLRE 251R,A00,907817,Mehta; Ravindra L.,9994,0,9999,5
1746605922808,CLRE 252,A00,891864,Cuomo; Raphael Eduardo,9993,0,9999,6
1746605923834,CLRE 253,A00,891867,Vaida; Florin,9994,0,9999,5
1746605923834,CLRE 253,B00,907819,Staff,9999,0,9999,0
1746605924864,CLRE 259,A00,891868,Patel; Hemal,9998,0,9999,1
1746605925890,CLRE 260,A00,891872,Cuomo; Raphael Eduardo,9999,0,9999,0
1746605926919,CLRE 297,001,891888,Cuomo; Raphael Eduardo,9999,0,9999,0
1746605927946,CSE 191,A00,958773,Minnes Kemp; Mor Mia,9995,0,9999,4
1746605928976,CSE 197,001,959846,Minnes Kemp; Mor Mia,9990,0,9999,9
1746605930002,CSS 201S,A01,892054,Mignozzetti; Umberto,25,0,30,5
1746605931031,CSS 202S,A01,892056,Mignozzetti; Umberto,25,0,30,5
1746605932058,DSC 197,001,956898,Eldridge; Justin Matthew,9996,0,9999,3
1746605933085,DSC 297,001,958000,Mazumdar; Arya,9998,0,9999,1
1746605933085,DSC 297,002,959862,Wang; Yusu,9998,0,9999,1
1746605934110,EAP 100,A00,905686,Staff,9778,0,9999,221
1746605935138,ECE 45,A01,892618,Staff,0,0,65,65
1746605937190,ECE 111,A01,892719,Staff,6,0,65,59
1746605938218,ECE 197,001,957920,Mercier; Patrick Philip,9991,0,9999,8
1746605939247,ECON 178,A01,907814,Zhu; Ying,26,0,35,9
1746605940272,EDS 115,A00,895312,Staff,35,0,45,10
1746605941302,EDS 117,A01,895337,Staff,23,0,30,7
1746605942332,EDS 125,A00,895341,Jones; Gabrielle Anastasia,36,0,45,9
1746605943366,EDS 128A,A01,895459,Fargason; Sharon Gayle,44,0,45,1
1746605944391,EDS 128B,A01,895543,Pappas; Elizabeth,44,0,45,1
1746605945419,EDS 139,A00,897203,Pappas; Elizabeth,44,0,45,1
1746605945419,EDS 139,B00,897209,Fargason; Sharon Gayle,41,0,45,4
1746605946446,EDS 201,A00,895545,Staff,22,0,45,23
1746605947480,EDS 203,A01,895581,Halter; Christopher P.,22,0,45,23
1746605948510,EDS 204R,A01,895625,Heinzman; Erica M.,39,0,45,6
1746605948510,EDS 204R,B01,895693,Halter; Christopher P.,10,0,45,35
1746605949543,EDS 206R,A00,895694,Fargason; Sharon Gayle,1,0,30,29
1746605949543,EDS 206R,B00,895695,Choi; Bailey Miyeon,16,0,30,14
1746605950573,EDS 250,A00,895697,Hemans; Patricia Ann Benitez,22,0,45,23
1746605951605,EDS 281,A00,895701,Meyerott; Theresa Ann,1,0,15,14
1746605952635,EDS 284,A00,895736,Meyerott; Theresa Ann,1,0,15,14
1746605953665,EDS 286,A00,897210,Fine; Sarah,0,0,15,15
1746605954691,EDS 289C,A01,895770,Daly; Alan J.,1,0,15,14
1746605955718,EDS 290,A00,897211,Hofstetter; Carolyn,0,0,15,15
1746605956747,LIGM 5A,A00,896162,Fischer-Grunski; Eva K,12,0,20,8
1746605957777,LIGM 5B,A00,896260,Fischer-Grunski; Eva K,17,0,20,3
1746605958803,LIGM 5C,A00,896308,Fischer-Grunski; Eva K,18,0,20,2
1746605959829,LIIT 5AS,A00,896313,Carnelos; Chiara,18,0,20,2
1746605960855,LIIT 5BS,A00,896416,Carnelos; Chiara,20,0,20,0
1746605961881,LIIT 5CS,A00,896564,Carnelos; Chiara,20,0,20,0
1746605962906,LISP 5A,A00,896588,Munoz Sanchez; Alicia,2,0,20,18
1746605963930,LISP 5B,A00,896653,Munoz Sanchez; Alicia,7,0,20,13
1746605964960,LISP 5C,A00,896655,Munoz Sanchez; Alicia,0,1,20,20
1746605965990,MAE 197,001,957918,Kleissl; Jan,9996,0,9999,3
1746605965990,MAE 197,002,959806,Boechler; Nicholas Sebastia,9998,0,9999,1
1746605965990,MAE 197,003,959852,Mullin; Jennifer S,9998,0,9999,1
1746605967074,MATH 2,A01,957937,Staff,33,0,35,2
1746605968104,MATH 197,001,957876,Kedlaya; Kiran S.,9993,0,9999,6
1746605969136,MCWP 40,A00,892729,Duru; Nur,10,0,20,10
1746605969136,MCWP 40,B00,893304,Montejo; Carolina,14,0,20,6
1746605970165,MCWP 40R,A00,893757,Redela; Pamela Morgan,0,5,20,20
1746605971193,MCWP 50,A00,893758,Morshed; Michael James,0,0,20,20
1746605971193,MCWP 50,B00,893761,Bartulis; Jason Michael,16,0,20,4
1746605972221,MCWP 50R,A00,893766,Compas; Sean Matthew,0,1,20,20
1746605972221,MCWP 50R,B00,893769,Carter; Jennifer A,0,1,20,20
1746605972221,MCWP 50R,C00,893771,Krone; Jarret,0,3,20,20
1746605972221,MCWP 50R,D00,893772,Miller; Elizabeth Deen,0,0,20,20
1746605972221,MCWP 50R,E00,893775,Carter; Andrea L,0,1,20,20
1746605973247,MMW 11R,A01,892721,Herbst; Matthew,14,0,30,16
1746605973247,MMW 11R,A02,892722,Herbst; Matthew,0,0,0,3
1746605974275,MMW 12R,A01,892724,Herbst; Matthew,0,11,16,16
1746605974275,MMW 12R,A02,892725,Herbst; Matthew,0,10,16,16
1746605975304,MMW 13R,A01,892727,Staff,0,4,16,16
1746605975304,MMW 13R,A02,892728,Staff,0,4,16,16
1746605975304,MMW 13R,A03,958032,Staff,0,4,16,16
1746605975304,MMW 13R,A04,958033,Staff,0,4,16,16
1746605975304,MMW 13R,A05,958034,Staff,0,4,16,16
1746605976333,SIO 295LS,A00,894015,Staff,5,0,25,20
1746605977359,SIO 295S,A00,894020,Staff,5,0,25,20
1746605978389,SIOC 290S,B01,958918,Merrifield; Mark A,14,0,30,16
1746605979417,SIOC 291S,B01,958922,Gabriel; Corey John,14,0,30,16
1746605980447,SOCI 117,A01,895339,Staff,2,0,5,3
1746605981475,WES 237B,A00,894149,Staff,11,0,20,9
1746605983559,AESE 279B,A00,891859,Staff,13,0,35,22
1746605984584,AIP 197,001,891854,Vespa; Emanuel Ignacio,9999,0,9999,0
1746605985613,ANTH 289S,A00,891856,Gagneux; Pascal,12,0,12,0
1746605986641,BENG 196,001,957946,Engler; Adam J.,9996,0,9999,3
1746605987670,BISP 197,001,959851,Wilhelm; James E.,9998,0,9999,1
1746605988695,CAT 124RS,A01,956906,Staff,6,0,25,19
1746605989725,CAT 125RS,A01,922013,Staff,6,0,25,19
1746605990751,CLRE 250,A00,891860,Morris; Sheldon,9995,0,9999,4
1746605992809,CLRE 251R,A00,907817,Mehta; Ravindra L.,9994,0,9999,5
1746605993836,CLRE 252,A00,891864,Cuomo; Raphael Eduardo,9993,0,9999,6
1746605994867,CLRE 253,A00,891867,Vaida; Florin,9994,0,9999,5
1746605994867,CLRE 253,B00,907819,Staff,9999,0,9999,0
1746605995893,CLRE 259,A00,891868,Patel; Hemal,9998,0,9999,1
1746605996920,CLRE 260,A00,891872,Cuomo; Raphael Eduardo,9999,0,9999,0
1746605997948,CLRE 297,001,891888,Cuomo; Raphael Eduardo,9999,0,9999,0
1746605998980,CSE 191,A00,958773,Minnes Kemp; Mor Mia,9995,0,9999,4
1746606000013,CSE 197,001,959846,Minnes Kemp; Mor Mia,9990,0,9999,9
1746606001045,CSS 201S,A01,892054,Mignozzetti; Umberto,25,0,30,5
1746606002078,CSS 202S,A01,892056,Mignozzetti; Umberto,25,0,30,5
1746606003109,DSC 197,001,956898,Eldridge; Justin Matthew,9996,0,9999,3
1746606004133,DSC 297,001,958000,Mazumdar; Arya,9998,0,9999,1
1746606004133,DSC 297,002,959862,Wang; Yusu,9998,0,9999,1
1746606005163,EAP 100,A00,905686,Staff,9778,0,9999,221
1746606006188,ECE 45,A01,892618,Staff,0,0,65,65
1746606008245,ECE 111,A01,892719,Staff,6,0,65,59
1746606009273,ECE 197,001,957920,Mercier; Patrick Philip,9991,0,9999,8
1746606010298,ECON 178,A01,907814,Zhu; Ying,26,0,35,9
1746606011326,EDS 115,A00,895312,Staff,35,0,45,10
1746606012353,EDS 117,A01,895337,Staff,23,0,30,7
1746606013380,EDS 125,A00,895341,Jones; Gabrielle Anastasia,36,0,45,9
1746606014411,EDS 128A,A01,895459,Fargason; Sharon Gayle,44,0,45,1
1746606015436,EDS 128B,A01,895543,Pappas; Elizabeth,44,0,45,1
1746606016462,EDS 139,A00,897203,Pappas; Elizabeth,44,0,45,1
1746606016462,EDS 139,B00,897209,Fargason; Sharon Gayle,41,0,45,4
1746606017492,EDS 201,A00,895545,Staff,22,0,45,23
1746606018521,EDS 203,A01,895581,Halter; Christopher P.,22,0,45,23
1746606019551,EDS 204R,A01,895625,Heinzman; Erica M.,39,0,45,6
1746606019551,EDS 204R,B01,895693,Halter; Christopher P.,10,0,45,35
1746606020582,EDS 206R,A00,895694,Fargason; Sharon Gayle,1,0,30,29
1746606020582,EDS 206R,B00,895695,Choi; Bailey Miyeon,16,0,30,14
1746606021609,EDS 250,A00,895697,Hemans; Patricia Ann Benitez,22,0,45,23
1746606022636,EDS 281,A00,895701,Meyerott; Theresa Ann,1,0,15,14
1746606023665,EDS 284,A00,895736,Meyerott; Theresa Ann,1,0,15,14
1746606024693,EDS 286,A00,897210,Fine; Sarah,0,0,15,15
1746606025719,EDS 289C,A01,895770,Daly; Alan J.,1,0,15,14
1746606026745,EDS 290,A00,897211,Hofstetter; Carolyn,0,0,15,15
1746606027774,LIGM 5A,A00,896162,Fischer-Grunski; Eva K,12,0,20,8
1746606028805,LIGM 5B,A00,896260,Fischer-Grunski; Eva K,17,0,20,3
1746606029832,LIGM 5C,A00,896308,Fischer-Grunski; Eva K,18,0,20,2
1746606030861,LIIT 5AS,A00,896313,Carnelos; Chiara,18,0,20,2
1746606031886,LIIT 5BS,A00,896416,Carnelos; Chiara,20,0,20,0
1746606032915,LIIT 5CS,A00,896564,Carnelos; Chiara,20,0,20,0
1746606033947,LISP 5A,A00,896588,Munoz Sanchez; Alicia,2,0,20,18
1746606034982,LISP 5B,A00,896653,Munoz Sanchez; Alicia,7,0,20,13
1746606036012,LISP 5C,A00,896655,Munoz Sanchez; Alicia,0,1,20,20
1746606037041,MAE 197,001,957918,Kleissl; Jan,9996,0,9999,3
1746606037041,MAE 197,002,959806,Boechler; Nicholas Sebastia,9998,0,9999,1
1746606037041,MAE 197,003,959852,Mullin; Jennifer S,9998,0,9999,1
1746606038068,MATH 2,A01,957937,Staff,33,0,35,2
1746606039095,MATH 197,001,957876,Kedlaya; Kiran S.,9993,0,9999,6
1746606040127,MCWP 40,A00,892729,Duru; Nur,10,0,20,10
1746606040127,MCWP 40,B00,893304,Montejo; Carolina,14,0,20,6
1746606041155,MCWP 40R,A00,893757,Redela; Pamela Morgan,0,5,20,20
1746606042185,MCWP 50,A00,893758,Morshed; Michael James,0,0,20,20
1746606042185,MCWP 50,B00,893761,Bartulis; Jason Michael,16,0,20,4
1746606043217,MCWP 50R,A00,893766,Compas; Sean Matthew,0,1,20,20
1746606043217,MCWP 50R,B00,893769,Carter; Jennifer A,0,1,20,20
1746606043217,MCWP 50R,C00,893771,Krone; Jarret,0,3,20,20
1746606043217,MCWP 50R,D00,893772,Miller; Elizabeth Deen,0,0,20,20
1746606043217,MCWP 50R,E00,893775,Carter; Andrea L,0,1,20,20
1746606044244,MMW 11R,A01,892721,Herbst; Matthew,14,0,30,16
1746606044244,MMW 11R,A02,892722,Herbst; Matthew,0,0,0,3
1746606045275,MMW 12R,A01,892724,Herbst; Matthew,0,11,16,16
1746606045275,MMW 12R,A02,892725,Herbst; Matthew,0,10,16,16
1746606046301,MMW 13R,A01,892727,Staff,0,4,16,16
1746606046301,MMW 13R,A02,892728,Staff,0,4,16,16
1746606046301,MMW 13R,A03,958032,Staff,0,4,16,16
1746606046301,MMW 13R,A04,958033,Staff,0,4,16,16
1746606046301,MMW 13R,A05,958034,Staff,0,4,16,16
1746606047327,SIO 295LS,A00,894015,Staff,5,0,25,20
1746606048357,SIO 295S,A00,894020,Staff,5,0,25,20
1746606049383,SIOC 290S,B01,958918,Merrifield; Mark A,14,0,30,16
1746606050413,SIOC 291S,B01,958922,Gabriel; Corey John,14,0,30,16
1746606051440,SOCI 117,A01,895339,Staff,2,0,5,3
1746606052466,WES 237B,A00,894149,Staff,11,0,20,9
1746606054547,AESE 279B,A00,891859,Staff,13,0,35,22
1746606055577,AIP 197,001,891854,Vespa; Emanuel Ignacio,9999,0,9999,0
1746606056605,ANTH 289S,A00,891856,Gagneux; Pascal,12,0,12,0
1746606057632,BENG 196,001,957946,Engler; Adam J.,9996,0,9999,3
1746606058657,BISP 197,001,959851,Wilhelm; James E.,9998,0,9999,1
1746606059683,CAT 124RS,A01,956906,Staff,6,0,25,19
1746606060711,CAT 125RS,A01,922013,Staff,6,0,25,19
1746606061739,CLRE 250,A00,891860,Morris; Sheldon,9995,0,9999,4
1746606063796,CLRE 251R,A00,907817,Mehta; Ravindra L.,9994,0,9999,5
1746606064823,CLRE 252,A00,891864,Cuomo; Raphael Eduardo,9993,0,9999,6
1746606065850,CLRE 253,A00,891867,Vaida; Florin,9994,0,9999,5
1746606065850,CLRE 253,B00,907819,Staff,9999,0,9999,0
1746606066876,CLRE 259,A00,891868,Patel; Hemal,9998,0,9999,1
1746606067903,CLRE 260,A00,891872,Cuomo; Raphael Eduardo,9999,0,9999,0
1746606068929,CLRE 297,001,891888,Cuomo; Raphael Eduardo,9999,0,9999,0
1746606069961,CSE 191,A00,958773,Minnes Kemp; Mor Mia,9995,0,9999,4
1746606070989,CSE 197,001,959846,Minnes Kemp; Mor Mia,9990,0,9999,9
1746606072014,CSS 201S,A01,892054,Mignozzetti; Umberto,25,0,30,5
1746606073043,CSS 202S,A01,892056,Mignozzetti; Umberto,25,0,30,5
1746606074068,DSC 197,001,956898,Eldridge; Justin Matthew,9996,0,9999,3
1746606075094,DSC 297,001,958000,Mazumdar; Arya,9998,0,9999,1
1746606075094,DSC 297,002,959862,Wang; Yusu,9998,0,9999,1
1746606076123,EAP 100,A00,905686,Staff,9778,0,9999,221
1746606077154,ECE 45,A01,892618,Staff,0,0,65,65
1746606079207,ECE 111,A01,892719,Staff,6,0,65,59
1746606080234,ECE 197,001,957920,Mercier; Patrick Philip,9991,0,9999,8
1746606081262,ECON 178,A01,907814,Zhu; Ying,26,0,35,9
1746606082286,EDS 115,A00,895312,Staff,35,0,45,10
1746606083311,EDS 117,A01,895337,Staff,23,0,30,7
1746606084338,EDS 125,A00,895341,Jones; Gabrielle Anastasia,36,0,45,9
1746606085364,EDS 128A,A01,895459,Fargason; Sharon Gayle,44,0,45,1
1746606086390,EDS 128B,A01,895543,Pappas; Elizabeth,44,0,45,1
1746606087416,EDS 139,A00,897203,Pappas; Elizabeth,44,0,45,1
1746606087416,EDS 139,B00,897209,Fargason; Sharon Gayle,41,0,45,4
1746606088441,EDS 201,A00,895545,Staff,22,0,45,23
1746606089470,EDS 203,A01,895581,Halter; Christopher P.,22,0,45,23
1746606090499,EDS 204R,A01,895625,Heinzman; Erica M.,39,0,45,6
1746606090499,EDS 204R,B01,895693,Halter; Christopher P.,10,0,45,35
1746606091528,EDS 206R,A00,895694,Fargason; Sharon Gayle,1,0,30,29
1746606091528,EDS 206R,B00,895695,Choi; Bailey Miyeon,16,0,30,14
1746606092557,EDS 250,A00,895697,Hemans; Patricia Ann Benitez,22,0,45,23
1746606093583,EDS 281,A00,895701,Meyerott; Theresa Ann,1,0,15,14
1746606094612,EDS 284,A00,895736,Meyerott; Theresa Ann,1,0,15,14
1746606095641,EDS 286,A00,897210,Fine; Sarah,0,0,15,15
1746606096667,EDS 289C,A01,895770,Daly; Alan J.,1,0,15,14
1746606097695,EDS 290,A00,897211,Hofstetter; Carolyn,0,0,15,15
1746606098724,LIGM 5A,A00,896162,Fischer-Grunski; Eva K,12,0,20,8
1746606099755,LIGM 5B,A00,896260,Fischer-Grunski; Eva K,17,0,20,3
1746606100781,LIGM 5C,A00,896308,Fischer-Grunski; Eva K,18,0,20,2
1746606101811,LIIT 5AS,A00,896313,Carnelos; Chiara,18,0,20,2
1746606102838,LIIT 5BS,A00,896416,Carnelos; Chiara,20,0,20,0
1746606103865,LIIT 5CS,A00,896564,Carnelos; Chiara,20,0,20,0
1746606104893,LISP 5A,A00,896588,Munoz Sanchez; Alicia,2,0,20,18
1746606105922,LISP 5B,A00,896653,Munoz Sanchez; Alicia,7,0,20,13
1746606106951,LISP 5C,A00,896655,Munoz Sanchez; Alicia,0,1,20,20
1746606107978,MAE 197,001,957918,Kleissl; Jan,9996,0,9999,3
1746606107978,MAE 197,002,959806,Boechler; Nicholas Sebastia,9998,0,9999,1
1746606107978,MAE 197,003,959852,Mullin; Jennifer S,9998,0,9999,1
1746606109005,MATH 2,A01,957937,Staff,33,0,35,2
1746606110037,MATH 197,001,957876,Kedlaya; Kiran S.,9993,0,9999,6
1746606111067,MCWP 40,A00,892729,Duru; Nur,10,0,20,10
1746606111067,MCWP 40,B00,893304,Montejo; Carolina,14,0,20,6
1746606112096,MCWP 40R,A00,893757,Redela; Pamela Morgan,0,5,20,20
1746606113126,MCWP 50,A00,893758,Morshed; Michael James,0,0,20,20
1746606113126,MCWP 50,B00,893761,Bartulis; Jason Michael,16,0,20,4
1746606114155,MCWP 50R,A00,893766,Compas; Sean Matthew,0,1,20,20
1746606114155,MCWP 50R,B00,893769,Carter; Jennifer A,0,1,20,20
1746606114155,MCWP 50R,C00,893771,Krone; Jarret,0,3,20,20
1746606114155,MCWP 50R,D00,893772,Miller; Elizabeth Deen,0,0,20,20
1746606114155,MCWP 50R,E00,893775,Carter; Andrea L,0,1,20,20
1746606115186,MMW 11R,A01,892721,Herbst; Matthew,14,0,30,16
1746606115186,MMW 11R,A02,892722,Herbst; Matthew,0,0,0,3
1746606116211,MMW 12R,A01,892724,Herbst; Matthew,0,11,16,16
1746606116211,MMW 12R,A02,892725,Herbst; Matthew,0,10,16,16
1746606117243,MMW 13R,A01,892727,Staff,0,4,16,16
1746606117243,MMW 13R,A02,892728,Staff,0,4,16,16
1746606117243,MMW 13R,A03,958032,Staff,0,4,16,16
1746606117243,MMW 13R,A04,958033,Staff,0,4,16,16
1746606117243,MMW 13R,A05,958034,Staff,0,4,16,16
1746606118271,SIO 295LS,A00,894015,Staff,5,0,25,20
1746606119297,SIO 295S,A00,894020,Staff,5,0,25,20
1746606120329,SIOC 290S,B01,958918,Merrifield; Mark A,14,0,30,16
1746606121354,SIOC 291S,B01,958922,Gabriel; Corey John,14,0,30,16
1746606122379,SOCI 117,A01,895339,Staff,2,0,5,3
1746606123408,WES 237B,A00,894149,Staff,11,0,20,9
1746606125480,AESE 279B,A00,891859,Staff,13,0,35,22
1746606126510,AIP 197,001,891854,Vespa; Emanuel Ignacio,9999,0,9999,0
1746606127540,ANTH 289S,A00,891856,Gagneux; Pascal,12,0,12,0
1746606128621,BENG 196,001,957946,Engler; Adam J.,9996,0,9999,3
1746606129646,BISP 197,001,959851,Wilhelm; James E.,9998,0,9999,1
1746606130676,CAT 124RS,A01,956906,Staff,6,0,25,19
1746606131705,CAT 125RS,A01,922013,Staff,6,0,25,19
1746606132734,CLRE 250,A00,891860,Morris; Sheldon,9995,0,9999,4
1746606134787,CLRE 251R,A00,907817,Mehta; Ravindra L.,9994,0,9999,5
1746606135815,CLRE 252,A00,891864,Cuomo; Raphael Eduardo,9993,0,9999,6
1746606136842,CLRE 253,A00,891867,Vaida; Florin,9994,0,9999,5
1746606136842,CLRE 253,B00,907819,Staff,9999,0,9999,0
1746606137868,CLRE 259,A00,891868,Patel; Hemal,9998,0,9999,1
1746606138895,CLRE 260,A00,891872,Cuomo; Raphael Eduardo,9999,0,9999,0
1746606139921,CLRE 297,001,891888,Cuomo; Raphael Eduardo,9999,0,9999,0
1746606140948,CSE 191,A00,958773,Minnes Kemp; Mor Mia,9995,0,9999,4
1746606141978,CSE 197,001,959846,Minnes Kemp; Mor Mia,9990,0,9999,9
1746606143010,CSS 201S,A01,892054,Mignozzetti; Umberto,25,0,30,5
1746606144037,CSS 202S,A01,892056,Mignozzetti; Umberto,25,0,30,5
1746606145064,DSC 197,001,956898,Eldridge; Justin Matthew,9996,0,9999,3
1746606146093,DSC 297,001,958000,Mazumdar; Arya,9998,0,9999,1
1746606146093,DSC 297,002,959862,Wang; Yusu,9998,0,9999,1
1746606147118,EAP 100,A00,905686,Staff,9778,0,9999,221
1746606148147,ECE 45,A01,892618,Staff,0,0,65,65
1746606150199,ECE 111,A01,892719,Staff,6,0,65,59
1746606151228,ECE 197,001,957920,Mercier; Patrick Philip,9991,0,9999,8
1746606152259,ECON 178,A01,907814,Zhu; Ying,26,0,35,9
1746606153284,EDS 115,A00,895312,Staff,35,0,45,10
1746606154314,EDS 117,A01,895337,Staff,23,0,30,7
1746606155345,EDS 125,A00,895341,Jones; Gabrielle Anastasia,36,0,45,9
1746606156376,EDS 128A,A01,895459,Fargason; Sharon Gayle,44,0,45,1
1746606157405,EDS 128B,A01,895543,Pappas; Elizabeth,44,0,45,1
1746606158434,EDS 139,A00,897203,Pappas; Elizabeth,44,0,45,1
1746606158434,EDS 139,B00,897209,Fargason; Sharon Gayle,41,0,45,4
1746606159459,EDS 201,A00,895545,Staff,22,0,45,23
1746606160485,EDS 203,A01,895581,Halter; Christopher P.,22,0,45,23
1746606161516,EDS 204R,A01,895625,Heinzman; Erica M.,39,0,45,6
1746606161516,EDS 204R,B01,895693,Halter; Christopher P.,10,0,45,35
1746606162544,EDS 206R,A00,895694,Fargason; Sharon Gayle,1,0,30,29
1746606162544,EDS 206R,B00,895695,Choi; Bailey Miyeon,16,0,30,14
1746606163569,EDS 250,A00,895697,Hemans; Patricia Ann Benitez,22,0,45,23
1746606164597,EDS 281,A00,895701,Meyerott; Theresa Ann,1,0,15,14
1746606165626,EDS 284,A00,895736,Meyerott; Theresa Ann,1,0,15,14
1746606166654,EDS 286,A00,897210,Fine; Sarah,0,0,15,15
1746606167681,EDS 289C,A01,895770,Daly; Alan J.,1,0,15,14
1746606168710,EDS 290,A00,897211,Hofstetter; Carolyn,0,0,15,15
1746606169742,LIGM 5A,A00,896162,Fischer-Grunski; Eva K,12,0,20,8
1746606170767,LIGM 5B,A00,896260,Fischer-Grunski; Eva K,17,0,20,3
1746606171798,LIGM 5C,A00,896308,Fischer-Grunski; Eva K,18,0,20,2
1746606172823,LIIT 5AS,A00,896313,Carnelos; Chiara,18,0,20,2
1746606173849,LIIT 5BS,A00,896416,Carnelos; Chiara,20,0,20,0
1746606174875,LIIT 5CS,A00,896564,Carnelos; Chiara,20,0,20,0
1746606175899,LISP 5A,A00,896588,Munoz Sanchez; Alicia,2,0,20,18
1746606176927,LISP 5B,A00,896653,Munoz Sanchez; Alicia,7,0,20,13
1746606177956,LISP 5C,A00,896655,Munoz Sanchez; Alicia,0,1,20,20
1746606178982,MAE 197,001,957918,Kleissl; Jan,9996,0,9999,3
1746606178982,MAE 197,002,959806,Boechler; Nicholas Sebastia,9998,0,9999,1
1746606178982,MAE 197,003,959852,Mullin; Jennifer S,9998,0,9999,1
1746606180008,MATH 2,A01,957937,Staff,33,0,35,2
1746606181032,MATH 197,001,957876,Kedlaya; Kiran S.,9993,0,9999,6
1746606182060,MCWP 40,A00,892729,Duru; Nur,10,0,20,10
1746606182060,MCWP 40,B00,893304,Montejo; Carolina,14,0,20,6
1746606183090,MCWP 40R,A00,893757,Redela; Pamela Morgan,0,5,20,20
1746606184121,MCWP 50,A00,893758,Morshed; Michael James,0,0,20,20
1746606184121,MCWP 50,B00,893761,Bartulis; Jason Michael,16,0,20,4
1746606185147,MCWP 50R,A00,893766,Compas; Sean Matthew,0,1,20,20
1746606185147,MCWP 50R,B00,893769,Carter; Jennifer A,0,1,20,20
1746606185147,MCWP 50R,C00,893771,Krone; Jarret,0,3,20,20
1746606185147,MCWP 50R,D00,893772,Miller; Elizabeth Deen,0,0,20,20
1746606185147,MCWP 50R,E00,893775,Carter; Andrea L,0,1,20,20
1746606186176,MMW 11R,A01,892721,Herbst; Matthew,14,0,30,16
1746606186176,MMW 11R,A02,892722,Herbst; Matthew,0,0,0,3
1746606187204,MMW 12R,A01,892724,Herbst; Matthew,0,11,16,16
1746606187204,MMW 12R,A02,892725,Herbst; Matthew,0,10,16,16
1746606188230,MMW 13R,A01,892727,Staff,0,4,16,16
1746606188230,MMW 13R,A02,892728,Staff,0,4,16,16
1746606188230,MMW 13R,A03,958032,Staff,0,4,16,16
1746606188230,MMW 13R,A04,958033,Staff,0,4,16,16
1746606188230,MMW 13R,A05,958034,Staff,0,4,16,16
1746606189258,SIO 295LS,A00,894015,Staff,5,0,25,20
1746606190287,SIO 295S,A00,894020,Staff,5,0,25,20
1746606191313,SIOC 290S,B01,958918,Merrifield; Mark A,14,0,30,16
1746606192339,SIOC 291S,B01,958922,Gabriel; Corey John,14,0,30,16
1746606193364,SOCI 117,A01,895339,Staff,2,0,5,3
1746606194391,WES 237B,A00,894149,Staff,11,0,20,9
1746606196457,AESE 279B,A00,891859,Staff,13,0,35,22
1746606197483,AIP 197,001,891854,Vespa; Emanuel Ignacio,9999,0,9999,0
1746606198509,ANTH 289S,A00,891856,Gagneux; Pascal,12,0,12,0
1746606199534,BENG 196,001,957946,Engler; Adam J.,9996,0,9999,3
1746606200564,BISP 197,001,959851,Wilhelm; James E.,9998,0,9999,1
1746606201588,CAT 124RS,A01,956906,Staff,6,0,25,19
1746606202616,CAT 125RS,A01,922013,Staff,6,0,25,19
1746606203647,CLRE 250,A00,891860,Morris; Sheldon,9995,0,9999,4
1746606205700,CLRE 251R,A00,907817,Mehta; Ravindra L.,9994,0,9999,5
1746606206725,CLRE 252,A00,891864,Cuomo; Raphael Eduardo,9993,0,9999,6
1746606207753,CLRE 253,A00,891867,Vaida; Florin,9994,0,9999,5
1746606207753,CLRE 253,B00,907819,Staff,9999,0,9999,0
1746606208781,CLRE 259,A00,891868,Patel; Hemal,9998,0,9999,1
1746606209808,CLRE 260,A00,891872,Cuomo; Raphael Eduardo,9999,0,9999,0
1746606210838,CLRE 297,001,891888,Cuomo; Raphael Eduardo,9999,0,9999,0
1746606211866,CSE 191,A00,958773,Minnes Kemp; Mor Mia,9995,0,9999,4
1746606212892,CSE 197,001,959846,Minnes Kemp; Mor Mia,9990,0,9999,9
1746606213923,CSS 201S,A01,892054,Mignozzetti; Umberto,25,0,30,5
1746606214949,CSS 202S,A01,892056,Mignozzetti; Umberto,25,0,30,5
1746606215975,DSC 197,001,956898,Eldridge; Justin Matthew,9996,0,9999,3
1746606217002,DSC 297,001,958000,Mazumdar; Arya,9998,0,9999,1
1746606217002,DSC 297,002,959862,Wang; Yusu,9998,0,9999,1
1746606218027,EAP 100,A00,905686,Staff,9778,0,9999,221
1746606219057,ECE 45,A01,892618,Staff,0,0,65,65
1746606221113,ECE 111,A01,892719,Staff,6,0,65,59
1746606222139,ECE 197,001,957920,Mercier; Patrick Philip,9991,0,9999,8
1746606223169,ECON 178,A01,907814,Zhu; Ying,26,0,35,9
1746606224200,EDS 115,A00,895312,Staff,35,0,45,10
1746606225225,EDS 117,A01,895337,Staff,23,0,30,7
1746606226254,EDS 125,A00,895341,Jones; Gabrielle Anastasia,36,0,45,9
1746606227282,EDS 128A,A01,895459,Fargason; Sharon Gayle,44,0,45,1
1746606228307,EDS 128B,A01,895543,Pappas; Elizabeth,44,0,45,1
1746606229334,EDS 139,A00,897203,Pappas; Elizabeth,44,0,45,1
1746606229334,EDS 139,B00,897209,Fargason; Sharon Gayle,41,0,45,4
1746606230363,EDS 201,A00,895545,Staff,22,0,45,23
1746606231390,EDS 203,A01,895581,Halter; Christopher P.,22,0,45,23
1746606232471,EDS 204R,A01,895625,Heinzman; Erica M.,39,0,45,6
1746606232471,EDS 204R,B01,895693,Halter; Christopher P.,10,0,45,35
1746606233501,EDS 206R,A00,895694,Fargason; Sharon Gayle,1,0,30,29
1746606233501,EDS 206R,B00,895695,Choi; Bailey Miyeon,16,0,30,14
1746606234530,EDS 250,A00,895697,Hemans; Patricia Ann Benitez,22,0,45,23
1746606235557,EDS 281,A00,895701,Meyerott; Theresa Ann,1,0,15,14
1746606236583,EDS 284,A00,895736,Meyerott; Theresa Ann,1,0,15,14
1746606237610,EDS 286,A00,897210,Fine; Sarah,0,0,15,15
1746606238639,EDS 289C,A01,895770,Daly; Alan J.,1,0,15,14
1746606239666,EDS 290,A00,897211,Hofstetter; Carolyn,0,0,15,15
1746606240692,LIGM 5A,A00,896162,Fischer-Grunski; Eva K,12,0,20,8
1746606241718,LIGM 5B,A00,896260,Fischer-Grunski; Eva K,17,0,20,3
1746606242745,LIGM 5C,A00,896308,Fischer-Grunski; Eva K,18,0,20,2
1746606243771,LIIT 5AS,A00,896313,Carnelos; Chiara,18,0,20,2
1746606244801,LIIT 5BS,A00,896416,Carnelos; Chiara,20,0,20,0
1746606245827,LIIT 5CS,A00,896564,Carnelos; Chiara,20,0,20,0
1746606246856,LISP 5A,A00,896588,Munoz Sanchez; Alicia,2,0,20,18
1746606247882,LISP 5B,A00,896653,Munoz Sanchez; Alicia,7,0,20,13
1746606248906,LISP 5C,A00,896655,Munoz Sanchez; Alicia,0,1,20,20
1746606249935,MAE 197,001,957918,Kleissl; Jan,9996,0,9999,3
1746606249935,MAE 197,002,959806,Boechler; Nicholas Sebastia,9998,0,9999,1
1746606249935,MAE 197,003,959852,Mullin; Jennifer S,9998,0,9999,1
1746606250961,MATH 2,A01,957937,Staff,33,0,35,2
1746606251988,MATH 197,001,957876,Kedlaya; Kiran S.,9993,0,9999,6
1746606253017,MCWP 40,A00,892729,Duru; Nur,10,0,20,10
1746606253017,MCWP 40,B00,893304,Montejo; Carolina,14,0,20,6
1746606254043,MCWP 40R,A00,893757,Redela; Pamela Morgan,0,5,20,20
1746606255075,MCWP 50,A00,893758,Morshed; Michael James,0,0,20,20
1746606255075,MCWP 50,B00,893761,Bartulis; Jason Michael,16,0,20,4
1746606256101,MCWP 50R,A00,893766,Compas; Sean Matthew,0,1,20,20
1746606256101,MCWP 50R,B00,893769,Carter; Jennifer A,0,1,20,20
1746606256101,MCWP 50R,C00,893771,Krone; Jarret,0,3,20,20
1746606256101,MCWP 50R,D00,893772,Miller; Elizabeth Deen,0,0,20,20
1746606256101,MCWP 50R,E00,893775,Carter; Andrea L,0,1,20,20
1746606257129,MMW 11R,A01,892721,Herbst; Matthew,14,0,30,16
1746606257129,MMW 11R,A02,892722,Herbst; Matthew,0,0,0,3
1746606258154,MMW 12R,A01,892724,Herbst; Matthew,0,11,16,16
1746606258154,MMW 12R,A02,892725,Herbst; Matthew,0,10,16,16
1746606259178,MMW 13R,A01,892727,Staff,0,4,16,16
1746606259178,MMW 13R,A02,892728,Staff,0,4,16,16
1746606259178,MMW 13R,A03,958032,Staff,0,4,16,16
1746606259178,MMW 13R,A04,958033,Staff,0,4,16,16
1746606259178,MMW 13R,A05,958034,Staff,0,4,16,16
1746606260203,SIO 295LS,A00,894015,Staff,5,0,25,20
1746606261228,SIO 295S,A00,894020,Staff,5,0,25,20
1746606262262,SIOC 290S,B01,958918,Merrifield; Mark A,14,0,30,16
1746606263289,SIOC 291S,B01,958922,Gabriel; Corey John,14,0,30,16
1746606264317,SOCI 117,A01,895339,Staff,2,0,5,3
1746606265342,WES 237B,A00,894149,Staff,11,0,20,9
1746606267409,AESE 279B,A00,891859,Staff,13,0,35,22
1746606268434,AIP 197,001,891854,Vespa; Emanuel Ignacio,9999,0,9999,0
1746606269460,ANTH 289S,A00,891856,Gagneux; Pascal,12,0,12,0
1746606270487,BENG 196,001,957946,Engler; Adam J.,9996,0,9999,3
1746606271511,BISP 197,001,959851,Wilhelm; James E.,9998,0,9999,1
1746606272542,CAT 124RS,A01,956906,Staff,6,0,25,19
1746606273569,CAT 125RS,A01,922013,Staff,6,0,25,19
1746606274596,CLRE 250,A00,891860,Morris; Sheldon,9995,0,9999,4
1746606276654,CLRE 251R,A00,907817,Mehta; Ravindra L.,9994,0,9999,5
1746606277682,CLRE 252,A00,891864,Cuomo; Raphael Eduardo,9993,0,9999,6
1746606278707,CLRE 253,A00,891867,Vaida; Florin,9994,0,9999,5
1746606278707,CLRE 253,B00,907819,Staff,9999,0,9999,0
1746606279737,CLRE 259,A00,891868,Patel; Hemal,9998,0,9999,1
1746606280766,CLRE 260,A00,891872,Cuomo; Raphael Eduardo,9999,0,9999,0
1746606281793,CLRE 297,001,891888,Cuomo; Raphael Eduardo,9999,0,9999,0
1746606282821,CSE 191,A00,958773,Minnes Kemp; Mor Mia,9995,0,9999,4
1746606283852,CSE 197,001,959846,Minnes Kemp; Mor Mia,9990,0,9999,9
1746606284884,CSS 201S,A01,892054,Mignozzetti; Umberto,25,0,30,5
1746606285910,CSS 202S,A01,892056,Mignozzetti; Umberto,25,0,30,5
1746606286937,DSC 197,001,956898,Eldridge; Justin Matthew,9996,0,9999,3
1746606287964,DSC 297,001,958000,Mazumdar; Arya,9998,0,9999,1
1746606287964,DSC 297,002,959862,Wang; Yusu,9998,0,9999,1
1746606288989,EAP 100,A00,905686,Staff,9778,0,9999,221
1746606290025,ECE 45,A01,892618,Staff,0,0,65,65
1746606292081,ECE 111,A01,892719,Staff,6,0,65,59
1746606293108,ECE 197,001,957920,Mercier; Patrick Philip,9991,0,9999,8
1746606294133,ECON 178,A01,907814,Zhu; Ying,26,0,35,9
1746606295162,EDS 115,A00,895312,Staff,35,0,45,10
1746606296189,EDS 117,A01,895337,Staff,23,0,30,7
1746606297219,EDS 125,A00,895341,Jones; Gabrielle Anastasia,36,0,45,9
1746606298247,EDS 128A,A01,895459,Fargason; Sharon Gayle,44,0,45,1
1746606299274,EDS 128B,A01,895543,Pappas; Elizabeth,44,0,45,1
1746606300301,EDS 139,A00,897203,Pappas; Elizabeth,44,0,45,1
1746606300301,EDS 139,B00,897209,Fargason; Sharon Gayle,41,0,45,4
1746606301329,EDS 201,A00,895545,Staff,22,0,45,23
1746606302356,EDS 203,A01,895581,Halter; Christopher P.,22,0,45,23
1746606303386,EDS 204R,A01,895625,Heinzman; Erica M.,39,0,45,6
1746606303386,EDS 204R,B01,895693,Halter; Christopher P.,10,0,45,35
1746606304414,EDS 206R,A00,895694,Fargason; Sharon Gayle,1,0,30,29
1746606304414,EDS 206R,B00,895695,Choi; Bailey Miyeon,16,0,30,14
1746606305439,EDS 250,A00,895697,Hemans; Patricia Ann Benitez,22,0,45,23
1746606306468,EDS 281,A00,895701,Meyerott; Theresa Ann,1,0,15,14
1746606307497,EDS 284,A00,895736,Meyerott; Theresa Ann,1,0,15,14
1746606308523,EDS 286,A00,897210,Fine; Sarah,0,0,15,15
1746606309553,EDS 289C,A01,895770,Daly; Alan J.,1,0,15,14
1746606310581,EDS 290,A00,897211,Hofstetter; Carolyn,0,0,15,15
1746606311611,LIGM 5A,A00,896162,Fischer-Grunski; Eva K,12,0,20,8
1746606312637,LIGM 5B,A00,896260,Fischer-Grunski; Eva K,17,0,20,3
1746606313664,LIGM 5C,A00,896308,Fischer-Grunski; Eva K,18,0,20,2
1746606314694,LIIT 5AS,A00,896313,Carnelos; Chiara,18,0,20,2
1746606315724,LIIT 5BS,A00,896416,Carnelos; Chiara,20,0,20,0
1746606316754,LIIT 5CS,A00,896564,Carnelos; Chiara,20,0,20,0
1746606317780,LISP 5A,A00,896588,Munoz Sanchez; Alicia,2,0,20,18
1746606318807,LISP 5B,A00,896653,Munoz Sanchez; Alicia,7,0,20,13
1746606319834,LISP 5C,A00,896655,Munoz Sanchez; Alicia,0,1,20,20
1746606320860,MAE 197,001,957918,Kleissl; Jan,9996,0,9999,3
1746606320860,MAE 197,002,959806,Boechler; Nicholas Sebastia,9998,0,9999,1
1746606320860,MAE 197,003,959852,Mullin; Jennifer S,9998,0,9999,1
1746606321887,MATH 2,A01,957937,Staff,33,0,35,2
1746606322915,MATH 197,001,957876,Kedlaya; Kiran S.,9993,0,9999,6
1746606323941,MCWP 40,A00,892729,Duru; Nur,10,0,20,10
1746606323941,MCWP 40,B00,893304,Montejo; Carolina,14,0,20,6
1746606324973,MCWP 40R,A00,893757,Redela; Pamela Morgan,0,5,20,20
1746606326000,MCWP 50,A00,893758,Morshed; Michael James,0,0,20,20
1746606326000,MCWP 50,B00,893761,Bartulis; Jason Michael,16,0,20,4
1746606327031,MCWP 50R,A00,893766,Compas; Sean Matthew,0,1,20,20
1746606327031,MCWP 50R,B00,893769,Carter; Jennifer A,0,1,20,20
1746606327031,MCWP 50R,C00,893771,Krone; Jarret,0,3,20,20
1746606327031,MCWP 50R,D00,893772,Miller; Elizabeth Deen,0,0,20,20
1746606327031,MCWP 50R,E00,893775,Carter; Andrea L,0,1,20,20
1746606328058,MMW 11R,A01,892721,Herbst; Matthew,14,0,30,16
1746606328058,MMW 11R,A02,892722,Herbst; Matthew,0,0,0,3
1746606329086,MMW 12R,A01,892724,Herbst; Matthew,0,11,16,16
1746606329086,MMW 12R,A02,892725,Herbst; Matthew,0,10,16,16
1746606330116,MMW 13R,A01,892727,Staff,0,4,16,16
1746606330116,MMW 13R,A02,892728,Staff,0,4,16,16
1746606330116,MMW 13R,A03,958032,Staff,0,4,16,16
1746606330116,MMW 13R,A04,958033,Staff,0,4,16,16
1746606330116,MMW 13R,A05,958034,Staff,0,4,16,16
1746606331144,SIO 295LS,A00,894015,Staff,5,0,25,20
1746606332170,SIO 295S,A00,894020,Staff,5,0,25,20
1746606333202,SIOC 290S,B01,958918,Merrifield; Mark A,14,0,30,16
1746606334227,SIOC 291S,B01,958922,Gabriel; Corey John,14,0,30,16
1746606335256,SOCI 117,A01,895339,Staff,2,0,5,3
1746606336339,WES 237B,A00,894149,Staff,11,0,20,9
1746606338420,AESE 279B,A00,891859,Staff,13,0,35,22
1746606339447,AIP 197,001,891854,Vespa; Emanuel Ignacio,9999,0,9999,0
1746606340474,ANTH 289S,A00,891856,Gagneux; Pascal,12,0,12,0
1746606341500,BENG 196,001,957946,Engler; Adam J.,9996,0,9999,3
1746606342526,BISP 197,001,959851,Wilhelm; James E.,9998,0,9999,1
1746606343552,CAT 124RS,A01,956906,Staff,6,0,25,19
1746606344579,CAT 125RS,A01,922013,Staff,6,0,25,19
1746606345606,CLRE 250,A00,891860,Morris; Sheldon,9995,0,9999,4
1746606347658,CLRE 251R,A00,907817,Mehta; Ravindra L.,9994,0,9999,5
1746606348685,CLRE 252,A00,891864,Cuomo; Raphael Eduardo,9993,0,9999,6
1746606349715,CLRE 253,A00,891867,Vaida; Florin,9994,0,9999,5
1746606349715,CLRE 253,B00,907819,Staff,9999,0,9999,0
1746606350744,CLRE 259,A00,891868,Patel; Hemal,9998,0,9999,1
1746606351771,CLRE 260,A00,891872,Cuomo; Raphael Eduardo,9999,0,9999,0
1746606352800,CLRE 297,001,891888,Cuomo; Raphael Eduardo,9999,0,9999,0
1746606353829,CSE 191,A00,958773,Minnes Kemp; Mor Mia,9995,0,9999,4
1746606354860,CSE 197,001,959846,Minnes Kemp; Mor Mia,9990,0,9999,9
1746606355887,CSS 201S,A01,892054,Mignozzetti; Umberto,25,0,30,5
1746606356914,CSS 202S,A01,892056,Mignozzetti; Umberto,25,0,30,5
1746606357942,DSC 197,001,956898,Eldridge; Justin Matthew,9996,0,9999,3
1746606358968,DSC 297,001,958000,Mazumdar; Arya,9998,0,9999,1
1746606358968,DSC 297,002,959862,Wang; Yusu,9998,0,9999,1
1746606359995,EAP 100,A00,905686,Staff,9778,0,9999,221
1746606361021,ECE 45,A01,892618,Staff,0,0,65,65
1746606363078,ECE 111,A01,892719,Staff,6,0,65,59
1746606364102,ECE 197,001,957920,Mercier; Patrick Philip,9991,0,9999,8
1746606365153,ECON 178,A01,907814,Zhu; Ying,26,0,35,9
1746606366177,EDS 115,A00,895312,Staff,35,0,45,10
1746606367201,EDS 117,A01,895337,Staff,23,0,30,7
1746606368254,EDS 125,A00,895341,Jones; Gabrielle Anastasia,36,0,45,9
1746606369282,EDS 128A,A01,895459,Fargason; Sharon Gayle,44,0,45,1
1746606370314,EDS 128B,A01,895543,Pappas; Elizabeth,44,0,45,1
1746606371339,EDS 139,A00,897203,Pappas; Elizabeth,44,0,45,1
1746606371339,EDS 139,B00,897209,Fargason; Sharon Gayle,41,0,45,4
1746606372365,EDS 201,A00,895545,Staff,22,0,45,23
1746606373389,EDS 203,A01,895581,Halter; Christopher P.,22,0,45,23
1746606374414,EDS 204R,A01,895625,Heinzman; Erica M.,39,0,45,6
1746606374414,EDS 204R,B01,895693,Halter; Christopher P.,10,0,45,35
1746606375479,EDS 206R,A00,895694,Fargason; Sharon Gayle,1,0,30,29
1746606375479,EDS 206R,B00,895695,Choi; Bailey Miyeon,16,0,30,14
1746606376504,EDS 250,A00,895697,Hemans; Patricia Ann Benitez,22,0,45,23
1746606377531,EDS 281,A00,895701,Meyerott; Theresa Ann,1,0,15,14
1746606378557,EDS 284,A00,895736,Meyerott; Theresa Ann,1,0,15,14
1746606379582,EDS 286,A00,897210,Fine; Sarah,0,0,15,15
1746606380704,EDS 289C,A01,895770,Daly; Alan J.,1,0,15,14
1746606381736,EDS 290,A00,897211,Hofstetter; Carolyn,0,0,15,15
1746606382763,LIGM 5A,A00,896162,Fischer-Grunski; Eva K,12,0,20,8
1746606383846,LIGM 5B,A00,896260,Fischer-Grunski; Eva K,17,0,20,3
1746606384871,LIGM 5C,A00,896308,Fischer-Grunski; Eva K,18,0,20,2
1746606385898,LIIT 5AS,A00,896313,Carnelos; Chiara,18,0,20,2
1746606386926,LIIT 5BS,A00,896416,Carnelos; Chiara,20,0,20,0
1746606388004,LIIT 5CS,A00,896564,Carnelos; Chiara,20,0,20,0
1746606389029,LISP 5A,A00,896588,Munoz Sanchez; Alicia,2,0,20,18
1746606390059,LISP 5B,A00,896653,Munoz Sanchez; Alicia,7,0,20,13
1746606391088,LISP 5C,A00,896655,Munoz Sanchez; Alicia,0,1,20,20
1746606392112,MAE 197,001,957918,Kleissl; Jan,9996,0,9999,3
1746606392112,MAE 197,002,959806,Boechler; Nicholas Sebastia,9998,0,9999,1
1746606392112,MAE 197,003,959852,Mullin; Jennifer S,9998,0,9999,1
1746606393240,MATH 2,A01,957937,Staff,33,0,35,2
1746606394265,MATH 197,001,957876,Kedlaya; Kiran S.,9993,0,9999,6
1746606395291,MCWP 40,A00,892729,Duru; Nur,10,0,20,10
1746606395291,MCWP 40,B00,893304,Montejo; Carolina,14,0,20,6
1746606396337,MCWP 40R,A00,893757,Redela; Pamela Morgan,0,5,20,20
1746606397362,MCWP 50,A00,893758,Morshed; Michael James,0,0,20,20
1746606397362,MCWP 50,B00,893761,Bartulis; Jason Michael,16,0,20,4
1746606398393,MCWP 50R,A00,893766,Compas; Sean Matthew,0,1,20,20
1746606398393,MCWP 50R,B00,893769,Carter; Jennifer A,0,1,20,20
1746606398393,MCWP 50R,C00,893771,Krone; Jarret,0,3,20,20
1746606398393,MCWP 50R,D00,893772,Miller; Elizabeth Deen,0,0,20,20
1746606398393,MCWP 50R,E00,893775,Carter; Andrea L,0,1,20,20
1746606399420,MMW 11R,A01,892721,Herbst; Matthew,14,0,30,16
1746606399420,MMW 11R,A02,892722,Herbst; Matthew,0,0,0,3
1746606400444,MMW 12R,A01,892724,Herbst; Matthew,0,11,16,16
1746606400444,MMW 12R,A02,892725,Herbst; Matthew,0,10,16,16
1746606401475,MMW 13R,A01,892727,Staff,0,4,16,16
1746606401475,MMW 13R,A02,892728,Staff,0,4,16,16
1746606401475,MMW 13R,A03,958032,Staff,0,4,16,16
1746606401475,MMW 13R,A04,958033,Staff,0,4,16,16
1746606401475,MMW 13R,A05,958034,Staff,0,4,16,16
1746606402504,SIO 295LS,A00,894015,Staff,5,0,25,20
1746606403530,SIO 295S,A00,894020,Staff,5,0,25,20
1746606404562,SIOC 290S,B01,958918,Merrifield; Mark A,14,0,30,16
1746606405595,SIOC 291S,B01,958922,Gabriel; Corey John,14,0,30,16
1746606406622,SOCI 117,A01,895339,Staff,2,0,5,3
1746606407651,WES 237B,A00,894149,Staff,11,0,20,9
1746606409736,AESE 279B,A00,891859,Staff,13,0,35,22
1746606410762,AIP 197,001,891854,Vespa; Emanuel Ignacio,9999,0,9999,0
1746606411791,ANTH 289S,A00,891856,Gagneux; Pascal,12,0,12,0
1746606412817,BENG 196,001,957946,Engler; Adam J.,9996,0,9999,3
1746606413849,BISP 197,001,959851,Wilhelm; James E.,9998,0,9999,1
1746606414875,CAT 124RS,A01,956906,Staff,6,0,25,19
1746606415904,CAT 125RS,A01,922013,Staff,6,0,25,19
1746606416930,CLRE 250,A00,891860,Morris; Sheldon,9995,0,9999,4
1746606418982,CLRE 251R,A00,907817,Mehta; Ravindra L.,9994,0,9999,5
1746606420018,CLRE 252,A00,891864,Cuomo; Raphael Eduardo,9993,0,9999,6
1746606421056,CLRE 253,A00,891867,Vaida; Florin,9994,0,9999,5
1746606421056,CLRE 253,B00,907819,Staff,9999,0,9999,0
1746606422083,CLRE 259,A00,891868,Patel; Hemal,9998,0,9999,1
1746606423113,CLRE 260,A00,891872,Cuomo; Raphael Eduardo,9999,0,9999,0
1746606424140,CLRE 297,001,891888,Cuomo; Raphael Eduardo,9999,0,9999,0
1746606425168,CSE 191,A00,958773,Minnes Kemp; Mor Mia,9995,0,9999,4
1746606426195,CSE 197,001,959846,Minnes Kemp; Mor Mia,9990,0,9999,9
1746606427222,CSS 201S,A01,892054,Mignozzetti; Umberto,25,0,30,5
1746606428253,CSS 202S,A01,892056,Mignozzetti; Umberto,25,0,30,5
1746606429279,DSC 197,001,956898,Eldridge; Justin Matthew,9996,0,9999,3
1746606430305,DSC 297,001,958000,Mazumdar; Arya,9998,0,9999,1
1746606430305,DSC 297,002,959862,Wang; Yusu,9998,0,9999,1
1746606431332,EAP 100,A00,905686,Staff,9778,0,9999,221
1746606432362,ECE 45,A01,892618,Staff,0,0,65,65
1746606434419,ECE 111,A01,892719,Staff,6,0,65,59
1746606435449,ECE 197,001,957920,Mercier; Patrick Philip,9991,0,9999,8
1746606436479,ECON 178,A01,907814,Zhu; Ying,26,0,35,9
1746606437507,EDS 115,A00,895312,Staff,35,0,45,10
1746606438532,EDS 117,A01,895337,Staff,23,0,30,7
1746606439562,EDS 125,A00,895341,Jones; Gabrielle Anastasia,36,0,45,9
1746606440590,EDS 128A,A01,895459,Fargason; Sharon Gayle,44,0,45,1
1746606441618,EDS 128B,A01,895543,Pappas; Elizabeth,44,0,45,1
1746606442645,EDS 139,A00,897203,Pappas; Elizabeth,44,0,45,1
1746606442645,EDS 139,B00,897209,Fargason; Sharon Gayle,41,0,45,4
1746606443674,EDS 201,A00,895545,Staff,22,0,45,23
1746606444698,EDS 203,A01,895581,Halter; Christopher P.,22,0,45,23
1746606445729,EDS 204R,A01,895625,Heinzman; Erica M.,39,0,45,6
1746606445729,EDS 204R,B01,895693,Halter; Christopher P.,10,0,45,35
1746606446758,EDS 206R,A00,895694,Fargason; Sharon Gayle,1,0,30,29
1746606446758,EDS 206R,B00,895695,Choi; Bailey Miyeon,16,0,30,14
1746606447784,EDS 250,A00,895697,Hemans; Patricia Ann Benitez,22,0,45,23
1746606448812,EDS 281,A00,895701,Meyerott; Theresa Ann,1,0,15,14
1746606449838,EDS 284,A00,895736,Meyerott; Theresa Ann,1,0,15,14
1746606450864,EDS 286,A00,897210,Fine; Sarah,0,0,15,15
1746606451891,EDS 289C,A01,895770,Daly; Alan J.,1,0,15,14
1746606452915,EDS 290,A00,897211,Hofstetter; Carolyn,0,0,15,15
1746606453943,LIGM 5A,A00,896162,Fischer-Grunski; Eva K,12,0,20,8
1746606454979,LIGM 5B,A00,896260,Fischer-Grunski; Eva K,17,0,20,3
1746606456004,LIGM 5C,A00,896308,Fischer-Grunski; Eva K,18,0,20,2
1746606457030,LIIT 5AS,A00,896313,Carnelos; Chiara,18,0,20,2
1746606458057,LIIT 5BS,A00,896416,Carnelos; Chiara,20,0,20,0
1746606459086,LIIT 5CS,A00,896564,Carnelos; Chiara,20,0,20,0
1746606460119,LISP 5A,A00,896588,Munoz Sanchez; Alicia,2,0,20,18
1746606461148,LISP 5B,A00,896653,Munoz Sanchez; Alicia,7,0,20,13
1746606462177,LISP 5C,A00,896655,Munoz Sanchez; Alicia,0,1,20,20
1746606463204,MAE 197,001,957918,Kleissl; Jan,9996,0,9999,3
1746606463204,MAE 197,002,959806,Boechler; Nicholas Sebastia,9998,0,9999,1
1746606463204,MAE 197,003,959852,Mullin; Jennifer S,9998,0,9999,1
1746606464234,MATH 2,A01,957937,Staff,33,0,35,2
1746606465263,MATH 197,001,957876,Kedlaya; Kiran S.,9993,0,9999,6
1746606466289,MCWP 40,A00,892729,Duru; Nur,10,0,20,10
1746606466289,MCWP 40,B00,893304,Montejo; Carolina,14,0,20,6
1746606467318,MCWP 40R,A00,893757,Redela; Pamela Morgan,0,5,20,20
1746606468350,MCWP 50,A00,893758,Morshed; Michael James,0,0,20,20
1746606468350,MCWP 50,B00,893761,Bartulis; Jason Michael,16,0,20,4
1746606469383,MCWP 50R,A00,893766,Compas; Sean Matthew,0,1,20,20
1746606469383,MCWP 50R,B00,893769,Carter; Jennifer A,0,1,20,20
1746606469383,MCWP 50R,C00,893771,Krone; Jarret,0,3,20,20
1746606469383,MCWP 50R,D00,893772,Miller; Elizabeth Deen,0,0,20,20
1746606469383,MCWP 50R,E00,893775,Carter; Andrea L,0,1,20,20
1746606470410,MMW 11R,A01,892721,Herbst; Matthew,14,0,30,16
1746606470410,MMW 11R,A02,892722,Herbst; Matthew,0,0,0,3
1746606471439,MMW 12R,A01,892724,Herbst; Matthew,0,11,16,16
1746606471439,MMW 12R,A02,892725,Herbst; Matthew,0,10,16,16
1746606472465,MMW 13R,A01,892727,Staff,0,4,16,16
1746606472465,MMW 13R,A02,892728,Staff,0,4,16,16
1746606472465,MMW 13R,A03,958032,Staff,0,4,16,16
1746606472465,MMW 13R,A04,958033,Staff,0,4,16,16
1746606472465,MMW 13R,A05,958034,Staff,0,4,16,16
1746606473489,SIO 295LS,A00,894015,Staff,5,0,25,20
1746606474517,SIO 295S,A00,894020,Staff,5,0,25,20
1746606475544,SIOC 290S,B01,958918,Merrifield; Mark A,14,0,30,16
1746606476573,SIOC 291S,B01,958922,Gabriel; Corey John,14,0,30,16
1746606477599,SOCI 117,A01,895339,Staff,2,0,5,3
1746606478626,WES 237B,A00,894149,Staff,11,0,20,9
1746606480720,AESE 279B,A00,891859,Staff,13,0,35,22
1746606481750,AIP 197,001,891854,Vespa; Emanuel Ignacio,9999,0,9999,0
1746606482778,ANTH 289S,A00,891856,Gagneux; Pascal,12,0,12,0
1746606483806,BENG 196,001,957946,Engler; Adam J.,9996,0,9999,3
1746606484833,BISP 197,001,959851,Wilhelm; James E.,9998,0,9999,1
1746606485863,CAT 124RS,A01,956906,Staff,6,0,25,19
1746606486889,CAT 125RS,A01,922013,Staff,6,0,25,19
1746606487918,CLRE 250,A00,891860,Morris; Sheldon,9995,0,9999,4
1746606489977,CLRE 251R,A00,907817,Mehta; Ravindra L.,9994,0,9999,5
1746606491003,CLRE 252,A00,891864,Cuomo; Raphael Eduardo,9993,0,9999,6
1746606492030,CLRE 253,A00,891867,Vaida; Florin,9994,0,9999,5
1746606492030,CLRE 253,B00,907819,Staff,9999,0,9999,0
1746606493055,CLRE 259,A00,891868,Patel; Hemal,9998,0,9999,1
1746606494083,CLRE 260,A00,891872,Cuomo; Raphael Eduardo,9999,0,9999,0
1746606495112,CLRE 297,001,891888,Cuomo; Raphael Eduardo,9999,0,9999,0
1746606496136,CSE 191,A00,958773,Minnes Kemp; Mor Mia,9995,0,9999,4
1746606497162,CSE 197,001,959846,Minnes Kemp; Mor Mia,9990,0,9999,9
1746606498192,CSS 201S,A01,892054,Mignozzetti; Umberto,25,0,30,5
1746606499221,CSS 202S,A01,892056,Mignozzetti; Umberto,25,0,30,5
1746606500249,DSC 197,001,956898,Eldridge; Justin Matthew,9996,0,9999,3
1746606501275,DSC 297,001,958000,Mazumdar; Arya,9998,0,9999,1
1746606501275,DSC 297,002,959862,Wang; Yusu,9998,0,9999,1
1746606502303,EAP 100,A00,905686,Staff,9778,0,9999,221
1746606503396,ECE 45,A01,892618,Staff,0,0,65,65
1746606505449,ECE 111,A01,892719,Staff,6,0,65,59
1746606506477,ECE 197,001,957920,Mercier; Patrick Philip,9991,0,9999,8
1746606507504,ECON 178,A01,907814,Zhu; Ying,26,0,35,9
1746606508532,EDS 115,A00,895312,Staff,35,0,45,10
1746606509560,EDS 117,A01,895337,Staff,23,0,30,7
1746606510591,EDS 125,A00,895341,Jones; Gabrielle Anastasia,36,0,45,9
1746606511616,EDS 128A,A01,895459,Fargason; Sharon Gayle,44,0,45,1
1746606512643,EDS 128B,A01,895543,Pappas; Elizabeth,44,0,45,1
1746606513673,EDS 139,A00,897203,Pappas; Elizabeth,44,0,45,1
1746606513673,EDS 139,B00,897209,Fargason; Sharon Gayle,41,0,45,4
1746606514702,EDS 201,A00,895545,Staff,22,0,45,23
1746606515731,EDS 203,A01,895581,Halter; Christopher P.,22,0,45,23
1746606516761,EDS 204R,A01,895625,Heinzman; Erica M.,39,0,45,6
1746606516761,EDS 204R,B01,895693,Halter; Christopher P.,10,0,45,35
1746606517790,EDS 206R,A00,895694,Fargason; Sharon Gayle,1,0,30,29
1746606517790,EDS 206R,B00,895695,Choi; Bailey Miyeon,16,0,30,14
1746606518821,EDS 250,A00,895697,Hemans; Patricia Ann Benitez,22,0,45,23
1746606519851,EDS 281,A00,895701,Meyerott; Theresa Ann,1,0,15,14
1746606520876,EDS 284,A00,895736,Meyerott; Theresa Ann,1,0,15,14
1746606521901,EDS 286,A00,897210,Fine; Sarah,0,0,15,15
1746606522929,EDS 289C,A01,895770,Daly; Alan J.,1,0,15,14
1746606523957,EDS 290,A00,897211,Hofstetter; Carolyn,0,0,15,15
1746606524985,LIGM 5A,A00,896162,Fischer-Grunski; Eva K,12,0,20,8
1746606526215,LIGM 5B,A00,896260,Fischer-Grunski; Eva K,17,0,20,3
1746606527245,LIGM 5C,A00,896308,Fischer-Grunski; Eva K,18,0,20,2
1746606528275,LIIT 5AS,A00,896313,Carnelos; Chiara,18,0,20,2
1746606529304,LIIT 5BS,A00,896416,Carnelos; Chiara,20,0,20,0
1746606530335,LIIT 5CS,A00,896564,Carnelos; Chiara,20,0,20,0
1746606531362,LISP 5A,A00,896588,Munoz Sanchez; Alicia,2,0,20,18
1746606532398,LISP 5B,A00,896653,Munoz Sanchez; Alicia,7,0,20,13
1746606533431,LISP 5C,A00,896655,Munoz Sanchez; Alicia,0,1,20,20
1746606534461,MAE 197,001,957918,Kleissl; Jan,9996,0,9999,3
1746606534461,MAE 197,002,959806,Boechler; Nicholas Sebastia,9998,0,9999,1
1746606534461,MAE 197,003,959852,Mullin; Jennifer S,9998,0,9999,1
1746606535489,MATH 2,A01,957937,Staff,33,0,35,2
1746606536520,MATH 197,001,957876,Kedlaya; Kiran S.,9993,0,9999,6
1746606537548,MCWP 40,A00,892729,Duru; Nur,10,0,20,10
1746606537548,MCWP 40,B00,893304,Montejo; Carolina,14,0,20,6
1746606538582,MCWP 40R,A00,893757,Redela; Pamela Morgan,0,5,20,20
1746606539611,MCWP 50,A00,893758,Morshed; Michael James,0,0,20,20
1746606539611,MCWP 50,B00,893761,Bartulis; Jason Michael,16,0,20,4
1746606540641,MCWP 50R,A00,893766,Compas; Sean Matthew,0,1,20,20
1746606540641,MCWP 50R,B00,893769,Carter; Jennifer A,0,1,20,20
1746606540641,MCWP 50R,C00,893771,Krone; Jarret,0,3,20,20
1746606540641,MCWP 50R,D00,893772,Miller; Elizabeth Deen,0,0,20,20
1746606540641,MCWP 50R,E00,893775,Carter; Andrea L,0,1,20,20
1746606541669,MMW 11R,A01,892721,Herbst; Matthew,14,0,30,16
1746606541669,MMW 11R,A02,892722,Herbst; Matthew,0,0,0,3
1746606542699,MMW 12R,A01,892724,Herbst; Matthew,0,11,16,16
1746606542699,MMW 12R,A02,892725,Herbst; Matthew,0,10,16,16
1746606543729,MMW 13R,A01,892727,Staff,0,4,16,16
1746606543729,MMW 13R,A02,892728,Staff,0,4,16,16
1746606543729,MMW 13R,A03,958032,Staff,0,4,16,16
1746606543729,MMW 13R,A04,958033,Staff,0,4,16,16
1746606543729,MMW 13R,A05,958034,Staff,0,4,16,16
1746606544756,SIO 295LS,A00,894015,Staff,5,0,25,20
1746606545783,SIO 295S,A00,894020,Staff,5,0,25,20
1746606546813,SIOC 290S,B01,958918,Merrifield; Mark A,14,0,30,16
1746606547844,SIOC 291S,B01,958922,Gabriel; Corey John,14,0,30,16
1746606548870,SOCI 117,A01,895339,Staff,2,0,5,3
1746606549919,WES 237B,A00,894149,Staff,11,0,20,9
1746606552010,AESE 279B,A00,891859,Staff,13,0,35,22
1746606553037,AIP 197,001,891854,Vespa; Emanuel Ignacio,9999,0,9999,0
1746606554066,ANTH 289S,A00,891856,Gagneux; Pascal,12,0,12,0
1746606555094,BENG 196,001,957946,Engler; Adam J.,9996,0,9999,3
1746606556118,BISP 197,001,959851,Wilhelm; James E.,9998,0,9999,1
1746606557143,CAT 124RS,A01,956906,Staff,6,0,25,19
1746606558170,CAT 125RS,A01,922013,Staff,6,0,25,19
1746606559196,CLRE 250,A00,891860,Morris; Sheldon,9995,0,9999,4
1746606561254,CLRE 251R,A00,907817,Mehta; Ravindra L.,9994,0,9999,5
1746606562280,CLRE 252,A00,891864,Cuomo; Raphael Eduardo,9993,0,9999,6
1746606563307,CLRE 253,A00,891867,Vaida; Florin,9994,0,9999,5
1746606563307,CLRE 253,B00,907819,Staff,9999,0,9999,0
1746606564334,CLRE 259,A00,891868,Patel; Hemal,9998,0,9999,1
1746606565359,CLRE 260,A00,891872,Cuomo; Raphael Eduardo,9999,0,9999,0
1746606566387,CLRE 297,001,891888,Cuomo; Raphael Eduardo,9999,0,9999,0
1746606567413,CSE 191,A00,958773,Minnes Kemp; Mor Mia,9995,0,9999,4
1746606568441,CSE 197,001,959846,Minnes Kemp; Mor Mia,9990,0,9999,9
1746606569466,CSS 201S,A01,892054,Mignozzetti; Umberto,25,0,30,5
1746606570496,CSS 202S,A01,892056,Mignozzetti; Umberto,25,0,30,5
1746606571524,DSC 197,001,956898,Eldridge; Justin Matthew,9996,0,9999,3
1746606572551,DSC 297,001,958000,Mazumdar; Arya,9998,0,9999,1
1746606572551,DSC 297,002,959862,Wang; Yusu,9998,0,9999,1
1746606573577,EAP 100,A00,905686,Staff,9778,0,9999,221
1746606574607,ECE 45,A01,892618,Staff,0,0,65,65
1746606576659,ECE 111,A01,892719,Staff,6,0,65,59
1746606577686,ECE 197,001,957920,Mercier; Patrick Philip,9991,0,9999,8
1746606578713,ECON 178,A01,907814,Zhu; Ying,26,0,35,9
1746606579740,EDS 115,A00,895312,Staff,35,0,45,10
1746606580770,EDS 117,A01,895337,Staff,23,0,30,7
1746606581798,EDS 125,A00,895341,Jones; Gabrielle Anastasia,36,0,45,9
1746606582825,EDS 128A,A01,895459,Fargason; Sharon Gayle,44,0,45,1
1746606583852,EDS 128B,A01,895543,Pappas; Elizabeth,44,0,45,1
1746606584880,EDS 139,A00,897203,Pappas; Elizabeth,44,0,45,1
1746606584880,EDS 139,B00,897209,Fargason; Sharon Gayle,41,0,45,4
1746606585907,EDS 201,A00,895545,Staff,22,0,45,23
1746606586936,EDS 203,A01,895581,Halter; Christopher P.,22,0,45,23
1746606587966,EDS 204R,A01,895625,Heinzman; Erica M.,39,0,45,6
1746606587966,EDS 204R,B01,895693,Halter; Christopher P.,10,0,45,35
1746606588996,EDS 206R,A00,895694,Fargason; Sharon Gayle,1,0,30,29
1746606588996,EDS 206R,B00,895695,Choi; Bailey Miyeon,16,0,30,14
1746606590026,EDS 250,A00,895697,Hemans; Patricia Ann Benitez,22,0,45,23
1746606591052,EDS 281,A00,895701,Meyerott; Theresa Ann,1,0,15,14
1746606592078,EDS 284,A00,895736,Meyerott; Theresa Ann,1,0,15,14
1746606593106,EDS 286,A00,897210,Fine; Sarah,0,0,15,15
1746606594134,EDS 289C,A01,895770,Daly; Alan J.,1,0,15,14
1746606595161,EDS 290,A00,897211,Hofstetter; Carolyn,0,0,15,15
1746606596190,LIGM 5A,A00,896162,Fischer-Grunski; Eva K,12,0,20,8
1746606597217,LIGM 5B,A00,896260,Fischer-Grunski; Eva K,17,0,20,3
1746606598246,LIGM 5C,A00,896308,Fischer-Grunski; Eva K,18,0,20,2
1746606599271,LIIT 5AS,A00,896313,Carnelos; Chiara,18,0,20,2
1746606600297,LIIT 5BS,A00,896416,Carnelos; Chiara,20,0,20,0
1746606601324,LIIT 5CS,A00,896564,Carnelos; Chiara,20,0,20,0
1746606602350,LISP 5A,A00,896588,Munoz Sanchez; Alicia,2,0,20,18
1746606603381,LISP 5B,A00,896653,Munoz Sanchez; Alicia,7,0,20,13
1746606604409,LISP 5C,A00,896655,Munoz Sanchez; Alicia,0,1,20,20
1746606605437,MAE 197,001,957918,Kleissl; Jan,9996,0,9999,3
1746606605437,MAE 197,002,959806,Boechler; Nicholas Sebastia,9998,0,9999,1
1746606605437,MAE 197,003,959852,Mullin; Jennifer S,9998,0,9999,1
1746606606466,MATH 2,A01,957937,Staff,33,0,35,2
1746606607498,MATH 197,001,957876,Kedlaya; Kiran S.,9993,0,9999,6
1746606608525,MCWP 40,A00,892729,Duru; Nur,10,0,20,10
1746606608525,MCWP 40,B00,893304,Montejo; Carolina,14,0,20,6
1746606609552,MCWP 40R,A00,893757,Redela; Pamela Morgan,0,5,20,20
1746606610581,MCWP 50,A00,893758,Morshed; Michael James,0,0,20,20
1746606610581,MCWP 50,B00,893761,Bartulis; Jason Michael,16,0,20,4
1746606611609,MCWP 50R,A00,893766,Compas; Sean Matthew,0,1,20,20
1746606611609,MCWP 50R,B00,893769,Carter; Jennifer A,0,1,20,20
1746606611609,MCWP 50R,C00,893771,Krone; Jarret,0,3,20,20
1746606611609,MCWP 50R,D00,893772,Miller; Elizabeth Deen,0,0,20,20
1746606611609,MCWP 50R,E00,893775,Carter; Andrea L,0,1,20,20
1746606612635,MMW 11R,A01,892721,Herbst; Matthew,14,0,30,16
1746606612635,MMW 11R,A02,892722,Herbst; Matthew,0,0,0,3
1746606613725,MMW 12R,A01,892724,Herbst; Matthew,0,11,16,16
1746606613725,MMW 12R,A02,892725,Herbst; Matthew,0,10,16,16
1746606614753,MMW 13R,A01,892727,Staff,0,4,16,16
1746606614753,MMW 13R,A02,892728,Staff,0,4,16,16
1746606614753,MMW 13R,A03,958032,Staff,0,4,16,16
1746606614753,MMW 13R,A04,958033,Staff,0,4,16,16
1746606614753,MMW 13R,A05,958034,Staff,0,4,16,16
1746606615777,SIO 295LS,A00,894015,Staff,5,0,25,20
1746606616806,SIO 295S,A00,894020,Staff,5,0,25,20
1746606617834,SIOC 290S,B01,958918,Merrifield; Mark A,14,0,30,16
1746606618859,SIOC 291S,B01,958922,Gabriel; Corey John,14,0,30,16
1746606619884,SOCI 117,A01,895339,Staff,2,0,5,3
1746606620912,WES 237B,A00,894149,Staff,11,0,20,9
1746606622987,AESE 279B,A00,891859,Staff,13,0,35,22
1746606624014,AIP 197,001,891854,Vespa; Emanuel Ignacio,9999,0,9999,0
1746606625039,ANTH 289S,A00,891856,Gagneux; Pascal,12,0,12,0
1746606626066,BENG 196,001,957946,Engler; Adam J.,9996,0,9999,3
1746606627096,BISP 197,001,959851,Wilhelm; James E.,9998,0,9999,1
1746606628123,CAT 124RS,A01,956906,Staff,6,0,25,19
1746606629150,CAT 125RS,A01,922013,Staff,6,0,25,19
1746606630180,CLRE 250,A00,891860,Morris; Sheldon,9995,0,9999,4
1746606632233,CLRE 251R,A00,907817,Mehta; Ravindra L.,9994,0,9999,5
1746606633259,CLRE 252,A00,891864,Cuomo; Raphael Eduardo,9993,0,9999,6
1746606634286,CLRE 253,A00,891867,Vaida; Florin,9994,0,9999,5
1746606634286,CLRE 253,B00,907819,Staff,9999,0,9999,0
1746606635312,CLRE 259,A00,891868,Patel; Hemal,9998,0,9999,1
1746606636340,CLRE 260,A00,891872,Cuomo; Raphael Eduardo,9999,0,9999,0
1746606637368,CLRE 297,001,891888,Cuomo; Raphael Eduardo,9999,0,9999,0
1746606638397,CSE 191,A00,958773,Minnes Kemp; Mor Mia,9995,0,9999,4
1746606639423,CSE 197,001,959846,Minnes Kemp; Mor Mia,9990,0,9999,9
1746606640450,CSS 201S,A01,892054,Mignozzetti; Umberto,25,0,30,5
1746606641479,CSS 202S,A01,892056,Mignozzetti; Umberto,25,0,30,5
1746606642505,DSC 197,001,956898,Eldridge; Justin Matthew,9996,0,9999,3
1746606643533,DSC 297,001,958000,Mazumdar; Arya,9998,0,9999,1
1746606643533,DSC 297,002,959862,Wang; Yusu,9998,0,9999,1
1746606644558,EAP 100,A00,905686,Staff,9778,0,9999,221
1746606645583,ECE 45,A01,892618,Staff,0,0,65,65
1746606647646,ECE 111,A01,892719,Staff,6,0,65,59
1746606648672,ECE 197,001,957920,Mercier; Patrick Philip,9991,0,9999,8
1746606649699,ECON 178,A01,907814,Zhu; Ying,26,0,35,9
1746606650725,EDS 115,A00,895312,Staff,35,0,45,10
1746606651750,EDS 117,A01,895337,Staff,23,0,30,7
1746606652779,EDS 125,A00,895341,Jones; Gabrielle Anastasia,36,0,45,9
1746606653806,EDS 128A,A01,895459,Fargason; Sharon Gayle,44,0,45,1
1746606654837,EDS 128B,A01,895543,Pappas; Elizabeth,44,0,45,1
1746606655863,EDS 139,A00,897203,Pappas; Elizabeth,44,0,45,1
1746606655863,EDS 139,B00,897209,Fargason; Sharon Gayle,41,0,45,4
1746606656892,EDS 201,A00,895545,Staff,22,0,45,23
1746606657939,EDS 203,A01,895581,Halter; Christopher P.,22,0,45,23
1746606658967,EDS 204R,A01,895625,Heinzman; Erica M.,39,0,45,6
1746606658967,EDS 204R,B01,895693,Halter; Christopher P.,10,0,45,35
1746606659995,EDS 206R,A00,895694,Fargason; Sharon Gayle,1,0,30,29
1746606659995,EDS 206R,B00,895695,Choi; Bailey Miyeon,16,0,30,14
1746606661025,EDS 250,A00,895697,Hemans; Patricia Ann Benitez,22,0,45,23
1746606662058,EDS 281,A00,895701,Meyerott; Theresa Ann,1,0,15,14
1746606663088,EDS 284,A00,895736,Meyerott; Theresa Ann,1,0,15,14
1746606664115,EDS 286,A00,897210,Fine; Sarah,0,0,15,15
1746606665141,EDS 289C,A01,895770,Daly; Alan J.,1,0,15,14
1746606666171,EDS 290,A00,897211,Hofstetter; Carolyn,0,0,15,15
1746606667198,LIGM 5A,A00,896162,Fischer-Grunski; Eva K,12,0,20,8
1746606668225,LIGM 5B,A00,896260,Fischer-Grunski; Eva K,17,0,20,3
1746606669252,LIGM 5C,A00,896308,Fischer-Grunski; Eva K,18,0,20,2
1746606670281,LIIT 5AS,A00,896313,Carnelos; Chiara,18,0,20,2
1746606671308,LIIT 5BS,A00,896416,Carnelos; Chiara,20,0,20,0
1746606672336,LIIT 5CS,A00,896564,Carnelos; Chiara,20,0,20,0
1746606673362,LISP 5A,A00,896588,Munoz Sanchez; Alicia,2,0,20,18
1746606674390,LISP 5B,A00,896653,Munoz Sanchez; Alicia,7,0,20,13
1746606675418,LISP 5C,A00,896655,Munoz Sanchez; Alicia,0,1,20,20
1746606676443,MAE 197,001,957918,Kleissl; Jan,9996,0,9999,3
1746606676443,MAE 197,002,959806,Boechler; Nicholas Sebastia,9998,0,9999,1
1746606676443,MAE 197,003,959852,Mullin; Jennifer S,9998,0,9999,1
1746606677468,MATH 2,A01,957937,Staff,33,0,35,2
1746606678497,MATH 197,001,957876,Kedlaya; Kiran S.,9993,0,9999,6
1746606679526,MCWP 40,A00,892729,Duru; Nur,10,0,20,10
1746606679526,MCWP 40,B00,893304,Montejo; Carolina,14,0,20,6
1746606680557,MCWP 40R,A00,893757,Redela; Pamela Morgan,0,5,20,20
1746606681582,MCWP 50,A00,893758,Morshed; Michael James,0,0,20,20
1746606681582,MCWP 50,B00,893761,Bartulis; Jason Michael,16,0,20,4
1746606682612,MCWP 50R,A00,893766,Compas; Sean Matthew,0,1,20,20
1746606682612,MCWP 50R,B00,893769,Carter; Jennifer A,0,1,20,20
1746606682612,MCWP 50R,C00,893771,Krone; Jarret,0,3,20,20
1746606682612,MCWP 50R,D00,893772,Miller; Elizabeth Deen,0,0,20,20
1746606682612,MCWP 50R,E00,893775,Carter; Andrea L,0,1,20,20
1746606683642,MMW 11R,A01,892721,Herbst; Matthew,14,0,30,16
1746606683642,MMW 11R,A02,892722,Herbst; Matthew,0,0,0,3
1746606684668,MMW 12R,A01,892724,Herbst; Matthew,0,11,16,16
1746606684668,MMW 12R,A02,892725,Herbst; Matthew,0,10,16,16
1746606685698,MMW 13R,A01,892727,Staff,0,4,16,16
1746606685698,MMW 13R,A02,892728,Staff,0,4,16,16
1746606685698,MMW 13R,A03,958032,Staff,0,4,16,16
1746606685698,MMW 13R,A04,958033,Staff,0,4,16,16
1746606685698,MMW 13R,A05,958034,Staff,0,4,16,16
1746606686723,SIO 295LS,A00,894015,Staff,5,0,25,20
1746606687750,SIO 295S,A00,894020,Staff,5,0,25,20
1746606688776,SIOC 290S,B01,958918,Merrifield; Mark A,14,0,30,16
1746606689812,SIOC 291S,B01,958922,Gabriel; Corey John,14,0,30,16
1746606690842,SOCI 117,A01,895339,Staff,2,0,5,3
1746606691867,WES 237B,A00,894149,Staff,11,0,20,9
1746606693954,AESE 279B,A00,891859,Staff,13,0,35,22
1746606694983,AIP 197,001,891854,Vespa; Emanuel Ignacio,9999,0,9999,0
1746606696010,ANTH 289S,A00,891856,Gagneux; Pascal,12,0,12,0
1746606697036,BENG 196,001,957946,Engler; Adam J.,9996,0,9999,3
1746606698067,BISP 197,001,959851,Wilhelm; James E.,9998,0,9999,1
1746606699094,CAT 124RS,A01,956906,Staff,6,0,25,19
1746606700127,CAT 125RS,A01,922013,Staff,6,0,25,19
1746606701156,CLRE 250,A00,891860,Morris; Sheldon,9995,0,9999,4
1746606703215,CLRE 251R,A00,907817,Mehta; Ravindra L.,9994,0,9999,5
1746606704242,CLRE 252,A00,891864,Cuomo; Raphael Eduardo,9993,0,9999,6
1746606705269,CLRE 253,A00,891867,Vaida; Florin,9994,0,9999,5
1746606705269,CLRE 253,B00,907819,Staff,9999,0,9999,0
1746606706294,CLRE 259,A00,891868,Patel; Hemal,9998,0,9999,1
1746606707320,CLRE 260,A00,891872,Cuomo; Raphael Eduardo,9999,0,9999,0
1746606708350,CLRE 297,001,891888,Cuomo; Raphael Eduardo,9999,0,9999,0
1746606709380,CSE 191,A00,958773,Minnes Kemp; Mor Mia,9995,0,9999,4
1746606710406,CSE 197,001,959846,Minnes Kemp; Mor Mia,9990,0,9999,9
1746606711433,CSS 201S,A01,892054,Mignozzetti; Umberto,25,0,30,5
1746606712460,CSS 202S,A01,892056,Mignozzetti; Umberto,25,0,30,5
1746606713485,DSC 197,001,956898,Eldridge; Justin Matthew,9996,0,9999,3
1746606714517,DSC 297,001,958000,Mazumdar; Arya,9998,0,9999,1
1746606714517,DSC 297,002,959862,Wang; Yusu,9998,0,9999,1
1746606715543,EAP 100,A00,905686,Staff,9778,0,9999,221
1746606716570,ECE 45,A01,892618,Staff,0,0,65,65
1746606718626,ECE 111,A01,892719,Staff,6,0,65,59
1746606719654,ECE 197,001,957920,Mercier; Patrick Philip,9991,0,9999,8
1746606720689,ECON 178,A01,907814,Zhu; Ying,26,0,35,9
1746606721713,EDS 115,A00,895312,Staff,35,0,45,10
1746606722745,EDS 117,A01,895337,Staff,23,0,30,7
1746606723773,EDS 125,A00,895341,Jones; Gabrielle Anastasia,36,0,45,9
1746606724800,EDS 128A,A01,895459,Fargason; Sharon Gayle,44,0,45,1
1746606725827,EDS 128B,A01,895543,Pappas; Elizabeth,44,0,45,1
1746606726854,EDS 139,A00,897203,Pappas; Elizabeth,44,0,45,1
1746606726854,EDS 139,B00,897209,Fargason; Sharon Gayle,41,0,45,4
1746606727885,EDS 201,A00,895545,Staff,22,0,45,23
1746606728911,EDS 203,A01,895581,Halter; Christopher P.,22,0,45,23
1746606729937,EDS 204R,A01,895625,Heinzman; Erica M.,39,0,45,6
1746606729937,EDS 204R,B01,895693,Halter; Christopher P.,10,0,45,35
1746606730968,EDS 206R,A00,895694,Fargason; Sharon Gayle,1,0,30,29
1746606730968,EDS 206R,B00,895695,Choi; Bailey Miyeon,16,0,30,14
1746606731995,EDS 250,A00,895697,Hemans; Patricia Ann Benitez,22,0,45,23
1746606733025,EDS 281,A00,895701,Meyerott; Theresa Ann,1,0,15,14
1746606734051,EDS 284,A00,895736,Meyerott; Theresa Ann,1,0,15,14
1746606735078,EDS 286,A00,897210,Fine; Sarah,0,0,15,15
1746606736104,EDS 289C,A01,895770,Daly; Alan J.,1,0,15,14
1746606737134,EDS 290,A00,897211,Hofstetter; Carolyn,0,0,15,15
1746606738166,LIGM 5A,A00,896162,Fischer-Grunski; Eva K,12,0,20,8
1746606739197,LIGM 5B,A00,896260,Fischer-Grunski; Eva K,17,0,20,3
1746606740224,LIGM 5C,A00,896308,Fischer-Grunski; Eva K,18,0,20,2
1746606741250,LIIT 5AS,A00,896313,Carnelos; Chiara,18,0,20,2
1746606742280,LIIT 5BS,A00,896416,Carnelos; Chiara,20,0,20,0
1746606743310,LIIT 5CS,A00,896564,Carnelos; Chiara,20,0,20,0
1746606744339,LISP 5A,A00,896588,Munoz Sanchez; Alicia,2,0,20,18
1746606745366,LISP 5B,A00,896653,Munoz Sanchez; Alicia,7,0,20,13
1746606746393,LISP 5C,A00,896655,Munoz Sanchez; Alicia,0,1,20,20
1746606747422,MAE 197,001,957918,Kleissl; Jan,9996,0,9999,3
1746606747422,MAE 197,002,959806,Boechler; Nicholas Sebastia,9998,0,9999,1
1746606747422,MAE 197,003,959852,Mullin; Jennifer S,9998,0,9999,1
1746606748449,MATH 2,A01,957937,Staff,33,0,35,2
1746606749478,MATH 197,001,957876,Kedlaya; Kiran S.,9993,0,9999,6
1746606750505,MCWP 40,A00,892729,Duru; Nur,10,0,20,10
1746606750505,MCWP 40,B00,893304,Montejo; Carolina,14,0,20,6
1746606751531,MCWP 40R,A00,893757,Redela; Pamela Morgan,0,5,20,20
1746606752564,MCWP 50,A00,893758,Morshed; Michael James,0,0,20,20
1746606752564,MCWP 50,B00,893761,Bartulis; Jason Michael,16,0,20,4
1746606753592,MCWP 50R,A00,893766,Compas; Sean Matthew,0,1,20,20
1746606753592,MCWP 50R,B00,893769,Carter; Jennifer A,0,1,20,20
1746606753592,MCWP 50R,C00,893771,Krone; Jarret,0,3,20,20
1746606753592,MCWP 50R,D00,893772,Miller; Elizabeth Deen,0,0,20,20
1746606753592,MCWP 50R,E00,893775,Carter; Andrea L,0,1,20,20
1746606754620,MMW 11R,A01,892721,Herbst; Matthew,14,0,30,16
1746606754620,MMW 11R,A02,892722,Herbst; Matthew,0,0,0,3
1746606755651,MMW 12R,A01,892724,Herbst; Matthew,0,11,16,16
1746606755651,MMW 12R,A02,892725,Herbst; Matthew,0,10,16,16
1746606756680,MMW 13R,A01,892727,Staff,0,4,16,16
1746606756680,MMW 13R,A02,892728,Staff,0,4,16,16
1746606756680,MMW 13R,A03,958032,Staff,0,4,16,16
1746606756680,MMW 13R,A04,958033,Staff,0,4,16,16
1746606756680,MMW 13R,A05,958034,Staff,0,4,16,16
1746606757707,SIO 295LS,A00,894015,Staff,5,0,25,20
1746606758733,SIO 295S,A00,894020,Staff,5,0,25,20
1746606759772,SIOC 290S,B01,958918,Merrifield; Mark A,14,0,30,16
1746606760802,SIOC 291S,B01,958922,Gabriel; Corey John,14,0,30,16
1746606761828,SOCI 117,A01,895339,Staff,2,0,5,3
1746606762854,WES 237B,A00,894149,Staff,11,0,20,9
1746606764947,AESE 279B,A00,891859,Staff,13,0,35,22
1746606765975,AIP 197,001,891854,Vespa; Emanuel Ignacio,9999,0,9999,0
1746606767006,ANTH 289S,A00,891856,Gagneux; Pascal,12,0,12,0
1746606768034,BENG 196,001,957946,Engler; Adam J.,9996,0,9999,3
1746606769059,BISP 197,001,959851,Wilhelm; James E.,9998,0,9999,1
1746606770090,CAT 124RS,A01,956906,Staff,6,0,25,19
1746606771116,CAT 125RS,A01,922013,Staff,6,0,25,19
1746606772147,CLRE 250,A00,891860,Morris; Sheldon,9995,0,9999,4
1746606774203,CLRE 251R,A00,907817,Mehta; Ravindra L.,9994,0,9999,5
1746606775230,CLRE 252,A00,891864,Cuomo; Raphael Eduardo,9993,0,9999,6
1746606776257,CLRE 253,A00,891867,Vaida; Florin,9994,0,9999,5
1746606776257,CLRE 253,B00,907819,Staff,9999,0,9999,0
1746606777283,CLRE 259,A00,891868,Patel; Hemal,9998,0,9999,1
1746606778313,CLRE 260,A00,891872,Cuomo; Raphael Eduardo,9999,0,9999,0
1746606779339,CLRE 297,001,891888,Cuomo; Raphael Eduardo,9999,0,9999,0
1746606780366,CSE 191,A00,958773,Minnes Kemp; Mor Mia,9995,0,9999,4
1746606781391,CSE 197,001,959846,Minnes Kemp; Mor Mia,9990,0,9999,9
1746606782430,CSS 201S,A01,892054,Mignozzetti; Umberto,25,0,30,5
1746606783458,CSS 202S,A01,892056,Mignozzetti; Umberto,25,0,30,5
1746606784483,DSC 197,001,956898,Eldridge; Justin Matthew,9996,0,9999,3
1746606785508,DSC 297,001,958000,Mazumdar; Arya,9998,0,9999,1
1746606785508,DSC 297,002,959862,Wang; Yusu,9998,0,9999,1
1746606786534,EAP 100,A00,905686,Staff,9778,0,9999,221
1746606787561,ECE 45,A01,892618,Staff,0,0,65,65
1746606789617,ECE 111,A01,892719,Staff,6,0,65,59
1746606790643,ECE 197,001,957920,Mercier; Patrick Philip,9991,0,9999,8
1746606791679,ECON 178,A01,907814,Zhu; Ying,26,0,35,9
1746606792704,EDS 115,A00,895312,Staff,35,0,45,10
1746606793730,EDS 117,A01,895337,Staff,23,0,30,7
1746606794757,EDS 125,A00,895341,Jones; Gabrielle Anastasia,36,0,45,9
1746606795784,EDS 128A,A01,895459,Fargason; Sharon Gayle,44,0,45,1
1746606796817,EDS 128B,A01,895543,Pappas; Elizabeth,44,0,45,1
1746606797849,EDS 139,A00,897203,Pappas; Elizabeth,44,0,45,1
1746606797849,EDS 139,B00,897209,Fargason; Sharon Gayle,41,0,45,4
1746606798875,EDS 201,A00,895545,Staff,22,0,45,23
1746606799900,EDS 203,A01,895581,Halter; Christopher P.,22,0,45,23
1746606800926,EDS 204R,A01,895625,Heinzman; Erica M.,39,0,45,6
1746606800926,EDS 204R,B01,895693,Halter; Christopher P.,10,0,45,35
1746606801950,EDS 206R,A00,895694,Fargason; Sharon Gayle,1,0,30,29
1746606801950,EDS 206R,B00,895695,Choi; Bailey Miyeon,16,0,30,14
1746606802976,EDS 250,A00,895697,Hemans; Patricia Ann Benitez,22,0,45,23
1746606804002,EDS 281,A00,895701,Meyerott; Theresa Ann,1,0,15,14
1746606805040,EDS 284,A00,895736,Meyerott; Theresa Ann,1,0,15,14
1746606806070,EDS 286,A00,897210,Fine; Sarah,0,0,15,15
1746606807097,EDS 289C,A01,895770,Daly; Alan J.,1,0,15,14
1746606808122,EDS 290,A00,897211,Hofstetter; Carolyn,0,0,15,15
1746606809154,LIGM 5A,A00,896162,Fischer-Grunski; Eva K,12,0,20,8
1746606810184,LIGM 5B,A00,896260,Fischer-Grunski; Eva K,17,0,20,3
1746606811210,LIGM 5C,A00,896308,Fischer-Grunski; Eva K,18,0,20,2
1746606812245,LIIT 5AS,A00,896313,Carnelos; Chiara,18,0,20,2
1746606813276,LIIT 5BS,A00,896416,Carnelos; Chiara,20,0,20,0
1746606814303,LIIT 5CS,A00,896564,Carnelos; Chiara,20,0,20,0
1746606815335,LISP 5A,A00,896588,Munoz Sanchez; Alicia,2,0,20,18
1746606816363,LISP 5B,A00,896653,Munoz Sanchez; Alicia,7,0,20,13
1746606817389,LISP 5C,A00,896655,Munoz Sanchez; Alicia,0,1,20,20
1746606818429,MAE 197,001,957918,Kleissl; Jan,9996,0,9999,3
1746606818429,MAE 197,002,959806,Boechler; Nicholas Sebastia,9998,0,9999,1
1746606818429,MAE 197,003,959852,Mullin; Jennifer S,9998,0,9999,1
1746606819460,MATH 2,A01,957937,Staff,33,0,35,2
1746606820500,MATH 197,001,957876,Kedlaya; Kiran S.,9993,0,9999,6
1746606821527,MCWP 40,A00,892729,Duru; Nur,10,0,20,10
1746606821527,MCWP 40,B00,893304,Montejo; Carolina,14,0,20,6
1746606822560,MCWP 40R,A00,893757,Redela; Pamela Morgan,0,5,20,20
1746606823588,MCWP 50,A00,893758,Morshed; Michael James,0,0,20,20
1746606823588,MCWP 50,B00,893761,Bartulis; Jason Michael,16,0,20,4
1746606824616,MCWP 50R,A00,893766,Compas; Sean Matthew,0,1,20,20
1746606824616,MCWP 50R,B00,893769,Carter; Jennifer A,0,1,20,20
1746606824616,MCWP 50R,C00,893771,Krone; Jarret,0,3,20,20
1746606824616,MCWP 50R,D00,893772,Miller; Elizabeth Deen,0,0,20,20
1746606824616,MCWP 50R,E00,893775,Carter; Andrea L,0,1,20,20
1746606825641,MMW 11R,A01,892721,Herbst; Matthew,14,0,30,16
1746606825641,MMW 11R,A02,892722,Herbst; Matthew,0,0,0,3
1746606826668,MMW 12R,A01,892724,Herbst; Matthew,0,11,16,16
1746606826668,MMW 12R,A02,892725,Herbst; Matthew,0,10,16,16
1746606827695,MMW 13R,A01,892727,Staff,0,4,16,16
1746606827695,MMW 13R,A02,892728,Staff,0,4,16,16
1746606827695,MMW 13R,A03,958032,Staff,0,4,16,16
1746606827695,MMW 13R,A04,958033,Staff,0,4,16,16
1746606827695,MMW 13R,A05,958034,Staff,0,4,16,16
1746606828726,SIO 295LS,A00,894015,Staff,5,0,25,20
1746606829754,SIO 295S,A00,894020,Staff,5,0,25,20
1746606830781,SIOC 290S,B01,958918,Merrifield; Mark A,14,0,30,16
1746606831812,SIOC 291S,B01,958922,Gabriel; Corey John,14,0,30,16
1746606832837,SOCI 117,A01,895339,Staff,2,0,5,3
1746606833863,WES 237B,A00,894149,Staff,11,0,20,9
1746606835955,AESE 279B,A00,891859,Staff,13,0,35,22
1746606836985,AIP 197,001,891854,Vespa; Emanuel Ignacio,9999,0,9999,0
1746606838012,ANTH 289S,A00,891856,Gagneux; Pascal,12,0,12,0
1746606839039,BENG 196,001,957946,Engler; Adam J.,9996,0,9999,3
1746606840066,BISP 197,001,959851,Wilhelm; James E.,9998,0,9999,1
1746606841094,CAT 124RS,A01,956906,Staff,6,0,25,19
1746606842160,CAT 125RS,A01,922013,Staff,6,0,25,19
1746606843192,CLRE 250,A00,891860,Morris; Sheldon,9995,0,9999,4
1746606845242,CLRE 251R,A00,907817,Mehta; Ravindra L.,9994,0,9999,5
1746606846269,CLRE 252,A00,891864,Cuomo; Raphael Eduardo,9993,0,9999,6
1746606847296,CLRE 253,A00,891867,Vaida; Florin,9994,0,9999,5
1746606847296,CLRE 253,B00,907819,Staff,9999,0,9999,0
1746606848327,CLRE 259,A00,891868,Patel; Hemal,9998,0,9999,1
1746606849354,CLRE 260,A00,891872,Cuomo; Raphael Eduardo,9999,0,9999,0
1746606850380,CLRE 297,001,891888,Cuomo; Raphael Eduardo,9999,0,9999,0
1746606851408,CSE 191,A00,958773,Minnes Kemp; Mor Mia,9995,0,9999,4
1746606852439,CSE 197,001,959846,Minnes Kemp; Mor Mia,9990,0,9999,9
1746606853470,CSS 201S,A01,892054,Mignozzetti; Umberto,25,0,30,5
1746606854499,CSS 202S,A01,892056,Mignozzetti; Umberto,25,0,30,5
1746606855526,DSC 197,001,956898,Eldridge; Justin Matthew,9996,0,9999,3
1746606856552,DSC 297,001,958000,Mazumdar; Arya,9998,0,9999,1
1746606856552,DSC 297,002,959862,Wang; Yusu,9998,0,9999,1
1746606857579,EAP 100,A00,905686,Staff,9778,0,9999,221
1746606858605,ECE 45,A01,892618,Staff,0,0,65,65
1746606860668,ECE 111,A01,892719,Staff,6,0,65,59
1746606861700,ECE 197,001,957920,Mercier; Patrick Philip,9991,0,9999,8
1746606862728,ECON 178,A01,907814,Zhu; Ying,26,0,35,9
1746606863754,EDS 115,A00,895312,Staff,35,0,45,10
1746606864786,EDS 117,A01,895337,Staff,23,0,30,7
1746606865811,EDS 125,A00,895341,Jones; Gabrielle Anastasia,36,0,45,9
1746606866841,EDS 128A,A01,895459,Fargason; Sharon Gayle,44,0,45,1
1746606867872,EDS 128B,A01,895543,Pappas; Elizabeth,44,0,45,1
1746606868896,EDS 139,A00,897203,Pappas; Elizabeth,44,0,45,1
1746606868896,EDS 139,B00,897209,Fargason; Sharon Gayle,41,0,45,4
1746606869928,EDS 201,A00,895545,Staff,22,0,45,23
1746606870954,EDS 203,A01,895581,Halter; Christopher P.,22,0,45,23
1746606871980,EDS 204R,A01,895625,Heinzman; Erica M.,39,0,45,6
1746606871980,EDS 204R,B01,895693,Halter; Christopher P.,10,0,45,35
1746606873008,EDS 206R,A00,895694,Fargason; Sharon Gayle,1,0,30,29
1746606873008,EDS 206R,B00,895695,Choi; Bailey Miyeon,16,0,30,14
1746606874043,EDS 250,A00,895697,Hemans; Patricia Ann Benitez,22,0,45,23
1746606875072,EDS 281,A00,895701,Meyerott; Theresa Ann,1,0,15,14
1746606876099,EDS 284,A00,895736,Meyerott; Theresa Ann,1,0,15,14
1746606877125,EDS 286,A00,897210,Fine; Sarah,0,0,15,15
1746606878151,EDS 289C,A01,895770,Daly; Alan J.,1,0,15,14
1746606879178,EDS 290,A00,897211,Hofstetter; Carolyn,0,0,15,15
1746606880213,LIGM 5A,A00,896162,Fischer-Grunski; Eva K,12,0,20,8
1746606881238,LIGM 5B,A00,896260,Fischer-Grunski; Eva K,17,0,20,3
1746606882269,LIGM 5C,A00,896308,Fischer-Grunski; Eva K,18,0,20,2
1746606883294,LIIT 5AS,A00,896313,Carnelos; Chiara,18,0,20,2
1746606884325,LIIT 5BS,A00,896416,Carnelos; Chiara,20,0,20,0
1746606885355,LIIT 5CS,A00,896564,Carnelos; Chiara,20,0,20,0
1746606886381,LISP 5A,A00,896588,Munoz Sanchez; Alicia,2,0,20,18
1746606887406,LISP 5B,A00,896653,Munoz Sanchez; Alicia,7,0,20,13
1746606888437,LISP 5C,A00,896655,Munoz Sanchez; Alicia,0,1,20,20
1746606889463,MAE 197,001,957918,Kleissl; Jan,9996,0,9999,3
1746606889463,MAE 197,002,959806,Boechler; Nicholas Sebastia,9998,0,9999,1
1746606889463,MAE 197,003,959852,Mullin; Jennifer S,9998,0,9999,1
1746606890491,MATH 2,A01,957937,Staff,33,0,35,2
1746606891517,MATH 197,001,957876,Kedlaya; Kiran S.,9993,0,9999,6
1746606892544,MCWP 40,A00,892729,Duru; Nur,10,0,20,10
1746606892544,MCWP 40,B00,893304,Montejo; Carolina,14,0,20,6
1746606893577,MCWP 40R,A00,893757,Redela; Pamela Morgan,0,5,20,20
1746606894604,MCWP 50,A00,893758,Morshed; Michael James,0,0,20,20
1746606894604,MCWP 50,B00,893761,Bartulis; Jason Michael,16,0,20,4
1746606895632,MCWP 50R,A00,893766,Compas; Sean Matthew,0,1,20,20
1746606895632,MCWP 50R,B00,893769,Carter; Jennifer A,0,1,20,20
1746606895632,MCWP 50R,C00,893771,Krone; Jarret,0,3,20,20
1746606895632,MCWP 50R,D00,893772,Miller; Elizabeth Deen,0,0,20,20
1746606895632,MCWP 50R,E00,893775,Carter; Andrea L,0,1,20,20
1746606896657,MMW 11R,A01,892721,Herbst; Matthew,14,0,30,16
1746606896657,MMW 11R,A02,892722,Herbst; Matthew,0,0,0,3
1746606897683,MMW 12R,A01,892724,Herbst; Matthew,0,11,16,16
1746606897683,MMW 12R,A02,892725,Herbst; Matthew,0,10,16,16
1746606898712,MMW 13R,A01,892727,Staff,0,4,16,16
1746606898712,MMW 13R,A02,892728,Staff,0,4,16,16
1746606898712,MMW 13R,A03,958032,Staff,0,4,16,16
1746606898712,MMW 13R,A04,958033,Staff,0,4,16,16
1746606898712,MMW 13R,A05,958034,Staff,0,4,16,16
1746606899743,SIO 295LS,A00,894015,Staff,5,0,25,20
1746606900770,SIO 295S,A00,894020,Staff,5,0,25,20
1746606901797,SIOC 290S,B01,958918,Merrifield; Mark A,14,0,30,16
1746606902831,SIOC 291S,B01,958922,Gabriel; Corey John,14,0,30,16
1746606903867,SOCI 117,A01,895339,Staff,2,0,5,3
1746606904892,WES 237B,A00,894149,Staff,11,0,20,9
1746606906958,AESE 279B,A00,891859,Staff,13,0,35,22
1746606907987,AIP 197,001,891854,Vespa; Emanuel Ignacio,9999,0,9999,0
1746606909015,ANTH 289S,A00,891856,Gagneux; Pascal,12,0,12,0
1746606910044,BENG 196,001,957946,Engler; Adam J.,9996,0,9999,3
1746606911071,BISP 197,001,959851,Wilhelm; James E.,9998,0,9999,1
1746606912098,CAT 124RS,A01,956906,Staff,6,0,25,19
1746606913125,CAT 125RS,A01,922013,Staff,6,0,25,19
1746606914156,CLRE 250,A00,891860,Morris; Sheldon,9995,0,9999,4
1746606916210,CLRE 251R,A00,907817,Mehta; Ravindra L.,9994,0,9999,5
1746606917241,CLRE 252,A00,891864,Cuomo; Raphael Eduardo,9993,0,9999,6
1746606918272,CLRE 253,A00,891867,Vaida; Florin,9994,0,9999,5
1746606918272,CLRE 253,B00,907819,Staff,9999,0,9999,0
1746606919299,CLRE 259,A00,891868,Patel; Hemal,9998,0,9999,1
1746606920325,CLRE 260,A00,891872,Cuomo; Raphael Eduardo,9999,0,9999,0
1746606921352,CLRE 297,001,891888,Cuomo; Raphael Eduardo,9999,0,9999,0
1746606922378,CSE 191,A00,958773,Minnes Kemp; Mor Mia,9995,0,9999,4
1746606923407,CSE 197,001,959846,Minnes Kemp; Mor Mia,9990,0,9999,9
1746606924434,CSS 201S,A01,892054,Mignozzetti; Umberto,25,0,30,5
1746606925459,CSS 202S,A01,892056,Mignozzetti; Umberto,25,0,30,5
1746606926485,DSC 197,001,956898,Eldridge; Justin Matthew,9996,0,9999,3
1746606927512,DSC 297,001,958000,Mazumdar; Arya,9998,0,9999,1
1746606927512,DSC 297,002,959862,Wang; Yusu,9998,0,9999,1
1746606928541,EAP 100,A00,905686,Staff,9778,0,9999,221
1746606929567,ECE 45,A01,892618,Staff,0,0,65,65
1746606931625,ECE 111,A01,892719,Staff,6,0,65,59
1746606932657,ECE 197,001,957920,Mercier; Patrick Philip,9991,0,9999,8
1746606933684,ECON 178,A01,907814,Zhu; Ying,26,0,35,9
1746606934710,EDS 115,A00,895312,Staff,35,0,45,10
1746606935740,EDS 117,A01,895337,Staff,23,0,30,7
1746606936767,EDS 125,A00,895341,Jones; Gabrielle Anastasia,36,0,45,9
1746606937798,EDS 128A,A01,895459,Fargason; Sharon Gayle,44,0,45,1
1746606938828,EDS 128B,A01,895543,Pappas; Elizabeth,44,0,45,1
1746606939858,EDS 139,A00,897203,Pappas; Elizabeth,44,0,45,1
1746606939858,EDS 139,B00,897209,Fargason; Sharon Gayle,41,0,45,4
1746606940884,EDS 201,A00,895545,Staff,22,0,45,23
1746606941914,EDS 203,A01,895581,Halter; Christopher P.,22,0,45,23
1746606942943,EDS 204R,A01,895625,Heinzman; Erica M.,39,0,45,6
1746606942943,EDS 204R,B01,895693,Halter; Christopher P.,10,0,45,35
1746606943969,EDS 206R,A00,895694,Fargason; Sharon Gayle,1,0,30,29
1746606943969,EDS 206R,B00,895695,Choi; Bailey Miyeon,16,0,30,14
1746606945001,EDS 250,A00,895697,Hemans; Patricia Ann Benitez,22,0,45,23
1746606946027,EDS 281,A00,895701,Meyerott; Theresa Ann,1,0,15,14
1746606947056,EDS 284,A00,895736,Meyerott; Theresa Ann,1,0,15,14
1746606948090,EDS 286,A00,897210,Fine; Sarah,0,0,15,15
1746606949160,EDS 289C,A01,895770,Daly; Alan J.,1,0,15,14
1746606950189,EDS 290,A00,897211,Hofstetter; Carolyn,0,0,15,15
1746606951221,LIGM 5A,A00,896162,Fischer-Grunski; Eva K,12,0,20,8
1746606952248,LIGM 5B,A00,896260,Fischer-Grunski; Eva K,17,0,20,3
1746606953273,LIGM 5C,A00,896308,Fischer-Grunski; Eva K,18,0,20,2
1746606954305,LIIT 5AS,A00,896313,Carnelos; Chiara,18,0,20,2
1746606955332,LIIT 5BS,A00,896416,Carnelos; Chiara,20,0,20,0
1746606956359,LIIT 5CS,A00,896564,Carnelos; Chiara,20,0,20,0
1746606957389,LISP 5A,A00,896588,Munoz Sanchez; Alicia,2,0,20,18
1746606958418,LISP 5B,A00,896653,Munoz Sanchez; Alicia,7,0,20,13
1746606959448,LISP 5C,A00,896655,Munoz Sanchez; Alicia,0,1,20,20
1746606960480,MAE 197,001,957918,Kleissl; Jan,9996,0,9999,3
1746606960480,MAE 197,002,959806,Boechler; Nicholas Sebastia,9998,0,9999,1
1746606960480,MAE 197,003,959852,Mullin; Jennifer S,9998,0,9999,1
1746606961508,MATH 2,A01,957937,Staff,33,0,35,2
1746606962534,MATH 197,001,957876,Kedlaya; Kiran S.,9993,0,9999,6
1746606963568,MCWP 40,A00,892729,Duru; Nur,10,0,20,10
1746606963568,MCWP 40,B00,893304,Montejo; Carolina,14,0,20,6
1746606964597,MCWP 40R,A00,893757,Redela; Pamela Morgan,0,5,20,20
1746606965624,MCWP 50,A00,893758,Morshed; Michael James,0,0,20,20
1746606965624,MCWP 50,B00,893761,Bartulis; Jason Michael,16,0,20,4
1746606966651,MCWP 50R,A00,893766,Compas; Sean Matthew,0,1,20,20
1746606966651,MCWP 50R,B00,893769,Carter; Jennifer A,0,1,20,20
1746606966651,MCWP 50R,C00,893771,Krone; Jarret,0,3,20,20
1746606966651,MCWP 50R,D00,893772,Miller; Elizabeth Deen,0,0,20,20
1746606966651,MCWP 50R,E00,893775,Carter; Andrea L,0,1,20,20
1746606967713,MMW 11R,A01,892721,Herbst; Matthew,14,0,30,16
1746606967713,MMW 11R,A02,892722,Herbst; Matthew,0,0,0,3
1746606968745,MMW 12R,A01,892724,Herbst; Matthew,0,11,16,16
1746606968745,MMW 12R,A02,892725,Herbst; Matthew,0,10,16,16
1746606969773,MMW 13R,A01,892727,Staff,0,4,16,16
1746606969773,MMW 13R,A02,892728,Staff,0,4,16,16
1746606969773,MMW 13R,A03,958032,Staff,0,4,16,16
1746606969773,MMW 13R,A04,958033,Staff,0,4,16,16
1746606969773,MMW 13R,A05,958034,Staff,0,4,16,16
1746606970800,SIO 295LS,A00,894015,Staff,5,0,25,20
1746606971963,SIO 295S,A00,894020,Staff,5,0,25,20
1746606972990,SIOC 290S,B01,958918,Merrifield; Mark A,14,0,30,16
1746606974017,SIOC 291S,B01,958922,Gabriel; Corey John,14,0,30,16
1746606975048,SOCI 117,A01,895339,Staff,2,0,5,3
1746606976074,WES 237B,A00,894149,Staff,11,0,20,9
1746606978167,AESE 279B,A00,891859,Staff,13,0,35,22
1746606979199,AIP 197,001,891854,Vespa; Emanuel Ignacio,9999,0,9999,0
1746606980229,ANTH 289S,A00,891856,Gagneux; Pascal,12,0,12,0
1746606981255,BENG 196,001,957946,Engler; Adam J.,9996,0,9999,3
1746606982284,BISP 197,001,959851,Wilhelm; James E.,9998,0,9999,1
1746606983309,CAT 124RS,A01,956906,Staff,6,0,25,19
1746606984333,CAT 125RS,A01,922013,Staff,6,0,25,19
1746606985362,CLRE 250,A00,891860,Morris; Sheldon,9995,0,9999,4
1746606987413,CLRE 251R,A00,907817,Mehta; Ravindra L.,9994,0,9999,5
1746606988442,CLRE 252,A00,891864,Cuomo; Raphael Eduardo,9993,0,9999,6
1746606989466,CLRE 253,A00,891867,Vaida; Florin,9994,0,9999,5
1746606989466,CLRE 253,B00,907819,Staff,9999,0,9999,0
1746606990496,CLRE 259,A00,891868,Patel; Hemal,9998,0,9999,1
1746606991521,CLRE 260,A00,891872,Cuomo; Raphael Eduardo,9999,0,9999,0
1746606992546,CLRE 297,001,891888,Cuomo; Raphael Eduardo,9999,0,9999,0
1746606993573,CSE 191,A00,958773,Minnes Kemp; Mor Mia,9995,0,9999,4
1746606994598,CSE 197,001,959846,Minnes Kemp; Mor Mia,9990,0,9999,9
1746606995624,CSS 201S,A01,892054,Mignozzetti; Umberto,25,0,30,5
1746606996653,CSS 202S,A01,892056,Mignozzetti; Umberto,25,0,30,5
1746606997678,DSC 197,001,956898,Eldridge; Justin Matthew,9996,0,9999,3
1746606998709,DSC 297,001,958000,Mazumdar; Arya,9998,0,9999,1
1746606998709,DSC 297,002,959862,Wang; Yusu,9998,0,9999,1
1746606999746,EAP 100,A00,905686,Staff,9778,0,9999,221
1746607000776,ECE 45,A01,892618,Staff,0,0,65,65
1746607002832,ECE 111,A01,892719,Staff,6,0,65,59
1746607003857,ECE 197,001,957920,Mercier; Patrick Philip,9991,0,9999,8
1746607004887,ECON 178,A01,907814,Zhu; Ying,26,0,35,9
1746607005913,EDS 115,A00,895312,Staff,35,0,45,10
1746607006941,EDS 117,A01,895337,Staff,23,0,30,7
1746607007972,EDS 125,A00,895341,Jones; Gabrielle Anastasia,36,0,45,9
1746607008998,EDS 128A,A01,895459,Fargason; Sharon Gayle,44,0,45,1
1746607010024,EDS 128B,A01,895543,Pappas; Elizabeth,44,0,45,1
1746607011050,EDS 139,A00,897203,Pappas; Elizabeth,44,0,45,1
1746607011050,EDS 139,B00,897209,Fargason; Sharon Gayle,41,0,45,4
1746607012075,EDS 201,A00,895545,Staff,22,0,45,23
1746607013101,EDS 203,A01,895581,Halter; Christopher P.,22,0,45,23
1746607014133,EDS 204R,A01,895625,Heinzman; Erica M.,39,0,45,6
1746607014133,EDS 204R,B01,895693,Halter; Christopher P.,10,0,45,35
1746607015161,EDS 206R,A00,895694,Fargason; Sharon Gayle,1,0,30,29
1746607015161,EDS 206R,B00,895695,Choi; Bailey Miyeon,16,0,30,14
1746607016187,EDS 250,A00,895697,Hemans; Patricia Ann Benitez,22,0,45,23
1746607017213,EDS 281,A00,895701,Meyerott; Theresa Ann,1,0,15,14
1746607018238,EDS 284,A00,895736,Meyerott; Theresa Ann,1,0,15,14
1746607019266,EDS 286,A00,897210,Fine; Sarah,0,0,15,15
1746607020297,EDS 289C,A01,895770,Daly; Alan J.,1,0,15,14
1746607021326,EDS 290,A00,897211,Hofstetter; Carolyn,0,0,15,15
1746607022352,LIGM 5A,A00,896162,Fischer-Grunski; Eva K,12,0,20,8
1746607023381,LIGM 5B,A00,896260,Fischer-Grunski; Eva K,17,0,20,3
1746607024409,LIGM 5C,A00,896308,Fischer-Grunski; Eva K,18,0,20,2
1746607025436,LIIT 5AS,A00,896313,Carnelos; Chiara,18,0,20,2
1746607026464,LIIT 5BS,A00,896416,Carnelos; Chiara,20,0,20,0
1746607027491,LIIT 5CS,A00,896564,Carnelos; Chiara,20,0,20,0
1746607028522,LISP 5A,A00,896588,Munoz Sanchez; Alicia,2,0,20,18
1746607029552,LISP 5B,A00,896653,Munoz Sanchez; Alicia,7,0,20,13
1746607030583,LISP 5C,A00,896655,Munoz Sanchez; Alicia,0,1,20,20
1746607031612,MAE 197,001,957918,Kleissl; Jan,9996,0,9999,3
1746607031612,MAE 197,002,959806,Boechler; Nicholas Sebastia,9998,0,9999,1
1746607031612,MAE 197,003,959852,Mullin; Jennifer S,9998,0,9999,1
1746607032639,MATH 2,A01,957937,Staff,33,0,35,2
1746607033667,MATH 197,001,957876,Kedlaya; Kiran S.,9993,0,9999,6
1746607034697,MCWP 40,A00,892729,Duru; Nur,10,0,20,10
1746607034697,MCWP 40,B00,893304,Montejo; Carolina,14,0,20,6
1746607035728,MCWP 40R,A00,893757,Redela; Pamela Morgan,0,5,20,20
1746607036797,MCWP 50,A00,893758,Morshed; Michael James,0,0,20,20
1746607036797,MCWP 50,B00,893761,Bartulis; Jason Michael,16,0,20,4
1746607037828,MCWP 50R,A00,893766,Compas; Sean Matthew,0,1,20,20
1746607037828,MCWP 50R,B00,893769,Carter; Jennifer A,0,1,20,20
1746607037828,MCWP 50R,C00,893771,Krone; Jarret,0,3,20,20
1746607037828,MCWP 50R,D00,893772,Miller; Elizabeth Deen,0,0,20,20
1746607037828,MCWP 50R,E00,893775,Carter; Andrea L,0,1,20,20
1746607038854,MMW 11R,A01,892721,Herbst; Matthew,14,0,30,16
1746607038854,MMW 11R,A02,892722,Herbst; Matthew,0,0,0,3
1746607039882,MMW 12R,A01,892724,Herbst; Matthew,0,11,16,16
1746607039882,MMW 12R,A02,892725,Herbst; Matthew,0,10,16,16
1746607040906,MMW 13R,A01,892727,Staff,0,4,16,16
1746607040906,MMW 13R,A02,892728,Staff,0,4,16,16
1746607040906,MMW 13R,A03,958032,Staff,0,4,16,16
1746607040906,MMW 13R,A04,958033,Staff,0,4,16,16
1746607040906,MMW 13R,A05,958034,Staff,0,4,16,16
1746607041936,SIO 295LS,A00,894015,Staff,5,0,25,20
1746607042962,SIO 295S,A00,894020,Staff,5,0,25,20
1746607043990,SIOC 290S,B01,958918,Merrifield; Mark A,14,0,30,16
1746607045018,SIOC 291S,B01,958922,Gabriel; Corey John,14,0,30,16
1746607046045,SOCI 117,A01,895339,Staff,2,0,5,3
1746607047073,WES 237B,A00,894149,Staff,11,0,20,9
1746607049154,AESE 279B,A00,891859,Staff,13,0,35,22
1746607050184,AIP 197,001,891854,Vespa; Emanuel Ignacio,9999,0,9999,0
1746607051210,ANTH 289S,A00,891856,Gagneux; Pascal,12,0,12,0
1746607052237,BENG 196,001,957946,Engler; Adam J.,9996,0,9999,3
1746607053262,BISP 197,001,959851,Wilhelm; James E.,9998,0,9999,1
1746607054289,CAT 124RS,A01,956906,Staff,6,0,25,19
1746607055317,CAT 125RS,A01,922013,Staff,6,0,25,19
1746607056348,CLRE 250,A00,891860,Morris; Sheldon,9995,0,9999,4
1746607058397,CLRE 251R,A00,907817,Mehta; Ravindra L.,9994,0,9999,5
1746607059424,CLRE 252,A00,891864,Cuomo; Raphael Eduardo,9993,0,9999,6
1746607060452,CLRE 253,A00,891867,Vaida; Florin,9994,0,9999,5
1746607060452,CLRE 253,B00,907819,Staff,9999,0,9999,0
1746607061477,CLRE 259,A00,891868,Patel; Hemal,9998,0,9999,1
1746607062504,CLRE 260,A00,891872,Cuomo; Raphael Eduardo,9999,0,9999,0
1746607063530,CLRE 297,001,891888,Cuomo; Raphael Eduardo,9999,0,9999,0
1746607064560,CSE 191,A00,958773,Minnes Kemp; Mor Mia,9995,0,9999,4
1746607065586,CSE 197,001,959846,Minnes Kemp; Mor Mia,9990,0,9999,9
1746607066611,CSS 201S,A01,892054,Mignozzetti; Umberto,25,0,30,5
1746607067637,CSS 202S,A01,892056,Mignozzetti; Umberto,25,0,30,5
1746607068666,DSC 197,001,956898,Eldridge; Justin Matthew,9996,0,9999,3
1746607069692,DSC 297,001,958000,Mazumdar; Arya,9998,0,9999,1
1746607069692,DSC 297,002,959862,Wang; Yusu,9998,0,9999,1
1746607070716,EAP 100,A00,905686,Staff,9778,0,9999,221
1746607071747,ECE 45,A01,892618,Staff,0,0,65,65
1746607073800,ECE 111,A01,892719,Staff,6,0,65,59
1746607074828,ECE 197,001,957920,Mercier; Patrick Philip,9991,0,9999,8
1746607075855,ECON 178,A01,907814,Zhu; Ying,26,0,35,9
1746607076882,EDS 115,A00,895312,Staff,35,0,45,10
1746607077911,EDS 117,A01,895337,Staff,23,0,30,7
1746607078935,EDS 125,A00,895341,Jones; Gabrielle Anastasia,36,0,45,9
1746607079960,EDS 128A,A01,895459,Fargason; Sharon Gayle,44,0,45,1
1746607080985,EDS 128B,A01,895543,Pappas; Elizabeth,44,0,45,1
1746607082010,EDS 139,A00,897203,Pappas; Elizabeth,44,0,45,1
1746607082010,EDS 139,B00,897209,Fargason; Sharon Gayle,41,0,45,4
1746607083037,EDS 201,A00,895545,Staff,22,0,45,23
1746607084064,EDS 203,A01,895581,Halter; Christopher P.,22,0,45,23
1746607085095,EDS 204R,A01,895625,Heinzman; Erica M.,39,0,45,6
1746607085095,EDS 204R,B01,895693,Halter; Christopher P.,10,0,45,35
1746607086123,EDS 206R,A00,895694,Fargason; Sharon Gayle,1,0,30,29
1746607086123,EDS 206R,B00,895695,Choi; Bailey Miyeon,16,0,30,14
1746607087150,EDS 250,A00,895697,Hemans; Patricia Ann Benitez,22,0,45,23
1746607088180,EDS 281,A00,895701,Meyerott; Theresa Ann,1,0,15,14
1746607089206,EDS 284,A00,895736,Meyerott; Theresa Ann,1,0,15,14
1746607090232,EDS 286,A00,897210,Fine; Sarah,0,0,15,15
1746607091256,EDS 289C,A01,895770,Daly; Alan J.,1,0,15,14
1746607092286,EDS 290,A00,897211,Hofstetter; Carolyn,0,0,15,15
1746607093317,LIGM 5A,A00,896162,Fischer-Grunski; Eva K,12,0,20,8
1746607094345,LIGM 5B,A00,896260,Fischer-Grunski; Eva K,17,0,20,3
1746607095374,LIGM 5C,A00,896308,Fischer-Grunski; Eva K,18,0,20,2
1746607096401,LIIT 5AS,A00,896313,Carnelos; Chiara,18,0,20,2
1746607097426,LIIT 5BS,A00,896416,Carnelos; Chiara,20,0,20,0
1746607098456,LIIT 5CS,A00,896564,Carnelos; Chiara,20,0,20,0
1746607099486,LISP 5A,A00,896588,Munoz Sanchez; Alicia,2,0,20,18
1746607100510,LISP 5B,A00,896653,Munoz Sanchez; Alicia,7,0,20,13
1746607101542,LISP 5C,A00,896655,Munoz Sanchez; Alicia,0,1,20,20
1746607102567,MAE 197,001,957918,Kleissl; Jan,9996,0,9999,3
1746607102567,MAE 197,002,959806,Boechler; Nicholas Sebastia,9998,0,9999,1
1746607102567,MAE 197,003,959852,Mullin; Jennifer S,9998,0,9999,1
1746607103598,MATH 2,A01,957937,Staff,33,0,35,2
1746607104628,MATH 197,001,957876,Kedlaya; Kiran S.,9993,0,9999,6
1746607105656,MCWP 40,A00,892729,Duru; Nur,10,0,20,10
1746607105656,MCWP 40,B00,893304,Montejo; Carolina,14,0,20,6
1746607106683,MCWP 40R,A00,893757,Redela; Pamela Morgan,0,5,20,20
1746607107711,MCWP 50,A00,893758,Morshed; Michael James,0,0,20,20
1746607107711,MCWP 50,B00,893761,Bartulis; Jason Michael,16,0,20,4
1746607108739,MCWP 50R,A00,893766,Compas; Sean Matthew,0,1,20,20
1746607108739,MCWP 50R,B00,893769,Carter; Jennifer A,0,1,20,20
1746607108739,MCWP 50R,C00,893771,Krone; Jarret,0,3,20,20
1746607108739,MCWP 50R,D00,893772,Miller; Elizabeth Deen,0,0,20,20
1746607108739,MCWP 50R,E00,893775,Carter; Andrea L,0,1,20,20
1746607109767,MMW 11R,A01,892721,Herbst; Matthew,14,0,30,16
1746607109767,MMW 11R,A02,892722,Herbst; Matthew,0,0,0,3
1746607110794,MMW 12R,A01,892724,Herbst; Matthew,0,11,16,16
1746607110794,MMW 12R,A02,892725,Herbst; Matthew,0,10,16,16
1746607111822,MMW 13R,A01,892727,Staff,0,4,16,16
1746607111822,MMW 13R,A02,892728,Staff,0,4,16,16
1746607111822,MMW 13R,A03,958032,Staff,0,4,16,16
1746607111822,MMW 13R,A04,958033,Staff,0,4,16,16
1746607111822,MMW 13R,A05,958034,Staff,0,4,16,16
1746607112850,SIO 295LS,A00,894015,Staff,5,0,25,20
1746607113876,SIO 295S,A00,894020,Staff,5,0,25,20
1746607114906,SIOC 290S,B01,958918,Merrifield; Mark A,14,0,30,16
1746607115937,SIOC 291S,B01,958922,Gabriel; Corey John,14,0,30,16
1746607116963,SOCI 117,A01,895339,Staff,2,0,5,3
1746607117992,WES 237B,A00,894149,Staff,11,0,20,9
1746607120077,AESE 279B,A00,891859,Staff,13,0,35,22
1746607121102,AIP 197,001,891854,Vespa; Emanuel Ignacio,9999,0,9999,0
1746607122132,ANTH 289S,A00,891856,Gagneux; Pascal,12,0,12,0
1746607123160,BENG 196,001,957946,Engler; Adam J.,9996,0,9999,3
1746607124188,BISP 197,001,959851,Wilhelm; James E.,9998,0,9999,1
1746607125214,CAT 124RS,A01,956906,Staff,6,0,25,19
1746607126242,CAT 125RS,A01,922013,Staff,6,0,25,19
1746607127267,CLRE 250,A00,891860,Morris; Sheldon,9995,0,9999,4
1746607129324,CLRE 251R,A00,907817,Mehta; Ravindra L.,9994,0,9999,5
1746607130349,CLRE 252,A00,891864,Cuomo; Raphael Eduardo,9993,0,9999,6
1746607131377,CLRE 253,A00,891867,Vaida; Florin,9994,0,9999,5
1746607131377,CLRE 253,B00,907819,Staff,9999,0,9999,0
1746607132401,CLRE 259,A00,891868,Patel; Hemal,9998,0,9999,1
1746607133427,CLRE 260,A00,891872,Cuomo; Raphael Eduardo,9999,0,9999,0
1746607134452,CLRE 297,001,891888,Cuomo; Raphael Eduardo,9999,0,9999,0
1746607135481,CSE 191,A00,958773,Minnes Kemp; Mor Mia,9995,0,9999,4
1746607136510,CSE 197,001,959846,Minnes Kemp; Mor Mia,9990,0,9999,9
1746607137541,CSS 201S,A01,892054,Mignozzetti; Umberto,25,0,30,5
1746607138570,CSS 202S,A01,892056,Mignozzetti; Umberto,25,0,30,5
1746607139597,DSC 197,001,956898,Eldridge; Justin Matthew,9996,0,9999,3
1746607140664,DSC 297,001,958000,Mazumdar; Arya,9998,0,9999,1
1746607140664,DSC 297,002,959862,Wang; Yusu,9998,0,9999,1
1746607141690,EAP 100,A00,905686,Staff,9778,0,9999,221
1746607142716,ECE 45,A01,892618,Staff,0,0,65,65
1746607144774,ECE 111,A01,892719,Staff,6,0,65,59
1746607145799,ECE 197,001,957920,Mercier; Patrick Philip,9991,0,9999,8
1746607146827,ECON 178,A01,907814,Zhu; Ying,26,0,35,9
1746607147855,EDS 115,A00,895312,Staff,35,0,45,10
1746607148880,EDS 117,A01,895337,Staff,23,0,30,7
1746607149909,EDS 125,A00,895341,Jones; Gabrielle Anastasia,36,0,45,9
1746607150939,EDS 128A,A01,895459,Fargason; Sharon Gayle,44,0,45,1
1746607151967,EDS 128B,A01,895543,Pappas; Elizabeth,44,0,45,1
1746607152992,EDS 139,A00,897203,Pappas; Elizabeth,44,0,45,1
1746607152992,EDS 139,B00,897209,Fargason; Sharon Gayle,41,0,45,4
1746607154018,EDS 201,A00,895545,Staff,22,0,45,23
1746607155045,EDS 203,A01,895581,Halter; Christopher P.,22,0,45,23
1746607156072,EDS 204R,A01,895625,Heinzman; Erica M.,39,0,45,6
1746607156072,EDS 204R,B01,895693,Halter; Christopher P.,10,0,45,35
1746607157101,EDS 206R,A00,895694,Fargason; Sharon Gayle,1,0,30,29
1746607157101,EDS 206R,B00,895695,Choi; Bailey Miyeon,16,0,30,14
1746607158127,EDS 250,A00,895697,Hemans; Patricia Ann Benitez,22,0,45,23
1746607159152,EDS 281,A00,895701,Meyerott; Theresa Ann,1,0,15,14
1746607160177,EDS 284,A00,895736,Meyerott; Theresa Ann,1,0,15,14
1746607161206,EDS 286,A00,897210,Fine; Sarah,0,0,15,15
1746607162235,EDS 289C,A01,895770,Daly; Alan J.,1,0,15,14
1746607163260,EDS 290,A00,897211,Hofstetter; Carolyn,0,0,15,15
1746607164290,LIGM 5A,A00,896162,Fischer-Grunski; Eva K,12,0,20,8
1746607165314,LIGM 5B,A00,896260,Fischer-Grunski; Eva K,17,0,20,3
1746607166340,LIGM 5C,A00,896308,Fischer-Grunski; Eva K,18,0,20,2
1746607167366,LIIT 5AS,A00,896313,Carnelos; Chiara,18,0,20,2
1746607168391,LIIT 5BS,A00,896416,Carnelos; Chiara,20,0,20,0
1746607169421,LIIT 5CS,A00,896564,Carnelos; Chiara,20,0,20,0
1746607170446,LISP 5A,A00,896588,Munoz Sanchez; Alicia,2,0,20,18
1746607171471,LISP 5B,A00,896653,Munoz Sanchez; Alicia,7,0,20,13
1746607172497,LISP 5C,A00,896655,Munoz Sanchez; Alicia,0,1,20,20
1746607173528,MAE 197,001,957918,Kleissl; Jan,9996,0,9999,3
1746607173528,MAE 197,002,959806,Boechler; Nicholas Sebastia,9998,0,9999,1
1746607173528,MAE 197,003,959852,Mullin; Jennifer S,9998,0,9999,1
1746607174554,MATH 2,A01,957937,Staff,33,0,35,2
1746607175581,MATH 197,001,957876,Kedlaya; Kiran S.,9993,0,9999,6
1746607176612,MCWP 40,A00,892729,Duru; Nur,10,0,20,10
1746607176612,MCWP 40,B00,893304,Montejo; Carolina,14,0,20,6
1746607177637,MCWP 40R,A00,893757,Redela; Pamela Morgan,0,5,20,20
1746607178663,MCWP 50,A00,893758,Morshed; Michael James,0,0,20,20
1746607178663,MCWP 50,B00,893761,Bartulis; Jason Michael,16,0,20,4
1746607179693,MCWP 50R,A00,893766,Compas; Sean Matthew,0,1,20,20
1746607179693,MCWP 50R,B00,893769,Carter; Jennifer A,0,1,20,20
1746607179693,MCWP 50R,C00,893771,Krone; Jarret,0,3,20,20
1746607179693,MCWP 50R,D00,893772,Miller; Elizabeth Deen,0,0,20,20
1746607179693,MCWP 50R,E00,893775,Carter; Andrea L,0,1,20,20
1746607180719,MMW 11R,A01,892721,Herbst; Matthew,14,0,30,16
1746607180719,MMW 11R,A02,892722,Herbst; Matthew,0,0,0,3
1746607181745,MMW 12R,A01,892724,Herbst; Matthew,0,11,16,16
1746607181745,MMW 12R,A02,892725,Herbst; Matthew,0,10,16,16
1746607182773,MMW 13R,A01,892727,Staff,0,4,16,16
1746607182773,MMW 13R,A02,892728,Staff,0,4,16,16
1746607182773,MMW 13R,A03,958032,Staff,0,4,16,16
1746607182773,MMW 13R,A04,958033,Staff,0,4,16,16
1746607182773,MMW 13R,A05,958034,Staff,0,4,16,16
1746607183800,SIO 295LS,A00,894015,Staff,5,0,25,20
1746607184830,SIO 295S,A00,894020,Staff,5,0,25,20
1746607185857,SIOC 290S,B01,958918,Merrifield; Mark A,14,0,30,16
1746607186888,SIOC 291S,B01,958922,Gabriel; Corey John,14,0,30,16
1746607187917,SOCI 117,A01,895339,Staff,2,0,5,3
1746607188943,WES 237B,A00,894149,Staff,11,0,20,9
1746607191019,AESE 279B,A00,891859,Staff,13,0,35,22
1746607192048,AIP 197,001,891854,Vespa; Emanuel Ignacio,9999,0,9999,0
1746607193075,ANTH 289S,A00,891856,Gagneux; Pascal,12,0,12,0
1746607194100,BENG 196,001,957946,Engler; Adam J.,9996,0,9999,3
1746607195126,BISP 197,001,959851,Wilhelm; James E.,9998,0,9999,1
1746607196152,CAT 124RS,A01,956906,Staff,6,0,25,19
1746607197179,CAT 125RS,A01,922013,Staff,6,0,25,19
1746607198205,CLRE 250,A00,891860,Morris; Sheldon,9995,0,9999,4
1746607200257,CLRE 251R,A00,907817,Mehta; Ravindra L.,9994,0,9999,5
1746607201283,CLRE 252,A00,891864,Cuomo; Raphael Eduardo,9993,0,9999,6
1746607202310,CLRE 253,A00,891867,Vaida; Florin,9994,0,9999,5
1746607202310,CLRE 253,B00,907819,Staff,9999,0,9999,0
1746607203339,CLRE 259,A00,891868,Patel; Hemal,9998,0,9999,1
1746607204363,CLRE 260,A00,891872,Cuomo; Raphael Eduardo,9999,0,9999,0
1746607205392,CLRE 297,001,891888,Cuomo; Raphael Eduardo,9999,0,9999,0
1746607206418,CSE 191,A00,958773,Minnes Kemp; Mor Mia,9995,0,9999,4
1746607207442,CSE 197,001,959846,Minnes Kemp; Mor Mia,9990,0,9999,9
1746607208468,CSS 201S,A01,892054,Mignozzetti; Umberto,25,0,30,5
1746607209495,CSS 202S,A01,892056,Mignozzetti; Umberto,25,0,30,5
1746607210519,DSC 197,001,956898,Eldridge; Justin Matthew,9996,0,9999,3
1746607211546,DSC 297,001,958000,Mazumdar; Arya,9998,0,9999,1
1746607211546,DSC 297,002,959862,Wang; Yusu,9998,0,9999,1
1746607212572,EAP 100,A00,905686,Staff,9778,0,9999,221
1746607213603,ECE 45,A01,892618,Staff,0,0,65,65
1746607215660,ECE 111,A01,892719,Staff,6,0,65,59
1746607216687,ECE 197,001,957920,Mercier; Patrick Philip,9991,0,9999,8
1746607217712,ECON 178,A01,907814,Zhu; Ying,26,0,35,9
1746607218738,EDS 115,A00,895312,Staff,35,0,45,10
1746607219767,EDS 117,A01,895337,Staff,23,0,30,7
1746607220795,EDS 125,A00,895341,Jones; Gabrielle Anastasia,36,0,45,9
1746607221824,EDS 128A,A01,895459,Fargason; Sharon Gayle,44,0,45,1
1746607222850,EDS 128B,A01,895543,Pappas; Elizabeth,44,0,45,1
1746607223882,EDS 139,A00,897203,Pappas; Elizabeth,44,0,45,1
1746607223882,EDS 139,B00,897209,Fargason; Sharon Gayle,41,0,45,4
1746607224907,EDS 201,A00,895545,Staff,22,0,45,23
1746607225933,EDS 203,A01,895581,Halter; Christopher P.,22,0,45,23
1746607226961,EDS 204R,A01,895625,Heinzman; Erica M.,39,0,45,6
1746607226961,EDS 204R,B01,895693,Halter; Christopher P.,10,0,45,35
1746607227985,EDS 206R,A00,895694,Fargason; Sharon Gayle,1,0,30,29
1746607227985,EDS 206R,B00,895695,Choi; Bailey Miyeon,16,0,30,14
1746607229012,EDS 250,A00,895697,Hemans; Patricia Ann Benitez,22,0,45,23
1746607230040,EDS 281,A00,895701,Meyerott; Theresa Ann,1,0,15,14
1746607231065,EDS 284,A00,895736,Meyerott; Theresa Ann,1,0,15,14
1746607232091,EDS 286,A00,897210,Fine; Sarah,0,0,15,15
1746607233119,EDS 289C,A01,895770,Daly; Alan J.,1,0,15,14
1746607234143,EDS 290,A00,897211,Hofstetter; Carolyn,0,0,15,15
1746607235169,LIGM 5A,A00,896162,Fischer-Grunski; Eva K,12,0,20,8
1746607236199,LIGM 5B,A00,896260,Fischer-Grunski; Eva K,17,0,20,3
1746607237227,LIGM 5C,A00,896308,Fischer-Grunski; Eva K,18,0,20,2
1746607238251,LIIT 5AS,A00,896313,Carnelos; Chiara,18,0,20,2
1746607239277,LIIT 5BS,A00,896416,Carnelos; Chiara,20,0,20,0
1746607240307,LIIT 5CS,A00,896564,Carnelos; Chiara,20,0,20,0
1746607241334,LISP 5A,A00,896588,Munoz Sanchez; Alicia,2,0,20,18
1746607242361,LISP 5B,A00,896653,Munoz Sanchez; Alicia,7,0,20,13
1746607243391,LISP 5C,A00,896655,Munoz Sanchez; Alicia,0,1,20,20
1746607244457,MAE 197,001,957918,Kleissl; Jan,9996,0,9999,3
1746607244457,MAE 197,002,959806,Boechler; Nicholas Sebastia,9998,0,9999,1
1746607244457,MAE 197,003,959852,Mullin; Jennifer S,9998,0,9999,1
1746607245484,MATH 2,A01,957937,Staff,33,0,35,2
1746607246513,MATH 197,001,957876,Kedlaya; Kiran S.,9993,0,9999,6
1746607247539,MCWP 40,A00,892729,Duru; Nur,10,0,20,10
1746607247539,MCWP 40,B00,893304,Montejo; Carolina,14,0,20,6
1746607248567,MCWP 40R,A00,893757,Redela; Pamela Morgan,0,5,20,20
1746607249593,MCWP 50,A00,893758,Morshed; Michael James,0,0,20,20
1746607249593,MCWP 50,B00,893761,Bartulis; Jason Michael,16,0,20,4
1746607250623,MCWP 50R,A00,893766,Compas; Sean Matthew,0,1,20,20
1746607250623,MCWP 50R,B00,893769,Carter; Jennifer A,0,1,20,20
1746607250623,MCWP 50R,C00,893771,Krone; Jarret,0,3,20,20
1746607250623,MCWP 50R,D00,893772,Miller; Elizabeth Deen,0,0,20,20
1746607250623,MCWP 50R,E00,893775,Carter; Andrea L,0,1,20,20
1746607251649,MMW 11R,A01,892721,Herbst; Matthew,14,0,30,16
1746607251649,MMW 11R,A02,892722,Herbst; Matthew,0,0,0,3
1746607252677,MMW 12R,A01,892724,Herbst; Matthew,0,11,16,16
1746607252677,MMW 12R,A02,892725,Herbst; Matthew,0,10,16,16
1746607253706,MMW 13R,A01,892727,Staff,0,4,16,16
1746607253706,MMW 13R,A02,892728,Staff,0,4,16,16
1746607253706,MMW 13R,A03,958032,Staff,0,4,16,16
1746607253706,MMW 13R,A04,958033,Staff,0,4,16,16
1746607253706,MMW 13R,A05,958034,Staff,0,4,16,16
1746607254733,SIO 295LS,A00,894015,Staff,5,0,25,20
1746607255758,SIO 295S,A00,894020,Staff,5,0,25,20
1746607256783,SIOC 290S,B01,958918,Merrifield; Mark A,14,0,30,16
1746607257810,SIOC 291S,B01,958922,Gabriel; Corey John,14,0,30,16
1746607258840,SOCI 117,A01,895339,Staff,2,0,5,3
1746607259865,WES 237B,A00,894149,Staff,11,0,20,9
1746607261958,AESE 279B,A00,891859,Staff,13,0,35,22
1746607262986,AIP 197,001,891854,Vespa; Emanuel Ignacio,9999,0,9999,0
1746607264014,ANTH 289S,A00,891856,Gagneux; Pascal,12,0,12,0
1746607265052,BENG 196,001,957946,Engler; Adam J.,9996,0,9999,3
1746607266084,BISP 197,001,959851,Wilhelm; James E.,9998,0,9999,1
1746607267115,CAT 124RS,A01,956906,Staff,6,0,25,19
1746607268141,CAT 125RS,A01,922013,Staff,6,0,25,19
1746607269171,CLRE 250,A00,891860,Morris; Sheldon,9995,0,9999,4
1746607271228,CLRE 251R,A00,907817,Mehta; Ravindra L.,9994,0,9999,5
1746607272255,CLRE 252,A00,891864,Cuomo; Raphael Eduardo,9993,0,9999,6
1746607273285,CLRE 253,A00,891867,Vaida; Florin,9994,0,9999,5
1746607273285,CLRE 253,B00,907819,Staff,9999,0,9999,0
1746607274312,CLRE 259,A00,891868,Patel; Hemal,9998,0,9999,1
1746607275337,CLRE 260,A00,891872,Cuomo; Raphael Eduardo,9999,0,9999,0
1746607276365,CLRE 297,001,891888,Cuomo; Raphael Eduardo,9999,0,9999,0
1746607277395,CSE 191,A00,958773,Minnes Kemp; Mor Mia,9995,0,9999,4
1746607278422,CSE 197,001,959846,Minnes Kemp; Mor Mia,9990,0,9999,9
1746607279454,CSS 201S,A01,892054,Mignozzetti; Umberto,25,0,30,5
1746607280482,CSS 202S,A01,892056,Mignozzetti; Umberto,25,0,30,5
1746607281509,DSC 197,001,956898,Eldridge; Justin Matthew,9996,0,9999,3
1746607282540,DSC 297,001,958000,Mazumdar; Arya,9998,0,9999,1
1746607282540,DSC 297,002,959862,Wang; Yusu,9998,0,9999,1
1746607283569,EAP 100,A00,905686,Staff,9778,0,9999,221
1746607284601,ECE 45,A01,892618,Staff,0,0,65,65
1746607286657,ECE 111,A01,892719,Staff,6,0,65,59
1746607287687,ECE 197,001,957920,Mercier; Patrick Philip,9991,0,9999,8
1746607288712,ECON 178,A01,907814,Zhu; Ying,26,0,35,9
1746607289739,EDS 115,A00,895312,Staff,35,0,45,10
1746607290766,EDS 117,A01,895337,Staff,23,0,30,7
1746607291793,EDS 125,A00,895341,Jones; Gabrielle Anastasia,36,0,45,9
1746607292818,EDS 128A,A01,895459,Fargason; Sharon Gayle,44,0,45,1
1746607293851,EDS 128B,A01,895543,Pappas; Elizabeth,44,0,45,1
1746607294880,EDS 139,A00,897203,Pappas; Elizabeth,44,0,45,1
1746607294880,EDS 139,B00,897209,Fargason; Sharon Gayle,41,0,45,4
1746607295909,EDS 201,A00,895545,Staff,22,0,45,23
1746607296935,EDS 203,A01,895581,Halter; Christopher P.,22,0,45,23
1746607297962,EDS 204R,A01,895625,Heinzman; Erica M.,39,0,45,6
1746607297962,EDS 204R,B01,895693,Halter; Christopher P.,10,0,45,35
1746607298992,EDS 206R,A00,895694,Fargason; Sharon Gayle,1,0,30,29
1746607298992,EDS 206R,B00,895695,Choi; Bailey Miyeon,16,0,30,14
1746607300023,EDS 250,A00,895697,Hemans; Patricia Ann Benitez,22,0,45,23
1746607301051,EDS 281,A00,895701,Meyerott; Theresa Ann,1,0,15,14
1746607302080,EDS 284,A00,895736,Meyerott; Theresa Ann,1,0,15,14
1746607303106,EDS 286,A00,897210,Fine; Sarah,0,0,15,15
1746607304135,EDS 289C,A01,895770,Daly; Alan J.,1,0,15,14
1746607305162,EDS 290,A00,897211,Hofstetter; Carolyn,0,0,15,15
1746607306195,LIGM 5A,A00,896162,Fischer-Grunski; Eva K,12,0,20,8
1746607307225,LIGM 5B,A00,896260,Fischer-Grunski; Eva K,17,0,20,3
1746607308252,LIGM 5C,A00,896308,Fischer-Grunski; Eva K,18,0,20,2
1746607309281,LIIT 5AS,A00,896313,Carnelos; Chiara,18,0,20,2
1746607310310,LIIT 5BS,A00,896416,Carnelos; Chiara,20,0,20,0
1746607311339,LIIT 5CS,A00,896564,Carnelos; Chiara,20,0,20,0
1746607312371,LISP 5A,A00,896588,Munoz Sanchez; Alicia,2,0,20,18
1746607313404,LISP 5B,A00,896653,Munoz Sanchez; Alicia,7,0,20,13
1746607314430,LISP 5C,A00,896655,Munoz Sanchez; Alicia,0,1,20,20
1746607315462,MAE 197,001,957918,Kleissl; Jan,9996,0,9999,3
1746607315462,MAE 197,002,959806,Boechler; Nicholas Sebastia,9998,0,9999,1
1746607315462,MAE 197,003,959852,Mullin; Jennifer S,9998,0,9999,1
1746607316488,MATH 2,A01,957937,Staff,33,0,35,2
1746607317513,MATH 197,001,957876,Kedlaya; Kiran S.,9993,0,9999,6
1746607318548,MCWP 40,A00,892729,Duru; Nur,10,0,20,10
1746607318548,MCWP 40,B00,893304,Montejo; Carolina,14,0,20,6
1746607319576,MCWP 40R,A00,893757,Redela; Pamela Morgan,0,5,20,20
1746607320603,MCWP 50,A00,893758,Morshed; Michael James,0,0,20,20
1746607320603,MCWP 50,B00,893761,Bartulis; Jason Michael,16,0,20,4
1746607321631,MCWP 50R,A00,893766,Compas; Sean Matthew,0,1,20,20
1746607321631,MCWP 50R,B00,893769,Carter; Jennifer A,0,1,20,20
1746607321631,MCWP 50R,C00,893771,Krone; Jarret,0,3,20,20
1746607321631,MCWP 50R,D00,893772,Miller; Elizabeth Deen,0,0,20,20
1746607321631,MCWP 50R,E00,893775,Carter; Andrea L,0,1,20,20
1746607322665,MMW 11R,A01,892721,Herbst; Matthew,14,0,30,16
1746607322665,MMW 11R,A02,892722,Herbst; Matthew,0,0,0,3
1746607323694,MMW 12R,A01,892724,Herbst; Matthew,0,11,16,16
1746607323694,MMW 12R,A02,892725,Herbst; Matthew,0,10,16,16
1746607324721,MMW 13R,A01,892727,Staff,0,4,16,16
1746607324721,MMW 13R,A02,892728,Staff,0,4,16,16
1746607324721,MMW 13R,A03,958032,Staff,0,4,16,16
1746607324721,MMW 13R,A04,958033,Staff,0,4,16,16
1746607324721,MMW 13R,A05,958034,Staff,0,4,16,16
1746607325751,SIO 295LS,A00,894015,Staff,5,0,25,20
1746607326781,SIO 295S,A00,894020,Staff,5,0,25,20
1746607327809,SIOC 290S,B01,958918,Merrifield; Mark A,14,0,30,16
1746607328836,SIOC 291S,B01,958922,Gabriel; Corey John,14,0,30,16
1746607329863,SOCI 117,A01,895339,Staff,2,0,5,3
1746607330890,WES 237B,A00,894149,Staff,11,0,20,9
1746607332981,AESE 279B,A00,891859,Staff,13,0,35,22
1746607334012,AIP 197,001,891854,Vespa; Emanuel Ignacio,9999,0,9999,0
1746607335038,ANTH 289S,A00,891856,Gagneux; Pascal,12,0,12,0
1746607336069,BENG 196,001,957946,Engler; Adam J.,9996,0,9999,3
1746607337097,BISP 197,001,959851,Wilhelm; James E.,9998,0,9999,1
1746607338126,CAT 124RS,A01,956906,Staff,6,0,25,19
1746607339151,CAT 125RS,A01,922013,Staff,6,0,25,19
1746607340175,CLRE 250,A00,891860,Morris; Sheldon,9995,0,9999,4
1746607342227,CLRE 251R,A00,907817,Mehta; Ravindra L.,9994,0,9999,5
1746607343257,CLRE 252,A00,891864,Cuomo; Raphael Eduardo,9993,0,9999,6
1746607344284,CLRE 253,A00,891867,Vaida; Florin,9994,0,9999,5
1746607344284,CLRE 253,B00,907819,Staff,9999,0,9999,0
1746607345314,CLRE 259,A00,891868,Patel; Hemal,9998,0,9999,1
1746607346344,CLRE 260,A00,891872,Cuomo; Raphael Eduardo,9999,0,9999,0
1746607347370,CLRE 297,001,891888,Cuomo; Raphael Eduardo,9999,0,9999,0
1746607348400,CSE 191,A00,958773,Minnes Kemp; Mor Mia,9995,0,9999,4
1746607349434,CSE 197,001,959846,Minnes Kemp; Mor Mia,9990,0,9999,9
1746607350462,CSS 201S,A01,892054,Mignozzetti; Umberto,25,0,30,5
1746607351493,CSS 202S,A01,892056,Mignozzetti; Umberto,25,0,30,5
1746607352522,DSC 197,001,956898,Eldridge; Justin Matthew,9996,0,9999,3
1746607353547,DSC 297,001,958000,Mazumdar; Arya,9998,0,9999,1
1746607353547,DSC 297,002,959862,Wang; Yusu,9998,0,9999,1
1746607354579,EAP 100,A00,905686,Staff,9778,0,9999,221
1746607355607,ECE 45,A01,892618,Staff,0,0,65,65
1746607357668,ECE 111,A01,892719,Staff,6,0,65,59
1746607358695,ECE 197,001,957920,Mercier; Patrick Philip,9991,0,9999,8
1746607359722,ECON 178,A01,907814,Zhu; Ying,26,0,35,9
1746607360750,EDS 115,A00,895312,Staff,35,0,45,10
1746607361776,EDS 117,A01,895337,Staff,23,0,30,7
1746607362804,EDS 125,A00,895341,Jones; Gabrielle Anastasia,36,0,45,9
1746607363836,EDS 128A,A01,895459,Fargason; Sharon Gayle,44,0,45,1
1746607364867,EDS 128B,A01,895543,Pappas; Elizabeth,44,0,45,1
1746607365895,EDS 139,A00,897203,Pappas; Elizabeth,44,0,45,1
1746607365895,EDS 139,B00,897209,Fargason; Sharon Gayle,41,0,45,4
1746607366920,EDS 201,A00,895545,Staff,22,0,45,23
1746607367947,EDS 203,A01,895581,Halter; Christopher P.,22,0,45,23
1746607368973,EDS 204R,A01,895625,Heinzman; Erica M.,39,0,45,6
1746607368973,EDS 204R,B01,895693,Halter; Christopher P.,10,0,45,35
1746607370001,EDS 206R,A00,895694,Fargason; Sharon Gayle,1,0,30,29
1746607370001,EDS 206R,B00,895695,Choi; Bailey Miyeon,16,0,30,14
1746607371031,EDS 250,A00,895697,Hemans; Patricia Ann Benitez,22,0,45,23
1746607372060,EDS 281,A00,895701,Meyerott; Theresa Ann,1,0,15,14
1746607373088,EDS 284,A00,895736,Meyerott; Theresa Ann,1,0,15,14
1746607374115,EDS 286,A00,897210,Fine; Sarah,0,0,15,15
1746607375141,EDS 289C,A01,895770,Daly; Alan J.,1,0,15,14
1746607376169,EDS 290,A00,897211,Hofstetter; Carolyn,0,0,15,15
1746607377201,LIGM 5A,A00,896162,Fischer-Grunski; Eva K,12,0,20,8
1746607378227,LIGM 5B,A00,896260,Fischer-Grunski; Eva K,17,0,20,3
1746607379257,LIGM 5C,A00,896308,Fischer-Grunski; Eva K,18,0,20,2
1746607380287,LIIT 5AS,A00,896313,Carnelos; Chiara,18,0,20,2
1746607381317,LIIT 5BS,A00,896416,Carnelos; Chiara,20,0,20,0
1746607382345,LIIT 5CS,A00,896564,Carnelos; Chiara,20,0,20,0
1746607383372,LISP 5A,A00,896588,Munoz Sanchez; Alicia,2,0,20,18
1746607384400,LISP 5B,A00,896653,Munoz Sanchez; Alicia,7,0,20,13
1746607385432,LISP 5C,A00,896655,Munoz Sanchez; Alicia,0,1,20,20
1746607386460,MAE 197,001,957918,Kleissl; Jan,9996,0,9999,3
1746607386460,MAE 197,002,959806,Boechler; Nicholas Sebastia,9998,0,9999,1
1746607386460,MAE 197,003,959852,Mullin; Jennifer S,9998,0,9999,1
1746607387487,MATH 2,A01,957937,Staff,33,0,35,2
1746607388516,MATH 197,001,957876,Kedlaya; Kiran S.,9993,0,9999,6
1746607389541,MCWP 40,A00,892729,Duru; Nur,10,0,20,10
1746607389541,MCWP 40,B00,893304,Montejo; Carolina,14,0,20,6
1746607390573,MCWP 40R,A00,893757,Redela; Pamela Morgan,0,5,20,20
1746607391599,MCWP 50,A00,893758,Morshed; Michael James,0,0,20,20
1746607391599,MCWP 50,B00,893761,Bartulis; Jason Michael,16,0,20,4
1746607392626,MCWP 50R,A00,893766,Compas; Sean Matthew,0,1,20,20
1746607392626,MCWP 50R,B00,893769,Carter; Jennifer A,0,1,20,20
1746607392626,MCWP 50R,C00,893771,Krone; Jarret,0,3,20,20
1746607392626,MCWP 50R,D00,893772,Miller; Elizabeth Deen,0,0,20,20
1746607392626,MCWP 50R,E00,893775,Carter; Andrea L,0,1,20,20
1746607393652,MMW 11R,A01,892721,Herbst; Matthew,14,0,30,16
1746607393652,MMW 11R,A02,892722,Herbst; Matthew,0,0,0,3
1746607394679,MMW 12R,A01,892724,Herbst; Matthew,0,11,16,16
1746607394679,MMW 12R,A02,892725,Herbst; Matthew,0,10,16,16
1746607395706,MMW 13R,A01,892727,Staff,0,4,16,16
1746607395706,MMW 13R,A02,892728,Staff,0,4,16,16
1746607395706,MMW 13R,A03,958032,Staff,0,4,16,16
1746607395706,MMW 13R,A04,958033,Staff,0,4,16,16
1746607395706,MMW 13R,A05,958034,Staff,0,4,16,16
1746607396732,SIO 295LS,A00,894015,Staff,5,0,25,20
1746607397757,SIO 295S,A00,894020,Staff,5,0,25,20
1746607398783,SIOC 290S,B01,958918,Merrifield; Mark A,14,0,30,16
1746607399816,SIOC 291S,B01,958922,Gabriel; Corey John,14,0,30,16
1746607400842,SOCI 117,A01,895339,Staff,2,0,5,3
1746607401869,WES 237B,A00,894149,Staff,11,0,20,9
1746607403954,AESE 279B,A00,891859,Staff,13,0,35,22
1746607404984,AIP 197,001,891854,Vespa; Emanuel Ignacio,9999,0,9999,0
1746607406014,ANTH 289S,A00,891856,Gagneux; Pascal,12,0,12,0
1746607407041,BENG 196,001,957946,Engler; Adam J.,9996,0,9999,3
1746607408070,BISP 197,001,959851,Wilhelm; James E.,9998,0,9999,1
1746607409100,CAT 124RS,A01,956906,Staff,6,0,25,19
1746607410126,CAT 125RS,A01,922013,Staff,6,0,25,19
1746607411151,CLRE 250,A00,891860,Morris; Sheldon,9995,0,9999,4
1746607413206,CLRE 251R,A00,907817,Mehta; Ravindra L.,9994,0,9999,5
1746607414231,CLRE 252,A00,891864,Cuomo; Raphael Eduardo,9993,0,9999,6
1746607415262,CLRE 253,A00,891867,Vaida; Florin,9994,0,9999,5
1746607415262,CLRE 253,B00,907819,Staff,9999,0,9999,0
1746607416292,CLRE 259,A00,891868,Patel; Hemal,9998,0,9999,1
1746607417320,CLRE 260,A00,891872,Cuomo; Raphael Eduardo,9999,0,9999,0
1746607418344,CLRE 297,001,891888,Cuomo; Raphael Eduardo,9999,0,9999,0
1746607419371,CSE 191,A00,958773,Minnes Kemp; Mor Mia,9995,0,9999,4
1746607420396,CSE 197,001,959846,Minnes Kemp; Mor Mia,9990,0,9999,9
1746607421425,CSS 201S,A01,892054,Mignozzetti; Umberto,25,0,30,5
1746607422463,CSS 202S,A01,892056,Mignozzetti; Umberto,25,0,30,5
1746607423490,DSC 197,001,956898,Eldridge; Justin Matthew,9996,0,9999,3
1746607424522,DSC 297,001,958000,Mazumdar; Arya,9998,0,9999,1
1746607424522,DSC 297,002,959862,Wang; Yusu,9998,0,9999,1
1746607425549,EAP 100,A00,905686,Staff,9778,0,9999,221
1746607426577,ECE 45,A01,892618,Staff,0,0,65,65
1746607428638,ECE 111,A01,892719,Staff,6,0,65,59
1746607429664,ECE 197,001,957920,Mercier; Patrick Philip,9991,0,9999,8
1746607430695,ECON 178,A01,907814,Zhu; Ying,26,0,35,9
1746607431726,EDS 115,A00,895312,Staff,35,0,45,10
1746607432753,EDS 117,A01,895337,Staff,23,0,30,7
1746607433779,EDS 125,A00,895341,Jones; Gabrielle Anastasia,36,0,45,9
1746607434806,EDS 128A,A01,895459,Fargason; Sharon Gayle,44,0,45,1
1746607435831,EDS 128B,A01,895543,Pappas; Elizabeth,44,0,45,1
1746607436857,EDS 139,A00,897203,Pappas; Elizabeth,44,0,45,1
1746607436857,EDS 139,B00,897209,Fargason; Sharon Gayle,41,0,45,4
1746607437882,EDS 201,A00,895545,Staff,22,0,45,23
1746607438908,EDS 203,A01,895581,Halter; Christopher P.,22,0,45,23
1746607439940,EDS 204R,A01,895625,Heinzman; Erica M.,39,0,45,6
1746607439940,EDS 204R,B01,895693,Halter; Christopher P.,10,0,45,35
1746607440965,EDS 206R,A00,895694,Fargason; Sharon Gayle,1,0,30,29
1746607440965,EDS 206R,B00,895695,Choi; Bailey Miyeon,16,0,30,14
1746607441992,EDS 250,A00,895697,Hemans; Patricia Ann Benitez,22,0,45,23
1746607443021,EDS 281,A00,895701,Meyerott; Theresa Ann,1,0,15,14
1746607444254,EDS 284,A00,895736,Meyerott; Theresa Ann,1,0,15,14
1746607445281,EDS 286,A00,897210,Fine; Sarah,0,0,15,15
1746607446308,EDS 289C,A01,895770,Daly; Alan J.,1,0,15,14
1746607447336,EDS 290,A00,897211,Hofstetter; Carolyn,0,0,15,15
1746607448421,LIGM 5A,A00,896162,Fischer-Grunski; Eva K,12,0,20,8
1746607449452,LIGM 5B,A00,896260,Fischer-Grunski; Eva K,17,0,20,3
1746607450480,LIGM 5C,A00,896308,Fischer-Grunski; Eva K,18,0,20,2
1746607451513,LIIT 5AS,A00,896313,Carnelos; Chiara,18,0,20,2
1746607452539,LIIT 5BS,A00,896416,Carnelos; Chiara,20,0,20,0
1746607453567,LIIT 5CS,A00,896564,Carnelos; Chiara,20,0,20,0
1746607454594,LISP 5A,A00,896588,Munoz Sanchez; Alicia,2,0,20,18
1746607455622,LISP 5B,A00,896653,Munoz Sanchez; Alicia,7,0,20,13
1746607456648,LISP 5C,A00,896655,Munoz Sanchez; Alicia,0,1,20,20
1746607457675,MAE 197,001,957918,Kleissl; Jan,9996,0,9999,3
1746607457675,MAE 197,002,959806,Boechler; Nicholas Sebastia,9998,0,9999,1
1746607457675,MAE 197,003,959852,Mullin; Jennifer S,9998,0,9999,1
1746607458706,MATH 2,A01,957937,Staff,33,0,35,2
1746607459736,MATH 197,001,957876,Kedlaya; Kiran S.,9993,0,9999,6
1746607460762,MCWP 40,A00,892729,Duru; Nur,10,0,20,10
1746607460762,MCWP 40,B00,893304,Montejo; Carolina,14,0,20,6
1746607461789,MCWP 40R,A00,893757,Redela; Pamela Morgan,0,5,20,20
1746607462814,MCWP 50,A00,893758,Morshed; Michael James,0,0,20,20
1746607462814,MCWP 50,B00,893761,Bartulis; Jason Michael,16,0,20,4
1746607463846,MCWP 50R,A00,893766,Compas; Sean Matthew,0,1,20,20
1746607463846,MCWP 50R,B00,893769,Carter; Jennifer A,0,1,20,20
1746607463846,MCWP 50R,C00,893771,Krone; Jarret,0,3,20,20
1746607463846,MCWP 50R,D00,893772,Miller; Elizabeth Deen,0,0,20,20
1746607463846,MCWP 50R,E00,893775,Carter; Andrea L,0,1,20,20
1746607464875,MMW 11R,A01,892721,Herbst; Matthew,14,0,30,16
1746607464875,MMW 11R,A02,892722,Herbst; Matthew,0,0,0,3
1746607465903,MMW 12R,A01,892724,Herbst; Matthew,0,11,16,16
1746607465903,MMW 12R,A02,892725,Herbst; Matthew,0,10,16,16
1746607466933,MMW 13R,A01,892727,Staff,0,4,16,16
1746607466933,MMW 13R,A02,892728,Staff,0,4,16,16
1746607466933,MMW 13R,A03,958032,Staff,0,4,16,16
1746607466933,MMW 13R,A04,958033,Staff,0,4,16,16
1746607466933,MMW 13R,A05,958034,Staff,0,4,16,16
1746607467958,SIO 295LS,A00,894015,Staff,5,0,25,20
1746607468986,SIO 295S,A00,894020,Staff,5,0,25,20
1746607470027,SIOC 290S,B01,958918,Merrifield; Mark A,14,0,30,16
1746607471091,SIOC 291S,B01,958922,Gabriel; Corey John,14,0,30,16
1746607472118,SOCI 117,A01,895339,Staff,2,0,5,3
1746607473144,WES 237B,A00,894149,Staff,11,0,20,9
1746607475232,AESE 279B,A00,891859,Staff,13,0,35,22
1746607476259,AIP 197,001,891854,Vespa; Emanuel Ignacio,9999,0,9999,0
1746607477289,ANTH 289S,A00,891856,Gagneux; Pascal,12,0,12,0
1746607478315,BENG 196,001,957946,Engler; Adam J.,9996,0,9999,3
1746607479343,BISP 197,001,959851,Wilhelm; James E.,9998,0,9999,1
1746607480370,CAT 124RS,A01,956906,Staff,6,0,25,19
1746607481398,CAT 125RS,A01,922013,Staff,6,0,25,19
1746607482429,CLRE 250,A00,891860,Morris; Sheldon,9995,0,9999,4
1746607484486,CLRE 251R,A00,907817,Mehta; Ravindra L.,9994,0,9999,5
1746607485516,CLRE 252,A00,891864,Cuomo; Raphael Eduardo,9993,0,9999,6
1746607486543,CLRE 253,A00,891867,Vaida; Florin,9994,0,9999,5
1746607486543,CLRE 253,B00,907819,Staff,9999,0,9999,0
1746607487571,CLRE 259,A00,891868,Patel; Hemal,9998,0,9999,1
1746607488601,CLRE 260,A00,891872,Cuomo; Raphael Eduardo,9999,0,9999,0
1746607489629,CLRE 297,001,891888,Cuomo; Raphael Eduardo,9999,0,9999,0
1746607490658,CSE 191,A00,958773,Minnes Kemp; Mor Mia,9995,0,9999,4
1746607491688,CSE 197,001,959846,Minnes Kemp; Mor Mia,9990,0,9999,9
1746607492715,CSS 201S,A01,892054,Mignozzetti; Umberto,25,0,30,5
1746607493746,CSS 202S,A01,892056,Mignozzetti; Umberto,25,0,30,5
1746607494772,DSC 197,001,956898,Eldridge; Justin Matthew,9996,0,9999,3
1746607495798,DSC 297,001,958000,Mazumdar; Arya,9998,0,9999,1
1746607495798,DSC 297,002,959862,Wang; Yusu,9998,0,9999,1
1746607496826,EAP 100,A00,905686,Staff,9778,0,9999,221
1746607497854,ECE 45,A01,892618,Staff,0,0,65,65
1746607499911,ECE 111,A01,892719,Staff,6,0,65,59
1746607500936,ECE 197,001,957920,Mercier; Patrick Philip,9991,0,9999,8
1746607501973,ECON 178,A01,907814,Zhu; Ying,26,0,35,9
1746607503002,EDS 115,A00,895312,Staff,35,0,45,10
1746607504031,EDS 117,A01,895337,Staff,23,0,30,7
1746607505059,EDS 125,A00,895341,Jones; Gabrielle Anastasia,36,0,45,9
1746607506090,EDS 128A,A01,895459,Fargason; Sharon Gayle,44,0,45,1
1746607507115,EDS 128B,A01,895543,Pappas; Elizabeth,44,0,45,1
1746607508143,EDS 139,A00,897203,Pappas; Elizabeth,44,0,45,1
1746607508143,EDS 139,B00,897209,Fargason; Sharon Gayle,41,0,45,4
1746607509171,EDS 201,A00,895545,Staff,22,0,45,23
1746607510197,EDS 203,A01,895581,Halter; Christopher P.,22,0,45,23
1746607511224,EDS 204R,A01,895625,Heinzman; Erica M.,39,0,45,6
1746607511224,EDS 204R,B01,895693,Halter; Christopher P.,10,0,45,35
1746607512249,EDS 206R,A00,895694,Fargason; Sharon Gayle,1,0,30,29
1746607512249,EDS 206R,B00,895695,Choi; Bailey Miyeon,16,0,30,14
1746607513274,EDS 250,A00,895697,Hemans; Patricia Ann Benitez,22,0,45,23
1746607514300,EDS 281,A00,895701,Meyerott; Theresa Ann,1,0,15,14
1746607515326,EDS 284,A00,895736,Meyerott; Theresa Ann,1,0,15,14
1746607516355,EDS 286,A00,897210,Fine; Sarah,0,0,15,15
1746607517381,EDS 289C,A01,895770,Daly; Alan J.,1,0,15,14
1746607518408,EDS 290,A00,897211,Hofstetter; Carolyn,0,0,15,15
1746607519435,LIGM 5A,A00,896162,Fischer-Grunski; Eva K,12,0,20,8
1746607520463,LIGM 5B,A00,896260,Fischer-Grunski; Eva K,17,0,20,3
1746607521488,LIGM 5C,A00,896308,Fischer-Grunski; Eva K,18,0,20,2
1746607522515,LIIT 5AS,A00,896313,Carnelos; Chiara,18,0,20,2
1746607523542,LIIT 5BS,A00,896416,Carnelos; Chiara,20,0,20,0
1746607524569,LIIT 5CS,A00,896564,Carnelos; Chiara,20,0,20,0
1746607525595,LISP 5A,A00,896588,Munoz Sanchez; Alicia,2,0,20,18
1746607526626,LISP 5B,A00,896653,Munoz Sanchez; Alicia,7,0,20,13
1746607527651,LISP 5C,A00,896655,Munoz Sanchez; Alicia,0,1,20,20
1746607528680,MAE 197,001,957918,Kleissl; Jan,9996,0,9999,3
1746607528680,MAE 197,002,959806,Boechler; Nicholas Sebastia,9998,0,9999,1
1746607528680,MAE 197,003,959852,Mullin; Jennifer S,9998,0,9999,1
1746607529705,MATH 2,A01,957937,Staff,33,0,35,2
1746607530732,MATH 197,001,957876,Kedlaya; Kiran S.,9993,0,9999,6
1746607531763,MCWP 40,A00,892729,Duru; Nur,10,0,20,10
1746607531763,MCWP 40,B00,893304,Montejo; Carolina,14,0,20,6
1746607532790,MCWP 40R,A00,893757,Redela; Pamela Morgan,0,5,20,20
1746607533817,MCWP 50,A00,893758,Morshed; Michael James,0,0,20,20
1746607533817,MCWP 50,B00,893761,Bartulis; Jason Michael,16,0,20,4
1746607534849,MCWP 50R,A00,893766,Compas; Sean Matthew,0,1,20,20
1746607534849,MCWP 50R,B00,893769,Carter; Jennifer A,0,1,20,20
1746607534849,MCWP 50R,C00,893771,Krone; Jarret,0,3,20,20
1746607534849,MCWP 50R,D00,893772,Miller; Elizabeth Deen,0,0,20,20
1746607534849,MCWP 50R,E00,893775,Carter; Andrea L,0,1,20,20
1746607535877,MMW 11R,A01,892721,Herbst; Matthew,14,0,30,16
1746607535877,MMW 11R,A02,892722,Herbst; Matthew,0,0,0,3
1746607536904,MMW 12R,A01,892724,Herbst; Matthew,0,11,16,16
1746607536904,MMW 12R,A02,892725,Herbst; Matthew,0,10,16,16
1746607537931,MMW 13R,A01,892727,Staff,0,4,16,16
1746607537931,MMW 13R,A02,892728,Staff,0,4,16,16
1746607537931,MMW 13R,A03,958032,Staff,0,4,16,16
1746607537931,MMW 13R,A04,958033,Staff,0,4,16,16
1746607537931,MMW 13R,A05,958034,Staff,0,4,16,16
1746607538955,SIO 295LS,A00,894015,Staff,5,0,25,20
1746607539982,SIO 295S,A00,894020,Staff,5,0,25,20
1746607541007,SIOC 290S,B01,958918,Merrifield; Mark A,14,0,30,16
1746607542035,SIOC 291S,B01,958922,Gabriel; Corey John,14,0,30,16
1746607543062,SOCI 117,A01,895339,Staff,2,0,5,3
1746607544087,WES 237B,A00,894149,Staff,11,0,20,9
1746607546163,AESE 279B,A00,891859,Staff,13,0,35,22
1746607547189,AIP 197,001,891854,Vespa; Emanuel Ignacio,9999,0,9999,0
1746607548214,ANTH 289S,A00,891856,Gagneux; Pascal,12,0,12,0
1746607549241,BENG 196,001,957946,Engler; Adam J.,9996,0,9999,3
1746607550268,BISP 197,001,959851,Wilhelm; James E.,9998,0,9999,1
1746607551292,CAT 124RS,A01,956906,Staff,6,0,25,19
1746607552325,CAT 125RS,A01,922013,Staff,6,0,25,19
1746607553356,CLRE 250,A00,891860,Morris; Sheldon,9995,0,9999,4
1746607555410,CLRE 251R,A00,907817,Mehta; Ravindra L.,9994,0,9999,5
1746607556436,CLRE 252,A00,891864,Cuomo; Raphael Eduardo,9993,0,9999,6
1746607557461,CLRE 253,A00,891867,Vaida; Florin,9994,0,9999,5
1746607557461,CLRE 253,B00,907819,Staff,9999,0,9999,0
1746607558488,CLRE 259,A00,891868,Patel; Hemal,9998,0,9999,1
1746607559515,CLRE 260,A00,891872,Cuomo; Raphael Eduardo,9999,0,9999,0
1746607560542,CLRE 297,001,891888,Cuomo; Raphael Eduardo,9999,0,9999,0
1746607561569,CSE 191,A00,958773,Minnes Kemp; Mor Mia,9995,0,9999,4
1746607562595,CSE 197,001,959846,Minnes Kemp; Mor Mia,9990,0,9999,9
1746607563627,CSS 201S,A01,892054,Mignozzetti; Umberto,25,0,30,5
1746607564655,CSS 202S,A01,892056,Mignozzetti; Umberto,25,0,30,5
1746607565681,DSC 197,001,956898,Eldridge; Justin Matthew,9996,0,9999,3
1746607566707,DSC 297,001,958000,Mazumdar; Arya,9998,0,9999,1
1746607566707,DSC 297,002,959862,Wang; Yusu,9998,0,9999,1
1746607567733,EAP 100,A00,905686,Staff,9778,0,9999,221
1746607568761,ECE 45,A01,892618,Staff,0,0,65,65
1746607570812,ECE 111,A01,892719,Staff,6,0,65,59
1746607571844,ECE 197,001,957920,Mercier; Patrick Philip,9991,0,9999,8
1746607572873,ECON 178,A01,907814,Zhu; Ying,26,0,35,9
1746607573898,EDS 115,A00,895312,Staff,35,0,45,10
1746607574923,EDS 117,A01,895337,Staff,23,0,30,7
1746607575960,EDS 125,A00,895341,Jones; Gabrielle Anastasia,36,0,45,9
1746607577000,EDS 128A,A01,895459,Fargason; Sharon Gayle,44,0,45,1
1746607578028,EDS 128B,A01,895543,Pappas; Elizabeth,44,0,45,1
1746607579052,EDS 139,A00,897203,Pappas; Elizabeth,44,0,45,1
1746607579052,EDS 139,B00,897209,Fargason; Sharon Gayle,41,0,45,4
1746607580079,EDS 201,A00,895545,Staff,22,0,45,23
1746607581134,EDS 203,A01,895581,Halter; Christopher P.,22,0,45,23
1746607582161,EDS 204R,A01,895625,Heinzman; Erica M.,39,0,45,6
1746607582161,EDS 204R,B01,895693,Halter; Christopher P.,10,0,45,35
1746607583254,EDS 206R,A00,895694,Fargason; Sharon Gayle,1,0,30,29
1746607583254,EDS 206R,B00,895695,Choi; Bailey Miyeon,16,0,30,14
1746607584281,EDS 250,A00,895697,Hemans; Patricia Ann Benitez,22,0,45,23
1746607585307,EDS 281,A00,895701,Meyerott; Theresa Ann,1,0,15,14
1746607586335,EDS 284,A00,895736,Meyerott; Theresa Ann,1,0,15,14
1746607587359,EDS 286,A00,897210,Fine; Sarah,0,0,15,15
1746607588386,EDS 289C,A01,895770,Daly; Alan J.,1,0,15,14
1746607589412,EDS 290,A00,897211,Hofstetter; Carolyn,0,0,15,15
1746607590439,LIGM 5A,A00,896162,Fischer-Grunski; Eva K,12,0,20,8
1746607591467,LIGM 5B,A00,896260,Fischer-Grunski; Eva K,17,0,20,3
1746607592496,LIGM 5C,A00,896308,Fischer-Grunski; Eva K,18,0,20,2
1746607593520,LIIT 5AS,A00,896313,Carnelos; Chiara,18,0,20,2
1746607594551,LIIT 5BS,A00,896416,Carnelos; Chiara,20,0,20,0
1746607595599,LIIT 5CS,A00,896564,Carnelos; Chiara,20,0,20,0
1746607596624,LISP 5A,A00,896588,Munoz Sanchez; Alicia,2,0,20,18
1746607597694,LISP 5B,A00,896653,Munoz Sanchez; Alicia,7,0,20,13
1746607598722,LISP 5C,A00,896655,Munoz Sanchez; Alicia,0,1,20,20
1746607599751,MAE 197,001,957918,Kleissl; Jan,9996,0,9999,3
1746607599751,MAE 197,002,959806,Boechler; Nicholas Sebastia,9998,0,9999,1
1746607599751,MAE 197,003,959852,Mullin; Jennifer S,9998,0,9999,1
1746607600780,MATH 2,A01,957937,Staff,33,0,35,2
1746607601806,MATH 197,001,957876,Kedlaya; Kiran S.,9993,0,9999,6
1746607602833,MCWP 40,A00,892729,Duru; Nur,10,0,20,10
1746607602833,MCWP 40,B00,893304,Montejo; Carolina,14,0,20,6
1746607603869,MCWP 40R,A00,893757,Redela; Pamela Morgan,0,5,20,20
1746607604901,MCWP 50,A00,893758,Morshed; Michael James,0,0,20,20
1746607604901,MCWP 50,B00,893761,Bartulis; Jason Michael,16,0,20,4
1746607605935,MCWP 50R,A00,893766,Compas; Sean Matthew,0,1,20,20
1746607605935,MCWP 50R,B00,893769,Carter; Jennifer A,0,1,20,20
1746607605935,MCWP 50R,C00,893771,Krone; Jarret,0,3,20,20
1746607605935,MCWP 50R,D00,893772,Miller; Elizabeth Deen,0,0,20,20
1746607605935,MCWP 50R,E00,893775,Carter; Andrea L,0,1,20,20
1746607606965,MMW 11R,A01,892721,Herbst; Matthew,14,0,30,16
1746607606965,MMW 11R,A02,892722,Herbst; Matthew,0,0,0,3
1746607607995,MMW 12R,A01,892724,Herbst; Matthew,0,11,16,16
1746607607995,MMW 12R,A02,892725,Herbst; Matthew,0,10,16,16
1746607609023,MMW 13R,A01,892727,Staff,0,4,16,16
1746607609023,MMW 13R,A02,892728,Staff,0,4,16,16
1746607609023,MMW 13R,A03,958032,Staff,0,4,16,16
1746607609023,MMW 13R,A04,958033,Staff,0,4,16,16
1746607609023,MMW 13R,A05,958034,Staff,0,4,16,16
1746607610053,SIO 295LS,A00,894015,Staff,5,0,25,20
1746607611079,SIO 295S,A00,894020,Staff,5,0,25,20
1746607612107,SIOC 290S,B01,958918,Merrifield; Mark A,14,0,30,16
1746607613138,SIOC 291S,B01,958922,Gabriel; Corey John,14,0,30,16
1746607614165,SOCI 117,A01,895339,Staff,2,0,5,3
1746607615193,WES 237B,A00,894149,Staff,11,0,20,9
1746607617267,AESE 279B,A00,891859,Staff,13,0,35,22
1746607618294,AIP 197,001,891854,Vespa; Emanuel Ignacio,9999,0,9999,0
1746607619322,ANTH 289S,A00,891856,Gagneux; Pascal,12,0,12,0
1746607620349,BENG 196,001,957946,Engler; Adam J.,9996,0,9999,3
1746607621377,BISP 197,001,959851,Wilhelm; James E.,9998,0,9999,1
1746607622409,CAT 124RS,A01,956906,Staff,6,0,25,19
1746607623435,CAT 125RS,A01,922013,Staff,6,0,25,19
1746607624463,CLRE 250,A00,891860,Morris; Sheldon,9995,0,9999,4
1746607626522,CLRE 251R,A00,907817,Mehta; Ravindra L.,9994,0,9999,5
1746607627547,CLRE 252,A00,891864,Cuomo; Raphael Eduardo,9993,0,9999,6
1746607628581,CLRE 253,A00,891867,Vaida; Florin,9994,0,9999,5
1746607628581,CLRE 253,B00,907819,Staff,9999,0,9999,0
1746607629608,CLRE 259,A00,891868,Patel; Hemal,9998,0,9999,1
1746607630635,CLRE 260,A00,891872,Cuomo; Raphael Eduardo,9999,0,9999,0
1746607631662,CLRE 297,001,891888,Cuomo; Raphael Eduardo,9999,0,9999,0
1746607632689,CSE 191,A00,958773,Minnes Kemp; Mor Mia,9995,0,9999,4
1746607633715,CSE 197,001,959846,Minnes Kemp; Mor Mia,9990,0,9999,9
1746607634741,CSS 201S,A01,892054,Mignozzetti; Umberto,25,0,30,5
1746607635767,CSS 202S,A01,892056,Mignozzetti; Umberto,25,0,30,5
1746607636793,DSC 197,001,956898,Eldridge; Justin Matthew,9996,0,9999,3
1746607637820,DSC 297,001,958000,Mazumdar; Arya,9998,0,9999,1
1746607637820,DSC 297,002,959862,Wang; Yusu,9998,0,9999,1
1746607638849,EAP 100,A00,905686,Staff,9778,0,9999,221
1746607639875,ECE 45,A01,892618,Staff,0,0,65,65
1746607641928,ECE 111,A01,892719,Staff,6,0,65,59
1746607642959,ECE 197,001,957920,Mercier; Patrick Philip,9991,0,9999,8
1746607643991,ECON 178,A01,907814,Zhu; Ying,26,0,35,9
1746607645017,EDS 115,A00,895312,Staff,35,0,45,10
1746607646041,EDS 117,A01,895337,Staff,23,0,30,7
1746607647070,EDS 125,A00,895341,Jones; Gabrielle Anastasia,36,0,45,9
1746607648099,EDS 128A,A01,895459,Fargason; Sharon Gayle,44,0,45,1
1746607649123,EDS 128B,A01,895543,Pappas; Elizabeth,44,0,45,1
1746607650148,EDS 139,A00,897203,Pappas; Elizabeth,44,0,45,1
1746607650148,EDS 139,B00,897209,Fargason; Sharon Gayle,41,0,45,4
1746607651183,EDS 201,A00,895545,Staff,22,0,45,23
1746607652209,EDS 203,A01,895581,Halter; Christopher P.,22,0,45,23
1746607653236,EDS 204R,A01,895625,Heinzman; Erica M.,39,0,45,6
1746607653236,EDS 204R,B01,895693,Halter; Christopher P.,10,0,45,35
1746607654265,EDS 206R,A00,895694,Fargason; Sharon Gayle,1,0,30,29
1746607654265,EDS 206R,B00,895695,Choi; Bailey Miyeon,16,0,30,14
1746607655292,EDS 250,A00,895697,Hemans; Patricia Ann Benitez,22,0,45,23
1746607656318,EDS 281,A00,895701,Meyerott; Theresa Ann,1,0,15,14
1746607657347,EDS 284,A00,895736,Meyerott; Theresa Ann,1,0,15,14
1746607658376,EDS 286,A00,897210,Fine; Sarah,0,0,15,15
1746607659402,EDS 289C,A01,895770,Daly; Alan J.,1,0,15,14
1746607660432,EDS 290,A00,897211,Hofstetter; Carolyn,0,0,15,15
1746607661463,LIGM 5A,A00,896162,Fischer-Grunski; Eva K,12,0,20,8
1746607662488,LIGM 5B,A00,896260,Fischer-Grunski; Eva K,17,0,20,3
1746607663513,LIGM 5C,A00,896308,Fischer-Grunski; Eva K,18,0,20,2
1746607664544,LIIT 5AS,A00,896313,Carnelos; Chiara,18,0,20,2
1746607665571,LIIT 5BS,A00,896416,Carnelos; Chiara,20,0,20,0
1746607666598,LIIT 5CS,A00,896564,Carnelos; Chiara,20,0,20,0
1746607667628,LISP 5A,A00,896588,Munoz Sanchez; Alicia,2,0,20,18
1746607668659,LISP 5B,A00,896653,Munoz Sanchez; Alicia,7,0,20,13
1746607669687,LISP 5C,A00,896655,Munoz Sanchez; Alicia,0,1,20,20
1746607670723,MAE 197,001,957918,Kleissl; Jan,9996,0,9999,3
1746607670723,MAE 197,002,959806,Boechler; Nicholas Sebastia,9998,0,9999,1
1746607670723,MAE 197,003,959852,Mullin; Jennifer S,9998,0,9999,1
1746607671753,MATH 2,A01,957937,Staff,33,0,35,2
1746607672778,MATH 197,001,957876,Kedlaya; Kiran S.,9993,0,9999,6
1746607673804,MCWP 40,A00,892729,Duru; Nur,10,0,20,10
1746607673804,MCWP 40,B00,893304,Montejo; Carolina,14,0,20,6
1746607674836,MCWP 40R,A00,893757,Redela; Pamela Morgan,0,5,20,20
1746607675861,MCWP 50,A00,893758,Morshed; Michael James,0,0,20,20
1746607675861,MCWP 50,B00,893761,Bartulis; Jason Michael,16,0,20,4
1746607676889,MCWP 50R,A00,893766,Compas; Sean Matthew,0,1,20,20
1746607676889,MCWP 50R,B00,893769,Carter; Jennifer A,0,1,20,20
1746607676889,MCWP 50R,C00,893771,Krone; Jarret,0,3,20,20
1746607676889,MCWP 50R,D00,893772,Miller; Elizabeth Deen,0,0,20,20
1746607676889,MCWP 50R,E00,893775,Carter; Andrea L,0,1,20,20
1746607677915,MMW 11R,A01,892721,Herbst; Matthew,14,0,30,16
1746607677915,MMW 11R,A02,892722,Herbst; Matthew,0,0,0,3
1746607678941,MMW 12R,A01,892724,Herbst; Matthew,0,11,16,16
1746607678941,MMW 12R,A02,892725,Herbst; Matthew,0,10,16,16
1746607679972,MMW 13R,A01,892727,Staff,0,4,16,16
1746607679972,MMW 13R,A02,892728,Staff,0,4,16,16
1746607679972,MMW 13R,A03,958032,Staff,0,4,16,16
1746607679972,MMW 13R,A04,958033,Staff,0,4,16,16
1746607679972,MMW 13R,A05,958034,Staff,0,4,16,16
1746607680998,SIO 295LS,A00,894015,Staff,5,0,25,20
1746607682030,SIO 295S,A00,894020,Staff,5,0,25,20
1746607683063,SIOC 290S,B01,958918,Merrifield; Mark A,14,0,30,16
1746607684088,SIOC 291S,B01,958922,Gabriel; Corey John,14,0,30,16
1746607685114,SOCI 117,A01,895339,Staff,2,0,5,3
1746607686139,WES 237B,A00,894149,Staff,11,0,20,9
1746607688224,AESE 279B,A00,891859,Staff,13,0,35,22
1746607689252,AIP 197,001,891854,Vespa; Emanuel Ignacio,9999,0,9999,0
1746607690278,ANTH 289S,A00,891856,Gagneux; Pascal,12,0,12,0
1746607691308,BENG 196,001,957946,Engler; Adam J.,9996,0,9999,3
1746607692335,BISP 197,001,959851,Wilhelm; James E.,9998,0,9999,1
1746607693358,CAT 124RS,A01,956906,Staff,6,0,25,19
1746607694383,CAT 125RS,A01,922013,Staff,6,0,25,19
1746607695409,CLRE 250,A00,891860,Morris; Sheldon,9995,0,9999,4
1746607697463,CLRE 251R,A00,907817,Mehta; Ravindra L.,9994,0,9999,5
1746607698491,CLRE 252,A00,891864,Cuomo; Raphael Eduardo,9993,0,9999,6
1746607699519,CLRE 253,A00,891867,Vaida; Florin,9994,0,9999,5
1746607699519,CLRE 253,B00,907819,Staff,9999,0,9999,0
1746607700549,CLRE 259,A00,891868,Patel; Hemal,9998,0,9999,1
1746607701574,CLRE 260,A00,891872,Cuomo; Raphael Eduardo,9999,0,9999,0
1746607702602,CLRE 297,001,891888,Cuomo; Raphael Eduardo,9999,0,9999,0
1746607703627,CSE 191,A00,958773,Minnes Kemp; Mor Mia,9995,0,9999,4
1746607704652,CSE 197,001,959846,Minnes Kemp; Mor Mia,9990,0,9999,9
1746607705683,CSS 201S,A01,892054,Mignozzetti; Umberto,25,0,30,5
1746607706709,CSS 202S,A01,892056,Mignozzetti; Umberto,25,0,30,5
1746607707735,DSC 197,001,956898,Eldridge; Justin Matthew,9996,0,9999,3
1746607708761,DSC 297,001,958000,Mazumdar; Arya,9998,0,9999,1
1746607708761,DSC 297,002,959862,Wang; Yusu,9998,0,9999,1
1746607709788,EAP 100,A00,905686,Staff,9778,0,9999,221
1746607710814,ECE 45,A01,892618,Staff,0,0,65,65
1746607712868,ECE 111,A01,892719,Staff,6,0,65,59
1746607713896,ECE 197,001,957920,Mercier; Patrick Philip,9991,0,9999,8
1746607714923,ECON 178,A01,907814,Zhu; Ying,26,0,35,9
1746607715950,EDS 115,A00,895312,Staff,35,0,45,10
1746607716975,EDS 117,A01,895337,Staff,23,0,30,7
1746607718003,EDS 125,A00,895341,Jones; Gabrielle Anastasia,36,0,45,9
1746607719030,EDS 128A,A01,895459,Fargason; Sharon Gayle,44,0,45,1
1746607720055,EDS 128B,A01,895543,Pappas; Elizabeth,44,0,45,1
1746607721082,EDS 139,A00,897203,Pappas; Elizabeth,44,0,45,1
1746607721082,EDS 139,B00,897209,Fargason; Sharon Gayle,41,0,45,4
1746607722112,EDS 201,A00,895545,Staff,22,0,45,23
1746607723139,EDS 203,A01,895581,Halter; Christopher P.,22,0,45,23
1746607724167,EDS 204R,A01,895625,Heinzman; Erica M.,39,0,45,6
1746607724167,EDS 204R,B01,895693,Halter; Christopher P.,10,0,45,35
1746607725212,EDS 206R,A00,895694,Fargason; Sharon Gayle,1,0,30,29
1746607725212,EDS 206R,B00,895695,Choi; Bailey Miyeon,16,0,30,14
1746607726242,EDS 250,A00,895697,Hemans; Patricia Ann Benitez,22,0,45,23
1746607727269,EDS 281,A00,895701,Meyerott; Theresa Ann,1,0,15,14
1746607728295,EDS 284,A00,895736,Meyerott; Theresa Ann,1,0,15,14
1746607729325,EDS 286,A00,897210,Fine; Sarah,0,0,15,15
1746607730353,EDS 289C,A01,895770,Daly; Alan J.,1,0,15,14
1746607731377,EDS 290,A00,897211,Hofstetter; Carolyn,0,0,15,15
1746607732412,LIGM 5A,A00,896162,Fischer-Grunski; Eva K,12,0,20,8
1746607733442,LIGM 5B,A00,896260,Fischer-Grunski; Eva K,17,0,20,3
1746607734468,LIGM 5C,A00,896308,Fischer-Grunski; Eva K,18,0,20,2
1746607735499,LIIT 5AS,A00,896313,Carnelos; Chiara,18,0,20,2
1746607736525,LIIT 5BS,A00,896416,Carnelos; Chiara,20,0,20,0
1746607737556,LIIT 5CS,A00,896564,Carnelos; Chiara,20,0,20,0
1746607738584,LISP 5A,A00,896588,Munoz Sanchez; Alicia,2,0,20,18
1746607739610,LISP 5B,A00,896653,Munoz Sanchez; Alicia,7,0,20,13
1746607740637,LISP 5C,A00,896655,Munoz Sanchez; Alicia,0,1,20,20
1746607741663,MAE 197,001,957918,Kleissl; Jan,9996,0,9999,3
1746607741663,MAE 197,002,959806,Boechler; Nicholas Sebastia,9998,0,9999,1
1746607741663,MAE 197,003,959852,Mullin; Jennifer S,9998,0,9999,1
1746607742689,MATH 2,A01,957937,Staff,33,0,35,2
1746607743716,MATH 197,001,957876,Kedlaya; Kiran S.,9993,0,9999,6
1746607744745,MCWP 40,A00,892729,Duru; Nur,10,0,20,10
1746607744745,MCWP 40,B00,893304,Montejo; Carolina,14,0,20,6
1746607745769,MCWP 40R,A00,893757,Redela; Pamela Morgan,0,5,20,20
1746607746796,MCWP 50,A00,893758,Morshed; Michael James,0,0,20,20
1746607746796,MCWP 50,B00,893761,Bartulis; Jason Michael,16,0,20,4
1746607747824,MCWP 50R,A00,893766,Compas; Sean Matthew,0,1,20,20
1746607747824,MCWP 50R,B00,893769,Carter; Jennifer A,0,1,20,20
1746607747824,MCWP 50R,C00,893771,Krone; Jarret,0,3,20,20
1746607747824,MCWP 50R,D00,893772,Miller; Elizabeth Deen,0,0,20,20
1746607747824,MCWP 50R,E00,893775,Carter; Andrea L,0,1,20,20
1746607748852,MMW 11R,A01,892721,Herbst; Matthew,14,0,30,16
1746607748852,MMW 11R,A02,892722,Herbst; Matthew,0,0,0,3
1746607749877,MMW 12R,A01,892724,Herbst; Matthew,0,11,16,16
1746607749877,MMW 12R,A02,892725,Herbst; Matthew,0,10,16,16
1746607750902,MMW 13R,A01,892727,Staff,0,4,16,16
1746607750902,MMW 13R,A02,892728,Staff,0,4,16,16
1746607750902,MMW 13R,A03,958032,Staff,0,4,16,16
1746607750902,MMW 13R,A04,958033,Staff,0,4,16,16
1746607750902,MMW 13R,A05,958034,Staff,0,4,16,16
1746607751930,SIO 295LS,A00,894015,Staff,5,0,25,20
1746607752957,SIO 295S,A00,894020,Staff,5,0,25,20
1746607753988,SIOC 290S,B01,958918,Merrifield; Mark A,14,0,30,16
1746607755014,SIOC 291S,B01,958922,Gabriel; Corey John,14,0,30,16
1746607756043,SOCI 117,A01,895339,Staff,2,0,5,3
1746607757071,WES 237B,A00,894149,Staff,11,0,20,9
1746607759134,AESE 279B,A00,891859,Staff,13,0,35,22
1746607760164,AIP 197,001,891854,Vespa; Emanuel Ignacio,9999,0,9999,0
1746607761197,ANTH 289S,A00,891856,Gagneux; Pascal,12,0,12,0
1746607762227,BENG 196,001,957946,Engler; Adam J.,9996,0,9999,3
1746607763255,BISP 197,001,959851,Wilhelm; James E.,9998,0,9999,1
1746607764283,CAT 124RS,A01,956906,Staff,6,0,25,19
1746607765308,CAT 125RS,A01,922013,Staff,6,0,25,19
1746607766334,CLRE 250,A00,891860,Morris; Sheldon,9995,0,9999,4
1746607768383,CLRE 251R,A00,907817,Mehta; Ravindra L.,9994,0,9999,5
1746607769409,CLRE 252,A00,891864,Cuomo; Raphael Eduardo,9993,0,9999,6
1746607770436,CLRE 253,A00,891867,Vaida; Florin,9994,0,9999,5
1746607770436,CLRE 253,B00,907819,Staff,9999,0,9999,0
1746607771475,CLRE 259,A00,891868,Patel; Hemal,9998,0,9999,1
1746607772501,CLRE 260,A00,891872,Cuomo; Raphael Eduardo,9999,0,9999,0
1746607773530,CLRE 297,001,891888,Cuomo; Raphael Eduardo,9999,0,9999,0
1746607774554,CSE 191,A00,958773,Minnes Kemp; Mor Mia,9995,0,9999,4
1746607775586,CSE 197,001,959846,Minnes Kemp; Mor Mia,9990,0,9999,9
1746607776616,CSS 201S,A01,892054,Mignozzetti; Umberto,25,0,30,5
1746607777647,CSS 202S,A01,892056,Mignozzetti; Umberto,25,0,30,5
1746607778674,DSC 197,001,956898,Eldridge; Justin Matthew,9996,0,9999,3
1746607779702,DSC 297,001,958000,Mazumdar; Arya,9998,0,9999,1
1746607779702,DSC 297,002,959862,Wang; Yusu,9998,0,9999,1
1746607780728,EAP 100,A00,905686,Staff,9778,0,9999,221
1746607781755,ECE 45,A01,892618,Staff,0,0,65,65
1746607783813,ECE 111,A01,892719,Staff,6,0,65,59
1746607784842,ECE 197,001,957920,Mercier; Patrick Philip,9991,0,9999,8
1746607785868,ECON 178,A01,907814,Zhu; Ying,26,0,35,9
1746607786895,EDS 115,A00,895312,Staff,35,0,45,10
1746607787923,EDS 117,A01,895337,Staff,23,0,30,7
1746607788949,EDS 125,A00,895341,Jones; Gabrielle Anastasia,36,0,45,9
1746607789976,EDS 128A,A01,895459,Fargason; Sharon Gayle,44,0,45,1
1746607791002,EDS 128B,A01,895543,Pappas; Elizabeth,44,0,45,1
1746607792026,EDS 139,A00,897203,Pappas; Elizabeth,44,0,45,1
1746607792026,EDS 139,B00,897209,Fargason; Sharon Gayle,41,0,45,4
1746607793054,EDS 201,A00,895545,Staff,22,0,45,23
1746607794083,EDS 203,A01,895581,Halter; Christopher P.,22,0,45,23
1746607795109,EDS 204R,A01,895625,Heinzman; Erica M.,39,0,45,6
1746607795109,EDS 204R,B01,895693,Halter; Christopher P.,10,0,45,35
1746607796141,EDS 206R,A00,895694,Fargason; Sharon Gayle,1,0,30,29
1746607796141,EDS 206R,B00,895695,Choi; Bailey Miyeon,16,0,30,14
1746607797167,EDS 250,A00,895697,Hemans; Patricia Ann Benitez,22,0,45,23
1746607798193,EDS 281,A00,895701,Meyerott; Theresa Ann,1,0,15,14
1746607799221,EDS 284,A00,895736,Meyerott; Theresa Ann,1,0,15,14
1746607800247,EDS 286,A00,897210,Fine; Sarah,0,0,15,15
1746607801275,EDS 289C,A01,895770,Daly; Alan J.,1,0,15,14
1746607802304,EDS 290,A00,897211,Hofstetter; Carolyn,0,0,15,15
1746607803331,LIGM 5A,A00,896162,Fischer-Grunski; Eva K,12,0,20,8
1746607804361,LIGM 5B,A00,896260,Fischer-Grunski; Eva K,17,0,20,3
1746607805390,LIGM 5C,A00,896308,Fischer-Grunski; Eva K,18,0,20,2
1746607806419,LIIT 5AS,A00,896313,Carnelos; Chiara,18,0,20,2
1746607807446,LIIT 5BS,A00,896416,Carnelos; Chiara,20,0,20,0
1746607808473,LIIT 5CS,A00,896564,Carnelos; Chiara,20,0,20,0
1746607809500,LISP 5A,A00,896588,Munoz Sanchez; Alicia,2,0,20,18
1746607810530,LISP 5B,A00,896653,Munoz Sanchez; Alicia,7,0,20,13
1746607811556,LISP 5C,A00,896655,Munoz Sanchez; Alicia,0,1,20,20
1746607812584,MAE 197,001,957918,Kleissl; Jan,9996,0,9999,3
1746607812584,MAE 197,002,959806,Boechler; Nicholas Sebastia,9998,0,9999,1
1746607812584,MAE 197,003,959852,Mullin; Jennifer S,9998,0,9999,1
1746607813611,MATH 2,A01,957937,Staff,33,0,35,2
1746607814636,MATH 197,001,957876,Kedlaya; Kiran S.,9993,0,9999,6
1746607815670,MCWP 40,A00,892729,Duru; Nur,10,0,20,10
1746607815670,MCWP 40,B00,893304,Montejo; Carolina,14,0,20,6
1746607816697,MCWP 40R,A00,893757,Redela; Pamela Morgan,0,5,20,20
1746607817722,MCWP 50,A00,893758,Morshed; Michael James,0,0,20,20
1746607817722,MCWP 50,B00,893761,Bartulis; Jason Michael,16,0,20,4
1746607818751,MCWP 50R,A00,893766,Compas; Sean Matthew,0,1,20,20
1746607818751,MCWP 50R,B00,893769,Carter; Jennifer A,0,1,20,20
1746607818751,MCWP 50R,C00,893771,Krone; Jarret,0,3,20,20
1746607818751,MCWP 50R,D00,893772,Miller; Elizabeth Deen,0,0,20,20
1746607818751,MCWP 50R,E00,893775,Carter; Andrea L,0,1,20,20
1746607819818,MMW 11R,A01,892721,Herbst; Matthew,14,0,30,16
1746607819818,MMW 11R,A02,892722,Herbst; Matthew,0,0,0,3
1746607820844,MMW 12R,A01,892724,Herbst; Matthew,0,11,16,16
1746607820844,MMW 12R,A02,892725,Herbst; Matthew,0,10,16,16
1746607821870,MMW 13R,A01,892727,Staff,0,4,16,16
1746607821870,MMW 13R,A02,892728,Staff,0,4,16,16
1746607821870,MMW 13R,A03,958032,Staff,0,4,16,16
1746607821870,MMW 13R,A04,958033,Staff,0,4,16,16
1746607821870,MMW 13R,A05,958034,Staff,0,4,16,16
1746607822901,SIO 295LS,A00,894015,Staff,5,0,25,20
1746607823931,SIO 295S,A00,894020,Staff,5,0,25,20
1746607824964,SIOC 290S,B01,958918,Merrifield; Mark A,14,0,30,16
1746607825994,SIOC 291S,B01,958922,Gabriel; Corey John,14,0,30,16
1746607827024,SOCI 117,A01,895339,Staff,2,0,5,3
1746607828051,WES 237B,A00,894149,Staff,11,0,20,9
1746607830136,AESE 279B,A00,891859,Staff,13,0,35,22
1746607831162,AIP 197,001,891854,Vespa; Emanuel Ignacio,9999,0,9999,0
1746607832191,ANTH 289S,A00,891856,Gagneux; Pascal,12,0,12,0
1746607833218,BENG 196,001,957946,Engler; Adam J.,9996,0,9999,3
1746607834243,BISP 197,001,959851,Wilhelm; James E.,9998,0,9999,1
1746607835268,CAT 124RS,A01,956906,Staff,6,0,25,19
1746607836293,CAT 125RS,A01,922013,Staff,6,0,25,19
1746607837320,CLRE 250,A00,891860,Morris; Sheldon,9995,0,9999,4
1746607839383,CLRE 251R,A00,907817,Mehta; Ravindra L.,9994,0,9999,5
1746607840411,CLRE 252,A00,891864,Cuomo; Raphael Eduardo,9993,0,9999,6
1746607841439,CLRE 253,A00,891867,Vaida; Florin,9994,0,9999,5
1746607841439,CLRE 253,B00,907819,Staff,9999,0,9999,0
1746607842465,CLRE 259,A00,891868,Patel; Hemal,9998,0,9999,1
1746607843490,CLRE 260,A00,891872,Cuomo; Raphael Eduardo,9999,0,9999,0
1746607844516,CLRE 297,001,891888,Cuomo; Raphael Eduardo,9999,0,9999,0
1746607845543,CSE 191,A00,958773,Minnes Kemp; Mor Mia,9995,0,9999,4
1746607846570,CSE 197,001,959846,Minnes Kemp; Mor Mia,9990,0,9999,9
1746607847598,CSS 201S,A01,892054,Mignozzetti; Umberto,25,0,30,5
1746607848628,CSS 202S,A01,892056,Mignozzetti; Umberto,25,0,30,5
1746607849654,DSC 197,001,956898,Eldridge; Justin Matthew,9996,0,9999,3
1746607850682,DSC 297,001,958000,Mazumdar; Arya,9998,0,9999,1
1746607850682,DSC 297,002,959862,Wang; Yusu,9998,0,9999,1
1746607851713,EAP 100,A00,905686,Staff,9778,0,9999,221
1746607852743,ECE 45,A01,892618,Staff,0,0,65,65
1746607854838,ECE 111,A01,892719,Staff,6,0,65,59
1746607855864,ECE 197,001,957920,Mercier; Patrick Philip,9991,0,9999,8
1746607856893,ECON 178,A01,907814,Zhu; Ying,26,0,35,9
1746607857919,EDS 115,A00,895312,Staff,35,0,45,10
1746607858949,EDS 117,A01,895337,Staff,23,0,30,7
1746607859975,EDS 125,A00,895341,Jones; Gabrielle Anastasia,36,0,45,9
1746607861002,EDS 128A,A01,895459,Fargason; Sharon Gayle,44,0,45,1
1746607862029,EDS 128B,A01,895543,Pappas; Elizabeth,44,0,45,1
1746607863055,EDS 139,A00,897203,Pappas; Elizabeth,44,0,45,1
1746607863055,EDS 139,B00,897209,Fargason; Sharon Gayle,41,0,45,4
1746607864298,EDS 201,A00,895545,Staff,22,0,45,23
1746607865329,EDS 203,A01,895581,Halter; Christopher P.,22,0,45,23
1746607866356,EDS 204R,A01,895625,Heinzman; Erica M.,39,0,45,6
1746607866356,EDS 204R,B01,895693,Halter; Christopher P.,10,0,45,35
1746607867382,EDS 206R,A00,895694,Fargason; Sharon Gayle,1,0,30,29
1746607867382,EDS 206R,B00,895695,Choi; Bailey Miyeon,16,0,30,14
1746607868412,EDS 250,A00,895697,Hemans; Patricia Ann Benitez,22,0,45,23
1746607869444,EDS 281,A00,895701,Meyerott; Theresa Ann,1,0,15,14
1746607870469,EDS 284,A00,895736,Meyerott; Theresa Ann,1,0,15,14
1746607871499,EDS 286,A00,897210,Fine; Sarah,0,0,15,15
1746607872526,EDS 289C,A01,895770,Daly; Alan J.,1,0,15,14
1746607873553,EDS 290,A00,897211,Hofstetter; Carolyn,0,0,15,15
1746607874580,LIGM 5A,A00,896162,Fischer-Grunski; Eva K,12,0,20,8
1746607875606,LIGM 5B,A00,896260,Fischer-Grunski; Eva K,17,0,20,3
1746607876638,LIGM 5C,A00,896308,Fischer-Grunski; Eva K,18,0,20,2
1746607877663,LIIT 5AS,A00,896313,Carnelos; Chiara,18,0,20,2
1746607878690,LIIT 5BS,A00,896416,Carnelos; Chiara,20,0,20,0
1746607879722,LIIT 5CS,A00,896564,Carnelos; Chiara,20,0,20,0
1746607880748,LISP 5A,A00,896588,Munoz Sanchez; Alicia,2,0,20,18
1746607881778,LISP 5B,A00,896653,Munoz Sanchez; Alicia,7,0,20,13
1746607882809,LISP 5C,A00,896655,Munoz Sanchez; Alicia,0,1,20,20
1746607883844,MAE 197,001,957918,Kleissl; Jan,9996,0,9999,3
1746607883844,MAE 197,002,959806,Boechler; Nicholas Sebastia,9998,0,9999,1
1746607883844,MAE 197,003,959852,Mullin; Jennifer S,9998,0,9999,1
1746607884868,MATH 2,A01,957937,Staff,33,0,35,2
1746607885899,MATH 197,001,957876,Kedlaya; Kiran S.,9993,0,9999,6
1746607886925,MCWP 40,A00,892729,Duru; Nur,10,0,20,10
1746607886925,MCWP 40,B00,893304,Montejo; Carolina,14,0,20,6
1746607887953,MCWP 40R,A00,893757,Redela; Pamela Morgan,0,5,20,20
1746607888982,MCWP 50,A00,893758,Morshed; Michael James,0,0,20,20
1746607888982,MCWP 50,B00,893761,Bartulis; Jason Michael,16,0,20,4
1746607890050,MCWP 50R,A00,893766,Compas; Sean Matthew,0,1,20,20
1746607890050,MCWP 50R,B00,893769,Carter; Jennifer A,0,1,20,20
1746607890050,MCWP 50R,C00,893771,Krone; Jarret,0,3,20,20
1746607890050,MCWP 50R,D00,893772,Miller; Elizabeth Deen,0,0,20,20
1746607890050,MCWP 50R,E00,893775,Carter; Andrea L,0,1,20,20
1746607891078,MMW 11R,A01,892721,Herbst; Matthew,14,0,30,16
1746607891078,MMW 11R,A02,892722,Herbst; Matthew,0,0,0,3
1746607892104,MMW 12R,A01,892724,Herbst; Matthew,0,11,16,16
1746607892104,MMW 12R,A02,892725,Herbst; Matthew,0,10,16,16
1746607893133,MMW 13R,A01,892727,Staff,0,4,16,16
1746607893133,MMW 13R,A02,892728,Staff,0,4,16,16
1746607893133,MMW 13R,A03,958032,Staff,0,4,16,16
1746607893133,MMW 13R,A04,958033,Staff,0,4,16,16
1746607893133,MMW 13R,A05,958034,Staff,0,4,16,16
1746607894158,SIO 295LS,A00,894015,Staff,5,0,25,20
1746607895187,SIO 295S,A00,894020,Staff,5,0,25,20
1746607896215,SIOC 290S,B01,958918,Merrifield; Mark A,14,0,30,16
1746607897249,SIOC 291S,B01,958922,Gabriel; Corey John,14,0,30,16
1746607898277,SOCI 117,A01,895339,Staff,2,0,5,3
1746607899306,WES 237B,A00,894149,Staff,11,0,20,9
1746607901390,AESE 279B,A00,891859,Staff,13,0,35,22
1746607902425,AIP 197,001,891854,Vespa; Emanuel Ignacio,9999,0,9999,0
1746607903455,ANTH 289S,A00,891856,Gagneux; Pascal,12,0,12,0
1746607904483,BENG 196,001,957946,Engler; Adam J.,9996,0,9999,3
1746607905510,BISP 197,001,959851,Wilhelm; James E.,9998,0,9999,1
1746607906537,CAT 124RS,A01,956906,Staff,6,0,25,19
1746607907566,CAT 125RS,A01,922013,Staff,6,0,25,19
1746607908596,CLRE 250,A00,891860,Morris; Sheldon,9995,0,9999,4
1746607910653,CLRE 251R,A00,907817,Mehta; Ravindra L.,9994,0,9999,5
1746607911682,CLRE 252,A00,891864,Cuomo; Raphael Eduardo,9993,0,9999,6
1746607912708,CLRE 253,A00,891867,Vaida; Florin,9994,0,9999,5
1746607912708,CLRE 253,B00,907819,Staff,9999,0,9999,0
1746607913734,CLRE 259,A00,891868,Patel; Hemal,9998,0,9999,1
1746607914762,CLRE 260,A00,891872,Cuomo; Raphael Eduardo,9999,0,9999,0
1746607915789,CLRE 297,001,891888,Cuomo; Raphael Eduardo,9999,0,9999,0
1746607916819,CSE 191,A00,958773,Minnes Kemp; Mor Mia,9995,0,9999,4
1746607917847,CSE 197,001,959846,Minnes Kemp; Mor Mia,9990,0,9999,9
1746607918875,CSS 201S,A01,892054,Mignozzetti; Umberto,25,0,30,5
1746607919906,CSS 202S,A01,892056,Mignozzetti; Umberto,25,0,30,5
1746607920933,DSC 197,001,956898,Eldridge; Justin Matthew,9996,0,9999,3
1746607921959,DSC 297,001,958000,Mazumdar; Arya,9998,0,9999,1
1746607921959,DSC 297,002,959862,Wang; Yusu,9998,0,9999,1
1746607922985,EAP 100,A00,905686,Staff,9778,0,9999,221
1746607924020,ECE 45,A01,892618,Staff,0,0,65,65
1746607926078,ECE 111,A01,892719,Staff,6,0,65,59
1746607927108,ECE 197,001,957920,Mercier; Patrick Philip,9991,0,9999,8
1746607928135,ECON 178,A01,907814,Zhu; Ying,26,0,35,9
1746607929162,EDS 115,A00,895312,Staff,35,0,45,10
1746607930191,EDS 117,A01,895337,Staff,23,0,30,7
1746607931222,EDS 125,A00,895341,Jones; Gabrielle Anastasia,36,0,45,9
1746607932248,EDS 128A,A01,895459,Fargason; Sharon Gayle,44,0,45,1
1746607933276,EDS 128B,A01,895543,Pappas; Elizabeth,44,0,45,1
1746607934302,EDS 139,A00,897203,Pappas; Elizabeth,44,0,45,1
1746607934302,EDS 139,B00,897209,Fargason; Sharon Gayle,41,0,45,4
1746607935328,EDS 201,A00,895545,Staff,22,0,45,23
1746607936359,EDS 203,A01,895581,Halter; Christopher P.,22,0,45,23
1746607937385,EDS 204R,A01,895625,Heinzman; Erica M.,39,0,45,6
1746607937385,EDS 204R,B01,895693,Halter; Christopher P.,10,0,45,35
1746607938414,EDS 206R,A00,895694,Fargason; Sharon Gayle,1,0,30,29
1746607938414,EDS 206R,B00,895695,Choi; Bailey Miyeon,16,0,30,14
1746607939439,EDS 250,A00,895697,Hemans; Patricia Ann Benitez,22,0,45,23
1746607940465,EDS 281,A00,895701,Meyerott; Theresa Ann,1,0,15,14
1746607941492,EDS 284,A00,895736,Meyerott; Theresa Ann,1,0,15,14
1746607942519,EDS 286,A00,897210,Fine; Sarah,0,0,15,15
1746607943546,EDS 289C,A01,895770,Daly; Alan J.,1,0,15,14
1746607944572,EDS 290,A00,897211,Hofstetter; Carolyn,0,0,15,15
1746607945603,LIGM 5A,A00,896162,Fischer-Grunski; Eva K,12,0,20,8
1746607946630,LIGM 5B,A00,896260,Fischer-Grunski; Eva K,17,0,20,3
1746607947656,LIGM 5C,A00,896308,Fischer-Grunski; Eva K,18,0,20,2
1746607948682,LIIT 5AS,A00,896313,Carnelos; Chiara,18,0,20,2
1746607949712,LIIT 5BS,A00,896416,Carnelos; Chiara,20,0,20,0
1746607950742,LIIT 5CS,A00,896564,Carnelos; Chiara,20,0,20,0
1746607951767,LISP 5A,A00,896588,Munoz Sanchez; Alicia,2,0,20,18
1746607952798,LISP 5B,A00,896653,Munoz Sanchez; Alicia,7,0,20,13
1746607953829,LISP 5C,A00,896655,Munoz Sanchez; Alicia,0,1,20,20
1746607954859,MAE 197,001,957918,Kleissl; Jan,9996,0,9999,3
1746607954859,MAE 197,002,959806,Boechler; Nicholas Sebastia,9998,0,9999,1
1746607954859,MAE 197,003,959852,Mullin; Jennifer S,9998,0,9999,1
1746607955883,MATH 2,A01,957937,Staff,33,0,35,2
1746607956914,MATH 197,001,957876,Kedlaya; Kiran S.,9993,0,9999,6
1746607957940,MCWP 40,A00,892729,Duru; Nur,10,0,20,10
1746607957940,MCWP 40,B00,893304,Montejo; Carolina,14,0,20,6
1746607958968,MCWP 40R,A00,893757,Redela; Pamela Morgan,0,5,20,20
1746607959998,MCWP 50,A00,893758,Morshed; Michael James,0,0,20,20
1746607959998,MCWP 50,B00,893761,Bartulis; Jason Michael,16,0,20,4
1746607961024,MCWP 50R,A00,893766,Compas; Sean Matthew,0,1,20,20
1746607961024,MCWP 50R,B00,893769,Carter; Jennifer A,0,1,20,20
1746607961024,MCWP 50R,C00,893771,Krone; Jarret,0,3,20,20
1746607961024,MCWP 50R,D00,893772,Miller; Elizabeth Deen,0,0,20,20
1746607961024,MCWP 50R,E00,893775,Carter; Andrea L,0,1,20,20
1746607962050,MMW 11R,A01,892721,Herbst; Matthew,14,0,30,16
1746607962050,MMW 11R,A02,892722,Herbst; Matthew,0,0,0,3
1746607963080,MMW 12R,A01,892724,Herbst; Matthew,0,11,16,16
1746607963080,MMW 12R,A02,892725,Herbst; Matthew,0,10,16,16
1746607964107,MMW 13R,A01,892727,Staff,0,4,16,16
1746607964107,MMW 13R,A02,892728,Staff,0,4,16,16
1746607964107,MMW 13R,A03,958032,Staff,0,4,16,16
1746607964107,MMW 13R,A04,958033,Staff,0,4,16,16
1746607964107,MMW 13R,A05,958034,Staff,0,4,16,16
1746607965135,SIO 295LS,A00,894015,Staff,5,0,25,20
1746607966161,SIO 295S,A00,894020,Staff,5,0,25,20
1746607967193,SIOC 290S,B01,958918,Merrifield; Mark A,14,0,30,16
1746607968222,SIOC 291S,B01,958922,Gabriel; Corey John,14,0,30,16
1746607969251,SOCI 117,A01,895339,Staff,2,0,5,3
1746607970276,WES 237B,A00,894149,Staff,11,0,20,9
1746607972349,AESE 279B,A00,891859,Staff,13,0,35,22
1746607973376,AIP 197,001,891854,Vespa; Emanuel Ignacio,9999,0,9999,0
1746607974402,ANTH 289S,A00,891856,Gagneux; Pascal,12,0,12,0
1746607975427,BENG 196,001,957946,Engler; Adam J.,9996,0,9999,3
1746607976453,BISP 197,001,959851,Wilhelm; James E.,9998,0,9999,1
1746607977481,CAT 124RS,A01,956906,Staff,6,0,25,19
1746607978508,CAT 125RS,A01,922013,Staff,6,0,25,19
1746607979536,CLRE 250,A00,891860,Morris; Sheldon,9995,0,9999,4
1746607981590,CLRE 251R,A00,907817,Mehta; Ravindra L.,9994,0,9999,5
1746607982615,CLRE 252,A00,891864,Cuomo; Raphael Eduardo,9993,0,9999,6
1746607983643,CLRE 253,A00,891867,Vaida; Florin,9994,0,9999,5
1746607983643,CLRE 253,B00,907819,Staff,9999,0,9999,0
1746607984670,CLRE 259,A00,891868,Patel; Hemal,9998,0,9999,1
1746607985697,CLRE 260,A00,891872,Cuomo; Raphael Eduardo,9999,0,9999,0
1746607986722,CLRE 297,001,891888,Cuomo; Raphael Eduardo,9999,0,9999,0
1746607987750,CSE 191,A00,958773,Minnes Kemp; Mor Mia,9995,0,9999,4
1746607988777,CSE 197,001,959846,Minnes Kemp; Mor Mia,9990,0,9999,9
1746607989807,CSS 201S,A01,892054,Mignozzetti; Umberto,25,0,30,5
1746607990836,CSS 202S,A01,892056,Mignozzetti; Umberto,25,0,30,5
1746607991862,DSC 197,001,956898,Eldridge; Justin Matthew,9996,0,9999,3
1746607992888,DSC 297,001,958000,Mazumdar; Arya,9998,0,9999,1
1746607992888,DSC 297,002,959862,Wang; Yusu,9998,0,9999,1
1746607993914,EAP 100,A00,905686,Staff,9778,0,9999,221
1746607994940,ECE 45,A01,892618,Staff,0,0,65,65
1746607996994,ECE 111,A01,892719,Staff,6,0,65,59
1746607998018,ECE 197,001,957920,Mercier; Patrick Philip,9991,0,9999,8
1746607999049,ECON 178,A01,907814,Zhu; Ying,26,0,35,9
1746608000075,EDS 115,A00,895312,Staff,35,0,45,10
1746608001103,EDS 117,A01,895337,Staff,23,0,30,7
1746608002129,EDS 125,A00,895341,Jones; Gabrielle Anastasia,36,0,45,9
1746608003155,EDS 128A,A01,895459,Fargason; Sharon Gayle,44,0,45,1
1746608004180,EDS 128B,A01,895543,Pappas; Elizabeth,44,0,45,1
1746608005203,EDS 139,A00,897203,Pappas; Elizabeth,44,0,45,1
1746608005203,EDS 139,B00,897209,Fargason; Sharon Gayle,41,0,45,4
1746608006232,EDS 201,A00,895545,Staff,22,0,45,23
1746608007259,EDS 203,A01,895581,Halter; Christopher P.,22,0,45,23
1746608008282,EDS 204R,A01,895625,Heinzman; Erica M.,39,0,45,6
1746608008282,EDS 204R,B01,895693,Halter; Christopher P.,10,0,45,35
1746608009309,EDS 206R,A00,895694,Fargason; Sharon Gayle,1,0,30,29
1746608009309,EDS 206R,B00,895695,Choi; Bailey Miyeon,16,0,30,14
1746608010337,EDS 250,A00,895697,Hemans; Patricia Ann Benitez,22,0,45,23
1746608011362,EDS 281,A00,895701,Meyerott; Theresa Ann,1,0,15,14
1746608012388,EDS 284,A00,895736,Meyerott; Theresa Ann,1,0,15,14
1746608013413,EDS 286,A00,897210,Fine; Sarah,0,0,15,15
1746608014438,EDS 289C,A01,895770,Daly; Alan J.,1,0,15,14
1746608015465,EDS 290,A00,897211,Hofstetter; Carolyn,0,0,15,15
1746608016493,LIGM 5A,A00,896162,Fischer-Grunski; Eva K,12,0,20,8
1746608017524,LIGM 5B,A00,896260,Fischer-Grunski; Eva K,17,0,20,3
1746608018552,LIGM 5C,A00,896308,Fischer-Grunski; Eva K,18,0,20,2
1746608019577,LIIT 5AS,A00,896313,Carnelos; Chiara,18,0,20,2
1746608020602,LIIT 5BS,A00,896416,Carnelos; Chiara,20,0,20,0
1746608021631,LIIT 5CS,A00,896564,Carnelos; Chiara,20,0,20,0
1746608022658,LISP 5A,A00,896588,Munoz Sanchez; Alicia,2,0,20,18
1746608023688,LISP 5B,A00,896653,Munoz Sanchez; Alicia,7,0,20,13
1746608024717,LISP 5C,A00,896655,Munoz Sanchez; Alicia,0,1,20,20
1746608025746,MAE 197,001,957918,Kleissl; Jan,9996,0,9999,3
1746608025746,MAE 197,002,959806,Boechler; Nicholas Sebastia,9998,0,9999,1
1746608025746,MAE 197,003,959852,Mullin; Jennifer S,9998,0,9999,1
1746608026775,MATH 2,A01,957937,Staff,33,0,35,2
1746608027802,MATH 197,001,957876,Kedlaya; Kiran S.,9993,0,9999,6
1746608028831,MCWP 40,A00,892729,Duru; Nur,10,0,20,10
1746608028831,MCWP 40,B00,893304,Montejo; Carolina,14,0,20,6
1746608029858,MCWP 40R,A00,893757,Redela; Pamela Morgan,0,5,20,20
1746608030889,MCWP 50,A00,893758,Morshed; Michael James,0,0,20,20
1746608030889,MCWP 50,B00,893761,Bartulis; Jason Michael,16,0,20,4
1746608031972,MCWP 50R,A00,893766,Compas; Sean Matthew,0,1,20,20
1746608031972,MCWP 50R,B00,893769,Carter; Jennifer A,0,1,20,20
1746608031972,MCWP 50R,C00,893771,Krone; Jarret,0,3,20,20
1746608031972,MCWP 50R,D00,893772,Miller; Elizabeth Deen,0,0,20,20
1746608031972,MCWP 50R,E00,893775,Carter; Andrea L,0,1,20,20
1746608032996,MMW 11R,A01,892721,Herbst; Matthew,14,0,30,16
1746608032996,MMW 11R,A02,892722,Herbst; Matthew,0,0,0,3
1746608034023,MMW 12R,A01,892724,Herbst; Matthew,0,11,16,16
1746608034023,MMW 12R,A02,892725,Herbst; Matthew,0,10,16,16
1746608035048,MMW 13R,A01,892727,Staff,0,4,16,16
1746608035048,MMW 13R,A02,892728,Staff,0,4,16,16
1746608035048,MMW 13R,A03,958032,Staff,0,4,16,16
1746608035048,MMW 13R,A04,958033,Staff,0,4,16,16
1746608035048,MMW 13R,A05,958034,Staff,0,4,16,16
1746608036077,SIO 295LS,A00,894015,Staff,5,0,25,20
1746608037104,SIO 295S,A00,894020,Staff,5,0,25,20
1746608038133,SIOC 290S,B01,958918,Merrifield; Mark A,14,0,30,16
1746608039162,SIOC 291S,B01,958922,Gabriel; Corey John,14,0,30,16
1746608040190,SOCI 117,A01,895339,Staff,2,0,5,3
1746608041217,WES 237B,A00,894149,Staff,11,0,20,9
1746608043285,AESE 279B,A00,891859,Staff,13,0,35,22
1746608044313,AIP 197,001,891854,Vespa; Emanuel Ignacio,9999,0,9999,0
1746608045339,ANTH 289S,A00,891856,Gagneux; Pascal,12,0,12,0
1746608046366,BENG 196,001,957946,Engler; Adam J.,9996,0,9999,3
1746608047393,BISP 197,001,959851,Wilhelm; James E.,9998,0,9999,1
1746608048420,CAT 124RS,A01,956906,Staff,6,0,25,19
1746608049443,CAT 125RS,A01,922013,Staff,6,0,25,19
1746608050470,CLRE 250,A00,891860,Morris; Sheldon,9995,0,9999,4
1746608052525,CLRE 251R,A00,907817,Mehta; Ravindra L.,9994,0,9999,5
1746608053550,CLRE 252,A00,891864,Cuomo; Raphael Eduardo,9993,0,9999,6
1746608054578,CLRE 253,A00,891867,Vaida; Florin,9994,0,9999,5
1746608054578,CLRE 253,B00,907819,Staff,9999,0,9999,0
1746608055604,CLRE 259,A00,891868,Patel; Hemal,9998,0,9999,1
1746608056629,CLRE 260,A00,891872,Cuomo; Raphael Eduardo,9999,0,9999,0
1746608057656,CLRE 297,001,891888,Cuomo; Raphael Eduardo,9999,0,9999,0
1746608058683,CSE 191,A00,958773,Minnes Kemp; Mor Mia,9995,0,9999,4
1746608059710,CSE 197,001,959846,Minnes Kemp; Mor Mia,9990,0,9999,9
1746608060741,CSS 201S,A01,892054,Mignozzetti; Umberto,25,0,30,5
1746608061767,CSS 202S,A01,892056,Mignozzetti; Umberto,25,0,30,5
1746608062794,DSC 197,001,956898,Eldridge; Justin Matthew,9996,0,9999,3
1746608063819,DSC 297,001,958000,Mazumdar; Arya,9998,0,9999,1
1746608063819,DSC 297,002,959862,Wang; Yusu,9998,0,9999,1
1746608064847,EAP 100,A00,905686,Staff,9778,0,9999,221
1746608065872,ECE 45,A01,892618,Staff,0,0,65,65
1746608067921,ECE 111,A01,892719,Staff,6,0,65,59
1746608068949,ECE 197,001,957920,Mercier; Patrick Philip,9991,0,9999,8
1746608069976,ECON 178,A01,907814,Zhu; Ying,26,0,35,9
1746608071003,EDS 115,A00,895312,Staff,35,0,45,10
1746608072031,EDS 117,A01,895337,Staff,23,0,30,7
1746608073057,EDS 125,A00,895341,Jones; Gabrielle Anastasia,36,0,45,9
1746608074087,EDS 128A,A01,895459,Fargason; Sharon Gayle,44,0,45,1
1746608075113,EDS 128B,A01,895543,Pappas; Elizabeth,44,0,45,1
1746608076140,EDS 139,A00,897203,Pappas; Elizabeth,44,0,45,1
1746608076140,EDS 139,B00,897209,Fargason; Sharon Gayle,41,0,45,4
1746608077166,EDS 201,A00,895545,Staff,22,0,45,23
1746608078192,EDS 203,A01,895581,Halter; Christopher P.,22,0,45,23
1746608079217,EDS 204R,A01,895625,Heinzman; Erica M.,39,0,45,6
1746608079217,EDS 204R,B01,895693,Halter; Christopher P.,10,0,45,35
1746608080242,EDS 206R,A00,895694,Fargason; Sharon Gayle,1,0,30,29
1746608080242,EDS 206R,B00,895695,Choi; Bailey Miyeon,16,0,30,14
1746608081269,EDS 250,A00,895697,Hemans; Patricia Ann Benitez,22,0,45,23
1746608082295,EDS 281,A00,895701,Meyerott; Theresa Ann,1,0,15,14
1746608083320,EDS 284,A00,895736,Meyerott; Theresa Ann,1,0,15,14
1746608084351,EDS 286,A00,897210,Fine; Sarah,0,0,15,15
1746608085380,EDS 289C,A01,895770,Daly; Alan J.,1,0,15,14
1746608086411,EDS 290,A00,897211,Hofstetter; Carolyn,0,0,15,15
1746608087437,LIGM 5A,A00,896162,Fischer-Grunski; Eva K,12,0,20,8
1746608088469,LIGM 5B,A00,896260,Fischer-Grunski; Eva K,17,0,20,3
1746608089495,LIGM 5C,A00,896308,Fischer-Grunski; Eva K,18,0,20,2
1746608090527,LIIT 5AS,A00,896313,Carnelos; Chiara,18,0,20,2
1746608091555,LIIT 5BS,A00,896416,Carnelos; Chiara,20,0,20,0
1746608092579,LIIT 5CS,A00,896564,Carnelos; Chiara,20,0,20,0
1746608093610,LISP 5A,A00,896588,Munoz Sanchez; Alicia,2,0,20,18
1746608094640,LISP 5B,A00,896653,Munoz Sanchez; Alicia,7,0,20,13
1746608095670,LISP 5C,A00,896655,Munoz Sanchez; Alicia,0,1,20,20
1746608096698,MAE 197,001,957918,Kleissl; Jan,9996,0,9999,3
1746608096698,MAE 197,002,959806,Boechler; Nicholas Sebastia,9998,0,9999,1
1746608096698,MAE 197,003,959852,Mullin; Jennifer S,9998,0,9999,1
1746608097728,MATH 2,A01,957937,Staff,33,0,35,2
1746608098755,MATH 197,001,957876,Kedlaya; Kiran S.,9993,0,9999,6
1746608099788,MCWP 40,A00,892729,Duru; Nur,10,0,20,10
1746608099788,MCWP 40,B00,893304,Montejo; Carolina,14,0,20,6
1746608100818,MCWP 40R,A00,893757,Redela; Pamela Morgan,0,5,20,20
1746608101845,MCWP 50,A00,893758,Morshed; Michael James,0,0,20,20
1746608101845,MCWP 50,B00,893761,Bartulis; Jason Michael,16,0,20,4
1746608102871,MCWP 50R,A00,893766,Compas; Sean Matthew,0,1,20,20
1746608102871,MCWP 50R,B00,893769,Carter; Jennifer A,0,1,20,20
1746608102871,MCWP 50R,C00,893771,Krone; Jarret,0,3,20,20
1746608102871,MCWP 50R,D00,893772,Miller; Elizabeth Deen,0,0,20,20
1746608102871,MCWP 50R,E00,893775,Carter; Andrea L,0,1,20,20
1746608103899,MMW 11R,A01,892721,Herbst; Matthew,14,0,30,16
1746608103899,MMW 11R,A02,892722,Herbst; Matthew,0,0,0,3
1746608104926,MMW 12R,A01,892724,Herbst; Matthew,0,11,16,16
1746608104926,MMW 12R,A02,892725,Herbst; Matthew,0,10,16,16
1746608105951,MMW 13R,A01,892727,Staff,0,4,16,16
1746608105951,MMW 13R,A02,892728,Staff,0,4,16,16
1746608105951,MMW 13R,A03,958032,Staff,0,4,16,16
1746608105951,MMW 13R,A04,958033,Staff,0,4,16,16
1746608105951,MMW 13R,A05,958034,Staff,0,4,16,16
1746608106980,SIO 295LS,A00,894015,Staff,5,0,25,20
1746608108008,SIO 295S,A00,894020,Staff,5,0,25,20
1746608109042,SIOC 290S,B01,958918,Merrifield; Mark A,14,0,30,16
1746608110075,SIOC 291S,B01,958922,Gabriel; Corey John,14,0,30,16
1746608111106,SOCI 117,A01,895339,Staff,2,0,5,3
1746608112139,WES 237B,A00,894149,Staff,11,0,20,9
1746608114219,AESE 279B,A00,891859,Staff,13,0,35,22
1746608115246,AIP 197,001,891854,Vespa; Emanuel Ignacio,9999,0,9999,0
1746608116271,ANTH 289S,A00,891856,Gagneux; Pascal,12,0,12,0
1746608117296,BENG 196,001,957946,Engler; Adam J.,9996,0,9999,3
1746608118321,BISP 197,001,959851,Wilhelm; James E.,9998,0,9999,1
1746608119348,CAT 124RS,A01,956906,Staff,6,0,25,19
1746608120374,CAT 125RS,A01,922013,Staff,6,0,25,19
1746608121404,CLRE 250,A00,891860,Morris; Sheldon,9995,0,9999,4
1746608123461,CLRE 251R,A00,907817,Mehta; Ravindra L.,9994,0,9999,5
1746608124488,CLRE 252,A00,891864,Cuomo; Raphael Eduardo,9993,0,9999,6
1746608125513,CLRE 253,A00,891867,Vaida; Florin,9994,0,9999,5
1746608125513,CLRE 253,B00,907819,Staff,9999,0,9999,0
1746608126543,CLRE 259,A00,891868,Patel; Hemal,9998,0,9999,1
1746608127570,CLRE 260,A00,891872,Cuomo; Raphael Eduardo,9999,0,9999,0
1746608128595,CLRE 297,001,891888,Cuomo; Raphael Eduardo,9999,0,9999,0
1746608129623,CSE 191,A00,958773,Minnes Kemp; Mor Mia,9995,0,9999,4
1746608130651,CSE 197,001,959846,Minnes Kemp; Mor Mia,9990,0,9999,9
1746608131676,CSS 201S,A01,892054,Mignozzetti; Umberto,25,0,30,5
1746608132706,CSS 202S,A01,892056,Mignozzetti; Umberto,25,0,30,5
1746608133733,DSC 197,001,956898,Eldridge; Justin Matthew,9996,0,9999,3
1746608134761,DSC 297,001,958000,Mazumdar; Arya,9998,0,9999,1
1746608134761,DSC 297,002,959862,Wang; Yusu,9998,0,9999,1
1746608135789,EAP 100,A00,905686,Staff,9778,0,9999,221
1746608136816,ECE 45,A01,892618,Staff,0,0,65,65
1746608138871,ECE 111,A01,892719,Staff,6,0,65,59
1746608139901,ECE 197,001,957920,Mercier; Patrick Philip,9991,0,9999,8
1746608140936,ECON 178,A01,907814,Zhu; Ying,26,0,35,9
1746608141961,EDS 115,A00,895312,Staff,35,0,45,10
1746608142991,EDS 117,A01,895337,Staff,23,0,30,7
1746608144019,EDS 125,A00,895341,Jones; Gabrielle Anastasia,36,0,45,9
1746608145046,EDS 128A,A01,895459,Fargason; Sharon Gayle,44,0,45,1
1746608146073,EDS 128B,A01,895543,Pappas; Elizabeth,44,0,45,1
1746608147100,EDS 139,A00,897203,Pappas; Elizabeth,44,0,45,1
1746608147100,EDS 139,B00,897209,Fargason; Sharon Gayle,41,0,45,4
1746608148129,EDS 201,A00,895545,Staff,22,0,45,23
1746608149160,EDS 203,A01,895581,Halter; Christopher P.,22,0,45,23
1746608150187,EDS 204R,A01,895625,Heinzman; Erica M.,39,0,45,6
1746608150187,EDS 204R,B01,895693,Halter; Christopher P.,10,0,45,35
1746608151216,EDS 206R,A00,895694,Fargason; Sharon Gayle,1,0,30,29
1746608151216,EDS 206R,B00,895695,Choi; Bailey Miyeon,16,0,30,14
1746608152241,EDS 250,A00,895697,Hemans; Patricia Ann Benitez,22,0,45,23
1746608153270,EDS 281,A00,895701,Meyerott; Theresa Ann,1,0,15,14
1746608154299,EDS 284,A00,895736,Meyerott; Theresa Ann,1,0,15,14
1746608155326,EDS 286,A00,897210,Fine; Sarah,0,0,15,15
1746608156357,EDS 289C,A01,895770,Daly; Alan J.,1,0,15,14
1746608157384,EDS 290,A00,897211,Hofstetter; Carolyn,0,0,15,15
1746608158410,LIGM 5A,A00,896162,Fischer-Grunski; Eva K,12,0,20,8
1746608159440,LIGM 5B,A00,896260,Fischer-Grunski; Eva K,17,0,20,3
1746608160467,LIGM 5C,A00,896308,Fischer-Grunski; Eva K,18,0,20,2
1746608161496,LIIT 5AS,A00,896313,Carnelos; Chiara,18,0,20,2
1746608162524,LIIT 5BS,A00,896416,Carnelos; Chiara,20,0,20,0
1746608163553,LIIT 5CS,A00,896564,Carnelos; Chiara,20,0,20,0
1746608164582,LISP 5A,A00,896588,Munoz Sanchez; Alicia,2,0,20,18
1746608165610,LISP 5B,A00,896653,Munoz Sanchez; Alicia,7,0,20,13
1746608166638,LISP 5C,A00,896655,Munoz Sanchez; Alicia,0,1,20,20
1746608167672,MAE 197,001,957918,Kleissl; Jan,9996,0,9999,3
1746608167672,MAE 197,002,959806,Boechler; Nicholas Sebastia,9998,0,9999,1
1746608167672,MAE 197,003,959852,Mullin; Jennifer S,9998,0,9999,1
1746608168699,MATH 2,A01,957937,Staff,33,0,35,2
1746608169726,MATH 197,001,957876,Kedlaya; Kiran S.,9993,0,9999,6
1746608170753,MCWP 40,A00,892729,Duru; Nur,10,0,20,10
1746608170753,MCWP 40,B00,893304,Montejo; Carolina,14,0,20,6
1746608171779,MCWP 40R,A00,893757,Redela; Pamela Morgan,0,5,20,20
1746608172809,MCWP 50,A00,893758,Morshed; Michael James,0,0,20,20
1746608172809,MCWP 50,B00,893761,Bartulis; Jason Michael,16,0,20,4
1746608173837,MCWP 50R,A00,893766,Compas; Sean Matthew,0,1,20,20
1746608173837,MCWP 50R,B00,893769,Carter; Jennifer A,0,1,20,20
1746608173837,MCWP 50R,C00,893771,Krone; Jarret,0,3,20,20
1746608173837,MCWP 50R,D00,893772,Miller; Elizabeth Deen,0,0,20,20
1746608173837,MCWP 50R,E00,893775,Carter; Andrea L,0,1,20,20
1746608174868,MMW 11R,A01,892721,Herbst; Matthew,14,0,30,16
1746608174868,MMW 11R,A02,892722,Herbst; Matthew,0,0,0,3
1746608175896,MMW 12R,A01,892724,Herbst; Matthew,0,11,16,16
1746608175896,MMW 12R,A02,892725,Herbst; Matthew,0,10,16,16
1746608176923,MMW 13R,A01,892727,Staff,0,4,16,16
1746608176923,MMW 13R,A02,892728,Staff,0,4,16,16
1746608176923,MMW 13R,A03,958032,Staff,0,4,16,16
1746608176923,MMW 13R,A04,958033,Staff,0,4,16,16
1746608176923,MMW 13R,A05,958034,Staff,0,4,16,16
1746608177955,SIO 295LS,A00,894015,Staff,5,0,25,20
1746608178983,SIO 295S,A00,894020,Staff,5,0,25,20
1746608180011,SIOC 290S,B01,958918,Merrifield; Mark A,14,0,30,16
1746608181039,SIOC 291S,B01,958922,Gabriel; Corey John,14,0,30,16
1746608182067,SOCI 117,A01,895339,Staff,2,0,5,3
1746608183093,WES 237B,A00,894149,Staff,11,0,20,9
1746608185169,AESE 279B,A00,891859,Staff,13,0,35,22
1746608186198,AIP 197,001,891854,Vespa; Emanuel Ignacio,9999,0,9999,0
1746608187223,ANTH 289S,A00,891856,Gagneux; Pascal,12,0,12,0
1746608188248,BENG 196,001,957946,Engler; Adam J.,9996,0,9999,3
1746608189275,BISP 197,001,959851,Wilhelm; James E.,9998,0,9999,1
1746608190299,CAT 124RS,A01,956906,Staff,6,0,25,19
1746608191343,CAT 125RS,A01,922013,Staff,6,0,25,19
1746608192369,CLRE 250,A00,891860,Morris; Sheldon,9995,0,9999,4
1746608194438,CLRE 251R,A00,907817,Mehta; Ravindra L.,9994,0,9999,5
1746608195467,CLRE 252,A00,891864,Cuomo; Raphael Eduardo,9993,0,9999,6
1746608196495,CLRE 253,A00,891867,Vaida; Florin,9994,0,9999,5
1746608196495,CLRE 253,B00,907819,Staff,9999,0,9999,0
1746608197522,CLRE 259,A00,891868,Patel; Hemal,9998,0,9999,1
1746608198547,CLRE 260,A00,891872,Cuomo; Raphael Eduardo,9999,0,9999,0
1746608199576,CLRE 297,001,891888,Cuomo; Raphael Eduardo,9999,0,9999,0
1746608200601,CSE 191,A00,958773,Minnes Kemp; Mor Mia,9995,0,9999,4
1746608201628,CSE 197,001,959846,Minnes Kemp; Mor Mia,9990,0,9999,9
1746608202656,CSS 201S,A01,892054,Mignozzetti; Umberto,25,0,30,5
1746608203683,CSS 202S,A01,892056,Mignozzetti; Umberto,25,0,30,5
1746608204708,DSC 197,001,956898,Eldridge; Justin Matthew,9996,0,9999,3
1746608205731,DSC 297,001,958000,Mazumdar; Arya,9998,0,9999,1
1746608205731,DSC 297,002,959862,Wang; Yusu,9998,0,9999,1
1746608206754,EAP 100,A00,905686,Staff,9778,0,9999,221
1746608207813,ECE 45,A01,892618,Staff,0,0,65,65
1746608209864,ECE 111,A01,892719,Staff,6,0,65,59
1746608210887,ECE 197,001,957920,Mercier; Patrick Philip,9991,0,9999,8
1746608211912,ECON 178,A01,907814,Zhu; Ying,26,0,35,9
1746608212938,EDS 115,A00,895312,Staff,35,0,45,10
1746608213962,EDS 117,A01,895337,Staff,23,0,30,7
1746608215013,EDS 125,A00,895341,Jones; Gabrielle Anastasia,36,0,45,9
1746608216036,EDS 128A,A01,895459,Fargason; Sharon Gayle,44,0,45,1
1746608217061,EDS 128B,A01,895543,Pappas; Elizabeth,44,0,45,1
1746608218089,EDS 139,A00,897203,Pappas; Elizabeth,44,0,45,1
1746608218089,EDS 139,B00,897209,Fargason; Sharon Gayle,41,0,45,4
1746608219113,EDS 201,A00,895545,Staff,22,0,45,23
1746608220137,EDS 203,A01,895581,Halter; Christopher P.,22,0,45,23
1746608221178,EDS 204R,A01,895625,Heinzman; Erica M.,39,0,45,6
1746608221178,EDS 204R,B01,895693,Halter; Christopher P.,10,0,45,35
1746608222333,EDS 206R,A00,895694,Fargason; Sharon Gayle,1,0,30,29
1746608222333,EDS 206R,B00,895695,Choi; Bailey Miyeon,16,0,30,14
1746608223357,EDS 250,A00,895697,Hemans; Patricia Ann Benitez,22,0,45,23
1746608224401,EDS 281,A00,895701,Meyerott; Theresa Ann,1,0,15,14
1746608225451,EDS 284,A00,895736,Meyerott; Theresa Ann,1,0,15,14
1746608226476,EDS 286,A00,897210,Fine; Sarah,0,0,15,15
1746608227554,EDS 289C,A01,895770,Daly; Alan J.,1,0,15,14
1746608228601,EDS 290,A00,897211,Hofstetter; Carolyn,0,0,15,15
1746608229671,LIGM 5A,A00,896162,Fischer-Grunski; Eva K,12,0,20,8
1746608230696,LIGM 5B,A00,896260,Fischer-Grunski; Eva K,17,0,20,3
1746608231736,LIGM 5C,A00,896308,Fischer-Grunski; Eva K,18,0,20,2
1746608232760,LIIT 5AS,A00,896313,Carnelos; Chiara,18,0,20,2
1746608233785,LIIT 5BS,A00,896416,Carnelos; Chiara,20,0,20,0
1746608234812,LIIT 5CS,A00,896564,Carnelos; Chiara,20,0,20,0
1746608235857,LISP 5A,A00,896588,Munoz Sanchez; Alicia,2,0,20,18
1746608236881,LISP 5B,A00,896653,Munoz Sanchez; Alicia,7,0,20,13
1746608237909,LISP 5C,A00,896655,Munoz Sanchez; Alicia,0,1,20,20
1746608238936,MAE 197,001,957918,Kleissl; Jan,9996,0,9999,3
1746608238936,MAE 197,002,959806,Boechler; Nicholas Sebastia,9998,0,9999,1
1746608238936,MAE 197,003,959852,Mullin; Jennifer S,9998,0,9999,1
1746608239964,MATH 2,A01,957937,Staff,33,0,35,2
1746608240993,MATH 197,001,957876,Kedlaya; Kiran S.,9993,0,9999,6
1746608242021,MCWP 40,A00,892729,Duru; Nur,10,0,20,10
1746608242021,MCWP 40,B00,893304,Montejo; Carolina,14,0,20,6
1746608243046,MCWP 40R,A00,893757,Redela; Pamela Morgan,0,5,20,20
1746608244074,MCWP 50,A00,893758,Morshed; Michael James,0,0,20,20
1746608244074,MCWP 50,B00,893761,Bartulis; Jason Michael,16,0,20,4
1746608245107,MCWP 50R,A00,893766,Compas; Sean Matthew,0,1,20,20
1746608245107,MCWP 50R,B00,893769,Carter; Jennifer A,0,1,20,20
1746608245107,MCWP 50R,C00,893771,Krone; Jarret,0,3,20,20
1746608245107,MCWP 50R,D00,893772,Miller; Elizabeth Deen,0,0,20,20
1746608245107,MCWP 50R,E00,893775,Carter; Andrea L,0,1,20,20
1746608246134,MMW 11R,A01,892721,Herbst; Matthew,14,0,30,16
1746608246134,MMW 11R,A02,892722,Herbst; Matthew,0,0,0,3
1746608247162,MMW 12R,A01,892724,Herbst; Matthew,0,11,16,16
1746608247162,MMW 12R,A02,892725,Herbst; Matthew,0,10,16,16
1746608248189,MMW 13R,A01,892727,Staff,0,4,16,16
1746608248189,MMW 13R,A02,892728,Staff,0,4,16,16
1746608248189,MMW 13R,A03,958032,Staff,0,4,16,16
1746608248189,MMW 13R,A04,958033,Staff,0,4,16,16
1746608248189,MMW 13R,A05,958034,Staff,0,4,16,16
1746608249214,SIO 295LS,A00,894015,Staff,5,0,25,20
1746608250241,SIO 295S,A00,894020,Staff,5,0,25,20
1746608251266,SIOC 290S,B01,958918,Merrifield; Mark A,14,0,30,16
1746608252293,SIOC 291S,B01,958922,Gabriel; Corey John,14,0,30,16
1746608253322,SOCI 117,A01,895339,Staff,2,0,5,3
1746608254346,WES 237B,A00,894149,Staff,11,0,20,9
1746608256423,AESE 279B,A00,891859,Staff,13,0,35,22
1746608257451,AIP 197,001,891854,Vespa; Emanuel Ignacio,9999,0,9999,0
1746608258478,ANTH 289S,A00,891856,Gagneux; Pascal,12,0,12,0
1746608259505,BENG 196,001,957946,Engler; Adam J.,9996,0,9999,3
1746608260534,BISP 197,001,959851,Wilhelm; James E.,9998,0,9999,1
1746608261568,CAT 124RS,A01,956906,Staff,6,0,25,19
1746608262594,CAT 125RS,A01,922013,Staff,6,0,25,19
1746608263623,CLRE 250,A00,891860,Morris; Sheldon,9995,0,9999,4
1746608265676,CLRE 251R,A00,907817,Mehta; Ravindra L.,9994,0,9999,5
1746608266701,CLRE 252,A00,891864,Cuomo; Raphael Eduardo,9993,0,9999,6
1746608267731,CLRE 253,A00,891867,Vaida; Florin,9994,0,9999,5
1746608267731,CLRE 253,B00,907819,Staff,9999,0,9999,0
1746608268756,CLRE 259,A00,891868,Patel; Hemal,9998,0,9999,1
1746608269784,CLRE 260,A00,891872,Cuomo; Raphael Eduardo,9999,0,9999,0
1746608270811,CLRE 297,001,891888,Cuomo; Raphael Eduardo,9999,0,9999,0
1746608271839,CSE 191,A00,958773,Minnes Kemp; Mor Mia,9995,0,9999,4
1746608272864,CSE 197,001,959846,Minnes Kemp; Mor Mia,9990,0,9999,9
1746608273891,CSS 201S,A01,892054,Mignozzetti; Umberto,25,0,30,5
1746608274921,CSS 202S,A01,892056,Mignozzetti; Umberto,25,0,30,5
1746608275946,DSC 197,001,956898,Eldridge; Justin Matthew,9996,0,9999,3
1746608276977,DSC 297,001,958000,Mazumdar; Arya,9998,0,9999,1
1746608276977,DSC 297,002,959862,Wang; Yusu,9998,0,9999,1
1746608278003,EAP 100,A00,905686,Staff,9778,0,9999,221
1746608279028,ECE 45,A01,892618,Staff,0,0,65,65
1746608281084,ECE 111,A01,892719,Staff,6,0,65,59
1746608282110,ECE 197,001,957920,Mercier; Patrick Philip,9991,0,9999,8
1746608283137,ECON 178,A01,907814,Zhu; Ying,26,0,35,9
1746608284165,EDS 115,A00,895312,Staff,35,0,45,10
1746608285194,EDS 117,A01,895337,Staff,23,0,30,7
1746608286224,EDS 125,A00,895341,Jones; Gabrielle Anastasia,36,0,45,9
1746608287252,EDS 128A,A01,895459,Fargason; Sharon Gayle,44,0,45,1
1746608288279,EDS 128B,A01,895543,Pappas; Elizabeth,44,0,45,1
1746608289304,EDS 139,A00,897203,Pappas; Elizabeth,44,0,45,1
1746608289304,EDS 139,B00,897209,Fargason; Sharon Gayle,41,0,45,4
1746608290331,EDS 201,A00,895545,Staff,22,0,45,23
1746608291358,EDS 203,A01,895581,Halter; Christopher P.,22,0,45,23
1746608292383,EDS 204R,A01,895625,Heinzman; Erica M.,39,0,45,6
1746608292383,EDS 204R,B01,895693,Halter; Christopher P.,10,0,45,35
1746608293410,EDS 206R,A00,895694,Fargason; Sharon Gayle,1,0,30,29
1746608293410,EDS 206R,B00,895695,Choi; Bailey Miyeon,16,0,30,14
1746608294437,EDS 250,A00,895697,Hemans; Patricia Ann Benitez,22,0,45,23
1746608295462,EDS 281,A00,895701,Meyerott; Theresa Ann,1,0,15,14
1746608296490,EDS 284,A00,895736,Meyerott; Theresa Ann,1,0,15,14
1746608297519,EDS 286,A00,897210,Fine; Sarah,0,0,15,15
1746608298547,EDS 289C,A01,895770,Daly; Alan J.,1,0,15,14
1746608299571,EDS 290,A00,897211,Hofstetter; Carolyn,0,0,15,15
1746608300600,LIGM 5A,A00,896162,Fischer-Grunski; Eva K,12,0,20,8
1746608301628,LIGM 5B,A00,896260,Fischer-Grunski; Eva K,17,0,20,3
1746608302656,LIGM 5C,A00,896308,Fischer-Grunski; Eva K,18,0,20,2
1746608303681,LIIT 5AS,A00,896313,Carnelos; Chiara,18,0,20,2
1746608304710,LIIT 5BS,A00,896416,Carnelos; Chiara,20,0,20,0
1746608305736,LIIT 5CS,A00,896564,Carnelos; Chiara,20,0,20,0
1746608306762,LISP 5A,A00,896588,Munoz Sanchez; Alicia,2,0,20,18
1746608307786,LISP 5B,A00,896653,Munoz Sanchez; Alicia,7,0,20,13
1746608308813,LISP 5C,A00,896655,Munoz Sanchez; Alicia,0,1,20,20
1746608309840,MAE 197,001,957918,Kleissl; Jan,9996,0,9999,3
1746608309840,MAE 197,002,959806,Boechler; Nicholas Sebastia,9998,0,9999,1
1746608309840,MAE 197,003,959852,Mullin; Jennifer S,9998,0,9999,1
1746608310871,MATH 2,A01,957937,Staff,33,0,35,2
1746608311895,MATH 197,001,957876,Kedlaya; Kiran S.,9993,0,9999,6
1746608312926,MCWP 40,A00,892729,Duru; Nur,10,0,20,10
1746608312926,MCWP 40,B00,893304,Montejo; Carolina,14,0,20,6
1746608313952,MCWP 40R,A00,893757,Redela; Pamela Morgan,0,5,20,20
1746608314982,MCWP 50,A00,893758,Morshed; Michael James,0,0,20,20
1746608314982,MCWP 50,B00,893761,Bartulis; Jason Michael,16,0,20,4
1746608316009,MCWP 50R,A00,893766,Compas; Sean Matthew,0,1,20,20
1746608316009,MCWP 50R,B00,893769,Carter; Jennifer A,0,1,20,20
1746608316009,MCWP 50R,C00,893771,Krone; Jarret,0,3,20,20
1746608316009,MCWP 50R,D00,893772,Miller; Elizabeth Deen,0,0,20,20
1746608316009,MCWP 50R,E00,893775,Carter; Andrea L,0,1,20,20
1746608317037,MMW 11R,A01,892721,Herbst; Matthew,14,0,30,16
1746608317037,MMW 11R,A02,892722,Herbst; Matthew,0,0,0,3
1746608318062,MMW 12R,A01,892724,Herbst; Matthew,0,11,16,16
1746608318062,MMW 12R,A02,892725,Herbst; Matthew,0,10,16,16
1746608319146,MMW 13R,A01,892727,Staff,0,4,16,16
1746608319146,MMW 13R,A02,892728,Staff,0,4,16,16
1746608319146,MMW 13R,A03,958032,Staff,0,4,16,16
1746608319146,MMW 13R,A04,958033,Staff,0,4,16,16
1746608319146,MMW 13R,A05,958034,Staff,0,4,16,16
1746608320175,SIO 295LS,A00,894015,Staff,5,0,25,20
1746608321205,SIO 295S,A00,894020,Staff,5,0,25,20
1746608322232,SIOC 290S,B01,958918,Merrifield; Mark A,14,0,30,16
1746608323260,SIOC 291S,B01,958922,Gabriel; Corey John,14,0,30,16
1746608324287,SOCI 117,A01,895339,Staff,2,0,5,3
1746608325312,WES 237B,A00,894149,Staff,11,0,20,9
1746608327379,AESE 279B,A00,891859,Staff,13,0,35,22
1746608328404,AIP 197,001,891854,Vespa; Emanuel Ignacio,9999,0,9999,0
1746608329436,ANTH 289S,A00,891856,Gagneux; Pascal,12,0,12,0
1746608330465,BENG 196,001,957946,Engler; Adam J.,9996,0,9999,3
1746608331491,BISP 197,001,959851,Wilhelm; James E.,9998,0,9999,1
1746608332520,CAT 124RS,A01,956906,Staff,6,0,25,19
1746608333548,CAT 125RS,A01,922013,Staff,6,0,25,19
1746608334575,CLRE 250,A00,891860,Morris; Sheldon,9995,0,9999,4
1746608336628,CLRE 251R,A00,907817,Mehta; Ravindra L.,9994,0,9999,5
1746608337657,CLRE 252,A00,891864,Cuomo; Raphael Eduardo,9993,0,9999,6
1746608338688,CLRE 253,A00,891867,Vaida; Florin,9994,0,9999,5
1746608338688,CLRE 253,B00,907819,Staff,9999,0,9999,0
1746608339715,CLRE 259,A00,891868,Patel; Hemal,9998,0,9999,1
1746608340746,CLRE 260,A00,891872,Cuomo; Raphael Eduardo,9999,0,9999,0
1746608341771,CLRE 297,001,891888,Cuomo; Raphael Eduardo,9999,0,9999,0
1746608342801,CSE 191,A00,958773,Minnes Kemp; Mor Mia,9995,0,9999,4
1746608343827,CSE 197,001,959846,Minnes Kemp; Mor Mia,9990,0,9999,9
1746608344856,CSS 201S,A01,892054,Mignozzetti; Umberto,25,0,30,5
1746608345885,CSS 202S,A01,892056,Mignozzetti; Umberto,25,0,30,5
1746608346912,DSC 197,001,956898,Eldridge; Justin Matthew,9996,0,9999,3
1746608347937,DSC 297,001,958000,Mazumdar; Arya,9998,0,9999,1
1746608347937,DSC 297,002,959862,Wang; Yusu,9998,0,9999,1
1746608348964,EAP 100,A00,905686,Staff,9778,0,9999,221
1746608349994,ECE 45,A01,892618,Staff,0,0,65,65
1746608352046,ECE 111,A01,892719,Staff,6,0,65,59
1746608353073,ECE 197,001,957920,Mercier; Patrick Philip,9991,0,9999,8
1746608354103,ECON 178,A01,907814,Zhu; Ying,26,0,35,9
1746608355129,EDS 115,A00,895312,Staff,35,0,45,10
1746608356154,EDS 117,A01,895337,Staff,23,0,30,7
1746608357182,EDS 125,A00,895341,Jones; Gabrielle Anastasia,36,0,45,9
1746608358207,EDS 128A,A01,895459,Fargason; Sharon Gayle,44,0,45,1
1746608359230,EDS 128B,A01,895543,Pappas; Elizabeth,44,0,45,1
1746608360257,EDS 139,A00,897203,Pappas; Elizabeth,44,0,45,1
1746608360257,EDS 139,B00,897209,Fargason; Sharon Gayle,41,0,45,4
1746608361284,EDS 201,A00,895545,Staff,22,0,45,23
1746608362308,EDS 203,A01,895581,Halter; Christopher P.,22,0,45,23
1746608363337,EDS 204R,A01,895625,Heinzman; Erica M.,39,0,45,6
1746608363337,EDS 204R,B01,895693,Halter; Christopher P.,10,0,45,35
1746608364875,EDS 206R,A00,895694,Fargason; Sharon Gayle,1,0,30,29
1746608364875,EDS 206R,B00,895695,Choi; Bailey Miyeon,16,0,30,14
1746608365905,EDS 250,A00,895697,Hemans; Patricia Ann Benitez,22,0,45,23
1746608366931,EDS 281,A00,895701,Meyerott; Theresa Ann,1,0,15,14
1746608367960,EDS 284,A00,895736,Meyerott; Theresa Ann,1,0,15,14
1746608368988,EDS 286,A00,897210,Fine; Sarah,0,0,15,15
1746608370023,EDS 289C,A01,895770,Daly; Alan J.,1,0,15,14
1746608371053,EDS 290,A00,897211,Hofstetter; Carolyn,0,0,15,15
1746608372081,LIGM 5A,A00,896162,Fischer-Grunski; Eva K,12,0,20,8
1746608373106,LIGM 5B,A00,896260,Fischer-Grunski; Eva K,17,0,20,3
1746608374131,LIGM 5C,A00,896308,Fischer-Grunski; Eva K,18,0,20,2
1746608375161,LIIT 5AS,A00,896313,Carnelos; Chiara,18,0,20,2
1746608376192,LIIT 5BS,A00,896416,Carnelos; Chiara,20,0,20,0
1746608377220,LIIT 5CS,A00,896564,Carnelos; Chiara,20,0,20,0
1746608378248,LISP 5A,A00,896588,Munoz Sanchez; Alicia,2,0,20,18
1746608379274,LISP 5B,A00,896653,Munoz Sanchez; Alicia,7,0,20,13
1746608380299,LISP 5C,A00,896655,Munoz Sanchez; Alicia,0,1,20,20
1746608381330,MAE 197,001,957918,Kleissl; Jan,9996,0,9999,3
1746608381330,MAE 197,002,959806,Boechler; Nicholas Sebastia,9998,0,9999,1
1746608381330,MAE 197,003,959852,Mullin; Jennifer S,9998,0,9999,1
1746608382361,MATH 2,A01,957937,Staff,33,0,35,2
1746608383386,MATH 197,001,957876,Kedlaya; Kiran S.,9993,0,9999,6
1746608384413,MCWP 40,A00,892729,Duru; Nur,10,0,20,10
1746608384413,MCWP 40,B00,893304,Montejo; Carolina,14,0,20,6
1746608385441,MCWP 40R,A00,893757,Redela; Pamela Morgan,0,5,20,20
1746608386465,MCWP 50,A00,893758,Morshed; Michael James,0,0,20,20
1746608386465,MCWP 50,B00,893761,Bartulis; Jason Michael,16,0,20,4
1746608387491,MCWP 50R,A00,893766,Compas; Sean Matthew,0,1,20,20
1746608387491,MCWP 50R,B00,893769,Carter; Jennifer A,0,1,20,20
1746608387491,MCWP 50R,C00,893771,Krone; Jarret,0,3,20,20
1746608387491,MCWP 50R,D00,893772,Miller; Elizabeth Deen,0,0,20,20
1746608387491,MCWP 50R,E00,893775,Carter; Andrea L,0,1,20,20
1746608388521,MMW 11R,A01,892721,Herbst; Matthew,14,0,30,16
1746608388521,MMW 11R,A02,892722,Herbst; Matthew,0,0,0,3
1746608389548,MMW 12R,A01,892724,Herbst; Matthew,0,11,16,16
1746608389548,MMW 12R,A02,892725,Herbst; Matthew,0,10,16,16
1746608390574,MMW 13R,A01,892727,Staff,0,4,16,16
1746608390574,MMW 13R,A02,892728,Staff,0,4,16,16
1746608390574,MMW 13R,A03,958032,Staff,0,4,16,16
1746608390574,MMW 13R,A04,958033,Staff,0,4,16,16
1746608390574,MMW 13R,A05,958034,Staff,0,4,16,16
1746608391604,SIO 295LS,A00,894015,Staff,5,0,25,20
1746608392631,SIO 295S,A00,894020,Staff,5,0,25,20
1746608393662,SIOC 290S,B01,958918,Merrifield; Mark A,14,0,30,16
1746608394692,SIOC 291S,B01,958922,Gabriel; Corey John,14,0,30,16
1746608395720,SOCI 117,A01,895339,Staff,2,0,5,3
1746608396747,WES 237B,A00,894149,Staff,11,0,20,9
1746608398823,AESE 279B,A00,891859,Staff,13,0,35,22
1746608399851,AIP 197,001,891854,Vespa; Emanuel Ignacio,9999,0,9999,0
1746608400876,ANTH 289S,A00,891856,Gagneux; Pascal,12,0,12,0
1746608401902,BENG 196,001,957946,Engler; Adam J.,9996,0,9999,3
1746608402928,BISP 197,001,959851,Wilhelm; James E.,9998,0,9999,1
1746608403957,CAT 124RS,A01,956906,Staff,6,0,25,19
1746608404987,CAT 125RS,A01,922013,Staff,6,0,25,19
1746608406013,CLRE 250,A00,891860,Morris; Sheldon,9995,0,9999,4
1746608409079,CLRE 251R,A00,907817,Mehta; Ravindra L.,9994,0,9999,5
1746608410108,CLRE 252,A00,891864,Cuomo; Raphael Eduardo,9993,0,9999,6
1746608411135,CLRE 253,A00,891867,Vaida; Florin,9994,0,9999,5
1746608411135,CLRE 253,B00,907819,Staff,9999,0,9999,0
1746608412164,CLRE 259,A00,891868,Patel; Hemal,9998,0,9999,1
1746608413190,CLRE 260,A00,891872,Cuomo; Raphael Eduardo,9999,0,9999,0
1746608414216,CLRE 297,001,891888,Cuomo; Raphael Eduardo,9999,0,9999,0
1746608415244,CSE 191,A00,958773,Minnes Kemp; Mor Mia,9995,0,9999,4
1746608416271,CSE 197,001,959846,Minnes Kemp; Mor Mia,9990,0,9999,9
1746608417299,CSS 201S,A01,892054,Mignozzetti; Umberto,25,0,30,5
1746608418328,CSS 202S,A01,892056,Mignozzetti; Umberto,25,0,30,5
1746608419351,DSC 197,001,956898,Eldridge; Justin Matthew,9996,0,9999,3
1746608420377,DSC 297,001,958000,Mazumdar; Arya,9998,0,9999,1
1746608420377,DSC 297,002,959862,Wang; Yusu,9998,0,9999,1
1746608421404,EAP 100,A00,905686,Staff,9778,0,9999,221
1746608422428,ECE 45,A01,892618,Staff,0,0,65,65
1746608424485,ECE 111,A01,892719,Staff,6,0,65,59
1746608425510,ECE 197,001,957920,Mercier; Patrick Philip,9991,0,9999,8
1746608426541,ECON 178,A01,907814,Zhu; Ying,26,0,35,9
1746608427570,EDS 115,A00,895312,Staff,35,0,45,10
1746608428598,EDS 117,A01,895337,Staff,23,0,30,7
1746608429623,EDS 125,A00,895341,Jones; Gabrielle Anastasia,36,0,45,9
1746608430650,EDS 128A,A01,895459,Fargason; Sharon Gayle,44,0,45,1
1746608431678,EDS 128B,A01,895543,Pappas; Elizabeth,44,0,45,1
1746608432710,EDS 139,A00,897203,Pappas; Elizabeth,44,0,45,1
1746608432710,EDS 139,B00,897209,Fargason; Sharon Gayle,41,0,45,4
1746608433738,EDS 201,A00,895545,Staff,22,0,45,23
1746608434764,EDS 203,A01,895581,Halter; Christopher P.,22,0,45,23
1746608435790,EDS 204R,A01,895625,Heinzman; Erica M.,39,0,45,6
1746608435790,EDS 204R,B01,895693,Halter; Christopher P.,10,0,45,35
1746608436820,EDS 206R,A00,895694,Fargason; Sharon Gayle,1,0,30,29
1746608436820,EDS 206R,B00,895695,Choi; Bailey Miyeon,16,0,30,14
1746608437847,EDS 250,A00,895697,Hemans; Patricia Ann Benitez,22,0,45,23
1746608438877,EDS 281,A00,895701,Meyerott; Theresa Ann,1,0,15,14
1746608439906,EDS 284,A00,895736,Meyerott; Theresa Ann,1,0,15,14
1746608440931,EDS 286,A00,897210,Fine; Sarah,0,0,15,15
1746608441959,EDS 289C,A01,895770,Daly; Alan J.,1,0,15,14
1746608442984,EDS 290,A00,897211,Hofstetter; Carolyn,0,0,15,15
1746608444014,LIGM 5A,A00,896162,Fischer-Grunski; Eva K,12,0,20,8
1746608445045,LIGM 5B,A00,896260,Fischer-Grunski; Eva K,17,0,20,3
1746608446071,LIGM 5C,A00,896308,Fischer-Grunski; Eva K,18,0,20,2
1746608447096,LIIT 5AS,A00,896313,Carnelos; Chiara,18,0,20,2
1746608448124,LIIT 5BS,A00,896416,Carnelos; Chiara,20,0,20,0
1746608449149,LIIT 5CS,A00,896564,Carnelos; Chiara,20,0,20,0
1746608450176,LISP 5A,A00,896588,Munoz Sanchez; Alicia,2,0,20,18
1746608451202,LISP 5B,A00,896653,Munoz Sanchez; Alicia,7,0,20,13
1746608452233,LISP 5C,A00,896655,Munoz Sanchez; Alicia,0,1,20,20
1746608453259,MAE 197,001,957918,Kleissl; Jan,9996,0,9999,3
1746608453259,MAE 197,002,959806,Boechler; Nicholas Sebastia,9998,0,9999,1
1746608453259,MAE 197,003,959852,Mullin; Jennifer S,9998,0,9999,1
1746608454288,MATH 2,A01,957937,Staff,33,0,35,2
1746608455318,MATH 197,001,957876,Kedlaya; Kiran S.,9993,0,9999,6
1746608456344,MCWP 40,A00,892729,Duru; Nur,10,0,20,10
1746608456344,MCWP 40,B00,893304,Montejo; Carolina,14,0,20,6
1746608457372,MCWP 40R,A00,893757,Redela; Pamela Morgan,0,5,20,20
1746608458439,MCWP 50,A00,893758,Morshed; Michael James,0,0,20,20
1746608458439,MCWP 50,B00,893761,Bartulis; Jason Michael,16,0,20,4
1746608459465,MCWP 50R,A00,893766,Compas; Sean Matthew,0,1,20,20
1746608459465,MCWP 50R,B00,893769,Carter; Jennifer A,0,1,20,20
1746608459465,MCWP 50R,C00,893771,Krone; Jarret,0,3,20,20
1746608459465,MCWP 50R,D00,893772,Miller; Elizabeth Deen,0,0,20,20
1746608459465,MCWP 50R,E00,893775,Carter; Andrea L,0,1,20,20
1746608460492,MMW 11R,A01,892721,Herbst; Matthew,14,0,30,16
1746608460492,MMW 11R,A02,892722,Herbst; Matthew,0,0,0,3
1746608461517,MMW 12R,A01,892724,Herbst; Matthew,0,11,16,16
1746608461517,MMW 12R,A02,892725,Herbst; Matthew,0,10,16,16
1746608462545,MMW 13R,A01,892727,Staff,0,4,16,16
1746608462545,MMW 13R,A02,892728,Staff,0,4,16,16
1746608462545,MMW 13R,A03,958032,Staff,0,4,16,16
1746608462545,MMW 13R,A04,958033,Staff,0,4,16,16
1746608462545,MMW 13R,A05,958034,Staff,0,4,16,16
1746608463576,SIO 295LS,A00,894015,Staff,5,0,25,20
1746608464603,SIO 295S,A00,894020,Staff,5,0,25,20
1746608465637,SIOC 290S,B01,958918,Merrifield; Mark A,14,0,30,16
1746608466663,SIOC 291S,B01,958922,Gabriel; Corey John,14,0,30,16
1746608467690,SOCI 117,A01,895339,Staff,2,0,5,3
1746608468717,WES 237B,A00,894149,Staff,11,0,20,9
1746608470800,AESE 279B,A00,891859,Staff,13,0,35,22
1746608471827,AIP 197,001,891854,Vespa; Emanuel Ignacio,9999,0,9999,0
1746608472854,ANTH 289S,A00,891856,Gagneux; Pascal,12,0,12,0
1746608473886,BENG 196,001,957946,Engler; Adam J.,9996,0,9999,3
1746608474915,BISP 197,001,959851,Wilhelm; James E.,9998,0,9999,1
1746608475942,CAT 124RS,A01,956906,Staff,6,0,25,19
1746608476969,CAT 125RS,A01,922013,Staff,6,0,25,19
1746608477994,CLRE 250,A00,891860,Morris; Sheldon,9995,0,9999,4
1746608480051,CLRE 251R,A00,907817,Mehta; Ravindra L.,9994,0,9999,5
1746608481077,CLRE 252,A00,891864,Cuomo; Raphael Eduardo,9993,0,9999,6
1746608482109,CLRE 253,A00,891867,Vaida; Florin,9994,0,9999,5
1746608482109,CLRE 253,B00,907819,Staff,9999,0,9999,0
1746608483139,CLRE 259,A00,891868,Patel; Hemal,9998,0,9999,1
1746608484165,CLRE 260,A00,891872,Cuomo; Raphael Eduardo,9999,0,9999,0
1746608485195,CLRE 297,001,891888,Cuomo; Raphael Eduardo,9999,0,9999,0
1746608486227,CSE 191,A00,958773,Minnes Kemp; Mor Mia,9995,0,9999,4
1746608487252,CSE 197,001,959846,Minnes Kemp; Mor Mia,9990,0,9999,9
1746608488281,CSS 201S,A01,892054,Mignozzetti; Umberto,25,0,30,5
1746608489314,CSS 202S,A01,892056,Mignozzetti; Umberto,25,0,30,5
1746608490342,DSC 197,001,956898,Eldridge; Justin Matthew,9996,0,9999,3
1746608491369,DSC 297,001,958000,Mazumdar; Arya,9998,0,9999,1
1746608491369,DSC 297,002,959862,Wang; Yusu,9998,0,9999,1
1746608492412,EAP 100,A00,905686,Staff,9778,0,9999,221
1746608493440,ECE 45,A01,892618,Staff,0,0,65,65
1746608495497,ECE 111,A01,892719,Staff,6,0,65,59
1746608496527,ECE 197,001,957920,Mercier; Patrick Philip,9991,0,9999,8
1746608497559,ECON 178,A01,907814,Zhu; Ying,26,0,35,9
1746608498589,EDS 115,A00,895312,Staff,35,0,45,10
1746608499617,EDS 117,A01,895337,Staff,23,0,30,7
1746608500647,EDS 125,A00,895341,Jones; Gabrielle Anastasia,36,0,45,9
1746608501679,EDS 128A,A01,895459,Fargason; Sharon Gayle,44,0,45,1
1746608502707,EDS 128B,A01,895543,Pappas; Elizabeth,44,0,45,1
1746608503739,EDS 139,A00,897203,Pappas; Elizabeth,44,0,45,1
1746608503739,EDS 139,B00,897209,Fargason; Sharon Gayle,41,0,45,4
1746608504771,EDS 201,A00,895545,Staff,22,0,45,23
1746608505798,EDS 203,A01,895581,Halter; Christopher P.,22,0,45,23
1746608506826,EDS 204R,A01,895625,Heinzman; Erica M.,39,0,45,6
1746608506826,EDS 204R,B01,895693,Halter; Christopher P.,10,0,45,35
1746608507858,EDS 206R,A00,895694,Fargason; Sharon Gayle,1,0,30,29
1746608507858,EDS 206R,B00,895695,Choi; Bailey Miyeon,16,0,30,14
1746608508886,EDS 250,A00,895697,Hemans; Patricia Ann Benitez,22,0,45,23
1746608509913,EDS 281,A00,895701,Meyerott; Theresa Ann,1,0,15,14
1746608510947,EDS 284,A00,895736,Meyerott; Theresa Ann,1,0,15,14
1746608511978,EDS 286,A00,897210,Fine; Sarah,0,0,15,15
1746608513004,EDS 289C,A01,895770,Daly; Alan J.,1,0,15,14
1746608514034,EDS 290,A00,897211,Hofstetter; Carolyn,0,0,15,15
1746608515068,LIGM 5A,A00,896162,Fischer-Grunski; Eva K,12,0,20,8
1746608516100,LIGM 5B,A00,896260,Fischer-Grunski; Eva K,17,0,20,3
1746608517132,LIGM 5C,A00,896308,Fischer-Grunski; Eva K,18,0,20,2
1746608518159,LIIT 5AS,A00,896313,Carnelos; Chiara,18,0,20,2
1746608519187,LIIT 5BS,A00,896416,Carnelos; Chiara,20,0,20,0
1746608520217,LIIT 5CS,A00,896564,Carnelos; Chiara,20,0,20,0
1746608521245,LISP 5A,A00,896588,Munoz Sanchez; Alicia,2,0,20,18
1746608522273,LISP 5B,A00,896653,Munoz Sanchez; Alicia,7,0,20,13
1746608523300,LISP 5C,A00,896655,Munoz Sanchez; Alicia,0,1,20,20
1746608524329,MAE 197,001,957918,Kleissl; Jan,9996,0,9999,3
1746608524329,MAE 197,002,959806,Boechler; Nicholas Sebastia,9998,0,9999,1
1746608524329,MAE 197,003,959852,Mullin; Jennifer S,9998,0,9999,1
1746608525356,MATH 2,A01,957937,Staff,33,0,35,2
1746608526386,MATH 197,001,957876,Kedlaya; Kiran S.,9993,0,9999,6
1746608527418,MCWP 40,A00,892729,Duru; Nur,10,0,20,10
1746608527418,MCWP 40,B00,893304,Montejo; Carolina,14,0,20,6
1746608528445,MCWP 40R,A00,893757,Redela; Pamela Morgan,0,5,20,20
1746608529472,MCWP 50,A00,893758,Morshed; Michael James,0,0,20,20
1746608529472,MCWP 50,B00,893761,Bartulis; Jason Michael,16,0,20,4
1746608530507,MCWP 50R,A00,893766,Compas; Sean Matthew,0,1,20,20
1746608530507,MCWP 50R,B00,893769,Carter; Jennifer A,0,1,20,20
1746608530507,MCWP 50R,C00,893771,Krone; Jarret,0,3,20,20
1746608530507,MCWP 50R,D00,893772,Miller; Elizabeth Deen,0,0,20,20
1746608530507,MCWP 50R,E00,893775,Carter; Andrea L,0,1,20,20
1746608531534,MMW 11R,A01,892721,Herbst; Matthew,14,0,30,16
1746608531534,MMW 11R,A02,892722,Herbst; Matthew,0,0,0,3
1746608532560,MMW 12R,A01,892724,Herbst; Matthew,0,11,16,16
1746608532560,MMW 12R,A02,892725,Herbst; Matthew,0,10,16,16
1746608533588,MMW 13R,A01,892727,Staff,0,4,16,16
1746608533588,MMW 13R,A02,892728,Staff,0,4,16,16
1746608533588,MMW 13R,A03,958032,Staff,0,4,16,16
1746608533588,MMW 13R,A04,958033,Staff,0,4,16,16
1746608533588,MMW 13R,A05,958034,Staff,0,4,16,16
1746608534614,SIO 295LS,A00,894015,Staff,5,0,25,20
1746608535641,SIO 295S,A00,894020,Staff,5,0,25,20
1746608536669,SIOC 290S,B01,958918,Merrifield; Mark A,14,0,30,16
1746608537701,SIOC 291S,B01,958922,Gabriel; Corey John,14,0,30,16
1746608538728,SOCI 117,A01,895339,Staff,2,0,5,3
1746608539755,WES 237B,A00,894149,Staff,11,0,20,9
1746608541827,AESE 279B,A00,891859,Staff,13,0,35,22
1746608542855,AIP 197,001,891854,Vespa; Emanuel Ignacio,9999,0,9999,0
1746608543883,ANTH 289S,A00,891856,Gagneux; Pascal,12,0,12,0
1746608544913,BENG 196,001,957946,Engler; Adam J.,9996,0,9999,3
1746608545944,BISP 197,001,959851,Wilhelm; James E.,9998,0,9999,1
1746608546970,CAT 124RS,A01,956906,Staff,6,0,25,19
1746608547997,CAT 125RS,A01,922013,Staff,6,0,25,19
1746608549027,CLRE 250,A00,891860,Morris; Sheldon,9995,0,9999,4
1746608551088,CLRE 251R,A00,907817,Mehta; Ravindra L.,9994,0,9999,5
1746608552114,CLRE 252,A00,891864,Cuomo; Raphael Eduardo,9993,0,9999,6
1746608553141,CLRE 253,A00,891867,Vaida; Florin,9994,0,9999,5
1746608553141,CLRE 253,B00,907819,Staff,9999,0,9999,0
1746608554170,CLRE 259,A00,891868,Patel; Hemal,9998,0,9999,1
1746608555197,CLRE 260,A00,891872,Cuomo; Raphael Eduardo,9999,0,9999,0
1746608556224,CLRE 297,001,891888,Cuomo; Raphael Eduardo,9999,0,9999,0
1746608557252,CSE 191,A00,958773,Minnes Kemp; Mor Mia,9995,0,9999,4
1746608558282,CSE 197,001,959846,Minnes Kemp; Mor Mia,9990,0,9999,9
1746608559309,CSS 201S,A01,892054,Mignozzetti; Umberto,25,0,30,5
1746608560334,CSS 202S,A01,892056,Mignozzetti; Umberto,25,0,30,5
1746608561362,DSC 197,001,956898,Eldridge; Justin Matthew,9996,0,9999,3
1746608562433,DSC 297,001,958000,Mazumdar; Arya,9998,0,9999,1
1746608562433,DSC 297,002,959862,Wang; Yusu,9998,0,9999,1
1746608563463,EAP 100,A00,905686,Staff,9778,0,9999,221
1746608564493,ECE 45,A01,892618,Staff,0,0,65,65
1746608566550,ECE 111,A01,892719,Staff,6,0,65,59
1746608567578,ECE 197,001,957920,Mercier; Patrick Philip,9991,0,9999,8
1746608568608,ECON 178,A01,907814,Zhu; Ying,26,0,35,9
1746608569635,EDS 115,A00,895312,Staff,35,0,45,10
1746608570663,EDS 117,A01,895337,Staff,23,0,30,7
1746608571695,EDS 125,A00,895341,Jones; Gabrielle Anastasia,36,0,45,9
1746608572724,EDS 128A,A01,895459,Fargason; Sharon Gayle,44,0,45,1
1746608573749,EDS 128B,A01,895543,Pappas; Elizabeth,44,0,45,1
1746608574775,EDS 139,A00,897203,Pappas; Elizabeth,44,0,45,1
1746608574775,EDS 139,B00,897209,Fargason; Sharon Gayle,41,0,45,4
1746608575802,EDS 201,A00,895545,Staff,22,0,45,23
1746608576829,EDS 203,A01,895581,Halter; Christopher P.,22,0,45,23
1746608577859,EDS 204R,A01,895625,Heinzman; Erica M.,39,0,45,6
1746608577859,EDS 204R,B01,895693,Halter; Christopher P.,10,0,45,35
1746608578890,EDS 206R,A00,895694,Fargason; Sharon Gayle,1,0,30,29
1746608578890,EDS 206R,B00,895695,Choi; Bailey Miyeon,16,0,30,14
1746608579917,EDS 250,A00,895697,Hemans; Patricia Ann Benitez,22,0,45,23
1746608580945,EDS 281,A00,895701,Meyerott; Theresa Ann,1,0,15,14
1746608581980,EDS 284,A00,895736,Meyerott; Theresa Ann,1,0,15,14
1746608583007,EDS 286,A00,897210,Fine; Sarah,0,0,15,15
1746608584036,EDS 289C,A01,895770,Daly; Alan J.,1,0,15,14
1746608585064,EDS 290,A00,897211,Hofstetter; Carolyn,0,0,15,15
1746608586092,LIGM 5A,A00,896162,Fischer-Grunski; Eva K,12,0,20,8
1746608587121,LIGM 5B,A00,896260,Fischer-Grunski; Eva K,17,0,20,3
1746608588148,LIGM 5C,A00,896308,Fischer-Grunski; Eva K,18,0,20,2
1746608589179,LIIT 5AS,A00,896313,Carnelos; Chiara,18,0,20,2
1746608590205,LIIT 5BS,A00,896416,Carnelos; Chiara,20,0,20,0
1746608591231,LIIT 5CS,A00,896564,Carnelos; Chiara,20,0,20,0
1746608592258,LISP 5A,A00,896588,Munoz Sanchez; Alicia,2,0,20,18
1746608593283,LISP 5B,A00,896653,Munoz Sanchez; Alicia,7,0,20,13
1746608594311,LISP 5C,A00,896655,Munoz Sanchez; Alicia,0,1,20,20
1746608595343,MAE 197,001,957918,Kleissl; Jan,9996,0,9999,3
1746608595343,MAE 197,002,959806,Boechler; Nicholas Sebastia,9998,0,9999,1
1746608595343,MAE 197,003,959852,Mullin; Jennifer S,9998,0,9999,1
1746608596368,MATH 2,A01,957937,Staff,33,0,35,2
1746608597399,MATH 197,001,957876,Kedlaya; Kiran S.,9993,0,9999,6
1746608598425,MCWP 40,A00,892729,Duru; Nur,10,0,20,10
1746608598425,MCWP 40,B00,893304,Montejo; Carolina,14,0,20,6
1746608599456,MCWP 40R,A00,893757,Redela; Pamela Morgan,0,5,20,20
1746608600482,MCWP 50,A00,893758,Morshed; Michael James,0,0,20,20
1746608600482,MCWP 50,B00,893761,Bartulis; Jason Michael,16,0,20,4
1746608601509,MCWP 50R,A00,893766,Compas; Sean Matthew,0,1,20,20
1746608601509,MCWP 50R,B00,893769,Carter; Jennifer A,0,1,20,20
1746608601509,MCWP 50R,C00,893771,Krone; Jarret,0,3,20,20
1746608601509,MCWP 50R,D00,893772,Miller; Elizabeth Deen,0,0,20,20
1746608601509,MCWP 50R,E00,893775,Carter; Andrea L,0,1,20,20
1746608602539,MMW 11R,A01,892721,Herbst; Matthew,14,0,30,16
1746608602539,MMW 11R,A02,892722,Herbst; Matthew,0,0,0,3
1746608603566,MMW 12R,A01,892724,Herbst; Matthew,0,11,16,16
1746608603566,MMW 12R,A02,892725,Herbst; Matthew,0,10,16,16
1746608604591,MMW 13R,A01,892727,Staff,0,4,16,16
1746608604591,MMW 13R,A02,892728,Staff,0,4,16,16
1746608604591,MMW 13R,A03,958032,Staff,0,4,16,16
1746608604591,MMW 13R,A04,958033,Staff,0,4,16,16
1746608604591,MMW 13R,A05,958034,Staff,0,4,16,16
1746608605617,SIO 295LS,A00,894015,Staff,5,0,25,20
1746608606644,SIO 295S,A00,894020,Staff,5,0,25,20
1746608607676,SIOC 290S,B01,958918,Merrifield; Mark A,14,0,30,16
1746608608709,SIOC 291S,B01,958922,Gabriel; Corey John,14,0,30,16
1746608609738,SOCI 117,A01,895339,Staff,2,0,5,3
1746608610766,WES 237B,A00,894149,Staff,11,0,20,9
1746608612844,AESE 279B,A00,891859,Staff,13,0,35,22
1746608613871,AIP 197,001,891854,Vespa; Emanuel Ignacio,9999,0,9999,0
1746608614896,ANTH 289S,A00,891856,Gagneux; Pascal,12,0,12,0
1746608615922,BENG 196,001,957946,Engler; Adam J.,9996,0,9999,3
1746608616948,BISP 197,001,959851,Wilhelm; James E.,9998,0,9999,1
1746608617973,CAT 124RS,A01,956906,Staff,6,0,25,19
1746608619003,CAT 125RS,A01,922013,Staff,6,0,25,19
1746608620033,CLRE 250,A00,891860,Morris; Sheldon,9995,0,9999,4
1746608622084,CLRE 251R,A00,907817,Mehta; Ravindra L.,9994,0,9999,5
1746608623109,CLRE 252,A00,891864,Cuomo; Raphael Eduardo,9993,0,9999,6
1746608624134,CLRE 253,A00,891867,Vaida; Florin,9994,0,9999,5
1746608624134,CLRE 253,B00,907819,Staff,9999,0,9999,0
1746608625161,CLRE 259,A00,891868,Patel; Hemal,9998,0,9999,1
1746608626187,CLRE 260,A00,891872,Cuomo; Raphael Eduardo,9999,0,9999,0
1746608627213,CLRE 297,001,891888,Cuomo; Raphael Eduardo,9999,0,9999,0
1746608628239,CSE 191,A00,958773,Minnes Kemp; Mor Mia,9995,0,9999,4
1746608629266,CSE 197,001,959846,Minnes Kemp; Mor Mia,9990,0,9999,9
1746608630296,CSS 201S,A01,892054,Mignozzetti; Umberto,25,0,30,5
1746608631322,CSS 202S,A01,892056,Mignozzetti; Umberto,25,0,30,5
1746608632349,DSC 197,001,956898,Eldridge; Justin Matthew,9996,0,9999,3
1746608633378,DSC 297,001,958000,Mazumdar; Arya,9998,0,9999,1
1746608633378,DSC 297,002,959862,Wang; Yusu,9998,0,9999,1
1746608634404,EAP 100,A00,905686,Staff,9778,0,9999,221
1746608635431,ECE 45,A01,892618,Staff,0,0,65,65
1746608637490,ECE 111,A01,892719,Staff,6,0,65,59
1746608638518,ECE 197,001,957920,Mercier; Patrick Philip,9991,0,9999,8
1746608639545,ECON 178,A01,907814,Zhu; Ying,26,0,35,9
1746608640573,EDS 115,A00,895312,Staff,35,0,45,10
1746608641600,EDS 117,A01,895337,Staff,23,0,30,7
1746608642625,EDS 125,A00,895341,Jones; Gabrielle Anastasia,36,0,45,9
1746608643654,EDS 128A,A01,895459,Fargason; Sharon Gayle,44,0,45,1
1746608644683,EDS 128B,A01,895543,Pappas; Elizabeth,44,0,45,1
1746608645712,EDS 139,A00,897203,Pappas; Elizabeth,44,0,45,1
1746608645712,EDS 139,B00,897209,Fargason; Sharon Gayle,41,0,45,4
1746608646739,EDS 201,A00,895545,Staff,22,0,45,23
1746608647766,EDS 203,A01,895581,Halter; Christopher P.,22,0,45,23
1746608648795,EDS 204R,A01,895625,Heinzman; Erica M.,39,0,45,6
1746608648795,EDS 204R,B01,895693,Halter; Christopher P.,10,0,45,35
1746608649825,EDS 206R,A00,895694,Fargason; Sharon Gayle,1,0,30,29
1746608649825,EDS 206R,B00,895695,Choi; Bailey Miyeon,16,0,30,14
1746608650854,EDS 250,A00,895697,Hemans; Patricia Ann Benitez,22,0,45,23
1746608651883,EDS 281,A00,895701,Meyerott; Theresa Ann,1,0,15,14
1746608652909,EDS 284,A00,895736,Meyerott; Theresa Ann,1,0,15,14
1746608653934,EDS 286,A00,897210,Fine; Sarah,0,0,15,15
1746608654960,EDS 289C,A01,895770,Daly; Alan J.,1,0,15,14
1746608655987,EDS 290,A00,897211,Hofstetter; Carolyn,0,0,15,15
1746608657014,LIGM 5A,A00,896162,Fischer-Grunski; Eva K,12,0,20,8
1746608658039,LIGM 5B,A00,896260,Fischer-Grunski; Eva K,17,0,20,3
1746608659068,LIGM 5C,A00,896308,Fischer-Grunski; Eva K,18,0,20,2
1746608660094,LIIT 5AS,A00,896313,Carnelos; Chiara,18,0,20,2
1746608661119,LIIT 5BS,A00,896416,Carnelos; Chiara,20,0,20,0
1746608662148,LIIT 5CS,A00,896564,Carnelos; Chiara,20,0,20,0
1746608663180,LISP 5A,A00,896588,Munoz Sanchez; Alicia,2,0,20,18
1746608664208,LISP 5B,A00,896653,Munoz Sanchez; Alicia,7,0,20,13
1746608665239,LISP 5C,A00,896655,Munoz Sanchez; Alicia,0,1,20,20
1746608666323,MAE 197,001,957918,Kleissl; Jan,9996,0,9999,3
1746608666323,MAE 197,002,959806,Boechler; Nicholas Sebastia,9998,0,9999,1
1746608666323,MAE 197,003,959852,Mullin; Jennifer S,9998,0,9999,1
1746608667349,MATH 2,A01,957937,Staff,33,0,35,2
1746608668375,MATH 197,001,957876,Kedlaya; Kiran S.,9993,0,9999,6
1746608669404,MCWP 40,A00,892729,Duru; Nur,10,0,20,10
1746608669404,MCWP 40,B00,893304,Montejo; Carolina,14,0,20,6
1746608670430,MCWP 40R,A00,893757,Redela; Pamela Morgan,0,5,20,20
1746608671461,MCWP 50,A00,893758,Morshed; Michael James,0,0,20,20
1746608671461,MCWP 50,B00,893761,Bartulis; Jason Michael,16,0,20,4
1746608672487,MCWP 50R,A00,893766,Compas; Sean Matthew,0,1,20,20
1746608672487,MCWP 50R,B00,893769,Carter; Jennifer A,0,1,20,20
1746608672487,MCWP 50R,C00,893771,Krone; Jarret,0,3,20,20
1746608672487,MCWP 50R,D00,893772,Miller; Elizabeth Deen,0,0,20,20
1746608672487,MCWP 50R,E00,893775,Carter; Andrea L,0,1,20,20
1746608673512,MMW 11R,A01,892721,Herbst; Matthew,14,0,30,16
1746608673512,MMW 11R,A02,892722,Herbst; Matthew,0,0,0,3
1746608674538,MMW 12R,A01,892724,Herbst; Matthew,0,11,16,16
1746608674538,MMW 12R,A02,892725,Herbst; Matthew,0,10,16,16
1746608675568,MMW 13R,A01,892727,Staff,0,4,16,16
1746608675568,MMW 13R,A02,892728,Staff,0,4,16,16
1746608675568,MMW 13R,A03,958032,Staff,0,4,16,16
1746608675568,MMW 13R,A04,958033,Staff,0,4,16,16
1746608675568,MMW 13R,A05,958034,Staff,0,4,16,16
1746608676594,SIO 295LS,A00,894015,Staff,5,0,25,20
1746608677623,SIO 295S,A00,894020,Staff,5,0,25,20
1746608678655,SIOC 290S,B01,958918,Merrifield; Mark A,14,0,30,16
1746608679684,SIOC 291S,B01,958922,Gabriel; Corey John,14,0,30,16
1746608680712,SOCI 117,A01,895339,Staff,2,0,5,3
1746608681738,WES 237B,A00,894149,Staff,11,0,20,9
1746608683803,AESE 279B,A00,891859,Staff,13,0,35,22
1746608684828,AIP 197,001,891854,Vespa; Emanuel Ignacio,9999,0,9999,0
1746608685858,ANTH 289S,A00,891856,Gagneux; Pascal,12,0,12,0
1746608686888,BENG 196,001,957946,Engler; Adam J.,9996,0,9999,3
1746608687916,BISP 197,001,959851,Wilhelm; James E.,9998,0,9999,1
1746608688942,CAT 124RS,A01,956906,Staff,6,0,25,19
1746608689970,CAT 125RS,A01,922013,Staff,6,0,25,19
1746608690999,CLRE 250,A00,891860,Morris; Sheldon,9995,0,9999,4
1746608693057,CLRE 251R,A00,907817,Mehta; Ravindra L.,9994,0,9999,5
1746608694084,CLRE 252,A00,891864,Cuomo; Raphael Eduardo,9993,0,9999,6
1746608695111,CLRE 253,A00,891867,Vaida; Florin,9994,0,9999,5
1746608695111,CLRE 253,B00,907819,Staff,9999,0,9999,0
1746608696141,CLRE 259,A00,891868,Patel; Hemal,9998,0,9999,1
1746608697167,CLRE 260,A00,891872,Cuomo; Raphael Eduardo,9999,0,9999,0
1746608698194,CLRE 297,001,891888,Cuomo; Raphael Eduardo,9999,0,9999,0
1746608699220,CSE 191,A00,958773,Minnes Kemp; Mor Mia,9995,0,9999,4
1746608700247,CSE 197,001,959846,Minnes Kemp; Mor Mia,9990,0,9999,9
1746608701278,CSS 201S,A01,892054,Mignozzetti; Umberto,25,0,30,5
1746608702304,CSS 202S,A01,892056,Mignozzetti; Umberto,25,0,30,5
1746608703334,DSC 197,001,956898,Eldridge; Justin Matthew,9996,0,9999,3
1746608704365,DSC 297,001,958000,Mazumdar; Arya,9998,0,9999,1
1746608704365,DSC 297,002,959862,Wang; Yusu,9998,0,9999,1
1746608705393,EAP 100,A00,905686,Staff,9778,0,9999,221
1746608706420,ECE 45,A01,892618,Staff,0,0,65,65
1746608708479,ECE 111,A01,892719,Staff,6,0,65,59
1746608709504,ECE 197,001,957920,Mercier; Patrick Philip,9991,0,9999,8
1746608710532,ECON 178,A01,907814,Zhu; Ying,26,0,35,9
1746608711559,EDS 115,A00,895312,Staff,35,0,45,10
1746608712586,EDS 117,A01,895337,Staff,23,0,30,7
1746608713618,EDS 125,A00,895341,Jones; Gabrielle Anastasia,36,0,45,9
1746608714645,EDS 128A,A01,895459,Fargason; Sharon Gayle,44,0,45,1
1746608715675,EDS 128B,A01,895543,Pappas; Elizabeth,44,0,45,1
1746608716703,EDS 139,A00,897203,Pappas; Elizabeth,44,0,45,1
1746608716703,EDS 139,B00,897209,Fargason; Sharon Gayle,41,0,45,4
1746608717729,EDS 201,A00,895545,Staff,22,0,45,23
1746608718757,EDS 203,A01,895581,Halter; Christopher P.,22,0,45,23
1746608719783,EDS 204R,A01,895625,Heinzman; Erica M.,39,0,45,6
1746608719783,EDS 204R,B01,895693,Halter; Christopher P.,10,0,45,35
1746608720812,EDS 206R,A00,895694,Fargason; Sharon Gayle,1,0,30,29
1746608720812,EDS 206R,B00,895695,Choi; Bailey Miyeon,16,0,30,14
1746608721841,EDS 250,A00,895697,Hemans; Patricia Ann Benitez,22,0,45,23
1746608722870,EDS 281,A00,895701,Meyerott; Theresa Ann,1,0,15,14
1746608723897,EDS 284,A00,895736,Meyerott; Theresa Ann,1,0,15,14
1746608724923,EDS 286,A00,897210,Fine; Sarah,0,0,15,15
1746608725949,EDS 289C,A01,895770,Daly; Alan J.,1,0,15,14
1746608726975,EDS 290,A00,897211,Hofstetter; Carolyn,0,0,15,15
1746608728001,LIGM 5A,A00,896162,Fischer-Grunski; Eva K,12,0,20,8
1746608729031,LIGM 5B,A00,896260,Fischer-Grunski; Eva K,17,0,20,3
1746608730056,LIGM 5C,A00,896308,Fischer-Grunski; Eva K,18,0,20,2
1746608731085,LIIT 5AS,A00,896313,Carnelos; Chiara,18,0,20,2
1746608732111,LIIT 5BS,A00,896416,Carnelos; Chiara,20,0,20,0
1746608733140,LIIT 5CS,A00,896564,Carnelos; Chiara,20,0,20,0
1746608734169,LISP 5A,A00,896588,Munoz Sanchez; Alicia,2,0,20,18
1746608735195,LISP 5B,A00,896653,Munoz Sanchez; Alicia,7,0,20,13
1746608736225,LISP 5C,A00,896655,Munoz Sanchez; Alicia,0,1,20,20
1746608737252,MAE 197,001,957918,Kleissl; Jan,9996,0,9999,3
1746608737252,MAE 197,002,959806,Boechler; Nicholas Sebastia,9998,0,9999,1
1746608737252,MAE 197,003,959852,Mullin; Jennifer S,9998,0,9999,1
1746608738277,MATH 2,A01,957937,Staff,33,0,35,2
1746608739306,MATH 197,001,957876,Kedlaya; Kiran S.,9993,0,9999,6
1746608740336,MCWP 40,A00,892729,Duru; Nur,10,0,20,10
1746608740336,MCWP 40,B00,893304,Montejo; Carolina,14,0,20,6
1746608741364,MCWP 40R,A00,893757,Redela; Pamela Morgan,0,5,20,20
1746608742403,MCWP 50,A00,893758,Morshed; Michael James,0,0,20,20
1746608742403,MCWP 50,B00,893761,Bartulis; Jason Michael,16,0,20,4
1746608743432,MCWP 50R,A00,893766,Compas; Sean Matthew,0,1,20,20
1746608743432,MCWP 50R,B00,893769,Carter; Jennifer A,0,1,20,20
1746608743432,MCWP 50R,C00,893771,Krone; Jarret,0,3,20,20
1746608743432,MCWP 50R,D00,893772,Miller; Elizabeth Deen,0,0,20,20
1746608743432,MCWP 50R,E00,893775,Carter; Andrea L,0,1,20,20
1746608744462,MMW 11R,A01,892721,Herbst; Matthew,14,0,30,16
1746608744462,MMW 11R,A02,892722,Herbst; Matthew,0,0,0,3
1746608745486,MMW 12R,A01,892724,Herbst; Matthew,0,11,16,16
1746608745486,MMW 12R,A02,892725,Herbst; Matthew,0,10,16,16
1746608746512,MMW 13R,A01,892727,Staff,0,4,16,16
1746608746512,MMW 13R,A02,892728,Staff,0,4,16,16
1746608746512,MMW 13R,A03,958032,Staff,0,4,16,16
1746608746512,MMW 13R,A04,958033,Staff,0,4,16,16
1746608746512,MMW 13R,A05,958034,Staff,0,4,16,16
1746608747536,SIO 295LS,A00,894015,Staff,5,0,25,20
1746608748562,SIO 295S,A00,894020,Staff,5,0,25,20
1746608749589,SIOC 290S,B01,958918,Merrifield; Mark A,14,0,30,16
1746608750617,SIOC 291S,B01,958922,Gabriel; Corey John,14,0,30,16
1746608751643,SOCI 117,A01,895339,Staff,2,0,5,3
1746608752670,WES 237B,A00,894149,Staff,11,0,20,9
1746608754734,AESE 279B,A00,891859,Staff,13,0,35,22
1746608755761,AIP 197,001,891854,Vespa; Emanuel Ignacio,9999,0,9999,0
1746608756787,ANTH 289S,A00,891856,Gagneux; Pascal,12,0,12,0
1746608757818,BENG 196,001,957946,Engler; Adam J.,9996,0,9999,3
1746608758848,BISP 197,001,959851,Wilhelm; James E.,9998,0,9999,1
1746608759879,CAT 124RS,A01,956906,Staff,6,0,25,19
1746608760904,CAT 125RS,A01,922013,Staff,6,0,25,19
1746608761930,CLRE 250,A00,891860,Morris; Sheldon,9995,0,9999,4
1746608763983,CLRE 251R,A00,907817,Mehta; Ravindra L.,9994,0,9999,5
1746608765009,CLRE 252,A00,891864,Cuomo; Raphael Eduardo,9993,0,9999,6
1746608766039,CLRE 253,A00,891867,Vaida; Florin,9994,0,9999,5
1746608766039,CLRE 253,B00,907819,Staff,9999,0,9999,0
1746608767065,CLRE 259,A00,891868,Patel; Hemal,9998,0,9999,1
1746608768091,CLRE 260,A00,891872,Cuomo; Raphael Eduardo,9999,0,9999,0
1746608769120,CLRE 297,001,891888,Cuomo; Raphael Eduardo,9999,0,9999,0
1746608770186,CSE 191,A00,958773,Minnes Kemp; Mor Mia,9995,0,9999,4
1746608771213,CSE 197,001,959846,Minnes Kemp; Mor Mia,9990,0,9999,9
1746608772246,CSS 201S,A01,892054,Mignozzetti; Umberto,25,0,30,5
1746608773278,CSS 202S,A01,892056,Mignozzetti; Umberto,25,0,30,5
1746608774303,DSC 197,001,956898,Eldridge; Justin Matthew,9996,0,9999,3
1746608775331,DSC 297,001,958000,Mazumdar; Arya,9998,0,9999,1
1746608775331,DSC 297,002,959862,Wang; Yusu,9998,0,9999,1
1746608776355,EAP 100,A00,905686,Staff,9778,0,9999,221
1746608777386,ECE 45,A01,892618,Staff,0,0,65,65
1746608779443,ECE 111,A01,892719,Staff,6,0,65,59
1746608780471,ECE 197,001,957920,Mercier; Patrick Philip,9991,0,9999,8
1746608781499,ECON 178,A01,907814,Zhu; Ying,26,0,35,9
1746608782525,EDS 115,A00,895312,Staff,35,0,45,10
1746608783555,EDS 117,A01,895337,Staff,23,0,30,7
1746608784584,EDS 125,A00,895341,Jones; Gabrielle Anastasia,36,0,45,9
1746608785614,EDS 128A,A01,895459,Fargason; Sharon Gayle,44,0,45,1
1746608786641,EDS 128B,A01,895543,Pappas; Elizabeth,44,0,45,1
1746608787667,EDS 139,A00,897203,Pappas; Elizabeth,44,0,45,1
1746608787667,EDS 139,B00,897209,Fargason; Sharon Gayle,41,0,45,4
1746608788692,EDS 201,A00,895545,Staff,22,0,45,23
1746608789718,EDS 203,A01,895581,Halter; Christopher P.,22,0,45,23
1746608790744,EDS 204R,A01,895625,Heinzman; Erica M.,39,0,45,6
1746608790744,EDS 204R,B01,895693,Halter; Christopher P.,10,0,45,35
1746608791769,EDS 206R,A00,895694,Fargason; Sharon Gayle,1,0,30,29
1746608791769,EDS 206R,B00,895695,Choi; Bailey Miyeon,16,0,30,14
1746608792798,EDS 250,A00,895697,Hemans; Patricia Ann Benitez,22,0,45,23
1746608793826,EDS 281,A00,895701,Meyerott; Theresa Ann,1,0,15,14
1746608794853,EDS 284,A00,895736,Meyerott; Theresa Ann,1,0,15,14
1746608795883,EDS 286,A00,897210,Fine; Sarah,0,0,15,15
1746608796911,EDS 289C,A01,895770,Daly; Alan J.,1,0,15,14
1746608797937,EDS 290,A00,897211,Hofstetter; Carolyn,0,0,15,15
1746608798971,LIGM 5A,A00,896162,Fischer-Grunski; Eva K,12,0,20,8
1746608800004,LIGM 5B,A00,896260,Fischer-Grunski; Eva K,17,0,20,3
1746608801034,LIGM 5C,A00,896308,Fischer-Grunski; Eva K,18,0,20,2
1746608802061,LIIT 5AS,A00,896313,Carnelos; Chiara,18,0,20,2
1746608803087,LIIT 5BS,A00,896416,Carnelos; Chiara,20,0,20,0
1746608804112,LIIT 5CS,A00,896564,Carnelos; Chiara,20,0,20,0
1746608805143,LISP 5A,A00,896588,Munoz Sanchez; Alicia,2,0,20,18
1746608806172,LISP 5B,A00,896653,Munoz Sanchez; Alicia,7,0,20,13
1746608807200,LISP 5C,A00,896655,Munoz Sanchez; Alicia,0,1,20,20
1746608808225,MAE 197,001,957918,Kleissl; Jan,9996,0,9999,3
1746608808225,MAE 197,002,959806,Boechler; Nicholas Sebastia,9998,0,9999,1
1746608808225,MAE 197,003,959852,Mullin; Jennifer S,9998,0,9999,1
1746608809249,MATH 2,A01,957937,Staff,33,0,35,2
1746608810274,MATH 197,001,957876,Kedlaya; Kiran S.,9993,0,9999,6
1746608811305,MCWP 40,A00,892729,Duru; Nur,10,0,20,10
1746608811305,MCWP 40,B00,893304,Montejo; Carolina,14,0,20,6
1746608812330,MCWP 40R,A00,893757,Redela; Pamela Morgan,0,5,20,20
1746608813357,MCWP 50,A00,893758,Morshed; Michael James,0,0,20,20
1746608813357,MCWP 50,B00,893761,Bartulis; Jason Michael,16,0,20,4
1746608814383,MCWP 50R,A00,893766,Compas; Sean Matthew,0,1,20,20
1746608814383,MCWP 50R,B00,893769,Carter; Jennifer A,0,1,20,20
1746608814383,MCWP 50R,C00,893771,Krone; Jarret,0,3,20,20
1746608814383,MCWP 50R,D00,893772,Miller; Elizabeth Deen,0,0,20,20
1746608814383,MCWP 50R,E00,893775,Carter; Andrea L,0,1,20,20
1746608815408,MMW 11R,A01,892721,Herbst; Matthew,14,0,30,16
1746608815408,MMW 11R,A02,892722,Herbst; Matthew,0,0,0,3
1746608816434,MMW 12R,A01,892724,Herbst; Matthew,0,11,16,16
1746608816434,MMW 12R,A02,892725,Herbst; Matthew,0,10,16,16
1746608817464,MMW 13R,A01,892727,Staff,0,4,16,16
1746608817464,MMW 13R,A02,892728,Staff,0,4,16,16
1746608817464,MMW 13R,A03,958032,Staff,0,4,16,16
1746608817464,MMW 13R,A04,958033,Staff,0,4,16,16
1746608817464,MMW 13R,A05,958034,Staff,0,4,16,16
1746608818490,SIO 295LS,A00,894015,Staff,5,0,25,20
1746608819517,SIO 295S,A00,894020,Staff,5,0,25,20
1746608820543,SIOC 290S,B01,958918,Merrifield; Mark A,14,0,30,16
1746608821575,SIOC 291S,B01,958922,Gabriel; Corey John,14,0,30,16
1746608822604,SOCI 117,A01,895339,Staff,2,0,5,3
1746608823630,WES 237B,A00,894149,Staff,11,0,20,9
1746608825698,AESE 279B,A00,891859,Staff,13,0,35,22
1746608826724,AIP 197,001,891854,Vespa; Emanuel Ignacio,9999,0,9999,0
1746608827755,ANTH 289S,A00,891856,Gagneux; Pascal,12,0,12,0
1746608828781,BENG 196,001,957946,Engler; Adam J.,9996,0,9999,3
1746608829806,BISP 197,001,959851,Wilhelm; James E.,9998,0,9999,1
1746608830835,CAT 124RS,A01,956906,Staff,6,0,25,19
1746608831860,CAT 125RS,A01,922013,Staff,6,0,25,19
1746608832887,CLRE 250,A00,891860,Morris; Sheldon,9995,0,9999,4
1746608834936,CLRE 251R,A00,907817,Mehta; Ravindra L.,9994,0,9999,5
1746608835962,CLRE 252,A00,891864,Cuomo; Raphael Eduardo,9993,0,9999,6
1746608836988,CLRE 253,A00,891867,Vaida; Florin,9994,0,9999,5
1746608836988,CLRE 253,B00,907819,Staff,9999,0,9999,0
1746608838015,CLRE 259,A00,891868,Patel; Hemal,9998,0,9999,1
1746608839040,CLRE 260,A00,891872,Cuomo; Raphael Eduardo,9999,0,9999,0
1746608840067,CLRE 297,001,891888,Cuomo; Raphael Eduardo,9999,0,9999,0
1746608841092,CSE 191,A00,958773,Minnes Kemp; Mor Mia,9995,0,9999,4
1746608842117,CSE 197,001,959846,Minnes Kemp; Mor Mia,9990,0,9999,9
1746608843145,CSS 201S,A01,892054,Mignozzetti; Umberto,25,0,30,5
1746608844169,CSS 202S,A01,892056,Mignozzetti; Umberto,25,0,30,5
1746608845194,DSC 197,001,956898,Eldridge; Justin Matthew,9996,0,9999,3
1746608846222,DSC 297,001,958000,Mazumdar; Arya,9998,0,9999,1
1746608846222,DSC 297,002,959862,Wang; Yusu,9998,0,9999,1
1746608847251,EAP 100,A00,905686,Staff,9778,0,9999,221
1746608848279,ECE 45,A01,892618,Staff,0,0,65,65
1746608850333,ECE 111,A01,892719,Staff,6,0,65,59
1746608851362,ECE 197,001,957920,Mercier; Patrick Philip,9991,0,9999,8
1746608852388,ECON 178,A01,907814,Zhu; Ying,26,0,35,9
1746608853414,EDS 115,A00,895312,Staff,35,0,45,10
1746608854438,EDS 117,A01,895337,Staff,23,0,30,7
1746608855464,EDS 125,A00,895341,Jones; Gabrielle Anastasia,36,0,45,9
1746608856494,EDS 128A,A01,895459,Fargason; Sharon Gayle,44,0,45,1
1746608857524,EDS 128B,A01,895543,Pappas; Elizabeth,44,0,45,1
1746608858552,EDS 139,A00,897203,Pappas; Elizabeth,44,0,45,1
1746608858552,EDS 139,B00,897209,Fargason; Sharon Gayle,41,0,45,4
1746608859581,EDS 201,A00,895545,Staff,22,0,45,23
1746608860607,EDS 203,A01,895581,Halter; Christopher P.,22,0,45,23
1746608861634,EDS 204R,A01,895625,Heinzman; Erica M.,39,0,45,6
1746608861634,EDS 204R,B01,895693,Halter; Christopher P.,10,0,45,35
1746608862661,EDS 206R,A00,895694,Fargason; Sharon Gayle,1,0,30,29
1746608862661,EDS 206R,B00,895695,Choi; Bailey Miyeon,16,0,30,14
1746608863685,EDS 250,A00,895697,Hemans; Patricia Ann Benitez,22,0,45,23
1746608864710,EDS 281,A00,895701,Meyerott; Theresa Ann,1,0,15,14
1746608865738,EDS 284,A00,895736,Meyerott; Theresa Ann,1,0,15,14
1746608866766,EDS 286,A00,897210,Fine; Sarah,0,0,15,15
1746608867790,EDS 289C,A01,895770,Daly; Alan J.,1,0,15,14
1746608868816,EDS 290,A00,897211,Hofstetter; Carolyn,0,0,15,15
1746608869842,LIGM 5A,A00,896162,Fischer-Grunski; Eva K,12,0,20,8
1746608870869,LIGM 5B,A00,896260,Fischer-Grunski; Eva K,17,0,20,3
1746608871897,LIGM 5C,A00,896308,Fischer-Grunski; Eva K,18,0,20,2
1746608872926,LIIT 5AS,A00,896313,Carnelos; Chiara,18,0,20,2
1746608873990,LIIT 5BS,A00,896416,Carnelos; Chiara,20,0,20,0
1746608875020,LIIT 5CS,A00,896564,Carnelos; Chiara,20,0,20,0
1746608876048,LISP 5A,A00,896588,Munoz Sanchez; Alicia,2,0,20,18
1746608877076,LISP 5B,A00,896653,Munoz Sanchez; Alicia,7,0,20,13
1746608878103,LISP 5C,A00,896655,Munoz Sanchez; Alicia,0,1,20,20
1746608879133,MAE 197,001,957918,Kleissl; Jan,9996,0,9999,3
1746608879133,MAE 197,002,959806,Boechler; Nicholas Sebastia,9998,0,9999,1
1746608879133,MAE 197,003,959852,Mullin; Jennifer S,9998,0,9999,1
1746608880159,MATH 2,A01,957937,Staff,33,0,35,2
1746608881188,MATH 197,001,957876,Kedlaya; Kiran S.,9993,0,9999,6
1746608882219,MCWP 40,A00,892729,Duru; Nur,10,0,20,10
1746608882219,MCWP 40,B00,893304,Montejo; Carolina,14,0,20,6
1746608883248,MCWP 40R,A00,893757,Redela; Pamela Morgan,0,5,20,20
1746608884272,MCWP 50,A00,893758,Morshed; Michael James,0,0,20,20
1746608884272,MCWP 50,B00,893761,Bartulis; Jason Michael,16,0,20,4
1746608885299,MCWP 50R,A00,893766,Compas; Sean Matthew,0,1,20,20
1746608885299,MCWP 50R,B00,893769,Carter; Jennifer A,0,1,20,20
1746608885299,MCWP 50R,C00,893771,Krone; Jarret,0,3,20,20
1746608885299,MCWP 50R,D00,893772,Miller; Elizabeth Deen,0,0,20,20
1746608885299,MCWP 50R,E00,893775,Carter; Andrea L,0,1,20,20
1746608886326,MMW 11R,A01,892721,Herbst; Matthew,14,0,30,16
1746608886326,MMW 11R,A02,892722,Herbst; Matthew,0,0,0,3
1746608887353,MMW 12R,A01,892724,Herbst; Matthew,0,11,16,16
1746608887353,MMW 12R,A02,892725,Herbst; Matthew,0,10,16,16
1746608888379,MMW 13R,A01,892727,Staff,0,4,16,16
1746608888379,MMW 13R,A02,892728,Staff,0,4,16,16
1746608888379,MMW 13R,A03,958032,Staff,0,4,16,16
1746608888379,MMW 13R,A04,958033,Staff,0,4,16,16
1746608888379,MMW 13R,A05,958034,Staff,0,4,16,16
1746608889406,SIO 295LS,A00,894015,Staff,5,0,25,20
1746608890432,SIO 295S,A00,894020,Staff,5,0,25,20
1746608891463,SIOC 290S,B01,958918,Merrifield; Mark A,14,0,30,16
1746608892488,SIOC 291S,B01,958922,Gabriel; Corey John,14,0,30,16
1746608893515,SOCI 117,A01,895339,Staff,2,0,5,3
1746608894542,WES 237B,A00,894149,Staff,11,0,20,9
1746608896602,AESE 279B,A00,891859,Staff,13,0,35,22
1746608897630,AIP 197,001,891854,Vespa; Emanuel Ignacio,9999,0,9999,0
1746608898658,ANTH 289S,A00,891856,Gagneux; Pascal,12,0,12,0
1746608899682,BENG 196,001,957946,Engler; Adam J.,9996,0,9999,3
1746608900709,BISP 197,001,959851,Wilhelm; James E.,9998,0,9999,1
1746608901734,CAT 124RS,A01,956906,Staff,6,0,25,19
1746608902758,CAT 125RS,A01,922013,Staff,6,0,25,19
1746608903787,CLRE 250,A00,891860,Morris; Sheldon,9995,0,9999,4
1746608905840,CLRE 251R,A00,907817,Mehta; Ravindra L.,9994,0,9999,5
1746608906866,CLRE 252,A00,891864,Cuomo; Raphael Eduardo,9993,0,9999,6
1746608907894,CLRE 253,A00,891867,Vaida; Florin,9994,0,9999,5
1746608907894,CLRE 253,B00,907819,Staff,9999,0,9999,0
1746608908923,CLRE 259,A00,891868,Patel; Hemal,9998,0,9999,1
1746608909948,CLRE 260,A00,891872,Cuomo; Raphael Eduardo,9999,0,9999,0
1746608910975,CLRE 297,001,891888,Cuomo; Raphael Eduardo,9999,0,9999,0
1746608912002,CSE 191,A00,958773,Minnes Kemp; Mor Mia,9995,0,9999,4
1746608913027,CSE 197,001,959846,Minnes Kemp; Mor Mia,9990,0,9999,9
1746608914053,CSS 201S,A01,892054,Mignozzetti; Umberto,25,0,30,5
1746608915080,CSS 202S,A01,892056,Mignozzetti; Umberto,25,0,30,5
1746608916106,DSC 197,001,956898,Eldridge; Justin Matthew,9996,0,9999,3
1746608917134,DSC 297,001,958000,Mazumdar; Arya,9998,0,9999,1
1746608917134,DSC 297,002,959862,Wang; Yusu,9998,0,9999,1
1746608918162,EAP 100,A00,905686,Staff,9778,0,9999,221
1746608919190,ECE 45,A01,892618,Staff,0,0,65,65
1746608921241,ECE 111,A01,892719,Staff,6,0,65,59
1746608922269,ECE 197,001,957920,Mercier; Patrick Philip,9991,0,9999,8
1746608923300,ECON 178,A01,907814,Zhu; Ying,26,0,35,9
1746608924327,EDS 115,A00,895312,Staff,35,0,45,10
1746608925354,EDS 117,A01,895337,Staff,23,0,30,7
1746608926382,EDS 125,A00,895341,Jones; Gabrielle Anastasia,36,0,45,9
1746608927410,EDS 128A,A01,895459,Fargason; Sharon Gayle,44,0,45,1
1746608928439,EDS 128B,A01,895543,Pappas; Elizabeth,44,0,45,1
1746608929464,EDS 139,A00,897203,Pappas; Elizabeth,44,0,45,1
1746608929464,EDS 139,B00,897209,Fargason; Sharon Gayle,41,0,45,4
1746608930491,EDS 201,A00,895545,Staff,22,0,45,23
1746608931517,EDS 203,A01,895581,Halter; Christopher P.,22,0,45,23
1746608932544,EDS 204R,A01,895625,Heinzman; Erica M.,39,0,45,6
1746608932544,EDS 204R,B01,895693,Halter; Christopher P.,10,0,45,35
1746608933573,EDS 206R,A00,895694,Fargason; Sharon Gayle,1,0,30,29
1746608933573,EDS 206R,B00,895695,Choi; Bailey Miyeon,16,0,30,14
1746608934598,EDS 250,A00,895697,Hemans; Patricia Ann Benitez,22,0,45,23
1746608935623,EDS 281,A00,895701,Meyerott; Theresa Ann,1,0,15,14
1746608936649,EDS 284,A00,895736,Meyerott; Theresa Ann,1,0,15,14
1746608937675,EDS 286,A00,897210,Fine; Sarah,0,0,15,15
1746608938702,EDS 289C,A01,895770,Daly; Alan J.,1,0,15,14
1746608939729,EDS 290,A00,897211,Hofstetter; Carolyn,0,0,15,15
1746608940759,LIGM 5A,A00,896162,Fischer-Grunski; Eva K,12,0,20,8
1746608941784,LIGM 5B,A00,896260,Fischer-Grunski; Eva K,17,0,20,3
1746608942811,LIGM 5C,A00,896308,Fischer-Grunski; Eva K,18,0,20,2
1746608943841,LIIT 5AS,A00,896313,Carnelos; Chiara,18,0,20,2
1746608944866,LIIT 5BS,A00,896416,Carnelos; Chiara,20,0,20,0
1746608945894,LIIT 5CS,A00,896564,Carnelos; Chiara,20,0,20,0
1746608946922,LISP 5A,A00,896588,Munoz Sanchez; Alicia,2,0,20,18
1746608947948,LISP 5B,A00,896653,Munoz Sanchez; Alicia,7,0,20,13
1746608948982,LISP 5C,A00,896655,Munoz Sanchez; Alicia,0,1,20,20
1746608950008,MAE 197,001,957918,Kleissl; Jan,9996,0,9999,3
1746608950008,MAE 197,002,959806,Boechler; Nicholas Sebastia,9998,0,9999,1
1746608950008,MAE 197,003,959852,Mullin; Jennifer S,9998,0,9999,1
1746608951038,MATH 2,A01,957937,Staff,33,0,35,2
1746608952064,MATH 197,001,957876,Kedlaya; Kiran S.,9993,0,9999,6
1746608953092,MCWP 40,A00,892729,Duru; Nur,10,0,20,10
1746608953092,MCWP 40,B00,893304,Montejo; Carolina,14,0,20,6
1746608954117,MCWP 40R,A00,893757,Redela; Pamela Morgan,0,5,20,20
1746608955142,MCWP 50,A00,893758,Morshed; Michael James,0,0,20,20
1746608955142,MCWP 50,B00,893761,Bartulis; Jason Michael,16,0,20,4
1746608956169,MCWP 50R,A00,893766,Compas; Sean Matthew,0,1,20,20
1746608956169,MCWP 50R,B00,893769,Carter; Jennifer A,0,1,20,20
1746608956169,MCWP 50R,C00,893771,Krone; Jarret,0,3,20,20
1746608956169,MCWP 50R,D00,893772,Miller; Elizabeth Deen,0,0,20,20
1746608956169,MCWP 50R,E00,893775,Carter; Andrea L,0,1,20,20
1746608957196,MMW 11R,A01,892721,Herbst; Matthew,14,0,30,16
1746608957196,MMW 11R,A02,892722,Herbst; Matthew,0,0,0,3
1746608958223,MMW 12R,A01,892724,Herbst; Matthew,0,11,16,16
1746608958223,MMW 12R,A02,892725,Herbst; Matthew,0,10,16,16
1746608959251,MMW 13R,A01,892727,Staff,0,4,16,16
1746608959251,MMW 13R,A02,892728,Staff,0,4,16,16
1746608959251,MMW 13R,A03,958032,Staff,0,4,16,16
1746608959251,MMW 13R,A04,958033,Staff,0,4,16,16
1746608959251,MMW 13R,A05,958034,Staff,0,4,16,16
1746608960279,SIO 295LS,A00,894015,Staff,5,0,25,20
1746608961305,SIO 295S,A00,894020,Staff,5,0,25,20
1746608962330,SIOC 290S,B01,958918,Merrifield; Mark A,14,0,30,16
1746608963361,SIOC 291S,B01,958922,Gabriel; Corey John,14,0,30,16
1746608964395,SOCI 117,A01,895339,Staff,2,0,5,3
1746608965420,WES 237B,A00,894149,Staff,11,0,20,9
1746608967485,AESE 279B,A00,891859,Staff,13,0,35,22
1746608968513,AIP 197,001,891854,Vespa; Emanuel Ignacio,9999,0,9999,0
1746608969538,ANTH 289S,A00,891856,Gagneux; Pascal,12,0,12,0
1746608970564,BENG 196,001,957946,Engler; Adam J.,9996,0,9999,3
1746608971593,BISP 197,001,959851,Wilhelm; James E.,9998,0,9999,1
1746608972623,CAT 124RS,A01,956906,Staff,6,0,25,19
1746608973649,CAT 125RS,A01,922013,Staff,6,0,25,19
1746608974675,CLRE 250,A00,891860,Morris; Sheldon,9995,0,9999,4
1746608976733,CLRE 251R,A00,907817,Mehta; Ravindra L.,9994,0,9999,5
1746608977802,CLRE 252,A00,891864,Cuomo; Raphael Eduardo,9993,0,9999,6
1746608978829,CLRE 253,A00,891867,Vaida; Florin,9994,0,9999,5
1746608978829,CLRE 253,B00,907819,Staff,9999,0,9999,0
1746608979855,CLRE 259,A00,891868,Patel; Hemal,9998,0,9999,1
1746608980881,CLRE 260,A00,891872,Cuomo; Raphael Eduardo,9999,0,9999,0
1746608981908,CLRE 297,001,891888,Cuomo; Raphael Eduardo,9999,0,9999,0
1746608982936,CSE 191,A00,958773,Minnes Kemp; Mor Mia,9995,0,9999,4
1746608983965,CSE 197,001,959846,Minnes Kemp; Mor Mia,9990,0,9999,9
1746608984997,CSS 201S,A01,892054,Mignozzetti; Umberto,25,0,30,5
1746608986022,CSS 202S,A01,892056,Mignozzetti; Umberto,25,0,30,5
1746608987049,DSC 197,001,956898,Eldridge; Justin Matthew,9996,0,9999,3
1746608988075,DSC 297,001,958000,Mazumdar; Arya,9998,0,9999,1
1746608988075,DSC 297,002,959862,Wang; Yusu,9998,0,9999,1
1746608989101,EAP 100,A00,905686,Staff,9778,0,9999,221
1746608990130,ECE 45,A01,892618,Staff,0,0,65,65
1746608992183,ECE 111,A01,892719,Staff,6,0,65,59
1746608993211,ECE 197,001,957920,Mercier; Patrick Philip,9991,0,9999,8
1746608994241,ECON 178,A01,907814,Zhu; Ying,26,0,35,9
1746608995267,EDS 115,A00,895312,Staff,35,0,45,10
1746608996295,EDS 117,A01,895337,Staff,23,0,30,7
1746608997322,EDS 125,A00,895341,Jones; Gabrielle Anastasia,36,0,45,9
1746608998349,EDS 128A,A01,895459,Fargason; Sharon Gayle,44,0,45,1
1746608999377,EDS 128B,A01,895543,Pappas; Elizabeth,44,0,45,1
1746609000408,EDS 139,A00,897203,Pappas; Elizabeth,44,0,45,1
1746609000408,EDS 139,B00,897209,Fargason; Sharon Gayle,41,0,45,4
1746609001432,EDS 201,A00,895545,Staff,22,0,45,23
1746609002461,EDS 203,A01,895581,Halter; Christopher P.,22,0,45,23
1746609003486,EDS 204R,A01,895625,Heinzman; Erica M.,39,0,45,6
1746609003486,EDS 204R,B01,895693,Halter; Christopher P.,10,0,45,35
1746609004512,EDS 206R,A00,895694,Fargason; Sharon Gayle,1,0,30,29
1746609004512,EDS 206R,B00,895695,Choi; Bailey Miyeon,16,0,30,14
1746609005539,EDS 250,A00,895697,Hemans; Patricia Ann Benitez,22,0,45,23
1746609006565,EDS 281,A00,895701,Meyerott; Theresa Ann,1,0,15,14
1746609007595,EDS 284,A00,895736,Meyerott; Theresa Ann,1,0,15,14
1746609008623,EDS 286,A00,897210,Fine; Sarah,0,0,15,15
1746609009647,EDS 289C,A01,895770,Daly; Alan J.,1,0,15,14
1746609010672,EDS 290,A00,897211,Hofstetter; Carolyn,0,0,15,15
1746609011704,LIGM 5A,A00,896162,Fischer-Grunski; Eva K,12,0,20,8
1746609012733,LIGM 5B,A00,896260,Fischer-Grunski; Eva K,17,0,20,3
1746609013759,LIGM 5C,A00,896308,Fischer-Grunski; Eva K,18,0,20,2
1746609014789,LIIT 5AS,A00,896313,Carnelos; Chiara,18,0,20,2
1746609015817,LIIT 5BS,A00,896416,Carnelos; Chiara,20,0,20,0
1746609016846,LIIT 5CS,A00,896564,Carnelos; Chiara,20,0,20,0
1746609017873,LISP 5A,A00,896588,Munoz Sanchez; Alicia,2,0,20,18
1746609018901,LISP 5B,A00,896653,Munoz Sanchez; Alicia,7,0,20,13
1746609019926,LISP 5C,A00,896655,Munoz Sanchez; Alicia,0,1,20,20
1746609020955,MAE 197,001,957918,Kleissl; Jan,9996,0,9999,3
1746609020955,MAE 197,002,959806,Boechler; Nicholas Sebastia,9998,0,9999,1
1746609020955,MAE 197,003,959852,Mullin; Jennifer S,9998,0,9999,1
1746609021984,MATH 2,A01,957937,Staff,33,0,35,2
1746609023010,MATH 197,001,957876,Kedlaya; Kiran S.,9993,0,9999,6
1746609024041,MCWP 40,A00,892729,Duru; Nur,10,0,20,10
1746609024041,MCWP 40,B00,893304,Montejo; Carolina,14,0,20,6
1746609025073,MCWP 40R,A00,893757,Redela; Pamela Morgan,0,5,20,20
1746609026106,MCWP 50,A00,893758,Morshed; Michael James,0,0,20,20
1746609026106,MCWP 50,B00,893761,Bartulis; Jason Michael,16,0,20,4
1746609027137,MCWP 50R,A00,893766,Compas; Sean Matthew,0,1,20,20
1746609027137,MCWP 50R,B00,893769,Carter; Jennifer A,0,1,20,20
1746609027137,MCWP 50R,C00,893771,Krone; Jarret,0,3,20,20
1746609027137,MCWP 50R,D00,893772,Miller; Elizabeth Deen,0,0,20,20
1746609027137,MCWP 50R,E00,893775,Carter; Andrea L,0,1,20,20
1746609028163,MMW 11R,A01,892721,Herbst; Matthew,14,0,30,16
1746609028163,MMW 11R,A02,892722,Herbst; Matthew,0,0,0,3
1746609029189,MMW 12R,A01,892724,Herbst; Matthew,0,11,16,16
1746609029189,MMW 12R,A02,892725,Herbst; Matthew,0,10,16,16
1746609030219,MMW 13R,A01,892727,Staff,0,4,16,16
1746609030219,MMW 13R,A02,892728,Staff,0,4,16,16
1746609030219,MMW 13R,A03,958032,Staff,0,4,16,16
1746609030219,MMW 13R,A04,958033,Staff,0,4,16,16
1746609030219,MMW 13R,A05,958034,Staff,0,4,16,16
1746609031244,SIO 295LS,A00,894015,Staff,5,0,25,20
1746609032271,SIO 295S,A00,894020,Staff,5,0,25,20
1746609033301,SIOC 290S,B01,958918,Merrifield; Mark A,14,0,30,16
1746609034329,SIOC 291S,B01,958922,Gabriel; Corey John,14,0,30,16
1746609035355,SOCI 117,A01,895339,Staff,2,0,5,3
1746609036383,WES 237B,A00,894149,Staff,11,0,20,9
1746609038460,AESE 279B,A00,891859,Staff,13,0,35,22
1746609039486,AIP 197,001,891854,Vespa; Emanuel Ignacio,9999,0,9999,0
1746609040511,ANTH 289S,A00,891856,Gagneux; Pascal,12,0,12,0
1746609041537,BENG 196,001,957946,Engler; Adam J.,9996,0,9999,3
1746609042562,BISP 197,001,959851,Wilhelm; James E.,9998,0,9999,1
1746609043588,CAT 124RS,A01,956906,Staff,6,0,25,19
1746609044617,CAT 125RS,A01,922013,Staff,6,0,25,19
1746609045645,CLRE 250,A00,891860,Morris; Sheldon,9995,0,9999,4
1746609047702,CLRE 251R,A00,907817,Mehta; Ravindra L.,9994,0,9999,5
1746609048728,CLRE 252,A00,891864,Cuomo; Raphael Eduardo,9993,0,9999,6
1746609049754,CLRE 253,A00,891867,Vaida; Florin,9994,0,9999,5
1746609049754,CLRE 253,B00,907819,Staff,9999,0,9999,0
1746609050783,CLRE 259,A00,891868,Patel; Hemal,9998,0,9999,1
1746609051808,CLRE 260,A00,891872,Cuomo; Raphael Eduardo,9999,0,9999,0
1746609052835,CLRE 297,001,891888,Cuomo; Raphael Eduardo,9999,0,9999,0
1746609053864,CSE 191,A00,958773,Minnes Kemp; Mor Mia,9995,0,9999,4
1746609054893,CSE 197,001,959846,Minnes Kemp; Mor Mia,9990,0,9999,9
1746609055925,CSS 201S,A01,892054,Mignozzetti; Umberto,25,0,30,5
1746609056953,CSS 202S,A01,892056,Mignozzetti; Umberto,25,0,30,5
1746609057981,DSC 197,001,956898,Eldridge; Justin Matthew,9996,0,9999,3
1746609059010,DSC 297,001,958000,Mazumdar; Arya,9998,0,9999,1
1746609059010,DSC 297,002,959862,Wang; Yusu,9998,0,9999,1
1746609060036,EAP 100,A00,905686,Staff,9778,0,9999,221
1746609061062,ECE 45,A01,892618,Staff,0,0,65,65
1746609063125,ECE 111,A01,892719,Staff,6,0,65,59
1746609064152,ECE 197,001,957920,Mercier; Patrick Philip,9991,0,9999,8
1746609065178,ECON 178,A01,907814,Zhu; Ying,26,0,35,9
1746609066205,EDS 115,A00,895312,Staff,35,0,45,10
1746609067233,EDS 117,A01,895337,Staff,23,0,30,7
1746609068260,EDS 125,A00,895341,Jones; Gabrielle Anastasia,36,0,45,9
1746609069289,EDS 128A,A01,895459,Fargason; Sharon Gayle,44,0,45,1
1746609070319,EDS 128B,A01,895543,Pappas; Elizabeth,44,0,45,1
1746609071346,EDS 139,A00,897203,Pappas; Elizabeth,44,0,45,1
1746609071346,EDS 139,B00,897209,Fargason; Sharon Gayle,41,0,45,4
1746609072372,EDS 201,A00,895545,Staff,22,0,45,23
1746609073399,EDS 203,A01,895581,Halter; Christopher P.,22,0,45,23
1746609074425,EDS 204R,A01,895625,Heinzman; Erica M.,39,0,45,6
1746609074425,EDS 204R,B01,895693,Halter; Christopher P.,10,0,45,35
1746609075452,EDS 206R,A00,895694,Fargason; Sharon Gayle,1,0,30,29
1746609075452,EDS 206R,B00,895695,Choi; Bailey Miyeon,16,0,30,14
1746609076479,EDS 250,A00,895697,Hemans; Patricia Ann Benitez,22,0,45,23
1746609077505,EDS 281,A00,895701,Meyerott; Theresa Ann,1,0,15,14
1746609078533,EDS 284,A00,895736,Meyerott; Theresa Ann,1,0,15,14
1746609079560,EDS 286,A00,897210,Fine; Sarah,0,0,15,15
1746609080585,EDS 289C,A01,895770,Daly; Alan J.,1,0,15,14
1746609081652,EDS 290,A00,897211,Hofstetter; Carolyn,0,0,15,15
1746609082677,LIGM 5A,A00,896162,Fischer-Grunski; Eva K,12,0,20,8
1746609083703,LIGM 5B,A00,896260,Fischer-Grunski; Eva K,17,0,20,3
1746609084730,LIGM 5C,A00,896308,Fischer-Grunski; Eva K,18,0,20,2
1746609085757,LIIT 5AS,A00,896313,Carnelos; Chiara,18,0,20,2
1746609086785,LIIT 5BS,A00,896416,Carnelos; Chiara,20,0,20,0
1746609087813,LIIT 5CS,A00,896564,Carnelos; Chiara,20,0,20,0
1746609088845,LISP 5A,A00,896588,Munoz Sanchez; Alicia,2,0,20,18
1746609089871,LISP 5B,A00,896653,Munoz Sanchez; Alicia,7,0,20,13
1746609090902,LISP 5C,A00,896655,Munoz Sanchez; Alicia,0,1,20,20
1746609091930,MAE 197,001,957918,Kleissl; Jan,9996,0,9999,3
1746609091930,MAE 197,002,959806,Boechler; Nicholas Sebastia,9998,0,9999,1
1746609091930,MAE 197,003,959852,Mullin; Jennifer S,9998,0,9999,1
1746609092957,MATH 2,A01,957937,Staff,33,0,35,2
1746609093984,MATH 197,001,957876,Kedlaya; Kiran S.,9993,0,9999,6
1746609095010,MCWP 40,A00,892729,Duru; Nur,10,0,20,10
1746609095010,MCWP 40,B00,893304,Montejo; Carolina,14,0,20,6
1746609096036,MCWP 40R,A00,893757,Redela; Pamela Morgan,0,5,20,20
1746609097062,MCWP 50,A00,893758,Morshed; Michael James,0,0,20,20
1746609097062,MCWP 50,B00,893761,Bartulis; Jason Michael,16,0,20,4
1746609098091,MCWP 50R,A00,893766,Compas; Sean Matthew,0,1,20,20
1746609098091,MCWP 50R,B00,893769,Carter; Jennifer A,0,1,20,20
1746609098091,MCWP 50R,C00,893771,Krone; Jarret,0,3,20,20
1746609098091,MCWP 50R,D00,893772,Miller; Elizabeth Deen,0,0,20,20
1746609098091,MCWP 50R,E00,893775,Carter; Andrea L,0,1,20,20
1746609099119,MMW 11R,A01,892721,Herbst; Matthew,14,0,30,16
1746609099119,MMW 11R,A02,892722,Herbst; Matthew,0,0,0,3
1746609100146,MMW 12R,A01,892724,Herbst; Matthew,0,11,16,16
1746609100146,MMW 12R,A02,892725,Herbst; Matthew,0,10,16,16
1746609101173,MMW 13R,A01,892727,Staff,0,4,16,16
1746609101173,MMW 13R,A02,892728,Staff,0,4,16,16
1746609101173,MMW 13R,A03,958032,Staff,0,4,16,16
1746609101173,MMW 13R,A04,958033,Staff,0,4,16,16
1746609101173,MMW 13R,A05,958034,Staff,0,4,16,16
1746609102204,SIO 295LS,A00,894015,Staff,5,0,25,20
1746609103232,SIO 295S,A00,894020,Staff,5,0,25,20
1746609104265,SIOC 290S,B01,958918,Merrifield; Mark A,14,0,30,16
1746609105290,SIOC 291S,B01,958922,Gabriel; Corey John,14,0,30,16
1746609106316,SOCI 117,A01,895339,Staff,2,0,5,3
1746609107340,WES 237B,A00,894149,Staff,11,0,20,9
1746609109403,AESE 279B,A00,891859,Staff,13,0,35,22
1746609110433,AIP 197,001,891854,Vespa; Emanuel Ignacio,9999,0,9999,0
1746609111462,ANTH 289S,A00,891856,Gagneux; Pascal,12,0,12,0
1746609112488,BENG 196,001,957946,Engler; Adam J.,9996,0,9999,3
1746609113515,BISP 197,001,959851,Wilhelm; James E.,9998,0,9999,1
1746609114544,CAT 124RS,A01,956906,Staff,6,0,25,19
1746609115570,CAT 125RS,A01,922013,Staff,6,0,25,19
1746609116597,CLRE 250,A00,891860,Morris; Sheldon,9995,0,9999,4
1746609118655,CLRE 251R,A00,907817,Mehta; Ravindra L.,9994,0,9999,5
1746609119684,CLRE 252,A00,891864,Cuomo; Raphael Eduardo,9993,0,9999,6
1746609120711,CLRE 253,A00,891867,Vaida; Florin,9994,0,9999,5
1746609120711,CLRE 253,B00,907819,Staff,9999,0,9999,0
1746609121737,CLRE 259,A00,891868,Patel; Hemal,9998,0,9999,1
1746609122763,CLRE 260,A00,891872,Cuomo; Raphael Eduardo,9999,0,9999,0
1746609123790,CLRE 297,001,891888,Cuomo; Raphael Eduardo,9999,0,9999,0
1746609124818,CSE 191,A00,958773,Minnes Kemp; Mor Mia,9995,0,9999,4
1746609125846,CSE 197,001,959846,Minnes Kemp; Mor Mia,9990,0,9999,9
1746609126872,CSS 201S,A01,892054,Mignozzetti; Umberto,25,0,30,5
1746609127897,CSS 202S,A01,892056,Mignozzetti; Umberto,25,0,30,5
1746609128923,DSC 197,001,956898,Eldridge; Justin Matthew,9996,0,9999,3
1746609129948,DSC 297,001,958000,Mazumdar; Arya,9998,0,9999,1
1746609129948,DSC 297,002,959862,Wang; Yusu,9998,0,9999,1
1746609130975,EAP 100,A00,905686,Staff,9778,0,9999,221
1746609132002,ECE 45,A01,892618,Staff,0,0,65,65
1746609134054,ECE 111,A01,892719,Staff,6,0,65,59
1746609135079,ECE 197,001,957920,Mercier; Patrick Philip,9991,0,9999,8
1746609136105,ECON 178,A01,907814,Zhu; Ying,26,0,35,9
1746609137133,EDS 115,A00,895312,Staff,35,0,45,10
1746609138158,EDS 117,A01,895337,Staff,23,0,30,7
1746609139184,EDS 125,A00,895341,Jones; Gabrielle Anastasia,36,0,45,9
1746609140210,EDS 128A,A01,895459,Fargason; Sharon Gayle,44,0,45,1
1746609141238,EDS 128B,A01,895543,Pappas; Elizabeth,44,0,45,1
1746609142265,EDS 139,A00,897203,Pappas; Elizabeth,44,0,45,1
1746609142265,EDS 139,B00,897209,Fargason; Sharon Gayle,41,0,45,4
1746609143291,EDS 201,A00,895545,Staff,22,0,45,23
1746609144322,EDS 203,A01,895581,Halter; Christopher P.,22,0,45,23
1746609145347,EDS 204R,A01,895625,Heinzman; Erica M.,39,0,45,6
1746609145347,EDS 204R,B01,895693,Halter; Christopher P.,10,0,45,35
1746609146372,EDS 206R,A00,895694,Fargason; Sharon Gayle,1,0,30,29
1746609146372,EDS 206R,B00,895695,Choi; Bailey Miyeon,16,0,30,14
1746609147405,EDS 250,A00,895697,Hemans; Patricia Ann Benitez,22,0,45,23
1746609148433,EDS 281,A00,895701,Meyerott; Theresa Ann,1,0,15,14
1746609149460,EDS 284,A00,895736,Meyerott; Theresa Ann,1,0,15,14
1746609150484,EDS 286,A00,897210,Fine; Sarah,0,0,15,15
1746609151510,EDS 289C,A01,895770,Daly; Alan J.,1,0,15,14
1746609152541,EDS 290,A00,897211,Hofstetter; Carolyn,0,0,15,15
1746609153570,LIGM 5A,A00,896162,Fischer-Grunski; Eva K,12,0,20,8
1746609154595,LIGM 5B,A00,896260,Fischer-Grunski; Eva K,17,0,20,3
1746609155624,LIGM 5C,A00,896308,Fischer-Grunski; Eva K,18,0,20,2
1746609156655,LIIT 5AS,A00,896313,Carnelos; Chiara,18,0,20,2
1746609157683,LIIT 5BS,A00,896416,Carnelos; Chiara,20,0,20,0
1746609158712,LIIT 5CS,A00,896564,Carnelos; Chiara,20,0,20,0
1746609159740,LISP 5A,A00,896588,Munoz Sanchez; Alicia,2,0,20,18
1746609160770,LISP 5B,A00,896653,Munoz Sanchez; Alicia,7,0,20,13
1746609161801,LISP 5C,A00,896655,Munoz Sanchez; Alicia,0,1,20,20
1746609162825,MAE 197,001,957918,Kleissl; Jan,9996,0,9999,3
1746609162825,MAE 197,002,959806,Boechler; Nicholas Sebastia,9998,0,9999,1
1746609162825,MAE 197,003,959852,Mullin; Jennifer S,9998,0,9999,1
1746609163850,MATH 2,A01,957937,Staff,33,0,35,2
1746609164882,MATH 197,001,957876,Kedlaya; Kiran S.,9993,0,9999,6
1746609165913,MCWP 40,A00,892729,Duru; Nur,10,0,20,10
1746609165913,MCWP 40,B00,893304,Montejo; Carolina,14,0,20,6
1746609166943,MCWP 40R,A00,893757,Redela; Pamela Morgan,0,5,20,20
1746609167968,MCWP 50,A00,893758,Morshed; Michael James,0,0,20,20
1746609167968,MCWP 50,B00,893761,Bartulis; Jason Michael,16,0,20,4
1746609169002,MCWP 50R,A00,893766,Compas; Sean Matthew,0,1,20,20
1746609169002,MCWP 50R,B00,893769,Carter; Jennifer A,0,1,20,20
1746609169002,MCWP 50R,C00,893771,Krone; Jarret,0,3,20,20
1746609169002,MCWP 50R,D00,893772,Miller; Elizabeth Deen,0,0,20,20
1746609169002,MCWP 50R,E00,893775,Carter; Andrea L,0,1,20,20
1746609170030,MMW 11R,A01,892721,Herbst; Matthew,14,0,30,16
1746609170030,MMW 11R,A02,892722,Herbst; Matthew,0,0,0,3
1746609171055,MMW 12R,A01,892724,Herbst; Matthew,0,11,16,16
1746609171055,MMW 12R,A02,892725,Herbst; Matthew,0,10,16,16
1746609172086,MMW 13R,A01,892727,Staff,0,4,16,16
1746609172086,MMW 13R,A02,892728,Staff,0,4,16,16
1746609172086,MMW 13R,A03,958032,Staff,0,4,16,16
1746609172086,MMW 13R,A04,958033,Staff,0,4,16,16
1746609172086,MMW 13R,A05,958034,Staff,0,4,16,16
1746609173116,SIO 295LS,A00,894015,Staff,5,0,25,20
1746609174147,SIO 295S,A00,894020,Staff,5,0,25,20
1746609175178,SIOC 290S,B01,958918,Merrifield; Mark A,14,0,30,16
1746609176210,SIOC 291S,B01,958922,Gabriel; Corey John,14,0,30,16
1746609177236,SOCI 117,A01,895339,Staff,2,0,5,3
1746609178263,WES 237B,A00,894149,Staff,11,0,20,9
1746609180334,AESE 279B,A00,891859,Staff,13,0,35,22
1746609181362,AIP 197,001,891854,Vespa; Emanuel Ignacio,9999,0,9999,0
1746609182403,ANTH 289S,A00,891856,Gagneux; Pascal,12,0,12,0
1746609183432,BENG 196,001,957946,Engler; Adam J.,9996,0,9999,3
1746609184459,BISP 197,001,959851,Wilhelm; James E.,9998,0,9999,1
1746609185487,CAT 124RS,A01,956906,Staff,6,0,25,19
1746609186515,CAT 125RS,A01,922013,Staff,6,0,25,19
1746609187544,CLRE 250,A00,891860,Morris; Sheldon,9995,0,9999,4
1746609189596,CLRE 251R,A00,907817,Mehta; Ravindra L.,9994,0,9999,5
1746609190625,CLRE 252,A00,891864,Cuomo; Raphael Eduardo,9993,0,9999,6
1746609191651,CLRE 253,A00,891867,Vaida; Florin,9994,0,9999,5
1746609191651,CLRE 253,B00,907819,Staff,9999,0,9999,0
1746609192678,CLRE 259,A00,891868,Patel; Hemal,9998,0,9999,1
1746609193707,CLRE 260,A00,891872,Cuomo; Raphael Eduardo,9999,0,9999,0
1746609194737,CLRE 297,001,891888,Cuomo; Raphael Eduardo,9999,0,9999,0
1746609195766,CSE 191,A00,958773,Minnes Kemp; Mor Mia,9995,0,9999,4
1746609196793,CSE 197,001,959846,Minnes Kemp; Mor Mia,9990,0,9999,9
1746609197821,CSS 201S,A01,892054,Mignozzetti; Umberto,25,0,30,5
1746609198851,CSS 202S,A01,892056,Mignozzetti; Umberto,25,0,30,5
1746609199878,DSC 197,001,956898,Eldridge; Justin Matthew,9996,0,9999,3
1746609200903,DSC 297,001,958000,Mazumdar; Arya,9998,0,9999,1
1746609200903,DSC 297,002,959862,Wang; Yusu,9998,0,9999,1
1746609201931,EAP 100,A00,905686,Staff,9778,0,9999,221
1746609202961,ECE 45,A01,892618,Staff,0,0,65,65
1746609205022,ECE 111,A01,892719,Staff,6,0,65,59
1746609206048,ECE 197,001,957920,Mercier; Patrick Philip,9991,0,9999,8
1746609207074,ECON 178,A01,907814,Zhu; Ying,26,0,35,9
1746609208100,EDS 115,A00,895312,Staff,35,0,45,10
1746609209128,EDS 117,A01,895337,Staff,23,0,30,7
1746609210154,EDS 125,A00,895341,Jones; Gabrielle Anastasia,36,0,45,9
1746609211179,EDS 128A,A01,895459,Fargason; Sharon Gayle,44,0,45,1
1746609212205,EDS 128B,A01,895543,Pappas; Elizabeth,44,0,45,1
1746609213231,EDS 139,A00,897203,Pappas; Elizabeth,44,0,45,1
1746609213231,EDS 139,B00,897209,Fargason; Sharon Gayle,41,0,45,4
1746609214258,EDS 201,A00,895545,Staff,22,0,45,23
1746609215287,EDS 203,A01,895581,Halter; Christopher P.,22,0,45,23
1746609216313,EDS 204R,A01,895625,Heinzman; Erica M.,39,0,45,6
1746609216313,EDS 204R,B01,895693,Halter; Christopher P.,10,0,45,35
1746609217340,EDS 206R,A00,895694,Fargason; Sharon Gayle,1,0,30,29
1746609217340,EDS 206R,B00,895695,Choi; Bailey Miyeon,16,0,30,14
1746609218369,EDS 250,A00,895697,Hemans; Patricia Ann Benitez,22,0,45,23
1746609219395,EDS 281,A00,895701,Meyerott; Theresa Ann,1,0,15,14
1746609220422,EDS 284,A00,895736,Meyerott; Theresa Ann,1,0,15,14
1746609221451,EDS 286,A00,897210,Fine; Sarah,0,0,15,15
1746609222478,EDS 289C,A01,895770,Daly; Alan J.,1,0,15,14
1746609223508,EDS 290,A00,897211,Hofstetter; Carolyn,0,0,15,15
1746609224537,LIGM 5A,A00,896162,Fischer-Grunski; Eva K,12,0,20,8
1746609225565,LIGM 5B,A00,896260,Fischer-Grunski; Eva K,17,0,20,3
1746609226596,LIGM 5C,A00,896308,Fischer-Grunski; Eva K,18,0,20,2
1746609227624,LIIT 5AS,A00,896313,Carnelos; Chiara,18,0,20,2
1746609228652,LIIT 5BS,A00,896416,Carnelos; Chiara,20,0,20,0
1746609229676,LIIT 5CS,A00,896564,Carnelos; Chiara,20,0,20,0
1746609230704,LISP 5A,A00,896588,Munoz Sanchez; Alicia,2,0,20,18
1746609231733,LISP 5B,A00,896653,Munoz Sanchez; Alicia,7,0,20,13
1746609232760,LISP 5C,A00,896655,Munoz Sanchez; Alicia,0,1,20,20
1746609233790,MAE 197,001,957918,Kleissl; Jan,9996,0,9999,3
1746609233790,MAE 197,002,959806,Boechler; Nicholas Sebastia,9998,0,9999,1
1746609233790,MAE 197,003,959852,Mullin; Jennifer S,9998,0,9999,1
1746609234814,MATH 2,A01,957937,Staff,33,0,35,2
1746609235841,MATH 197,001,957876,Kedlaya; Kiran S.,9993,0,9999,6
1746609236872,MCWP 40,A00,892729,Duru; Nur,10,0,20,10
1746609236872,MCWP 40,B00,893304,Montejo; Carolina,14,0,20,6
1746609237900,MCWP 40R,A00,893757,Redela; Pamela Morgan,0,5,20,20
1746609238927,MCWP 50,A00,893758,Morshed; Michael James,0,0,20,20
1746609238927,MCWP 50,B00,893761,Bartulis; Jason Michael,16,0,20,4
1746609239959,MCWP 50R,A00,893766,Compas; Sean Matthew,0,1,20,20
1746609239959,MCWP 50R,B00,893769,Carter; Jennifer A,0,1,20,20
1746609239959,MCWP 50R,C00,893771,Krone; Jarret,0,3,20,20
1746609239959,MCWP 50R,D00,893772,Miller; Elizabeth Deen,0,0,20,20
1746609239959,MCWP 50R,E00,893775,Carter; Andrea L,0,1,20,20
1746609240984,MMW 11R,A01,892721,Herbst; Matthew,14,0,30,16
1746609240984,MMW 11R,A02,892722,Herbst; Matthew,0,0,0,3
1746609242009,MMW 12R,A01,892724,Herbst; Matthew,0,11,16,16
1746609242009,MMW 12R,A02,892725,Herbst; Matthew,0,10,16,16
1746609243037,MMW 13R,A01,892727,Staff,0,4,16,16
1746609243037,MMW 13R,A02,892728,Staff,0,4,16,16
1746609243037,MMW 13R,A03,958032,Staff,0,4,16,16
1746609243037,MMW 13R,A04,958033,Staff,0,4,16,16
1746609243037,MMW 13R,A05,958034,Staff,0,4,16,16
1746609244064,SIO 295LS,A00,894015,Staff,5,0,25,20
1746609245101,SIO 295S,A00,894020,Staff,5,0,25,20
1746609246127,SIOC 290S,B01,958918,Merrifield; Mark A,14,0,30,16
1746609247158,SIOC 291S,B01,958922,Gabriel; Corey John,14,0,30,16
1746609248205,SOCI 117,A01,895339,Staff,2,0,5,3
1746609249230,WES 237B,A00,894149,Staff,11,0,20,9
1746609251311,AESE 279B,A00,891859,Staff,13,0,35,22
1746609252337,AIP 197,001,891854,Vespa; Emanuel Ignacio,9999,0,9999,0
1746609253365,ANTH 289S,A00,891856,Gagneux; Pascal,12,0,12,0
1746609254389,BENG 196,001,957946,Engler; Adam J.,9996,0,9999,3
1746609255415,BISP 197,001,959851,Wilhelm; James E.,9998,0,9999,1
1746609256440,CAT 124RS,A01,956906,Staff,6,0,25,19
1746609257467,CAT 125RS,A01,922013,Staff,6,0,25,19
1746609258493,CLRE 250,A00,891860,Morris; Sheldon,9995,0,9999,4
1746609260547,CLRE 251R,A00,907817,Mehta; Ravindra L.,9994,0,9999,5
1746609261575,CLRE 252,A00,891864,Cuomo; Raphael Eduardo,9993,0,9999,6
1746609262600,CLRE 253,A00,891867,Vaida; Florin,9994,0,9999,5
1746609262600,CLRE 253,B00,907819,Staff,9999,0,9999,0
1746609263626,CLRE 259,A00,891868,Patel; Hemal,9998,0,9999,1
1746609264652,CLRE 260,A00,891872,Cuomo; Raphael Eduardo,9999,0,9999,0
1746609265682,CLRE 297,001,891888,Cuomo; Raphael Eduardo,9999,0,9999,0
1746609266709,CSE 191,A00,958773,Minnes Kemp; Mor Mia,9995,0,9999,4
1746609267734,CSE 197,001,959846,Minnes Kemp; Mor Mia,9990,0,9999,9
1746609268760,CSS 201S,A01,892054,Mignozzetti; Umberto,25,0,30,5
1746609269790,CSS 202S,A01,892056,Mignozzetti; Umberto,25,0,30,5
1746609270817,DSC 197,001,956898,Eldridge; Justin Matthew,9996,0,9999,3
1746609271842,DSC 297,001,958000,Mazumdar; Arya,9998,0,9999,1
1746609271842,DSC 297,002,959862,Wang; Yusu,9998,0,9999,1
1746609272870,EAP 100,A00,905686,Staff,9778,0,9999,221
1746609273900,ECE 45,A01,892618,Staff,0,0,65,65
1746609275954,ECE 111,A01,892719,Staff,6,0,65,59
1746609276984,ECE 197,001,957920,Mercier; Patrick Philip,9991,0,9999,8
1746609278012,ECON 178,A01,907814,Zhu; Ying,26,0,35,9
1746609279037,EDS 115,A00,895312,Staff,35,0,45,10
1746609280065,EDS 117,A01,895337,Staff,23,0,30,7
1746609281092,EDS 125,A00,895341,Jones; Gabrielle Anastasia,36,0,45,9
1746609282118,EDS 128A,A01,895459,Fargason; Sharon Gayle,44,0,45,1
1746609283146,EDS 128B,A01,895543,Pappas; Elizabeth,44,0,45,1
1746609284172,EDS 139,A00,897203,Pappas; Elizabeth,44,0,45,1
1746609284172,EDS 139,B00,897209,Fargason; Sharon Gayle,41,0,45,4
1746609285200,EDS 201,A00,895545,Staff,22,0,45,23
1746609286228,EDS 203,A01,895581,Halter; Christopher P.,22,0,45,23
1746609287254,EDS 204R,A01,895625,Heinzman; Erica M.,39,0,45,6
1746609287254,EDS 204R,B01,895693,Halter; Christopher P.,10,0,45,35
1746609288283,EDS 206R,A00,895694,Fargason; Sharon Gayle,1,0,30,29
1746609288283,EDS 206R,B00,895695,Choi; Bailey Miyeon,16,0,30,14
1746609289307,EDS 250,A00,895697,Hemans; Patricia Ann Benitez,22,0,45,23
1746609290333,EDS 281,A00,895701,Meyerott; Theresa Ann,1,0,15,14
1746609291361,EDS 284,A00,895736,Meyerott; Theresa Ann,1,0,15,14
1746609292386,EDS 286,A00,897210,Fine; Sarah,0,0,15,15
1746609293415,EDS 289C,A01,895770,Daly; Alan J.,1,0,15,14
1746609294443,EDS 290,A00,897211,Hofstetter; Carolyn,0,0,15,15
1746609295473,LIGM 5A,A00,896162,Fischer-Grunski; Eva K,12,0,20,8
1746609296500,LIGM 5B,A00,896260,Fischer-Grunski; Eva K,17,0,20,3
1746609297533,LIGM 5C,A00,896308,Fischer-Grunski; Eva K,18,0,20,2
1746609298562,LIIT 5AS,A00,896313,Carnelos; Chiara,18,0,20,2
1746609299592,LIIT 5BS,A00,896416,Carnelos; Chiara,20,0,20,0
1746609300623,LIIT 5CS,A00,896564,Carnelos; Chiara,20,0,20,0
1746609301649,LISP 5A,A00,896588,Munoz Sanchez; Alicia,2,0,20,18
1746609302675,LISP 5B,A00,896653,Munoz Sanchez; Alicia,7,0,20,13
1746609303705,LISP 5C,A00,896655,Munoz Sanchez; Alicia,0,1,20,20
1746609304736,MAE 197,001,957918,Kleissl; Jan,9996,0,9999,3
1746609304736,MAE 197,002,959806,Boechler; Nicholas Sebastia,9998,0,9999,1
1746609304736,MAE 197,003,959852,Mullin; Jennifer S,9998,0,9999,1
1746609305803,MATH 2,A01,957937,Staff,33,0,35,2
1746609306830,MATH 197,001,957876,Kedlaya; Kiran S.,9993,0,9999,6
1746609307855,MCWP 40,A00,892729,Duru; Nur,10,0,20,10
1746609307855,MCWP 40,B00,893304,Montejo; Carolina,14,0,20,6
1746609308884,MCWP 40R,A00,893757,Redela; Pamela Morgan,0,5,20,20
1746609309911,MCWP 50,A00,893758,Morshed; Michael James,0,0,20,20
1746609309911,MCWP 50,B00,893761,Bartulis; Jason Michael,16,0,20,4
1746609310936,MCWP 50R,A00,893766,Compas; Sean Matthew,0,1,20,20
1746609310936,MCWP 50R,B00,893769,Carter; Jennifer A,0,1,20,20
1746609310936,MCWP 50R,C00,893771,Krone; Jarret,0,3,20,20
1746609310936,MCWP 50R,D00,893772,Miller; Elizabeth Deen,0,0,20,20
1746609310936,MCWP 50R,E00,893775,Carter; Andrea L,0,1,20,20
1746609311966,MMW 11R,A01,892721,Herbst; Matthew,14,0,30,16
1746609311966,MMW 11R,A02,892722,Herbst; Matthew,0,0,0,3
1746609312993,MMW 12R,A01,892724,Herbst; Matthew,0,11,16,16
1746609312993,MMW 12R,A02,892725,Herbst; Matthew,0,10,16,16
1746609314018,MMW 13R,A01,892727,Staff,0,4,16,16
1746609314018,MMW 13R,A02,892728,Staff,0,4,16,16
1746609314018,MMW 13R,A03,958032,Staff,0,4,16,16
1746609314018,MMW 13R,A04,958033,Staff,0,4,16,16
1746609314018,MMW 13R,A05,958034,Staff,0,4,16,16
1746609315049,SIO 295LS,A00,894015,Staff,5,0,25,20
1746609316074,SIO 295S,A00,894020,Staff,5,0,25,20
1746609317105,SIOC 290S,B01,958918,Merrifield; Mark A,14,0,30,16
1746609318141,SIOC 291S,B01,958922,Gabriel; Corey John,14,0,30,16
1746609319170,SOCI 117,A01,895339,Staff,2,0,5,3
1746609320199,WES 237B,A00,894149,Staff,11,0,20,9
1746609322280,AESE 279B,A00,891859,Staff,13,0,35,22
1746609323309,AIP 197,001,891854,Vespa; Emanuel Ignacio,9999,0,9999,0
1746609324334,ANTH 289S,A00,891856,Gagneux; Pascal,12,0,12,0
1746609325359,BENG 196,001,957946,Engler; Adam J.,9996,0,9999,3
1746609326383,BISP 197,001,959851,Wilhelm; James E.,9998,0,9999,1
1746609327410,CAT 124RS,A01,956906,Staff,6,0,25,19
1746609328436,CAT 125RS,A01,922013,Staff,6,0,25,19
1746609329463,CLRE 250,A00,891860,Morris; Sheldon,9995,0,9999,4
1746609331515,CLRE 251R,A00,907817,Mehta; Ravindra L.,9994,0,9999,5
1746609332542,CLRE 252,A00,891864,Cuomo; Raphael Eduardo,9993,0,9999,6
1746609333569,CLRE 253,A00,891867,Vaida; Florin,9994,0,9999,5
1746609333569,CLRE 253,B00,907819,Staff,9999,0,9999,0
1746609334595,CLRE 259,A00,891868,Patel; Hemal,9998,0,9999,1
1746609335624,CLRE 260,A00,891872,Cuomo; Raphael Eduardo,9999,0,9999,0
1746609336650,CLRE 297,001,891888,Cuomo; Raphael Eduardo,9999,0,9999,0
1746609337680,CSE 191,A00,958773,Minnes Kemp; Mor Mia,9995,0,9999,4
1746609338708,CSE 197,001,959846,Minnes Kemp; Mor Mia,9990,0,9999,9
1746609339733,CSS 201S,A01,892054,Mignozzetti; Umberto,25,0,30,5
1746609340764,CSS 202S,A01,892056,Mignozzetti; Umberto,25,0,30,5
1746609341791,DSC 197,001,956898,Eldridge; Justin Matthew,9996,0,9999,3
1746609342818,DSC 297,001,958000,Mazumdar; Arya,9998,0,9999,1
1746609342818,DSC 297,002,959862,Wang; Yusu,9998,0,9999,1
1746609343845,EAP 100,A00,905686,Staff,9778,0,9999,221
1746609344873,ECE 45,A01,892618,Staff,0,0,65,65
1746609346927,ECE 111,A01,892719,Staff,6,0,65,59
1746609347954,ECE 197,001,957920,Mercier; Patrick Philip,9991,0,9999,8
1746609348979,ECON 178,A01,907814,Zhu; Ying,26,0,35,9
1746609350009,EDS 115,A00,895312,Staff,35,0,45,10
1746609351037,EDS 117,A01,895337,Staff,23,0,30,7
1746609352063,EDS 125,A00,895341,Jones; Gabrielle Anastasia,36,0,45,9
1746609353090,EDS 128A,A01,895459,Fargason; Sharon Gayle,44,0,45,1
1746609354118,EDS 128B,A01,895543,Pappas; Elizabeth,44,0,45,1
1746609355145,EDS 139,A00,897203,Pappas; Elizabeth,44,0,45,1
1746609355145,EDS 139,B00,897209,Fargason; Sharon Gayle,41,0,45,4
1746609356175,EDS 201,A00,895545,Staff,22,0,45,23
1746609357217,EDS 203,A01,895581,Halter; Christopher P.,22,0,45,23
1746609358243,EDS 204R,A01,895625,Heinzman; Erica M.,39,0,45,6
1746609358243,EDS 204R,B01,895693,Halter; Christopher P.,10,0,45,35
1746609359274,EDS 206R,A00,895694,Fargason; Sharon Gayle,1,0,30,29
1746609359274,EDS 206R,B00,895695,Choi; Bailey Miyeon,16,0,30,14
1746609360302,EDS 250,A00,895697,Hemans; Patricia Ann Benitez,22,0,45,23
1746609361330,EDS 281,A00,895701,Meyerott; Theresa Ann,1,0,15,14
1746609362356,EDS 284,A00,895736,Meyerott; Theresa Ann,1,0,15,14
1746609363383,EDS 286,A00,897210,Fine; Sarah,0,0,15,15
1746609364409,EDS 289C,A01,895770,Daly; Alan J.,1,0,15,14
1746609365437,EDS 290,A00,897211,Hofstetter; Carolyn,0,0,15,15
1746609366462,LIGM 5A,A00,896162,Fischer-Grunski; Eva K,12,0,20,8
1746609367491,LIGM 5B,A00,896260,Fischer-Grunski; Eva K,17,0,20,3
1746609368519,LIGM 5C,A00,896308,Fischer-Grunski; Eva K,18,0,20,2
1746609369548,LIIT 5AS,A00,896313,Carnelos; Chiara,18,0,20,2
1746609370573,LIIT 5BS,A00,896416,Carnelos; Chiara,20,0,20,0
1746609371601,LIIT 5CS,A00,896564,Carnelos; Chiara,20,0,20,0
1746609372626,LISP 5A,A00,896588,Munoz Sanchez; Alicia,2,0,20,18
1746609373650,LISP 5B,A00,896653,Munoz Sanchez; Alicia,7,0,20,13
1746609374678,LISP 5C,A00,896655,Munoz Sanchez; Alicia,0,1,20,20
1746609375702,MAE 197,001,957918,Kleissl; Jan,9996,0,9999,3
1746609375702,MAE 197,002,959806,Boechler; Nicholas Sebastia,9998,0,9999,1
1746609375702,MAE 197,003,959852,Mullin; Jennifer S,9998,0,9999,1
1746609376729,MATH 2,A01,957937,Staff,33,0,35,2
1746609377757,MATH 197,001,957876,Kedlaya; Kiran S.,9993,0,9999,6
1746609378785,MCWP 40,A00,892729,Duru; Nur,10,0,20,10
1746609378785,MCWP 40,B00,893304,Montejo; Carolina,14,0,20,6
1746609379810,MCWP 40R,A00,893757,Redela; Pamela Morgan,0,5,20,20
1746609380834,MCWP 50,A00,893758,Morshed; Michael James,0,0,20,20
1746609380834,MCWP 50,B00,893761,Bartulis; Jason Michael,16,0,20,4
1746609381859,MCWP 50R,A00,893766,Compas; Sean Matthew,0,1,20,20
1746609381859,MCWP 50R,B00,893769,Carter; Jennifer A,0,1,20,20
1746609381859,MCWP 50R,C00,893771,Krone; Jarret,0,3,20,20
1746609381859,MCWP 50R,D00,893772,Miller; Elizabeth Deen,0,0,20,20
1746609381859,MCWP 50R,E00,893775,Carter; Andrea L,0,1,20,20
1746609382886,MMW 11R,A01,892721,Herbst; Matthew,14,0,30,16
1746609382886,MMW 11R,A02,892722,Herbst; Matthew,0,0,0,3
1746609383911,MMW 12R,A01,892724,Herbst; Matthew,0,11,16,16
1746609383911,MMW 12R,A02,892725,Herbst; Matthew,0,10,16,16
1746609384937,MMW 13R,A01,892727,Staff,0,4,16,16
1746609384937,MMW 13R,A02,892728,Staff,0,4,16,16
1746609384937,MMW 13R,A03,958032,Staff,0,4,16,16
1746609384937,MMW 13R,A04,958033,Staff,0,4,16,16
1746609384937,MMW 13R,A05,958034,Staff,0,4,16,16
1746609385967,SIO 295LS,A00,894015,Staff,5,0,25,20
1746609386995,SIO 295S,A00,894020,Staff,5,0,25,20
1746609388020,SIOC 290S,B01,958918,Merrifield; Mark A,14,0,30,16
1746609389046,SIOC 291S,B01,958922,Gabriel; Corey John,14,0,30,16
1746609390071,SOCI 117,A01,895339,Staff,2,0,5,3
1746609391099,WES 237B,A00,894149,Staff,11,0,20,9
1746609393174,AESE 279B,A00,891859,Staff,13,0,35,22
1746609394199,AIP 197,001,891854,Vespa; Emanuel Ignacio,9999,0,9999,0
1746609395225,ANTH 289S,A00,891856,Gagneux; Pascal,12,0,12,0
1746609396252,BENG 196,001,957946,Engler; Adam J.,9996,0,9999,3
1746609397276,BISP 197,001,959851,Wilhelm; James E.,9998,0,9999,1
1746609398300,CAT 124RS,A01,956906,Staff,6,0,25,19
1746609399325,CAT 125RS,A01,922013,Staff,6,0,25,19
1746609400353,CLRE 250,A00,891860,Morris; Sheldon,9995,0,9999,4
1746609402423,CLRE 251R,A00,907817,Mehta; Ravindra L.,9994,0,9999,5
1746609403449,CLRE 252,A00,891864,Cuomo; Raphael Eduardo,9993,0,9999,6
1746609404475,CLRE 253,A00,891867,Vaida; Florin,9994,0,9999,5
1746609404475,CLRE 253,B00,907819,Staff,9999,0,9999,0
1746609405499,CLRE 259,A00,891868,Patel; Hemal,9998,0,9999,1
1746609406527,CLRE 260,A00,891872,Cuomo; Raphael Eduardo,9999,0,9999,0
1746609407553,CLRE 297,001,891888,Cuomo; Raphael Eduardo,9999,0,9999,0
1746609408583,CSE 191,A00,958773,Minnes Kemp; Mor Mia,9995,0,9999,4
1746609409607,CSE 197,001,959846,Minnes Kemp; Mor Mia,9990,0,9999,9
1746609410637,CSS 201S,A01,892054,Mignozzetti; Umberto,25,0,30,5
1746609411666,CSS 202S,A01,892056,Mignozzetti; Umberto,25,0,30,5
1746609412694,DSC 197,001,956898,Eldridge; Justin Matthew,9996,0,9999,3
1746609413723,DSC 297,001,958000,Mazumdar; Arya,9998,0,9999,1
1746609413723,DSC 297,002,959862,Wang; Yusu,9998,0,9999,1
1746609414752,EAP 100,A00,905686,Staff,9778,0,9999,221
1746609415778,ECE 45,A01,892618,Staff,0,0,65,65
1746609417833,ECE 111,A01,892719,Staff,6,0,65,59
1746609418858,ECE 197,001,957920,Mercier; Patrick Philip,9991,0,9999,8
1746609419884,ECON 178,A01,907814,Zhu; Ying,26,0,35,9
1746609420909,EDS 115,A00,895312,Staff,35,0,45,10
1746609421938,EDS 117,A01,895337,Staff,23,0,30,7
1746609422966,EDS 125,A00,895341,Jones; Gabrielle Anastasia,36,0,45,9
1746609423991,EDS 128A,A01,895459,Fargason; Sharon Gayle,44,0,45,1
1746609425015,EDS 128B,A01,895543,Pappas; Elizabeth,44,0,45,1
1746609426040,EDS 139,A00,897203,Pappas; Elizabeth,44,0,45,1
1746609426040,EDS 139,B00,897209,Fargason; Sharon Gayle,41,0,45,4
1746609427066,EDS 201,A00,895545,Staff,22,0,45,23
1746609428095,EDS 203,A01,895581,Halter; Christopher P.,22,0,45,23
1746609429123,EDS 204R,A01,895625,Heinzman; Erica M.,39,0,45,6
1746609429123,EDS 204R,B01,895693,Halter; Christopher P.,10,0,45,35
1746609430152,EDS 206R,A00,895694,Fargason; Sharon Gayle,1,0,30,29
1746609430152,EDS 206R,B00,895695,Choi; Bailey Miyeon,16,0,30,14
1746609431180,EDS 250,A00,895697,Hemans; Patricia Ann Benitez,22,0,45,23
1746609432207,EDS 281,A00,895701,Meyerott; Theresa Ann,1,0,15,14
1746609433234,EDS 284,A00,895736,Meyerott; Theresa Ann,1,0,15,14
1746609434259,EDS 286,A00,897210,Fine; Sarah,0,0,15,15
1746609435285,EDS 289C,A01,895770,Daly; Alan J.,1,0,15,14
1746609436312,EDS 290,A00,897211,Hofstetter; Carolyn,0,0,15,15
1746609437340,LIGM 5A,A00,896162,Fischer-Grunski; Eva K,12,0,20,8
1746609438368,LIGM 5B,A00,896260,Fischer-Grunski; Eva K,17,0,20,3
1746609439397,LIGM 5C,A00,896308,Fischer-Grunski; Eva K,18,0,20,2
1746609440428,LIIT 5AS,A00,896313,Carnelos; Chiara,18,0,20,2
1746609441454,LIIT 5BS,A00,896416,Carnelos; Chiara,20,0,20,0
1746609442479,LIIT 5CS,A00,896564,Carnelos; Chiara,20,0,20,0
1746609443507,LISP 5A,A00,896588,Munoz Sanchez; Alicia,2,0,20,18
1746609444533,LISP 5B,A00,896653,Munoz Sanchez; Alicia,7,0,20,13
1746609445557,LISP 5C,A00,896655,Munoz Sanchez; Alicia,0,1,20,20
1746609446584,MAE 197,001,957918,Kleissl; Jan,9996,0,9999,3
1746609446584,MAE 197,002,959806,Boechler; Nicholas Sebastia,9998,0,9999,1
1746609446584,MAE 197,003,959852,Mullin; Jennifer S,9998,0,9999,1
1746609447610,MATH 2,A01,957937,Staff,33,0,35,2
1746609448635,MATH 197,001,957876,Kedlaya; Kiran S.,9993,0,9999,6
1746609449662,MCWP 40,A00,892729,Duru; Nur,10,0,20,10
1746609449662,MCWP 40,B00,893304,Montejo; Carolina,14,0,20,6
1746609450688,MCWP 40R,A00,893757,Redela; Pamela Morgan,0,5,20,20
1746609451718,MCWP 50,A00,893758,Morshed; Michael James,0,0,20,20
1746609451718,MCWP 50,B00,893761,Bartulis; Jason Michael,16,0,20,4
1746609452748,MCWP 50R,A00,893766,Compas; Sean Matthew,0,1,20,20
1746609452748,MCWP 50R,B00,893769,Carter; Jennifer A,0,1,20,20
1746609452748,MCWP 50R,C00,893771,Krone; Jarret,0,3,20,20
1746609452748,MCWP 50R,D00,893772,Miller; Elizabeth Deen,0,0,20,20
1746609452748,MCWP 50R,E00,893775,Carter; Andrea L,0,1,20,20
1746609453775,MMW 11R,A01,892721,Herbst; Matthew,14,0,30,16
1746609453775,MMW 11R,A02,892722,Herbst; Matthew,0,0,0,3
1746609454800,MMW 12R,A01,892724,Herbst; Matthew,0,11,16,16
1746609454800,MMW 12R,A02,892725,Herbst; Matthew,0,10,16,16
1746609455824,MMW 13R,A01,892727,Staff,0,4,16,16
1746609455824,MMW 13R,A02,892728,Staff,0,4,16,16
1746609455824,MMW 13R,A03,958032,Staff,0,4,16,16
1746609455824,MMW 13R,A04,958033,Staff,0,4,16,16
1746609455824,MMW 13R,A05,958034,Staff,0,4,16,16
1746609456850,SIO 295LS,A00,894015,Staff,5,0,25,20
1746609457880,SIO 295S,A00,894020,Staff,5,0,25,20
1746609458906,SIOC 290S,B01,958918,Merrifield; Mark A,14,0,30,16
1746609459931,SIOC 291S,B01,958922,Gabriel; Corey John,14,0,30,16
1746609460956,SOCI 117,A01,895339,Staff,2,0,5,3
1746609461980,WES 237B,A00,894149,Staff,11,0,20,9
1746609464043,AESE 279B,A00,891859,Staff,13,0,35,22
1746609465070,AIP 197,001,891854,Vespa; Emanuel Ignacio,9999,0,9999,0
1746609466101,ANTH 289S,A00,891856,Gagneux; Pascal,12,0,12,0
1746609467132,BENG 196,001,957946,Engler; Adam J.,9996,0,9999,3
1746609468161,BISP 197,001,959851,Wilhelm; James E.,9998,0,9999,1
1746609469186,CAT 124RS,A01,956906,Staff,6,0,25,19
1746609470212,CAT 125RS,A01,922013,Staff,6,0,25,19
1746609471239,CLRE 250,A00,891860,Morris; Sheldon,9995,0,9999,4
1746609473292,CLRE 251R,A00,907817,Mehta; Ravindra L.,9994,0,9999,5
1746609474320,CLRE 252,A00,891864,Cuomo; Raphael Eduardo,9993,0,9999,6
1746609475351,CLRE 253,A00,891867,Vaida; Florin,9994,0,9999,5
1746609475351,CLRE 253,B00,907819,Staff,9999,0,9999,0
1746609476377,CLRE 259,A00,891868,Patel; Hemal,9998,0,9999,1
1746609477402,CLRE 260,A00,891872,Cuomo; Raphael Eduardo,9999,0,9999,0
1746609478428,CLRE 297,001,891888,Cuomo; Raphael Eduardo,9999,0,9999,0
1746609479456,CSE 191,A00,958773,Minnes Kemp; Mor Mia,9995,0,9999,4
1746609480485,CSE 197,001,959846,Minnes Kemp; Mor Mia,9990,0,9999,9
1746609481513,CSS 201S,A01,892054,Mignozzetti; Umberto,25,0,30,5
1746609482543,CSS 202S,A01,892056,Mignozzetti; Umberto,25,0,30,5
1746609483568,DSC 197,001,956898,Eldridge; Justin Matthew,9996,0,9999,3
1746609484595,DSC 297,001,958000,Mazumdar; Arya,9998,0,9999,1
1746609484595,DSC 297,002,959862,Wang; Yusu,9998,0,9999,1
1746609485620,EAP 100,A00,905686,Staff,9778,0,9999,221
1746609486650,ECE 45,A01,892618,Staff,0,0,65,65
1746609488704,ECE 111,A01,892719,Staff,6,0,65,59
1746609489733,ECE 197,001,957920,Mercier; Patrick Philip,9991,0,9999,8
1746609490763,ECON 178,A01,907814,Zhu; Ying,26,0,35,9
1746609491789,EDS 115,A00,895312,Staff,35,0,45,10
1746609492817,EDS 117,A01,895337,Staff,23,0,30,7
1746609493843,EDS 125,A00,895341,Jones; Gabrielle Anastasia,36,0,45,9
1746609494868,EDS 128A,A01,895459,Fargason; Sharon Gayle,44,0,45,1
1746609495897,EDS 128B,A01,895543,Pappas; Elizabeth,44,0,45,1
1746609496921,EDS 139,A00,897203,Pappas; Elizabeth,44,0,45,1
1746609496921,EDS 139,B00,897209,Fargason; Sharon Gayle,41,0,45,4
1746609497947,EDS 201,A00,895545,Staff,22,0,45,23
1746609498972,EDS 203,A01,895581,Halter; Christopher P.,22,0,45,23
1746609499999,EDS 204R,A01,895625,Heinzman; Erica M.,39,0,45,6
1746609499999,EDS 204R,B01,895693,Halter; Christopher P.,10,0,45,35
1746609501027,EDS 206R,A00,895694,Fargason; Sharon Gayle,1,0,30,29
1746609501027,EDS 206R,B00,895695,Choi; Bailey Miyeon,16,0,30,14
1746609502053,EDS 250,A00,895697,Hemans; Patricia Ann Benitez,22,0,45,23
1746609503080,EDS 281,A00,895701,Meyerott; Theresa Ann,1,0,15,14
1746609504105,EDS 284,A00,895736,Meyerott; Theresa Ann,1,0,15,14
1746609505135,EDS 286,A00,897210,Fine; Sarah,0,0,15,15
1746609506164,EDS 289C,A01,895770,Daly; Alan J.,1,0,15,14
1746609507192,EDS 290,A00,897211,Hofstetter; Carolyn,0,0,15,15
1746609508218,LIGM 5A,A00,896162,Fischer-Grunski; Eva K,12,0,20,8
1746609509243,LIGM 5B,A00,896260,Fischer-Grunski; Eva K,17,0,20,3
1746609510268,LIGM 5C,A00,896308,Fischer-Grunski; Eva K,18,0,20,2
1746609511297,LIIT 5AS,A00,896313,Carnelos; Chiara,18,0,20,2
1746609512326,LIIT 5BS,A00,896416,Carnelos; Chiara,20,0,20,0
1746609513353,LIIT 5CS,A00,896564,Carnelos; Chiara,20,0,20,0
1746609514380,LISP 5A,A00,896588,Munoz Sanchez; Alicia,2,0,20,18
1746609515410,LISP 5B,A00,896653,Munoz Sanchez; Alicia,7,0,20,13
1746609516451,LISP 5C,A00,896655,Munoz Sanchez; Alicia,0,1,20,20
1746609517477,MAE 197,001,957918,Kleissl; Jan,9996,0,9999,3
1746609517477,MAE 197,002,959806,Boechler; Nicholas Sebastia,9998,0,9999,1
1746609517477,MAE 197,003,959852,Mullin; Jennifer S,9998,0,9999,1
1746609518506,MATH 2,A01,957937,Staff,33,0,35,2
1746609519533,MATH 197,001,957876,Kedlaya; Kiran S.,9993,0,9999,6
1746609520561,MCWP 40,A00,892729,Duru; Nur,10,0,20,10
1746609520561,MCWP 40,B00,893304,Montejo; Carolina,14,0,20,6
1746609521592,MCWP 40R,A00,893757,Redela; Pamela Morgan,0,5,20,20
1746609522619,MCWP 50,A00,893758,Morshed; Michael James,0,0,20,20
1746609522619,MCWP 50,B00,893761,Bartulis; Jason Michael,16,0,20,4
1746609523651,MCWP 50R,A00,893766,Compas; Sean Matthew,0,1,20,20
1746609523651,MCWP 50R,B00,893769,Carter; Jennifer A,0,1,20,20
1746609523651,MCWP 50R,C00,893771,Krone; Jarret,0,3,20,20
1746609523651,MCWP 50R,D00,893772,Miller; Elizabeth Deen,0,0,20,20
1746609523651,MCWP 50R,E00,893775,Carter; Andrea L,0,1,20,20
1746609524683,MMW 11R,A01,892721,Herbst; Matthew,14,0,30,16
1746609524683,MMW 11R,A02,892722,Herbst; Matthew,0,0,0,3
1746609525707,MMW 12R,A01,892724,Herbst; Matthew,0,11,16,16
1746609525707,MMW 12R,A02,892725,Herbst; Matthew,0,10,16,16
1746609526736,MMW 13R,A01,892727,Staff,0,4,16,16
1746609526736,MMW 13R,A02,892728,Staff,0,4,16,16
1746609526736,MMW 13R,A03,958032,Staff,0,4,16,16
1746609526736,MMW 13R,A04,958033,Staff,0,4,16,16
1746609526736,MMW 13R,A05,958034,Staff,0,4,16,16
1746609527764,SIO 295LS,A00,894015,Staff,5,0,25,20
1746609528789,SIO 295S,A00,894020,Staff,5,0,25,20
1746609529815,SIOC 290S,B01,958918,Merrifield; Mark A,14,0,30,16
1746609530856,SIOC 291S,B01,958922,Gabriel; Corey John,14,0,30,16
1746609531881,SOCI 117,A01,895339,Staff,2,0,5,3
1746609532908,WES 237B,A00,894149,Staff,11,0,20,9
1746609534975,AESE 279B,A00,891859,Staff,13,0,35,22
1746609536003,AIP 197,001,891854,Vespa; Emanuel Ignacio,9999,0,9999,0
1746609537029,ANTH 289S,A00,891856,Gagneux; Pascal,12,0,12,0
1746609538056,BENG 196,001,957946,Engler; Adam J.,9996,0,9999,3
1746609539082,BISP 197,001,959851,Wilhelm; James E.,9998,0,9999,1
1746609540110,CAT 124RS,A01,956906,Staff,6,0,25,19
1746609541140,CAT 125RS,A01,922013,Staff,6,0,25,19
1746609542166,CLRE 250,A00,891860,Morris; Sheldon,9995,0,9999,4
1746609544215,CLRE 251R,A00,907817,Mehta; Ravindra L.,9994,0,9999,5
1746609545240,CLRE 252,A00,891864,Cuomo; Raphael Eduardo,9993,0,9999,6
1746609546265,CLRE 253,A00,891867,Vaida; Florin,9994,0,9999,5
1746609546265,CLRE 253,B00,907819,Staff,9999,0,9999,0
1746609547293,CLRE 259,A00,891868,Patel; Hemal,9998,0,9999,1
1746609548318,CLRE 260,A00,891872,Cuomo; Raphael Eduardo,9999,0,9999,0
1746609549344,CLRE 297,001,891888,Cuomo; Raphael Eduardo,9999,0,9999,0
1746609550370,CSE 191,A00,958773,Minnes Kemp; Mor Mia,9995,0,9999,4
1746609551395,CSE 197,001,959846,Minnes Kemp; Mor Mia,9990,0,9999,9
1746609552423,CSS 201S,A01,892054,Mignozzetti; Umberto,25,0,30,5
1746609553451,CSS 202S,A01,892056,Mignozzetti; Umberto,25,0,30,5
1746609554477,DSC 197,001,956898,Eldridge; Justin Matthew,9996,0,9999,3
1746609555506,DSC 297,001,958000,Mazumdar; Arya,9998,0,9999,1
1746609555506,DSC 297,002,959862,Wang; Yusu,9998,0,9999,1
1746609556590,EAP 100,A00,905686,Staff,9778,0,9999,221
1746609557618,ECE 45,A01,892618,Staff,0,0,65,65
1746609559676,ECE 111,A01,892719,Staff,6,0,65,59
1746609560702,ECE 197,001,957920,Mercier; Patrick Philip,9991,0,9999,8
1746609561729,ECON 178,A01,907814,Zhu; Ying,26,0,35,9
1746609562755,EDS 115,A00,895312,Staff,35,0,45,10
1746609563780,EDS 117,A01,895337,Staff,23,0,30,7
1746609564806,EDS 125,A00,895341,Jones; Gabrielle Anastasia,36,0,45,9
1746609565835,EDS 128A,A01,895459,Fargason; Sharon Gayle,44,0,45,1
1746609566860,EDS 128B,A01,895543,Pappas; Elizabeth,44,0,45,1
1746609567887,EDS 139,A00,897203,Pappas; Elizabeth,44,0,45,1
1746609567887,EDS 139,B00,897209,Fargason; Sharon Gayle,41,0,45,4
1746609568915,EDS 201,A00,895545,Staff,22,0,45,23
1746609569942,EDS 203,A01,895581,Halter; Christopher P.,22,0,45,23
1746609570970,EDS 204R,A01,895625,Heinzman; Erica M.,39,0,45,6
1746609570970,EDS 204R,B01,895693,Halter; Christopher P.,10,0,45,35
1746609571998,EDS 206R,A00,895694,Fargason; Sharon Gayle,1,0,30,29
1746609571998,EDS 206R,B00,895695,Choi; Bailey Miyeon,16,0,30,14
1746609573029,EDS 250,A00,895697,Hemans; Patricia Ann Benitez,22,0,45,23
1746609574056,EDS 281,A00,895701,Meyerott; Theresa Ann,1,0,15,14
1746609575086,EDS 284,A00,895736,Meyerott; Theresa Ann,1,0,15,14
1746609576112,EDS 286,A00,897210,Fine; Sarah,0,0,15,15
1746609577138,EDS 289C,A01,895770,Daly; Alan J.,1,0,15,14
1746609578166,EDS 290,A00,897211,Hofstetter; Carolyn,0,0,15,15
1746609579192,LIGM 5A,A00,896162,Fischer-Grunski; Eva K,12,0,20,8
1746609580221,LIGM 5B,A00,896260,Fischer-Grunski; Eva K,17,0,20,3
1746609581247,LIGM 5C,A00,896308,Fischer-Grunski; Eva K,18,0,20,2
1746609582277,LIIT 5AS,A00,896313,Carnelos; Chiara,18,0,20,2
1746609583304,LIIT 5BS,A00,896416,Carnelos; Chiara,20,0,20,0
1746609584331,LIIT 5CS,A00,896564,Carnelos; Chiara,20,0,20,0
1746609585362,LISP 5A,A00,896588,Munoz Sanchez; Alicia,2,0,20,18
1746609586389,LISP 5B,A00,896653,Munoz Sanchez; Alicia,7,0,20,13
1746609587417,LISP 5C,A00,896655,Munoz Sanchez; Alicia,0,1,20,20
1746609588444,MAE 197,001,957918,Kleissl; Jan,9996,0,9999,3
1746609588444,MAE 197,002,959806,Boechler; Nicholas Sebastia,9998,0,9999,1
1746609588444,MAE 197,003,959852,Mullin; Jennifer S,9998,0,9999,1
1746609589468,MATH 2,A01,957937,Staff,33,0,35,2
1746609590495,MATH 197,001,957876,Kedlaya; Kiran S.,9993,0,9999,6
1746609591522,MCWP 40,A00,892729,Duru; Nur,10,0,20,10
1746609591522,MCWP 40,B00,893304,Montejo; Carolina,14,0,20,6
1746609592549,MCWP 40R,A00,893757,Redela; Pamela Morgan,0,5,20,20
1746609593578,MCWP 50,A00,893758,Morshed; Michael James,0,0,20,20
1746609593578,MCWP 50,B00,893761,Bartulis; Jason Michael,16,0,20,4
1746609594611,MCWP 50R,A00,893766,Compas; Sean Matthew,0,1,20,20
1746609594611,MCWP 50R,B00,893769,Carter; Jennifer A,0,1,20,20
1746609594611,MCWP 50R,C00,893771,Krone; Jarret,0,3,20,20
1746609594611,MCWP 50R,D00,893772,Miller; Elizabeth Deen,0,0,20,20
1746609594611,MCWP 50R,E00,893775,Carter; Andrea L,0,1,20,20
1746609595640,MMW 11R,A01,892721,Herbst; Matthew,14,0,30,16
1746609595640,MMW 11R,A02,892722,Herbst; Matthew,0,0,0,3
1746609596670,MMW 12R,A01,892724,Herbst; Matthew,0,11,16,16
1746609596670,MMW 12R,A02,892725,Herbst; Matthew,0,10,16,16
1746609597699,MMW 13R,A01,892727,Staff,0,4,16,16
1746609597699,MMW 13R,A02,892728,Staff,0,4,16,16
1746609597699,MMW 13R,A03,958032,Staff,0,4,16,16
1746609597699,MMW 13R,A04,958033,Staff,0,4,16,16
1746609597699,MMW 13R,A05,958034,Staff,0,4,16,16
1746609598725,SIO 295LS,A00,894015,Staff,5,0,25,20
1746609599751,SIO 295S,A00,894020,Staff,5,0,25,20
1746609600784,SIOC 290S,B01,958918,Merrifield; Mark A,14,0,30,16
1746609601812,SIOC 291S,B01,958922,Gabriel; Corey John,14,0,30,16
1746609602841,SOCI 117,A01,895339,Staff,2,0,5,3
1746609603871,WES 237B,A00,894149,Staff,11,0,20,9
1746609605943,AESE 279B,A00,891859,Staff,13,0,35,22
1746609606968,AIP 197,001,891854,Vespa; Emanuel Ignacio,9999,0,9999,0
1746609607996,ANTH 289S,A00,891856,Gagneux; Pascal,12,0,12,0
1746609609021,BENG 196,001,957946,Engler; Adam J.,9996,0,9999,3
1746609610046,BISP 197,001,959851,Wilhelm; James E.,9998,0,9999,1
1746609611071,CAT 124RS,A01,956906,Staff,6,0,25,19
1746609612098,CAT 125RS,A01,922013,Staff,6,0,25,19
1746609613122,CLRE 250,A00,891860,Morris; Sheldon,9995,0,9999,4
1746609615181,CLRE 251R,A00,907817,Mehta; Ravindra L.,9994,0,9999,5
1746609616207,CLRE 252,A00,891864,Cuomo; Raphael Eduardo,9993,0,9999,6
1746609617234,CLRE 253,A00,891867,Vaida; Florin,9994,0,9999,5
1746609617234,CLRE 253,B00,907819,Staff,9999,0,9999,0
1746609618260,CLRE 259,A00,891868,Patel; Hemal,9998,0,9999,1
1746609619291,CLRE 260,A00,891872,Cuomo; Raphael Eduardo,9999,0,9999,0
1746609620315,CLRE 297,001,891888,Cuomo; Raphael Eduardo,9999,0,9999,0
1746609621340,CSE 191,A00,958773,Minnes Kemp; Mor Mia,9995,0,9999,4
1746609622365,CSE 197,001,959846,Minnes Kemp; Mor Mia,9990,0,9999,9
1746609623394,CSS 201S,A01,892054,Mignozzetti; Umberto,25,0,30,5
1746609624422,CSS 202S,A01,892056,Mignozzetti; Umberto,25,0,30,5
1746609625446,DSC 197,001,956898,Eldridge; Justin Matthew,9996,0,9999,3
1746609626475,DSC 297,001,958000,Mazumdar; Arya,9998,0,9999,1
1746609626475,DSC 297,002,959862,Wang; Yusu,9998,0,9999,1
1746609627502,EAP 100,A00,905686,Staff,9778,0,9999,221
1746609628533,ECE 45,A01,892618,Staff,0,0,65,65
1746609630589,ECE 111,A01,892719,Staff,6,0,65,59
1746609631617,ECE 197,001,957920,Mercier; Patrick Philip,9991,0,9999,8
1746609632644,ECON 178,A01,907814,Zhu; Ying,26,0,35,9
1746609633670,EDS 115,A00,895312,Staff,35,0,45,10
1746609634698,EDS 117,A01,895337,Staff,23,0,30,7
1746609635723,EDS 125,A00,895341,Jones; Gabrielle Anastasia,36,0,45,9
1746609636751,EDS 128A,A01,895459,Fargason; Sharon Gayle,44,0,45,1
1746609637779,EDS 128B,A01,895543,Pappas; Elizabeth,44,0,45,1
1746609638808,EDS 139,A00,897203,Pappas; Elizabeth,44,0,45,1
1746609638808,EDS 139,B00,897209,Fargason; Sharon Gayle,41,0,45,4
1746609639835,EDS 201,A00,895545,Staff,22,0,45,23
1746609640861,EDS 203,A01,895581,Halter; Christopher P.,22,0,45,23
1746609641891,EDS 204R,A01,895625,Heinzman; Erica M.,39,0,45,6
1746609641891,EDS 204R,B01,895693,Halter; Christopher P.,10,0,45,35
1746609642918,EDS 206R,A00,895694,Fargason; Sharon Gayle,1,0,30,29
1746609642918,EDS 206R,B00,895695,Choi; Bailey Miyeon,16,0,30,14
1746609643945,EDS 250,A00,895697,Hemans; Patricia Ann Benitez,22,0,45,23
1746609644972,EDS 281,A00,895701,Meyerott; Theresa Ann,1,0,15,14
1746609645999,EDS 284,A00,895736,Meyerott; Theresa Ann,1,0,15,14
1746609647024,EDS 286,A00,897210,Fine; Sarah,0,0,15,15
1746609648051,EDS 289C,A01,895770,Daly; Alan J.,1,0,15,14
1746609649082,EDS 290,A00,897211,Hofstetter; Carolyn,0,0,15,15
1746609650111,LIGM 5A,A00,896162,Fischer-Grunski; Eva K,12,0,20,8
1746609651139,LIGM 5B,A00,896260,Fischer-Grunski; Eva K,17,0,20,3
1746609652165,LIGM 5C,A00,896308,Fischer-Grunski; Eva K,18,0,20,2
1746609653189,LIIT 5AS,A00,896313,Carnelos; Chiara,18,0,20,2
1746609654219,LIIT 5BS,A00,896416,Carnelos; Chiara,20,0,20,0
1746609655251,LIIT 5CS,A00,896564,Carnelos; Chiara,20,0,20,0
1746609656280,LISP 5A,A00,896588,Munoz Sanchez; Alicia,2,0,20,18
1746609657306,LISP 5B,A00,896653,Munoz Sanchez; Alicia,7,0,20,13
1746609658333,LISP 5C,A00,896655,Munoz Sanchez; Alicia,0,1,20,20
1746609659364,MAE 197,001,957918,Kleissl; Jan,9996,0,9999,3
1746609659364,MAE 197,002,959806,Boechler; Nicholas Sebastia,9998,0,9999,1
1746609659364,MAE 197,003,959852,Mullin; Jennifer S,9998,0,9999,1
1746609660394,MATH 2,A01,957937,Staff,33,0,35,2
1746609661422,MATH 197,001,957876,Kedlaya; Kiran S.,9993,0,9999,6
1746609662449,MCWP 40,A00,892729,Duru; Nur,10,0,20,10
1746609662449,MCWP 40,B00,893304,Montejo; Carolina,14,0,20,6
1746609663477,MCWP 40R,A00,893757,Redela; Pamela Morgan,0,5,20,20
1746609664509,MCWP 50,A00,893758,Morshed; Michael James,0,0,20,20
1746609664509,MCWP 50,B00,893761,Bartulis; Jason Michael,16,0,20,4
1746609665540,MCWP 50R,A00,893766,Compas; Sean Matthew,0,1,20,20
1746609665540,MCWP 50R,B00,893769,Carter; Jennifer A,0,1,20,20
1746609665540,MCWP 50R,C00,893771,Krone; Jarret,0,3,20,20
1746609665540,MCWP 50R,D00,893772,Miller; Elizabeth Deen,0,0,20,20
1746609665540,MCWP 50R,E00,893775,Carter; Andrea L,0,1,20,20
1746609666566,MMW 11R,A01,892721,Herbst; Matthew,14,0,30,16
1746609666566,MMW 11R,A02,892722,Herbst; Matthew,0,0,0,3
1746609667592,MMW 12R,A01,892724,Herbst; Matthew,0,11,16,16
1746609667592,MMW 12R,A02,892725,Herbst; Matthew,0,10,16,16
1746609668617,MMW 13R,A01,892727,Staff,0,4,16,16
1746609668617,MMW 13R,A02,892728,Staff,0,4,16,16
1746609668617,MMW 13R,A03,958032,Staff,0,4,16,16
1746609668617,MMW 13R,A04,958033,Staff,0,4,16,16
1746609668617,MMW 13R,A05,958034,Staff,0,4,16,16
1746609669645,SIO 295LS,A00,894015,Staff,5,0,25,20
1746609670676,SIO 295S,A00,894020,Staff,5,0,25,20
1746609671706,SIOC 290S,B01,958918,Merrifield; Mark A,14,0,30,16
1746609672733,SIOC 291S,B01,958922,Gabriel; Corey John,14,0,30,16
1746609673760,SOCI 117,A01,895339,Staff,2,0,5,3
1746609674788,WES 237B,A00,894149,Staff,11,0,20,9
1746609676851,AESE 279B,A00,891859,Staff,13,0,35,22
1746609677881,AIP 197,001,891854,Vespa; Emanuel Ignacio,9999,0,9999,0
1746609678908,ANTH 289S,A00,891856,Gagneux; Pascal,12,0,12,0
1746609679937,BENG 196,001,957946,Engler; Adam J.,9996,0,9999,3
1746609680962,BISP 197,001,959851,Wilhelm; James E.,9998,0,9999,1
1746609681988,CAT 124RS,A01,956906,Staff,6,0,25,19
1746609683015,CAT 125RS,A01,922013,Staff,6,0,25,19
1746609684041,CLRE 250,A00,891860,Morris; Sheldon,9995,0,9999,4
1746609686093,CLRE 251R,A00,907817,Mehta; Ravindra L.,9994,0,9999,5
1746609687119,CLRE 252,A00,891864,Cuomo; Raphael Eduardo,9993,0,9999,6
1746609688145,CLRE 253,A00,891867,Vaida; Florin,9994,0,9999,5
1746609688145,CLRE 253,B00,907819,Staff,9999,0,9999,0
1746609689172,CLRE 259,A00,891868,Patel; Hemal,9998,0,9999,1
1746609690201,CLRE 260,A00,891872,Cuomo; Raphael Eduardo,9999,0,9999,0
1746609691227,CLRE 297,001,891888,Cuomo; Raphael Eduardo,9999,0,9999,0
1746609692254,CSE 191,A00,958773,Minnes Kemp; Mor Mia,9995,0,9999,4
1746609693284,CSE 197,001,959846,Minnes Kemp; Mor Mia,9990,0,9999,9
1746609694312,CSS 201S,A01,892054,Mignozzetti; Umberto,25,0,30,5
1746609695341,CSS 202S,A01,892056,Mignozzetti; Umberto,25,0,30,5
1746609696373,DSC 197,001,956898,Eldridge; Justin Matthew,9996,0,9999,3
1746609697399,DSC 297,001,958000,Mazumdar; Arya,9998,0,9999,1
1746609697399,DSC 297,002,959862,Wang; Yusu,9998,0,9999,1
1746609698423,EAP 100,A00,905686,Staff,9778,0,9999,221
1746609699491,ECE 45,A01,892618,Staff,0,0,65,65
1746609701542,ECE 111,A01,892719,Staff,6,0,65,59
1746609702567,ECE 197,001,957920,Mercier; Patrick Philip,9991,0,9999,8
1746609703597,ECON 178,A01,907814,Zhu; Ying,26,0,35,9
1746609704623,EDS 115,A00,895312,Staff,35,0,45,10
1746609705650,EDS 117,A01,895337,Staff,23,0,30,7
1746609706676,EDS 125,A00,895341,Jones; Gabrielle Anastasia,36,0,45,9
1746609707699,EDS 128A,A01,895459,Fargason; Sharon Gayle,44,0,45,1
1746609708724,EDS 128B,A01,895543,Pappas; Elizabeth,44,0,45,1
1746609709754,EDS 139,A00,897203,Pappas; Elizabeth,44,0,45,1
1746609709754,EDS 139,B00,897209,Fargason; Sharon Gayle,41,0,45,4
1746609710781,EDS 201,A00,895545,Staff,22,0,45,23
1746609711808,EDS 203,A01,895581,Halter; Christopher P.,22,0,45,23
1746609712835,EDS 204R,A01,895625,Heinzman; Erica M.,39,0,45,6
1746609712835,EDS 204R,B01,895693,Halter; Christopher P.,10,0,45,35
1746609713862,EDS 206R,A00,895694,Fargason; Sharon Gayle,1,0,30,29
1746609713862,EDS 206R,B00,895695,Choi; Bailey Miyeon,16,0,30,14
1746609714887,EDS 250,A00,895697,Hemans; Patricia Ann Benitez,22,0,45,23
1746609715913,EDS 281,A00,895701,Meyerott; Theresa Ann,1,0,15,14
1746609716937,EDS 284,A00,895736,Meyerott; Theresa Ann,1,0,15,14
1746609717961,EDS 286,A00,897210,Fine; Sarah,0,0,15,15
1746609718985,EDS 289C,A01,895770,Daly; Alan J.,1,0,15,14
1746609720015,EDS 290,A00,897211,Hofstetter; Carolyn,0,0,15,15
1746609721040,LIGM 5A,A00,896162,Fischer-Grunski; Eva K,12,0,20,8
1746609722065,LIGM 5B,A00,896260,Fischer-Grunski; Eva K,17,0,20,3
1746609723091,LIGM 5C,A00,896308,Fischer-Grunski; Eva K,18,0,20,2
1746609724116,LIIT 5AS,A00,896313,Carnelos; Chiara,18,0,20,2
1746609725146,LIIT 5BS,A00,896416,Carnelos; Chiara,20,0,20,0
1746609726174,LIIT 5CS,A00,896564,Carnelos; Chiara,20,0,20,0
1746609727202,LISP 5A,A00,896588,Munoz Sanchez; Alicia,2,0,20,18
1746609728228,LISP 5B,A00,896653,Munoz Sanchez; Alicia,7,0,20,13
1746609729255,LISP 5C,A00,896655,Munoz Sanchez; Alicia,0,1,20,20
1746609730282,MAE 197,001,957918,Kleissl; Jan,9996,0,9999,3
1746609730282,MAE 197,002,959806,Boechler; Nicholas Sebastia,9998,0,9999,1
1746609730282,MAE 197,003,959852,Mullin; Jennifer S,9998,0,9999,1
1746609731308,MATH 2,A01,957937,Staff,33,0,35,2
1746609732337,MATH 197,001,957876,Kedlaya; Kiran S.,9993,0,9999,6
1746609733363,MCWP 40,A00,892729,Duru; Nur,10,0,20,10
1746609733363,MCWP 40,B00,893304,Montejo; Carolina,14,0,20,6
1746609734392,MCWP 40R,A00,893757,Redela; Pamela Morgan,0,5,20,20
1746609735417,MCWP 50,A00,893758,Morshed; Michael James,0,0,20,20
1746609735417,MCWP 50,B00,893761,Bartulis; Jason Michael,16,0,20,4
1746609736443,MCWP 50R,A00,893766,Compas; Sean Matthew,0,1,20,20
1746609736443,MCWP 50R,B00,893769,Carter; Jennifer A,0,1,20,20
1746609736443,MCWP 50R,C00,893771,Krone; Jarret,0,3,20,20
1746609736443,MCWP 50R,D00,893772,Miller; Elizabeth Deen,0,0,20,20
1746609736443,MCWP 50R,E00,893775,Carter; Andrea L,0,1,20,20
1746609737471,MMW 11R,A01,892721,Herbst; Matthew,14,0,30,16
1746609737471,MMW 11R,A02,892722,Herbst; Matthew,0,0,0,3
1746609738498,MMW 12R,A01,892724,Herbst; Matthew,0,11,16,16
1746609738498,MMW 12R,A02,892725,Herbst; Matthew,0,10,16,16
1746609739523,MMW 13R,A01,892727,Staff,0,4,16,16
1746609739523,MMW 13R,A02,892728,Staff,0,4,16,16
1746609739523,MMW 13R,A03,958032,Staff,0,4,16,16
1746609739523,MMW 13R,A04,958033,Staff,0,4,16,16
1746609739523,MMW 13R,A05,958034,Staff,0,4,16,16
1746609740552,SIO 295LS,A00,894015,Staff,5,0,25,20
1746609741580,SIO 295S,A00,894020,Staff,5,0,25,20
1746609742608,SIOC 290S,B01,958918,Merrifield; Mark A,14,0,30,16
1746609743634,SIOC 291S,B01,958922,Gabriel; Corey John,14,0,30,16
1746609744658,SOCI 117,A01,895339,Staff,2,0,5,3
1746609745686,WES 237B,A00,894149,Staff,11,0,20,9
1746609747764,AESE 279B,A00,891859,Staff,13,0,35,22
1746609748791,AIP 197,001,891854,Vespa; Emanuel Ignacio,9999,0,9999,0
1746609749817,ANTH 289S,A00,891856,Gagneux; Pascal,12,0,12,0
1746609750841,BENG 196,001,957946,Engler; Adam J.,9996,0,9999,3
1746609751868,BISP 197,001,959851,Wilhelm; James E.,9998,0,9999,1
1746609752897,CAT 124RS,A01,956906,Staff,6,0,25,19
1746609753926,CAT 125RS,A01,922013,Staff,6,0,25,19
1746609754954,CLRE 250,A00,891860,Morris; Sheldon,9995,0,9999,4
1746609757007,CLRE 251R,A00,907817,Mehta; Ravindra L.,9994,0,9999,5
1746609758035,CLRE 252,A00,891864,Cuomo; Raphael Eduardo,9993,0,9999,6
1746609759059,CLRE 253,A00,891867,Vaida; Florin,9994,0,9999,5
1746609759059,CLRE 253,B00,907819,Staff,9999,0,9999,0
1746609760085,CLRE 259,A00,891868,Patel; Hemal,9998,0,9999,1
1746609761110,CLRE 260,A00,891872,Cuomo; Raphael Eduardo,9999,0,9999,0
1746609762140,CLRE 297,001,891888,Cuomo; Raphael Eduardo,9999,0,9999,0
1746609763168,CSE 191,A00,958773,Minnes Kemp; Mor Mia,9995,0,9999,4
1746609764193,CSE 197,001,959846,Minnes Kemp; Mor Mia,9990,0,9999,9
1746609765225,CSS 201S,A01,892054,Mignozzetti; Umberto,25,0,30,5
1746609766252,CSS 202S,A01,892056,Mignozzetti; Umberto,25,0,30,5
1746609767277,DSC 197,001,956898,Eldridge; Justin Matthew,9996,0,9999,3
1746609768305,DSC 297,001,958000,Mazumdar; Arya,9998,0,9999,1
1746609768305,DSC 297,002,959862,Wang; Yusu,9998,0,9999,1
1746609769333,EAP 100,A00,905686,Staff,9778,0,9999,221
1746609770365,ECE 45,A01,892618,Staff,0,0,65,65
1746609772430,ECE 111,A01,892719,Staff,6,0,65,59
1746609773456,ECE 197,001,957920,Mercier; Patrick Philip,9991,0,9999,8
1746609774486,ECON 178,A01,907814,Zhu; Ying,26,0,35,9
1746609775515,EDS 115,A00,895312,Staff,35,0,45,10
1746609776545,EDS 117,A01,895337,Staff,23,0,30,7
1746609777570,EDS 125,A00,895341,Jones; Gabrielle Anastasia,36,0,45,9
1746609778597,EDS 128A,A01,895459,Fargason; Sharon Gayle,44,0,45,1
1746609779627,EDS 128B,A01,895543,Pappas; Elizabeth,44,0,45,1
1746609780654,EDS 139,A00,897203,Pappas; Elizabeth,44,0,45,1
1746609780654,EDS 139,B00,897209,Fargason; Sharon Gayle,41,0,45,4
1746609781682,EDS 201,A00,895545,Staff,22,0,45,23
1746609782709,EDS 203,A01,895581,Halter; Christopher P.,22,0,45,23
1746609783735,EDS 204R,A01,895625,Heinzman; Erica M.,39,0,45,6
1746609783735,EDS 204R,B01,895693,Halter; Christopher P.,10,0,45,35
1746609784762,EDS 206R,A00,895694,Fargason; Sharon Gayle,1,0,30,29
1746609784762,EDS 206R,B00,895695,Choi; Bailey Miyeon,16,0,30,14
1746609785789,EDS 250,A00,895697,Hemans; Patricia Ann Benitez,22,0,45,23
1746609786816,EDS 281,A00,895701,Meyerott; Theresa Ann,1,0,15,14
1746609787841,EDS 284,A00,895736,Meyerott; Theresa Ann,1,0,15,14
1746609788868,EDS 286,A00,897210,Fine; Sarah,0,0,15,15
1746609789896,EDS 289C,A01,895770,Daly; Alan J.,1,0,15,14
1746609790925,EDS 290,A00,897211,Hofstetter; Carolyn,0,0,15,15
1746609791956,LIGM 5A,A00,896162,Fischer-Grunski; Eva K,12,0,20,8
1746609792985,LIGM 5B,A00,896260,Fischer-Grunski; Eva K,17,0,20,3
1746609794013,LIGM 5C,A00,896308,Fischer-Grunski; Eva K,18,0,20,2
1746609795039,LIIT 5AS,A00,896313,Carnelos; Chiara,18,0,20,2
1746609796070,LIIT 5BS,A00,896416,Carnelos; Chiara,20,0,20,0
1746609797096,LIIT 5CS,A00,896564,Carnelos; Chiara,20,0,20,0
1746609798122,LISP 5A,A00,896588,Munoz Sanchez; Alicia,2,0,20,18
1746609799148,LISP 5B,A00,896653,Munoz Sanchez; Alicia,7,0,20,13
1746609800173,LISP 5C,A00,896655,Munoz Sanchez; Alicia,0,1,20,20
1746609801200,MAE 197,001,957918,Kleissl; Jan,9996,0,9999,3
1746609801200,MAE 197,002,959806,Boechler; Nicholas Sebastia,9998,0,9999,1
1746609801200,MAE 197,003,959852,Mullin; Jennifer S,9998,0,9999,1
1746609802228,MATH 2,A01,957937,Staff,33,0,35,2
1746609803255,MATH 197,001,957876,Kedlaya; Kiran S.,9993,0,9999,6
1746609804284,MCWP 40,A00,892729,Duru; Nur,10,0,20,10
1746609804284,MCWP 40,B00,893304,Montejo; Carolina,14,0,20,6
1746609805308,MCWP 40R,A00,893757,Redela; Pamela Morgan,0,5,20,20
1746609806335,MCWP 50,A00,893758,Morshed; Michael James,0,0,20,20
1746609806335,MCWP 50,B00,893761,Bartulis; Jason Michael,16,0,20,4
1746609807362,MCWP 50R,A00,893766,Compas; Sean Matthew,0,1,20,20
1746609807362,MCWP 50R,B00,893769,Carter; Jennifer A,0,1,20,20
1746609807362,MCWP 50R,C00,893771,Krone; Jarret,0,3,20,20
1746609807362,MCWP 50R,D00,893772,Miller; Elizabeth Deen,0,0,20,20
1746609807362,MCWP 50R,E00,893775,Carter; Andrea L,0,1,20,20
1746609808389,MMW 11R,A01,892721,Herbst; Matthew,14,0,30,16
1746609808389,MMW 11R,A02,892722,Herbst; Matthew,0,0,0,3
1746609809414,MMW 12R,A01,892724,Herbst; Matthew,0,11,16,16
1746609809414,MMW 12R,A02,892725,Herbst; Matthew,0,10,16,16
1746609810441,MMW 13R,A01,892727,Staff,0,4,16,16
1746609810441,MMW 13R,A02,892728,Staff,0,4,16,16
1746609810441,MMW 13R,A03,958032,Staff,0,4,16,16
1746609810441,MMW 13R,A04,958033,Staff,0,4,16,16
1746609810441,MMW 13R,A05,958034,Staff,0,4,16,16
1746609811469,SIO 295LS,A00,894015,Staff,5,0,25,20
1746609812500,SIO 295S,A00,894020,Staff,5,0,25,20
1746609813534,SIOC 290S,B01,958918,Merrifield; Mark A,14,0,30,16
1746609814560,SIOC 291S,B01,958922,Gabriel; Corey John,14,0,30,16
1746609815587,SOCI 117,A01,895339,Staff,2,0,5,3
1746609816612,WES 237B,A00,894149,Staff,11,0,20,9
1746609818689,AESE 279B,A00,891859,Staff,13,0,35,22
1746609819719,AIP 197,001,891854,Vespa; Emanuel Ignacio,9999,0,9999,0
1746609820747,ANTH 289S,A00,891856,Gagneux; Pascal,12,0,12,0
1746609821772,BENG 196,001,957946,Engler; Adam J.,9996,0,9999,3
1746609822801,BISP 197,001,959851,Wilhelm; James E.,9998,0,9999,1
1746609823828,CAT 124RS,A01,956906,Staff,6,0,25,19
1746609824857,CAT 125RS,A01,922013,Staff,6,0,25,19
1746609825884,CLRE 250,A00,891860,Morris; Sheldon,9995,0,9999,4
1746609827944,CLRE 251R,A00,907817,Mehta; Ravindra L.,9994,0,9999,5
1746609828971,CLRE 252,A00,891864,Cuomo; Raphael Eduardo,9993,0,9999,6
1746609830002,CLRE 253,A00,891867,Vaida; Florin,9994,0,9999,5
1746609830002,CLRE 253,B00,907819,Staff,9999,0,9999,0
1746609831032,CLRE 259,A00,891868,Patel; Hemal,9998,0,9999,1
1746609832059,CLRE 260,A00,891872,Cuomo; Raphael Eduardo,9999,0,9999,0
1746609833084,CLRE 297,001,891888,Cuomo; Raphael Eduardo,9999,0,9999,0
1746609834112,CSE 191,A00,958773,Minnes Kemp; Mor Mia,9995,0,9999,4
1746609835143,CSE 197,001,959846,Minnes Kemp; Mor Mia,9990,0,9999,9
1746609836168,CSS 201S,A01,892054,Mignozzetti; Umberto,25,0,30,5
1746609837198,CSS 202S,A01,892056,Mignozzetti; Umberto,25,0,30,5
1746609838226,DSC 197,001,956898,Eldridge; Justin Matthew,9996,0,9999,3
1746609839253,DSC 297,001,958000,Mazumdar; Arya,9998,0,9999,1
1746609839253,DSC 297,002,959862,Wang; Yusu,9998,0,9999,1
1746609840280,EAP 100,A00,905686,Staff,9778,0,9999,221
1746609841312,ECE 45,A01,892618,Staff,0,0,65,65
1746609843367,ECE 111,A01,892719,Staff,6,0,65,59
1746609844391,ECE 197,001,957920,Mercier; Patrick Philip,9991,0,9999,8
1746609845421,ECON 178,A01,907814,Zhu; Ying,26,0,35,9
1746609846447,EDS 115,A00,895312,Staff,35,0,45,10
1746609847479,EDS 117,A01,895337,Staff,23,0,30,7
1746609848510,EDS 125,A00,895341,Jones; Gabrielle Anastasia,36,0,45,9
1746609849538,EDS 128A,A01,895459,Fargason; Sharon Gayle,44,0,45,1
1746609850564,EDS 128B,A01,895543,Pappas; Elizabeth,44,0,45,1
1746609851590,EDS 139,A00,897203,Pappas; Elizabeth,44,0,45,1
1746609851590,EDS 139,B00,897209,Fargason; Sharon Gayle,41,0,45,4
1746609852631,EDS 201,A00,895545,Staff,22,0,45,23
1746609853656,EDS 203,A01,895581,Halter; Christopher P.,22,0,45,23
1746609854682,EDS 204R,A01,895625,Heinzman; Erica M.,39,0,45,6
1746609854682,EDS 204R,B01,895693,Halter; Christopher P.,10,0,45,35
1746609855709,EDS 206R,A00,895694,Fargason; Sharon Gayle,1,0,30,29
1746609855709,EDS 206R,B00,895695,Choi; Bailey Miyeon,16,0,30,14
1746609856734,EDS 250,A00,895697,Hemans; Patricia Ann Benitez,22,0,45,23
1746609857761,EDS 281,A00,895701,Meyerott; Theresa Ann,1,0,15,14
1746609858786,EDS 284,A00,895736,Meyerott; Theresa Ann,1,0,15,14
1746609859812,EDS 286,A00,897210,Fine; Sarah,0,0,15,15
1746609860839,EDS 289C,A01,895770,Daly; Alan J.,1,0,15,14
1746609861865,EDS 290,A00,897211,Hofstetter; Carolyn,0,0,15,15
1746609862894,LIGM 5A,A00,896162,Fischer-Grunski; Eva K,12,0,20,8
1746609863924,LIGM 5B,A00,896260,Fischer-Grunski; Eva K,17,0,20,3
1746609864951,LIGM 5C,A00,896308,Fischer-Grunski; Eva K,18,0,20,2
1746609865979,LIIT 5AS,A00,896313,Carnelos; Chiara,18,0,20,2
1746609867004,LIIT 5BS,A00,896416,Carnelos; Chiara,20,0,20,0
1746609868031,LIIT 5CS,A00,896564,Carnelos; Chiara,20,0,20,0
1746609869056,LISP 5A,A00,896588,Munoz Sanchez; Alicia,2,0,20,18
1746609870085,LISP 5B,A00,896653,Munoz Sanchez; Alicia,7,0,20,13
1746609871111,LISP 5C,A00,896655,Munoz Sanchez; Alicia,0,1,20,20
1746609872137,MAE 197,001,957918,Kleissl; Jan,9996,0,9999,3
1746609872137,MAE 197,002,959806,Boechler; Nicholas Sebastia,9998,0,9999,1
1746609872137,MAE 197,003,959852,Mullin; Jennifer S,9998,0,9999,1
1746609873163,MATH 2,A01,957937,Staff,33,0,35,2
1746609874191,MATH 197,001,957876,Kedlaya; Kiran S.,9993,0,9999,6
1746609875220,MCWP 40,A00,892729,Duru; Nur,10,0,20,10
1746609875220,MCWP 40,B00,893304,Montejo; Carolina,14,0,20,6
1746609876245,MCWP 40R,A00,893757,Redela; Pamela Morgan,0,5,20,20
1746609877271,MCWP 50,A00,893758,Morshed; Michael James,0,0,20,20
1746609877271,MCWP 50,B00,893761,Bartulis; Jason Michael,16,0,20,4
1746609878299,MCWP 50R,A00,893766,Compas; Sean Matthew,0,1,20,20
1746609878299,MCWP 50R,B00,893769,Carter; Jennifer A,0,1,20,20
1746609878299,MCWP 50R,C00,893771,Krone; Jarret,0,3,20,20
1746609878299,MCWP 50R,D00,893772,Miller; Elizabeth Deen,0,0,20,20
1746609878299,MCWP 50R,E00,893775,Carter; Andrea L,0,1,20,20
1746609879327,MMW 11R,A01,892721,Herbst; Matthew,14,0,30,16
1746609879327,MMW 11R,A02,892722,Herbst; Matthew,0,0,0,3
1746609880353,MMW 12R,A01,892724,Herbst; Matthew,0,11,16,16
1746609880353,MMW 12R,A02,892725,Herbst; Matthew,0,10,16,16
1746609881379,MMW 13R,A01,892727,Staff,0,4,16,16
1746609881379,MMW 13R,A02,892728,Staff,0,4,16,16
1746609881379,MMW 13R,A03,958032,Staff,0,4,16,16
1746609881379,MMW 13R,A04,958033,Staff,0,4,16,16
1746609881379,MMW 13R,A05,958034,Staff,0,4,16,16
1746609882420,SIO 295LS,A00,894015,Staff,5,0,25,20
1746609883446,SIO 295S,A00,894020,Staff,5,0,25,20
1746609884474,SIOC 290S,B01,958918,Merrifield; Mark A,14,0,30,16
1746609885502,SIOC 291S,B01,958922,Gabriel; Corey John,14,0,30,16
1746609886530,SOCI 117,A01,895339,Staff,2,0,5,3
1746609887559,WES 237B,A00,894149,Staff,11,0,20,9
1746609889629,AESE 279B,A00,891859,Staff,13,0,35,22
1746609890658,AIP 197,001,891854,Vespa; Emanuel Ignacio,9999,0,9999,0
1746609891688,ANTH 289S,A00,891856,Gagneux; Pascal,12,0,12,0
1746609892715,BENG 196,001,957946,Engler; Adam J.,9996,0,9999,3
1746609893742,BISP 197,001,959851,Wilhelm; James E.,9998,0,9999,1
1746609894768,CAT 124RS,A01,956906,Staff,6,0,25,19
1746609895799,CAT 125RS,A01,922013,Staff,6,0,25,19
1746609896825,CLRE 250,A00,891860,Morris; Sheldon,9995,0,9999,4
1746609898879,CLRE 251R,A00,907817,Mehta; Ravindra L.,9994,0,9999,5
1746609899909,CLRE 252,A00,891864,Cuomo; Raphael Eduardo,9993,0,9999,6
1746609900935,CLRE 253,A00,891867,Vaida; Florin,9994,0,9999,5
1746609900935,CLRE 253,B00,907819,Staff,9999,0,9999,0
1746609901972,CLRE 259,A00,891868,Patel; Hemal,9998,0,9999,1
1746609903001,CLRE 260,A00,891872,Cuomo; Raphael Eduardo,9999,0,9999,0
1746609904036,CLRE 297,001,891888,Cuomo; Raphael Eduardo,9999,0,9999,0
1746609905062,CSE 191,A00,958773,Minnes Kemp; Mor Mia,9995,0,9999,4
1746609906087,CSE 197,001,959846,Minnes Kemp; Mor Mia,9990,0,9999,9
1746609907115,CSS 201S,A01,892054,Mignozzetti; Umberto,25,0,30,5
1746609908142,CSS 202S,A01,892056,Mignozzetti; Umberto,25,0,30,5
1746609909168,DSC 197,001,956898,Eldridge; Justin Matthew,9996,0,9999,3
1746609910198,DSC 297,001,958000,Mazumdar; Arya,9998,0,9999,1
1746609910198,DSC 297,002,959862,Wang; Yusu,9998,0,9999,1
1746609911224,EAP 100,A00,905686,Staff,9778,0,9999,221
1746609912258,ECE 45,A01,892618,Staff,0,0,65,65
1746609914311,ECE 111,A01,892719,Staff,6,0,65,59
1746609915339,ECE 197,001,957920,Mercier; Patrick Philip,9991,0,9999,8
1746609916367,ECON 178,A01,907814,Zhu; Ying,26,0,35,9
1746609917393,EDS 115,A00,895312,Staff,35,0,45,10
1746609918417,EDS 117,A01,895337,Staff,23,0,30,7
1746609919445,EDS 125,A00,895341,Jones; Gabrielle Anastasia,36,0,45,9
1746609920476,EDS 128A,A01,895459,Fargason; Sharon Gayle,44,0,45,1
1746609921504,EDS 128B,A01,895543,Pappas; Elizabeth,44,0,45,1
1746609922530,EDS 139,A00,897203,Pappas; Elizabeth,44,0,45,1
1746609922530,EDS 139,B00,897209,Fargason; Sharon Gayle,41,0,45,4
1746609923560,EDS 201,A00,895545,Staff,22,0,45,23
1746609924610,EDS 203,A01,895581,Halter; Christopher P.,22,0,45,23
1746609925638,EDS 204R,A01,895625,Heinzman; Erica M.,39,0,45,6
1746609925638,EDS 204R,B01,895693,Halter; Christopher P.,10,0,45,35
1746609926669,EDS 206R,A00,895694,Fargason; Sharon Gayle,1,0,30,29
1746609926669,EDS 206R,B00,895695,Choi; Bailey Miyeon,16,0,30,14
1746609927694,EDS 250,A00,895697,Hemans; Patricia Ann Benitez,22,0,45,23
1746609928719,EDS 281,A00,895701,Meyerott; Theresa Ann,1,0,15,14
1746609929747,EDS 284,A00,895736,Meyerott; Theresa Ann,1,0,15,14
1746609930776,EDS 286,A00,897210,Fine; Sarah,0,0,15,15
1746609931801,EDS 289C,A01,895770,Daly; Alan J.,1,0,15,14
1746609932830,EDS 290,A00,897211,Hofstetter; Carolyn,0,0,15,15
1746609933856,LIGM 5A,A00,896162,Fischer-Grunski; Eva K,12,0,20,8
1746609934883,LIGM 5B,A00,896260,Fischer-Grunski; Eva K,17,0,20,3
1746609935910,LIGM 5C,A00,896308,Fischer-Grunski; Eva K,18,0,20,2
1746609936936,LIIT 5AS,A00,896313,Carnelos; Chiara,18,0,20,2
1746609937963,LIIT 5BS,A00,896416,Carnelos; Chiara,20,0,20,0
1746609938988,LIIT 5CS,A00,896564,Carnelos; Chiara,20,0,20,0
1746609940018,LISP 5A,A00,896588,Munoz Sanchez; Alicia,2,0,20,18
1746609941043,LISP 5B,A00,896653,Munoz Sanchez; Alicia,7,0,20,13
1746609942074,LISP 5C,A00,896655,Munoz Sanchez; Alicia,0,1,20,20
1746609943100,MAE 197,001,957918,Kleissl; Jan,9996,0,9999,3
1746609943100,MAE 197,002,959806,Boechler; Nicholas Sebastia,9998,0,9999,1
1746609943100,MAE 197,003,959852,Mullin; Jennifer S,9998,0,9999,1
1746609944128,MATH 2,A01,957937,Staff,33,0,35,2
1746609945155,MATH 197,001,957876,Kedlaya; Kiran S.,9993,0,9999,6
1746609946180,MCWP 40,A00,892729,Duru; Nur,10,0,20,10
1746609946180,MCWP 40,B00,893304,Montejo; Carolina,14,0,20,6
1746609947207,MCWP 40R,A00,893757,Redela; Pamela Morgan,0,5,20,20
1746609948237,MCWP 50,A00,893758,Morshed; Michael James,0,0,20,20
1746609948237,MCWP 50,B00,893761,Bartulis; Jason Michael,16,0,20,4
1746609949265,MCWP 50R,A00,893766,Compas; Sean Matthew,0,1,20,20
1746609949265,MCWP 50R,B00,893769,Carter; Jennifer A,0,1,20,20
1746609949265,MCWP 50R,C00,893771,Krone; Jarret,0,3,20,20
1746609949265,MCWP 50R,D00,893772,Miller; Elizabeth Deen,0,0,20,20
1746609949265,MCWP 50R,E00,893775,Carter; Andrea L,0,1,20,20
1746609950294,MMW 11R,A01,892721,Herbst; Matthew,14,0,30,16
1746609950294,MMW 11R,A02,892722,Herbst; Matthew,0,0,0,3
1746609951321,MMW 12R,A01,892724,Herbst; Matthew,0,11,16,16
1746609951321,MMW 12R,A02,892725,Herbst; Matthew,0,10,16,16
1746609952348,MMW 13R,A01,892727,Staff,0,4,16,16
1746609952348,MMW 13R,A02,892728,Staff,0,4,16,16
1746609952348,MMW 13R,A03,958032,Staff,0,4,16,16
1746609952348,MMW 13R,A04,958033,Staff,0,4,16,16
1746609952348,MMW 13R,A05,958034,Staff,0,4,16,16
1746609953378,SIO 295LS,A00,894015,Staff,5,0,25,20
1746609954403,SIO 295S,A00,894020,Staff,5,0,25,20
1746609955433,SIOC 290S,B01,958918,Merrifield; Mark A,14,0,30,16
1746609956461,SIOC 291S,B01,958922,Gabriel; Corey John,14,0,30,16
1746609957488,SOCI 117,A01,895339,Staff,2,0,5,3
1746609958514,WES 237B,A00,894149,Staff,11,0,20,9
1746609960594,AESE 279B,A00,891859,Staff,13,0,35,22
1746609961634,AIP 197,001,891854,Vespa; Emanuel Ignacio,9999,0,9999,0
1746609962668,ANTH 289S,A00,891856,Gagneux; Pascal,12,0,12,0
1746609963695,BENG 196,001,957946,Engler; Adam J.,9996,0,9999,3
1746609964724,BISP 197,001,959851,Wilhelm; James E.,9998,0,9999,1
1746609965754,CAT 124RS,A01,956906,Staff,6,0,25,19
1746609966779,CAT 125RS,A01,922013,Staff,6,0,25,19
1746609967805,CLRE 250,A00,891860,Morris; Sheldon,9995,0,9999,4
1746609969863,CLRE 251R,A00,907817,Mehta; Ravindra L.,9994,0,9999,5
1746609970892,CLRE 252,A00,891864,Cuomo; Raphael Eduardo,9993,0,9999,6
1746609971919,CLRE 253,A00,891867,Vaida; Florin,9994,0,9999,5
1746609971919,CLRE 253,B00,907819,Staff,9999,0,9999,0
1746609972944,CLRE 259,A00,891868,Patel; Hemal,9998,0,9999,1
1746609973973,CLRE 260,A00,891872,Cuomo; Raphael Eduardo,9999,0,9999,0
1746609975005,CLRE 297,001,891888,Cuomo; Raphael Eduardo,9999,0,9999,0
1746609976031,CSE 191,A00,958773,Minnes Kemp; Mor Mia,9995,0,9999,4
1746609977057,CSE 197,001,959846,Minnes Kemp; Mor Mia,9990,0,9999,9
1746609978083,CSS 201S,A01,892054,Mignozzetti; Umberto,25,0,30,5
1746609979113,CSS 202S,A01,892056,Mignozzetti; Umberto,25,0,30,5
1746609980141,DSC 197,001,956898,Eldridge; Justin Matthew,9996,0,9999,3
1746609981169,DSC 297,001,958000,Mazumdar; Arya,9998,0,9999,1
1746609981169,DSC 297,002,959862,Wang; Yusu,9998,0,9999,1
1746609982194,EAP 100,A00,905686,Staff,9778,0,9999,221
1746609983222,ECE 45,A01,892618,Staff,0,0,65,65
1746609985272,ECE 111,A01,892719,Staff,6,0,65,59
1746609986299,ECE 197,001,957920,Mercier; Patrick Philip,9991,0,9999,8
1746609987331,ECON 178,A01,907814,Zhu; Ying,26,0,35,9
1746609988355,EDS 115,A00,895312,Staff,35,0,45,10
1746609989384,EDS 117,A01,895337,Staff,23,0,30,7
1746609990410,EDS 125,A00,895341,Jones; Gabrielle Anastasia,36,0,45,9
1746609991489,EDS 128A,A01,895459,Fargason; Sharon Gayle,44,0,45,1
1746609992515,EDS 128B,A01,895543,Pappas; Elizabeth,44,0,45,1
1746609993542,EDS 139,A00,897203,Pappas; Elizabeth,44,0,45,1
1746609993542,EDS 139,B00,897209,Fargason; Sharon Gayle,41,0,45,4
1746609994571,EDS 201,A00,895545,Staff,22,0,45,23
1746609995598,EDS 203,A01,895581,Halter; Christopher P.,22,0,45,23
1746609996622,EDS 204R,A01,895625,Heinzman; Erica M.,39,0,45,6
1746609996622,EDS 204R,B01,895693,Halter; Christopher P.,10,0,45,35
1746609997649,EDS 206R,A00,895694,Fargason; Sharon Gayle,1,0,30,29
1746609997649,EDS 206R,B00,895695,Choi; Bailey Miyeon,16,0,30,14
1746609998674,EDS 250,A00,895697,Hemans; Patricia Ann Benitez,22,0,45,23
1746609999703,EDS 281,A00,895701,Meyerott; Theresa Ann,1,0,15,14
1746610000730,EDS 284,A00,895736,Meyerott; Theresa Ann,1,0,15,14
1746610001757,EDS 286,A00,897210,Fine; Sarah,0,0,15,15
1746610002786,EDS 289C,A01,895770,Daly; Alan J.,1,0,15,14
1746610003812,EDS 290,A00,897211,Hofstetter; Carolyn,0,0,15,15
1746610004841,LIGM 5A,A00,896162,Fischer-Grunski; Eva K,12,0,20,8
1746610005867,LIGM 5B,A00,896260,Fischer-Grunski; Eva K,17,0,20,3
1746610006896,LIGM 5C,A00,896308,Fischer-Grunski; Eva K,18,0,20,2
1746610007923,LIIT 5AS,A00,896313,Carnelos; Chiara,18,0,20,2
1746610008951,LIIT 5BS,A00,896416,Carnelos; Chiara,20,0,20,0
1746610009982,LIIT 5CS,A00,896564,Carnelos; Chiara,20,0,20,0
1746610011610,LISP 5A,A00,896588,Munoz Sanchez; Alicia,2,0,20,18
1746610012637,LISP 5B,A00,896653,Munoz Sanchez; Alicia,7,0,20,13
1746610013663,LISP 5C,A00,896655,Munoz Sanchez; Alicia,0,1,20,20
1746610014690,MAE 197,001,957918,Kleissl; Jan,9996,0,9999,3
1746610014690,MAE 197,002,959806,Boechler; Nicholas Sebastia,9998,0,9999,1
1746610014690,MAE 197,003,959852,Mullin; Jennifer S,9998,0,9999,1
1746610015715,MATH 2,A01,957937,Staff,33,0,35,2
1746610016743,MATH 197,001,957876,Kedlaya; Kiran S.,9993,0,9999,6
1746610017772,MCWP 40,A00,892729,Duru; Nur,10,0,20,10
1746610017772,MCWP 40,B00,893304,Montejo; Carolina,14,0,20,6
1746610018798,MCWP 40R,A00,893757,Redela; Pamela Morgan,0,5,20,20
1746610019823,MCWP 50,A00,893758,Morshed; Michael James,0,0,20,20
1746610019823,MCWP 50,B00,893761,Bartulis; Jason Michael,16,0,20,4
1746610020854,MCWP 50R,A00,893766,Compas; Sean Matthew,0,1,20,20
1746610020854,MCWP 50R,B00,893769,Carter; Jennifer A,0,1,20,20
1746610020854,MCWP 50R,C00,893771,Krone; Jarret,0,3,20,20
1746610020854,MCWP 50R,D00,893772,Miller; Elizabeth Deen,0,0,20,20
1746610020854,MCWP 50R,E00,893775,Carter; Andrea L,0,1,20,20
1746610021880,MMW 11R,A01,892721,Herbst; Matthew,14,0,30,16
1746610021880,MMW 11R,A02,892722,Herbst; Matthew,0,0,0,3
1746610022905,MMW 12R,A01,892724,Herbst; Matthew,0,11,16,16
1746610022905,MMW 12R,A02,892725,Herbst; Matthew,0,10,16,16
1746610023936,MMW 13R,A01,892727,Staff,0,4,16,16
1746610023936,MMW 13R,A02,892728,Staff,0,4,16,16
1746610023936,MMW 13R,A03,958032,Staff,0,4,16,16
1746610023936,MMW 13R,A04,958033,Staff,0,4,16,16
1746610023936,MMW 13R,A05,958034,Staff,0,4,16,16
1746610024962,SIO 295LS,A00,894015,Staff,5,0,25,20
1746610025989,SIO 295S,A00,894020,Staff,5,0,25,20
1746610027020,SIOC 290S,B01,958918,Merrifield; Mark A,14,0,30,16
1746610028050,SIOC 291S,B01,958922,Gabriel; Corey John,14,0,30,16
1746610029084,SOCI 117,A01,895339,Staff,2,0,5,3
1746610030109,WES 237B,A00,894149,Staff,11,0,20,9
1746610032186,AESE 279B,A00,891859,Staff,13,0,35,22
1746610033210,AIP 197,001,891854,Vespa; Emanuel Ignacio,9999,0,9999,0
1746610034240,ANTH 289S,A00,891856,Gagneux; Pascal,12,0,12,0
1746610035267,BENG 196,001,957946,Engler; Adam J.,9996,0,9999,3
1746610036293,BISP 197,001,959851,Wilhelm; James E.,9998,0,9999,1
1746610037321,CAT 124RS,A01,956906,Staff,6,0,25,19
1746610038349,CAT 125RS,A01,922013,Staff,6,0,25,19
1746610039373,CLRE 250,A00,891860,Morris; Sheldon,9995,0,9999,4
1746610041434,CLRE 251R,A00,907817,Mehta; Ravindra L.,9994,0,9999,5
1746610042459,CLRE 252,A00,891864,Cuomo; Raphael Eduardo,9993,0,9999,6
1746610043488,CLRE 253,A00,891867,Vaida; Florin,9994,0,9999,5
1746610043488,CLRE 253,B00,907819,Staff,9999,0,9999,0
1746610044518,CLRE 259,A00,891868,Patel; Hemal,9998,0,9999,1
1746610045543,CLRE 260,A00,891872,Cuomo; Raphael Eduardo,9999,0,9999,0
1746610046569,CLRE 297,001,891888,Cuomo; Raphael Eduardo,9999,0,9999,0
1746610047598,CSE 191,A00,958773,Minnes Kemp; Mor Mia,9995,0,9999,4
1746610048625,CSE 197,001,959846,Minnes Kemp; Mor Mia,9990,0,9999,9
1746610049649,CSS 201S,A01,892054,Mignozzetti; Umberto,25,0,30,5
1746610050675,CSS 202S,A01,892056,Mignozzetti; Umberto,25,0,30,5
1746610051703,DSC 197,001,956898,Eldridge; Justin Matthew,9996,0,9999,3
1746610052730,DSC 297,001,958000,Mazumdar; Arya,9998,0,9999,1
1746610052730,DSC 297,002,959862,Wang; Yusu,9998,0,9999,1
1746610053759,EAP 100,A00,905686,Staff,9778,0,9999,221
1746610054787,ECE 45,A01,892618,Staff,0,0,65,65
1746610056842,ECE 111,A01,892719,Staff,6,0,65,59
1746610057870,ECE 197,001,957920,Mercier; Patrick Philip,9991,0,9999,8
1746610058899,ECON 178,A01,907814,Zhu; Ying,26,0,35,9
1746610059924,EDS 115,A00,895312,Staff,35,0,45,10
1746610060952,EDS 117,A01,895337,Staff,23,0,30,7
1746610061979,EDS 125,A00,895341,Jones; Gabrielle Anastasia,36,0,45,9
1746610063005,EDS 128A,A01,895459,Fargason; Sharon Gayle,44,0,45,1
1746610064033,EDS 128B,A01,895543,Pappas; Elizabeth,44,0,45,1
1746610065059,EDS 139,A00,897203,Pappas; Elizabeth,44,0,45,1
1746610065059,EDS 139,B00,897209,Fargason; Sharon Gayle,41,0,45,4
1746610066087,EDS 201,A00,895545,Staff,22,0,45,23
1746610067113,EDS 203,A01,895581,Halter; Christopher P.,22,0,45,23
1746610068139,EDS 204R,A01,895625,Heinzman; Erica M.,39,0,45,6
1746610068139,EDS 204R,B01,895693,Halter; Christopher P.,10,0,45,35
1746610069170,EDS 206R,A00,895694,Fargason; Sharon Gayle,1,0,30,29
1746610069170,EDS 206R,B00,895695,Choi; Bailey Miyeon,16,0,30,14
1746610070200,EDS 250,A00,895697,Hemans; Patricia Ann Benitez,22,0,45,23
1746610071229,EDS 281,A00,895701,Meyerott; Theresa Ann,1,0,15,14
1746610072258,EDS 284,A00,895736,Meyerott; Theresa Ann,1,0,15,14
1746610073283,EDS 286,A00,897210,Fine; Sarah,0,0,15,15
1746610074313,EDS 289C,A01,895770,Daly; Alan J.,1,0,15,14
1746610075340,EDS 290,A00,897211,Hofstetter; Carolyn,0,0,15,15
1746610076366,LIGM 5A,A00,896162,Fischer-Grunski; Eva K,12,0,20,8
1746610077394,LIGM 5B,A00,896260,Fischer-Grunski; Eva K,17,0,20,3
1746610078419,LIGM 5C,A00,896308,Fischer-Grunski; Eva K,18,0,20,2
1746610079448,LIIT 5AS,A00,896313,Carnelos; Chiara,18,0,20,2
1746610080475,LIIT 5BS,A00,896416,Carnelos; Chiara,20,0,20,0
1746610081502,LIIT 5CS,A00,896564,Carnelos; Chiara,20,0,20,0
1746610082527,LISP 5A,A00,896588,Munoz Sanchez; Alicia,2,0,20,18
1746610083557,LISP 5B,A00,896653,Munoz Sanchez; Alicia,7,0,20,13
1746610084583,LISP 5C,A00,896655,Munoz Sanchez; Alicia,0,1,20,20
1746610085610,MAE 197,001,957918,Kleissl; Jan,9996,0,9999,3
1746610085610,MAE 197,002,959806,Boechler; Nicholas Sebastia,9998,0,9999,1
1746610085610,MAE 197,003,959852,Mullin; Jennifer S,9998,0,9999,1
1746610086636,MATH 2,A01,957937,Staff,33,0,35,2
1746610087663,MATH 197,001,957876,Kedlaya; Kiran S.,9993,0,9999,6
1746610088691,MCWP 40,A00,892729,Duru; Nur,10,0,20,10
1746610088691,MCWP 40,B00,893304,Montejo; Carolina,14,0,20,6
1746610089719,MCWP 40R,A00,893757,Redela; Pamela Morgan,0,5,20,20
1746610090745,MCWP 50,A00,893758,Morshed; Michael James,0,0,20,20
1746610090745,MCWP 50,B00,893761,Bartulis; Jason Michael,16,0,20,4
1746610091772,MCWP 50R,A00,893766,Compas; Sean Matthew,0,1,20,20
1746610091772,MCWP 50R,B00,893769,Carter; Jennifer A,0,1,20,20
1746610091772,MCWP 50R,C00,893771,Krone; Jarret,0,3,20,20
1746610091772,MCWP 50R,D00,893772,Miller; Elizabeth Deen,0,0,20,20
1746610091772,MCWP 50R,E00,893775,Carter; Andrea L,0,1,20,20
1746610092797,MMW 11R,A01,892721,Herbst; Matthew,14,0,30,16
1746610092797,MMW 11R,A02,892722,Herbst; Matthew,0,0,0,3
1746610093824,MMW 12R,A01,892724,Herbst; Matthew,0,11,16,16
1746610093824,MMW 12R,A02,892725,Herbst; Matthew,0,10,16,16
1746610094850,MMW 13R,A01,892727,Staff,0,4,16,16
1746610094850,MMW 13R,A02,892728,Staff,0,4,16,16
1746610094850,MMW 13R,A03,958032,Staff,0,4,16,16
1746610094850,MMW 13R,A04,958033,Staff,0,4,16,16
1746610094850,MMW 13R,A05,958034,Staff,0,4,16,16
1746610095930,SIO 295LS,A00,894015,Staff,5,0,25,20
1746610096956,SIO 295S,A00,894020,Staff,5,0,25,20
1746610097985,SIOC 290S,B01,958918,Merrifield; Mark A,14,0,30,16
1746610099017,SIOC 291S,B01,958922,Gabriel; Corey John,14,0,30,16
1746610100044,SOCI 117,A01,895339,Staff,2,0,5,3
1746610101072,WES 237B,A00,894149,Staff,11,0,20,9
1746610103144,AESE 279B,A00,891859,Staff,13,0,35,22
1746610104170,AIP 197,001,891854,Vespa; Emanuel Ignacio,9999,0,9999,0
1746610105198,ANTH 289S,A00,891856,Gagneux; Pascal,12,0,12,0
1746610106225,BENG 196,001,957946,Engler; Adam J.,9996,0,9999,3
1746610107252,BISP 197,001,959851,Wilhelm; James E.,9998,0,9999,1
1746610108277,CAT 124RS,A01,956906,Staff,6,0,25,19
1746610109305,CAT 125RS,A01,922013,Staff,6,0,25,19
1746610110333,CLRE 250,A00,891860,Morris; Sheldon,9995,0,9999,4
1746610112386,CLRE 251R,A00,907817,Mehta; Ravindra L.,9994,0,9999,5
1746610113413,CLRE 252,A00,891864,Cuomo; Raphael Eduardo,9993,0,9999,6
1746610114440,CLRE 253,A00,891867,Vaida; Florin,9994,0,9999,5
1746610114440,CLRE 253,B00,907819,Staff,9999,0,9999,0
1746610115469,CLRE 259,A00,891868,Patel; Hemal,9998,0,9999,1
1746610116497,CLRE 260,A00,891872,Cuomo; Raphael Eduardo,9999,0,9999,0
1746610117524,CLRE 297,001,891888,Cuomo; Raphael Eduardo,9999,0,9999,0
1746610118552,CSE 191,A00,958773,Minnes Kemp; Mor Mia,9995,0,9999,4
1746610119581,CSE 197,001,959846,Minnes Kemp; Mor Mia,9990,0,9999,9
1746610120610,CSS 201S,A01,892054,Mignozzetti; Umberto,25,0,30,5
1746610121640,CSS 202S,A01,892056,Mignozzetti; Umberto,25,0,30,5
1746610122670,DSC 197,001,956898,Eldridge; Justin Matthew,9996,0,9999,3
1746610123698,DSC 297,001,958000,Mazumdar; Arya,9998,0,9999,1
1746610123698,DSC 297,002,959862,Wang; Yusu,9998,0,9999,1
1746610124725,EAP 100,A00,905686,Staff,9778,0,9999,221
1746610125754,ECE 45,A01,892618,Staff,0,0,65,65
1746610127808,ECE 111,A01,892719,Staff,6,0,65,59
1746610128837,ECE 197,001,957920,Mercier; Patrick Philip,9991,0,9999,8
1746610129863,ECON 178,A01,907814,Zhu; Ying,26,0,35,9
1746610130888,EDS 115,A00,895312,Staff,35,0,45,10
1746610131916,EDS 117,A01,895337,Staff,23,0,30,7
1746610132944,EDS 125,A00,895341,Jones; Gabrielle Anastasia,36,0,45,9
1746610133972,EDS 128A,A01,895459,Fargason; Sharon Gayle,44,0,45,1
1746610134998,EDS 128B,A01,895543,Pappas; Elizabeth,44,0,45,1
1746610136024,EDS 139,A00,897203,Pappas; Elizabeth,44,0,45,1
1746610136024,EDS 139,B00,897209,Fargason; Sharon Gayle,41,0,45,4
1746610137048,EDS 201,A00,895545,Staff,22,0,45,23
1746610138077,EDS 203,A01,895581,Halter; Christopher P.,22,0,45,23
1746610139107,EDS 204R,A01,895625,Heinzman; Erica M.,39,0,45,6
1746610139107,EDS 204R,B01,895693,Halter; Christopher P.,10,0,45,35
1746610140133,EDS 206R,A00,895694,Fargason; Sharon Gayle,1,0,30,29
1746610140133,EDS 206R,B00,895695,Choi; Bailey Miyeon,16,0,30,14
1746610141163,EDS 250,A00,895697,Hemans; Patricia Ann Benitez,22,0,45,23
1746610142191,EDS 281,A00,895701,Meyerott; Theresa Ann,1,0,15,14
1746610143219,EDS 284,A00,895736,Meyerott; Theresa Ann,1,0,15,14
1746610144246,EDS 286,A00,897210,Fine; Sarah,0,0,15,15
1746610145272,EDS 289C,A01,895770,Daly; Alan J.,1,0,15,14
1746610146299,EDS 290,A00,897211,Hofstetter; Carolyn,0,0,15,15
1746610147330,LIGM 5A,A00,896162,Fischer-Grunski; Eva K,12,0,20,8
1746610148357,LIGM 5B,A00,896260,Fischer-Grunski; Eva K,17,0,20,3
1746610149385,LIGM 5C,A00,896308,Fischer-Grunski; Eva K,18,0,20,2
1746610150411,LIIT 5AS,A00,896313,Carnelos; Chiara,18,0,20,2
1746610151438,LIIT 5BS,A00,896416,Carnelos; Chiara,20,0,20,0
1746610152464,LIIT 5CS,A00,896564,Carnelos; Chiara,20,0,20,0
1746610153496,LISP 5A,A00,896588,Munoz Sanchez; Alicia,2,0,20,18
1746610154524,LISP 5B,A00,896653,Munoz Sanchez; Alicia,7,0,20,13
1746610155553,LISP 5C,A00,896655,Munoz Sanchez; Alicia,0,1,20,20
1746610156582,MAE 197,001,957918,Kleissl; Jan,9996,0,9999,3
1746610156582,MAE 197,002,959806,Boechler; Nicholas Sebastia,9998,0,9999,1
1746610156582,MAE 197,003,959852,Mullin; Jennifer S,9998,0,9999,1
1746610157608,MATH 2,A01,957937,Staff,33,0,35,2
1746610158635,MATH 197,001,957876,Kedlaya; Kiran S.,9993,0,9999,6
1746610159663,MCWP 40,A00,892729,Duru; Nur,10,0,20,10
1746610159663,MCWP 40,B00,893304,Montejo; Carolina,14,0,20,6
1746610160687,MCWP 40R,A00,893757,Redela; Pamela Morgan,0,5,20,20
1746610161715,MCWP 50,A00,893758,Morshed; Michael James,0,0,20,20
1746610161715,MCWP 50,B00,893761,Bartulis; Jason Michael,16,0,20,4
1746610162741,MCWP 50R,A00,893766,Compas; Sean Matthew,0,1,20,20
1746610162741,MCWP 50R,B00,893769,Carter; Jennifer A,0,1,20,20
1746610162741,MCWP 50R,C00,893771,Krone; Jarret,0,3,20,20
1746610162741,MCWP 50R,D00,893772,Miller; Elizabeth Deen,0,0,20,20
1746610162741,MCWP 50R,E00,893775,Carter; Andrea L,0,1,20,20
1746610163767,MMW 11R,A01,892721,Herbst; Matthew,14,0,30,16
1746610163767,MMW 11R,A02,892722,Herbst; Matthew,0,0,0,3
1746610164795,MMW 12R,A01,892724,Herbst; Matthew,0,11,16,16
1746610164795,MMW 12R,A02,892725,Herbst; Matthew,0,10,16,16
1746610165821,MMW 13R,A01,892727,Staff,0,4,16,16
1746610165821,MMW 13R,A02,892728,Staff,0,4,16,16
1746610165821,MMW 13R,A03,958032,Staff,0,4,16,16
1746610165821,MMW 13R,A04,958033,Staff,0,4,16,16
1746610165821,MMW 13R,A05,958034,Staff,0,4,16,16
1746610166847,SIO 295LS,A00,894015,Staff,5,0,25,20
1746610167874,SIO 295S,A00,894020,Staff,5,0,25,20
1746610168902,SIOC 290S,B01,958918,Merrifield; Mark A,14,0,30,16
1746610169929,SIOC 291S,B01,958922,Gabriel; Corey John,14,0,30,16
1746610170959,SOCI 117,A01,895339,Staff,2,0,5,3
1746610171986,WES 237B,A00,894149,Staff,11,0,20,9
1746610174051,AESE 279B,A00,891859,Staff,13,0,35,22
1746610175077,AIP 197,001,891854,Vespa; Emanuel Ignacio,9999,0,9999,0
1746610176103,ANTH 289S,A00,891856,Gagneux; Pascal,12,0,12,0
1746610177129,BENG 196,001,957946,Engler; Adam J.,9996,0,9999,3
1746610178155,BISP 197,001,959851,Wilhelm; James E.,9998,0,9999,1
1746610179182,CAT 124RS,A01,956906,Staff,6,0,25,19
1746610180208,CAT 125RS,A01,922013,Staff,6,0,25,19
1746610181235,CLRE 250,A00,891860,Morris; Sheldon,9995,0,9999,4
1746610183288,CLRE 251R,A00,907817,Mehta; Ravindra L.,9994,0,9999,5
1746610184314,CLRE 252,A00,891864,Cuomo; Raphael Eduardo,9993,0,9999,6
1746610185342,CLRE 253,A00,891867,Vaida; Florin,9994,0,9999,5
1746610185342,CLRE 253,B00,907819,Staff,9999,0,9999,0
1746610186367,CLRE 259,A00,891868,Patel; Hemal,9998,0,9999,1
1746610187395,CLRE 260,A00,891872,Cuomo; Raphael Eduardo,9999,0,9999,0
1746610188421,CLRE 297,001,891888,Cuomo; Raphael Eduardo,9999,0,9999,0
1746610189445,CSE 191,A00,958773,Minnes Kemp; Mor Mia,9995,0,9999,4
1746610190472,CSE 197,001,959846,Minnes Kemp; Mor Mia,9990,0,9999,9
1746610191498,CSS 201S,A01,892054,Mignozzetti; Umberto,25,0,30,5
1746610192528,CSS 202S,A01,892056,Mignozzetti; Umberto,25,0,30,5
1746610193554,DSC 197,001,956898,Eldridge; Justin Matthew,9996,0,9999,3
1746610194580,DSC 297,001,958000,Mazumdar; Arya,9998,0,9999,1
1746610194580,DSC 297,002,959862,Wang; Yusu,9998,0,9999,1
1746610195608,EAP 100,A00,905686,Staff,9778,0,9999,221
1746610196633,ECE 45,A01,892618,Staff,0,0,65,65
1746610198689,ECE 111,A01,892719,Staff,6,0,65,59
1746610199769,ECE 197,001,957920,Mercier; Patrick Philip,9991,0,9999,8
1746610200796,ECON 178,A01,907814,Zhu; Ying,26,0,35,9
1746610201825,EDS 115,A00,895312,Staff,35,0,45,10
1746610202851,EDS 117,A01,895337,Staff,23,0,30,7
1746610203878,EDS 125,A00,895341,Jones; Gabrielle Anastasia,36,0,45,9
1746610204904,EDS 128A,A01,895459,Fargason; Sharon Gayle,44,0,45,1
1746610205929,EDS 128B,A01,895543,Pappas; Elizabeth,44,0,45,1
1746610206956,EDS 139,A00,897203,Pappas; Elizabeth,44,0,45,1
1746610206956,EDS 139,B00,897209,Fargason; Sharon Gayle,41,0,45,4
1746610207985,EDS 201,A00,895545,Staff,22,0,45,23
1746610209013,EDS 203,A01,895581,Halter; Christopher P.,22,0,45,23
1746610210040,EDS 204R,A01,895625,Heinzman; Erica M.,39,0,45,6
1746610210040,EDS 204R,B01,895693,Halter; Christopher P.,10,0,45,35
1746610211066,EDS 206R,A00,895694,Fargason; Sharon Gayle,1,0,30,29
1746610211066,EDS 206R,B00,895695,Choi; Bailey Miyeon,16,0,30,14
1746610212093,EDS 250,A00,895697,Hemans; Patricia Ann Benitez,22,0,45,23
1746610213118,EDS 281,A00,895701,Meyerott; Theresa Ann,1,0,15,14
1746610214150,EDS 284,A00,895736,Meyerott; Theresa Ann,1,0,15,14
1746610215176,EDS 286,A00,897210,Fine; Sarah,0,0,15,15
1746610216202,EDS 289C,A01,895770,Daly; Alan J.,1,0,15,14
1746610217229,EDS 290,A00,897211,Hofstetter; Carolyn,0,0,15,15
1746610218258,LIGM 5A,A00,896162,Fischer-Grunski; Eva K,12,0,20,8
1746610219285,LIGM 5B,A00,896260,Fischer-Grunski; Eva K,17,0,20,3
1746610220312,LIGM 5C,A00,896308,Fischer-Grunski; Eva K,18,0,20,2
1746610221338,LIIT 5AS,A00,896313,Carnelos; Chiara,18,0,20,2
1746610222363,LIIT 5BS,A00,896416,Carnelos; Chiara,20,0,20,0
1746610223388,LIIT 5CS,A00,896564,Carnelos; Chiara,20,0,20,0
1746610224414,LISP 5A,A00,896588,Munoz Sanchez; Alicia,2,0,20,18
1746610225440,LISP 5B,A00,896653,Munoz Sanchez; Alicia,7,0,20,13
1746610226467,LISP 5C,A00,896655,Munoz Sanchez; Alicia,0,1,20,20
1746610227495,MAE 197,001,957918,Kleissl; Jan,9996,0,9999,3
1746610227495,MAE 197,002,959806,Boechler; Nicholas Sebastia,9998,0,9999,1
1746610227495,MAE 197,003,959852,Mullin; Jennifer S,9998,0,9999,1
1746610228520,MATH 2,A01,957937,Staff,33,0,35,2
1746610229549,MATH 197,001,957876,Kedlaya; Kiran S.,9993,0,9999,6
1746610230575,MCWP 40,A00,892729,Duru; Nur,10,0,20,10
1746610230575,MCWP 40,B00,893304,Montejo; Carolina,14,0,20,6
1746610231601,MCWP 40R,A00,893757,Redela; Pamela Morgan,0,5,20,20
1746610232630,MCWP 50,A00,893758,Morshed; Michael James,0,0,20,20
1746610232630,MCWP 50,B00,893761,Bartulis; Jason Michael,16,0,20,4
1746610233659,MCWP 50R,A00,893766,Compas; Sean Matthew,0,1,20,20
1746610233659,MCWP 50R,B00,893769,Carter; Jennifer A,0,1,20,20
1746610233659,MCWP 50R,C00,893771,Krone; Jarret,0,3,20,20
1746610233659,MCWP 50R,D00,893772,Miller; Elizabeth Deen,0,0,20,20
1746610233659,MCWP 50R,E00,893775,Carter; Andrea L,0,1,20,20
1746610234687,MMW 11R,A01,892721,Herbst; Matthew,14,0,30,16
1746610234687,MMW 11R,A02,892722,Herbst; Matthew,0,0,0,3
1746610235713,MMW 12R,A01,892724,Herbst; Matthew,0,11,16,16
1746610235713,MMW 12R,A02,892725,Herbst; Matthew,0,10,16,16
1746610236738,MMW 13R,A01,892727,Staff,0,4,16,16
1746610236738,MMW 13R,A02,892728,Staff,0,4,16,16
1746610236738,MMW 13R,A03,958032,Staff,0,4,16,16
1746610236738,MMW 13R,A04,958033,Staff,0,4,16,16
1746610236738,MMW 13R,A05,958034,Staff,0,4,16,16
1746610237764,SIO 295LS,A00,894015,Staff,5,0,25,20
1746610238792,SIO 295S,A00,894020,Staff,5,0,25,20
1746610239823,SIOC 290S,B01,958918,Merrifield; Mark A,14,0,30,16
1746610240851,SIOC 291S,B01,958922,Gabriel; Corey John,14,0,30,16
1746610241877,SOCI 117,A01,895339,Staff,2,0,5,3
1746610242903,WES 237B,A00,894149,Staff,11,0,20,9
1746610244982,AESE 279B,A00,891859,Staff,13,0,35,22
1746610246010,AIP 197,001,891854,Vespa; Emanuel Ignacio,9999,0,9999,0
1746610247036,ANTH 289S,A00,891856,Gagneux; Pascal,12,0,12,0
1746610248062,BENG 196,001,957946,Engler; Adam J.,9996,0,9999,3
1746610249091,BISP 197,001,959851,Wilhelm; James E.,9998,0,9999,1
1746610250117,CAT 124RS,A01,956906,Staff,6,0,25,19
1746610251142,CAT 125RS,A01,922013,Staff,6,0,25,19
1746610252170,CLRE 250,A00,891860,Morris; Sheldon,9995,0,9999,4
1746610254226,CLRE 251R,A00,907817,Mehta; Ravindra L.,9994,0,9999,5
1746610255256,CLRE 252,A00,891864,Cuomo; Raphael Eduardo,9993,0,9999,6
1746610256281,CLRE 253,A00,891867,Vaida; Florin,9994,0,9999,5
1746610256281,CLRE 253,B00,907819,Staff,9999,0,9999,0
1746610257309,CLRE 259,A00,891868,Patel; Hemal,9998,0,9999,1
1746610258338,CLRE 260,A00,891872,Cuomo; Raphael Eduardo,9999,0,9999,0
1746610259366,CLRE 297,001,891888,Cuomo; Raphael Eduardo,9999,0,9999,0
1746610260393,CSE 191,A00,958773,Minnes Kemp; Mor Mia,9995,0,9999,4
1746610261417,CSE 197,001,959846,Minnes Kemp; Mor Mia,9990,0,9999,9
1746610262444,CSS 201S,A01,892054,Mignozzetti; Umberto,25,0,30,5
1746610263471,CSS 202S,A01,892056,Mignozzetti; Umberto,25,0,30,5
1746610264498,DSC 197,001,956898,Eldridge; Justin Matthew,9996,0,9999,3
1746610265529,DSC 297,001,958000,Mazumdar; Arya,9998,0,9999,1
1746610265529,DSC 297,002,959862,Wang; Yusu,9998,0,9999,1
1746610266555,EAP 100,A00,905686,Staff,9778,0,9999,221
1746610267582,ECE 45,A01,892618,Staff,0,0,65,65
1746610269635,ECE 111,A01,892719,Staff,6,0,65,59
1746610270663,ECE 197,001,957920,Mercier; Patrick Philip,9991,0,9999,8
1746610271694,ECON 178,A01,907814,Zhu; Ying,26,0,35,9
1746610272720,EDS 115,A00,895312,Staff,35,0,45,10
1746610273748,EDS 117,A01,895337,Staff,23,0,30,7
1746610274776,EDS 125,A00,895341,Jones; Gabrielle Anastasia,36,0,45,9
1746610275801,EDS 128A,A01,895459,Fargason; Sharon Gayle,44,0,45,1
1746610276827,EDS 128B,A01,895543,Pappas; Elizabeth,44,0,45,1
1746610277856,EDS 139,A00,897203,Pappas; Elizabeth,44,0,45,1
1746610277856,EDS 139,B00,897209,Fargason; Sharon Gayle,41,0,45,4
1746610278882,EDS 201,A00,895545,Staff,22,0,45,23
1746610279911,EDS 203,A01,895581,Halter; Christopher P.,22,0,45,23
1746610280940,EDS 204R,A01,895625,Heinzman; Erica M.,39,0,45,6
1746610280940,EDS 204R,B01,895693,Halter; Christopher P.,10,0,45,35
1746610281968,EDS 206R,A00,895694,Fargason; Sharon Gayle,1,0,30,29
1746610281968,EDS 206R,B00,895695,Choi; Bailey Miyeon,16,0,30,14
1746610282995,EDS 250,A00,895697,Hemans; Patricia Ann Benitez,22,0,45,23
1746610284022,EDS 281,A00,895701,Meyerott; Theresa Ann,1,0,15,14
1746610285051,EDS 284,A00,895736,Meyerott; Theresa Ann,1,0,15,14
1746610286081,EDS 286,A00,897210,Fine; Sarah,0,0,15,15
1746610287109,EDS 289C,A01,895770,Daly; Alan J.,1,0,15,14
1746610288136,EDS 290,A00,897211,Hofstetter; Carolyn,0,0,15,15
1746610289163,LIGM 5A,A00,896162,Fischer-Grunski; Eva K,12,0,20,8
1746610290192,LIGM 5B,A00,896260,Fischer-Grunski; Eva K,17,0,20,3
1746610291220,LIGM 5C,A00,896308,Fischer-Grunski; Eva K,18,0,20,2
1746610292249,LIIT 5AS,A00,896313,Carnelos; Chiara,18,0,20,2
1746610293275,LIIT 5BS,A00,896416,Carnelos; Chiara,20,0,20,0
1746610294300,LIIT 5CS,A00,896564,Carnelos; Chiara,20,0,20,0
1746610295325,LISP 5A,A00,896588,Munoz Sanchez; Alicia,2,0,20,18
1746610296350,LISP 5B,A00,896653,Munoz Sanchez; Alicia,7,0,20,13
1746610297374,LISP 5C,A00,896655,Munoz Sanchez; Alicia,0,1,20,20
1746610298403,MAE 197,001,957918,Kleissl; Jan,9996,0,9999,3
1746610298403,MAE 197,002,959806,Boechler; Nicholas Sebastia,9998,0,9999,1
1746610298403,MAE 197,003,959852,Mullin; Jennifer S,9998,0,9999,1
1746610299432,MATH 2,A01,957937,Staff,33,0,35,2
1746610300456,MATH 197,001,957876,Kedlaya; Kiran S.,9993,0,9999,6
1746610301482,MCWP 40,A00,892729,Duru; Nur,10,0,20,10
1746610301482,MCWP 40,B00,893304,Montejo; Carolina,14,0,20,6
1746610302509,MCWP 40R,A00,893757,Redela; Pamela Morgan,0,5,20,20
1746610303590,MCWP 50,A00,893758,Morshed; Michael James,0,0,20,20
1746610303590,MCWP 50,B00,893761,Bartulis; Jason Michael,16,0,20,4
1746610304615,MCWP 50R,A00,893766,Compas; Sean Matthew,0,1,20,20
1746610304615,MCWP 50R,B00,893769,Carter; Jennifer A,0,1,20,20
1746610304615,MCWP 50R,C00,893771,Krone; Jarret,0,3,20,20
1746610304615,MCWP 50R,D00,893772,Miller; Elizabeth Deen,0,0,20,20
1746610304615,MCWP 50R,E00,893775,Carter; Andrea L,0,1,20,20
1746610305645,MMW 11R,A01,892721,Herbst; Matthew,14,0,30,16
1746610305645,MMW 11R,A02,892722,Herbst; Matthew,0,0,0,3
1746610306671,MMW 12R,A01,892724,Herbst; Matthew,0,11,16,16
1746610306671,MMW 12R,A02,892725,Herbst; Matthew,0,10,16,16
1746610307697,MMW 13R,A01,892727,Staff,0,4,16,16
1746610307697,MMW 13R,A02,892728,Staff,0,4,16,16
1746610307697,MMW 13R,A03,958032,Staff,0,4,16,16
1746610307697,MMW 13R,A04,958033,Staff,0,4,16,16
1746610307697,MMW 13R,A05,958034,Staff,0,4,16,16
1746610308726,SIO 295LS,A00,894015,Staff,5,0,25,20
1746610309754,SIO 295S,A00,894020,Staff,5,0,25,20
1746610310783,SIOC 290S,B01,958918,Merrifield; Mark A,14,0,30,16
1746610311813,SIOC 291S,B01,958922,Gabriel; Corey John,14,0,30,16
1746610312842,SOCI 117,A01,895339,Staff,2,0,5,3
1746610313870,WES 237B,A00,894149,Staff,11,0,20,9
1746610315933,AESE 279B,A00,891859,Staff,13,0,35,22
1746610316959,AIP 197,001,891854,Vespa; Emanuel Ignacio,9999,0,9999,0
1746610317984,ANTH 289S,A00,891856,Gagneux; Pascal,12,0,12,0
1746610319012,BENG 196,001,957946,Engler; Adam J.,9996,0,9999,3
1746610320041,BISP 197,001,959851,Wilhelm; James E.,9998,0,9999,1
1746610321068,CAT 124RS,A01,956906,Staff,6,0,25,19
1746610322094,CAT 125RS,A01,922013,Staff,6,0,25,19
1746610323124,CLRE 250,A00,891860,Morris; Sheldon,9995,0,9999,4
1746610325175,CLRE 251R,A00,907817,Mehta; Ravindra L.,9994,0,9999,5
1746610326202,CLRE 252,A00,891864,Cuomo; Raphael Eduardo,9993,0,9999,6
1746610327226,CLRE 253,A00,891867,Vaida; Florin,9994,0,9999,5
1746610327226,CLRE 253,B00,907819,Staff,9999,0,9999,0
1746610328252,CLRE 259,A00,891868,Patel; Hemal,9998,0,9999,1
1746610329279,CLRE 260,A00,891872,Cuomo; Raphael Eduardo,9999,0,9999,0
1746610330306,CLRE 297,001,891888,Cuomo; Raphael Eduardo,9999,0,9999,0
1746610331333,CSE 191,A00,958773,Minnes Kemp; Mor Mia,9995,0,9999,4
1746610332363,CSE 197,001,959846,Minnes Kemp; Mor Mia,9990,0,9999,9
1746610333389,CSS 201S,A01,892054,Mignozzetti; Umberto,25,0,30,5
1746610334417,CSS 202S,A01,892056,Mignozzetti; Umberto,25,0,30,5
1746610335443,DSC 197,001,956898,Eldridge; Justin Matthew,9996,0,9999,3
1746610336472,DSC 297,001,958000,Mazumdar; Arya,9998,0,9999,1
1746610336472,DSC 297,002,959862,Wang; Yusu,9998,0,9999,1
1746610337499,EAP 100,A00,905686,Staff,9778,0,9999,221
1746610338528,ECE 45,A01,892618,Staff,0,0,65,65
1746610340586,ECE 111,A01,892719,Staff,6,0,65,59
1746610341612,ECE 197,001,957920,Mercier; Patrick Philip,9991,0,9999,8
1746610342641,ECON 178,A01,907814,Zhu; Ying,26,0,35,9
1746610343667,EDS 115,A00,895312,Staff,35,0,45,10
1746610344695,EDS 117,A01,895337,Staff,23,0,30,7
1746610345724,EDS 125,A00,895341,Jones; Gabrielle Anastasia,36,0,45,9
1746610346750,EDS 128A,A01,895459,Fargason; Sharon Gayle,44,0,45,1
1746610347775,EDS 128B,A01,895543,Pappas; Elizabeth,44,0,45,1
1746610348801,EDS 139,A00,897203,Pappas; Elizabeth,44,0,45,1
1746610348801,EDS 139,B00,897209,Fargason; Sharon Gayle,41,0,45,4
1746610349827,EDS 201,A00,895545,Staff,22,0,45,23
1746610350853,EDS 203,A01,895581,Halter; Christopher P.,22,0,45,23
1746610351880,EDS 204R,A01,895625,Heinzman; Erica M.,39,0,45,6
1746610351880,EDS 204R,B01,895693,Halter; Christopher P.,10,0,45,35
1746610352906,EDS 206R,A00,895694,Fargason; Sharon Gayle,1,0,30,29
1746610352906,EDS 206R,B00,895695,Choi; Bailey Miyeon,16,0,30,14
1746610353932,EDS 250,A00,895697,Hemans; Patricia Ann Benitez,22,0,45,23
1746610354961,EDS 281,A00,895701,Meyerott; Theresa Ann,1,0,15,14
1746610355989,EDS 284,A00,895736,Meyerott; Theresa Ann,1,0,15,14
1746610357016,EDS 286,A00,897210,Fine; Sarah,0,0,15,15
1746610358042,EDS 289C,A01,895770,Daly; Alan J.,1,0,15,14
1746610359074,EDS 290,A00,897211,Hofstetter; Carolyn,0,0,15,15
1746610360101,LIGM 5A,A00,896162,Fischer-Grunski; Eva K,12,0,20,8
1746610361127,LIGM 5B,A00,896260,Fischer-Grunski; Eva K,17,0,20,3
1746610362153,LIGM 5C,A00,896308,Fischer-Grunski; Eva K,18,0,20,2
1746610363182,LIIT 5AS,A00,896313,Carnelos; Chiara,18,0,20,2
1746610364208,LIIT 5BS,A00,896416,Carnelos; Chiara,20,0,20,0
1746610365240,LIIT 5CS,A00,896564,Carnelos; Chiara,20,0,20,0
1746610366270,LISP 5A,A00,896588,Munoz Sanchez; Alicia,2,0,20,18
1746610367295,LISP 5B,A00,896653,Munoz Sanchez; Alicia,7,0,20,13
1746610368323,LISP 5C,A00,896655,Munoz Sanchez; Alicia,0,1,20,20
1746610369353,MAE 197,001,957918,Kleissl; Jan,9996,0,9999,3
1746610369353,MAE 197,002,959806,Boechler; Nicholas Sebastia,9998,0,9999,1
1746610369353,MAE 197,003,959852,Mullin; Jennifer S,9998,0,9999,1
1746610370378,MATH 2,A01,957937,Staff,33,0,35,2
1746610371407,MATH 197,001,957876,Kedlaya; Kiran S.,9993,0,9999,6
1746610372434,MCWP 40,A00,892729,Duru; Nur,10,0,20,10
1746610372434,MCWP 40,B00,893304,Montejo; Carolina,14,0,20,6
1746610373462,MCWP 40R,A00,893757,Redela; Pamela Morgan,0,5,20,20
1746610374491,MCWP 50,A00,893758,Morshed; Michael James,0,0,20,20
1746610374491,MCWP 50,B00,893761,Bartulis; Jason Michael,16,0,20,4
1746610375520,MCWP 50R,A00,893766,Compas; Sean Matthew,0,1,20,20
1746610375520,MCWP 50R,B00,893769,Carter; Jennifer A,0,1,20,20
1746610375520,MCWP 50R,C00,893771,Krone; Jarret,0,3,20,20
1746610375520,MCWP 50R,D00,893772,Miller; Elizabeth Deen,0,0,20,20
1746610375520,MCWP 50R,E00,893775,Carter; Andrea L,0,1,20,20
1746610376545,MMW 11R,A01,892721,Herbst; Matthew,14,0,30,16
1746610376545,MMW 11R,A02,892722,Herbst; Matthew,0,0,0,3
1746610377572,MMW 12R,A01,892724,Herbst; Matthew,0,11,16,16
1746610377572,MMW 12R,A02,892725,Herbst; Matthew,0,10,16,16
1746610378601,MMW 13R,A01,892727,Staff,0,4,16,16
1746610378601,MMW 13R,A02,892728,Staff,0,4,16,16
1746610378601,MMW 13R,A03,958032,Staff,0,4,16,16
1746610378601,MMW 13R,A04,958033,Staff,0,4,16,16
1746610378601,MMW 13R,A05,958034,Staff,0,4,16,16
1746610379627,SIO 295LS,A00,894015,Staff,5,0,25,20
1746610380655,SIO 295S,A00,894020,Staff,5,0,25,20
1746610381687,SIOC 290S,B01,958918,Merrifield; Mark A,14,0,30,16
1746610382714,SIOC 291S,B01,958922,Gabriel; Corey John,14,0,30,16
1746610383742,SOCI 117,A01,895339,Staff,2,0,5,3
1746610384770,WES 237B,A00,894149,Staff,11,0,20,9
1746610386844,AESE 279B,A00,891859,Staff,13,0,35,22
1746610387869,AIP 197,001,891854,Vespa; Emanuel Ignacio,9999,0,9999,0
1746610388896,ANTH 289S,A00,891856,Gagneux; Pascal,12,0,12,0
1746610389925,BENG 196,001,957946,Engler; Adam J.,9996,0,9999,3
1746610390953,BISP 197,001,959851,Wilhelm; James E.,9998,0,9999,1
1746610391982,CAT 124RS,A01,956906,Staff,6,0,25,19
1746610393010,CAT 125RS,A01,922013,Staff,6,0,25,19
1746610394038,CLRE 250,A00,891860,Morris; Sheldon,9995,0,9999,4
1746610396092,CLRE 251R,A00,907817,Mehta; Ravindra L.,9994,0,9999,5
1746610397118,CLRE 252,A00,891864,Cuomo; Raphael Eduardo,9993,0,9999,6
1746610398144,CLRE 253,A00,891867,Vaida; Florin,9994,0,9999,5
1746610398144,CLRE 253,B00,907819,Staff,9999,0,9999,0
1746610399169,CLRE 259,A00,891868,Patel; Hemal,9998,0,9999,1
1746610400197,CLRE 260,A00,891872,Cuomo; Raphael Eduardo,9999,0,9999,0
1746610401223,CLRE 297,001,891888,Cuomo; Raphael Eduardo,9999,0,9999,0
1746610402248,CSE 191,A00,958773,Minnes Kemp; Mor Mia,9995,0,9999,4
1746610403273,CSE 197,001,959846,Minnes Kemp; Mor Mia,9990,0,9999,9
1746610404298,CSS 201S,A01,892054,Mignozzetti; Umberto,25,0,30,5
1746610405325,CSS 202S,A01,892056,Mignozzetti; Umberto,25,0,30,5
1746610406353,DSC 197,001,956898,Eldridge; Justin Matthew,9996,0,9999,3
1746610407436,DSC 297,001,958000,Mazumdar; Arya,9998,0,9999,1
1746610407436,DSC 297,002,959862,Wang; Yusu,9998,0,9999,1
1746610408461,EAP 100,A00,905686,Staff,9778,0,9999,221
1746610409488,ECE 45,A01,892618,Staff,0,0,65,65
1746610411543,ECE 111,A01,892719,Staff,6,0,65,59
1746610412573,ECE 197,001,957920,Mercier; Patrick Philip,9991,0,9999,8
1746610413604,ECON 178,A01,907814,Zhu; Ying,26,0,35,9
1746610414629,EDS 115,A00,895312,Staff,35,0,45,10
1746610415658,EDS 117,A01,895337,Staff,23,0,30,7
1746610416684,EDS 125,A00,895341,Jones; Gabrielle Anastasia,36,0,45,9
1746610417712,EDS 128A,A01,895459,Fargason; Sharon Gayle,44,0,45,1
1746610418739,EDS 128B,A01,895543,Pappas; Elizabeth,44,0,45,1
1746610419768,EDS 139,A00,897203,Pappas; Elizabeth,44,0,45,1
1746610419768,EDS 139,B00,897209,Fargason; Sharon Gayle,41,0,45,4
1746610420795,EDS 201,A00,895545,Staff,22,0,45,23
1746610421822,EDS 203,A01,895581,Halter; Christopher P.,22,0,45,23
1746610422848,EDS 204R,A01,895625,Heinzman; Erica M.,39,0,45,6
1746610422848,EDS 204R,B01,895693,Halter; Christopher P.,10,0,45,35
1746610423877,EDS 206R,A00,895694,Fargason; Sharon Gayle,1,0,30,29
1746610423877,EDS 206R,B00,895695,Choi; Bailey Miyeon,16,0,30,14
1746610424903,EDS 250,A00,895697,Hemans; Patricia Ann Benitez,22,0,45,23
1746610425932,EDS 281,A00,895701,Meyerott; Theresa Ann,1,0,15,14
1746610426960,EDS 284,A00,895736,Meyerott; Theresa Ann,1,0,15,14
1746610427988,EDS 286,A00,897210,Fine; Sarah,0,0,15,15
1746610429018,EDS 289C,A01,895770,Daly; Alan J.,1,0,15,14
1746610430043,EDS 290,A00,897211,Hofstetter; Carolyn,0,0,15,15
1746610431070,LIGM 5A,A00,896162,Fischer-Grunski; Eva K,12,0,20,8
1746610432099,LIGM 5B,A00,896260,Fischer-Grunski; Eva K,17,0,20,3
1746610433125,LIGM 5C,A00,896308,Fischer-Grunski; Eva K,18,0,20,2
1746610434154,LIIT 5AS,A00,896313,Carnelos; Chiara,18,0,20,2
1746610435181,LIIT 5BS,A00,896416,Carnelos; Chiara,20,0,20,0
1746610436207,LIIT 5CS,A00,896564,Carnelos; Chiara,20,0,20,0
1746610437233,LISP 5A,A00,896588,Munoz Sanchez; Alicia,2,0,20,18
1746610438262,LISP 5B,A00,896653,Munoz Sanchez; Alicia,7,0,20,13
1746610439291,LISP 5C,A00,896655,Munoz Sanchez; Alicia,0,1,20,20
1746610440321,MAE 197,001,957918,Kleissl; Jan,9996,0,9999,3
1746610440321,MAE 197,002,959806,Boechler; Nicholas Sebastia,9998,0,9999,1
1746610440321,MAE 197,003,959852,Mullin; Jennifer S,9998,0,9999,1
1746610441362,MATH 2,A01,957937,Staff,33,0,35,2
1746610442392,MATH 197,001,957876,Kedlaya; Kiran S.,9993,0,9999,6
1746610443422,MCWP 40,A00,892729,Duru; Nur,10,0,20,10
1746610443422,MCWP 40,B00,893304,Montejo; Carolina,14,0,20,6
1746610444452,MCWP 40R,A00,893757,Redela; Pamela Morgan,0,5,20,20
1746610445481,MCWP 50,A00,893758,Morshed; Michael James,0,0,20,20
1746610445481,MCWP 50,B00,893761,Bartulis; Jason Michael,16,0,20,4
1746610446507,MCWP 50R,A00,893766,Compas; Sean Matthew,0,1,20,20
1746610446507,MCWP 50R,B00,893769,Carter; Jennifer A,0,1,20,20
1746610446507,MCWP 50R,C00,893771,Krone; Jarret,0,3,20,20
1746610446507,MCWP 50R,D00,893772,Miller; Elizabeth Deen,0,0,20,20
1746610446507,MCWP 50R,E00,893775,Carter; Andrea L,0,1,20,20
1746610447534,MMW 11R,A01,892721,Herbst; Matthew,14,0,30,16
1746610447534,MMW 11R,A02,892722,Herbst; Matthew,0,0,0,3
1746610448562,MMW 12R,A01,892724,Herbst; Matthew,0,11,16,16
1746610448562,MMW 12R,A02,892725,Herbst; Matthew,0,10,16,16
1746610449589,MMW 13R,A01,892727,Staff,0,4,16,16
1746610449589,MMW 13R,A02,892728,Staff,0,4,16,16
1746610449589,MMW 13R,A03,958032,Staff,0,4,16,16
1746610449589,MMW 13R,A04,958033,Staff,0,4,16,16
1746610449589,MMW 13R,A05,958034,Staff,0,4,16,16
1746610450618,SIO 295LS,A00,894015,Staff,5,0,25,20
1746610451645,SIO 295S,A00,894020,Staff,5,0,25,20
1746610452671,SIOC 290S,B01,958918,Merrifield; Mark A,14,0,30,16
1746610453696,SIOC 291S,B01,958922,Gabriel; Corey John,14,0,30,16
1746610454720,SOCI 117,A01,895339,Staff,2,0,5,3
1746610455746,WES 237B,A00,894149,Staff,11,0,20,9
1746610457814,AESE 279B,A00,891859,Staff,13,0,35,22
1746610458840,AIP 197,001,891854,Vespa; Emanuel Ignacio,9999,0,9999,0
1746610459868,ANTH 289S,A00,891856,Gagneux; Pascal,12,0,12,0
1746610460894,BENG 196,001,957946,Engler; Adam J.,9996,0,9999,3
1746610461921,BISP 197,001,959851,Wilhelm; James E.,9998,0,9999,1
1746610462946,CAT 124RS,A01,956906,Staff,6,0,25,19
1746610463971,CAT 125RS,A01,922013,Staff,6,0,25,19
1746610465000,CLRE 250,A00,891860,Morris; Sheldon,9995,0,9999,4
1746610467055,CLRE 251R,A00,907817,Mehta; Ravindra L.,9994,0,9999,5
1746610468080,CLRE 252,A00,891864,Cuomo; Raphael Eduardo,9993,0,9999,6
1746610469108,CLRE 253,A00,891867,Vaida; Florin,9994,0,9999,5
1746610469108,CLRE 253,B00,907819,Staff,9999,0,9999,0
1746610470134,CLRE 259,A00,891868,Patel; Hemal,9998,0,9999,1
1746610471160,CLRE 260,A00,891872,Cuomo; Raphael Eduardo,9999,0,9999,0
1746610472188,CLRE 297,001,891888,Cuomo; Raphael Eduardo,9999,0,9999,0
1746610473216,CSE 191,A00,958773,Minnes Kemp; Mor Mia,9995,0,9999,4
1746610474241,CSE 197,001,959846,Minnes Kemp; Mor Mia,9990,0,9999,9
1746610475271,CSS 201S,A01,892054,Mignozzetti; Umberto,25,0,30,5
1746610476301,CSS 202S,A01,892056,Mignozzetti; Umberto,25,0,30,5
1746610477326,DSC 197,001,956898,Eldridge; Justin Matthew,9996,0,9999,3
1746610478354,DSC 297,001,958000,Mazumdar; Arya,9998,0,9999,1
1746610478354,DSC 297,002,959862,Wang; Yusu,9998,0,9999,1
1746610479380,EAP 100,A00,905686,Staff,9778,0,9999,221
1746610480407,ECE 45,A01,892618,Staff,0,0,65,65
1746610482459,ECE 111,A01,892719,Staff,6,0,65,59
1746610483484,ECE 197,001,957920,Mercier; Patrick Philip,9991,0,9999,8
1746610484510,ECON 178,A01,907814,Zhu; Ying,26,0,35,9
1746610485540,EDS 115,A00,895312,Staff,35,0,45,10
1746610486565,EDS 117,A01,895337,Staff,23,0,30,7
1746610487595,EDS 125,A00,895341,Jones; Gabrielle Anastasia,36,0,45,9
1746610488625,EDS 128A,A01,895459,Fargason; Sharon Gayle,44,0,45,1
1746610489650,EDS 128B,A01,895543,Pappas; Elizabeth,44,0,45,1
1746610490680,EDS 139,A00,897203,Pappas; Elizabeth,44,0,45,1
1746610490680,EDS 139,B00,897209,Fargason; Sharon Gayle,41,0,45,4
1746610491707,EDS 201,A00,895545,Staff,22,0,45,23
1746610492734,EDS 203,A01,895581,Halter; Christopher P.,22,0,45,23
1746610493763,EDS 204R,A01,895625,Heinzman; Erica M.,39,0,45,6
1746610493763,EDS 204R,B01,895693,Halter; Christopher P.,10,0,45,35
1746610494790,EDS 206R,A00,895694,Fargason; Sharon Gayle,1,0,30,29
1746610494790,EDS 206R,B00,895695,Choi; Bailey Miyeon,16,0,30,14
1746610495815,EDS 250,A00,895697,Hemans; Patricia Ann Benitez,22,0,45,23
1746610496841,EDS 281,A00,895701,Meyerott; Theresa Ann,1,0,15,14
1746610497869,EDS 284,A00,895736,Meyerott; Theresa Ann,1,0,15,14
1746610498895,EDS 286,A00,897210,Fine; Sarah,0,0,15,15
1746610499920,EDS 289C,A01,895770,Daly; Alan J.,1,0,15,14
1746610500948,EDS 290,A00,897211,Hofstetter; Carolyn,0,0,15,15
1746610501979,LIGM 5A,A00,896162,Fischer-Grunski; Eva K,12,0,20,8
1746610503011,LIGM 5B,A00,896260,Fischer-Grunski; Eva K,17,0,20,3
1746610504042,LIGM 5C,A00,896308,Fischer-Grunski; Eva K,18,0,20,2
1746610505070,LIIT 5AS,A00,896313,Carnelos; Chiara,18,0,20,2
1746610506095,LIIT 5BS,A00,896416,Carnelos; Chiara,20,0,20,0
1746610507123,LIIT 5CS,A00,896564,Carnelos; Chiara,20,0,20,0
1746610508149,LISP 5A,A00,896588,Munoz Sanchez; Alicia,2,0,20,18
1746610509180,LISP 5B,A00,896653,Munoz Sanchez; Alicia,7,0,20,13
1746610510207,LISP 5C,A00,896655,Munoz Sanchez; Alicia,0,1,20,20
1746610511294,MAE 197,001,957918,Kleissl; Jan,9996,0,9999,3
1746610511294,MAE 197,002,959806,Boechler; Nicholas Sebastia,9998,0,9999,1
1746610511294,MAE 197,003,959852,Mullin; Jennifer S,9998,0,9999,1
1746610512320,MATH 2,A01,957937,Staff,33,0,35,2
1746610513348,MATH 197,001,957876,Kedlaya; Kiran S.,9993,0,9999,6
1746610514374,MCWP 40,A00,892729,Duru; Nur,10,0,20,10
1746610514374,MCWP 40,B00,893304,Montejo; Carolina,14,0,20,6
1746610515405,MCWP 40R,A00,893757,Redela; Pamela Morgan,0,5,20,20
1746610516431,MCWP 50,A00,893758,Morshed; Michael James,0,0,20,20
1746610516431,MCWP 50,B00,893761,Bartulis; Jason Michael,16,0,20,4
1746610517458,MCWP 50R,A00,893766,Compas; Sean Matthew,0,1,20,20
1746610517458,MCWP 50R,B00,893769,Carter; Jennifer A,0,1,20,20
1746610517458,MCWP 50R,C00,893771,Krone; Jarret,0,3,20,20
1746610517458,MCWP 50R,D00,893772,Miller; Elizabeth Deen,0,0,20,20
1746610517458,MCWP 50R,E00,893775,Carter; Andrea L,0,1,20,20
1746610518488,MMW 11R,A01,892721,Herbst; Matthew,14,0,30,16
1746610518488,MMW 11R,A02,892722,Herbst; Matthew,0,0,0,3
1746610519513,MMW 12R,A01,892724,Herbst; Matthew,0,11,16,16
1746610519513,MMW 12R,A02,892725,Herbst; Matthew,0,10,16,16
1746610520541,MMW 13R,A01,892727,Staff,0,4,16,16
1746610520541,MMW 13R,A02,892728,Staff,0,4,16,16
1746610520541,MMW 13R,A03,958032,Staff,0,4,16,16
1746610520541,MMW 13R,A04,958033,Staff,0,4,16,16
1746610520541,MMW 13R,A05,958034,Staff,0,4,16,16
1746610521569,SIO 295LS,A00,894015,Staff,5,0,25,20
1746610522594,SIO 295S,A00,894020,Staff,5,0,25,20
1746610523624,SIOC 290S,B01,958918,Merrifield; Mark A,14,0,30,16
1746610524655,SIOC 291S,B01,958922,Gabriel; Corey John,14,0,30,16
1746610525683,SOCI 117,A01,895339,Staff,2,0,5,3
1746610526710,WES 237B,A00,894149,Staff,11,0,20,9
1746610528772,AESE 279B,A00,891859,Staff,13,0,35,22
1746610529797,AIP 197,001,891854,Vespa; Emanuel Ignacio,9999,0,9999,0
1746610530822,ANTH 289S,A00,891856,Gagneux; Pascal,12,0,12,0
1746610531850,BENG 196,001,957946,Engler; Adam J.,9996,0,9999,3
1746610532879,BISP 197,001,959851,Wilhelm; James E.,9998,0,9999,1
1746610533905,CAT 124RS,A01,956906,Staff,6,0,25,19
1746610534934,CAT 125RS,A01,922013,Staff,6,0,25,19
1746610535963,CLRE 250,A00,891860,Morris; Sheldon,9995,0,9999,4
1746610538023,CLRE 251R,A00,907817,Mehta; Ravindra L.,9994,0,9999,5
1746610539048,CLRE 252,A00,891864,Cuomo; Raphael Eduardo,9993,0,9999,6
1746610540077,CLRE 253,A00,891867,Vaida; Florin,9994,0,9999,5
1746610540077,CLRE 253,B00,907819,Staff,9999,0,9999,0
1746610541106,CLRE 259,A00,891868,Patel; Hemal,9998,0,9999,1
1746610542131,CLRE 260,A00,891872,Cuomo; Raphael Eduardo,9999,0,9999,0
1746610543159,CLRE 297,001,891888,Cuomo; Raphael Eduardo,9999,0,9999,0
1746610544187,CSE 191,A00,958773,Minnes Kemp; Mor Mia,9995,0,9999,4
1746610545213,CSE 197,001,959846,Minnes Kemp; Mor Mia,9990,0,9999,9
1746610546278,CSS 201S,A01,892054,Mignozzetti; Umberto,25,0,30,5
1746610547306,CSS 202S,A01,892056,Mignozzetti; Umberto,25,0,30,5
1746610548336,DSC 197,001,956898,Eldridge; Justin Matthew,9996,0,9999,3
1746610549365,DSC 297,001,958000,Mazumdar; Arya,9998,0,9999,1
1746610549365,DSC 297,002,959862,Wang; Yusu,9998,0,9999,1
1746610550391,EAP 100,A00,905686,Staff,9778,0,9999,221
1746610551421,ECE 45,A01,892618,Staff,0,0,65,65
1746610553479,ECE 111,A01,892719,Staff,6,0,65,59
1746610554506,ECE 197,001,957920,Mercier; Patrick Philip,9991,0,9999,8
1746610555532,ECON 178,A01,907814,Zhu; Ying,26,0,35,9
1746610556561,EDS 115,A00,895312,Staff,35,0,45,10
1746610557590,EDS 117,A01,895337,Staff,23,0,30,7
1746610558617,EDS 125,A00,895341,Jones; Gabrielle Anastasia,36,0,45,9
1746610559645,EDS 128A,A01,895459,Fargason; Sharon Gayle,44,0,45,1
1746610560672,EDS 128B,A01,895543,Pappas; Elizabeth,44,0,45,1
1746610561697,EDS 139,A00,897203,Pappas; Elizabeth,44,0,45,1
1746610561697,EDS 139,B00,897209,Fargason; Sharon Gayle,41,0,45,4
1746610562726,EDS 201,A00,895545,Staff,22,0,45,23
1746610563754,EDS 203,A01,895581,Halter; Christopher P.,22,0,45,23
1746610564781,EDS 204R,A01,895625,Heinzman; Erica M.,39,0,45,6
1746610564781,EDS 204R,B01,895693,Halter; Christopher P.,10,0,45,35
1746610565806,EDS 206R,A00,895694,Fargason; Sharon Gayle,1,0,30,29
1746610565806,EDS 206R,B00,895695,Choi; Bailey Miyeon,16,0,30,14
1746610566836,EDS 250,A00,895697,Hemans; Patricia Ann Benitez,22,0,45,23
1746610567866,EDS 281,A00,895701,Meyerott; Theresa Ann,1,0,15,14
1746610568893,EDS 284,A00,895736,Meyerott; Theresa Ann,1,0,15,14
1746610569919,EDS 286,A00,897210,Fine; Sarah,0,0,15,15
1746610570947,EDS 289C,A01,895770,Daly; Alan J.,1,0,15,14
1746610571979,EDS 290,A00,897211,Hofstetter; Carolyn,0,0,15,15
1746610573005,LIGM 5A,A00,896162,Fischer-Grunski; Eva K,12,0,20,8
1746610574032,LIGM 5B,A00,896260,Fischer-Grunski; Eva K,17,0,20,3
1746610575064,LIGM 5C,A00,896308,Fischer-Grunski; Eva K,18,0,20,2
1746610576089,LIIT 5AS,A00,896313,Carnelos; Chiara,18,0,20,2
1746610577118,LIIT 5BS,A00,896416,Carnelos; Chiara,20,0,20,0
1746610578145,LIIT 5CS,A00,896564,Carnelos; Chiara,20,0,20,0
1746610579172,LISP 5A,A00,896588,Munoz Sanchez; Alicia,2,0,20,18
1746610580199,LISP 5B,A00,896653,Munoz Sanchez; Alicia,7,0,20,13
1746610581225,LISP 5C,A00,896655,Munoz Sanchez; Alicia,0,1,20,20
1746610582257,MAE 197,001,957918,Kleissl; Jan,9996,0,9999,3
1746610582257,MAE 197,002,959806,Boechler; Nicholas Sebastia,9998,0,9999,1
1746610582257,MAE 197,003,959852,Mullin; Jennifer S,9998,0,9999,1
1746610583286,MATH 2,A01,957937,Staff,33,0,35,2
1746610584315,MATH 197,001,957876,Kedlaya; Kiran S.,9993,0,9999,6
1746610585341,MCWP 40,A00,892729,Duru; Nur,10,0,20,10
1746610585341,MCWP 40,B00,893304,Montejo; Carolina,14,0,20,6
1746610586368,MCWP 40R,A00,893757,Redela; Pamela Morgan,0,5,20,20
1746610587398,MCWP 50,A00,893758,Morshed; Michael James,0,0,20,20
1746610587398,MCWP 50,B00,893761,Bartulis; Jason Michael,16,0,20,4
1746610588425,MCWP 50R,A00,893766,Compas; Sean Matthew,0,1,20,20
1746610588425,MCWP 50R,B00,893769,Carter; Jennifer A,0,1,20,20
1746610588425,MCWP 50R,C00,893771,Krone; Jarret,0,3,20,20
1746610588425,MCWP 50R,D00,893772,Miller; Elizabeth Deen,0,0,20,20
1746610588425,MCWP 50R,E00,893775,Carter; Andrea L,0,1,20,20
1746610589449,MMW 11R,A01,892721,Herbst; Matthew,14,0,30,16
1746610589449,MMW 11R,A02,892722,Herbst; Matthew,0,0,0,3
1746610590478,MMW 12R,A01,892724,Herbst; Matthew,0,11,16,16
1746610590478,MMW 12R,A02,892725,Herbst; Matthew,0,10,16,16
1746610591503,MMW 13R,A01,892727,Staff,0,4,16,16
1746610591503,MMW 13R,A02,892728,Staff,0,4,16,16
1746610591503,MMW 13R,A03,958032,Staff,0,4,16,16
1746610591503,MMW 13R,A04,958033,Staff,0,4,16,16
1746610591503,MMW 13R,A05,958034,Staff,0,4,16,16
1746610592530,SIO 295LS,A00,894015,Staff,5,0,25,20
1746610593558,SIO 295S,A00,894020,Staff,5,0,25,20
1746610594586,SIOC 290S,B01,958918,Merrifield; Mark A,14,0,30,16
1746610595611,SIOC 291S,B01,958922,Gabriel; Corey John,14,0,30,16
1746610596637,SOCI 117,A01,895339,Staff,2,0,5,3
1746610597662,WES 237B,A00,894149,Staff,11,0,20,9
1746610599724,AESE 279B,A00,891859,Staff,13,0,35,22
1746610600755,AIP 197,001,891854,Vespa; Emanuel Ignacio,9999,0,9999,0
1746610601785,ANTH 289S,A00,891856,Gagneux; Pascal,12,0,12,0
1746610602813,BENG 196,001,957946,Engler; Adam J.,9996,0,9999,3
1746610603840,BISP 197,001,959851,Wilhelm; James E.,9998,0,9999,1
1746610604869,CAT 124RS,A01,956906,Staff,6,0,25,19
1746610605894,CAT 125RS,A01,922013,Staff,6,0,25,19
1746610606923,CLRE 250,A00,891860,Morris; Sheldon,9995,0,9999,4
1746610608975,CLRE 251R,A00,907817,Mehta; Ravindra L.,9994,0,9999,5
1746610610005,CLRE 252,A00,891864,Cuomo; Raphael Eduardo,9993,0,9999,6
1746610611035,CLRE 253,A00,891867,Vaida; Florin,9994,0,9999,5
1746610611035,CLRE 253,B00,907819,Staff,9999,0,9999,0
1746610612062,CLRE 259,A00,891868,Patel; Hemal,9998,0,9999,1
1746610613091,CLRE 260,A00,891872,Cuomo; Raphael Eduardo,9999,0,9999,0
1746610614117,CLRE 297,001,891888,Cuomo; Raphael Eduardo,9999,0,9999,0
1746610615144,CSE 191,A00,958773,Minnes Kemp; Mor Mia,9995,0,9999,4
1746610616170,CSE 197,001,959846,Minnes Kemp; Mor Mia,9990,0,9999,9
1746610617200,CSS 201S,A01,892054,Mignozzetti; Umberto,25,0,30,5
1746610618231,CSS 202S,A01,892056,Mignozzetti; Umberto,25,0,30,5
1746610619259,DSC 197,001,956898,Eldridge; Justin Matthew,9996,0,9999,3
1746610620288,DSC 297,001,958000,Mazumdar; Arya,9998,0,9999,1
1746610620288,DSC 297,002,959862,Wang; Yusu,9998,0,9999,1
1746610621317,EAP 100,A00,905686,Staff,9778,0,9999,221
1746610622344,ECE 45,A01,892618,Staff,0,0,65,65
1746610624394,ECE 111,A01,892719,Staff,6,0,65,59
1746610625422,ECE 197,001,957920,Mercier; Patrick Philip,9991,0,9999,8
1746610626452,ECON 178,A01,907814,Zhu; Ying,26,0,35,9
1746610627479,EDS 115,A00,895312,Staff,35,0,45,10
1746610628508,EDS 117,A01,895337,Staff,23,0,30,7
1746610629535,EDS 125,A00,895341,Jones; Gabrielle Anastasia,36,0,45,9
1746610630561,EDS 128A,A01,895459,Fargason; Sharon Gayle,44,0,45,1
1746610631592,EDS 128B,A01,895543,Pappas; Elizabeth,44,0,45,1
1746610632618,EDS 139,A00,897203,Pappas; Elizabeth,44,0,45,1
1746610632618,EDS 139,B00,897209,Fargason; Sharon Gayle,41,0,45,4
1746610633645,EDS 201,A00,895545,Staff,22,0,45,23
1746610634674,EDS 203,A01,895581,Halter; Christopher P.,22,0,45,23
1746610635702,EDS 204R,A01,895625,Heinzman; Erica M.,39,0,45,6
1746610635702,EDS 204R,B01,895693,Halter; Christopher P.,10,0,45,35
1746610636730,EDS 206R,A00,895694,Fargason; Sharon Gayle,1,0,30,29
1746610636730,EDS 206R,B00,895695,Choi; Bailey Miyeon,16,0,30,14
1746610637759,EDS 250,A00,895697,Hemans; Patricia Ann Benitez,22,0,45,23
1746610638786,EDS 281,A00,895701,Meyerott; Theresa Ann,1,0,15,14
1746610639813,EDS 284,A00,895736,Meyerott; Theresa Ann,1,0,15,14
1746610640843,EDS 286,A00,897210,Fine; Sarah,0,0,15,15
1746610641869,EDS 289C,A01,895770,Daly; Alan J.,1,0,15,14
1746610642898,EDS 290,A00,897211,Hofstetter; Carolyn,0,0,15,15
1746610643926,LIGM 5A,A00,896162,Fischer-Grunski; Eva K,12,0,20,8
1746610644955,LIGM 5B,A00,896260,Fischer-Grunski; Eva K,17,0,20,3
1746610645985,LIGM 5C,A00,896308,Fischer-Grunski; Eva K,18,0,20,2
1746610647014,LIIT 5AS,A00,896313,Carnelos; Chiara,18,0,20,2
1746610648040,LIIT 5BS,A00,896416,Carnelos; Chiara,20,0,20,0
1746610649068,LIIT 5CS,A00,896564,Carnelos; Chiara,20,0,20,0
1746610650093,LISP 5A,A00,896588,Munoz Sanchez; Alicia,2,0,20,18
1746610651121,LISP 5B,A00,896653,Munoz Sanchez; Alicia,7,0,20,13
1746610652151,LISP 5C,A00,896655,Munoz Sanchez; Alicia,0,1,20,20
1746610653177,MAE 197,001,957918,Kleissl; Jan,9996,0,9999,3
1746610653177,MAE 197,002,959806,Boechler; Nicholas Sebastia,9998,0,9999,1
1746610653177,MAE 197,003,959852,Mullin; Jennifer S,9998,0,9999,1
1746610654204,MATH 2,A01,957937,Staff,33,0,35,2
1746610655231,MATH 197,001,957876,Kedlaya; Kiran S.,9993,0,9999,6
1746610656260,MCWP 40,A00,892729,Duru; Nur,10,0,20,10
1746610656260,MCWP 40,B00,893304,Montejo; Carolina,14,0,20,6
1746610657290,MCWP 40R,A00,893757,Redela; Pamela Morgan,0,5,20,20
1746610658316,MCWP 50,A00,893758,Morshed; Michael James,0,0,20,20
1746610658316,MCWP 50,B00,893761,Bartulis; Jason Michael,16,0,20,4
1746610659343,MCWP 50R,A00,893766,Compas; Sean Matthew,0,1,20,20
1746610659343,MCWP 50R,B00,893769,Carter; Jennifer A,0,1,20,20
1746610659343,MCWP 50R,C00,893771,Krone; Jarret,0,3,20,20
1746610659343,MCWP 50R,D00,893772,Miller; Elizabeth Deen,0,0,20,20
1746610659343,MCWP 50R,E00,893775,Carter; Andrea L,0,1,20,20
1746610660367,MMW 11R,A01,892721,Herbst; Matthew,14,0,30,16
1746610660367,MMW 11R,A02,892722,Herbst; Matthew,0,0,0,3
1746610661392,MMW 12R,A01,892724,Herbst; Matthew,0,11,16,16
1746610661392,MMW 12R,A02,892725,Herbst; Matthew,0,10,16,16
1746610662430,MMW 13R,A01,892727,Staff,0,4,16,16
1746610662430,MMW 13R,A02,892728,Staff,0,4,16,16
1746610662430,MMW 13R,A03,958032,Staff,0,4,16,16
1746610662430,MMW 13R,A04,958033,Staff,0,4,16,16
1746610662430,MMW 13R,A05,958034,Staff,0,4,16,16
1746610663457,SIO 295LS,A00,894015,Staff,5,0,25,20
1746610664483,SIO 295S,A00,894020,Staff,5,0,25,20
1746610665515,SIOC 290S,B01,958918,Merrifield; Mark A,14,0,30,16
1746610666545,SIOC 291S,B01,958922,Gabriel; Corey John,14,0,30,16
1746610667572,SOCI 117,A01,895339,Staff,2,0,5,3
1746610668603,WES 237B,A00,894149,Staff,11,0,20,9
1746610670671,AESE 279B,A00,891859,Staff,13,0,35,22
1746610671700,AIP 197,001,891854,Vespa; Emanuel Ignacio,9999,0,9999,0
1746610672729,ANTH 289S,A00,891856,Gagneux; Pascal,12,0,12,0
1746610673756,BENG 196,001,957946,Engler; Adam J.,9996,0,9999,3
1746610674787,BISP 197,001,959851,Wilhelm; James E.,9998,0,9999,1
1746610675817,CAT 124RS,A01,956906,Staff,6,0,25,19
1746610676843,CAT 125RS,A01,922013,Staff,6,0,25,19
1746610677870,CLRE 250,A00,891860,Morris; Sheldon,9995,0,9999,4
1746610679923,CLRE 251R,A00,907817,Mehta; Ravindra L.,9994,0,9999,5
1746610680948,CLRE 252,A00,891864,Cuomo; Raphael Eduardo,9993,0,9999,6
1746610681976,CLRE 253,A00,891867,Vaida; Florin,9994,0,9999,5
1746610681976,CLRE 253,B00,907819,Staff,9999,0,9999,0
1746610683004,CLRE 259,A00,891868,Patel; Hemal,9998,0,9999,1
1746610684030,CLRE 260,A00,891872,Cuomo; Raphael Eduardo,9999,0,9999,0
1746610685058,CLRE 297,001,891888,Cuomo; Raphael Eduardo,9999,0,9999,0
1746610686084,CSE 191,A00,958773,Minnes Kemp; Mor Mia,9995,0,9999,4
1746610687111,CSE 197,001,959846,Minnes Kemp; Mor Mia,9990,0,9999,9
1746610688139,CSS 201S,A01,892054,Mignozzetti; Umberto,25,0,30,5
1746610689166,CSS 202S,A01,892056,Mignozzetti; Umberto,25,0,30,5
1746610690195,DSC 197,001,956898,Eldridge; Justin Matthew,9996,0,9999,3
1746610691219,DSC 297,001,958000,Mazumdar; Arya,9998,0,9999,1
1746610691219,DSC 297,002,959862,Wang; Yusu,9998,0,9999,1
1746610692245,EAP 100,A00,905686,Staff,9778,0,9999,221
1746610693272,ECE 45,A01,892618,Staff,0,0,65,65
1746610695325,ECE 111,A01,892719,Staff,6,0,65,59
1746610696355,ECE 197,001,957920,Mercier; Patrick Philip,9991,0,9999,8
1746610697380,ECON 178,A01,907814,Zhu; Ying,26,0,35,9
1746610698408,EDS 115,A00,895312,Staff,35,0,45,10
1746610699434,EDS 117,A01,895337,Staff,23,0,30,7
1746610700458,EDS 125,A00,895341,Jones; Gabrielle Anastasia,36,0,45,9
1746610701489,EDS 128A,A01,895459,Fargason; Sharon Gayle,44,0,45,1
1746610702516,EDS 128B,A01,895543,Pappas; Elizabeth,44,0,45,1
1746610703542,EDS 139,A00,897203,Pappas; Elizabeth,44,0,45,1
1746610703542,EDS 139,B00,897209,Fargason; Sharon Gayle,41,0,45,4
1746610704567,EDS 201,A00,895545,Staff,22,0,45,23
1746610705592,EDS 203,A01,895581,Halter; Christopher P.,22,0,45,23
1746610706620,EDS 204R,A01,895625,Heinzman; Erica M.,39,0,45,6
1746610706620,EDS 204R,B01,895693,Halter; Christopher P.,10,0,45,35
1746610707645,EDS 206R,A00,895694,Fargason; Sharon Gayle,1,0,30,29
1746610707645,EDS 206R,B00,895695,Choi; Bailey Miyeon,16,0,30,14
1746610708675,EDS 250,A00,895697,Hemans; Patricia Ann Benitez,22,0,45,23
1746610709702,EDS 281,A00,895701,Meyerott; Theresa Ann,1,0,15,14
1746610710727,EDS 284,A00,895736,Meyerott; Theresa Ann,1,0,15,14
1746610711753,EDS 286,A00,897210,Fine; Sarah,0,0,15,15
1746610712782,EDS 289C,A01,895770,Daly; Alan J.,1,0,15,14
1746610713808,EDS 290,A00,897211,Hofstetter; Carolyn,0,0,15,15
1746610714837,LIGM 5A,A00,896162,Fischer-Grunski; Eva K,12,0,20,8
1746610715867,LIGM 5B,A00,896260,Fischer-Grunski; Eva K,17,0,20,3
1746610716894,LIGM 5C,A00,896308,Fischer-Grunski; Eva K,18,0,20,2
1746610717921,LIIT 5AS,A00,896313,Carnelos; Chiara,18,0,20,2
1746610718948,LIIT 5BS,A00,896416,Carnelos; Chiara,20,0,20,0
1746610719975,LIIT 5CS,A00,896564,Carnelos; Chiara,20,0,20,0
1746610721002,LISP 5A,A00,896588,Munoz Sanchez; Alicia,2,0,20,18
1746610722029,LISP 5B,A00,896653,Munoz Sanchez; Alicia,7,0,20,13
1746610723055,LISP 5C,A00,896655,Munoz Sanchez; Alicia,0,1,20,20
1746610724083,MAE 197,001,957918,Kleissl; Jan,9996,0,9999,3
1746610724083,MAE 197,002,959806,Boechler; Nicholas Sebastia,9998,0,9999,1
1746610724083,MAE 197,003,959852,Mullin; Jennifer S,9998,0,9999,1
1746610725109,MATH 2,A01,957937,Staff,33,0,35,2
1746610726135,MATH 197,001,957876,Kedlaya; Kiran S.,9993,0,9999,6
1746610727167,MCWP 40,A00,892729,Duru; Nur,10,0,20,10
1746610727167,MCWP 40,B00,893304,Montejo; Carolina,14,0,20,6
1746610728195,MCWP 40R,A00,893757,Redela; Pamela Morgan,0,5,20,20
1746610729225,MCWP 50,A00,893758,Morshed; Michael James,0,0,20,20
1746610729225,MCWP 50,B00,893761,Bartulis; Jason Michael,16,0,20,4
1746610730253,MCWP 50R,A00,893766,Compas; Sean Matthew,0,1,20,20
1746610730253,MCWP 50R,B00,893769,Carter; Jennifer A,0,1,20,20
1746610730253,MCWP 50R,C00,893771,Krone; Jarret,0,3,20,20
1746610730253,MCWP 50R,D00,893772,Miller; Elizabeth Deen,0,0,20,20
1746610730253,MCWP 50R,E00,893775,Carter; Andrea L,0,1,20,20
1746610731279,MMW 11R,A01,892721,Herbst; Matthew,14,0,30,16
1746610731279,MMW 11R,A02,892722,Herbst; Matthew,0,0,0,3
1746610732305,MMW 12R,A01,892724,Herbst; Matthew,0,11,16,16
1746610732305,MMW 12R,A02,892725,Herbst; Matthew,0,10,16,16
1746610733335,MMW 13R,A01,892727,Staff,0,4,16,16
1746610733335,MMW 13R,A02,892728,Staff,0,4,16,16
1746610733335,MMW 13R,A03,958032,Staff,0,4,16,16
1746610733335,MMW 13R,A04,958033,Staff,0,4,16,16
1746610733335,MMW 13R,A05,958034,Staff,0,4,16,16
1746610734361,SIO 295LS,A00,894015,Staff,5,0,25,20
1746610735387,SIO 295S,A00,894020,Staff,5,0,25,20
1746610736420,SIOC 290S,B01,958918,Merrifield; Mark A,14,0,30,16
1746610737449,SIOC 291S,B01,958922,Gabriel; Corey John,14,0,30,16
1746610738476,SOCI 117,A01,895339,Staff,2,0,5,3
1746610739503,WES 237B,A00,894149,Staff,11,0,20,9
1746610741579,AESE 279B,A00,891859,Staff,13,0,35,22
1746610742605,AIP 197,001,891854,Vespa; Emanuel Ignacio,9999,0,9999,0
1746610743633,ANTH 289S,A00,891856,Gagneux; Pascal,12,0,12,0
1746610744661,BENG 196,001,957946,Engler; Adam J.,9996,0,9999,3
1746610745686,BISP 197,001,959851,Wilhelm; James E.,9998,0,9999,1
1746610746714,CAT 124RS,A01,956906,Staff,6,0,25,19
1746610747740,CAT 125RS,A01,922013,Staff,6,0,25,19
1746610748768,CLRE 250,A00,891860,Morris; Sheldon,9995,0,9999,4
1746610750826,CLRE 251R,A00,907817,Mehta; Ravindra L.,9994,0,9999,5
1746610751854,CLRE 252,A00,891864,Cuomo; Raphael Eduardo,9993,0,9999,6
1746610752881,CLRE 253,A00,891867,Vaida; Florin,9994,0,9999,5
1746610752881,CLRE 253,B00,907819,Staff,9999,0,9999,0
1746610753905,CLRE 259,A00,891868,Patel; Hemal,9998,0,9999,1
1746610754934,CLRE 260,A00,891872,Cuomo; Raphael Eduardo,9999,0,9999,0
1746610755959,CLRE 297,001,891888,Cuomo; Raphael Eduardo,9999,0,9999,0
1746610756985,CSE 191,A00,958773,Minnes Kemp; Mor Mia,9995,0,9999,4
1746610758013,CSE 197,001,959846,Minnes Kemp; Mor Mia,9990,0,9999,9
1746610759037,CSS 201S,A01,892054,Mignozzetti; Umberto,25,0,30,5
1746610760068,CSS 202S,A01,892056,Mignozzetti; Umberto,25,0,30,5
1746610761098,DSC 197,001,956898,Eldridge; Justin Matthew,9996,0,9999,3
1746610762123,DSC 297,001,958000,Mazumdar; Arya,9998,0,9999,1
1746610762123,DSC 297,002,959862,Wang; Yusu,9998,0,9999,1
1746610763146,EAP 100,A00,905686,Staff,9778,0,9999,221
1746610764176,ECE 45,A01,892618,Staff,0,0,65,65
1746610766232,ECE 111,A01,892719,Staff,6,0,65,59
1746610767258,ECE 197,001,957920,Mercier; Patrick Philip,9991,0,9999,8
1746610768284,ECON 178,A01,907814,Zhu; Ying,26,0,35,9
1746610769311,EDS 115,A00,895312,Staff,35,0,45,10
1746610770337,EDS 117,A01,895337,Staff,23,0,30,7
1746610771364,EDS 125,A00,895341,Jones; Gabrielle Anastasia,36,0,45,9
1746610772403,EDS 128A,A01,895459,Fargason; Sharon Gayle,44,0,45,1
1746610773433,EDS 128B,A01,895543,Pappas; Elizabeth,44,0,45,1
1746610774458,EDS 139,A00,897203,Pappas; Elizabeth,44,0,45,1
1746610774458,EDS 139,B00,897209,Fargason; Sharon Gayle,41,0,45,4
1746610775487,EDS 201,A00,895545,Staff,22,0,45,23
1746610776513,EDS 203,A01,895581,Halter; Christopher P.,22,0,45,23
1746610777542,EDS 204R,A01,895625,Heinzman; Erica M.,39,0,45,6
1746610777542,EDS 204R,B01,895693,Halter; Christopher P.,10,0,45,35
1746610778572,EDS 206R,A00,895694,Fargason; Sharon Gayle,1,0,30,29
1746610778572,EDS 206R,B00,895695,Choi; Bailey Miyeon,16,0,30,14
1746610779597,EDS 250,A00,895697,Hemans; Patricia Ann Benitez,22,0,45,23
1746610780624,EDS 281,A00,895701,Meyerott; Theresa Ann,1,0,15,14
1746610781651,EDS 284,A00,895736,Meyerott; Theresa Ann,1,0,15,14
1746610782677,EDS 286,A00,897210,Fine; Sarah,0,0,15,15
1746610783705,EDS 289C,A01,895770,Daly; Alan J.,1,0,15,14
1746610784730,EDS 290,A00,897211,Hofstetter; Carolyn,0,0,15,15
1746610785756,LIGM 5A,A00,896162,Fischer-Grunski; Eva K,12,0,20,8
1746610786782,LIGM 5B,A00,896260,Fischer-Grunski; Eva K,17,0,20,3
1746610787813,LIGM 5C,A00,896308,Fischer-Grunski; Eva K,18,0,20,2
1746610788839,LIIT 5AS,A00,896313,Carnelos; Chiara,18,0,20,2
1746610789867,LIIT 5BS,A00,896416,Carnelos; Chiara,20,0,20,0
1746610790892,LIIT 5CS,A00,896564,Carnelos; Chiara,20,0,20,0
1746610791920,LISP 5A,A00,896588,Munoz Sanchez; Alicia,2,0,20,18
1746610792949,LISP 5B,A00,896653,Munoz Sanchez; Alicia,7,0,20,13
1746610793975,LISP 5C,A00,896655,Munoz Sanchez; Alicia,0,1,20,20
1746610795006,MAE 197,001,957918,Kleissl; Jan,9996,0,9999,3
1746610795006,MAE 197,002,959806,Boechler; Nicholas Sebastia,9998,0,9999,1
1746610795006,MAE 197,003,959852,Mullin; Jennifer S,9998,0,9999,1
1746610796034,MATH 2,A01,957937,Staff,33,0,35,2
1746610797061,MATH 197,001,957876,Kedlaya; Kiran S.,9993,0,9999,6
1746610798087,MCWP 40,A00,892729,Duru; Nur,10,0,20,10
1746610798087,MCWP 40,B00,893304,Montejo; Carolina,14,0,20,6
1746610799115,MCWP 40R,A00,893757,Redela; Pamela Morgan,0,5,20,20
1746610800142,MCWP 50,A00,893758,Morshed; Michael James,0,0,20,20
1746610800142,MCWP 50,B00,893761,Bartulis; Jason Michael,16,0,20,4
1746610801169,MCWP 50R,A00,893766,Compas; Sean Matthew,0,1,20,20
1746610801169,MCWP 50R,B00,893769,Carter; Jennifer A,0,1,20,20
1746610801169,MCWP 50R,C00,893771,Krone; Jarret,0,3,20,20
1746610801169,MCWP 50R,D00,893772,Miller; Elizabeth Deen,0,0,20,20
1746610801169,MCWP 50R,E00,893775,Carter; Andrea L,0,1,20,20
1746610802201,MMW 11R,A01,892721,Herbst; Matthew,14,0,30,16
1746610802201,MMW 11R,A02,892722,Herbst; Matthew,0,0,0,3
1746610803239,MMW 12R,A01,892724,Herbst; Matthew,0,11,16,16
1746610803239,MMW 12R,A02,892725,Herbst; Matthew,0,10,16,16
1746610804269,MMW 13R,A01,892727,Staff,0,4,16,16
1746610804269,MMW 13R,A02,892728,Staff,0,4,16,16
1746610804269,MMW 13R,A03,958032,Staff,0,4,16,16
1746610804269,MMW 13R,A04,958033,Staff,0,4,16,16
1746610804269,MMW 13R,A05,958034,Staff,0,4,16,16
1746610805295,SIO 295LS,A00,894015,Staff,5,0,25,20
1746610806324,SIO 295S,A00,894020,Staff,5,0,25,20
1746610807351,SIOC 290S,B01,958918,Merrifield; Mark A,14,0,30,16
1746610808380,SIOC 291S,B01,958922,Gabriel; Corey John,14,0,30,16
1746610809406,SOCI 117,A01,895339,Staff,2,0,5,3
1746610810434,WES 237B,A00,894149,Staff,11,0,20,9
1746610812507,AESE 279B,A00,891859,Staff,13,0,35,22
1746610813535,AIP 197,001,891854,Vespa; Emanuel Ignacio,9999,0,9999,0
1746610814563,ANTH 289S,A00,891856,Gagneux; Pascal,12,0,12,0
1746610815593,BENG 196,001,957946,Engler; Adam J.,9996,0,9999,3
1746610816619,BISP 197,001,959851,Wilhelm; James E.,9998,0,9999,1
1746610817646,CAT 124RS,A01,956906,Staff,6,0,25,19
1746610818672,CAT 125RS,A01,922013,Staff,6,0,25,19
1746610819698,CLRE 250,A00,891860,Morris; Sheldon,9995,0,9999,4
1746610821753,CLRE 251R,A00,907817,Mehta; Ravindra L.,9994,0,9999,5
1746610822783,CLRE 252,A00,891864,Cuomo; Raphael Eduardo,9993,0,9999,6
1746610823812,CLRE 253,A00,891867,Vaida; Florin,9994,0,9999,5
1746610823812,CLRE 253,B00,907819,Staff,9999,0,9999,0
1746610824836,CLRE 259,A00,891868,Patel; Hemal,9998,0,9999,1
1746610825864,CLRE 260,A00,891872,Cuomo; Raphael Eduardo,9999,0,9999,0
1746610826892,CLRE 297,001,891888,Cuomo; Raphael Eduardo,9999,0,9999,0
1746610827921,CSE 191,A00,958773,Minnes Kemp; Mor Mia,9995,0,9999,4
1746610828946,CSE 197,001,959846,Minnes Kemp; Mor Mia,9990,0,9999,9
1746610829976,CSS 201S,A01,892054,Mignozzetti; Umberto,25,0,30,5
1746610831009,CSS 202S,A01,892056,Mignozzetti; Umberto,25,0,30,5
1746610832033,DSC 197,001,956898,Eldridge; Justin Matthew,9996,0,9999,3
1746610833060,DSC 297,001,958000,Mazumdar; Arya,9998,0,9999,1
1746610833060,DSC 297,002,959862,Wang; Yusu,9998,0,9999,1
1746610834088,EAP 100,A00,905686,Staff,9778,0,9999,221
1746610835115,ECE 45,A01,892618,Staff,0,0,65,65
1746610837168,ECE 111,A01,892719,Staff,6,0,65,59
1746610838195,ECE 197,001,957920,Mercier; Patrick Philip,9991,0,9999,8
1746610839226,ECON 178,A01,907814,Zhu; Ying,26,0,35,9
1746610840253,EDS 115,A00,895312,Staff,35,0,45,10
1746610841282,EDS 117,A01,895337,Staff,23,0,30,7
1746610842313,EDS 125,A00,895341,Jones; Gabrielle Anastasia,36,0,45,9
1746610843339,EDS 128A,A01,895459,Fargason; Sharon Gayle,44,0,45,1
1746610844365,EDS 128B,A01,895543,Pappas; Elizabeth,44,0,45,1
1746610845391,EDS 139,A00,897203,Pappas; Elizabeth,44,0,45,1
1746610845391,EDS 139,B00,897209,Fargason; Sharon Gayle,41,0,45,4
1746610846415,EDS 201,A00,895545,Staff,22,0,45,23
1746610847443,EDS 203,A01,895581,Halter; Christopher P.,22,0,45,23
1746610848469,EDS 204R,A01,895625,Heinzman; Erica M.,39,0,45,6
1746610848469,EDS 204R,B01,895693,Halter; Christopher P.,10,0,45,35
1746610849498,EDS 206R,A00,895694,Fargason; Sharon Gayle,1,0,30,29
1746610849498,EDS 206R,B00,895695,Choi; Bailey Miyeon,16,0,30,14
1746610850524,EDS 250,A00,895697,Hemans; Patricia Ann Benitez,22,0,45,23
1746610851552,EDS 281,A00,895701,Meyerott; Theresa Ann,1,0,15,14
1746610852580,EDS 284,A00,895736,Meyerott; Theresa Ann,1,0,15,14
1746610853608,EDS 286,A00,897210,Fine; Sarah,0,0,15,15
1746610854633,EDS 289C,A01,895770,Daly; Alan J.,1,0,15,14
1746610855663,EDS 290,A00,897211,Hofstetter; Carolyn,0,0,15,15
1746610856688,LIGM 5A,A00,896162,Fischer-Grunski; Eva K,12,0,20,8
1746610857714,LIGM 5B,A00,896260,Fischer-Grunski; Eva K,17,0,20,3
1746610858743,LIGM 5C,A00,896308,Fischer-Grunski; Eva K,18,0,20,2
1746610859775,LIIT 5AS,A00,896313,Carnelos; Chiara,18,0,20,2
1746610860801,LIIT 5BS,A00,896416,Carnelos; Chiara,20,0,20,0
1746610861830,LIIT 5CS,A00,896564,Carnelos; Chiara,20,0,20,0
1746610862862,LISP 5A,A00,896588,Munoz Sanchez; Alicia,2,0,20,18
1746610863888,LISP 5B,A00,896653,Munoz Sanchez; Alicia,7,0,20,13
1746610864914,LISP 5C,A00,896655,Munoz Sanchez; Alicia,0,1,20,20
1746610865939,MAE 197,001,957918,Kleissl; Jan,9996,0,9999,3
1746610865939,MAE 197,002,959806,Boechler; Nicholas Sebastia,9998,0,9999,1
1746610865939,MAE 197,003,959852,Mullin; Jennifer S,9998,0,9999,1
1746610866966,MATH 2,A01,957937,Staff,33,0,35,2
1746610867993,MATH 197,001,957876,Kedlaya; Kiran S.,9993,0,9999,6
1746610869021,MCWP 40,A00,892729,Duru; Nur,10,0,20,10
1746610869021,MCWP 40,B00,893304,Montejo; Carolina,14,0,20,6
1746610870048,MCWP 40R,A00,893757,Redela; Pamela Morgan,0,5,20,20
1746610871073,MCWP 50,A00,893758,Morshed; Michael James,0,0,20,20
1746610871073,MCWP 50,B00,893761,Bartulis; Jason Michael,16,0,20,4
1746610872100,MCWP 50R,A00,893766,Compas; Sean Matthew,0,1,20,20
1746610872100,MCWP 50R,B00,893769,Carter; Jennifer A,0,1,20,20
1746610872100,MCWP 50R,C00,893771,Krone; Jarret,0,3,20,20
1746610872100,MCWP 50R,D00,893772,Miller; Elizabeth Deen,0,0,20,20
1746610872100,MCWP 50R,E00,893775,Carter; Andrea L,0,1,20,20
1746610873130,MMW 11R,A01,892721,Herbst; Matthew,14,0,30,16
1746610873130,MMW 11R,A02,892722,Herbst; Matthew,0,0,0,3
1746610874161,MMW 12R,A01,892724,Herbst; Matthew,0,11,16,16
1746610874161,MMW 12R,A02,892725,Herbst; Matthew,0,10,16,16
1746610875192,MMW 13R,A01,892727,Staff,0,4,16,16
1746610875192,MMW 13R,A02,892728,Staff,0,4,16,16
1746610875192,MMW 13R,A03,958032,Staff,0,4,16,16
1746610875192,MMW 13R,A04,958033,Staff,0,4,16,16
1746610875192,MMW 13R,A05,958034,Staff,0,4,16,16
1746610876219,SIO 295LS,A00,894015,Staff,5,0,25,20
1746610877249,SIO 295S,A00,894020,Staff,5,0,25,20
1746610878281,SIOC 290S,B01,958918,Merrifield; Mark A,14,0,30,16
1746610879311,SIOC 291S,B01,958922,Gabriel; Corey John,14,0,30,16
1746610880339,SOCI 117,A01,895339,Staff,2,0,5,3
1746610881368,WES 237B,A00,894149,Staff,11,0,20,9
1746610883433,AESE 279B,A00,891859,Staff,13,0,35,22
1746610884461,AIP 197,001,891854,Vespa; Emanuel Ignacio,9999,0,9999,0
1746610885485,ANTH 289S,A00,891856,Gagneux; Pascal,12,0,12,0
1746610886515,BENG 196,001,957946,Engler; Adam J.,9996,0,9999,3
1746610887541,BISP 197,001,959851,Wilhelm; James E.,9998,0,9999,1
1746610888566,CAT 124RS,A01,956906,Staff,6,0,25,19
1746610889594,CAT 125RS,A01,922013,Staff,6,0,25,19
1746610890619,CLRE 250,A00,891860,Morris; Sheldon,9995,0,9999,4
1746610892672,CLRE 251R,A00,907817,Mehta; Ravindra L.,9994,0,9999,5
1746610893700,CLRE 252,A00,891864,Cuomo; Raphael Eduardo,9993,0,9999,6
1746610894726,CLRE 253,A00,891867,Vaida; Florin,9994,0,9999,5
1746610894726,CLRE 253,B00,907819,Staff,9999,0,9999,0
1746610895755,CLRE 259,A00,891868,Patel; Hemal,9998,0,9999,1
1746610896783,CLRE 260,A00,891872,Cuomo; Raphael Eduardo,9999,0,9999,0
1746610897808,CLRE 297,001,891888,Cuomo; Raphael Eduardo,9999,0,9999,0
1746610898837,CSE 191,A00,958773,Minnes Kemp; Mor Mia,9995,0,9999,4
1746610899861,CSE 197,001,959846,Minnes Kemp; Mor Mia,9990,0,9999,9
1746610900888,CSS 201S,A01,892054,Mignozzetti; Umberto,25,0,30,5
1746610901918,CSS 202S,A01,892056,Mignozzetti; Umberto,25,0,30,5
1746610902946,DSC 197,001,956898,Eldridge; Justin Matthew,9996,0,9999,3
1746610903977,DSC 297,001,958000,Mazumdar; Arya,9998,0,9999,1
1746610903977,DSC 297,002,959862,Wang; Yusu,9998,0,9999,1
1746610905003,EAP 100,A00,905686,Staff,9778,0,9999,221
1746610906033,ECE 45,A01,892618,Staff,0,0,65,65
1746610908088,ECE 111,A01,892719,Staff,6,0,65,59
1746610909116,ECE 197,001,957920,Mercier; Patrick Philip,9991,0,9999,8
1746610910142,ECON 178,A01,907814,Zhu; Ying,26,0,35,9
1746610911169,EDS 115,A00,895312,Staff,35,0,45,10
1746610912193,EDS 117,A01,895337,Staff,23,0,30,7
1746610913223,EDS 125,A00,895341,Jones; Gabrielle Anastasia,36,0,45,9
1746610914249,EDS 128A,A01,895459,Fargason; Sharon Gayle,44,0,45,1
1746610915276,EDS 128B,A01,895543,Pappas; Elizabeth,44,0,45,1
1746610916305,EDS 139,A00,897203,Pappas; Elizabeth,44,0,45,1
1746610916305,EDS 139,B00,897209,Fargason; Sharon Gayle,41,0,45,4
1746610917331,EDS 201,A00,895545,Staff,22,0,45,23
1746610918356,EDS 203,A01,895581,Halter; Christopher P.,22,0,45,23
1746610919382,EDS 204R,A01,895625,Heinzman; Erica M.,39,0,45,6
1746610919382,EDS 204R,B01,895693,Halter; Christopher P.,10,0,45,35
1746610920408,EDS 206R,A00,895694,Fargason; Sharon Gayle,1,0,30,29
1746610920408,EDS 206R,B00,895695,Choi; Bailey Miyeon,16,0,30,14
1746610921436,EDS 250,A00,895697,Hemans; Patricia Ann Benitez,22,0,45,23
1746610922466,EDS 281,A00,895701,Meyerott; Theresa Ann,1,0,15,14
1746610923494,EDS 284,A00,895736,Meyerott; Theresa Ann,1,0,15,14
1746610924519,EDS 286,A00,897210,Fine; Sarah,0,0,15,15
1746610925546,EDS 289C,A01,895770,Daly; Alan J.,1,0,15,14
1746610926573,EDS 290,A00,897211,Hofstetter; Carolyn,0,0,15,15
1746610927600,LIGM 5A,A00,896162,Fischer-Grunski; Eva K,12,0,20,8
1746610928629,LIGM 5B,A00,896260,Fischer-Grunski; Eva K,17,0,20,3
1746610929654,LIGM 5C,A00,896308,Fischer-Grunski; Eva K,18,0,20,2
1746610930681,LIIT 5AS,A00,896313,Carnelos; Chiara,18,0,20,2
1746610931711,LIIT 5BS,A00,896416,Carnelos; Chiara,20,0,20,0
1746610932738,LIIT 5CS,A00,896564,Carnelos; Chiara,20,0,20,0
1746610933765,LISP 5A,A00,896588,Munoz Sanchez; Alicia,2,0,20,18
1746610934790,LISP 5B,A00,896653,Munoz Sanchez; Alicia,7,0,20,13
1746610935816,LISP 5C,A00,896655,Munoz Sanchez; Alicia,0,1,20,20
1746610936841,MAE 197,001,957918,Kleissl; Jan,9996,0,9999,3
1746610936841,MAE 197,002,959806,Boechler; Nicholas Sebastia,9998,0,9999,1
1746610936841,MAE 197,003,959852,Mullin; Jennifer S,9998,0,9999,1
1746610937867,MATH 2,A01,957937,Staff,33,0,35,2
1746610938891,MATH 197,001,957876,Kedlaya; Kiran S.,9993,0,9999,6
1746610939917,MCWP 40,A00,892729,Duru; Nur,10,0,20,10
1746610939917,MCWP 40,B00,893304,Montejo; Carolina,14,0,20,6
1746610940946,MCWP 40R,A00,893757,Redela; Pamela Morgan,0,5,20,20
1746610941970,MCWP 50,A00,893758,Morshed; Michael James,0,0,20,20
1746610941970,MCWP 50,B00,893761,Bartulis; Jason Michael,16,0,20,4
1746610942996,MCWP 50R,A00,893766,Compas; Sean Matthew,0,1,20,20
1746610942996,MCWP 50R,B00,893769,Carter; Jennifer A,0,1,20,20
1746610942996,MCWP 50R,C00,893771,Krone; Jarret,0,3,20,20
1746610942996,MCWP 50R,D00,893772,Miller; Elizabeth Deen,0,0,20,20
1746610942996,MCWP 50R,E00,893775,Carter; Andrea L,0,1,20,20
1746610944022,MMW 11R,A01,892721,Herbst; Matthew,14,0,30,16
1746610944022,MMW 11R,A02,892722,Herbst; Matthew,0,0,0,3
1746610945051,MMW 12R,A01,892724,Herbst; Matthew,0,11,16,16
1746610945051,MMW 12R,A02,892725,Herbst; Matthew,0,10,16,16
1746610946078,MMW 13R,A01,892727,Staff,0,4,16,16
1746610946078,MMW 13R,A02,892728,Staff,0,4,16,16
1746610946078,MMW 13R,A03,958032,Staff,0,4,16,16
1746610946078,MMW 13R,A04,958033,Staff,0,4,16,16
1746610946078,MMW 13R,A05,958034,Staff,0,4,16,16
1746610947106,SIO 295LS,A00,894015,Staff,5,0,25,20
1746610948131,SIO 295S,A00,894020,Staff,5,0,25,20
1746610949156,SIOC 290S,B01,958918,Merrifield; Mark A,14,0,30,16
1746610950183,SIOC 291S,B01,958922,Gabriel; Corey John,14,0,30,16
1746610951209,SOCI 117,A01,895339,Staff,2,0,5,3
1746610952235,WES 237B,A00,894149,Staff,11,0,20,9
1746610954306,AESE 279B,A00,891859,Staff,13,0,35,22
1746610955329,AIP 197,001,891854,Vespa; Emanuel Ignacio,9999,0,9999,0
1746610956356,ANTH 289S,A00,891856,Gagneux; Pascal,12,0,12,0
1746610957380,BENG 196,001,957946,Engler; Adam J.,9996,0,9999,3
1746610958405,BISP 197,001,959851,Wilhelm; James E.,9998,0,9999,1
1746610959431,CAT 124RS,A01,956906,Staff,6,0,25,19
1746610960457,CAT 125RS,A01,922013,Staff,6,0,25,19
1746610961483,CLRE 250,A00,891860,Morris; Sheldon,9995,0,9999,4
1746610963537,CLRE 251R,A00,907817,Mehta; Ravindra L.,9994,0,9999,5
1746610964566,CLRE 252,A00,891864,Cuomo; Raphael Eduardo,9993,0,9999,6
1746610965596,CLRE 253,A00,891867,Vaida; Florin,9994,0,9999,5
1746610965596,CLRE 253,B00,907819,Staff,9999,0,9999,0
1746610966823,CLRE 259,A00,891868,Patel; Hemal,9998,0,9999,1
1746610967851,CLRE 260,A00,891872,Cuomo; Raphael Eduardo,9999,0,9999,0
1746610968879,CLRE 297,001,891888,Cuomo; Raphael Eduardo,9999,0,9999,0
1746610969907,CSE 191,A00,958773,Minnes Kemp; Mor Mia,9995,0,9999,4
1746610970932,CSE 197,001,959846,Minnes Kemp; Mor Mia,9990,0,9999,9
1746610971958,CSS 201S,A01,892054,Mignozzetti; Umberto,25,0,30,5
1746610972985,CSS 202S,A01,892056,Mignozzetti; Umberto,25,0,30,5
1746610974014,DSC 197,001,956898,Eldridge; Justin Matthew,9996,0,9999,3
1746610975039,DSC 297,001,958000,Mazumdar; Arya,9998,0,9999,1
1746610975039,DSC 297,002,959862,Wang; Yusu,9998,0,9999,1
1746610976065,EAP 100,A00,905686,Staff,9778,0,9999,221
1746610977094,ECE 45,A01,892618,Staff,0,0,65,65
1746610979155,ECE 111,A01,892719,Staff,6,0,65,59
1746610980182,ECE 197,001,957920,Mercier; Patrick Philip,9991,0,9999,8
1746610981212,ECON 178,A01,907814,Zhu; Ying,26,0,35,9
1746610982241,EDS 115,A00,895312,Staff,35,0,45,10
1746610983265,EDS 117,A01,895337,Staff,23,0,30,7
1746610984290,EDS 125,A00,895341,Jones; Gabrielle Anastasia,36,0,45,9
1746610985315,EDS 128A,A01,895459,Fargason; Sharon Gayle,44,0,45,1
1746610986343,EDS 128B,A01,895543,Pappas; Elizabeth,44,0,45,1
1746610987369,EDS 139,A00,897203,Pappas; Elizabeth,44,0,45,1
1746610987369,EDS 139,B00,897209,Fargason; Sharon Gayle,41,0,45,4
1746610988394,EDS 201,A00,895545,Staff,22,0,45,23
1746610989420,EDS 203,A01,895581,Halter; Christopher P.,22,0,45,23
1746610990448,EDS 204R,A01,895625,Heinzman; Erica M.,39,0,45,6
1746610990448,EDS 204R,B01,895693,Halter; Christopher P.,10,0,45,35
1746610991477,EDS 206R,A00,895694,Fargason; Sharon Gayle,1,0,30,29
1746610991477,EDS 206R,B00,895695,Choi; Bailey Miyeon,16,0,30,14
1746610992505,EDS 250,A00,895697,Hemans; Patricia Ann Benitez,22,0,45,23
1746610993531,EDS 281,A00,895701,Meyerott; Theresa Ann,1,0,15,14
1746610994558,EDS 284,A00,895736,Meyerott; Theresa Ann,1,0,15,14
1746610995586,EDS 286,A00,897210,Fine; Sarah,0,0,15,15
1746610996610,EDS 289C,A01,895770,Daly; Alan J.,1,0,15,14
1746611008930,EDS 290,A00,897211,Hofstetter; Carolyn,0,0,15,15
1746611009957,LIGM 5A,A00,896162,Fischer-Grunski; Eva K,12,0,20,8
1746611010986,LIGM 5B,A00,896260,Fischer-Grunski; Eva K,17,0,20,3
1746611012015,LIGM 5C,A00,896308,Fischer-Grunski; Eva K,18,0,20,2
1746611013043,LIIT 5AS,A00,896313,Carnelos; Chiara,18,0,20,2
1746611014072,LIIT 5BS,A00,896416,Carnelos; Chiara,20,0,20,0
1746611015097,LIIT 5CS,A00,896564,Carnelos; Chiara,20,0,20,0
1746611016123,LISP 5A,A00,896588,Munoz Sanchez; Alicia,2,0,20,18
1746611017151,LISP 5B,A00,896653,Munoz Sanchez; Alicia,7,0,20,13
1746611018181,LISP 5C,A00,896655,Munoz Sanchez; Alicia,0,1,20,20
1746611019211,MAE 197,001,957918,Kleissl; Jan,9996,0,9999,3
1746611019211,MAE 197,002,959806,Boechler; Nicholas Sebastia,9998,0,9999,1
1746611019211,MAE 197,003,959852,Mullin; Jennifer S,9998,0,9999,1
1746611020240,MATH 2,A01,957937,Staff,33,0,35,2
1746611021265,MATH 197,001,957876,Kedlaya; Kiran S.,9993,0,9999,6
1746611022294,MCWP 40,A00,892729,Duru; Nur,10,0,20,10
1746611022294,MCWP 40,B00,893304,Montejo; Carolina,14,0,20,6
1746611023323,MCWP 40R,A00,893757,Redela; Pamela Morgan,0,5,20,20
1746611024348,MCWP 50,A00,893758,Morshed; Michael James,0,0,20,20
1746611024348,MCWP 50,B00,893761,Bartulis; Jason Michael,16,0,20,4
1746611025377,MCWP 50R,A00,893766,Compas; Sean Matthew,0,1,20,20
1746611025377,MCWP 50R,B00,893769,Carter; Jennifer A,0,1,20,20
1746611025377,MCWP 50R,C00,893771,Krone; Jarret,0,3,20,20
1746611025377,MCWP 50R,D00,893772,Miller; Elizabeth Deen,0,0,20,20
1746611025377,MCWP 50R,E00,893775,Carter; Andrea L,0,1,20,20
1746611026403,MMW 11R,A01,892721,Herbst; Matthew,14,0,30,16
1746611026403,MMW 11R,A02,892722,Herbst; Matthew,0,0,0,3
1746611027433,MMW 12R,A01,892724,Herbst; Matthew,0,11,16,16
1746611027433,MMW 12R,A02,892725,Herbst; Matthew,0,10,16,16
1746611028459,MMW 13R,A01,892727,Staff,0,4,16,16
1746611028459,MMW 13R,A02,892728,Staff,0,4,16,16
1746611028459,MMW 13R,A03,958032,Staff,0,4,16,16
1746611028459,MMW 13R,A04,958033,Staff,0,4,16,16
1746611028459,MMW 13R,A05,958034,Staff,0,4,16,16
1746611029488,SIO 295LS,A00,894015,Staff,5,0,25,20
1746611030518,SIO 295S,A00,894020,Staff,5,0,25,20
1746611031546,SIOC 290S,B01,958918,Merrifield; Mark A,14,0,30,16
1746611032573,SIOC 291S,B01,958922,Gabriel; Corey John,14,0,30,16
1746611033596,SOCI 117,A01,895339,Staff,2,0,5,3
1746611034626,WES 237B,A00,894149,Staff,11,0,20,9
1746611036691,AESE 279B,A00,891859,Staff,13,0,35,22
1746611037716,AIP 197,001,891854,Vespa; Emanuel Ignacio,9999,0,9999,0
1746611038740,ANTH 289S,A00,891856,Gagneux; Pascal,12,0,12,0
1746611039768,BENG 196,001,957946,Engler; Adam J.,9996,0,9999,3
1746611040792,BISP 197,001,959851,Wilhelm; James E.,9998,0,9999,1
1746611041818,CAT 124RS,A01,956906,Staff,6,0,25,19
1746611042844,CAT 125RS,A01,922013,Staff,6,0,25,19
1746611043869,CLRE 250,A00,891860,Morris; Sheldon,9995,0,9999,4
1746611045934,CLRE 251R,A00,907817,Mehta; Ravindra L.,9994,0,9999,5
1746611046959,CLRE 252,A00,891864,Cuomo; Raphael Eduardo,9993,0,9999,6
1746611047986,CLRE 253,A00,891867,Vaida; Florin,9994,0,9999,5
1746611047986,CLRE 253,B00,907819,Staff,9999,0,9999,0
1746611049010,CLRE 259,A00,891868,Patel; Hemal,9998,0,9999,1
1746611050036,CLRE 260,A00,891872,Cuomo; Raphael Eduardo,9999,0,9999,0
1746611051063,CLRE 297,001,891888,Cuomo; Raphael Eduardo,9999,0,9999,0
1746611052087,CSE 191,A00,958773,Minnes Kemp; Mor Mia,9995,0,9999,4
1746611053115,CSE 197,001,959846,Minnes Kemp; Mor Mia,9990,0,9999,9
1746611054141,CSS 201S,A01,892054,Mignozzetti; Umberto,25,0,30,5
1746611055170,CSS 202S,A01,892056,Mignozzetti; Umberto,25,0,30,5
1746611056200,DSC 197,001,956898,Eldridge; Justin Matthew,9996,0,9999,3
1746611057228,DSC 297,001,958000,Mazumdar; Arya,9998,0,9999,1
1746611057228,DSC 297,002,959862,Wang; Yusu,9998,0,9999,1
1746611058254,EAP 100,A00,905686,Staff,9778,0,9999,221
1746611059286,ECE 45,A01,892618,Staff,0,0,65,65
1746611061337,ECE 111,A01,892719,Staff,6,0,65,59
1746611062365,ECE 197,001,957920,Mercier; Patrick Philip,9991,0,9999,8
1746611063409,ECON 178,A01,907814,Zhu; Ying,26,0,35,9
1746611064437,EDS 115,A00,895312,Staff,35,0,45,10
1746611065462,EDS 117,A01,895337,Staff,23,0,30,7
1746611066491,EDS 125,A00,895341,Jones; Gabrielle Anastasia,36,0,45,9
1746611067518,EDS 128A,A01,895459,Fargason; Sharon Gayle,44,0,45,1
1746611068543,EDS 128B,A01,895543,Pappas; Elizabeth,44,0,45,1
1746611069571,EDS 139,A00,897203,Pappas; Elizabeth,44,0,45,1
1746611069571,EDS 139,B00,897209,Fargason; Sharon Gayle,41,0,45,4
1746611070596,EDS 201,A00,895545,Staff,22,0,45,23
1746611071621,EDS 203,A01,895581,Halter; Christopher P.,22,0,45,23
1746611072649,EDS 204R,A01,895625,Heinzman; Erica M.,39,0,45,6
1746611072649,EDS 204R,B01,895693,Halter; Christopher P.,10,0,45,35
1746611073674,EDS 206R,A00,895694,Fargason; Sharon Gayle,1,0,30,29
1746611073674,EDS 206R,B00,895695,Choi; Bailey Miyeon,16,0,30,14
1746611074700,EDS 250,A00,895697,Hemans; Patricia Ann Benitez,22,0,45,23
1746611075726,EDS 281,A00,895701,Meyerott; Theresa Ann,1,0,15,14
1746611076753,EDS 284,A00,895736,Meyerott; Theresa Ann,1,0,15,14
1746611077781,EDS 286,A00,897210,Fine; Sarah,0,0,15,15
1746611078805,EDS 289C,A01,895770,Daly; Alan J.,1,0,15,14
1746611079832,EDS 290,A00,897211,Hofstetter; Carolyn,0,0,15,15
1746611080862,LIGM 5A,A00,896162,Fischer-Grunski; Eva K,12,0,20,8
1746611081887,LIGM 5B,A00,896260,Fischer-Grunski; Eva K,17,0,20,3
1746611082913,LIGM 5C,A00,896308,Fischer-Grunski; Eva K,18,0,20,2
1746611083939,LIIT 5AS,A00,896313,Carnelos; Chiara,18,0,20,2
1746611084965,LIIT 5BS,A00,896416,Carnelos; Chiara,20,0,20,0
1746611085993,LIIT 5CS,A00,896564,Carnelos; Chiara,20,0,20,0
1746611087019,LISP 5A,A00,896588,Munoz Sanchez; Alicia,2,0,20,18
1746611088044,LISP 5B,A00,896653,Munoz Sanchez; Alicia,7,0,20,13
1746611089070,LISP 5C,A00,896655,Munoz Sanchez; Alicia,0,1,20,20
1746611090096,MAE 197,001,957918,Kleissl; Jan,9996,0,9999,3
1746611090096,MAE 197,002,959806,Boechler; Nicholas Sebastia,9998,0,9999,1
1746611090096,MAE 197,003,959852,Mullin; Jennifer S,9998,0,9999,1
1746611091121,MATH 2,A01,957937,Staff,33,0,35,2
1746611092153,MATH 197,001,957876,Kedlaya; Kiran S.,9993,0,9999,6
1746611093181,MCWP 40,A00,892729,Duru; Nur,10,0,20,10
1746611093181,MCWP 40,B00,893304,Montejo; Carolina,14,0,20,6
1746611094207,MCWP 40R,A00,893757,Redela; Pamela Morgan,0,5,20,20
1746611095231,MCWP 50,A00,893758,Morshed; Michael James,0,0,20,20
1746611095231,MCWP 50,B00,893761,Bartulis; Jason Michael,16,0,20,4
1746611096255,MCWP 50R,A00,893766,Compas; Sean Matthew,0,1,20,20
1746611096255,MCWP 50R,B00,893769,Carter; Jennifer A,0,1,20,20
1746611096255,MCWP 50R,C00,893771,Krone; Jarret,0,3,20,20
1746611096255,MCWP 50R,D00,893772,Miller; Elizabeth Deen,0,0,20,20
1746611096255,MCWP 50R,E00,893775,Carter; Andrea L,0,1,20,20
1746611097279,MMW 11R,A01,892721,Herbst; Matthew,14,0,30,16
1746611097279,MMW 11R,A02,892722,Herbst; Matthew,0,0,0,3
1746611098320,MMW 12R,A01,892724,Herbst; Matthew,0,11,16,16
1746611098320,MMW 12R,A02,892725,Herbst; Matthew,0,10,16,16
1746611099345,MMW 13R,A01,892727,Staff,0,4,16,16
1746611099345,MMW 13R,A02,892728,Staff,0,4,16,16
1746611099345,MMW 13R,A03,958032,Staff,0,4,16,16
1746611099345,MMW 13R,A04,958033,Staff,0,4,16,16
1746611099345,MMW 13R,A05,958034,Staff,0,4,16,16
1746611100370,SIO 295LS,A00,894015,Staff,5,0,25,20
1746611101397,SIO 295S,A00,894020,Staff,5,0,25,20
1746611102422,SIOC 290S,B01,958918,Merrifield; Mark A,14,0,30,16
1746611103451,SIOC 291S,B01,958922,Gabriel; Corey John,14,0,30,16
1746611104477,SOCI 117,A01,895339,Staff,2,0,5,3
1746611105506,WES 237B,A00,894149,Staff,11,0,20,9
1746611107561,AESE 279B,A00,891859,Staff,13,0,35,22
1746611108591,AIP 197,001,891854,Vespa; Emanuel Ignacio,9999,0,9999,0
1746611109619,ANTH 289S,A00,891856,Gagneux; Pascal,12,0,12,0
1746611110646,BENG 196,001,957946,Engler; Adam J.,9996,0,9999,3
1746611111672,BISP 197,001,959851,Wilhelm; James E.,9998,0,9999,1
1746611112698,CAT 124RS,A01,956906,Staff,6,0,25,19
1746611113726,CAT 125RS,A01,922013,Staff,6,0,25,19
1746611114755,CLRE 250,A00,891860,Morris; Sheldon,9995,0,9999,4
1746611116813,CLRE 251R,A00,907817,Mehta; Ravindra L.,9994,0,9999,5
1746611117838,CLRE 252,A00,891864,Cuomo; Raphael Eduardo,9993,0,9999,6
1746611118865,CLRE 253,A00,891867,Vaida; Florin,9994,0,9999,5
1746611118865,CLRE 253,B00,907819,Staff,9999,0,9999,0
1746611119891,CLRE 259,A00,891868,Patel; Hemal,9998,0,9999,1
1746611120919,CLRE 260,A00,891872,Cuomo; Raphael Eduardo,9999,0,9999,0
1746611121949,CLRE 297,001,891888,Cuomo; Raphael Eduardo,9999,0,9999,0
1746611122979,CSE 191,A00,958773,Minnes Kemp; Mor Mia,9995,0,9999,4
1746611124005,CSE 197,001,959846,Minnes Kemp; Mor Mia,9990,0,9999,9
1746611125036,CSS 201S,A01,892054,Mignozzetti; Umberto,25,0,30,5
1746611126065,CSS 202S,A01,892056,Mignozzetti; Umberto,25,0,30,5
1746611127093,DSC 197,001,956898,Eldridge; Justin Matthew,9996,0,9999,3
1746611128119,DSC 297,001,958000,Mazumdar; Arya,9998,0,9999,1
1746611128119,DSC 297,002,959862,Wang; Yusu,9998,0,9999,1
1746611129144,EAP 100,A00,905686,Staff,9778,0,9999,221
1746611130173,ECE 45,A01,892618,Staff,0,0,65,65
1746611132226,ECE 111,A01,892719,Staff,6,0,65,59
1746611133255,ECE 197,001,957920,Mercier; Patrick Philip,9991,0,9999,8
1746611134284,ECON 178,A01,907814,Zhu; Ying,26,0,35,9
1746611135312,EDS 115,A00,895312,Staff,35,0,45,10
1746611136341,EDS 117,A01,895337,Staff,23,0,30,7
1746611137370,EDS 125,A00,895341,Jones; Gabrielle Anastasia,36,0,45,9
1746611138398,EDS 128A,A01,895459,Fargason; Sharon Gayle,44,0,45,1
1746611139423,EDS 128B,A01,895543,Pappas; Elizabeth,44,0,45,1
1746611140450,EDS 139,A00,897203,Pappas; Elizabeth,44,0,45,1
1746611140450,EDS 139,B00,897209,Fargason; Sharon Gayle,41,0,45,4
1746611141478,EDS 201,A00,895545,Staff,22,0,45,23
1746611142504,EDS 203,A01,895581,Halter; Christopher P.,22,0,45,23
1746611143533,EDS 204R,A01,895625,Heinzman; Erica M.,39,0,45,6
1746611143533,EDS 204R,B01,895693,Halter; Christopher P.,10,0,45,35
1746611144559,EDS 206R,A00,895694,Fargason; Sharon Gayle,1,0,30,29
1746611144559,EDS 206R,B00,895695,Choi; Bailey Miyeon,16,0,30,14
1746611145586,EDS 250,A00,895697,Hemans; Patricia Ann Benitez,22,0,45,23
1746611146616,EDS 281,A00,895701,Meyerott; Theresa Ann,1,0,15,14
1746611147644,EDS 284,A00,895736,Meyerott; Theresa Ann,1,0,15,14
1746611148670,EDS 286,A00,897210,Fine; Sarah,0,0,15,15
1746611149697,EDS 289C,A01,895770,Daly; Alan J.,1,0,15,14
1746611150726,EDS 290,A00,897211,Hofstetter; Carolyn,0,0,15,15
1746611151752,LIGM 5A,A00,896162,Fischer-Grunski; Eva K,12,0,20,8
1746611152782,LIGM 5B,A00,896260,Fischer-Grunski; Eva K,17,0,20,3
1746611153809,LIGM 5C,A00,896308,Fischer-Grunski; Eva K,18,0,20,2
1746611154836,LIIT 5AS,A00,896313,Carnelos; Chiara,18,0,20,2
1746611155864,LIIT 5BS,A00,896416,Carnelos; Chiara,20,0,20,0
1746611156890,LIIT 5CS,A00,896564,Carnelos; Chiara,20,0,20,0
1746611157916,LISP 5A,A00,896588,Munoz Sanchez; Alicia,2,0,20,18
1746611158942,LISP 5B,A00,896653,Munoz Sanchez; Alicia,7,0,20,13
1746611159970,LISP 5C,A00,896655,Munoz Sanchez; Alicia,0,1,20,20
1746611160999,MAE 197,001,957918,Kleissl; Jan,9996,0,9999,3
1746611160999,MAE 197,002,959806,Boechler; Nicholas Sebastia,9998,0,9999,1
1746611160999,MAE 197,003,959852,Mullin; Jennifer S,9998,0,9999,1
1746611162029,MATH 2,A01,957937,Staff,33,0,35,2
1746611163055,MATH 197,001,957876,Kedlaya; Kiran S.,9993,0,9999,6
1746611164081,MCWP 40,A00,892729,Duru; Nur,10,0,20,10
1746611164081,MCWP 40,B00,893304,Montejo; Carolina,14,0,20,6
1746611165110,MCWP 40R,A00,893757,Redela; Pamela Morgan,0,5,20,20
1746611166137,MCWP 50,A00,893758,Morshed; Michael James,0,0,20,20
1746611166137,MCWP 50,B00,893761,Bartulis; Jason Michael,16,0,20,4
1746611167168,MCWP 50R,A00,893766,Compas; Sean Matthew,0,1,20,20
1746611167168,MCWP 50R,B00,893769,Carter; Jennifer A,0,1,20,20
1746611167168,MCWP 50R,C00,893771,Krone; Jarret,0,3,20,20
1746611167168,MCWP 50R,D00,893772,Miller; Elizabeth Deen,0,0,20,20
1746611167168,MCWP 50R,E00,893775,Carter; Andrea L,0,1,20,20
1746611168196,MMW 11R,A01,892721,Herbst; Matthew,14,0,30,16
1746611168196,MMW 11R,A02,892722,Herbst; Matthew,0,0,0,3
1746611169223,MMW 12R,A01,892724,Herbst; Matthew,0,11,16,16
1746611169223,MMW 12R,A02,892725,Herbst; Matthew,0,10,16,16
1746611170250,MMW 13R,A01,892727,Staff,0,4,16,16
1746611170250,MMW 13R,A02,892728,Staff,0,4,16,16
1746611170250,MMW 13R,A03,958032,Staff,0,4,16,16
1746611170250,MMW 13R,A04,958033,Staff,0,4,16,16
1746611170250,MMW 13R,A05,958034,Staff,0,4,16,16
1746611171277,SIO 295LS,A00,894015,Staff,5,0,25,20
1746611172303,SIO 295S,A00,894020,Staff,5,0,25,20
1746611173332,SIOC 290S,B01,958918,Merrifield; Mark A,14,0,30,16
1746611174360,SIOC 291S,B01,958922,Gabriel; Corey John,14,0,30,16
1746611175408,SOCI 117,A01,895339,Staff,2,0,5,3
1746611176437,WES 237B,A00,894149,Staff,11,0,20,9
1746611178510,AESE 279B,A00,891859,Staff,13,0,35,22
1746611179536,AIP 197,001,891854,Vespa; Emanuel Ignacio,9999,0,9999,0
1746611180562,ANTH 289S,A00,891856,Gagneux; Pascal,12,0,12,0
1746611181589,BENG 196,001,957946,Engler; Adam J.,9996,0,9999,3
1746611182617,BISP 197,001,959851,Wilhelm; James E.,9998,0,9999,1
1746611183644,CAT 124RS,A01,956906,Staff,6,0,25,19
1746611184670,CAT 125RS,A01,922013,Staff,6,0,25,19
1746611185698,CLRE 250,A00,891860,Morris; Sheldon,9995,0,9999,4
1746611187749,CLRE 251R,A00,907817,Mehta; Ravindra L.,9994,0,9999,5
1746611188774,CLRE 252,A00,891864,Cuomo; Raphael Eduardo,9993,0,9999,6
1746611189800,CLRE 253,A00,891867,Vaida; Florin,9994,0,9999,5
1746611189800,CLRE 253,B00,907819,Staff,9999,0,9999,0
1746611190828,CLRE 259,A00,891868,Patel; Hemal,9998,0,9999,1
1746611191853,CLRE 260,A00,891872,Cuomo; Raphael Eduardo,9999,0,9999,0
1746611192879,CLRE 297,001,891888,Cuomo; Raphael Eduardo,9999,0,9999,0
1746611193904,CSE 191,A00,958773,Minnes Kemp; Mor Mia,9995,0,9999,4
1746611194932,CSE 197,001,959846,Minnes Kemp; Mor Mia,9990,0,9999,9
1746611195957,CSS 201S,A01,892054,Mignozzetti; Umberto,25,0,30,5
1746611196983,CSS 202S,A01,892056,Mignozzetti; Umberto,25,0,30,5
1746611198008,DSC 197,001,956898,Eldridge; Justin Matthew,9996,0,9999,3
1746611199032,DSC 297,001,958000,Mazumdar; Arya,9998,0,9999,1
1746611199032,DSC 297,002,959862,Wang; Yusu,9998,0,9999,1
1746611200060,EAP 100,A00,905686,Staff,9778,0,9999,221
1746611201089,ECE 45,A01,892618,Staff,0,0,65,65
1746611203140,ECE 111,A01,892719,Staff,6,0,65,59
1746611204168,ECE 197,001,957920,Mercier; Patrick Philip,9991,0,9999,8
1746611205200,ECON 178,A01,907814,Zhu; Ying,26,0,35,9
1746611206226,EDS 115,A00,895312,Staff,35,0,45,10
1746611207256,EDS 117,A01,895337,Staff,23,0,30,7
1746611208284,EDS 125,A00,895341,Jones; Gabrielle Anastasia,36,0,45,9
1746611209310,EDS 128A,A01,895459,Fargason; Sharon Gayle,44,0,45,1
1746611210339,EDS 128B,A01,895543,Pappas; Elizabeth,44,0,45,1
1746611211364,EDS 139,A00,897203,Pappas; Elizabeth,44,0,45,1
1746611211364,EDS 139,B00,897209,Fargason; Sharon Gayle,41,0,45,4
1746611212391,EDS 201,A00,895545,Staff,22,0,45,23
1746611213418,EDS 203,A01,895581,Halter; Christopher P.,22,0,45,23
1746611214447,EDS 204R,A01,895625,Heinzman; Erica M.,39,0,45,6
1746611214447,EDS 204R,B01,895693,Halter; Christopher P.,10,0,45,35
1746611215471,EDS 206R,A00,895694,Fargason; Sharon Gayle,1,0,30,29
1746611215471,EDS 206R,B00,895695,Choi; Bailey Miyeon,16,0,30,14
1746611216497,EDS 250,A00,895697,Hemans; Patricia Ann Benitez,22,0,45,23
1746611217522,EDS 281,A00,895701,Meyerott; Theresa Ann,1,0,15,14
1746611218549,EDS 284,A00,895736,Meyerott; Theresa Ann,1,0,15,14
1746611219576,EDS 286,A00,897210,Fine; Sarah,0,0,15,15
1746611220606,EDS 289C,A01,895770,Daly; Alan J.,1,0,15,14
1746611221631,EDS 290,A00,897211,Hofstetter; Carolyn,0,0,15,15
1746611222662,LIGM 5A,A00,896162,Fischer-Grunski; Eva K,12,0,20,8
1746611223687,LIGM 5B,A00,896260,Fischer-Grunski; Eva K,17,0,20,3
1746611224715,LIGM 5C,A00,896308,Fischer-Grunski; Eva K,18,0,20,2
1746611225742,LIIT 5AS,A00,896313,Carnelos; Chiara,18,0,20,2
1746611226768,LIIT 5BS,A00,896416,Carnelos; Chiara,20,0,20,0
1746611227794,LIIT 5CS,A00,896564,Carnelos; Chiara,20,0,20,0
1746611228820,LISP 5A,A00,896588,Munoz Sanchez; Alicia,2,0,20,18
1746611229848,LISP 5B,A00,896653,Munoz Sanchez; Alicia,7,0,20,13
1746611230878,LISP 5C,A00,896655,Munoz Sanchez; Alicia,0,1,20,20
1746611231906,MAE 197,001,957918,Kleissl; Jan,9996,0,9999,3
1746611231906,MAE 197,002,959806,Boechler; Nicholas Sebastia,9998,0,9999,1
1746611231906,MAE 197,003,959852,Mullin; Jennifer S,9998,0,9999,1
1746611232937,MATH 2,A01,957937,Staff,33,0,35,2
1746611233964,MATH 197,001,957876,Kedlaya; Kiran S.,9993,0,9999,6
1746611234995,MCWP 40,A00,892729,Duru; Nur,10,0,20,10
1746611234995,MCWP 40,B00,893304,Montejo; Carolina,14,0,20,6
1746611236020,MCWP 40R,A00,893757,Redela; Pamela Morgan,0,5,20,20
1746611237047,MCWP 50,A00,893758,Morshed; Michael James,0,0,20,20
1746611237047,MCWP 50,B00,893761,Bartulis; Jason Michael,16,0,20,4
1746611238076,MCWP 50R,A00,893766,Compas; Sean Matthew,0,1,20,20
1746611238076,MCWP 50R,B00,893769,Carter; Jennifer A,0,1,20,20
1746611238076,MCWP 50R,C00,893771,Krone; Jarret,0,3,20,20
1746611238076,MCWP 50R,D00,893772,Miller; Elizabeth Deen,0,0,20,20
1746611238076,MCWP 50R,E00,893775,Carter; Andrea L,0,1,20,20
1746611239133,MMW 11R,A01,892721,Herbst; Matthew,14,0,30,16
1746611239133,MMW 11R,A02,892722,Herbst; Matthew,0,0,0,3
1746611240163,MMW 12R,A01,892724,Herbst; Matthew,0,11,16,16
1746611240163,MMW 12R,A02,892725,Herbst; Matthew,0,10,16,16
1746611241188,MMW 13R,A01,892727,Staff,0,4,16,16
1746611241188,MMW 13R,A02,892728,Staff,0,4,16,16
1746611241188,MMW 13R,A03,958032,Staff,0,4,16,16
1746611241188,MMW 13R,A04,958033,Staff,0,4,16,16
1746611241188,MMW 13R,A05,958034,Staff,0,4,16,16
1746611242216,SIO 295LS,A00,894015,Staff,5,0,25,20
1746611243242,SIO 295S,A00,894020,Staff,5,0,25,20
1746611244269,SIOC 290S,B01,958918,Merrifield; Mark A,14,0,30,16
1746611245298,SIOC 291S,B01,958922,Gabriel; Corey John,14,0,30,16
1746611246322,SOCI 117,A01,895339,Staff,2,0,5,3
1746611247351,WES 237B,A00,894149,Staff,11,0,20,9
1746611249415,AESE 279B,A00,891859,Staff,13,0,35,22
1746611250440,AIP 197,001,891854,Vespa; Emanuel Ignacio,9999,0,9999,0
1746611251464,ANTH 289S,A00,891856,Gagneux; Pascal,12,0,12,0
1746611252492,BENG 196,001,957946,Engler; Adam J.,9996,0,9999,3
1746611253518,BISP 197,001,959851,Wilhelm; James E.,9998,0,9999,1
1746611254544,CAT 124RS,A01,956906,Staff,6,0,25,19
1746611255572,CAT 125RS,A01,922013,Staff,6,0,25,19
1746611256599,CLRE 250,A00,891860,Morris; Sheldon,9995,0,9999,4
1746611258653,CLRE 251R,A00,907817,Mehta; Ravindra L.,9994,0,9999,5
1746611259680,CLRE 252,A00,891864,Cuomo; Raphael Eduardo,9993,0,9999,6
1746611260708,CLRE 253,A00,891867,Vaida; Florin,9994,0,9999,5
1746611260708,CLRE 253,B00,907819,Staff,9999,0,9999,0
1746611261733,CLRE 259,A00,891868,Patel; Hemal,9998,0,9999,1
1746611262758,CLRE 260,A00,891872,Cuomo; Raphael Eduardo,9999,0,9999,0
1746611263785,CLRE 297,001,891888,Cuomo; Raphael Eduardo,9999,0,9999,0
1746611264812,CSE 191,A00,958773,Minnes Kemp; Mor Mia,9995,0,9999,4
1746611265840,CSE 197,001,959846,Minnes Kemp; Mor Mia,9990,0,9999,9
1746611266870,CSS 201S,A01,892054,Mignozzetti; Umberto,25,0,30,5
1746611267895,CSS 202S,A01,892056,Mignozzetti; Umberto,25,0,30,5
1746611268923,DSC 197,001,956898,Eldridge; Justin Matthew,9996,0,9999,3
1746611269951,DSC 297,001,958000,Mazumdar; Arya,9998,0,9999,1
1746611269951,DSC 297,002,959862,Wang; Yusu,9998,0,9999,1
1746611270976,EAP 100,A00,905686,Staff,9778,0,9999,221
1746611272004,ECE 45,A01,892618,Staff,0,0,65,65
1746611274054,ECE 111,A01,892719,Staff,6,0,65,59
1746611275077,ECE 197,001,957920,Mercier; Patrick Philip,9991,0,9999,8
1746611276106,ECON 178,A01,907814,Zhu; Ying,26,0,35,9
1746611277132,EDS 115,A00,895312,Staff,35,0,45,10
1746611278162,EDS 117,A01,895337,Staff,23,0,30,7
1746611279187,EDS 125,A00,895341,Jones; Gabrielle Anastasia,36,0,45,9
1746611280217,EDS 128A,A01,895459,Fargason; Sharon Gayle,44,0,45,1
1746611281244,EDS 128B,A01,895543,Pappas; Elizabeth,44,0,45,1
1746611282270,EDS 139,A00,897203,Pappas; Elizabeth,44,0,45,1
1746611282270,EDS 139,B00,897209,Fargason; Sharon Gayle,41,0,45,4
1746611283298,EDS 201,A00,895545,Staff,22,0,45,23
1746611284327,EDS 203,A01,895581,Halter; Christopher P.,22,0,45,23
1746611285369,EDS 204R,A01,895625,Heinzman; Erica M.,39,0,45,6
1746611285369,EDS 204R,B01,895693,Halter; Christopher P.,10,0,45,35
1746611286398,EDS 206R,A00,895694,Fargason; Sharon Gayle,1,0,30,29
1746611286398,EDS 206R,B00,895695,Choi; Bailey Miyeon,16,0,30,14
1746611287422,EDS 250,A00,895697,Hemans; Patricia Ann Benitez,22,0,45,23
1746611288447,EDS 281,A00,895701,Meyerott; Theresa Ann,1,0,15,14
1746611289473,EDS 284,A00,895736,Meyerott; Theresa Ann,1,0,15,14
1746611290498,EDS 286,A00,897210,Fine; Sarah,0,0,15,15
1746611291524,EDS 289C,A01,895770,Daly; Alan J.,1,0,15,14
1746611292549,EDS 290,A00,897211,Hofstetter; Carolyn,0,0,15,15
1746611293581,LIGM 5A,A00,896162,Fischer-Grunski; Eva K,12,0,20,8
1746611294609,LIGM 5B,A00,896260,Fischer-Grunski; Eva K,17,0,20,3
1746611295637,LIGM 5C,A00,896308,Fischer-Grunski; Eva K,18,0,20,2
1746611296665,LIIT 5AS,A00,896313,Carnelos; Chiara,18,0,20,2
1746611297692,LIIT 5BS,A00,896416,Carnelos; Chiara,20,0,20,0
1746611298718,LIIT 5CS,A00,896564,Carnelos; Chiara,20,0,20,0
1746611299743,LISP 5A,A00,896588,Munoz Sanchez; Alicia,2,0,20,18
1746611300769,LISP 5B,A00,896653,Munoz Sanchez; Alicia,7,0,20,13
1746611301793,LISP 5C,A00,896655,Munoz Sanchez; Alicia,0,1,20,20
1746611302819,MAE 197,001,957918,Kleissl; Jan,9996,0,9999,3
1746611302819,MAE 197,002,959806,Boechler; Nicholas Sebastia,9998,0,9999,1
1746611302819,MAE 197,003,959852,Mullin; Jennifer S,9998,0,9999,1
1746611303845,MATH 2,A01,957937,Staff,33,0,35,2
1746611304869,MATH 197,001,957876,Kedlaya; Kiran S.,9993,0,9999,6
1746611305896,MCWP 40,A00,892729,Duru; Nur,10,0,20,10
1746611305896,MCWP 40,B00,893304,Montejo; Carolina,14,0,20,6
1746611306923,MCWP 40R,A00,893757,Redela; Pamela Morgan,0,5,20,20
1746611307948,MCWP 50,A00,893758,Morshed; Michael James,0,0,20,20
1746611307948,MCWP 50,B00,893761,Bartulis; Jason Michael,16,0,20,4
1746611308974,MCWP 50R,A00,893766,Compas; Sean Matthew,0,1,20,20
1746611308974,MCWP 50R,B00,893769,Carter; Jennifer A,0,1,20,20
1746611308974,MCWP 50R,C00,893771,Krone; Jarret,0,3,20,20
1746611308974,MCWP 50R,D00,893772,Miller; Elizabeth Deen,0,0,20,20
1746611308974,MCWP 50R,E00,893775,Carter; Andrea L,0,1,20,20
1746611309998,MMW 11R,A01,892721,Herbst; Matthew,14,0,30,16
1746611309998,MMW 11R,A02,892722,Herbst; Matthew,0,0,0,3
1746611311022,MMW 12R,A01,892724,Herbst; Matthew,0,11,16,16
1746611311022,MMW 12R,A02,892725,Herbst; Matthew,0,10,16,16
1746611312050,MMW 13R,A01,892727,Staff,0,4,16,16
1746611312050,MMW 13R,A02,892728,Staff,0,4,16,16
1746611312050,MMW 13R,A03,958032,Staff,0,4,16,16
1746611312050,MMW 13R,A04,958033,Staff,0,4,16,16
1746611312050,MMW 13R,A05,958034,Staff,0,4,16,16
1746611313076,SIO 295LS,A00,894015,Staff,5,0,25,20
1746611314105,SIO 295S,A00,894020,Staff,5,0,25,20
1746611315136,SIOC 290S,B01,958918,Merrifield; Mark A,14,0,30,16
1746611316167,SIOC 291S,B01,958922,Gabriel; Corey John,14,0,30,16
1746611317191,SOCI 117,A01,895339,Staff,2,0,5,3
1746611318218,WES 237B,A00,894149,Staff,11,0,20,9
1746611320273,AESE 279B,A00,891859,Staff,13,0,35,22
1746611321301,AIP 197,001,891854,Vespa; Emanuel Ignacio,9999,0,9999,0
1746611322326,ANTH 289S,A00,891856,Gagneux; Pascal,12,0,12,0
1746611323351,BENG 196,001,957946,Engler; Adam J.,9996,0,9999,3
1746611324374,BISP 197,001,959851,Wilhelm; James E.,9998,0,9999,1
1746611325399,CAT 124RS,A01,956906,Staff,6,0,25,19
1746611326427,CAT 125RS,A01,922013,Staff,6,0,25,19
1746611327453,CLRE 250,A00,891860,Morris; Sheldon,9995,0,9999,4
1746611329506,CLRE 251R,A00,907817,Mehta; Ravindra L.,9994,0,9999,5
1746611330533,CLRE 252,A00,891864,Cuomo; Raphael Eduardo,9993,0,9999,6
1746611331559,CLRE 253,A00,891867,Vaida; Florin,9994,0,9999,5
1746611331559,CLRE 253,B00,907819,Staff,9999,0,9999,0
1746611332588,CLRE 259,A00,891868,Patel; Hemal,9998,0,9999,1
1746611333650,CLRE 260,A00,891872,Cuomo; Raphael Eduardo,9999,0,9999,0
1746611334693,CLRE 297,001,891888,Cuomo; Raphael Eduardo,9999,0,9999,0
1746611335719,CSE 191,A00,958773,Minnes Kemp; Mor Mia,9995,0,9999,4
1746611336747,CSE 197,001,959846,Minnes Kemp; Mor Mia,9990,0,9999,9
1746611337775,CSS 201S,A01,892054,Mignozzetti; Umberto,25,0,30,5
1746611338801,CSS 202S,A01,892056,Mignozzetti; Umberto,25,0,30,5
1746611339828,DSC 197,001,956898,Eldridge; Justin Matthew,9996,0,9999,3
1746611340857,DSC 297,001,958000,Mazumdar; Arya,9998,0,9999,1
1746611340857,DSC 297,002,959862,Wang; Yusu,9998,0,9999,1
1746611341881,EAP 100,A00,905686,Staff,9778,0,9999,221
1746611342907,ECE 45,A01,892618,Staff,0,0,65,65
1746611344958,ECE 111,A01,892719,Staff,6,0,65,59
1746611345984,ECE 197,001,957920,Mercier; Patrick Philip,9991,0,9999,8
1746611347009,ECON 178,A01,907814,Zhu; Ying,26,0,35,9
1746611348033,EDS 115,A00,895312,Staff,35,0,45,10
1746611349056,EDS 117,A01,895337,Staff,23,0,30,7
1746611350080,EDS 125,A00,895341,Jones; Gabrielle Anastasia,36,0,45,9
1746611351107,EDS 128A,A01,895459,Fargason; Sharon Gayle,44,0,45,1
1746611352137,EDS 128B,A01,895543,Pappas; Elizabeth,44,0,45,1
1746611353189,EDS 139,A00,897203,Pappas; Elizabeth,44,0,45,1
1746611353189,EDS 139,B00,897209,Fargason; Sharon Gayle,41,0,45,4
1746611354217,EDS 201,A00,895545,Staff,22,0,45,23
1746611355242,EDS 203,A01,895581,Halter; Christopher P.,22,0,45,23
1746611356270,EDS 204R,A01,895625,Heinzman; Erica M.,39,0,45,6
1746611356270,EDS 204R,B01,895693,Halter; Christopher P.,10,0,45,35
1746611357295,EDS 206R,A00,895694,Fargason; Sharon Gayle,1,0,30,29
1746611357295,EDS 206R,B00,895695,Choi; Bailey Miyeon,16,0,30,14
1746611358320,EDS 250,A00,895697,Hemans; Patricia Ann Benitez,22,0,45,23
1746611359349,EDS 281,A00,895701,Meyerott; Theresa Ann,1,0,15,14
1746611360376,EDS 284,A00,895736,Meyerott; Theresa Ann,1,0,15,14
1746611361404,EDS 286,A00,897210,Fine; Sarah,0,0,15,15
1746611362430,EDS 289C,A01,895770,Daly; Alan J.,1,0,15,14
1746611363457,EDS 290,A00,897211,Hofstetter; Carolyn,0,0,15,15
1746611364485,LIGM 5A,A00,896162,Fischer-Grunski; Eva K,12,0,20,8
1746611365510,LIGM 5B,A00,896260,Fischer-Grunski; Eva K,17,0,20,3
1746611366538,LIGM 5C,A00,896308,Fischer-Grunski; Eva K,18,0,20,2
1746611367565,LIIT 5AS,A00,896313,Carnelos; Chiara,18,0,20,2
1746611368594,LIIT 5BS,A00,896416,Carnelos; Chiara,20,0,20,0
1746611369620,LIIT 5CS,A00,896564,Carnelos; Chiara,20,0,20,0
1746611370648,LISP 5A,A00,896588,Munoz Sanchez; Alicia,2,0,20,18
1746611371677,LISP 5B,A00,896653,Munoz Sanchez; Alicia,7,0,20,13
1746611372703,LISP 5C,A00,896655,Munoz Sanchez; Alicia,0,1,20,20
1746611373732,MAE 197,001,957918,Kleissl; Jan,9996,0,9999,3
1746611373732,MAE 197,002,959806,Boechler; Nicholas Sebastia,9998,0,9999,1
1746611373732,MAE 197,003,959852,Mullin; Jennifer S,9998,0,9999,1
1746611374760,MATH 2,A01,957937,Staff,33,0,35,2
1746611375786,MATH 197,001,957876,Kedlaya; Kiran S.,9993,0,9999,6
1746611376814,MCWP 40,A00,892729,Duru; Nur,10,0,20,10
1746611376814,MCWP 40,B00,893304,Montejo; Carolina,14,0,20,6
1746611377839,MCWP 40R,A00,893757,Redela; Pamela Morgan,0,5,20,20
1746611378867,MCWP 50,A00,893758,Morshed; Michael James,0,0,20,20
1746611378867,MCWP 50,B00,893761,Bartulis; Jason Michael,16,0,20,4
1746611379895,MCWP 50R,A00,893766,Compas; Sean Matthew,0,1,20,20
1746611379895,MCWP 50R,B00,893769,Carter; Jennifer A,0,1,20,20
1746611379895,MCWP 50R,C00,893771,Krone; Jarret,0,3,20,20
1746611379895,MCWP 50R,D00,893772,Miller; Elizabeth Deen,0,0,20,20
1746611379895,MCWP 50R,E00,893775,Carter; Andrea L,0,1,20,20
1746611380922,MMW 11R,A01,892721,Herbst; Matthew,14,0,30,16
1746611380922,MMW 11R,A02,892722,Herbst; Matthew,0,0,0,3
1746611381950,MMW 12R,A01,892724,Herbst; Matthew,0,11,16,16
1746611381950,MMW 12R,A02,892725,Herbst; Matthew,0,10,16,16
1746611382980,MMW 13R,A01,892727,Staff,0,4,16,16
1746611382980,MMW 13R,A02,892728,Staff,0,4,16,16
1746611382980,MMW 13R,A03,958032,Staff,0,4,16,16
1746611382980,MMW 13R,A04,958033,Staff,0,4,16,16
1746611382980,MMW 13R,A05,958034,Staff,0,4,16,16
1746611384006,SIO 295LS,A00,894015,Staff,5,0,25,20
1746611385035,SIO 295S,A00,894020,Staff,5,0,25,20
1746611386061,SIOC 290S,B01,958918,Merrifield; Mark A,14,0,30,16
1746611387085,SIOC 291S,B01,958922,Gabriel; Corey John,14,0,30,16
1746611388114,SOCI 117,A01,895339,Staff,2,0,5,3
1746611389141,WES 237B,A00,894149,Staff,11,0,20,9
1746611391215,AESE 279B,A00,891859,Staff,13,0,35,22
1746611392239,AIP 197,001,891854,Vespa; Emanuel Ignacio,9999,0,9999,0
1746611393267,ANTH 289S,A00,891856,Gagneux; Pascal,12,0,12,0
1746611394293,BENG 196,001,957946,Engler; Adam J.,9996,0,9999,3
1746611395318,BISP 197,001,959851,Wilhelm; James E.,9998,0,9999,1
1746611396346,CAT 124RS,A01,956906,Staff,6,0,25,19
1746611397374,CAT 125RS,A01,922013,Staff,6,0,25,19
1746611398400,CLRE 250,A00,891860,Morris; Sheldon,9995,0,9999,4
1746611400451,CLRE 251R,A00,907817,Mehta; Ravindra L.,9994,0,9999,5
1746611401477,CLRE 252,A00,891864,Cuomo; Raphael Eduardo,9993,0,9999,6
1746611402505,CLRE 253,A00,891867,Vaida; Florin,9994,0,9999,5
1746611402505,CLRE 253,B00,907819,Staff,9999,0,9999,0
1746611403535,CLRE 259,A00,891868,Patel; Hemal,9998,0,9999,1
1746611404563,CLRE 260,A00,891872,Cuomo; Raphael Eduardo,9999,0,9999,0
1746611405589,CLRE 297,001,891888,Cuomo; Raphael Eduardo,9999,0,9999,0
1746611406618,CSE 191,A00,958773,Minnes Kemp; Mor Mia,9995,0,9999,4
1746611407646,CSE 197,001,959846,Minnes Kemp; Mor Mia,9990,0,9999,9
1746611408676,CSS 201S,A01,892054,Mignozzetti; Umberto,25,0,30,5
1746611409703,CSS 202S,A01,892056,Mignozzetti; Umberto,25,0,30,5
1746611410730,DSC 197,001,956898,Eldridge; Justin Matthew,9996,0,9999,3
1746611411757,DSC 297,001,958000,Mazumdar; Arya,9998,0,9999,1
1746611411757,DSC 297,002,959862,Wang; Yusu,9998,0,9999,1
1746611412785,EAP 100,A00,905686,Staff,9778,0,9999,221
1746611413818,ECE 45,A01,892618,Staff,0,0,65,65
1746611415868,ECE 111,A01,892719,Staff,6,0,65,59
1746611416896,ECE 197,001,957920,Mercier; Patrick Philip,9991,0,9999,8
1746611417921,ECON 178,A01,907814,Zhu; Ying,26,0,35,9
1746611418947,EDS 115,A00,895312,Staff,35,0,45,10
1746611419976,EDS 117,A01,895337,Staff,23,0,30,7
1746611421000,EDS 125,A00,895341,Jones; Gabrielle Anastasia,36,0,45,9
1746611422028,EDS 128A,A01,895459,Fargason; Sharon Gayle,44,0,45,1
1746611423052,EDS 128B,A01,895543,Pappas; Elizabeth,44,0,45,1
1746611424082,EDS 139,A00,897203,Pappas; Elizabeth,44,0,45,1
1746611424082,EDS 139,B00,897209,Fargason; Sharon Gayle,41,0,45,4
1746611425107,EDS 201,A00,895545,Staff,22,0,45,23
1746611426133,EDS 203,A01,895581,Halter; Christopher P.,22,0,45,23
1746611427162,EDS 204R,A01,895625,Heinzman; Erica M.,39,0,45,6
1746611427162,EDS 204R,B01,895693,Halter; Christopher P.,10,0,45,35
1746611428186,EDS 206R,A00,895694,Fargason; Sharon Gayle,1,0,30,29
1746611428186,EDS 206R,B00,895695,Choi; Bailey Miyeon,16,0,30,14
1746611429214,EDS 250,A00,895697,Hemans; Patricia Ann Benitez,22,0,45,23
1746611430239,EDS 281,A00,895701,Meyerott; Theresa Ann,1,0,15,14
1746611431266,EDS 284,A00,895736,Meyerott; Theresa Ann,1,0,15,14
1746611432292,EDS 286,A00,897210,Fine; Sarah,0,0,15,15
1746611433321,EDS 289C,A01,895770,Daly; Alan J.,1,0,15,14
1746611434346,EDS 290,A00,897211,Hofstetter; Carolyn,0,0,15,15
1746611435376,LIGM 5A,A00,896162,Fischer-Grunski; Eva K,12,0,20,8
1746611436403,LIGM 5B,A00,896260,Fischer-Grunski; Eva K,17,0,20,3
1746611437429,LIGM 5C,A00,896308,Fischer-Grunski; Eva K,18,0,20,2
1746611438458,LIIT 5AS,A00,896313,Carnelos; Chiara,18,0,20,2
1746611439484,LIIT 5BS,A00,896416,Carnelos; Chiara,20,0,20,0
1746611440514,LIIT 5CS,A00,896564,Carnelos; Chiara,20,0,20,0
1746611441541,LISP 5A,A00,896588,Munoz Sanchez; Alicia,2,0,20,18
1746611442566,LISP 5B,A00,896653,Munoz Sanchez; Alicia,7,0,20,13
1746611443597,LISP 5C,A00,896655,Munoz Sanchez; Alicia,0,1,20,20
1746611444628,MAE 197,001,957918,Kleissl; Jan,9996,0,9999,3
1746611444628,MAE 197,002,959806,Boechler; Nicholas Sebastia,9998,0,9999,1
1746611444628,MAE 197,003,959852,Mullin; Jennifer S,9998,0,9999,1
1746611445654,MATH 2,A01,957937,Staff,33,0,35,2
1746611446680,MATH 197,001,957876,Kedlaya; Kiran S.,9993,0,9999,6
1746611447921,MCWP 40,A00,892729,Duru; Nur,10,0,20,10
1746611447921,MCWP 40,B00,893304,Montejo; Carolina,14,0,20,6
1746611448950,MCWP 40R,A00,893757,Redela; Pamela Morgan,0,5,20,20
1746611449976,MCWP 50,A00,893758,Morshed; Michael James,0,0,20,20
1746611449976,MCWP 50,B00,893761,Bartulis; Jason Michael,16,0,20,4
1746611451001,MCWP 50R,A00,893766,Compas; Sean Matthew,0,1,20,20
1746611451001,MCWP 50R,B00,893769,Carter; Jennifer A,0,1,20,20
1746611451001,MCWP 50R,C00,893771,Krone; Jarret,0,3,20,20
1746611451001,MCWP 50R,D00,893772,Miller; Elizabeth Deen,0,0,20,20
1746611451001,MCWP 50R,E00,893775,Carter; Andrea L,0,1,20,20
1746611452028,MMW 11R,A01,892721,Herbst; Matthew,14,0,30,16
1746611452028,MMW 11R,A02,892722,Herbst; Matthew,0,0,0,3
1746611453055,MMW 12R,A01,892724,Herbst; Matthew,0,11,16,16
1746611453055,MMW 12R,A02,892725,Herbst; Matthew,0,10,16,16
1746611454083,MMW 13R,A01,892727,Staff,0,4,16,16
1746611454083,MMW 13R,A02,892728,Staff,0,4,16,16
1746611454083,MMW 13R,A03,958032,Staff,0,4,16,16
1746611454083,MMW 13R,A04,958033,Staff,0,4,16,16
1746611454083,MMW 13R,A05,958034,Staff,0,4,16,16
1746611455110,SIO 295LS,A00,894015,Staff,5,0,25,20
1746611456137,SIO 295S,A00,894020,Staff,5,0,25,20
1746611457162,SIOC 290S,B01,958918,Merrifield; Mark A,14,0,30,16
1746611458193,SIOC 291S,B01,958922,Gabriel; Corey John,14,0,30,16
1746611459222,SOCI 117,A01,895339,Staff,2,0,5,3
1746611460251,WES 237B,A00,894149,Staff,11,0,20,9
1746611462327,AESE 279B,A00,891859,Staff,13,0,35,22
1746611463353,AIP 197,001,891854,Vespa; Emanuel Ignacio,9999,0,9999,0
1746611464381,ANTH 289S,A00,891856,Gagneux; Pascal,12,0,12,0
1746611465408,BENG 196,001,957946,Engler; Adam J.,9996,0,9999,3
1746611466437,BISP 197,001,959851,Wilhelm; James E.,9998,0,9999,1
1746611467463,CAT 124RS,A01,956906,Staff,6,0,25,19
1746611468490,CAT 125RS,A01,922013,Staff,6,0,25,19
1746611469515,CLRE 250,A00,891860,Morris; Sheldon,9995,0,9999,4
1746611471569,CLRE 251R,A00,907817,Mehta; Ravindra L.,9994,0,9999,5
1746611472595,CLRE 252,A00,891864,Cuomo; Raphael Eduardo,9993,0,9999,6
1746611473621,CLRE 253,A00,891867,Vaida; Florin,9994,0,9999,5
1746611473621,CLRE 253,B00,907819,Staff,9999,0,9999,0
1746611474647,CLRE 259,A00,891868,Patel; Hemal,9998,0,9999,1
1746611475673,CLRE 260,A00,891872,Cuomo; Raphael Eduardo,9999,0,9999,0
1746611476702,CLRE 297,001,891888,Cuomo; Raphael Eduardo,9999,0,9999,0
1746611477728,CSE 191,A00,958773,Minnes Kemp; Mor Mia,9995,0,9999,4
1746611478755,CSE 197,001,959846,Minnes Kemp; Mor Mia,9990,0,9999,9
1746611479785,CSS 201S,A01,892054,Mignozzetti; Umberto,25,0,30,5
1746611480815,CSS 202S,A01,892056,Mignozzetti; Umberto,25,0,30,5
1746611481843,DSC 197,001,956898,Eldridge; Justin Matthew,9996,0,9999,3
1746611482871,DSC 297,001,958000,Mazumdar; Arya,9998,0,9999,1
1746611482871,DSC 297,002,959862,Wang; Yusu,9998,0,9999,1
1746611483899,EAP 100,A00,905686,Staff,9778,0,9999,221
1746611484927,ECE 45,A01,892618,Staff,0,0,65,65
1746611486977,ECE 111,A01,892719,Staff,6,0,65,59
1746611488003,ECE 197,001,957920,Mercier; Patrick Philip,9991,0,9999,8
1746611489029,ECON 178,A01,907814,Zhu; Ying,26,0,35,9
1746611490055,EDS 115,A00,895312,Staff,35,0,45,10
1746611491079,EDS 117,A01,895337,Staff,23,0,30,7
1746611492105,EDS 125,A00,895341,Jones; Gabrielle Anastasia,36,0,45,9
1746611493133,EDS 128A,A01,895459,Fargason; Sharon Gayle,44,0,45,1
1746611494159,EDS 128B,A01,895543,Pappas; Elizabeth,44,0,45,1
1746611495187,EDS 139,A00,897203,Pappas; Elizabeth,44,0,45,1
1746611495187,EDS 139,B00,897209,Fargason; Sharon Gayle,41,0,45,4
1746611496215,EDS 201,A00,895545,Staff,22,0,45,23
1746611497240,EDS 203,A01,895581,Halter; Christopher P.,22,0,45,23
1746611498268,EDS 204R,A01,895625,Heinzman; Erica M.,39,0,45,6
1746611498268,EDS 204R,B01,895693,Halter; Christopher P.,10,0,45,35
1746611499296,EDS 206R,A00,895694,Fargason; Sharon Gayle,1,0,30,29
1746611499296,EDS 206R,B00,895695,Choi; Bailey Miyeon,16,0,30,14
1746611500322,EDS 250,A00,895697,Hemans; Patricia Ann Benitez,22,0,45,23
1746611501350,EDS 281,A00,895701,Meyerott; Theresa Ann,1,0,15,14
1746611502378,EDS 284,A00,895736,Meyerott; Theresa Ann,1,0,15,14
1746611503404,EDS 286,A00,897210,Fine; Sarah,0,0,15,15
1746611504433,EDS 289C,A01,895770,Daly; Alan J.,1,0,15,14
1746611505458,EDS 290,A00,897211,Hofstetter; Carolyn,0,0,15,15
1746611506486,LIGM 5A,A00,896162,Fischer-Grunski; Eva K,12,0,20,8
1746611507514,LIGM 5B,A00,896260,Fischer-Grunski; Eva K,17,0,20,3
1746611508539,LIGM 5C,A00,896308,Fischer-Grunski; Eva K,18,0,20,2
1746611509569,LIIT 5AS,A00,896313,Carnelos; Chiara,18,0,20,2
1746611510600,LIIT 5BS,A00,896416,Carnelos; Chiara,20,0,20,0
1746611511626,LIIT 5CS,A00,896564,Carnelos; Chiara,20,0,20,0
1746611512652,LISP 5A,A00,896588,Munoz Sanchez; Alicia,2,0,20,18
1746611513678,LISP 5B,A00,896653,Munoz Sanchez; Alicia,7,0,20,13
1746611514703,LISP 5C,A00,896655,Munoz Sanchez; Alicia,0,1,20,20
1746611515730,MAE 197,001,957918,Kleissl; Jan,9996,0,9999,3
1746611515730,MAE 197,002,959806,Boechler; Nicholas Sebastia,9998,0,9999,1
1746611515730,MAE 197,003,959852,Mullin; Jennifer S,9998,0,9999,1
1746611516757,MATH 2,A01,957937,Staff,33,0,35,2
1746611517785,MATH 197,001,957876,Kedlaya; Kiran S.,9993,0,9999,6
1746611518809,MCWP 40,A00,892729,Duru; Nur,10,0,20,10
1746611518809,MCWP 40,B00,893304,Montejo; Carolina,14,0,20,6
1746611519836,MCWP 40R,A00,893757,Redela; Pamela Morgan,0,5,20,20
1746611520864,MCWP 50,A00,893758,Morshed; Michael James,0,0,20,20
1746611520864,MCWP 50,B00,893761,Bartulis; Jason Michael,16,0,20,4
1746611521892,MCWP 50R,A00,893766,Compas; Sean Matthew,0,1,20,20
1746611521892,MCWP 50R,B00,893769,Carter; Jennifer A,0,1,20,20
1746611521892,MCWP 50R,C00,893771,Krone; Jarret,0,3,20,20
1746611521892,MCWP 50R,D00,893772,Miller; Elizabeth Deen,0,0,20,20
1746611521892,MCWP 50R,E00,893775,Carter; Andrea L,0,1,20,20
1746611522919,MMW 11R,A01,892721,Herbst; Matthew,14,0,30,16
1746611522919,MMW 11R,A02,892722,Herbst; Matthew,0,0,0,3
1746611523947,MMW 12R,A01,892724,Herbst; Matthew,0,11,16,16
1746611523947,MMW 12R,A02,892725,Herbst; Matthew,0,10,16,16
1746611524973,MMW 13R,A01,892727,Staff,0,4,16,16
1746611524973,MMW 13R,A02,892728,Staff,0,4,16,16
1746611524973,MMW 13R,A03,958032,Staff,0,4,16,16
1746611524973,MMW 13R,A04,958033,Staff,0,4,16,16
1746611524973,MMW 13R,A05,958034,Staff,0,4,16,16
1746611525998,SIO 295LS,A00,894015,Staff,5,0,25,20
1746611527024,SIO 295S,A00,894020,Staff,5,0,25,20
1746611528051,SIOC 290S,B01,958918,Merrifield; Mark A,14,0,30,16
1746611529081,SIOC 291S,B01,958922,Gabriel; Corey John,14,0,30,16
1746611530110,SOCI 117,A01,895339,Staff,2,0,5,3
1746611531138,WES 237B,A00,894149,Staff,11,0,20,9
1746611533212,AESE 279B,A00,891859,Staff,13,0,35,22
1746611534238,AIP 197,001,891854,Vespa; Emanuel Ignacio,9999,0,9999,0
1746611535264,ANTH 289S,A00,891856,Gagneux; Pascal,12,0,12,0
1746611536288,BENG 196,001,957946,Engler; Adam J.,9996,0,9999,3
1746611537316,BISP 197,001,959851,Wilhelm; James E.,9998,0,9999,1
1746611538340,CAT 124RS,A01,956906,Staff,6,0,25,19
1746611539364,CAT 125RS,A01,922013,Staff,6,0,25,19
1746611540393,CLRE 250,A00,891860,Morris; Sheldon,9995,0,9999,4
1746611542446,CLRE 251R,A00,907817,Mehta; Ravindra L.,9994,0,9999,5
1746611543472,CLRE 252,A00,891864,Cuomo; Raphael Eduardo,9993,0,9999,6
1746611544496,CLRE 253,A00,891867,Vaida; Florin,9994,0,9999,5
1746611544496,CLRE 253,B00,907819,Staff,9999,0,9999,0
1746611545520,CLRE 259,A00,891868,Patel; Hemal,9998,0,9999,1
1746611546544,CLRE 260,A00,891872,Cuomo; Raphael Eduardo,9999,0,9999,0
1746611547569,CLRE 297,001,891888,Cuomo; Raphael Eduardo,9999,0,9999,0
1746611548594,CSE 191,A00,958773,Minnes Kemp; Mor Mia,9995,0,9999,4
1746611549622,CSE 197,001,959846,Minnes Kemp; Mor Mia,9990,0,9999,9
1746611550652,CSS 201S,A01,892054,Mignozzetti; Umberto,25,0,30,5
1746611551718,CSS 202S,A01,892056,Mignozzetti; Umberto,25,0,30,5
1746611552745,DSC 197,001,956898,Eldridge; Justin Matthew,9996,0,9999,3
1746611553769,DSC 297,001,958000,Mazumdar; Arya,9998,0,9999,1
1746611553769,DSC 297,002,959862,Wang; Yusu,9998,0,9999,1
1746611554794,EAP 100,A00,905686,Staff,9778,0,9999,221
1746611555824,ECE 45,A01,892618,Staff,0,0,65,65
1746611557877,ECE 111,A01,892719,Staff,6,0,65,59
1746611558903,ECE 197,001,957920,Mercier; Patrick Philip,9991,0,9999,8
1746611559932,ECON 178,A01,907814,Zhu; Ying,26,0,35,9
1746611560958,EDS 115,A00,895312,Staff,35,0,45,10
1746611561986,EDS 117,A01,895337,Staff,23,0,30,7
1746611563014,EDS 125,A00,895341,Jones; Gabrielle Anastasia,36,0,45,9
1746611564040,EDS 128A,A01,895459,Fargason; Sharon Gayle,44,0,45,1
1746611565068,EDS 128B,A01,895543,Pappas; Elizabeth,44,0,45,1
1746611566093,EDS 139,A00,897203,Pappas; Elizabeth,44,0,45,1
1746611566093,EDS 139,B00,897209,Fargason; Sharon Gayle,41,0,45,4
1746611567120,EDS 201,A00,895545,Staff,22,0,45,23
1746611568147,EDS 203,A01,895581,Halter; Christopher P.,22,0,45,23
1746611569176,EDS 204R,A01,895625,Heinzman; Erica M.,39,0,45,6
1746611569176,EDS 204R,B01,895693,Halter; Christopher P.,10,0,45,35
1746611570206,EDS 206R,A00,895694,Fargason; Sharon Gayle,1,0,30,29
1746611570206,EDS 206R,B00,895695,Choi; Bailey Miyeon,16,0,30,14
1746611571235,EDS 250,A00,895697,Hemans; Patricia Ann Benitez,22,0,45,23
1746611572263,EDS 281,A00,895701,Meyerott; Theresa Ann,1,0,15,14
1746611573289,EDS 284,A00,895736,Meyerott; Theresa Ann,1,0,15,14
1746611574316,EDS 286,A00,897210,Fine; Sarah,0,0,15,15
1746611575341,EDS 289C,A01,895770,Daly; Alan J.,1,0,15,14
1746611576368,EDS 290,A00,897211,Hofstetter; Carolyn,0,0,15,15
1746611577397,LIGM 5A,A00,896162,Fischer-Grunski; Eva K,12,0,20,8
1746611578427,LIGM 5B,A00,896260,Fischer-Grunski; Eva K,17,0,20,3
1746611579453,LIGM 5C,A00,896308,Fischer-Grunski; Eva K,18,0,20,2
1746611580480,LIIT 5AS,A00,896313,Carnelos; Chiara,18,0,20,2
1746611581508,LIIT 5BS,A00,896416,Carnelos; Chiara,20,0,20,0
1746611582534,LIIT 5CS,A00,896564,Carnelos; Chiara,20,0,20,0
1746611583560,LISP 5A,A00,896588,Munoz Sanchez; Alicia,2,0,20,18
1746611584588,LISP 5B,A00,896653,Munoz Sanchez; Alicia,7,0,20,13
1746611585613,LISP 5C,A00,896655,Munoz Sanchez; Alicia,0,1,20,20
1746611586641,MAE 197,001,957918,Kleissl; Jan,9996,0,9999,3
1746611586641,MAE 197,002,959806,Boechler; Nicholas Sebastia,9998,0,9999,1
1746611586641,MAE 197,003,959852,Mullin; Jennifer S,9998,0,9999,1
1746611587669,MATH 2,A01,957937,Staff,33,0,35,2
1746611588697,MATH 197,001,957876,Kedlaya; Kiran S.,9993,0,9999,6
1746611589721,MCWP 40,A00,892729,Duru; Nur,10,0,20,10
1746611589721,MCWP 40,B00,893304,Montejo; Carolina,14,0,20,6
1746611590746,MCWP 40R,A00,893757,Redela; Pamela Morgan,0,5,20,20
1746611591776,MCWP 50,A00,893758,Morshed; Michael James,0,0,20,20
1746611591776,MCWP 50,B00,893761,Bartulis; Jason Michael,16,0,20,4
1746611592805,MCWP 50R,A00,893766,Compas; Sean Matthew,0,1,20,20
1746611592805,MCWP 50R,B00,893769,Carter; Jennifer A,0,1,20,20
1746611592805,MCWP 50R,C00,893771,Krone; Jarret,0,3,20,20
1746611592805,MCWP 50R,D00,893772,Miller; Elizabeth Deen,0,0,20,20
1746611592805,MCWP 50R,E00,893775,Carter; Andrea L,0,1,20,20
1746611593831,MMW 11R,A01,892721,Herbst; Matthew,14,0,30,16
1746611593831,MMW 11R,A02,892722,Herbst; Matthew,0,0,0,3
1746611594856,MMW 12R,A01,892724,Herbst; Matthew,0,11,16,16
1746611594856,MMW 12R,A02,892725,Herbst; Matthew,0,10,16,16
1746611595884,MMW 13R,A01,892727,Staff,0,4,16,16
1746611595884,MMW 13R,A02,892728,Staff,0,4,16,16
1746611595884,MMW 13R,A03,958032,Staff,0,4,16,16
1746611595884,MMW 13R,A04,958033,Staff,0,4,16,16
1746611595884,MMW 13R,A05,958034,Staff,0,4,16,16
1746611596908,SIO 295LS,A00,894015,Staff,5,0,25,20
1746611597934,SIO 295S,A00,894020,Staff,5,0,25,20
1746611598959,SIOC 290S,B01,958918,Merrifield; Mark A,14,0,30,16
1746611599990,SIOC 291S,B01,958922,Gabriel; Corey John,14,0,30,16
1746611601017,SOCI 117,A01,895339,Staff,2,0,5,3
1746611602042,WES 237B,A00,894149,Staff,11,0,20,9
1746611604108,AESE 279B,A00,891859,Staff,13,0,35,22
1746611605136,AIP 197,001,891854,Vespa; Emanuel Ignacio,9999,0,9999,0
1746611606160,ANTH 289S,A00,891856,Gagneux; Pascal,12,0,12,0
1746611607188,BENG 196,001,957946,Engler; Adam J.,9996,0,9999,3
1746611608214,BISP 197,001,959851,Wilhelm; James E.,9998,0,9999,1
1746611609238,CAT 124RS,A01,956906,Staff,6,0,25,19
1746611610263,CAT 125RS,A01,922013,Staff,6,0,25,19
1746611611286,CLRE 250,A00,891860,Morris; Sheldon,9995,0,9999,4
1746611613341,CLRE 251R,A00,907817,Mehta; Ravindra L.,9994,0,9999,5
1746611614365,CLRE 252,A00,891864,Cuomo; Raphael Eduardo,9993,0,9999,6
1746611615392,CLRE 253,A00,891867,Vaida; Florin,9994,0,9999,5
1746611615392,CLRE 253,B00,907819,Staff,9999,0,9999,0
1746611616418,CLRE 259,A00,891868,Patel; Hemal,9998,0,9999,1
1746611617442,CLRE 260,A00,891872,Cuomo; Raphael Eduardo,9999,0,9999,0
1746611618467,CLRE 297,001,891888,Cuomo; Raphael Eduardo,9999,0,9999,0
1746611619492,CSE 191,A00,958773,Minnes Kemp; Mor Mia,9995,0,9999,4
1746611620517,CSE 197,001,959846,Minnes Kemp; Mor Mia,9990,0,9999,9
1746611621543,CSS 201S,A01,892054,Mignozzetti; Umberto,25,0,30,5
1746611622568,CSS 202S,A01,892056,Mignozzetti; Umberto,25,0,30,5
1746611623602,DSC 197,001,956898,Eldridge; Justin Matthew,9996,0,9999,3
1746611624627,DSC 297,001,958000,Mazumdar; Arya,9998,0,9999,1
1746611624627,DSC 297,002,959862,Wang; Yusu,9998,0,9999,1
1746611625653,EAP 100,A00,905686,Staff,9778,0,9999,221
1746611626681,ECE 45,A01,892618,Staff,0,0,65,65
1746611628740,ECE 111,A01,892719,Staff,6,0,65,59
1746611629767,ECE 197,001,957920,Mercier; Patrick Philip,9991,0,9999,8
1746611630793,ECON 178,A01,907814,Zhu; Ying,26,0,35,9
1746611631822,EDS 115,A00,895312,Staff,35,0,45,10
1746611632848,EDS 117,A01,895337,Staff,23,0,30,7
1746611633873,EDS 125,A00,895341,Jones; Gabrielle Anastasia,36,0,45,9
1746611634901,EDS 128A,A01,895459,Fargason; Sharon Gayle,44,0,45,1
1746611635927,EDS 128B,A01,895543,Pappas; Elizabeth,44,0,45,1
1746611636954,EDS 139,A00,897203,Pappas; Elizabeth,44,0,45,1
1746611636954,EDS 139,B00,897209,Fargason; Sharon Gayle,41,0,45,4
1746611637980,EDS 201,A00,895545,Staff,22,0,45,23
1746611639010,EDS 203,A01,895581,Halter; Christopher P.,22,0,45,23
1746611640038,EDS 204R,A01,895625,Heinzman; Erica M.,39,0,45,6
1746611640038,EDS 204R,B01,895693,Halter; Christopher P.,10,0,45,35
1746611641063,EDS 206R,A00,895694,Fargason; Sharon Gayle,1,0,30,29
1746611641063,EDS 206R,B00,895695,Choi; Bailey Miyeon,16,0,30,14
1746611642089,EDS 250,A00,895697,Hemans; Patricia Ann Benitez,22,0,45,23
1746611643116,EDS 281,A00,895701,Meyerott; Theresa Ann,1,0,15,14
1746611644144,EDS 284,A00,895736,Meyerott; Theresa Ann,1,0,15,14
1746611645170,EDS 286,A00,897210,Fine; Sarah,0,0,15,15
1746611646196,EDS 289C,A01,895770,Daly; Alan J.,1,0,15,14
1746611647220,EDS 290,A00,897211,Hofstetter; Carolyn,0,0,15,15
1746611648249,LIGM 5A,A00,896162,Fischer-Grunski; Eva K,12,0,20,8
1746611649275,LIGM 5B,A00,896260,Fischer-Grunski; Eva K,17,0,20,3
1746611650302,LIGM 5C,A00,896308,Fischer-Grunski; Eva K,18,0,20,2
1746611651328,LIIT 5AS,A00,896313,Carnelos; Chiara,18,0,20,2
1746611652354,LIIT 5BS,A00,896416,Carnelos; Chiara,20,0,20,0
1746611653379,LIIT 5CS,A00,896564,Carnelos; Chiara,20,0,20,0
1746611654405,LISP 5A,A00,896588,Munoz Sanchez; Alicia,2,0,20,18
1746611655473,LISP 5B,A00,896653,Munoz Sanchez; Alicia,7,0,20,13
1746611656501,LISP 5C,A00,896655,Munoz Sanchez; Alicia,0,1,20,20
1746611657525,MAE 197,001,957918,Kleissl; Jan,9996,0,9999,3
1746611657525,MAE 197,002,959806,Boechler; Nicholas Sebastia,9998,0,9999,1
1746611657525,MAE 197,003,959852,Mullin; Jennifer S,9998,0,9999,1
1746611658554,MATH 2,A01,957937,Staff,33,0,35,2
1746611659580,MATH 197,001,957876,Kedlaya; Kiran S.,9993,0,9999,6
1746611660605,MCWP 40,A00,892729,Duru; Nur,10,0,20,10
1746611660605,MCWP 40,B00,893304,Montejo; Carolina,14,0,20,6
1746611661632,MCWP 40R,A00,893757,Redela; Pamela Morgan,0,5,20,20
1746611662663,MCWP 50,A00,893758,Morshed; Michael James,0,0,20,20
1746611662663,MCWP 50,B00,893761,Bartulis; Jason Michael,16,0,20,4
1746611663688,MCWP 50R,A00,893766,Compas; Sean Matthew,0,1,20,20
1746611663688,MCWP 50R,B00,893769,Carter; Jennifer A,0,1,20,20
1746611663688,MCWP 50R,C00,893771,Krone; Jarret,0,3,20,20
1746611663688,MCWP 50R,D00,893772,Miller; Elizabeth Deen,0,0,20,20
1746611663688,MCWP 50R,E00,893775,Carter; Andrea L,0,1,20,20
1746611664714,MMW 11R,A01,892721,Herbst; Matthew,14,0,30,16
1746611664714,MMW 11R,A02,892722,Herbst; Matthew,0,0,0,3
1746611665742,MMW 12R,A01,892724,Herbst; Matthew,0,11,16,16
1746611665742,MMW 12R,A02,892725,Herbst; Matthew,0,10,16,16
1746611666771,MMW 13R,A01,892727,Staff,0,4,16,16
1746611666771,MMW 13R,A02,892728,Staff,0,4,16,16
1746611666771,MMW 13R,A03,958032,Staff,0,4,16,16
1746611666771,MMW 13R,A04,958033,Staff,0,4,16,16
1746611666771,MMW 13R,A05,958034,Staff,0,4,16,16
1746611667798,SIO 295LS,A00,894015,Staff,5,0,25,20
1746611668826,SIO 295S,A00,894020,Staff,5,0,25,20
1746611669851,SIOC 290S,B01,958918,Merrifield; Mark A,14,0,30,16
1746611670880,SIOC 291S,B01,958922,Gabriel; Corey John,14,0,30,16
1746611671907,SOCI 117,A01,895339,Staff,2,0,5,3
1746611672932,WES 237B,A00,894149,Staff,11,0,20,9
1746611675000,AESE 279B,A00,891859,Staff,13,0,35,22
1746611676026,AIP 197,001,891854,Vespa; Emanuel Ignacio,9999,0,9999,0
1746611677053,ANTH 289S,A00,891856,Gagneux; Pascal,12,0,12,0
1746611678079,BENG 196,001,957946,Engler; Adam J.,9996,0,9999,3
1746611679106,BISP 197,001,959851,Wilhelm; James E.,9998,0,9999,1
1746611680136,CAT 124RS,A01,956906,Staff,6,0,25,19
1746611681164,CAT 125RS,A01,922013,Staff,6,0,25,19
1746611682188,CLRE 250,A00,891860,Morris; Sheldon,9995,0,9999,4
1746611684244,CLRE 251R,A00,907817,Mehta; Ravindra L.,9994,0,9999,5
1746611685270,CLRE 252,A00,891864,Cuomo; Raphael Eduardo,9993,0,9999,6
1746611686296,CLRE 253,A00,891867,Vaida; Florin,9994,0,9999,5
1746611686296,CLRE 253,B00,907819,Staff,9999,0,9999,0
1746611687325,CLRE 259,A00,891868,Patel; Hemal,9998,0,9999,1
1746611688354,CLRE 260,A00,891872,Cuomo; Raphael Eduardo,9999,0,9999,0
1746611689378,CLRE 297,001,891888,Cuomo; Raphael Eduardo,9999,0,9999,0
1746611690406,CSE 191,A00,958773,Minnes Kemp; Mor Mia,9995,0,9999,4
1746611691433,CSE 197,001,959846,Minnes Kemp; Mor Mia,9990,0,9999,9
1746611692463,CSS 201S,A01,892054,Mignozzetti; Umberto,25,0,30,5
1746611693493,CSS 202S,A01,892056,Mignozzetti; Umberto,25,0,30,5
1746611694517,DSC 197,001,956898,Eldridge; Justin Matthew,9996,0,9999,3
1746611695543,DSC 297,001,958000,Mazumdar; Arya,9998,0,9999,1
1746611695543,DSC 297,002,959862,Wang; Yusu,9998,0,9999,1
1746611696572,EAP 100,A00,905686,Staff,9778,0,9999,221
1746611697602,ECE 45,A01,892618,Staff,0,0,65,65
1746611699657,ECE 111,A01,892719,Staff,6,0,65,59
1746611700684,ECE 197,001,957920,Mercier; Patrick Philip,9991,0,9999,8
1746611701710,ECON 178,A01,907814,Zhu; Ying,26,0,35,9
1746611702742,EDS 115,A00,895312,Staff,35,0,45,10
1746611703773,EDS 117,A01,895337,Staff,23,0,30,7
1746611704802,EDS 125,A00,895341,Jones; Gabrielle Anastasia,36,0,45,9
1746611705831,EDS 128A,A01,895459,Fargason; Sharon Gayle,44,0,45,1
1746611706858,EDS 128B,A01,895543,Pappas; Elizabeth,44,0,45,1
1746611707887,EDS 139,A00,897203,Pappas; Elizabeth,44,0,45,1
1746611707887,EDS 139,B00,897209,Fargason; Sharon Gayle,41,0,45,4
1746611708912,EDS 201,A00,895545,Staff,22,0,45,23
1746611709938,EDS 203,A01,895581,Halter; Christopher P.,22,0,45,23
1746611710962,EDS 204R,A01,895625,Heinzman; Erica M.,39,0,45,6
1746611710962,EDS 204R,B01,895693,Halter; Christopher P.,10,0,45,35
1746611711987,EDS 206R,A00,895694,Fargason; Sharon Gayle,1,0,30,29
1746611711987,EDS 206R,B00,895695,Choi; Bailey Miyeon,16,0,30,14
1746611713013,EDS 250,A00,895697,Hemans; Patricia Ann Benitez,22,0,45,23
1746611714040,EDS 281,A00,895701,Meyerott; Theresa Ann,1,0,15,14
1746611715067,EDS 284,A00,895736,Meyerott; Theresa Ann,1,0,15,14
1746611716094,EDS 286,A00,897210,Fine; Sarah,0,0,15,15
1746611717120,EDS 289C,A01,895770,Daly; Alan J.,1,0,15,14
1746611718146,EDS 290,A00,897211,Hofstetter; Carolyn,0,0,15,15
1746611719173,LIGM 5A,A00,896162,Fischer-Grunski; Eva K,12,0,20,8
1746611720200,LIGM 5B,A00,896260,Fischer-Grunski; Eva K,17,0,20,3
1746611721225,LIGM 5C,A00,896308,Fischer-Grunski; Eva K,18,0,20,2
1746611722253,LIIT 5AS,A00,896313,Carnelos; Chiara,18,0,20,2
1746611723277,LIIT 5BS,A00,896416,Carnelos; Chiara,20,0,20,0
1746611724304,LIIT 5CS,A00,896564,Carnelos; Chiara,20,0,20,0
1746611725333,LISP 5A,A00,896588,Munoz Sanchez; Alicia,2,0,20,18
1746611726362,LISP 5B,A00,896653,Munoz Sanchez; Alicia,7,0,20,13
1746611727388,LISP 5C,A00,896655,Munoz Sanchez; Alicia,0,1,20,20
1746611728417,MAE 197,001,957918,Kleissl; Jan,9996,0,9999,3
1746611728417,MAE 197,002,959806,Boechler; Nicholas Sebastia,9998,0,9999,1
1746611728417,MAE 197,003,959852,Mullin; Jennifer S,9998,0,9999,1
1746611729444,MATH 2,A01,957937,Staff,33,0,35,2
1746611730467,MATH 197,001,957876,Kedlaya; Kiran S.,9993,0,9999,6
1746611731496,MCWP 40,A00,892729,Duru; Nur,10,0,20,10
1746611731496,MCWP 40,B00,893304,Montejo; Carolina,14,0,20,6
1746611732522,MCWP 40R,A00,893757,Redela; Pamela Morgan,0,5,20,20
1746611733550,MCWP 50,A00,893758,Morshed; Michael James,0,0,20,20
1746611733550,MCWP 50,B00,893761,Bartulis; Jason Michael,16,0,20,4
1746611734580,MCWP 50R,A00,893766,Compas; Sean Matthew,0,1,20,20
1746611734580,MCWP 50R,B00,893769,Carter; Jennifer A,0,1,20,20
1746611734580,MCWP 50R,C00,893771,Krone; Jarret,0,3,20,20
1746611734580,MCWP 50R,D00,893772,Miller; Elizabeth Deen,0,0,20,20
1746611734580,MCWP 50R,E00,893775,Carter; Andrea L,0,1,20,20
1746611735608,MMW 11R,A01,892721,Herbst; Matthew,14,0,30,16
1746611735608,MMW 11R,A02,892722,Herbst; Matthew,0,0,0,3
1746611736635,MMW 12R,A01,892724,Herbst; Matthew,0,11,16,16
1746611736635,MMW 12R,A02,892725,Herbst; Matthew,0,10,16,16
1746611737663,MMW 13R,A01,892727,Staff,0,4,16,16
1746611737663,MMW 13R,A02,892728,Staff,0,4,16,16
1746611737663,MMW 13R,A03,958032,Staff,0,4,16,16
1746611737663,MMW 13R,A04,958033,Staff,0,4,16,16
1746611737663,MMW 13R,A05,958034,Staff,0,4,16,16
1746611738693,SIO 295LS,A00,894015,Staff,5,0,25,20
1746611739720,SIO 295S,A00,894020,Staff,5,0,25,20
1746611740750,SIOC 290S,B01,958918,Merrifield; Mark A,14,0,30,16
1746611741776,SIOC 291S,B01,958922,Gabriel; Corey John,14,0,30,16
1746611742802,SOCI 117,A01,895339,Staff,2,0,5,3
1746611743831,WES 237B,A00,894149,Staff,11,0,20,9
1746611745902,AESE 279B,A00,891859,Staff,13,0,35,22
1746611746927,AIP 197,001,891854,Vespa; Emanuel Ignacio,9999,0,9999,0
1746611747953,ANTH 289S,A00,891856,Gagneux; Pascal,12,0,12,0
1746611748977,BENG 196,001,957946,Engler; Adam J.,9996,0,9999,3
1746611750002,BISP 197,001,959851,Wilhelm; James E.,9998,0,9999,1
1746611751027,CAT 124RS,A01,956906,Staff,6,0,25,19
1746611752050,CAT 125RS,A01,922013,Staff,6,0,25,19
1746611753079,CLRE 250,A00,891860,Morris; Sheldon,9995,0,9999,4
1746611755132,CLRE 251R,A00,907817,Mehta; Ravindra L.,9994,0,9999,5
1746611756158,CLRE 252,A00,891864,Cuomo; Raphael Eduardo,9993,0,9999,6
1746611757181,CLRE 253,A00,891867,Vaida; Florin,9994,0,9999,5
1746611757181,CLRE 253,B00,907819,Staff,9999,0,9999,0
1746611758206,CLRE 259,A00,891868,Patel; Hemal,9998,0,9999,1
1746611759271,CLRE 260,A00,891872,Cuomo; Raphael Eduardo,9999,0,9999,0
1746611760297,CLRE 297,001,891888,Cuomo; Raphael Eduardo,9999,0,9999,0
1746611761324,CSE 191,A00,958773,Minnes Kemp; Mor Mia,9995,0,9999,4
1746611762348,CSE 197,001,959846,Minnes Kemp; Mor Mia,9990,0,9999,9
1746611763377,CSS 201S,A01,892054,Mignozzetti; Umberto,25,0,30,5
1746611764403,CSS 202S,A01,892056,Mignozzetti; Umberto,25,0,30,5
1746611765429,DSC 197,001,956898,Eldridge; Justin Matthew,9996,0,9999,3
1746611766456,DSC 297,001,958000,Mazumdar; Arya,9998,0,9999,1
1746611766456,DSC 297,002,959862,Wang; Yusu,9998,0,9999,1
1746611767481,EAP 100,A00,905686,Staff,9778,0,9999,221
1746611768511,ECE 45,A01,892618,Staff,0,0,65,65
1746611770565,ECE 111,A01,892719,Staff,6,0,65,59
1746611771591,ECE 197,001,957920,Mercier; Patrick Philip,9991,0,9999,8
1746611772619,ECON 178,A01,907814,Zhu; Ying,26,0,35,9
1746611773645,EDS 115,A00,895312,Staff,35,0,45,10
1746611774673,EDS 117,A01,895337,Staff,23,0,30,7
1746611775702,EDS 125,A00,895341,Jones; Gabrielle Anastasia,36,0,45,9
1746611776731,EDS 128A,A01,895459,Fargason; Sharon Gayle,44,0,45,1
1746611777757,EDS 128B,A01,895543,Pappas; Elizabeth,44,0,45,1
1746611778783,EDS 139,A00,897203,Pappas; Elizabeth,44,0,45,1
1746611778783,EDS 139,B00,897209,Fargason; Sharon Gayle,41,0,45,4
1746611779810,EDS 201,A00,895545,Staff,22,0,45,23
1746611780835,EDS 203,A01,895581,Halter; Christopher P.,22,0,45,23
1746611781863,EDS 204R,A01,895625,Heinzman; Erica M.,39,0,45,6
1746611781863,EDS 204R,B01,895693,Halter; Christopher P.,10,0,45,35
1746611782889,EDS 206R,A00,895694,Fargason; Sharon Gayle,1,0,30,29
1746611782889,EDS 206R,B00,895695,Choi; Bailey Miyeon,16,0,30,14
1746611783914,EDS 250,A00,895697,Hemans; Patricia Ann Benitez,22,0,45,23
1746611784938,EDS 281,A00,895701,Meyerott; Theresa Ann,1,0,15,14
1746611785961,EDS 284,A00,895736,Meyerott; Theresa Ann,1,0,15,14
1746611786987,EDS 286,A00,897210,Fine; Sarah,0,0,15,15
1746611788012,EDS 289C,A01,895770,Daly; Alan J.,1,0,15,14
1746611789038,EDS 290,A00,897211,Hofstetter; Carolyn,0,0,15,15
1746611790064,LIGM 5A,A00,896162,Fischer-Grunski; Eva K,12,0,20,8
1746611791090,LIGM 5B,A00,896260,Fischer-Grunski; Eva K,17,0,20,3
1746611792116,LIGM 5C,A00,896308,Fischer-Grunski; Eva K,18,0,20,2
1746611793144,LIIT 5AS,A00,896313,Carnelos; Chiara,18,0,20,2
1746611794172,LIIT 5BS,A00,896416,Carnelos; Chiara,20,0,20,0
1746611795196,LIIT 5CS,A00,896564,Carnelos; Chiara,20,0,20,0
1746611796221,LISP 5A,A00,896588,Munoz Sanchez; Alicia,2,0,20,18
1746611797253,LISP 5B,A00,896653,Munoz Sanchez; Alicia,7,0,20,13
1746611798278,LISP 5C,A00,896655,Munoz Sanchez; Alicia,0,1,20,20
1746611799301,MAE 197,001,957918,Kleissl; Jan,9996,0,9999,3
1746611799301,MAE 197,002,959806,Boechler; Nicholas Sebastia,9998,0,9999,1
1746611799301,MAE 197,003,959852,Mullin; Jennifer S,9998,0,9999,1
1746611800327,MATH 2,A01,957937,Staff,33,0,35,2
1746611801352,MATH 197,001,957876,Kedlaya; Kiran S.,9993,0,9999,6
1746611802381,MCWP 40,A00,892729,Duru; Nur,10,0,20,10
1746611802381,MCWP 40,B00,893304,Montejo; Carolina,14,0,20,6
1746611803406,MCWP 40R,A00,893757,Redela; Pamela Morgan,0,5,20,20
1746611804430,MCWP 50,A00,893758,Morshed; Michael James,0,0,20,20
1746611804430,MCWP 50,B00,893761,Bartulis; Jason Michael,16,0,20,4
1746611805454,MCWP 50R,A00,893766,Compas; Sean Matthew,0,1,20,20
1746611805454,MCWP 50R,B00,893769,Carter; Jennifer A,0,1,20,20
1746611805454,MCWP 50R,C00,893771,Krone; Jarret,0,3,20,20
1746611805454,MCWP 50R,D00,893772,Miller; Elizabeth Deen,0,0,20,20
1746611805454,MCWP 50R,E00,893775,Carter; Andrea L,0,1,20,20
1746611806481,MMW 11R,A01,892721,Herbst; Matthew,14,0,30,16
1746611806481,MMW 11R,A02,892722,Herbst; Matthew,0,0,0,3
1746611807509,MMW 12R,A01,892724,Herbst; Matthew,0,11,16,16
1746611807509,MMW 12R,A02,892725,Herbst; Matthew,0,10,16,16
1746611808534,MMW 13R,A01,892727,Staff,0,4,16,16
1746611808534,MMW 13R,A02,892728,Staff,0,4,16,16
1746611808534,MMW 13R,A03,958032,Staff,0,4,16,16
1746611808534,MMW 13R,A04,958033,Staff,0,4,16,16
1746611808534,MMW 13R,A05,958034,Staff,0,4,16,16
1746611809559,SIO 295LS,A00,894015,Staff,5,0,25,20
1746611810587,SIO 295S,A00,894020,Staff,5,0,25,20
1746611811617,SIOC 290S,B01,958918,Merrifield; Mark A,14,0,30,16
1746611812643,SIOC 291S,B01,958922,Gabriel; Corey John,14,0,30,16
1746611813667,SOCI 117,A01,895339,Staff,2,0,5,3
1746611814692,WES 237B,A00,894149,Staff,11,0,20,9
1746611816748,AESE 279B,A00,891859,Staff,13,0,35,22
1746611817775,AIP 197,001,891854,Vespa; Emanuel Ignacio,9999,0,9999,0
1746611818803,ANTH 289S,A00,891856,Gagneux; Pascal,12,0,12,0
1746611819828,BENG 196,001,957946,Engler; Adam J.,9996,0,9999,3
1746611820853,BISP 197,001,959851,Wilhelm; James E.,9998,0,9999,1
1746611821877,CAT 124RS,A01,956906,Staff,6,0,25,19
1746611822901,CAT 125RS,A01,922013,Staff,6,0,25,19
1746611823929,CLRE 250,A00,891860,Morris; Sheldon,9995,0,9999,4
1746611825979,CLRE 251R,A00,907817,Mehta; Ravindra L.,9994,0,9999,5
1746611827006,CLRE 252,A00,891864,Cuomo; Raphael Eduardo,9993,0,9999,6
1746611828033,CLRE 253,A00,891867,Vaida; Florin,9994,0,9999,5
1746611828033,CLRE 253,B00,907819,Staff,9999,0,9999,0
1746611829061,CLRE 259,A00,891868,Patel; Hemal,9998,0,9999,1
1746611830088,CLRE 260,A00,891872,Cuomo; Raphael Eduardo,9999,0,9999,0
1746611831115,CLRE 297,001,891888,Cuomo; Raphael Eduardo,9999,0,9999,0
1746611832138,CSE 191,A00,958773,Minnes Kemp; Mor Mia,9995,0,9999,4
1746611833165,CSE 197,001,959846,Minnes Kemp; Mor Mia,9990,0,9999,9
1746611834192,CSS 201S,A01,892054,Mignozzetti; Umberto,25,0,30,5
1746611835217,CSS 202S,A01,892056,Mignozzetti; Umberto,25,0,30,5
1746611836242,DSC 197,001,956898,Eldridge; Justin Matthew,9996,0,9999,3
1746611837267,DSC 297,001,958000,Mazumdar; Arya,9998,0,9999,1
1746611837267,DSC 297,002,959862,Wang; Yusu,9998,0,9999,1
1746611838292,EAP 100,A00,905686,Staff,9778,0,9999,221
1746611839321,ECE 45,A01,892618,Staff,0,0,65,65
1746611841376,ECE 111,A01,892719,Staff,6,0,65,59
1746611842407,ECE 197,001,957920,Mercier; Patrick Philip,9991,0,9999,8
1746611843432,ECON 178,A01,907814,Zhu; Ying,26,0,35,9
1746611844461,EDS 115,A00,895312,Staff,35,0,45,10
1746611845485,EDS 117,A01,895337,Staff,23,0,30,7
1746611846513,EDS 125,A00,895341,Jones; Gabrielle Anastasia,36,0,45,9
1746611847539,EDS 128A,A01,895459,Fargason; Sharon Gayle,44,0,45,1
1746611848567,EDS 128B,A01,895543,Pappas; Elizabeth,44,0,45,1
1746611849591,EDS 139,A00,897203,Pappas; Elizabeth,44,0,45,1
1746611849591,EDS 139,B00,897209,Fargason; Sharon Gayle,41,0,45,4
1746611850618,EDS 201,A00,895545,Staff,22,0,45,23
1746611851645,EDS 203,A01,895581,Halter; Christopher P.,22,0,45,23
1746611852670,EDS 204R,A01,895625,Heinzman; Erica M.,39,0,45,6
1746611852670,EDS 204R,B01,895693,Halter; Christopher P.,10,0,45,35
1746611853694,EDS 206R,A00,895694,Fargason; Sharon Gayle,1,0,30,29
1746611853694,EDS 206R,B00,895695,Choi; Bailey Miyeon,16,0,30,14
1746611854720,EDS 250,A00,895697,Hemans; Patricia Ann Benitez,22,0,45,23
1746611855746,EDS 281,A00,895701,Meyerott; Theresa Ann,1,0,15,14
1746611856773,EDS 284,A00,895736,Meyerott; Theresa Ann,1,0,15,14
1746611857798,EDS 286,A00,897210,Fine; Sarah,0,0,15,15
1746611858836,EDS 289C,A01,895770,Daly; Alan J.,1,0,15,14
1746611859860,EDS 290,A00,897211,Hofstetter; Carolyn,0,0,15,15
1746611860888,LIGM 5A,A00,896162,Fischer-Grunski; Eva K,12,0,20,8
1746611861916,LIGM 5B,A00,896260,Fischer-Grunski; Eva K,17,0,20,3
1746611862945,LIGM 5C,A00,896308,Fischer-Grunski; Eva K,18,0,20,2
1746611863971,LIIT 5AS,A00,896313,Carnelos; Chiara,18,0,20,2
1746611864999,LIIT 5BS,A00,896416,Carnelos; Chiara,20,0,20,0
1746611866026,LIIT 5CS,A00,896564,Carnelos; Chiara,20,0,20,0
1746611867055,LISP 5A,A00,896588,Munoz Sanchez; Alicia,2,0,20,18
1746611868081,LISP 5B,A00,896653,Munoz Sanchez; Alicia,7,0,20,13
1746611869113,LISP 5C,A00,896655,Munoz Sanchez; Alicia,0,1,20,20
1746611870141,MAE 197,001,957918,Kleissl; Jan,9996,0,9999,3
1746611870141,MAE 197,002,959806,Boechler; Nicholas Sebastia,9998,0,9999,1
1746611870141,MAE 197,003,959852,Mullin; Jennifer S,9998,0,9999,1
1746611871166,MATH 2,A01,957937,Staff,33,0,35,2
1746611872195,MATH 197,001,957876,Kedlaya; Kiran S.,9993,0,9999,6
1746611873220,MCWP 40,A00,892729,Duru; Nur,10,0,20,10
1746611873220,MCWP 40,B00,893304,Montejo; Carolina,14,0,20,6
1746611874249,MCWP 40R,A00,893757,Redela; Pamela Morgan,0,5,20,20
1746611875276,MCWP 50,A00,893758,Morshed; Michael James,0,0,20,20
1746611875276,MCWP 50,B00,893761,Bartulis; Jason Michael,16,0,20,4
1746611876306,MCWP 50R,A00,893766,Compas; Sean Matthew,0,1,20,20
1746611876306,MCWP 50R,B00,893769,Carter; Jennifer A,0,1,20,20
1746611876306,MCWP 50R,C00,893771,Krone; Jarret,0,3,20,20
1746611876306,MCWP 50R,D00,893772,Miller; Elizabeth Deen,0,0,20,20
1746611876306,MCWP 50R,E00,893775,Carter; Andrea L,0,1,20,20
1746611877335,MMW 11R,A01,892721,Herbst; Matthew,14,0,30,16
1746611877335,MMW 11R,A02,892722,Herbst; Matthew,0,0,0,3
1746611878359,MMW 12R,A01,892724,Herbst; Matthew,0,11,16,16
1746611878359,MMW 12R,A02,892725,Herbst; Matthew,0,10,16,16
1746611879387,MMW 13R,A01,892727,Staff,0,4,16,16
1746611879387,MMW 13R,A02,892728,Staff,0,4,16,16
1746611879387,MMW 13R,A03,958032,Staff,0,4,16,16
1746611879387,MMW 13R,A04,958033,Staff,0,4,16,16
1746611879387,MMW 13R,A05,958034,Staff,0,4,16,16
1746611880414,SIO 295LS,A00,894015,Staff,5,0,25,20
1746611881442,SIO 295S,A00,894020,Staff,5,0,25,20
1746611882471,SIOC 290S,B01,958918,Merrifield; Mark A,14,0,30,16
1746611883498,SIOC 291S,B01,958922,Gabriel; Corey John,14,0,30,16
1746611884527,SOCI 117,A01,895339,Staff,2,0,5,3
1746611885552,WES 237B,A00,894149,Staff,11,0,20,9
1746611887620,AESE 279B,A00,891859,Staff,13,0,35,22
1746611888647,AIP 197,001,891854,Vespa; Emanuel Ignacio,9999,0,9999,0
1746611889673,ANTH 289S,A00,891856,Gagneux; Pascal,12,0,12,0
1746611890701,BENG 196,001,957946,Engler; Adam J.,9996,0,9999,3
1746611891725,BISP 197,001,959851,Wilhelm; James E.,9998,0,9999,1
1746611892749,CAT 124RS,A01,956906,Staff,6,0,25,19
1746611893775,CAT 125RS,A01,922013,Staff,6,0,25,19
1746611894799,CLRE 250,A00,891860,Morris; Sheldon,9995,0,9999,4
1746611896851,CLRE 251R,A00,907817,Mehta; Ravindra L.,9994,0,9999,5
1746611897878,CLRE 252,A00,891864,Cuomo; Raphael Eduardo,9993,0,9999,6
1746611898905,CLRE 253,A00,891867,Vaida; Florin,9994,0,9999,5
1746611898905,CLRE 253,B00,907819,Staff,9999,0,9999,0
1746611899931,CLRE 259,A00,891868,Patel; Hemal,9998,0,9999,1
1746611900954,CLRE 260,A00,891872,Cuomo; Raphael Eduardo,9999,0,9999,0
1746611901979,CLRE 297,001,891888,Cuomo; Raphael Eduardo,9999,0,9999,0
1746611903008,CSE 191,A00,958773,Minnes Kemp; Mor Mia,9995,0,9999,4
1746611904032,CSE 197,001,959846,Minnes Kemp; Mor Mia,9990,0,9999,9
1746611905061,CSS 201S,A01,892054,Mignozzetti; Umberto,25,0,30,5
1746611906089,CSS 202S,A01,892056,Mignozzetti; Umberto,25,0,30,5
1746611907114,DSC 197,001,956898,Eldridge; Justin Matthew,9996,0,9999,3
1746611908138,DSC 297,001,958000,Mazumdar; Arya,9998,0,9999,1
1746611908138,DSC 297,002,959862,Wang; Yusu,9998,0,9999,1
1746611909168,EAP 100,A00,905686,Staff,9778,0,9999,221
1746611910193,ECE 45,A01,892618,Staff,0,0,65,65
1746611912243,ECE 111,A01,892719,Staff,6,0,65,59
1746611913268,ECE 197,001,957920,Mercier; Patrick Philip,9991,0,9999,8
1746611914295,ECON 178,A01,907814,Zhu; Ying,26,0,35,9
1746611915321,EDS 115,A00,895312,Staff,35,0,45,10
1746611916349,EDS 117,A01,895337,Staff,23,0,30,7
1746611917375,EDS 125,A00,895341,Jones; Gabrielle Anastasia,36,0,45,9
1746611918404,EDS 128A,A01,895459,Fargason; Sharon Gayle,44,0,45,1
1746611919427,EDS 128B,A01,895543,Pappas; Elizabeth,44,0,45,1
1746611920456,EDS 139,A00,897203,Pappas; Elizabeth,44,0,45,1
1746611920456,EDS 139,B00,897209,Fargason; Sharon Gayle,41,0,45,4
1746611921483,EDS 201,A00,895545,Staff,22,0,45,23
1746611922509,EDS 203,A01,895581,Halter; Christopher P.,22,0,45,23
1746611923535,EDS 204R,A01,895625,Heinzman; Erica M.,39,0,45,6
1746611923535,EDS 204R,B01,895693,Halter; Christopher P.,10,0,45,35
1746611924564,EDS 206R,A00,895694,Fargason; Sharon Gayle,1,0,30,29
1746611924564,EDS 206R,B00,895695,Choi; Bailey Miyeon,16,0,30,14
1746611925589,EDS 250,A00,895697,Hemans; Patricia Ann Benitez,22,0,45,23
1746611926614,EDS 281,A00,895701,Meyerott; Theresa Ann,1,0,15,14
1746611927644,EDS 284,A00,895736,Meyerott; Theresa Ann,1,0,15,14
1746611928669,EDS 286,A00,897210,Fine; Sarah,0,0,15,15
1746611929695,EDS 289C,A01,895770,Daly; Alan J.,1,0,15,14
1746611930723,EDS 290,A00,897211,Hofstetter; Carolyn,0,0,15,15
1746611931749,LIGM 5A,A00,896162,Fischer-Grunski; Eva K,12,0,20,8
1746611932775,LIGM 5B,A00,896260,Fischer-Grunski; Eva K,17,0,20,3
1746611933800,LIGM 5C,A00,896308,Fischer-Grunski; Eva K,18,0,20,2
1746611934830,LIIT 5AS,A00,896313,Carnelos; Chiara,18,0,20,2
1746611935856,LIIT 5BS,A00,896416,Carnelos; Chiara,20,0,20,0
1746611936881,LIIT 5CS,A00,896564,Carnelos; Chiara,20,0,20,0
1746611937907,LISP 5A,A00,896588,Munoz Sanchez; Alicia,2,0,20,18
1746611938931,LISP 5B,A00,896653,Munoz Sanchez; Alicia,7,0,20,13
1746611939957,LISP 5C,A00,896655,Munoz Sanchez; Alicia,0,1,20,20
1746611940985,MAE 197,001,957918,Kleissl; Jan,9996,0,9999,3
1746611940985,MAE 197,002,959806,Boechler; Nicholas Sebastia,9998,0,9999,1
1746611940985,MAE 197,003,959852,Mullin; Jennifer S,9998,0,9999,1
1746611942011,MATH 2,A01,957937,Staff,33,0,35,2
1746611943037,MATH 197,001,957876,Kedlaya; Kiran S.,9993,0,9999,6
1746611944067,MCWP 40,A00,892729,Duru; Nur,10,0,20,10
1746611944067,MCWP 40,B00,893304,Montejo; Carolina,14,0,20,6
1746611945092,MCWP 40R,A00,893757,Redela; Pamela Morgan,0,5,20,20
1746611946117,MCWP 50,A00,893758,Morshed; Michael James,0,0,20,20
1746611946117,MCWP 50,B00,893761,Bartulis; Jason Michael,16,0,20,4
1746611947144,MCWP 50R,A00,893766,Compas; Sean Matthew,0,1,20,20
1746611947144,MCWP 50R,B00,893769,Carter; Jennifer A,0,1,20,20
1746611947144,MCWP 50R,C00,893771,Krone; Jarret,0,3,20,20
1746611947144,MCWP 50R,D00,893772,Miller; Elizabeth Deen,0,0,20,20
1746611947144,MCWP 50R,E00,893775,Carter; Andrea L,0,1,20,20
1746611948170,MMW 11R,A01,892721,Herbst; Matthew,14,0,30,16
1746611948170,MMW 11R,A02,892722,Herbst; Matthew,0,0,0,3
1746611949196,MMW 12R,A01,892724,Herbst; Matthew,0,11,16,16
1746611949196,MMW 12R,A02,892725,Herbst; Matthew,0,10,16,16
1746611950230,MMW 13R,A01,892727,Staff,0,4,16,16
1746611950230,MMW 13R,A02,892728,Staff,0,4,16,16
1746611950230,MMW 13R,A03,958032,Staff,0,4,16,16
1746611950230,MMW 13R,A04,958033,Staff,0,4,16,16
1746611950230,MMW 13R,A05,958034,Staff,0,4,16,16
1746611951259,SIO 295LS,A00,894015,Staff,5,0,25,20
1746611952286,SIO 295S,A00,894020,Staff,5,0,25,20
1746611953313,SIOC 290S,B01,958918,Merrifield; Mark A,14,0,30,16
1746611954344,SIOC 291S,B01,958922,Gabriel; Corey John,14,0,30,16
1746611955375,SOCI 117,A01,895339,Staff,2,0,5,3
1746611956400,WES 237B,A00,894149,Staff,11,0,20,9
1746611958457,AESE 279B,A00,891859,Staff,13,0,35,22
1746611959484,AIP 197,001,891854,Vespa; Emanuel Ignacio,9999,0,9999,0
1746611960510,ANTH 289S,A00,891856,Gagneux; Pascal,12,0,12,0
1746611961538,BENG 196,001,957946,Engler; Adam J.,9996,0,9999,3
1746611962564,BISP 197,001,959851,Wilhelm; James E.,9998,0,9999,1
1746611963591,CAT 124RS,A01,956906,Staff,6,0,25,19
1746611964617,CAT 125RS,A01,922013,Staff,6,0,25,19
1746611965643,CLRE 250,A00,891860,Morris; Sheldon,9995,0,9999,4
1746611967695,CLRE 251R,A00,907817,Mehta; Ravindra L.,9994,0,9999,5
1746611968723,CLRE 252,A00,891864,Cuomo; Raphael Eduardo,9993,0,9999,6
1746611969752,CLRE 253,A00,891867,Vaida; Florin,9994,0,9999,5
1746611969752,CLRE 253,B00,907819,Staff,9999,0,9999,0
1746611970780,CLRE 259,A00,891868,Patel; Hemal,9998,0,9999,1
1746611971806,CLRE 260,A00,891872,Cuomo; Raphael Eduardo,9999,0,9999,0
1746611972830,CLRE 297,001,891888,Cuomo; Raphael Eduardo,9999,0,9999,0
1746611973858,CSE 191,A00,958773,Minnes Kemp; Mor Mia,9995,0,9999,4
1746611974883,CSE 197,001,959846,Minnes Kemp; Mor Mia,9990,0,9999,9
1746611975909,CSS 201S,A01,892054,Mignozzetti; Umberto,25,0,30,5
1746611976935,CSS 202S,A01,892056,Mignozzetti; Umberto,25,0,30,5
1746611977960,DSC 197,001,956898,Eldridge; Justin Matthew,9996,0,9999,3
1746611978987,DSC 297,001,958000,Mazumdar; Arya,9998,0,9999,1
1746611978987,DSC 297,002,959862,Wang; Yusu,9998,0,9999,1
1746611980016,EAP 100,A00,905686,Staff,9778,0,9999,221
1746611981041,ECE 45,A01,892618,Staff,0,0,65,65
1746611983097,ECE 111,A01,892719,Staff,6,0,65,59
1746611984137,ECE 197,001,957920,Mercier; Patrick Philip,9991,0,9999,8
1746611985161,ECON 178,A01,907814,Zhu; Ying,26,0,35,9
1746611986211,EDS 115,A00,895312,Staff,35,0,45,10
1746611987239,EDS 117,A01,895337,Staff,23,0,30,7
1746611988267,EDS 125,A00,895341,Jones; Gabrielle Anastasia,36,0,45,9
1746611989293,EDS 128A,A01,895459,Fargason; Sharon Gayle,44,0,45,1
1746611990320,EDS 128B,A01,895543,Pappas; Elizabeth,44,0,45,1
1746611991348,EDS 139,A00,897203,Pappas; Elizabeth,44,0,45,1
1746611991348,EDS 139,B00,897209,Fargason; Sharon Gayle,41,0,45,4
1746611992372,EDS 201,A00,895545,Staff,22,0,45,23
1746611993399,EDS 203,A01,895581,Halter; Christopher P.,22,0,45,23
1746611994424,EDS 204R,A01,895625,Heinzman; Erica M.,39,0,45,6
1746611994424,EDS 204R,B01,895693,Halter; Christopher P.,10,0,45,35
1746611995452,EDS 206R,A00,895694,Fargason; Sharon Gayle,1,0,30,29
1746611995452,EDS 206R,B00,895695,Choi; Bailey Miyeon,16,0,30,14
1746611996479,EDS 250,A00,895697,Hemans; Patricia Ann Benitez,22,0,45,23
1746611997507,EDS 281,A00,895701,Meyerott; Theresa Ann,1,0,15,14
1746611998532,EDS 284,A00,895736,Meyerott; Theresa Ann,1,0,15,14
1746611999556,EDS 286,A00,897210,Fine; Sarah,0,0,15,15
1746612000584,EDS 289C,A01,895770,Daly; Alan J.,1,0,15,14
1746612001611,EDS 290,A00,897211,Hofstetter; Carolyn,0,0,15,15
1746612002637,LIGM 5A,A00,896162,Fischer-Grunski; Eva K,12,0,20,8
1746612003664,LIGM 5B,A00,896260,Fischer-Grunski; Eva K,17,0,20,3
1746612004690,LIGM 5C,A00,896308,Fischer-Grunski; Eva K,18,0,20,2
1746612005716,LIIT 5AS,A00,896313,Carnelos; Chiara,18,0,20,2
1746612006744,LIIT 5BS,A00,896416,Carnelos; Chiara,20,0,20,0
1746612007769,LIIT 5CS,A00,896564,Carnelos; Chiara,20,0,20,0
1746612008798,LISP 5A,A00,896588,Munoz Sanchez; Alicia,2,0,20,18
1746612009826,LISP 5B,A00,896653,Munoz Sanchez; Alicia,7,0,20,13
1746612010853,LISP 5C,A00,896655,Munoz Sanchez; Alicia,0,1,20,20
1746612011881,MAE 197,001,957918,Kleissl; Jan,9996,0,9999,3
1746612011881,MAE 197,002,959806,Boechler; Nicholas Sebastia,9998,0,9999,1
1746612011881,MAE 197,003,959852,Mullin; Jennifer S,9998,0,9999,1
1746612012908,MATH 2,A01,957937,Staff,33,0,35,2
1746612013935,MATH 197,001,957876,Kedlaya; Kiran S.,9993,0,9999,6
1746612014960,MCWP 40,A00,892729,Duru; Nur,10,0,20,10
1746612014960,MCWP 40,B00,893304,Montejo; Carolina,14,0,20,6
1746612015986,MCWP 40R,A00,893757,Redela; Pamela Morgan,0,5,20,20
1746612017013,MCWP 50,A00,893758,Morshed; Michael James,0,0,20,20
1746612017013,MCWP 50,B00,893761,Bartulis; Jason Michael,16,0,20,4
1746612018042,MCWP 50R,A00,893766,Compas; Sean Matthew,0,1,20,20
1746612018042,MCWP 50R,B00,893769,Carter; Jennifer A,0,1,20,20
1746612018042,MCWP 50R,C00,893771,Krone; Jarret,0,3,20,20
1746612018042,MCWP 50R,D00,893772,Miller; Elizabeth Deen,0,0,20,20
1746612018042,MCWP 50R,E00,893775,Carter; Andrea L,0,1,20,20
1746612019069,MMW 11R,A01,892721,Herbst; Matthew,14,0,30,16
1746612019069,MMW 11R,A02,892722,Herbst; Matthew,0,0,0,3
1746612020099,MMW 12R,A01,892724,Herbst; Matthew,0,11,16,16
1746612020099,MMW 12R,A02,892725,Herbst; Matthew,0,10,16,16
1746612021127,MMW 13R,A01,892727,Staff,0,4,16,16
1746612021127,MMW 13R,A02,892728,Staff,0,4,16,16
1746612021127,MMW 13R,A03,958032,Staff,0,4,16,16
1746612021127,MMW 13R,A04,958033,Staff,0,4,16,16
1746612021127,MMW 13R,A05,958034,Staff,0,4,16,16
1746612022154,SIO 295LS,A00,894015,Staff,5,0,25,20
1746612023183,SIO 295S,A00,894020,Staff,5,0,25,20
1746612024213,SIOC 290S,B01,958918,Merrifield; Mark A,14,0,30,16
1746612025240,SIOC 291S,B01,958922,Gabriel; Corey John,14,0,30,16
1746612026266,SOCI 117,A01,895339,Staff,2,0,5,3
1746612027290,WES 237B,A00,894149,Staff,11,0,20,9
1746612029359,AESE 279B,A00,891859,Staff,13,0,35,22
1746612030389,AIP 197,001,891854,Vespa; Emanuel Ignacio,9999,0,9999,0
1746612031418,ANTH 289S,A00,891856,Gagneux; Pascal,12,0,12,0
1746612032443,BENG 196,001,957946,Engler; Adam J.,9996,0,9999,3
1746612033471,BISP 197,001,959851,Wilhelm; James E.,9998,0,9999,1
1746612034496,CAT 124RS,A01,956906,Staff,6,0,25,19
1746612035524,CAT 125RS,A01,922013,Staff,6,0,25,19
1746612036552,CLRE 250,A00,891860,Morris; Sheldon,9995,0,9999,4
1746612038609,CLRE 251R,A00,907817,Mehta; Ravindra L.,9994,0,9999,5
1746612039634,CLRE 252,A00,891864,Cuomo; Raphael Eduardo,9993,0,9999,6
1746612040660,CLRE 253,A00,891867,Vaida; Florin,9994,0,9999,5
1746612040660,CLRE 253,B00,907819,Staff,9999,0,9999,0
1746612041687,CLRE 259,A00,891868,Patel; Hemal,9998,0,9999,1
1746612042712,CLRE 260,A00,891872,Cuomo; Raphael Eduardo,9999,0,9999,0
1746612043739,CLRE 297,001,891888,Cuomo; Raphael Eduardo,9999,0,9999,0
1746612044766,CSE 191,A00,958773,Minnes Kemp; Mor Mia,9995,0,9999,4
1746612045793,CSE 197,001,959846,Minnes Kemp; Mor Mia,9990,0,9999,9
1746612046824,CSS 201S,A01,892054,Mignozzetti; Umberto,25,0,30,5
1746612047854,CSS 202S,A01,892056,Mignozzetti; Umberto,25,0,30,5
1746612048883,DSC 197,001,956898,Eldridge; Justin Matthew,9996,0,9999,3
1746612049911,DSC 297,001,958000,Mazumdar; Arya,9998,0,9999,1
1746612049911,DSC 297,002,959862,Wang; Yusu,9998,0,9999,1
1746612050962,EAP 100,A00,905686,Staff,9778,0,9999,221
1746612051987,ECE 45,A01,892618,Staff,0,0,65,65
1746612054041,ECE 111,A01,892719,Staff,6,0,65,59
1746612055065,ECE 197,001,957920,Mercier; Patrick Philip,9991,0,9999,8
1746612056090,ECON 178,A01,907814,Zhu; Ying,26,0,35,9
1746612057119,EDS 115,A00,895312,Staff,35,0,45,10
1746612058143,EDS 117,A01,895337,Staff,23,0,30,7
1746612059177,EDS 125,A00,895341,Jones; Gabrielle Anastasia,36,0,45,9
1746612060205,EDS 128A,A01,895459,Fargason; Sharon Gayle,44,0,45,1
1746612061234,EDS 128B,A01,895543,Pappas; Elizabeth,44,0,45,1
1746612062261,EDS 139,A00,897203,Pappas; Elizabeth,44,0,45,1
1746612062261,EDS 139,B00,897209,Fargason; Sharon Gayle,41,0,45,4
1746612063287,EDS 201,A00,895545,Staff,22,0,45,23
1746612064311,EDS 203,A01,895581,Halter; Christopher P.,22,0,45,23
1746612065338,EDS 204R,A01,895625,Heinzman; Erica M.,39,0,45,6
1746612065338,EDS 204R,B01,895693,Halter; Christopher P.,10,0,45,35
1746612066367,EDS 206R,A00,895694,Fargason; Sharon Gayle,1,0,30,29
1746612066367,EDS 206R,B00,895695,Choi; Bailey Miyeon,16,0,30,14
1746612067393,EDS 250,A00,895697,Hemans; Patricia Ann Benitez,22,0,45,23
1746612068418,EDS 281,A00,895701,Meyerott; Theresa Ann,1,0,15,14
1746612069442,EDS 284,A00,895736,Meyerott; Theresa Ann,1,0,15,14
1746612070466,EDS 286,A00,897210,Fine; Sarah,0,0,15,15
1746612071492,EDS 289C,A01,895770,Daly; Alan J.,1,0,15,14
1746612072517,EDS 290,A00,897211,Hofstetter; Carolyn,0,0,15,15
1746612073543,LIGM 5A,A00,896162,Fischer-Grunski; Eva K,12,0,20,8
1746612074571,LIGM 5B,A00,896260,Fischer-Grunski; Eva K,17,0,20,3
1746612075601,LIGM 5C,A00,896308,Fischer-Grunski; Eva K,18,0,20,2
1746612076626,LIIT 5AS,A00,896313,Carnelos; Chiara,18,0,20,2
1746612077653,LIIT 5BS,A00,896416,Carnelos; Chiara,20,0,20,0
1746612078678,LIIT 5CS,A00,896564,Carnelos; Chiara,20,0,20,0
1746612079705,LISP 5A,A00,896588,Munoz Sanchez; Alicia,2,0,20,18
1746612080731,LISP 5B,A00,896653,Munoz Sanchez; Alicia,7,0,20,13
1746612081758,LISP 5C,A00,896655,Munoz Sanchez; Alicia,0,1,20,20
1746612082784,MAE 197,001,957918,Kleissl; Jan,9996,0,9999,3
1746612082784,MAE 197,002,959806,Boechler; Nicholas Sebastia,9998,0,9999,1
1746612082784,MAE 197,003,959852,Mullin; Jennifer S,9998,0,9999,1
1746612083809,MATH 2,A01,957937,Staff,33,0,35,2
1746612084833,MATH 197,001,957876,Kedlaya; Kiran S.,9993,0,9999,6
1746612085859,MCWP 40,A00,892729,Duru; Nur,10,0,20,10
1746612085859,MCWP 40,B00,893304,Montejo; Carolina,14,0,20,6
1746612086887,MCWP 40R,A00,893757,Redela; Pamela Morgan,0,5,20,20
1746612087914,MCWP 50,A00,893758,Morshed; Michael James,0,0,20,20
1746612087914,MCWP 50,B00,893761,Bartulis; Jason Michael,16,0,20,4
1746612088942,MCWP 50R,A00,893766,Compas; Sean Matthew,0,1,20,20
1746612088942,MCWP 50R,B00,893769,Carter; Jennifer A,0,1,20,20
1746612088942,MCWP 50R,C00,893771,Krone; Jarret,0,3,20,20
1746612088942,MCWP 50R,D00,893772,Miller; Elizabeth Deen,0,0,20,20
1746612088942,MCWP 50R,E00,893775,Carter; Andrea L,0,1,20,20
1746612089976,MMW 11R,A01,892721,Herbst; Matthew,14,0,30,16
1746612089976,MMW 11R,A02,892722,Herbst; Matthew,0,0,0,3
1746612091002,MMW 12R,A01,892724,Herbst; Matthew,0,11,16,16
1746612091002,MMW 12R,A02,892725,Herbst; Matthew,0,10,16,16
1746612092030,MMW 13R,A01,892727,Staff,0,4,16,16
1746612092030,MMW 13R,A02,892728,Staff,0,4,16,16
1746612092030,MMW 13R,A03,958032,Staff,0,4,16,16
1746612092030,MMW 13R,A04,958033,Staff,0,4,16,16
1746612092030,MMW 13R,A05,958034,Staff,0,4,16,16
1746612093057,SIO 295LS,A00,894015,Staff,5,0,25,20
1746612094084,SIO 295S,A00,894020,Staff,5,0,25,20
1746612095110,SIOC 290S,B01,958918,Merrifield; Mark A,14,0,30,16
1746612096140,SIOC 291S,B01,958922,Gabriel; Corey John,14,0,30,16
1746612097165,SOCI 117,A01,895339,Staff,2,0,5,3
1746612098189,WES 237B,A00,894149,Staff,11,0,20,9
1746612100253,AESE 279B,A00,891859,Staff,13,0,35,22
1746612101281,AIP 197,001,891854,Vespa; Emanuel Ignacio,9999,0,9999,0
1746612102307,ANTH 289S,A00,891856,Gagneux; Pascal,12,0,12,0
1746612103333,BENG 196,001,957946,Engler; Adam J.,9996,0,9999,3
1746612104357,BISP 197,001,959851,Wilhelm; James E.,9998,0,9999,1
1746612105382,CAT 124RS,A01,956906,Staff,6,0,25,19
1746612106406,CAT 125RS,A01,922013,Staff,6,0,25,19
1746612107434,CLRE 250,A00,891860,Morris; Sheldon,9995,0,9999,4
1746612109486,CLRE 251R,A00,907817,Mehta; Ravindra L.,9994,0,9999,5
1746612110513,CLRE 252,A00,891864,Cuomo; Raphael Eduardo,9993,0,9999,6
1746612111540,CLRE 253,A00,891867,Vaida; Florin,9994,0,9999,5
1746612111540,CLRE 253,B00,907819,Staff,9999,0,9999,0
1746612112567,CLRE 259,A00,891868,Patel; Hemal,9998,0,9999,1
1746612113595,CLRE 260,A00,891872,Cuomo; Raphael Eduardo,9999,0,9999,0
1746612114623,CLRE 297,001,891888,Cuomo; Raphael Eduardo,9999,0,9999,0
1746612115650,CSE 191,A00,958773,Minnes Kemp; Mor Mia,9995,0,9999,4
1746612116675,CSE 197,001,959846,Minnes Kemp; Mor Mia,9990,0,9999,9
1746612117701,CSS 201S,A01,892054,Mignozzetti; Umberto,25,0,30,5
1746612118731,CSS 202S,A01,892056,Mignozzetti; Umberto,25,0,30,5
1746612119757,DSC 197,001,956898,Eldridge; Justin Matthew,9996,0,9999,3
1746612120782,DSC 297,001,958000,Mazumdar; Arya,9998,0,9999,1
1746612120782,DSC 297,002,959862,Wang; Yusu,9998,0,9999,1
1746612121807,EAP 100,A00,905686,Staff,9778,0,9999,221
1746612122832,ECE 45,A01,892618,Staff,0,0,65,65
1746612124883,ECE 111,A01,892719,Staff,6,0,65,59
1746612125908,ECE 197,001,957920,Mercier; Patrick Philip,9991,0,9999,8
1746612126937,ECON 178,A01,907814,Zhu; Ying,26,0,35,9
1746612127963,EDS 115,A00,895312,Staff,35,0,45,10
1746612128993,EDS 117,A01,895337,Staff,23,0,30,7
1746612130018,EDS 125,A00,895341,Jones; Gabrielle Anastasia,36,0,45,9
1746612131043,EDS 128A,A01,895459,Fargason; Sharon Gayle,44,0,45,1
1746612132068,EDS 128B,A01,895543,Pappas; Elizabeth,44,0,45,1
1746612133094,EDS 139,A00,897203,Pappas; Elizabeth,44,0,45,1
1746612133094,EDS 139,B00,897209,Fargason; Sharon Gayle,41,0,45,4
1746612134121,EDS 201,A00,895545,Staff,22,0,45,23
1746612135148,EDS 203,A01,895581,Halter; Christopher P.,22,0,45,23
1746612136177,EDS 204R,A01,895625,Heinzman; Erica M.,39,0,45,6
1746612136177,EDS 204R,B01,895693,Halter; Christopher P.,10,0,45,35
1746612137206,EDS 206R,A00,895694,Fargason; Sharon Gayle,1,0,30,29
1746612137206,EDS 206R,B00,895695,Choi; Bailey Miyeon,16,0,30,14
1746612138232,EDS 250,A00,895697,Hemans; Patricia Ann Benitez,22,0,45,23
1746612139258,EDS 281,A00,895701,Meyerott; Theresa Ann,1,0,15,14
1746612140286,EDS 284,A00,895736,Meyerott; Theresa Ann,1,0,15,14
1746612141316,EDS 286,A00,897210,Fine; Sarah,0,0,15,15
1746612142346,EDS 289C,A01,895770,Daly; Alan J.,1,0,15,14
1746612143375,EDS 290,A00,897211,Hofstetter; Carolyn,0,0,15,15
1746612144401,LIGM 5A,A00,896162,Fischer-Grunski; Eva K,12,0,20,8
1746612145428,LIGM 5B,A00,896260,Fischer-Grunski; Eva K,17,0,20,3
1746612146460,LIGM 5C,A00,896308,Fischer-Grunski; Eva K,18,0,20,2
1746612147486,LIIT 5AS,A00,896313,Carnelos; Chiara,18,0,20,2
1746612148518,LIIT 5BS,A00,896416,Carnelos; Chiara,20,0,20,0
1746612149549,LIIT 5CS,A00,896564,Carnelos; Chiara,20,0,20,0
1746612150580,LISP 5A,A00,896588,Munoz Sanchez; Alicia,2,0,20,18
1746612151607,LISP 5B,A00,896653,Munoz Sanchez; Alicia,7,0,20,13
1746612152637,LISP 5C,A00,896655,Munoz Sanchez; Alicia,0,1,20,20
1746612153663,MAE 197,001,957918,Kleissl; Jan,9996,0,9999,3
1746612153663,MAE 197,002,959806,Boechler; Nicholas Sebastia,9998,0,9999,1
1746612153663,MAE 197,003,959852,Mullin; Jennifer S,9998,0,9999,1
1746612154689,MATH 2,A01,957937,Staff,33,0,35,2
1746612155716,MATH 197,001,957876,Kedlaya; Kiran S.,9993,0,9999,6
1746612156746,MCWP 40,A00,892729,Duru; Nur,10,0,20,10
1746612156746,MCWP 40,B00,893304,Montejo; Carolina,14,0,20,6
1746612157777,MCWP 40R,A00,893757,Redela; Pamela Morgan,0,5,20,20
1746612158802,MCWP 50,A00,893758,Morshed; Michael James,0,0,20,20
1746612158802,MCWP 50,B00,893761,Bartulis; Jason Michael,16,0,20,4
1746612159829,MCWP 50R,A00,893766,Compas; Sean Matthew,0,1,20,20
1746612159829,MCWP 50R,B00,893769,Carter; Jennifer A,0,1,20,20
1746612159829,MCWP 50R,C00,893771,Krone; Jarret,0,3,20,20
1746612159829,MCWP 50R,D00,893772,Miller; Elizabeth Deen,0,0,20,20
1746612159829,MCWP 50R,E00,893775,Carter; Andrea L,0,1,20,20
1746612160854,MMW 11R,A01,892721,Herbst; Matthew,14,0,30,16
1746612160854,MMW 11R,A02,892722,Herbst; Matthew,0,0,0,3
1746612161882,MMW 12R,A01,892724,Herbst; Matthew,0,11,16,16
1746612161882,MMW 12R,A02,892725,Herbst; Matthew,0,10,16,16
1746612162911,MMW 13R,A01,892727,Staff,0,4,16,16
1746612162911,MMW 13R,A02,892728,Staff,0,4,16,16
1746612162911,MMW 13R,A03,958032,Staff,0,4,16,16
1746612162911,MMW 13R,A04,958033,Staff,0,4,16,16
1746612162911,MMW 13R,A05,958034,Staff,0,4,16,16
1746612163938,SIO 295LS,A00,894015,Staff,5,0,25,20
1746612164969,SIO 295S,A00,894020,Staff,5,0,25,20
1746612165995,SIOC 290S,B01,958918,Merrifield; Mark A,14,0,30,16
1746612167020,SIOC 291S,B01,958922,Gabriel; Corey John,14,0,30,16
1746612168047,SOCI 117,A01,895339,Staff,2,0,5,3
1746612169073,WES 237B,A00,894149,Staff,11,0,20,9
1746612171137,AESE 279B,A00,891859,Staff,13,0,35,22
1746612172161,AIP 197,001,891854,Vespa; Emanuel Ignacio,9999,0,9999,0
1746612173212,ANTH 289S,A00,891856,Gagneux; Pascal,12,0,12,0
1746612174241,BENG 196,001,957946,Engler; Adam J.,9996,0,9999,3
1746612175269,BISP 197,001,959851,Wilhelm; James E.,9998,0,9999,1
1746612176295,CAT 124RS,A01,956906,Staff,6,0,25,19
1746612177319,CAT 125RS,A01,922013,Staff,6,0,25,19
1746612178345,CLRE 250,A00,891860,Morris; Sheldon,9995,0,9999,4
1746612180403,CLRE 251R,A00,907817,Mehta; Ravindra L.,9994,0,9999,5
1746612181430,CLRE 252,A00,891864,Cuomo; Raphael Eduardo,9993,0,9999,6
1746612182460,CLRE 253,A00,891867,Vaida; Florin,9994,0,9999,5
1746612182460,CLRE 253,B00,907819,Staff,9999,0,9999,0
1746612183486,CLRE 259,A00,891868,Patel; Hemal,9998,0,9999,1
1746612184514,CLRE 260,A00,891872,Cuomo; Raphael Eduardo,9999,0,9999,0
1746612185545,CLRE 297,001,891888,Cuomo; Raphael Eduardo,9999,0,9999,0
1746612186572,CSE 191,A00,958773,Minnes Kemp; Mor Mia,9995,0,9999,4
1746612187597,CSE 197,001,959846,Minnes Kemp; Mor Mia,9990,0,9999,9
1746612188627,CSS 201S,A01,892054,Mignozzetti; Umberto,25,0,30,5
1746612189658,CSS 202S,A01,892056,Mignozzetti; Umberto,25,0,30,5
1746612190685,DSC 197,001,956898,Eldridge; Justin Matthew,9996,0,9999,3
1746612191711,DSC 297,001,958000,Mazumdar; Arya,9998,0,9999,1
1746612191711,DSC 297,002,959862,Wang; Yusu,9998,0,9999,1
1746612192740,EAP 100,A00,905686,Staff,9778,0,9999,221
1746612193771,ECE 45,A01,892618,Staff,0,0,65,65
1746612195823,ECE 111,A01,892719,Staff,6,0,65,59
1746612196852,ECE 197,001,957920,Mercier; Patrick Philip,9991,0,9999,8
1746612197881,ECON 178,A01,907814,Zhu; Ying,26,0,35,9
1746612198908,EDS 115,A00,895312,Staff,35,0,45,10
1746612199973,EDS 117,A01,895337,Staff,23,0,30,7
1746612201000,EDS 125,A00,895341,Jones; Gabrielle Anastasia,36,0,45,9
1746612202029,EDS 128A,A01,895459,Fargason; Sharon Gayle,44,0,45,1
1746612203057,EDS 128B,A01,895543,Pappas; Elizabeth,44,0,45,1
1746612204084,EDS 139,A00,897203,Pappas; Elizabeth,44,0,45,1
1746612204084,EDS 139,B00,897209,Fargason; Sharon Gayle,41,0,45,4
1746612205111,EDS 201,A00,895545,Staff,22,0,45,23
1746612206136,EDS 203,A01,895581,Halter; Christopher P.,22,0,45,23
1746612207162,EDS 204R,A01,895625,Heinzman; Erica M.,39,0,45,6
1746612207162,EDS 204R,B01,895693,Halter; Christopher P.,10,0,45,35
1746612208189,EDS 206R,A00,895694,Fargason; Sharon Gayle,1,0,30,29
1746612208189,EDS 206R,B00,895695,Choi; Bailey Miyeon,16,0,30,14
1746612209215,EDS 250,A00,895697,Hemans; Patricia Ann Benitez,22,0,45,23
1746612210243,EDS 281,A00,895701,Meyerott; Theresa Ann,1,0,15,14
1746612211268,EDS 284,A00,895736,Meyerott; Theresa Ann,1,0,15,14
1746612212297,EDS 286,A00,897210,Fine; Sarah,0,0,15,15
1746612213322,EDS 289C,A01,895770,Daly; Alan J.,1,0,15,14
1746612214347,EDS 290,A00,897211,Hofstetter; Carolyn,0,0,15,15
1746612215376,LIGM 5A,A00,896162,Fischer-Grunski; Eva K,12,0,20,8
1746612216404,LIGM 5B,A00,896260,Fischer-Grunski; Eva K,17,0,20,3
1746612217430,LIGM 5C,A00,896308,Fischer-Grunski; Eva K,18,0,20,2
1746612218455,LIIT 5AS,A00,896313,Carnelos; Chiara,18,0,20,2
1746612219481,LIIT 5BS,A00,896416,Carnelos; Chiara,20,0,20,0
1746612220506,LIIT 5CS,A00,896564,Carnelos; Chiara,20,0,20,0
1746612221533,LISP 5A,A00,896588,Munoz Sanchez; Alicia,2,0,20,18
1746612222562,LISP 5B,A00,896653,Munoz Sanchez; Alicia,7,0,20,13
1746612223591,LISP 5C,A00,896655,Munoz Sanchez; Alicia,0,1,20,20
1746612224617,MAE 197,001,957918,Kleissl; Jan,9996,0,9999,3
1746612224617,MAE 197,002,959806,Boechler; Nicholas Sebastia,9998,0,9999,1
1746612224617,MAE 197,003,959852,Mullin; Jennifer S,9998,0,9999,1
1746612225645,MATH 2,A01,957937,Staff,33,0,35,2
1746612226674,MATH 197,001,957876,Kedlaya; Kiran S.,9993,0,9999,6
1746612227699,MCWP 40,A00,892729,Duru; Nur,10,0,20,10
1746612227699,MCWP 40,B00,893304,Montejo; Carolina,14,0,20,6
1746612228724,MCWP 40R,A00,893757,Redela; Pamela Morgan,0,5,20,20
1746612229752,MCWP 50,A00,893758,Morshed; Michael James,0,0,20,20
1746612229752,MCWP 50,B00,893761,Bartulis; Jason Michael,16,0,20,4
1746612230779,MCWP 50R,A00,893766,Compas; Sean Matthew,0,1,20,20
1746612230779,MCWP 50R,B00,893769,Carter; Jennifer A,0,1,20,20
1746612230779,MCWP 50R,C00,893771,Krone; Jarret,0,3,20,20
1746612230779,MCWP 50R,D00,893772,Miller; Elizabeth Deen,0,0,20,20
1746612230779,MCWP 50R,E00,893775,Carter; Andrea L,0,1,20,20
1746612231806,MMW 11R,A01,892721,Herbst; Matthew,14,0,30,16
1746612231806,MMW 11R,A02,892722,Herbst; Matthew,0,0,0,3
1746612232831,MMW 12R,A01,892724,Herbst; Matthew,0,11,16,16
1746612232831,MMW 12R,A02,892725,Herbst; Matthew,0,10,16,16
1746612233861,MMW 13R,A01,892727,Staff,0,4,16,16
1746612233861,MMW 13R,A02,892728,Staff,0,4,16,16
1746612233861,MMW 13R,A03,958032,Staff,0,4,16,16
1746612233861,MMW 13R,A04,958033,Staff,0,4,16,16
1746612233861,MMW 13R,A05,958034,Staff,0,4,16,16
1746612234891,SIO 295LS,A00,894015,Staff,5,0,25,20
1746612235919,SIO 295S,A00,894020,Staff,5,0,25,20
1746612236951,SIOC 290S,B01,958918,Merrifield; Mark A,14,0,30,16
1746612237981,SIOC 291S,B01,958922,Gabriel; Corey John,14,0,30,16
1746612239007,SOCI 117,A01,895339,Staff,2,0,5,3
1746612240035,WES 237B,A00,894149,Staff,11,0,20,9
1746612242102,AESE 279B,A00,891859,Staff,13,0,35,22
1746612243130,AIP 197,001,891854,Vespa; Emanuel Ignacio,9999,0,9999,0
1746612244156,ANTH 289S,A00,891856,Gagneux; Pascal,12,0,12,0
1746612245182,BENG 196,001,957946,Engler; Adam J.,9996,0,9999,3
1746612246208,BISP 197,001,959851,Wilhelm; James E.,9998,0,9999,1
1746612247235,CAT 124RS,A01,956906,Staff,6,0,25,19
1746612248261,CAT 125RS,A01,922013,Staff,6,0,25,19
1746612249289,CLRE 250,A00,891860,Morris; Sheldon,9995,0,9999,4
1746612251346,CLRE 251R,A00,907817,Mehta; Ravindra L.,9994,0,9999,5
1746612252374,CLRE 252,A00,891864,Cuomo; Raphael Eduardo,9993,0,9999,6
1746612253403,CLRE 253,A00,891867,Vaida; Florin,9994,0,9999,5
1746612253403,CLRE 253,B00,907819,Staff,9999,0,9999,0
1746612254429,CLRE 259,A00,891868,Patel; Hemal,9998,0,9999,1
1746612255452,CLRE 260,A00,891872,Cuomo; Raphael Eduardo,9999,0,9999,0
1746612256478,CLRE 297,001,891888,Cuomo; Raphael Eduardo,9999,0,9999,0
1746612257503,CSE 191,A00,958773,Minnes Kemp; Mor Mia,9995,0,9999,4
1746612258529,CSE 197,001,959846,Minnes Kemp; Mor Mia,9990,0,9999,9
1746612259554,CSS 201S,A01,892054,Mignozzetti; Umberto,25,0,30,5
1746612260580,CSS 202S,A01,892056,Mignozzetti; Umberto,25,0,30,5
1746612261609,DSC 197,001,956898,Eldridge; Justin Matthew,9996,0,9999,3
1746612262634,DSC 297,001,958000,Mazumdar; Arya,9998,0,9999,1
1746612262634,DSC 297,002,959862,Wang; Yusu,9998,0,9999,1
1746612263659,EAP 100,A00,905686,Staff,9778,0,9999,221
1746612264689,ECE 45,A01,892618,Staff,0,0,65,65
1746612266744,ECE 111,A01,892719,Staff,6,0,65,59
1746612267771,ECE 197,001,957920,Mercier; Patrick Philip,9991,0,9999,8
1746612268798,ECON 178,A01,907814,Zhu; Ying,26,0,35,9
1746612269826,EDS 115,A00,895312,Staff,35,0,45,10
1746612270854,EDS 117,A01,895337,Staff,23,0,30,7
1746612271882,EDS 125,A00,895341,Jones; Gabrielle Anastasia,36,0,45,9
1746612272909,EDS 128A,A01,895459,Fargason; Sharon Gayle,44,0,45,1
1746612273935,EDS 128B,A01,895543,Pappas; Elizabeth,44,0,45,1
1746612274960,EDS 139,A00,897203,Pappas; Elizabeth,44,0,45,1
1746612274960,EDS 139,B00,897209,Fargason; Sharon Gayle,41,0,45,4
1746612275988,EDS 201,A00,895545,Staff,22,0,45,23
1746612277017,EDS 203,A01,895581,Halter; Christopher P.,22,0,45,23
1746612278046,EDS 204R,A01,895625,Heinzman; Erica M.,39,0,45,6
1746612278046,EDS 204R,B01,895693,Halter; Christopher P.,10,0,45,35
1746612279075,EDS 206R,A00,895694,Fargason; Sharon Gayle,1,0,30,29
1746612279075,EDS 206R,B00,895695,Choi; Bailey Miyeon,16,0,30,14
1746612280099,EDS 250,A00,895697,Hemans; Patricia Ann Benitez,22,0,45,23
1746612281125,EDS 281,A00,895701,Meyerott; Theresa Ann,1,0,15,14
1746612282150,EDS 284,A00,895736,Meyerott; Theresa Ann,1,0,15,14
1746612283178,EDS 286,A00,897210,Fine; Sarah,0,0,15,15
1746612284207,EDS 289C,A01,895770,Daly; Alan J.,1,0,15,14
1746612285232,EDS 290,A00,897211,Hofstetter; Carolyn,0,0,15,15
1746612286260,LIGM 5A,A00,896162,Fischer-Grunski; Eva K,12,0,20,8
1746612287287,LIGM 5B,A00,896260,Fischer-Grunski; Eva K,17,0,20,3
1746612288311,LIGM 5C,A00,896308,Fischer-Grunski; Eva K,18,0,20,2
1746612289339,LIIT 5AS,A00,896313,Carnelos; Chiara,18,0,20,2
1746612290365,LIIT 5BS,A00,896416,Carnelos; Chiara,20,0,20,0
1746612291391,LIIT 5CS,A00,896564,Carnelos; Chiara,20,0,20,0
1746612292422,LISP 5A,A00,896588,Munoz Sanchez; Alicia,2,0,20,18
1746612293447,LISP 5B,A00,896653,Munoz Sanchez; Alicia,7,0,20,13
1746612294472,LISP 5C,A00,896655,Munoz Sanchez; Alicia,0,1,20,20
1746612295499,MAE 197,001,957918,Kleissl; Jan,9996,0,9999,3
1746612295499,MAE 197,002,959806,Boechler; Nicholas Sebastia,9998,0,9999,1
1746612295499,MAE 197,003,959852,Mullin; Jennifer S,9998,0,9999,1
1746612296525,MATH 2,A01,957937,Staff,33,0,35,2
1746612297549,MATH 197,001,957876,Kedlaya; Kiran S.,9993,0,9999,6
1746612298576,MCWP 40,A00,892729,Duru; Nur,10,0,20,10
1746612298576,MCWP 40,B00,893304,Montejo; Carolina,14,0,20,6
1746612299603,MCWP 40R,A00,893757,Redela; Pamela Morgan,0,5,20,20
1746612300631,MCWP 50,A00,893758,Morshed; Michael James,0,0,20,20
1746612300631,MCWP 50,B00,893761,Bartulis; Jason Michael,16,0,20,4
1746612301659,MCWP 50R,A00,893766,Compas; Sean Matthew,0,1,20,20
1746612301659,MCWP 50R,B00,893769,Carter; Jennifer A,0,1,20,20
1746612301659,MCWP 50R,C00,893771,Krone; Jarret,0,3,20,20
1746612301659,MCWP 50R,D00,893772,Miller; Elizabeth Deen,0,0,20,20
1746612301659,MCWP 50R,E00,893775,Carter; Andrea L,0,1,20,20
1746612302689,MMW 11R,A01,892721,Herbst; Matthew,14,0,30,16
1746612302689,MMW 11R,A02,892722,Herbst; Matthew,0,0,0,3
1746612303719,MMW 12R,A01,892724,Herbst; Matthew,0,11,16,16
1746612303719,MMW 12R,A02,892725,Herbst; Matthew,0,10,16,16
1746612304745,MMW 13R,A01,892727,Staff,0,4,16,16
1746612304745,MMW 13R,A02,892728,Staff,0,4,16,16
1746612304745,MMW 13R,A03,958032,Staff,0,4,16,16
1746612304745,MMW 13R,A04,958033,Staff,0,4,16,16
1746612304745,MMW 13R,A05,958034,Staff,0,4,16,16
1746612305771,SIO 295LS,A00,894015,Staff,5,0,25,20
1746612306796,SIO 295S,A00,894020,Staff,5,0,25,20
1746612307826,SIOC 290S,B01,958918,Merrifield; Mark A,14,0,30,16
1746612308855,SIOC 291S,B01,958922,Gabriel; Corey John,14,0,30,16
1746612309882,SOCI 117,A01,895339,Staff,2,0,5,3
1746612310908,WES 237B,A00,894149,Staff,11,0,20,9
1746612312969,AESE 279B,A00,891859,Staff,13,0,35,22
1746612313995,AIP 197,001,891854,Vespa; Emanuel Ignacio,9999,0,9999,0
1746612315022,ANTH 289S,A00,891856,Gagneux; Pascal,12,0,12,0
1746612316048,BENG 196,001,957946,Engler; Adam J.,9996,0,9999,3
1746612317115,BISP 197,001,959851,Wilhelm; James E.,9998,0,9999,1
1746612318141,CAT 124RS,A01,956906,Staff,6,0,25,19
1746612319170,CAT 125RS,A01,922013,Staff,6,0,25,19
1746612320195,CLRE 250,A00,891860,Morris; Sheldon,9995,0,9999,4
1746612322245,CLRE 251R,A00,907817,Mehta; Ravindra L.,9994,0,9999,5
1746612323271,CLRE 252,A00,891864,Cuomo; Raphael Eduardo,9993,0,9999,6
1746612324298,CLRE 253,A00,891867,Vaida; Florin,9994,0,9999,5
1746612324298,CLRE 253,B00,907819,Staff,9999,0,9999,0
1746612325323,CLRE 259,A00,891868,Patel; Hemal,9998,0,9999,1
1746612326350,CLRE 260,A00,891872,Cuomo; Raphael Eduardo,9999,0,9999,0
1746612327377,CLRE 297,001,891888,Cuomo; Raphael Eduardo,9999,0,9999,0
1746612328401,CSE 191,A00,958773,Minnes Kemp; Mor Mia,9995,0,9999,4
1746612329429,CSE 197,001,959846,Minnes Kemp; Mor Mia,9990,0,9999,9
1746612330455,CSS 201S,A01,892054,Mignozzetti; Umberto,25,0,30,5
1746612331483,CSS 202S,A01,892056,Mignozzetti; Umberto,25,0,30,5
1746612332512,DSC 197,001,956898,Eldridge; Justin Matthew,9996,0,9999,3
1746612333536,DSC 297,001,958000,Mazumdar; Arya,9998,0,9999,1
1746612333536,DSC 297,002,959862,Wang; Yusu,9998,0,9999,1
1746612334562,EAP 100,A00,905686,Staff,9778,0,9999,221
1746612335591,ECE 45,A01,892618,Staff,0,0,65,65
1746612337650,ECE 111,A01,892719,Staff,6,0,65,59
1746612338676,ECE 197,001,957920,Mercier; Patrick Philip,9991,0,9999,8
1746612339701,ECON 178,A01,907814,Zhu; Ying,26,0,35,9
1746612340727,EDS 115,A00,895312,Staff,35,0,45,10
1746612341753,EDS 117,A01,895337,Staff,23,0,30,7
1746612342782,EDS 125,A00,895341,Jones; Gabrielle Anastasia,36,0,45,9
1746612343810,EDS 128A,A01,895459,Fargason; Sharon Gayle,44,0,45,1
1746612344836,EDS 128B,A01,895543,Pappas; Elizabeth,44,0,45,1
1746612345865,EDS 139,A00,897203,Pappas; Elizabeth,44,0,45,1
1746612345865,EDS 139,B00,897209,Fargason; Sharon Gayle,41,0,45,4
1746612346893,EDS 201,A00,895545,Staff,22,0,45,23
1746612347923,EDS 203,A01,895581,Halter; Christopher P.,22,0,45,23
1746612348950,EDS 204R,A01,895625,Heinzman; Erica M.,39,0,45,6
1746612348950,EDS 204R,B01,895693,Halter; Christopher P.,10,0,45,35
1746612349981,EDS 206R,A00,895694,Fargason; Sharon Gayle,1,0,30,29
1746612349981,EDS 206R,B00,895695,Choi; Bailey Miyeon,16,0,30,14
1746612351007,EDS 250,A00,895697,Hemans; Patricia Ann Benitez,22,0,45,23
1746612352035,EDS 281,A00,895701,Meyerott; Theresa Ann,1,0,15,14
1746612353061,EDS 284,A00,895736,Meyerott; Theresa Ann,1,0,15,14
1746612354087,EDS 286,A00,897210,Fine; Sarah,0,0,15,15
1746612355114,EDS 289C,A01,895770,Daly; Alan J.,1,0,15,14
1746612356140,EDS 290,A00,897211,Hofstetter; Carolyn,0,0,15,15
1746612357170,LIGM 5A,A00,896162,Fischer-Grunski; Eva K,12,0,20,8
1746612358199,LIGM 5B,A00,896260,Fischer-Grunski; Eva K,17,0,20,3
1746612359226,LIGM 5C,A00,896308,Fischer-Grunski; Eva K,18,0,20,2
1746612360257,LIIT 5AS,A00,896313,Carnelos; Chiara,18,0,20,2
1746612361285,LIIT 5BS,A00,896416,Carnelos; Chiara,20,0,20,0
1746612362315,LIIT 5CS,A00,896564,Carnelos; Chiara,20,0,20,0
1746612363340,LISP 5A,A00,896588,Munoz Sanchez; Alicia,2,0,20,18
1746612364368,LISP 5B,A00,896653,Munoz Sanchez; Alicia,7,0,20,13
1746612365393,LISP 5C,A00,896655,Munoz Sanchez; Alicia,0,1,20,20
1746612366420,MAE 197,001,957918,Kleissl; Jan,9996,0,9999,3
1746612366420,MAE 197,002,959806,Boechler; Nicholas Sebastia,9998,0,9999,1
1746612366420,MAE 197,003,959852,Mullin; Jennifer S,9998,0,9999,1
1746612367445,MATH 2,A01,957937,Staff,33,0,35,2
1746612368474,MATH 197,001,957876,Kedlaya; Kiran S.,9993,0,9999,6
1746612369504,MCWP 40,A00,892729,Duru; Nur,10,0,20,10
1746612369504,MCWP 40,B00,893304,Montejo; Carolina,14,0,20,6
1746612370535,MCWP 40R,A00,893757,Redela; Pamela Morgan,0,5,20,20
1746612371565,MCWP 50,A00,893758,Morshed; Michael James,0,0,20,20
1746612371565,MCWP 50,B00,893761,Bartulis; Jason Michael,16,0,20,4
1746612372592,MCWP 50R,A00,893766,Compas; Sean Matthew,0,1,20,20
1746612372592,MCWP 50R,B00,893769,Carter; Jennifer A,0,1,20,20
1746612372592,MCWP 50R,C00,893771,Krone; Jarret,0,3,20,20
1746612372592,MCWP 50R,D00,893772,Miller; Elizabeth Deen,0,0,20,20
1746612372592,MCWP 50R,E00,893775,Carter; Andrea L,0,1,20,20
1746612373617,MMW 11R,A01,892721,Herbst; Matthew,14,0,30,16
1746612373617,MMW 11R,A02,892722,Herbst; Matthew,0,0,0,3
1746612374642,MMW 12R,A01,892724,Herbst; Matthew,0,11,16,16
1746612374642,MMW 12R,A02,892725,Herbst; Matthew,0,10,16,16
1746612375667,MMW 13R,A01,892727,Staff,0,4,16,16
1746612375667,MMW 13R,A02,892728,Staff,0,4,16,16
1746612375667,MMW 13R,A03,958032,Staff,0,4,16,16
1746612375667,MMW 13R,A04,958033,Staff,0,4,16,16
1746612375667,MMW 13R,A05,958034,Staff,0,4,16,16
1746612376692,SIO 295LS,A00,894015,Staff,5,0,25,20
1746612377717,SIO 295S,A00,894020,Staff,5,0,25,20
1746612378745,SIOC 290S,B01,958918,Merrifield; Mark A,14,0,30,16
1746612379776,SIOC 291S,B01,958922,Gabriel; Corey John,14,0,30,16
1746612380800,SOCI 117,A01,895339,Staff,2,0,5,3
1746612381825,WES 237B,A00,894149,Staff,11,0,20,9
1746612383891,AESE 279B,A00,891859,Staff,13,0,35,22
1746612384919,AIP 197,001,891854,Vespa; Emanuel Ignacio,9999,0,9999,0
1746612386003,ANTH 289S,A00,891856,Gagneux; Pascal,12,0,12,0
1746612387029,BENG 196,001,957946,Engler; Adam J.,9996,0,9999,3
1746612388055,BISP 197,001,959851,Wilhelm; James E.,9998,0,9999,1
1746612389081,CAT 124RS,A01,956906,Staff,6,0,25,19
1746612390105,CAT 125RS,A01,922013,Staff,6,0,25,19
1746612391130,CLRE 250,A00,891860,Morris; Sheldon,9995,0,9999,4
1746612393185,CLRE 251R,A00,907817,Mehta; Ravindra L.,9994,0,9999,5
1746612394208,CLRE 252,A00,891864,Cuomo; Raphael Eduardo,9993,0,9999,6
1746612395234,CLRE 253,A00,891867,Vaida; Florin,9994,0,9999,5
1746612395234,CLRE 253,B00,907819,Staff,9999,0,9999,0
1746612396256,CLRE 259,A00,891868,Patel; Hemal,9998,0,9999,1
1746612397281,CLRE 260,A00,891872,Cuomo; Raphael Eduardo,9999,0,9999,0
1746612398306,CLRE 297,001,891888,Cuomo; Raphael Eduardo,9999,0,9999,0
1746612399334,CSE 191,A00,958773,Minnes Kemp; Mor Mia,9995,0,9999,4
1746612400359,CSE 197,001,959846,Minnes Kemp; Mor Mia,9990,0,9999,9
1746612401388,CSS 201S,A01,892054,Mignozzetti; Umberto,25,0,30,5
1746612402417,CSS 202S,A01,892056,Mignozzetti; Umberto,25,0,30,5
1746612403442,DSC 197,001,956898,Eldridge; Justin Matthew,9996,0,9999,3
1746612404471,DSC 297,001,958000,Mazumdar; Arya,9998,0,9999,1
1746612404471,DSC 297,002,959862,Wang; Yusu,9998,0,9999,1
1746612405499,EAP 100,A00,905686,Staff,9778,0,9999,221
1746612406523,ECE 45,A01,892618,Staff,0,0,65,65
1746612408576,ECE 111,A01,892719,Staff,6,0,65,59
1746612409640,ECE 197,001,957920,Mercier; Patrick Philip,9991,0,9999,8
1746612410672,ECON 178,A01,907814,Zhu; Ying,26,0,35,9
1746612411699,EDS 115,A00,895312,Staff,35,0,45,10
1746612412726,EDS 117,A01,895337,Staff,23,0,30,7
1746612413754,EDS 125,A00,895341,Jones; Gabrielle Anastasia,36,0,45,9
1746612414782,EDS 128A,A01,895459,Fargason; Sharon Gayle,44,0,45,1
1746612415806,EDS 128B,A01,895543,Pappas; Elizabeth,44,0,45,1
1746612416836,EDS 139,A00,897203,Pappas; Elizabeth,44,0,45,1
1746612416836,EDS 139,B00,897209,Fargason; Sharon Gayle,41,0,45,4
1746612417861,EDS 201,A00,895545,Staff,22,0,45,23
1746612418891,EDS 203,A01,895581,Halter; Christopher P.,22,0,45,23
1746612419917,EDS 204R,A01,895625,Heinzman; Erica M.,39,0,45,6
1746612419917,EDS 204R,B01,895693,Halter; Christopher P.,10,0,45,35
1746612420943,EDS 206R,A00,895694,Fargason; Sharon Gayle,1,0,30,29
1746612420943,EDS 206R,B00,895695,Choi; Bailey Miyeon,16,0,30,14
1746612421969,EDS 250,A00,895697,Hemans; Patricia Ann Benitez,22,0,45,23
1746612422995,EDS 281,A00,895701,Meyerott; Theresa Ann,1,0,15,14
1746612424022,EDS 284,A00,895736,Meyerott; Theresa Ann,1,0,15,14
1746612425045,EDS 286,A00,897210,Fine; Sarah,0,0,15,15
1746612426070,EDS 289C,A01,895770,Daly; Alan J.,1,0,15,14
1746612427093,EDS 290,A00,897211,Hofstetter; Carolyn,0,0,15,15
1746612428118,LIGM 5A,A00,896162,Fischer-Grunski; Eva K,12,0,20,8
1746612429144,LIGM 5B,A00,896260,Fischer-Grunski; Eva K,17,0,20,3
1746612430171,LIGM 5C,A00,896308,Fischer-Grunski; Eva K,18,0,20,2
1746612431196,LIIT 5AS,A00,896313,Carnelos; Chiara,18,0,20,2
1746612432222,LIIT 5BS,A00,896416,Carnelos; Chiara,20,0,20,0
1746612433246,LIIT 5CS,A00,896564,Carnelos; Chiara,20,0,20,0
1746612434277,LISP 5A,A00,896588,Munoz Sanchez; Alicia,2,0,20,18
1746612435307,LISP 5B,A00,896653,Munoz Sanchez; Alicia,7,0,20,13
1746612436333,LISP 5C,A00,896655,Munoz Sanchez; Alicia,0,1,20,20
1746612437359,MAE 197,001,957918,Kleissl; Jan,9996,0,9999,3
1746612437359,MAE 197,002,959806,Boechler; Nicholas Sebastia,9998,0,9999,1
1746612437359,MAE 197,003,959852,Mullin; Jennifer S,9998,0,9999,1
1746612438388,MATH 2,A01,957937,Staff,33,0,35,2
1746612439412,MATH 197,001,957876,Kedlaya; Kiran S.,9993,0,9999,6
1746612440441,MCWP 40,A00,892729,Duru; Nur,10,0,20,10
1746612440441,MCWP 40,B00,893304,Montejo; Carolina,14,0,20,6
1746612441470,MCWP 40R,A00,893757,Redela; Pamela Morgan,0,5,20,20
1746612442497,MCWP 50,A00,893758,Morshed; Michael James,0,0,20,20
1746612442497,MCWP 50,B00,893761,Bartulis; Jason Michael,16,0,20,4
1746612443522,MCWP 50R,A00,893766,Compas; Sean Matthew,0,1,20,20
1746612443522,MCWP 50R,B00,893769,Carter; Jennifer A,0,1,20,20
1746612443522,MCWP 50R,C00,893771,Krone; Jarret,0,3,20,20
1746612443522,MCWP 50R,D00,893772,Miller; Elizabeth Deen,0,0,20,20
1746612443522,MCWP 50R,E00,893775,Carter; Andrea L,0,1,20,20
1746612444550,MMW 11R,A01,892721,Herbst; Matthew,14,0,30,16
1746612444550,MMW 11R,A02,892722,Herbst; Matthew,0,0,0,3
1746612445575,MMW 12R,A01,892724,Herbst; Matthew,0,11,16,16
1746612445575,MMW 12R,A02,892725,Herbst; Matthew,0,10,16,16
1746612446601,MMW 13R,A01,892727,Staff,0,4,16,16
1746612446601,MMW 13R,A02,892728,Staff,0,4,16,16
1746612446601,MMW 13R,A03,958032,Staff,0,4,16,16
1746612446601,MMW 13R,A04,958033,Staff,0,4,16,16
1746612446601,MMW 13R,A05,958034,Staff,0,4,16,16
1746612447627,SIO 295LS,A00,894015,Staff,5,0,25,20
1746612448653,SIO 295S,A00,894020,Staff,5,0,25,20
1746612449679,SIOC 290S,B01,958918,Merrifield; Mark A,14,0,30,16
1746612450707,SIOC 291S,B01,958922,Gabriel; Corey John,14,0,30,16
1746612451732,SOCI 117,A01,895339,Staff,2,0,5,3
1746612452761,WES 237B,A00,894149,Staff,11,0,20,9
1746612454826,AESE 279B,A00,891859,Staff,13,0,35,22
1746612455853,AIP 197,001,891854,Vespa; Emanuel Ignacio,9999,0,9999,0
1746612456879,ANTH 289S,A00,891856,Gagneux; Pascal,12,0,12,0
1746612457904,BENG 196,001,957946,Engler; Adam J.,9996,0,9999,3
1746612458930,BISP 197,001,959851,Wilhelm; James E.,9998,0,9999,1
1746612459956,CAT 124RS,A01,956906,Staff,6,0,25,19
1746612460986,CAT 125RS,A01,922013,Staff,6,0,25,19
1746612462011,CLRE 250,A00,891860,Morris; Sheldon,9995,0,9999,4
1746612464068,CLRE 251R,A00,907817,Mehta; Ravindra L.,9994,0,9999,5
1746612465097,CLRE 252,A00,891864,Cuomo; Raphael Eduardo,9993,0,9999,6
1746612466121,CLRE 253,A00,891867,Vaida; Florin,9994,0,9999,5
1746612466121,CLRE 253,B00,907819,Staff,9999,0,9999,0
1746612467147,CLRE 259,A00,891868,Patel; Hemal,9998,0,9999,1
1746612468174,CLRE 260,A00,891872,Cuomo; Raphael Eduardo,9999,0,9999,0
1746612469199,CLRE 297,001,891888,Cuomo; Raphael Eduardo,9999,0,9999,0
1746612470225,CSE 191,A00,958773,Minnes Kemp; Mor Mia,9995,0,9999,4
1746612471251,CSE 197,001,959846,Minnes Kemp; Mor Mia,9990,0,9999,9
1746612472276,CSS 201S,A01,892054,Mignozzetti; Umberto,25,0,30,5
1746612473306,CSS 202S,A01,892056,Mignozzetti; Umberto,25,0,30,5
1746612474334,DSC 197,001,956898,Eldridge; Justin Matthew,9996,0,9999,3
1746612475363,DSC 297,001,958000,Mazumdar; Arya,9998,0,9999,1
1746612475363,DSC 297,002,959862,Wang; Yusu,9998,0,9999,1
1746612476405,EAP 100,A00,905686,Staff,9778,0,9999,221
1746612477432,ECE 45,A01,892618,Staff,0,0,65,65
1746612479486,ECE 111,A01,892719,Staff,6,0,65,59
1746612480514,ECE 197,001,957920,Mercier; Patrick Philip,9991,0,9999,8
1746612481540,ECON 178,A01,907814,Zhu; Ying,26,0,35,9
1746612482569,EDS 115,A00,895312,Staff,35,0,45,10
1746612483595,EDS 117,A01,895337,Staff,23,0,30,7
1746612484621,EDS 125,A00,895341,Jones; Gabrielle Anastasia,36,0,45,9
1746612485647,EDS 128A,A01,895459,Fargason; Sharon Gayle,44,0,45,1
1746612486676,EDS 128B,A01,895543,Pappas; Elizabeth,44,0,45,1
1746612487704,EDS 139,A00,897203,Pappas; Elizabeth,44,0,45,1
1746612487704,EDS 139,B00,897209,Fargason; Sharon Gayle,41,0,45,4
1746612488730,EDS 201,A00,895545,Staff,22,0,45,23
1746612489759,EDS 203,A01,895581,Halter; Christopher P.,22,0,45,23
1746612490787,EDS 204R,A01,895625,Heinzman; Erica M.,39,0,45,6
1746612490787,EDS 204R,B01,895693,Halter; Christopher P.,10,0,45,35
1746612491814,EDS 206R,A00,895694,Fargason; Sharon Gayle,1,0,30,29
1746612491814,EDS 206R,B00,895695,Choi; Bailey Miyeon,16,0,30,14
1746612492839,EDS 250,A00,895697,Hemans; Patricia Ann Benitez,22,0,45,23
1746612493867,EDS 281,A00,895701,Meyerott; Theresa Ann,1,0,15,14
1746612494895,EDS 284,A00,895736,Meyerott; Theresa Ann,1,0,15,14
1746612495923,EDS 286,A00,897210,Fine; Sarah,0,0,15,15
1746612496948,EDS 289C,A01,895770,Daly; Alan J.,1,0,15,14
1746612497976,EDS 290,A00,897211,Hofstetter; Carolyn,0,0,15,15
1746612499001,LIGM 5A,A00,896162,Fischer-Grunski; Eva K,12,0,20,8
1746612500027,LIGM 5B,A00,896260,Fischer-Grunski; Eva K,17,0,20,3
1746612501051,LIGM 5C,A00,896308,Fischer-Grunski; Eva K,18,0,20,2
1746612502075,LIIT 5AS,A00,896313,Carnelos; Chiara,18,0,20,2
1746612503125,LIIT 5BS,A00,896416,Carnelos; Chiara,20,0,20,0
1746612504155,LIIT 5CS,A00,896564,Carnelos; Chiara,20,0,20,0
1746612505179,LISP 5A,A00,896588,Munoz Sanchez; Alicia,2,0,20,18
1746612506205,LISP 5B,A00,896653,Munoz Sanchez; Alicia,7,0,20,13
1746612507230,LISP 5C,A00,896655,Munoz Sanchez; Alicia,0,1,20,20
1746612508255,MAE 197,001,957918,Kleissl; Jan,9996,0,9999,3
1746612508255,MAE 197,002,959806,Boechler; Nicholas Sebastia,9998,0,9999,1
1746612508255,MAE 197,003,959852,Mullin; Jennifer S,9998,0,9999,1
1746612509283,MATH 2,A01,957937,Staff,33,0,35,2
1746612510310,MATH 197,001,957876,Kedlaya; Kiran S.,9993,0,9999,6
1746612511336,MCWP 40,A00,892729,Duru; Nur,10,0,20,10
1746612511336,MCWP 40,B00,893304,Montejo; Carolina,14,0,20,6
1746612512362,MCWP 40R,A00,893757,Redela; Pamela Morgan,0,5,20,20
1746612513387,MCWP 50,A00,893758,Morshed; Michael James,0,0,20,20
1746612513387,MCWP 50,B00,893761,Bartulis; Jason Michael,16,0,20,4
1746612514416,MCWP 50R,A00,893766,Compas; Sean Matthew,0,1,20,20
1746612514416,MCWP 50R,B00,893769,Carter; Jennifer A,0,1,20,20
1746612514416,MCWP 50R,C00,893771,Krone; Jarret,0,3,20,20
1746612514416,MCWP 50R,D00,893772,Miller; Elizabeth Deen,0,0,20,20
1746612514416,MCWP 50R,E00,893775,Carter; Andrea L,0,1,20,20
1746612515441,MMW 11R,A01,892721,Herbst; Matthew,14,0,30,16
1746612515441,MMW 11R,A02,892722,Herbst; Matthew,0,0,0,3
1746612516470,MMW 12R,A01,892724,Herbst; Matthew,0,11,16,16
1746612516470,MMW 12R,A02,892725,Herbst; Matthew,0,10,16,16
1746612517496,MMW 13R,A01,892727,Staff,0,4,16,16
1746612517496,MMW 13R,A02,892728,Staff,0,4,16,16
1746612517496,MMW 13R,A03,958032,Staff,0,4,16,16
1746612517496,MMW 13R,A04,958033,Staff,0,4,16,16
1746612517496,MMW 13R,A05,958034,Staff,0,4,16,16
1746612518525,SIO 295LS,A00,894015,Staff,5,0,25,20
1746612519551,SIO 295S,A00,894020,Staff,5,0,25,20
1746612520578,SIOC 290S,B01,958918,Merrifield; Mark A,14,0,30,16
1746612521604,SIOC 291S,B01,958922,Gabriel; Corey John,14,0,30,16
1746612522629,SOCI 117,A01,895339,Staff,2,0,5,3
1746612523656,WES 237B,A00,894149,Staff,11,0,20,9
1746612525715,AESE 279B,A00,891859,Staff,13,0,35,22
1746612526739,AIP 197,001,891854,Vespa; Emanuel Ignacio,9999,0,9999,0
1746612527765,ANTH 289S,A00,891856,Gagneux; Pascal,12,0,12,0
1746612528789,BENG 196,001,957946,Engler; Adam J.,9996,0,9999,3
1746612529816,BISP 197,001,959851,Wilhelm; James E.,9998,0,9999,1
1746612530841,CAT 124RS,A01,956906,Staff,6,0,25,19
1746612531868,CAT 125RS,A01,922013,Staff,6,0,25,19
1746612532896,CLRE 250,A00,891860,Morris; Sheldon,9995,0,9999,4
1746612534952,CLRE 251R,A00,907817,Mehta; Ravindra L.,9994,0,9999,5
1746612535977,CLRE 252,A00,891864,Cuomo; Raphael Eduardo,9993,0,9999,6
1746612537006,CLRE 253,A00,891867,Vaida; Florin,9994,0,9999,5
1746612537006,CLRE 253,B00,907819,Staff,9999,0,9999,0
1746612538035,CLRE 259,A00,891868,Patel; Hemal,9998,0,9999,1
1746612539063,CLRE 260,A00,891872,Cuomo; Raphael Eduardo,9999,0,9999,0
1746612540091,CLRE 297,001,891888,Cuomo; Raphael Eduardo,9999,0,9999,0
1746612541116,CSE 191,A00,958773,Minnes Kemp; Mor Mia,9995,0,9999,4
1746612542145,CSE 197,001,959846,Minnes Kemp; Mor Mia,9990,0,9999,9
1746612543173,CSS 201S,A01,892054,Mignozzetti; Umberto,25,0,30,5
1746612544209,CSS 202S,A01,892056,Mignozzetti; Umberto,25,0,30,5
1746612545237,DSC 197,001,956898,Eldridge; Justin Matthew,9996,0,9999,3
1746612546264,DSC 297,001,958000,Mazumdar; Arya,9998,0,9999,1
1746612546264,DSC 297,002,959862,Wang; Yusu,9998,0,9999,1
1746612547291,EAP 100,A00,905686,Staff,9778,0,9999,221
1746612548322,ECE 45,A01,892618,Staff,0,0,65,65
1746612550379,ECE 111,A01,892719,Staff,6,0,65,59
1746612551404,ECE 197,001,957920,Mercier; Patrick Philip,9991,0,9999,8
1746612552430,ECON 178,A01,907814,Zhu; Ying,26,0,35,9
1746612553457,EDS 115,A00,895312,Staff,35,0,45,10
1746612554486,EDS 117,A01,895337,Staff,23,0,30,7
1746612555513,EDS 125,A00,895341,Jones; Gabrielle Anastasia,36,0,45,9
1746612556539,EDS 128A,A01,895459,Fargason; Sharon Gayle,44,0,45,1
1746612557567,EDS 128B,A01,895543,Pappas; Elizabeth,44,0,45,1
1746612558591,EDS 139,A00,897203,Pappas; Elizabeth,44,0,45,1
1746612558591,EDS 139,B00,897209,Fargason; Sharon Gayle,41,0,45,4
1746612559617,EDS 201,A00,895545,Staff,22,0,45,23
1746612560647,EDS 203,A01,895581,Halter; Christopher P.,22,0,45,23
1746612561673,EDS 204R,A01,895625,Heinzman; Erica M.,39,0,45,6
1746612561673,EDS 204R,B01,895693,Halter; Christopher P.,10,0,45,35
1746612562698,EDS 206R,A00,895694,Fargason; Sharon Gayle,1,0,30,29
1746612562698,EDS 206R,B00,895695,Choi; Bailey Miyeon,16,0,30,14
1746612563726,EDS 250,A00,895697,Hemans; Patricia Ann Benitez,22,0,45,23
1746612564752,EDS 281,A00,895701,Meyerott; Theresa Ann,1,0,15,14
1746612565778,EDS 284,A00,895736,Meyerott; Theresa Ann,1,0,15,14
1746612566803,EDS 286,A00,897210,Fine; Sarah,0,0,15,15
1746612567829,EDS 289C,A01,895770,Daly; Alan J.,1,0,15,14
1746612568853,EDS 290,A00,897211,Hofstetter; Carolyn,0,0,15,15
1746612569878,LIGM 5A,A00,896162,Fischer-Grunski; Eva K,12,0,20,8
1746612570905,LIGM 5B,A00,896260,Fischer-Grunski; Eva K,17,0,20,3
1746612571931,LIGM 5C,A00,896308,Fischer-Grunski; Eva K,18,0,20,2
1746612572957,LIIT 5AS,A00,896313,Carnelos; Chiara,18,0,20,2
1746612573983,LIIT 5BS,A00,896416,Carnelos; Chiara,20,0,20,0
1746612575009,LIIT 5CS,A00,896564,Carnelos; Chiara,20,0,20,0
1746612576035,LISP 5A,A00,896588,Munoz Sanchez; Alicia,2,0,20,18
1746612577063,LISP 5B,A00,896653,Munoz Sanchez; Alicia,7,0,20,13
1746612578093,LISP 5C,A00,896655,Munoz Sanchez; Alicia,0,1,20,20
1746612579119,MAE 197,001,957918,Kleissl; Jan,9996,0,9999,3
1746612579119,MAE 197,002,959806,Boechler; Nicholas Sebastia,9998,0,9999,1
1746612579119,MAE 197,003,959852,Mullin; Jennifer S,9998,0,9999,1
1746612580149,MATH 2,A01,957937,Staff,33,0,35,2
1746612581176,MATH 197,001,957876,Kedlaya; Kiran S.,9993,0,9999,6
1746612582201,MCWP 40,A00,892729,Duru; Nur,10,0,20,10
1746612582201,MCWP 40,B00,893304,Montejo; Carolina,14,0,20,6
1746612583229,MCWP 40R,A00,893757,Redela; Pamela Morgan,0,5,20,20
1746612584256,MCWP 50,A00,893758,Morshed; Michael James,0,0,20,20
1746612584256,MCWP 50,B00,893761,Bartulis; Jason Michael,16,0,20,4
1746612585286,MCWP 50R,A00,893766,Compas; Sean Matthew,0,1,20,20
1746612585286,MCWP 50R,B00,893769,Carter; Jennifer A,0,1,20,20
1746612585286,MCWP 50R,C00,893771,Krone; Jarret,0,3,20,20
1746612585286,MCWP 50R,D00,893772,Miller; Elizabeth Deen,0,0,20,20
1746612585286,MCWP 50R,E00,893775,Carter; Andrea L,0,1,20,20
1746612586311,MMW 11R,A01,892721,Herbst; Matthew,14,0,30,16
1746612586311,MMW 11R,A02,892722,Herbst; Matthew,0,0,0,3
1746612587340,MMW 12R,A01,892724,Herbst; Matthew,0,11,16,16
1746612587340,MMW 12R,A02,892725,Herbst; Matthew,0,10,16,16
1746612588370,MMW 13R,A01,892727,Staff,0,4,16,16
1746612588370,MMW 13R,A02,892728,Staff,0,4,16,16
1746612588370,MMW 13R,A03,958032,Staff,0,4,16,16
1746612588370,MMW 13R,A04,958033,Staff,0,4,16,16
1746612588370,MMW 13R,A05,958034,Staff,0,4,16,16
1746612589395,SIO 295LS,A00,894015,Staff,5,0,25,20
1746612590420,SIO 295S,A00,894020,Staff,5,0,25,20
1746612591450,SIOC 290S,B01,958918,Merrifield; Mark A,14,0,30,16
1746612592479,SIOC 291S,B01,958922,Gabriel; Corey John,14,0,30,16
1746612593505,SOCI 117,A01,895339,Staff,2,0,5,3
1746612594530,WES 237B,A00,894149,Staff,11,0,20,9
1746612596639,AESE 279B,A00,891859,Staff,13,0,35,22
1746612597668,AIP 197,001,891854,Vespa; Emanuel Ignacio,9999,0,9999,0
1746612598698,ANTH 289S,A00,891856,Gagneux; Pascal,12,0,12,0
1746612599724,BENG 196,001,957946,Engler; Adam J.,9996,0,9999,3
1746612600751,BISP 197,001,959851,Wilhelm; James E.,9998,0,9999,1
1746612601776,CAT 124RS,A01,956906,Staff,6,0,25,19
1746612602801,CAT 125RS,A01,922013,Staff,6,0,25,19
1746612603828,CLRE 250,A00,891860,Morris; Sheldon,9995,0,9999,4
1746612605900,CLRE 251R,A00,907817,Mehta; Ravindra L.,9994,0,9999,5
1746612606928,CLRE 252,A00,891864,Cuomo; Raphael Eduardo,9993,0,9999,6
1746612607958,CLRE 253,A00,891867,Vaida; Florin,9994,0,9999,5
1746612607958,CLRE 253,B00,907819,Staff,9999,0,9999,0
1746612608984,CLRE 259,A00,891868,Patel; Hemal,9998,0,9999,1
1746612610012,CLRE 260,A00,891872,Cuomo; Raphael Eduardo,9999,0,9999,0
1746612611039,CLRE 297,001,891888,Cuomo; Raphael Eduardo,9999,0,9999,0
1746612612064,CSE 191,A00,958773,Minnes Kemp; Mor Mia,9995,0,9999,4
1746612613090,CSE 197,001,959846,Minnes Kemp; Mor Mia,9990,0,9999,9
1746612614115,CSS 201S,A01,892054,Mignozzetti; Umberto,25,0,30,5
1746612615142,CSS 202S,A01,892056,Mignozzetti; Umberto,25,0,30,5
1746612616168,DSC 197,001,956898,Eldridge; Justin Matthew,9996,0,9999,3
1746612617197,DSC 297,001,958000,Mazumdar; Arya,9998,0,9999,1
1746612617197,DSC 297,002,959862,Wang; Yusu,9998,0,9999,1
1746612618223,EAP 100,A00,905686,Staff,9778,0,9999,221
1746612619249,ECE 45,A01,892618,Staff,0,0,65,65
1746612621304,ECE 111,A01,892719,Staff,6,0,65,59
1746612622333,ECE 197,001,957920,Mercier; Patrick Philip,9991,0,9999,8
1746612623358,ECON 178,A01,907814,Zhu; Ying,26,0,35,9
1746612624386,EDS 115,A00,895312,Staff,35,0,45,10
1746612625413,EDS 117,A01,895337,Staff,23,0,30,7
1746612626441,EDS 125,A00,895341,Jones; Gabrielle Anastasia,36,0,45,9
1746612627466,EDS 128A,A01,895459,Fargason; Sharon Gayle,44,0,45,1
1746612628495,EDS 128B,A01,895543,Pappas; Elizabeth,44,0,45,1
1746612629523,EDS 139,A00,897203,Pappas; Elizabeth,44,0,45,1
1746612629523,EDS 139,B00,897209,Fargason; Sharon Gayle,41,0,45,4
1746612630548,EDS 201,A00,895545,Staff,22,0,45,23
1746612631573,EDS 203,A01,895581,Halter; Christopher P.,22,0,45,23
1746612632598,EDS 204R,A01,895625,Heinzman; Erica M.,39,0,45,6
1746612632598,EDS 204R,B01,895693,Halter; Christopher P.,10,0,45,35
1746612633626,EDS 206R,A00,895694,Fargason; Sharon Gayle,1,0,30,29
1746612633626,EDS 206R,B00,895695,Choi; Bailey Miyeon,16,0,30,14
1746612634652,EDS 250,A00,895697,Hemans; Patricia Ann Benitez,22,0,45,23
1746612635680,EDS 281,A00,895701,Meyerott; Theresa Ann,1,0,15,14
1746612636709,EDS 284,A00,895736,Meyerott; Theresa Ann,1,0,15,14
1746612637734,EDS 286,A00,897210,Fine; Sarah,0,0,15,15
1746612638761,EDS 289C,A01,895770,Daly; Alan J.,1,0,15,14
1746612639789,EDS 290,A00,897211,Hofstetter; Carolyn,0,0,15,15
1746612640817,LIGM 5A,A00,896162,Fischer-Grunski; Eva K,12,0,20,8
1746612641843,LIGM 5B,A00,896260,Fischer-Grunski; Eva K,17,0,20,3
1746612642868,LIGM 5C,A00,896308,Fischer-Grunski; Eva K,18,0,20,2
1746612643894,LIIT 5AS,A00,896313,Carnelos; Chiara,18,0,20,2
1746612644921,LIIT 5BS,A00,896416,Carnelos; Chiara,20,0,20,0
1746612645951,LIIT 5CS,A00,896564,Carnelos; Chiara,20,0,20,0
1746612646980,LISP 5A,A00,896588,Munoz Sanchez; Alicia,2,0,20,18
1746612648069,LISP 5B,A00,896653,Munoz Sanchez; Alicia,7,0,20,13
1746612649096,LISP 5C,A00,896655,Munoz Sanchez; Alicia,0,1,20,20
1746612650122,MAE 197,001,957918,Kleissl; Jan,9996,0,9999,3
1746612650122,MAE 197,002,959806,Boechler; Nicholas Sebastia,9998,0,9999,1
1746612650122,MAE 197,003,959852,Mullin; Jennifer S,9998,0,9999,1
1746612651148,MATH 2,A01,957937,Staff,33,0,35,2
1746612652178,MATH 197,001,957876,Kedlaya; Kiran S.,9993,0,9999,6
1746612653205,MCWP 40,A00,892729,Duru; Nur,10,0,20,10
1746612653205,MCWP 40,B00,893304,Montejo; Carolina,14,0,20,6
1746612654232,MCWP 40R,A00,893757,Redela; Pamela Morgan,0,5,20,20
1746612655257,MCWP 50,A00,893758,Morshed; Michael James,0,0,20,20
1746612655257,MCWP 50,B00,893761,Bartulis; Jason Michael,16,0,20,4
1746612656288,MCWP 50R,A00,893766,Compas; Sean Matthew,0,1,20,20
1746612656288,MCWP 50R,B00,893769,Carter; Jennifer A,0,1,20,20
1746612656288,MCWP 50R,C00,893771,Krone; Jarret,0,3,20,20
1746612656288,MCWP 50R,D00,893772,Miller; Elizabeth Deen,0,0,20,20
1746612656288,MCWP 50R,E00,893775,Carter; Andrea L,0,1,20,20
1746612657317,MMW 11R,A01,892721,Herbst; Matthew,14,0,30,16
1746612657317,MMW 11R,A02,892722,Herbst; Matthew,0,0,0,3
1746612658343,MMW 12R,A01,892724,Herbst; Matthew,0,11,16,16
1746612658343,MMW 12R,A02,892725,Herbst; Matthew,0,10,16,16
1746612659369,MMW 13R,A01,892727,Staff,0,4,16,16
1746612659369,MMW 13R,A02,892728,Staff,0,4,16,16
1746612659369,MMW 13R,A03,958032,Staff,0,4,16,16
1746612659369,MMW 13R,A04,958033,Staff,0,4,16,16
1746612659369,MMW 13R,A05,958034,Staff,0,4,16,16
1746612660397,SIO 295LS,A00,894015,Staff,5,0,25,20
1746612661426,SIO 295S,A00,894020,Staff,5,0,25,20
1746612662454,SIOC 290S,B01,958918,Merrifield; Mark A,14,0,30,16
1746612663486,SIOC 291S,B01,958922,Gabriel; Corey John,14,0,30,16
1746612664516,SOCI 117,A01,895339,Staff,2,0,5,3
1746612665541,WES 237B,A00,894149,Staff,11,0,20,9
1746612667604,AESE 279B,A00,891859,Staff,13,0,35,22
1746612668629,AIP 197,001,891854,Vespa; Emanuel Ignacio,9999,0,9999,0
1746612669654,ANTH 289S,A00,891856,Gagneux; Pascal,12,0,12,0
1746612670680,BENG 196,001,957946,Engler; Adam J.,9996,0,9999,3
1746612671708,BISP 197,001,959851,Wilhelm; James E.,9998,0,9999,1
1746612672737,CAT 124RS,A01,956906,Staff,6,0,25,19
1746612673763,CAT 125RS,A01,922013,Staff,6,0,25,19
1746612674790,CLRE 250,A00,891860,Morris; Sheldon,9995,0,9999,4
1746612676849,CLRE 251R,A00,907817,Mehta; Ravindra L.,9994,0,9999,5
1746612677873,CLRE 252,A00,891864,Cuomo; Raphael Eduardo,9993,0,9999,6
1746612678905,CLRE 253,A00,891867,Vaida; Florin,9994,0,9999,5
1746612678905,CLRE 253,B00,907819,Staff,9999,0,9999,0
1746612679932,CLRE 259,A00,891868,Patel; Hemal,9998,0,9999,1
1746612680956,CLRE 260,A00,891872,Cuomo; Raphael Eduardo,9999,0,9999,0
1746612681985,CLRE 297,001,891888,Cuomo; Raphael Eduardo,9999,0,9999,0
1746612683015,CSE 191,A00,958773,Minnes Kemp; Mor Mia,9995,0,9999,4
1746612684041,CSE 197,001,959846,Minnes Kemp; Mor Mia,9990,0,9999,9
1746612685068,CSS 201S,A01,892054,Mignozzetti; Umberto,25,0,30,5
1746612686098,CSS 202S,A01,892056,Mignozzetti; Umberto,25,0,30,5
1746612687123,DSC 197,001,956898,Eldridge; Justin Matthew,9996,0,9999,3
1746612688149,DSC 297,001,958000,Mazumdar; Arya,9998,0,9999,1
1746612688149,DSC 297,002,959862,Wang; Yusu,9998,0,9999,1
1746612689177,EAP 100,A00,905686,Staff,9778,0,9999,221
1746612690209,ECE 45,A01,892618,Staff,0,0,65,65
1746612692268,ECE 111,A01,892719,Staff,6,0,65,59
1746612693294,ECE 197,001,957920,Mercier; Patrick Philip,9991,0,9999,8
1746612694320,ECON 178,A01,907814,Zhu; Ying,26,0,35,9
1746612695345,EDS 115,A00,895312,Staff,35,0,45,10
1746612696374,EDS 117,A01,895337,Staff,23,0,30,7
1746612697401,EDS 125,A00,895341,Jones; Gabrielle Anastasia,36,0,45,9
1746612698427,EDS 128A,A01,895459,Fargason; Sharon Gayle,44,0,45,1
1746612699458,EDS 128B,A01,895543,Pappas; Elizabeth,44,0,45,1
1746612700487,EDS 139,A00,897203,Pappas; Elizabeth,44,0,45,1
1746612700487,EDS 139,B00,897209,Fargason; Sharon Gayle,41,0,45,4
1746612701514,EDS 201,A00,895545,Staff,22,0,45,23
1746612702541,EDS 203,A01,895581,Halter; Christopher P.,22,0,45,23
1746612703568,EDS 204R,A01,895625,Heinzman; Erica M.,39,0,45,6
1746612703568,EDS 204R,B01,895693,Halter; Christopher P.,10,0,45,35
1746612704596,EDS 206R,A00,895694,Fargason; Sharon Gayle,1,0,30,29
1746612704596,EDS 206R,B00,895695,Choi; Bailey Miyeon,16,0,30,14
1746612705623,EDS 250,A00,895697,Hemans; Patricia Ann Benitez,22,0,45,23
1746612706648,EDS 281,A00,895701,Meyerott; Theresa Ann,1,0,15,14
1746612707678,EDS 284,A00,895736,Meyerott; Theresa Ann,1,0,15,14
1746612708706,EDS 286,A00,897210,Fine; Sarah,0,0,15,15
1746612709733,EDS 289C,A01,895770,Daly; Alan J.,1,0,15,14
1746612710758,EDS 290,A00,897211,Hofstetter; Carolyn,0,0,15,15
1746612711789,LIGM 5A,A00,896162,Fischer-Grunski; Eva K,12,0,20,8
1746612712818,LIGM 5B,A00,896260,Fischer-Grunski; Eva K,17,0,20,3
1746612713847,LIGM 5C,A00,896308,Fischer-Grunski; Eva K,18,0,20,2
1746612714874,LIIT 5AS,A00,896313,Carnelos; Chiara,18,0,20,2
1746612715900,LIIT 5BS,A00,896416,Carnelos; Chiara,20,0,20,0
1746612716928,LIIT 5CS,A00,896564,Carnelos; Chiara,20,0,20,0
1746612717969,LISP 5A,A00,896588,Munoz Sanchez; Alicia,2,0,20,18
1746612718997,LISP 5B,A00,896653,Munoz Sanchez; Alicia,7,0,20,13
1746612720027,LISP 5C,A00,896655,Munoz Sanchez; Alicia,0,1,20,20
1746612721055,MAE 197,001,957918,Kleissl; Jan,9996,0,9999,3
1746612721055,MAE 197,002,959806,Boechler; Nicholas Sebastia,9998,0,9999,1
1746612721055,MAE 197,003,959852,Mullin; Jennifer S,9998,0,9999,1
1746612722081,MATH 2,A01,957937,Staff,33,0,35,2
1746612723106,MATH 197,001,957876,Kedlaya; Kiran S.,9993,0,9999,6
1746612724132,MCWP 40,A00,892729,Duru; Nur,10,0,20,10
1746612724132,MCWP 40,B00,893304,Montejo; Carolina,14,0,20,6
1746612725160,MCWP 40R,A00,893757,Redela; Pamela Morgan,0,5,20,20
1746612726184,MCWP 50,A00,893758,Morshed; Michael James,0,0,20,20
1746612726184,MCWP 50,B00,893761,Bartulis; Jason Michael,16,0,20,4
1746612727209,MCWP 50R,A00,893766,Compas; Sean Matthew,0,1,20,20
1746612727209,MCWP 50R,B00,893769,Carter; Jennifer A,0,1,20,20
1746612727209,MCWP 50R,C00,893771,Krone; Jarret,0,3,20,20
1746612727209,MCWP 50R,D00,893772,Miller; Elizabeth Deen,0,0,20,20
1746612727209,MCWP 50R,E00,893775,Carter; Andrea L,0,1,20,20
1746612728237,MMW 11R,A01,892721,Herbst; Matthew,14,0,30,16
1746612728237,MMW 11R,A02,892722,Herbst; Matthew,0,0,0,3
1746612729263,MMW 12R,A01,892724,Herbst; Matthew,0,11,16,16
1746612729263,MMW 12R,A02,892725,Herbst; Matthew,0,10,16,16
1746612730290,MMW 13R,A01,892727,Staff,0,4,16,16
1746612730290,MMW 13R,A02,892728,Staff,0,4,16,16
1746612730290,MMW 13R,A03,958032,Staff,0,4,16,16
1746612730290,MMW 13R,A04,958033,Staff,0,4,16,16
1746612730290,MMW 13R,A05,958034,Staff,0,4,16,16
1746612731317,SIO 295LS,A00,894015,Staff,5,0,25,20
1746612732344,SIO 295S,A00,894020,Staff,5,0,25,20
1746612733370,SIOC 290S,B01,958918,Merrifield; Mark A,14,0,30,16
1746612734401,SIOC 291S,B01,958922,Gabriel; Corey John,14,0,30,16
1746612735424,SOCI 117,A01,895339,Staff,2,0,5,3
1746612736450,WES 237B,A00,894149,Staff,11,0,20,9
1746612738512,AESE 279B,A00,891859,Staff,13,0,35,22
1746612739540,AIP 197,001,891854,Vespa; Emanuel Ignacio,9999,0,9999,0
1746612740564,ANTH 289S,A00,891856,Gagneux; Pascal,12,0,12,0
1746612741589,BENG 196,001,957946,Engler; Adam J.,9996,0,9999,3
1746612742614,BISP 197,001,959851,Wilhelm; James E.,9998,0,9999,1
1746612743643,CAT 124RS,A01,956906,Staff,6,0,25,19
1746612744690,CAT 125RS,A01,922013,Staff,6,0,25,19
1746612745716,CLRE 250,A00,891860,Morris; Sheldon,9995,0,9999,4
1746612747771,CLRE 251R,A00,907817,Mehta; Ravindra L.,9994,0,9999,5
1746612748796,CLRE 252,A00,891864,Cuomo; Raphael Eduardo,9993,0,9999,6
1746612749821,CLRE 253,A00,891867,Vaida; Florin,9994,0,9999,5
1746612749821,CLRE 253,B00,907819,Staff,9999,0,9999,0
1746612750845,CLRE 259,A00,891868,Patel; Hemal,9998,0,9999,1
1746612751871,CLRE 260,A00,891872,Cuomo; Raphael Eduardo,9999,0,9999,0
1746612752894,CLRE 297,001,891888,Cuomo; Raphael Eduardo,9999,0,9999,0
1746612753920,CSE 191,A00,958773,Minnes Kemp; Mor Mia,9995,0,9999,4
1746612754946,CSE 197,001,959846,Minnes Kemp; Mor Mia,9990,0,9999,9
1746612755973,CSS 201S,A01,892054,Mignozzetti; Umberto,25,0,30,5
1746612757000,CSS 202S,A01,892056,Mignozzetti; Umberto,25,0,30,5
1746612758025,DSC 197,001,956898,Eldridge; Justin Matthew,9996,0,9999,3
1746612759052,DSC 297,001,958000,Mazumdar; Arya,9998,0,9999,1
1746612759052,DSC 297,002,959862,Wang; Yusu,9998,0,9999,1
1746612760077,EAP 100,A00,905686,Staff,9778,0,9999,221
1746612761104,ECE 45,A01,892618,Staff,0,0,65,65
1746612763157,ECE 111,A01,892719,Staff,6,0,65,59
1746612764211,ECE 197,001,957920,Mercier; Patrick Philip,9991,0,9999,8
1746612765242,ECON 178,A01,907814,Zhu; Ying,26,0,35,9
1746612766269,EDS 115,A00,895312,Staff,35,0,45,10
1746612767297,EDS 117,A01,895337,Staff,23,0,30,7
1746612768325,EDS 125,A00,895341,Jones; Gabrielle Anastasia,36,0,45,9
1746612769350,EDS 128A,A01,895459,Fargason; Sharon Gayle,44,0,45,1
1746612770376,EDS 128B,A01,895543,Pappas; Elizabeth,44,0,45,1
1746612771406,EDS 139,A00,897203,Pappas; Elizabeth,44,0,45,1
1746612771406,EDS 139,B00,897209,Fargason; Sharon Gayle,41,0,45,4
1746612772430,EDS 201,A00,895545,Staff,22,0,45,23
1746612773455,EDS 203,A01,895581,Halter; Christopher P.,22,0,45,23
1746612774485,EDS 204R,A01,895625,Heinzman; Erica M.,39,0,45,6
1746612774485,EDS 204R,B01,895693,Halter; Christopher P.,10,0,45,35
1746612775510,EDS 206R,A00,895694,Fargason; Sharon Gayle,1,0,30,29
1746612775510,EDS 206R,B00,895695,Choi; Bailey Miyeon,16,0,30,14
1746612776535,EDS 250,A00,895697,Hemans; Patricia Ann Benitez,22,0,45,23
1746612777560,EDS 281,A00,895701,Meyerott; Theresa Ann,1,0,15,14
1746612778588,EDS 284,A00,895736,Meyerott; Theresa Ann,1,0,15,14
1746612779614,EDS 286,A00,897210,Fine; Sarah,0,0,15,15
1746612780638,EDS 289C,A01,895770,Daly; Alan J.,1,0,15,14
1746612781667,EDS 290,A00,897211,Hofstetter; Carolyn,0,0,15,15
1746612782697,LIGM 5A,A00,896162,Fischer-Grunski; Eva K,12,0,20,8
1746612783722,LIGM 5B,A00,896260,Fischer-Grunski; Eva K,17,0,20,3
1746612784751,LIGM 5C,A00,896308,Fischer-Grunski; Eva K,18,0,20,2
1746612785776,LIIT 5AS,A00,896313,Carnelos; Chiara,18,0,20,2
1746612786801,LIIT 5BS,A00,896416,Carnelos; Chiara,20,0,20,0
1746612787824,LIIT 5CS,A00,896564,Carnelos; Chiara,20,0,20,0
1746612788854,LISP 5A,A00,896588,Munoz Sanchez; Alicia,2,0,20,18
1746612789880,LISP 5B,A00,896653,Munoz Sanchez; Alicia,7,0,20,13
1746612790904,LISP 5C,A00,896655,Munoz Sanchez; Alicia,0,1,20,20
1746612791929,MAE 197,001,957918,Kleissl; Jan,9996,0,9999,3
1746612791929,MAE 197,002,959806,Boechler; Nicholas Sebastia,9998,0,9999,1
1746612791929,MAE 197,003,959852,Mullin; Jennifer S,9998,0,9999,1
1746612792957,MATH 2,A01,957937,Staff,33,0,35,2
1746612793982,MATH 197,001,957876,Kedlaya; Kiran S.,9993,0,9999,6
1746612795009,MCWP 40,A00,892729,Duru; Nur,10,0,20,10
1746612795009,MCWP 40,B00,893304,Montejo; Carolina,14,0,20,6
1746612796033,MCWP 40R,A00,893757,Redela; Pamela Morgan,0,5,20,20
1746612797058,MCWP 50,A00,893758,Morshed; Michael James,0,0,20,20
1746612797058,MCWP 50,B00,893761,Bartulis; Jason Michael,16,0,20,4
1746612798085,MCWP 50R,A00,893766,Compas; Sean Matthew,0,1,20,20
1746612798085,MCWP 50R,B00,893769,Carter; Jennifer A,0,1,20,20
1746612798085,MCWP 50R,C00,893771,Krone; Jarret,0,3,20,20
1746612798085,MCWP 50R,D00,893772,Miller; Elizabeth Deen,0,0,20,20
1746612798085,MCWP 50R,E00,893775,Carter; Andrea L,0,1,20,20
1746612799115,MMW 11R,A01,892721,Herbst; Matthew,14,0,30,16
1746612799115,MMW 11R,A02,892722,Herbst; Matthew,0,0,0,3
1746612800144,MMW 12R,A01,892724,Herbst; Matthew,0,11,16,16
1746612800144,MMW 12R,A02,892725,Herbst; Matthew,0,10,16,16
1746612801172,MMW 13R,A01,892727,Staff,0,4,16,16
1746612801172,MMW 13R,A02,892728,Staff,0,4,16,16
1746612801172,MMW 13R,A03,958032,Staff,0,4,16,16
1746612801172,MMW 13R,A04,958033,Staff,0,4,16,16
1746612801172,MMW 13R,A05,958034,Staff,0,4,16,16
1746612802201,SIO 295LS,A00,894015,Staff,5,0,25,20
1746612803227,SIO 295S,A00,894020,Staff,5,0,25,20
1746612804253,SIOC 290S,B01,958918,Merrifield; Mark A,14,0,30,16
1746612805284,SIOC 291S,B01,958922,Gabriel; Corey John,14,0,30,16
1746612806309,SOCI 117,A01,895339,Staff,2,0,5,3
1746612807333,WES 237B,A00,894149,Staff,11,0,20,9
1746612809397,AESE 279B,A00,891859,Staff,13,0,35,22
1746612810422,AIP 197,001,891854,Vespa; Emanuel Ignacio,9999,0,9999,0
1746612811446,ANTH 289S,A00,891856,Gagneux; Pascal,12,0,12,0
1746612812475,BENG 196,001,957946,Engler; Adam J.,9996,0,9999,3
1746612813505,BISP 197,001,959851,Wilhelm; James E.,9998,0,9999,1
1746612814533,CAT 124RS,A01,956906,Staff,6,0,25,19
1746612815561,CAT 125RS,A01,922013,Staff,6,0,25,19
1746612816586,CLRE 250,A00,891860,Morris; Sheldon,9995,0,9999,4
1746612818640,CLRE 251R,A00,907817,Mehta; Ravindra L.,9994,0,9999,5
1746612819666,CLRE 252,A00,891864,Cuomo; Raphael Eduardo,9993,0,9999,6
1746612820695,CLRE 253,A00,891867,Vaida; Florin,9994,0,9999,5
1746612820695,CLRE 253,B00,907819,Staff,9999,0,9999,0
1746612821722,CLRE 259,A00,891868,Patel; Hemal,9998,0,9999,1
1746612822747,CLRE 260,A00,891872,Cuomo; Raphael Eduardo,9999,0,9999,0
1746612823774,CLRE 297,001,891888,Cuomo; Raphael Eduardo,9999,0,9999,0
1746612824798,CSE 191,A00,958773,Minnes Kemp; Mor Mia,9995,0,9999,4
1746612825824,CSE 197,001,959846,Minnes Kemp; Mor Mia,9990,0,9999,9
1746612826852,CSS 201S,A01,892054,Mignozzetti; Umberto,25,0,30,5
1746612827879,CSS 202S,A01,892056,Mignozzetti; Umberto,25,0,30,5
1746612828907,DSC 197,001,956898,Eldridge; Justin Matthew,9996,0,9999,3
1746612829938,DSC 297,001,958000,Mazumdar; Arya,9998,0,9999,1
1746612829938,DSC 297,002,959862,Wang; Yusu,9998,0,9999,1
1746612830963,EAP 100,A00,905686,Staff,9778,0,9999,221
1746612831994,ECE 45,A01,892618,Staff,0,0,65,65
1746612834047,ECE 111,A01,892719,Staff,6,0,65,59
1746612835074,ECE 197,001,957920,Mercier; Patrick Philip,9991,0,9999,8
1746612836104,ECON 178,A01,907814,Zhu; Ying,26,0,35,9
1746612837131,EDS 115,A00,895312,Staff,35,0,45,10
1746612838158,EDS 117,A01,895337,Staff,23,0,30,7
1746612839185,EDS 125,A00,895341,Jones; Gabrielle Anastasia,36,0,45,9
1746612840210,EDS 128A,A01,895459,Fargason; Sharon Gayle,44,0,45,1
1746612841238,EDS 128B,A01,895543,Pappas; Elizabeth,44,0,45,1
1746612842265,EDS 139,A00,897203,Pappas; Elizabeth,44,0,45,1
1746612842265,EDS 139,B00,897209,Fargason; Sharon Gayle,41,0,45,4
1746612843292,EDS 201,A00,895545,Staff,22,0,45,23
1746612844321,EDS 203,A01,895581,Halter; Christopher P.,22,0,45,23
1746612845348,EDS 204R,A01,895625,Heinzman; Erica M.,39,0,45,6
1746612845348,EDS 204R,B01,895693,Halter; Christopher P.,10,0,45,35
1746612846379,EDS 206R,A00,895694,Fargason; Sharon Gayle,1,0,30,29
1746612846379,EDS 206R,B00,895695,Choi; Bailey Miyeon,16,0,30,14
1746612847409,EDS 250,A00,895697,Hemans; Patricia Ann Benitez,22,0,45,23
1746612848434,EDS 281,A00,895701,Meyerott; Theresa Ann,1,0,15,14
1746612849459,EDS 284,A00,895736,Meyerott; Theresa Ann,1,0,15,14
1746612850484,EDS 286,A00,897210,Fine; Sarah,0,0,15,15
1746612851512,EDS 289C,A01,895770,Daly; Alan J.,1,0,15,14
1746612852539,EDS 290,A00,897211,Hofstetter; Carolyn,0,0,15,15
1746612853569,LIGM 5A,A00,896162,Fischer-Grunski; Eva K,12,0,20,8
1746612854596,LIGM 5B,A00,896260,Fischer-Grunski; Eva K,17,0,20,3
1746612855627,LIGM 5C,A00,896308,Fischer-Grunski; Eva K,18,0,20,2
1746612856654,LIIT 5AS,A00,896313,Carnelos; Chiara,18,0,20,2
1746612857685,LIIT 5BS,A00,896416,Carnelos; Chiara,20,0,20,0
1746612858712,LIIT 5CS,A00,896564,Carnelos; Chiara,20,0,20,0
1746612859743,LISP 5A,A00,896588,Munoz Sanchez; Alicia,2,0,20,18
1746612860772,LISP 5B,A00,896653,Munoz Sanchez; Alicia,7,0,20,13
1746612861798,LISP 5C,A00,896655,Munoz Sanchez; Alicia,0,1,20,20
1746612862830,MAE 197,001,957918,Kleissl; Jan,9996,0,9999,3
1746612862830,MAE 197,002,959806,Boechler; Nicholas Sebastia,9998,0,9999,1
1746612862830,MAE 197,003,959852,Mullin; Jennifer S,9998,0,9999,1
1746612863862,MATH 2,A01,957937,Staff,33,0,35,2
1746612864888,MATH 197,001,957876,Kedlaya; Kiran S.,9993,0,9999,6
1746612865915,MCWP 40,A00,892729,Duru; Nur,10,0,20,10
1746612865915,MCWP 40,B00,893304,Montejo; Carolina,14,0,20,6
1746612866940,MCWP 40R,A00,893757,Redela; Pamela Morgan,0,5,20,20
1746612867967,MCWP 50,A00,893758,Morshed; Michael James,0,0,20,20
1746612867967,MCWP 50,B00,893761,Bartulis; Jason Michael,16,0,20,4
1746612869001,MCWP 50R,A00,893766,Compas; Sean Matthew,0,1,20,20
1746612869001,MCWP 50R,B00,893769,Carter; Jennifer A,0,1,20,20
1746612869001,MCWP 50R,C00,893771,Krone; Jarret,0,3,20,20
1746612869001,MCWP 50R,D00,893772,Miller; Elizabeth Deen,0,0,20,20
1746612869001,MCWP 50R,E00,893775,Carter; Andrea L,0,1,20,20
1746612870029,MMW 11R,A01,892721,Herbst; Matthew,14,0,30,16
1746612870029,MMW 11R,A02,892722,Herbst; Matthew,0,0,0,3
1746612871056,MMW 12R,A01,892724,Herbst; Matthew,0,11,16,16
1746612871056,MMW 12R,A02,892725,Herbst; Matthew,0,10,16,16
1746612872084,MMW 13R,A01,892727,Staff,0,4,16,16
1746612872084,MMW 13R,A02,892728,Staff,0,4,16,16
1746612872084,MMW 13R,A03,958032,Staff,0,4,16,16
1746612872084,MMW 13R,A04,958033,Staff,0,4,16,16
1746612872084,MMW 13R,A05,958034,Staff,0,4,16,16
1746612873112,SIO 295LS,A00,894015,Staff,5,0,25,20
1746612874138,SIO 295S,A00,894020,Staff,5,0,25,20
1746612875173,SIOC 290S,B01,958918,Merrifield; Mark A,14,0,30,16
1746612876206,SIOC 291S,B01,958922,Gabriel; Corey John,14,0,30,16
1746612877235,SOCI 117,A01,895339,Staff,2,0,5,3
1746612878264,WES 237B,A00,894149,Staff,11,0,20,9
1746612880334,AESE 279B,A00,891859,Staff,13,0,35,22
1746612881361,AIP 197,001,891854,Vespa; Emanuel Ignacio,9999,0,9999,0
1746612882390,ANTH 289S,A00,891856,Gagneux; Pascal,12,0,12,0
1746612883416,BENG 196,001,957946,Engler; Adam J.,9996,0,9999,3
1746612884443,BISP 197,001,959851,Wilhelm; James E.,9998,0,9999,1
1746612885470,CAT 124RS,A01,956906,Staff,6,0,25,19
1746612886498,CAT 125RS,A01,922013,Staff,6,0,25,19
1746612887526,CLRE 250,A00,891860,Morris; Sheldon,9995,0,9999,4
1746612889584,CLRE 251R,A00,907817,Mehta; Ravindra L.,9994,0,9999,5
1746612890614,CLRE 252,A00,891864,Cuomo; Raphael Eduardo,9993,0,9999,6
1746612891641,CLRE 253,A00,891867,Vaida; Florin,9994,0,9999,5
1746612891641,CLRE 253,B00,907819,Staff,9999,0,9999,0
1746612892673,CLRE 259,A00,891868,Patel; Hemal,9998,0,9999,1
1746612893705,CLRE 260,A00,891872,Cuomo; Raphael Eduardo,9999,0,9999,0
1746612894732,CLRE 297,001,891888,Cuomo; Raphael Eduardo,9999,0,9999,0
1746612895758,CSE 191,A00,958773,Minnes Kemp; Mor Mia,9995,0,9999,4
1746612896787,CSE 197,001,959846,Minnes Kemp; Mor Mia,9990,0,9999,9
1746612897819,CSS 201S,A01,892054,Mignozzetti; Umberto,25,0,30,5
1746612898847,CSS 202S,A01,892056,Mignozzetti; Umberto,25,0,30,5
1746612899873,DSC 197,001,956898,Eldridge; Justin Matthew,9996,0,9999,3
1746612900899,DSC 297,001,958000,Mazumdar; Arya,9998,0,9999,1
1746612900899,DSC 297,002,959862,Wang; Yusu,9998,0,9999,1
1746612901925,EAP 100,A00,905686,Staff,9778,0,9999,221
1746612902953,ECE 45,A01,892618,Staff,0,0,65,65
1746612905010,ECE 111,A01,892719,Staff,6,0,65,59
1746612906038,ECE 197,001,957920,Mercier; Patrick Philip,9991,0,9999,8
1746612907065,ECON 178,A01,907814,Zhu; Ying,26,0,35,9
1746612908091,EDS 115,A00,895312,Staff,35,0,45,10
1746612909118,EDS 117,A01,895337,Staff,23,0,30,7
1746612910146,EDS 125,A00,895341,Jones; Gabrielle Anastasia,36,0,45,9
1746612911179,EDS 128A,A01,895459,Fargason; Sharon Gayle,44,0,45,1
1746612912209,EDS 128B,A01,895543,Pappas; Elizabeth,44,0,45,1
1746612913235,EDS 139,A00,897203,Pappas; Elizabeth,44,0,45,1
1746612913235,EDS 139,B00,897209,Fargason; Sharon Gayle,41,0,45,4
1746612914264,EDS 201,A00,895545,Staff,22,0,45,23
1746612915295,EDS 203,A01,895581,Halter; Christopher P.,22,0,45,23
1746612916330,EDS 204R,A01,895625,Heinzman; Erica M.,39,0,45,6
1746612916330,EDS 204R,B01,895693,Halter; Christopher P.,10,0,45,35
1746612917358,EDS 206R,A00,895694,Fargason; Sharon Gayle,1,0,30,29
1746612917358,EDS 206R,B00,895695,Choi; Bailey Miyeon,16,0,30,14
1746612918384,EDS 250,A00,895697,Hemans; Patricia Ann Benitez,22,0,45,23
1746612919410,EDS 281,A00,895701,Meyerott; Theresa Ann,1,0,15,14
1746612920440,EDS 284,A00,895736,Meyerott; Theresa Ann,1,0,15,14
1746612921469,EDS 286,A00,897210,Fine; Sarah,0,0,15,15
1746612922499,EDS 289C,A01,895770,Daly; Alan J.,1,0,15,14
1746612923527,EDS 290,A00,897211,Hofstetter; Carolyn,0,0,15,15
1746612924559,LIGM 5A,A00,896162,Fischer-Grunski; Eva K,12,0,20,8
1746612925586,LIGM 5B,A00,896260,Fischer-Grunski; Eva K,17,0,20,3
1746612926610,LIGM 5C,A00,896308,Fischer-Grunski; Eva K,18,0,20,2
1746612927639,LIIT 5AS,A00,896313,Carnelos; Chiara,18,0,20,2
1746612928669,LIIT 5BS,A00,896416,Carnelos; Chiara,20,0,20,0
1746612929698,LIIT 5CS,A00,896564,Carnelos; Chiara,20,0,20,0
1746612930726,LISP 5A,A00,896588,Munoz Sanchez; Alicia,2,0,20,18
1746612931757,LISP 5B,A00,896653,Munoz Sanchez; Alicia,7,0,20,13
1746612932785,LISP 5C,A00,896655,Munoz Sanchez; Alicia,0,1,20,20
1746612933818,MAE 197,001,957918,Kleissl; Jan,9996,0,9999,3
1746612933818,MAE 197,002,959806,Boechler; Nicholas Sebastia,9998,0,9999,1
1746612933818,MAE 197,003,959852,Mullin; Jennifer S,9998,0,9999,1
1746612934848,MATH 2,A01,957937,Staff,33,0,35,2
1746612935876,MATH 197,001,957876,Kedlaya; Kiran S.,9993,0,9999,6
1746612936909,MCWP 40,A00,892729,Duru; Nur,10,0,20,10
1746612936909,MCWP 40,B00,893304,Montejo; Carolina,14,0,20,6
1746612937940,MCWP 40R,A00,893757,Redela; Pamela Morgan,0,5,20,20
1746612938969,MCWP 50,A00,893758,Morshed; Michael James,0,0,20,20
1746612938969,MCWP 50,B00,893761,Bartulis; Jason Michael,16,0,20,4
1746612940011,MCWP 50R,A00,893766,Compas; Sean Matthew,0,1,20,20
1746612940011,MCWP 50R,B00,893769,Carter; Jennifer A,0,1,20,20
1746612940011,MCWP 50R,C00,893771,Krone; Jarret,0,3,20,20
1746612940011,MCWP 50R,D00,893772,Miller; Elizabeth Deen,0,0,20,20
1746612940011,MCWP 50R,E00,893775,Carter; Andrea L,0,1,20,20
1746612941040,MMW 11R,A01,892721,Herbst; Matthew,14,0,30,16
1746612941040,MMW 11R,A02,892722,Herbst; Matthew,0,0,0,3
1746612942067,MMW 12R,A01,892724,Herbst; Matthew,0,11,16,16
1746612942067,MMW 12R,A02,892725,Herbst; Matthew,0,10,16,16
1746612943093,MMW 13R,A01,892727,Staff,0,4,16,16
1746612943093,MMW 13R,A02,892728,Staff,0,4,16,16
1746612943093,MMW 13R,A03,958032,Staff,0,4,16,16
1746612943093,MMW 13R,A04,958033,Staff,0,4,16,16
1746612943093,MMW 13R,A05,958034,Staff,0,4,16,16
1746612944120,SIO 295LS,A00,894015,Staff,5,0,25,20
1746612945144,SIO 295S,A00,894020,Staff,5,0,25,20
1746612946172,SIOC 290S,B01,958918,Merrifield; Mark A,14,0,30,16
1746612947202,SIOC 291S,B01,958922,Gabriel; Corey John,14,0,30,16
1746612948228,SOCI 117,A01,895339,Staff,2,0,5,3
1746612949255,WES 237B,A00,894149,Staff,11,0,20,9
1746612951339,AESE 279B,A00,891859,Staff,13,0,35,22
1746612952366,AIP 197,001,891854,Vespa; Emanuel Ignacio,9999,0,9999,0
1746612953394,ANTH 289S,A00,891856,Gagneux; Pascal,12,0,12,0
1746612954423,BENG 196,001,957946,Engler; Adam J.,9996,0,9999,3
1746612955451,BISP 197,001,959851,Wilhelm; James E.,9998,0,9999,1
1746612956477,CAT 124RS,A01,956906,Staff,6,0,25,19
1746612957504,CAT 125RS,A01,922013,Staff,6,0,25,19
1746612958530,CLRE 250,A00,891860,Morris; Sheldon,9995,0,9999,4
1746612960587,CLRE 251R,A00,907817,Mehta; Ravindra L.,9994,0,9999,5
1746612961612,CLRE 252,A00,891864,Cuomo; Raphael Eduardo,9993,0,9999,6
1746612962642,CLRE 253,A00,891867,Vaida; Florin,9994,0,9999,5
1746612962642,CLRE 253,B00,907819,Staff,9999,0,9999,0
1746612963668,CLRE 259,A00,891868,Patel; Hemal,9998,0,9999,1
1746612964695,CLRE 260,A00,891872,Cuomo; Raphael Eduardo,9999,0,9999,0
1746612965725,CLRE 297,001,891888,Cuomo; Raphael Eduardo,9999,0,9999,0
1746612966752,CSE 191,A00,958773,Minnes Kemp; Mor Mia,9995,0,9999,4
1746612967779,CSE 197,001,959846,Minnes Kemp; Mor Mia,9990,0,9999,9
1746612968813,CSS 201S,A01,892054,Mignozzetti; Umberto,25,0,30,5
1746612969838,CSS 202S,A01,892056,Mignozzetti; Umberto,25,0,30,5
1746612970864,DSC 197,001,956898,Eldridge; Justin Matthew,9996,0,9999,3
1746612971929,DSC 297,001,958000,Mazumdar; Arya,9998,0,9999,1
1746612971929,DSC 297,002,959862,Wang; Yusu,9998,0,9999,1
1746612972956,EAP 100,A00,905686,Staff,9778,0,9999,221
1746612973989,ECE 45,A01,892618,Staff,0,0,65,65
1746612976042,ECE 111,A01,892719,Staff,6,0,65,59
1746612977068,ECE 197,001,957920,Mercier; Patrick Philip,9991,0,9999,8
1746612978100,ECON 178,A01,907814,Zhu; Ying,26,0,35,9
1746612979127,EDS 115,A00,895312,Staff,35,0,45,10
1746612980153,EDS 117,A01,895337,Staff,23,0,30,7
1746612981179,EDS 125,A00,895341,Jones; Gabrielle Anastasia,36,0,45,9
1746612982209,EDS 128A,A01,895459,Fargason; Sharon Gayle,44,0,45,1
1746612983235,EDS 128B,A01,895543,Pappas; Elizabeth,44,0,45,1
1746612984264,EDS 139,A00,897203,Pappas; Elizabeth,44,0,45,1
1746612984264,EDS 139,B00,897209,Fargason; Sharon Gayle,41,0,45,4
1746612985294,EDS 201,A00,895545,Staff,22,0,45,23
1746612986322,EDS 203,A01,895581,Halter; Christopher P.,22,0,45,23
1746612987350,EDS 204R,A01,895625,Heinzman; Erica M.,39,0,45,6
1746612987350,EDS 204R,B01,895693,Halter; Christopher P.,10,0,45,35
1746612988375,EDS 206R,A00,895694,Fargason; Sharon Gayle,1,0,30,29
1746612988375,EDS 206R,B00,895695,Choi; Bailey Miyeon,16,0,30,14
1746612989402,EDS 250,A00,895697,Hemans; Patricia Ann Benitez,22,0,45,23
1746612990429,EDS 281,A00,895701,Meyerott; Theresa Ann,1,0,15,14
1746612991459,EDS 284,A00,895736,Meyerott; Theresa Ann,1,0,15,14
1746612992485,EDS 286,A00,897210,Fine; Sarah,0,0,15,15
1746612993513,EDS 289C,A01,895770,Daly; Alan J.,1,0,15,14
1746612994539,EDS 290,A00,897211,Hofstetter; Carolyn,0,0,15,15
1746612995564,LIGM 5A,A00,896162,Fischer-Grunski; Eva K,12,0,20,8
1746612996593,LIGM 5B,A00,896260,Fischer-Grunski; Eva K,17,0,20,3
1746612997618,LIGM 5C,A00,896308,Fischer-Grunski; Eva K,18,0,20,2
1746612998644,LIIT 5AS,A00,896313,Carnelos; Chiara,18,0,20,2
1746612999669,LIIT 5BS,A00,896416,Carnelos; Chiara,20,0,20,0
1746613000695,LIIT 5CS,A00,896564,Carnelos; Chiara,20,0,20,0
1746613001720,LISP 5A,A00,896588,Munoz Sanchez; Alicia,2,0,20,18
1746613002748,LISP 5B,A00,896653,Munoz Sanchez; Alicia,7,0,20,13
1746613003775,LISP 5C,A00,896655,Munoz Sanchez; Alicia,0,1,20,20
1746613004805,MAE 197,001,957918,Kleissl; Jan,9996,0,9999,3
1746613004805,MAE 197,002,959806,Boechler; Nicholas Sebastia,9998,0,9999,1
1746613004805,MAE 197,003,959852,Mullin; Jennifer S,9998,0,9999,1
1746613005833,MATH 2,A01,957937,Staff,33,0,35,2
1746613006862,MATH 197,001,957876,Kedlaya; Kiran S.,9993,0,9999,6
1746613007895,MCWP 40,A00,892729,Duru; Nur,10,0,20,10
1746613007895,MCWP 40,B00,893304,Montejo; Carolina,14,0,20,6
1746613008923,MCWP 40R,A00,893757,Redela; Pamela Morgan,0,5,20,20
1746613009951,MCWP 50,A00,893758,Morshed; Michael James,0,0,20,20
1746613009951,MCWP 50,B00,893761,Bartulis; Jason Michael,16,0,20,4
1746613010981,MCWP 50R,A00,893766,Compas; Sean Matthew,0,1,20,20
1746613010981,MCWP 50R,B00,893769,Carter; Jennifer A,0,1,20,20
1746613010981,MCWP 50R,C00,893771,Krone; Jarret,0,3,20,20
1746613010981,MCWP 50R,D00,893772,Miller; Elizabeth Deen,0,0,20,20
1746613010981,MCWP 50R,E00,893775,Carter; Andrea L,0,1,20,20
1746613012008,MMW 11R,A01,892721,Herbst; Matthew,14,0,30,16
1746613012008,MMW 11R,A02,892722,Herbst; Matthew,0,0,0,3
1746613013036,MMW 12R,A01,892724,Herbst; Matthew,0,11,16,16
1746613013036,MMW 12R,A02,892725,Herbst; Matthew,0,10,16,16
1746613014069,MMW 13R,A01,892727,Staff,0,4,16,16
1746613014069,MMW 13R,A02,892728,Staff,0,4,16,16
1746613014069,MMW 13R,A03,958032,Staff,0,4,16,16
1746613014069,MMW 13R,A04,958033,Staff,0,4,16,16
1746613014069,MMW 13R,A05,958034,Staff,0,4,16,16
1746613015096,SIO 295LS,A00,894015,Staff,5,0,25,20
1746613016123,SIO 295S,A00,894020,Staff,5,0,25,20
1746613017150,SIOC 290S,B01,958918,Merrifield; Mark A,14,0,30,16
1746613018177,SIOC 291S,B01,958922,Gabriel; Corey John,14,0,30,16
1746613019208,SOCI 117,A01,895339,Staff,2,0,5,3
1746613020242,WES 237B,A00,894149,Staff,11,0,20,9
1746613022321,AESE 279B,A00,891859,Staff,13,0,35,22
1746613023347,AIP 197,001,891854,Vespa; Emanuel Ignacio,9999,0,9999,0
1746613024372,ANTH 289S,A00,891856,Gagneux; Pascal,12,0,12,0
1746613025399,BENG 196,001,957946,Engler; Adam J.,9996,0,9999,3
1746613026424,BISP 197,001,959851,Wilhelm; James E.,9998,0,9999,1
1746613027448,CAT 124RS,A01,956906,Staff,6,0,25,19
1746613028473,CAT 125RS,A01,922013,Staff,6,0,25,19
1746613029502,CLRE 250,A00,891860,Morris; Sheldon,9995,0,9999,4
1746613031552,CLRE 251R,A00,907817,Mehta; Ravindra L.,9994,0,9999,5
1746613032583,CLRE 252,A00,891864,Cuomo; Raphael Eduardo,9993,0,9999,6
1746613033608,CLRE 253,A00,891867,Vaida; Florin,9994,0,9999,5
1746613033608,CLRE 253,B00,907819,Staff,9999,0,9999,0
1746613034638,CLRE 259,A00,891868,Patel; Hemal,9998,0,9999,1
1746613035667,CLRE 260,A00,891872,Cuomo; Raphael Eduardo,9999,0,9999,0
1746613036692,CLRE 297,001,891888,Cuomo; Raphael Eduardo,9999,0,9999,0
1746613037721,CSE 191,A00,958773,Minnes Kemp; Mor Mia,9995,0,9999,4
1746613038750,CSE 197,001,959846,Minnes Kemp; Mor Mia,9990,0,9999,9
1746613039778,CSS 201S,A01,892054,Mignozzetti; Umberto,25,0,30,5
1746613040809,CSS 202S,A01,892056,Mignozzetti; Umberto,25,0,30,5
1746613041836,DSC 197,001,956898,Eldridge; Justin Matthew,9996,0,9999,3
1746613042866,DSC 297,001,958000,Mazumdar; Arya,9998,0,9999,1
1746613042866,DSC 297,002,959862,Wang; Yusu,9998,0,9999,1
1746613043891,EAP 100,A00,905686,Staff,9778,0,9999,221
1746613044925,ECE 45,A01,892618,Staff,0,0,65,65
1746613046977,ECE 111,A01,892719,Staff,6,0,65,59
1746613048004,ECE 197,001,957920,Mercier; Patrick Philip,9991,0,9999,8
1746613049037,ECON 178,A01,907814,Zhu; Ying,26,0,35,9
1746613050067,EDS 115,A00,895312,Staff,35,0,45,10
1746613051097,EDS 117,A01,895337,Staff,23,0,30,7
1746613052126,EDS 125,A00,895341,Jones; Gabrielle Anastasia,36,0,45,9
1746613053156,EDS 128A,A01,895459,Fargason; Sharon Gayle,44,0,45,1
1746613054184,EDS 128B,A01,895543,Pappas; Elizabeth,44,0,45,1
1746613055213,EDS 139,A00,897203,Pappas; Elizabeth,44,0,45,1
1746613055213,EDS 139,B00,897209,Fargason; Sharon Gayle,41,0,45,4
1746613056238,EDS 201,A00,895545,Staff,22,0,45,23
1746613057263,EDS 203,A01,895581,Halter; Christopher P.,22,0,45,23
1746613058294,EDS 204R,A01,895625,Heinzman; Erica M.,39,0,45,6
1746613058294,EDS 204R,B01,895693,Halter; Christopher P.,10,0,45,35
1746613059319,EDS 206R,A00,895694,Fargason; Sharon Gayle,1,0,30,29
1746613059319,EDS 206R,B00,895695,Choi; Bailey Miyeon,16,0,30,14
1746613060347,EDS 250,A00,895697,Hemans; Patricia Ann Benitez,22,0,45,23
1746613061375,EDS 281,A00,895701,Meyerott; Theresa Ann,1,0,15,14
1746613062400,EDS 284,A00,895736,Meyerott; Theresa Ann,1,0,15,14
1746613063429,EDS 286,A00,897210,Fine; Sarah,0,0,15,15
1746613064456,EDS 289C,A01,895770,Daly; Alan J.,1,0,15,14
1746613065482,EDS 290,A00,897211,Hofstetter; Carolyn,0,0,15,15
1746613066508,LIGM 5A,A00,896162,Fischer-Grunski; Eva K,12,0,20,8
1746613067545,LIGM 5B,A00,896260,Fischer-Grunski; Eva K,17,0,20,3
1746613068572,LIGM 5C,A00,896308,Fischer-Grunski; Eva K,18,0,20,2
1746613069605,LIIT 5AS,A00,896313,Carnelos; Chiara,18,0,20,2
1746613070635,LIIT 5BS,A00,896416,Carnelos; Chiara,20,0,20,0
1746613071666,LIIT 5CS,A00,896564,Carnelos; Chiara,20,0,20,0
1746613072696,LISP 5A,A00,896588,Munoz Sanchez; Alicia,2,0,20,18
1746613073727,LISP 5B,A00,896653,Munoz Sanchez; Alicia,7,0,20,13
1746613074753,LISP 5C,A00,896655,Munoz Sanchez; Alicia,0,1,20,20
1746613075781,MAE 197,001,957918,Kleissl; Jan,9996,0,9999,3
1746613075781,MAE 197,002,959806,Boechler; Nicholas Sebastia,9998,0,9999,1
1746613075781,MAE 197,003,959852,Mullin; Jennifer S,9998,0,9999,1
1746613076810,MATH 2,A01,957937,Staff,33,0,35,2
1746613077841,MATH 197,001,957876,Kedlaya; Kiran S.,9993,0,9999,6
1746613078870,MCWP 40,A00,892729,Duru; Nur,10,0,20,10
1746613078870,MCWP 40,B00,893304,Montejo; Carolina,14,0,20,6
1746613079897,MCWP 40R,A00,893757,Redela; Pamela Morgan,0,5,20,20
1746613080930,MCWP 50,A00,893758,Morshed; Michael James,0,0,20,20
1746613080930,MCWP 50,B00,893761,Bartulis; Jason Michael,16,0,20,4
1746613081957,MCWP 50R,A00,893766,Compas; Sean Matthew,0,1,20,20
1746613081957,MCWP 50R,B00,893769,Carter; Jennifer A,0,1,20,20
1746613081957,MCWP 50R,C00,893771,Krone; Jarret,0,3,20,20
1746613081957,MCWP 50R,D00,893772,Miller; Elizabeth Deen,0,0,20,20
1746613081957,MCWP 50R,E00,893775,Carter; Andrea L,0,1,20,20
1746613082985,MMW 11R,A01,892721,Herbst; Matthew,14,0,30,16
1746613082985,MMW 11R,A02,892722,Herbst; Matthew,0,0,0,3
1746613084014,MMW 12R,A01,892724,Herbst; Matthew,0,11,16,16
1746613084014,MMW 12R,A02,892725,Herbst; Matthew,0,10,16,16
1746613085042,MMW 13R,A01,892727,Staff,0,4,16,16
1746613085042,MMW 13R,A02,892728,Staff,0,4,16,16
1746613085042,MMW 13R,A03,958032,Staff,0,4,16,16
1746613085042,MMW 13R,A04,958033,Staff,0,4,16,16
1746613085042,MMW 13R,A05,958034,Staff,0,4,16,16
1746613086068,SIO 295LS,A00,894015,Staff,5,0,25,20
1746613087095,SIO 295S,A00,894020,Staff,5,0,25,20
1746613088124,SIOC 290S,B01,958918,Merrifield; Mark A,14,0,30,16
1746613089155,SIOC 291S,B01,958922,Gabriel; Corey John,14,0,30,16
1746613090183,SOCI 117,A01,895339,Staff,2,0,5,3
1746613091210,WES 237B,A00,894149,Staff,11,0,20,9
1746613093286,AESE 279B,A00,891859,Staff,13,0,35,22
1746613094312,AIP 197,001,891854,Vespa; Emanuel Ignacio,9999,0,9999,0
1746613095339,ANTH 289S,A00,891856,Gagneux; Pascal,12,0,12,0
1746613096365,BENG 196,001,957946,Engler; Adam J.,9996,0,9999,3
1746613097391,BISP 197,001,959851,Wilhelm; James E.,9998,0,9999,1
1746613098417,CAT 124RS,A01,956906,Staff,6,0,25,19
1746613099445,CAT 125RS,A01,922013,Staff,6,0,25,19
1746613100475,CLRE 250,A00,891860,Morris; Sheldon,9995,0,9999,4
1746613102527,CLRE 251R,A00,907817,Mehta; Ravindra L.,9994,0,9999,5
1746613103552,CLRE 252,A00,891864,Cuomo; Raphael Eduardo,9993,0,9999,6
1746613104581,CLRE 253,A00,891867,Vaida; Florin,9994,0,9999,5
1746613104581,CLRE 253,B00,907819,Staff,9999,0,9999,0
1746613105612,CLRE 259,A00,891868,Patel; Hemal,9998,0,9999,1
1746613106639,CLRE 260,A00,891872,Cuomo; Raphael Eduardo,9999,0,9999,0
1746613107665,CLRE 297,001,891888,Cuomo; Raphael Eduardo,9999,0,9999,0
1746613108691,CSE 191,A00,958773,Minnes Kemp; Mor Mia,9995,0,9999,4
1746613109721,CSE 197,001,959846,Minnes Kemp; Mor Mia,9990,0,9999,9
1746613110748,CSS 201S,A01,892054,Mignozzetti; Umberto,25,0,30,5
1746613111776,CSS 202S,A01,892056,Mignozzetti; Umberto,25,0,30,5
1746613112807,DSC 197,001,956898,Eldridge; Justin Matthew,9996,0,9999,3
1746613113840,DSC 297,001,958000,Mazumdar; Arya,9998,0,9999,1
1746613113840,DSC 297,002,959862,Wang; Yusu,9998,0,9999,1
1746613114921,EAP 100,A00,905686,Staff,9778,0,9999,221
1746613115957,ECE 45,A01,892618,Staff,0,0,65,65
1746613118015,ECE 111,A01,892719,Staff,6,0,65,59
1746613119045,ECE 197,001,957920,Mercier; Patrick Philip,9991,0,9999,8
1746613120074,ECON 178,A01,907814,Zhu; Ying,26,0,35,9
1746613121101,EDS 115,A00,895312,Staff,35,0,45,10
1746613122131,EDS 117,A01,895337,Staff,23,0,30,7
1746613123159,EDS 125,A00,895341,Jones; Gabrielle Anastasia,36,0,45,9
1746613124187,EDS 128A,A01,895459,Fargason; Sharon Gayle,44,0,45,1
1746613125345,EDS 128B,A01,895543,Pappas; Elizabeth,44,0,45,1
1746613126371,EDS 139,A00,897203,Pappas; Elizabeth,44,0,45,1
1746613126371,EDS 139,B00,897209,Fargason; Sharon Gayle,41,0,45,4
1746613127398,EDS 201,A00,895545,Staff,22,0,45,23
1746613128427,EDS 203,A01,895581,Halter; Christopher P.,22,0,45,23
1746613129456,EDS 204R,A01,895625,Heinzman; Erica M.,39,0,45,6
1746613129456,EDS 204R,B01,895693,Halter; Christopher P.,10,0,45,35
1746613130485,EDS 206R,A00,895694,Fargason; Sharon Gayle,1,0,30,29
1746613130485,EDS 206R,B00,895695,Choi; Bailey Miyeon,16,0,30,14
1746613131516,EDS 250,A00,895697,Hemans; Patricia Ann Benitez,22,0,45,23
1746613132548,EDS 281,A00,895701,Meyerott; Theresa Ann,1,0,15,14
1746613133574,EDS 284,A00,895736,Meyerott; Theresa Ann,1,0,15,14
1746613134808,EDS 286,A00,897210,Fine; Sarah,0,0,15,15
1746613135838,EDS 289C,A01,895770,Daly; Alan J.,1,0,15,14
1746613136866,EDS 290,A00,897211,Hofstetter; Carolyn,0,0,15,15
1746613137892,LIGM 5A,A00,896162,Fischer-Grunski; Eva K,12,0,20,8
1746613138922,LIGM 5B,A00,896260,Fischer-Grunski; Eva K,17,0,20,3
1746613139953,LIGM 5C,A00,896308,Fischer-Grunski; Eva K,18,0,20,2
1746613140980,LIIT 5AS,A00,896313,Carnelos; Chiara,18,0,20,2
1746613142007,LIIT 5BS,A00,896416,Carnelos; Chiara,20,0,20,0
1746613143037,LIIT 5CS,A00,896564,Carnelos; Chiara,20,0,20,0
1746613144069,LISP 5A,A00,896588,Munoz Sanchez; Alicia,2,0,20,18
1746613145101,LISP 5B,A00,896653,Munoz Sanchez; Alicia,7,0,20,13
1746613146127,LISP 5C,A00,896655,Munoz Sanchez; Alicia,0,1,20,20
1746613147154,MAE 197,001,957918,Kleissl; Jan,9996,0,9999,3
1746613147154,MAE 197,002,959806,Boechler; Nicholas Sebastia,9998,0,9999,1
1746613147154,MAE 197,003,959852,Mullin; Jennifer S,9998,0,9999,1
1746613148179,MATH 2,A01,957937,Staff,33,0,35,2
1746613149207,MATH 197,001,957876,Kedlaya; Kiran S.,9993,0,9999,6
1746613150239,MCWP 40,A00,892729,Duru; Nur,10,0,20,10
1746613150239,MCWP 40,B00,893304,Montejo; Carolina,14,0,20,6
1746613151266,MCWP 40R,A00,893757,Redela; Pamela Morgan,0,5,20,20
1746613152298,MCWP 50,A00,893758,Morshed; Michael James,0,0,20,20
1746613152298,MCWP 50,B00,893761,Bartulis; Jason Michael,16,0,20,4
1746613153332,MCWP 50R,A00,893766,Compas; Sean Matthew,0,1,20,20
1746613153332,MCWP 50R,B00,893769,Carter; Jennifer A,0,1,20,20
1746613153332,MCWP 50R,C00,893771,Krone; Jarret,0,3,20,20
1746613153332,MCWP 50R,D00,893772,Miller; Elizabeth Deen,0,0,20,20
1746613153332,MCWP 50R,E00,893775,Carter; Andrea L,0,1,20,20
1746613154366,MMW 11R,A01,892721,Herbst; Matthew,14,0,30,16
1746613154366,MMW 11R,A02,892722,Herbst; Matthew,0,0,0,3
1746613155398,MMW 12R,A01,892724,Herbst; Matthew,0,11,16,16
1746613155398,MMW 12R,A02,892725,Herbst; Matthew,0,10,16,16
1746613156425,MMW 13R,A01,892727,Staff,0,4,16,16
1746613156425,MMW 13R,A02,892728,Staff,0,4,16,16
1746613156425,MMW 13R,A03,958032,Staff,0,4,16,16
1746613156425,MMW 13R,A04,958033,Staff,0,4,16,16
1746613156425,MMW 13R,A05,958034,Staff,0,4,16,16
1746613157457,SIO 295LS,A00,894015,Staff,5,0,25,20
1746613158481,SIO 295S,A00,894020,Staff,5,0,25,20
1746613159510,SIOC 290S,B01,958918,Merrifield; Mark A,14,0,30,16
1746613160537,SIOC 291S,B01,958922,Gabriel; Corey John,14,0,30,16
1746613161563,SOCI 117,A01,895339,Staff,2,0,5,3
1746613162594,WES 237B,A00,894149,Staff,11,0,20,9
1746613164731,AESE 279B,A00,891859,Staff,13,0,35,22
1746613165757,AIP 197,001,891854,Vespa; Emanuel Ignacio,9999,0,9999,0
1746613166787,ANTH 289S,A00,891856,Gagneux; Pascal,12,0,12,0
1746613167816,BENG 196,001,957946,Engler; Adam J.,9996,0,9999,3
1746613168845,BISP 197,001,959851,Wilhelm; James E.,9998,0,9999,1
1746613169873,CAT 124RS,A01,956906,Staff,6,0,25,19
1746613170898,CAT 125RS,A01,922013,Staff,6,0,25,19
1746613171928,CLRE 250,A00,891860,Morris; Sheldon,9995,0,9999,4
1746613173982,CLRE 251R,A00,907817,Mehta; Ravindra L.,9994,0,9999,5
1746613175006,CLRE 252,A00,891864,Cuomo; Raphael Eduardo,9993,0,9999,6
1746613176032,CLRE 253,A00,891867,Vaida; Florin,9994,0,9999,5
1746613176032,CLRE 253,B00,907819,Staff,9999,0,9999,0
1746613177062,CLRE 259,A00,891868,Patel; Hemal,9998,0,9999,1
1746613178087,CLRE 260,A00,891872,Cuomo; Raphael Eduardo,9999,0,9999,0
1746613179113,CLRE 297,001,891888,Cuomo; Raphael Eduardo,9999,0,9999,0
1746613180141,CSE 191,A00,958773,Minnes Kemp; Mor Mia,9995,0,9999,4
1746613181167,CSE 197,001,959846,Minnes Kemp; Mor Mia,9990,0,9999,9
1746613182195,CSS 201S,A01,892054,Mignozzetti; Umberto,25,0,30,5
1746613183225,CSS 202S,A01,892056,Mignozzetti; Umberto,25,0,30,5
1746613184253,DSC 197,001,956898,Eldridge; Justin Matthew,9996,0,9999,3
1746613185285,DSC 297,001,958000,Mazumdar; Arya,9998,0,9999,1
1746613185285,DSC 297,002,959862,Wang; Yusu,9998,0,9999,1
1746613186309,EAP 100,A00,905686,Staff,9778,0,9999,221
1746613187336,ECE 45,A01,892618,Staff,0,0,65,65
1746613189396,ECE 111,A01,892719,Staff,6,0,65,59
1746613190425,ECE 197,001,957920,Mercier; Patrick Philip,9991,0,9999,8
1746613191455,ECON 178,A01,907814,Zhu; Ying,26,0,35,9
1746613192481,EDS 115,A00,895312,Staff,35,0,45,10
1746613193508,EDS 117,A01,895337,Staff,23,0,30,7
1746613194540,EDS 125,A00,895341,Jones; Gabrielle Anastasia,36,0,45,9
1746613195572,EDS 128A,A01,895459,Fargason; Sharon Gayle,44,0,45,1
1746613196606,EDS 128B,A01,895543,Pappas; Elizabeth,44,0,45,1
1746613197637,EDS 139,A00,897203,Pappas; Elizabeth,44,0,45,1
1746613197637,EDS 139,B00,897209,Fargason; Sharon Gayle,41,0,45,4
1746613198663,EDS 201,A00,895545,Staff,22,0,45,23
1746613199690,EDS 203,A01,895581,Halter; Christopher P.,22,0,45,23
1746613200718,EDS 204R,A01,895625,Heinzman; Erica M.,39,0,45,6
1746613200718,EDS 204R,B01,895693,Halter; Christopher P.,10,0,45,35
1746613201745,EDS 206R,A00,895694,Fargason; Sharon Gayle,1,0,30,29
1746613201745,EDS 206R,B00,895695,Choi; Bailey Miyeon,16,0,30,14
1746613202777,EDS 250,A00,895697,Hemans; Patricia Ann Benitez,22,0,45,23
1746613203810,EDS 281,A00,895701,Meyerott; Theresa Ann,1,0,15,14
1746613204841,EDS 284,A00,895736,Meyerott; Theresa Ann,1,0,15,14
1746613205873,EDS 286,A00,897210,Fine; Sarah,0,0,15,15
1746613206902,EDS 289C,A01,895770,Daly; Alan J.,1,0,15,14
1746613207932,EDS 290,A00,897211,Hofstetter; Carolyn,0,0,15,15
1746613208969,LIGM 5A,A00,896162,Fischer-Grunski; Eva K,12,0,20,8
1746613209998,LIGM 5B,A00,896260,Fischer-Grunski; Eva K,17,0,20,3
1746613211024,LIGM 5C,A00,896308,Fischer-Grunski; Eva K,18,0,20,2
1746613212053,LIIT 5AS,A00,896313,Carnelos; Chiara,18,0,20,2
1746613213080,LIIT 5BS,A00,896416,Carnelos; Chiara,20,0,20,0
1746613214112,LIIT 5CS,A00,896564,Carnelos; Chiara,20,0,20,0
1746613215146,LISP 5A,A00,896588,Munoz Sanchez; Alicia,2,0,20,18
1746613216173,LISP 5B,A00,896653,Munoz Sanchez; Alicia,7,0,20,13
1746613217199,LISP 5C,A00,896655,Munoz Sanchez; Alicia,0,1,20,20
1746613218228,MAE 197,001,957918,Kleissl; Jan,9996,0,9999,3
1746613218228,MAE 197,002,959806,Boechler; Nicholas Sebastia,9998,0,9999,1
1746613218228,MAE 197,003,959852,Mullin; Jennifer S,9998,0,9999,1
1746613219257,MATH 2,A01,957937,Staff,33,0,35,2
1746613220290,MATH 197,001,957876,Kedlaya; Kiran S.,9993,0,9999,6
1746613221320,MCWP 40,A00,892729,Duru; Nur,10,0,20,10
1746613221320,MCWP 40,B00,893304,Montejo; Carolina,14,0,20,6
1746613222347,MCWP 40R,A00,893757,Redela; Pamela Morgan,0,5,20,20
1746613223375,MCWP 50,A00,893758,Morshed; Michael James,0,0,20,20
1746613223375,MCWP 50,B00,893761,Bartulis; Jason Michael,16,0,20,4
1746613224413,MCWP 50R,A00,893766,Compas; Sean Matthew,0,1,20,20
1746613224413,MCWP 50R,B00,893769,Carter; Jennifer A,0,1,20,20
1746613224413,MCWP 50R,C00,893771,Krone; Jarret,0,3,20,20
1746613224413,MCWP 50R,D00,893772,Miller; Elizabeth Deen,0,0,20,20
1746613224413,MCWP 50R,E00,893775,Carter; Andrea L,0,1,20,20
1746613225441,MMW 11R,A01,892721,Herbst; Matthew,14,0,30,16
1746613225441,MMW 11R,A02,892722,Herbst; Matthew,0,0,0,3
1746613226471,MMW 12R,A01,892724,Herbst; Matthew,0,11,16,16
1746613226471,MMW 12R,A02,892725,Herbst; Matthew,0,10,16,16
1746613227500,MMW 13R,A01,892727,Staff,0,4,16,16
1746613227500,MMW 13R,A02,892728,Staff,0,4,16,16
1746613227500,MMW 13R,A03,958032,Staff,0,4,16,16
1746613227500,MMW 13R,A04,958033,Staff,0,4,16,16
1746613227500,MMW 13R,A05,958034,Staff,0,4,16,16
1746613228528,SIO 295LS,A00,894015,Staff,5,0,25,20
1746613229556,SIO 295S,A00,894020,Staff,5,0,25,20
1746613230586,SIOC 290S,B01,958918,Merrifield; Mark A,14,0,30,16
1746613231621,SIOC 291S,B01,958922,Gabriel; Corey John,14,0,30,16
1746613232653,SOCI 117,A01,895339,Staff,2,0,5,3
1746613233683,WES 237B,A00,894149,Staff,11,0,20,9
1746613235761,AESE 279B,A00,891859,Staff,13,0,35,22
1746613236789,AIP 197,001,891854,Vespa; Emanuel Ignacio,9999,0,9999,0
1746613237821,ANTH 289S,A00,891856,Gagneux; Pascal,12,0,12,0
1746613238848,BENG 196,001,957946,Engler; Adam J.,9996,0,9999,3
1746613239878,BISP 197,001,959851,Wilhelm; James E.,9998,0,9999,1
1746613240906,CAT 124RS,A01,956906,Staff,6,0,25,19
1746613241934,CAT 125RS,A01,922013,Staff,6,0,25,19
1746613242968,CLRE 250,A00,891860,Morris; Sheldon,9995,0,9999,4
1746613245028,CLRE 251R,A00,907817,Mehta; Ravindra L.,9994,0,9999,5
1746613246061,CLRE 252,A00,891864,Cuomo; Raphael Eduardo,9993,0,9999,6
1746613247087,CLRE 253,A00,891867,Vaida; Florin,9994,0,9999,5
1746613247087,CLRE 253,B00,907819,Staff,9999,0,9999,0
1746613248115,CLRE 259,A00,891868,Patel; Hemal,9998,0,9999,1
1746613249142,CLRE 260,A00,891872,Cuomo; Raphael Eduardo,9999,0,9999,0
1746613250173,CLRE 297,001,891888,Cuomo; Raphael Eduardo,9999,0,9999,0
1746613251206,CSE 191,A00,958773,Minnes Kemp; Mor Mia,9995,0,9999,4
1746613252233,CSE 197,001,959846,Minnes Kemp; Mor Mia,9990,0,9999,9
1746613253262,CSS 201S,A01,892054,Mignozzetti; Umberto,25,0,30,5
1746613254295,CSS 202S,A01,892056,Mignozzetti; Umberto,25,0,30,5
1746613255323,DSC 197,001,956898,Eldridge; Justin Matthew,9996,0,9999,3
1746613256350,DSC 297,001,958000,Mazumdar; Arya,9998,0,9999,1
1746613256350,DSC 297,002,959862,Wang; Yusu,9998,0,9999,1
1746613257377,EAP 100,A00,905686,Staff,9778,0,9999,221
1746613258419,ECE 45,A01,892618,Staff,0,0,65,65
1746613260479,ECE 111,A01,892719,Staff,6,0,65,59
1746613261508,ECE 197,001,957920,Mercier; Patrick Philip,9991,0,9999,8
1746613262537,ECON 178,A01,907814,Zhu; Ying,26,0,35,9
1746613263566,EDS 115,A00,895312,Staff,35,0,45,10
1746613264592,EDS 117,A01,895337,Staff,23,0,30,7
1746613265623,EDS 125,A00,895341,Jones; Gabrielle Anastasia,36,0,45,9
1746613266656,EDS 128A,A01,895459,Fargason; Sharon Gayle,44,0,45,1
1746613267686,EDS 128B,A01,895543,Pappas; Elizabeth,44,0,45,1
1746613268713,EDS 139,A00,897203,Pappas; Elizabeth,44,0,45,1
1746613268713,EDS 139,B00,897209,Fargason; Sharon Gayle,41,0,45,4
1746613269739,EDS 201,A00,895545,Staff,22,0,45,23
1746613270772,EDS 203,A01,895581,Halter; Christopher P.,22,0,45,23
1746613271801,EDS 204R,A01,895625,Heinzman; Erica M.,39,0,45,6
1746613271801,EDS 204R,B01,895693,Halter; Christopher P.,10,0,45,35
1746613272829,EDS 206R,A00,895694,Fargason; Sharon Gayle,1,0,30,29
1746613272829,EDS 206R,B00,895695,Choi; Bailey Miyeon,16,0,30,14
1746613273857,EDS 250,A00,895697,Hemans; Patricia Ann Benitez,22,0,45,23
1746613274885,EDS 281,A00,895701,Meyerott; Theresa Ann,1,0,15,14
1746613275912,EDS 284,A00,895736,Meyerott; Theresa Ann,1,0,15,14
1746613276940,EDS 286,A00,897210,Fine; Sarah,0,0,15,15
1746613277973,EDS 289C,A01,895770,Daly; Alan J.,1,0,15,14
1746613279001,EDS 290,A00,897211,Hofstetter; Carolyn,0,0,15,15
1746613280029,LIGM 5A,A00,896162,Fischer-Grunski; Eva K,12,0,20,8
1746613281057,LIGM 5B,A00,896260,Fischer-Grunski; Eva K,17,0,20,3
1746613282084,LIGM 5C,A00,896308,Fischer-Grunski; Eva K,18,0,20,2
1746613283112,LIIT 5AS,A00,896313,Carnelos; Chiara,18,0,20,2
1746613284146,LIIT 5BS,A00,896416,Carnelos; Chiara,20,0,20,0
1746613285173,LIIT 5CS,A00,896564,Carnelos; Chiara,20,0,20,0
1746613286207,LISP 5A,A00,896588,Munoz Sanchez; Alicia,2,0,20,18
1746613287235,LISP 5B,A00,896653,Munoz Sanchez; Alicia,7,0,20,13
1746613288265,LISP 5C,A00,896655,Munoz Sanchez; Alicia,0,1,20,20
1746613289298,MAE 197,001,957918,Kleissl; Jan,9996,0,9999,3
1746613289298,MAE 197,002,959806,Boechler; Nicholas Sebastia,9998,0,9999,1
1746613289298,MAE 197,003,959852,Mullin; Jennifer S,9998,0,9999,1
1746613290325,MATH 2,A01,957937,Staff,33,0,35,2
1746613291356,MATH 197,001,957876,Kedlaya; Kiran S.,9993,0,9999,6
1746613292400,MCWP 40,A00,892729,Duru; Nur,10,0,20,10
1746613292400,MCWP 40,B00,893304,Montejo; Carolina,14,0,20,6
1746613293428,MCWP 40R,A00,893757,Redela; Pamela Morgan,0,5,20,20
1746613294454,MCWP 50,A00,893758,Morshed; Michael James,0,0,20,20
1746613294454,MCWP 50,B00,893761,Bartulis; Jason Michael,16,0,20,4
1746613295484,MCWP 50R,A00,893766,Compas; Sean Matthew,0,1,20,20
1746613295484,MCWP 50R,B00,893769,Carter; Jennifer A,0,1,20,20
1746613295484,MCWP 50R,C00,893771,Krone; Jarret,0,3,20,20
1746613295484,MCWP 50R,D00,893772,Miller; Elizabeth Deen,0,0,20,20
1746613295484,MCWP 50R,E00,893775,Carter; Andrea L,0,1,20,20
1746613296512,MMW 11R,A01,892721,Herbst; Matthew,14,0,30,16
1746613296512,MMW 11R,A02,892722,Herbst; Matthew,0,0,0,3
1746613297542,MMW 12R,A01,892724,Herbst; Matthew,0,11,16,16
1746613297542,MMW 12R,A02,892725,Herbst; Matthew,0,10,16,16
1746613298571,MMW 13R,A01,892727,Staff,0,4,16,16
1746613298571,MMW 13R,A02,892728,Staff,0,4,16,16
1746613298571,MMW 13R,A03,958032,Staff,0,4,16,16
1746613298571,MMW 13R,A04,958033,Staff,0,4,16,16
1746613298571,MMW 13R,A05,958034,Staff,0,4,16,16
1746613299599,SIO 295LS,A00,894015,Staff,5,0,25,20
1746613300629,SIO 295S,A00,894020,Staff,5,0,25,20
1746613301669,SIOC 290S,B01,958918,Merrifield; Mark A,14,0,30,16
1746613302698,SIOC 291S,B01,958922,Gabriel; Corey John,14,0,30,16
1746613303730,SOCI 117,A01,895339,Staff,2,0,5,3
1746613304757,WES 237B,A00,894149,Staff,11,0,20,9
1746613306855,AESE 279B,A00,891859,Staff,13,0,35,22
1746613307881,AIP 197,001,891854,Vespa; Emanuel Ignacio,9999,0,9999,0
1746613308916,ANTH 289S,A00,891856,Gagneux; Pascal,12,0,12,0
1746613309943,BENG 196,001,957946,Engler; Adam J.,9996,0,9999,3
1746613310969,BISP 197,001,959851,Wilhelm; James E.,9998,0,9999,1
1746613311999,CAT 124RS,A01,956906,Staff,6,0,25,19
1746613313026,CAT 125RS,A01,922013,Staff,6,0,25,19
1746613314052,CLRE 250,A00,891860,Morris; Sheldon,9995,0,9999,4
1746613316110,CLRE 251R,A00,907817,Mehta; Ravindra L.,9994,0,9999,5
1746613317137,CLRE 252,A00,891864,Cuomo; Raphael Eduardo,9993,0,9999,6
1746613318164,CLRE 253,A00,891867,Vaida; Florin,9994,0,9999,5
1746613318164,CLRE 253,B00,907819,Staff,9999,0,9999,0
1746613319189,CLRE 259,A00,891868,Patel; Hemal,9998,0,9999,1
1746613320217,CLRE 260,A00,891872,Cuomo; Raphael Eduardo,9999,0,9999,0
1746613321243,CLRE 297,001,891888,Cuomo; Raphael Eduardo,9999,0,9999,0
1746613322277,CSE 191,A00,958773,Minnes Kemp; Mor Mia,9995,0,9999,4
1746613323307,CSE 197,001,959846,Minnes Kemp; Mor Mia,9990,0,9999,9
1746613324332,CSS 201S,A01,892054,Mignozzetti; Umberto,25,0,30,5
1746613325359,CSS 202S,A01,892056,Mignozzetti; Umberto,25,0,30,5
1746613326388,DSC 197,001,956898,Eldridge; Justin Matthew,9996,0,9999,3
1746613327417,DSC 297,001,958000,Mazumdar; Arya,9998,0,9999,1
1746613327417,DSC 297,002,959862,Wang; Yusu,9998,0,9999,1
1746613328445,EAP 100,A00,905686,Staff,9778,0,9999,221
1746613329473,ECE 45,A01,892618,Staff,0,0,65,65
1746613331529,ECE 111,A01,892719,Staff,6,0,65,59
1746613332559,ECE 197,001,957920,Mercier; Patrick Philip,9991,0,9999,8
1746613333588,ECON 178,A01,907814,Zhu; Ying,26,0,35,9
1746613334613,EDS 115,A00,895312,Staff,35,0,45,10
1746613335643,EDS 117,A01,895337,Staff,23,0,30,7
1746613336674,EDS 125,A00,895341,Jones; Gabrielle Anastasia,36,0,45,9
1746613337702,EDS 128A,A01,895459,Fargason; Sharon Gayle,44,0,45,1
1746613338729,EDS 128B,A01,895543,Pappas; Elizabeth,44,0,45,1
1746613339763,EDS 139,A00,897203,Pappas; Elizabeth,44,0,45,1
1746613339763,EDS 139,B00,897209,Fargason; Sharon Gayle,41,0,45,4
1746613340790,EDS 201,A00,895545,Staff,22,0,45,23
1746613341818,EDS 203,A01,895581,Halter; Christopher P.,22,0,45,23
1746613342846,EDS 204R,A01,895625,Heinzman; Erica M.,39,0,45,6
1746613342846,EDS 204R,B01,895693,Halter; Christopher P.,10,0,45,35
1746613343877,EDS 206R,A00,895694,Fargason; Sharon Gayle,1,0,30,29
1746613343877,EDS 206R,B00,895695,Choi; Bailey Miyeon,16,0,30,14
1746613344905,EDS 250,A00,895697,Hemans; Patricia Ann Benitez,22,0,45,23
1746613345935,EDS 281,A00,895701,Meyerott; Theresa Ann,1,0,15,14
1746613346961,EDS 284,A00,895736,Meyerott; Theresa Ann,1,0,15,14
1746613347990,EDS 286,A00,897210,Fine; Sarah,0,0,15,15
1746613349023,EDS 289C,A01,895770,Daly; Alan J.,1,0,15,14
1746613350054,EDS 290,A00,897211,Hofstetter; Carolyn,0,0,15,15
1746613351082,LIGM 5A,A00,896162,Fischer-Grunski; Eva K,12,0,20,8
1746613352113,LIGM 5B,A00,896260,Fischer-Grunski; Eva K,17,0,20,3
1746613353141,LIGM 5C,A00,896308,Fischer-Grunski; Eva K,18,0,20,2
1746613354170,LIIT 5AS,A00,896313,Carnelos; Chiara,18,0,20,2
1746613355197,LIIT 5BS,A00,896416,Carnelos; Chiara,20,0,20,0
1746613356224,LIIT 5CS,A00,896564,Carnelos; Chiara,20,0,20,0
1746613357258,LISP 5A,A00,896588,Munoz Sanchez; Alicia,2,0,20,18
1746613358286,LISP 5B,A00,896653,Munoz Sanchez; Alicia,7,0,20,13
1746613359316,LISP 5C,A00,896655,Munoz Sanchez; Alicia,0,1,20,20
1746613360352,MAE 197,001,957918,Kleissl; Jan,9996,0,9999,3
1746613360352,MAE 197,002,959806,Boechler; Nicholas Sebastia,9998,0,9999,1
1746613360352,MAE 197,003,959852,Mullin; Jennifer S,9998,0,9999,1
1746613361379,MATH 2,A01,957937,Staff,33,0,35,2
1746613362414,MATH 197,001,957876,Kedlaya; Kiran S.,9993,0,9999,6
1746613363446,MCWP 40,A00,892729,Duru; Nur,10,0,20,10
1746613363446,MCWP 40,B00,893304,Montejo; Carolina,14,0,20,6
1746613364474,MCWP 40R,A00,893757,Redela; Pamela Morgan,0,5,20,20
1746613365501,MCWP 50,A00,893758,Morshed; Michael James,0,0,20,20
1746613365501,MCWP 50,B00,893761,Bartulis; Jason Michael,16,0,20,4
1746613366530,MCWP 50R,A00,893766,Compas; Sean Matthew,0,1,20,20
1746613366530,MCWP 50R,B00,893769,Carter; Jennifer A,0,1,20,20
1746613366530,MCWP 50R,C00,893771,Krone; Jarret,0,3,20,20
1746613366530,MCWP 50R,D00,893772,Miller; Elizabeth Deen,0,0,20,20
1746613366530,MCWP 50R,E00,893775,Carter; Andrea L,0,1,20,20
1746613367564,MMW 11R,A01,892721,Herbst; Matthew,14,0,30,16
1746613367564,MMW 11R,A02,892722,Herbst; Matthew,0,0,0,3
1746613368595,MMW 12R,A01,892724,Herbst; Matthew,0,11,16,16
1746613368595,MMW 12R,A02,892725,Herbst; Matthew,0,10,16,16
1746613369621,MMW 13R,A01,892727,Staff,0,4,16,16
1746613369621,MMW 13R,A02,892728,Staff,0,4,16,16
1746613369621,MMW 13R,A03,958032,Staff,0,4,16,16
1746613369621,MMW 13R,A04,958033,Staff,0,4,16,16
1746613369621,MMW 13R,A05,958034,Staff,0,4,16,16
1746613370650,SIO 295LS,A00,894015,Staff,5,0,25,20
1746613371678,SIO 295S,A00,894020,Staff,5,0,25,20
1746613372705,SIOC 290S,B01,958918,Merrifield; Mark A,14,0,30,16
1746613373735,SIOC 291S,B01,958922,Gabriel; Corey John,14,0,30,16
1746613374761,SOCI 117,A01,895339,Staff,2,0,5,3
1746613375793,WES 237B,A00,894149,Staff,11,0,20,9
1746613377872,AESE 279B,A00,891859,Staff,13,0,35,22
1746613378898,AIP 197,001,891854,Vespa; Emanuel Ignacio,9999,0,9999,0
1746613379926,ANTH 289S,A00,891856,Gagneux; Pascal,12,0,12,0
1746613380951,BENG 196,001,957946,Engler; Adam J.,9996,0,9999,3
1746613381977,BISP 197,001,959851,Wilhelm; James E.,9998,0,9999,1
1746613383004,CAT 124RS,A01,956906,Staff,6,0,25,19
1746613384031,CAT 125RS,A01,922013,Staff,6,0,25,19
1746613385063,CLRE 250,A00,891860,Morris; Sheldon,9995,0,9999,4
1746613387117,CLRE 251R,A00,907817,Mehta; Ravindra L.,9994,0,9999,5
1746613388144,CLRE 252,A00,891864,Cuomo; Raphael Eduardo,9993,0,9999,6
1746613389171,CLRE 253,A00,891867,Vaida; Florin,9994,0,9999,5
1746613389171,CLRE 253,B00,907819,Staff,9999,0,9999,0
1746613390205,CLRE 259,A00,891868,Patel; Hemal,9998,0,9999,1
1746613391233,CLRE 260,A00,891872,Cuomo; Raphael Eduardo,9999,0,9999,0
1746613392260,CLRE 297,001,891888,Cuomo; Raphael Eduardo,9999,0,9999,0
1746613393291,CSE 191,A00,958773,Minnes Kemp; Mor Mia,9995,0,9999,4
1746613394322,CSE 197,001,959846,Minnes Kemp; Mor Mia,9990,0,9999,9
1746613395350,CSS 201S,A01,892054,Mignozzetti; Umberto,25,0,30,5
1746613396383,CSS 202S,A01,892056,Mignozzetti; Umberto,25,0,30,5
1746613397410,DSC 197,001,956898,Eldridge; Justin Matthew,9996,0,9999,3
1746613398437,DSC 297,001,958000,Mazumdar; Arya,9998,0,9999,1
1746613398437,DSC 297,002,959862,Wang; Yusu,9998,0,9999,1
1746613399466,EAP 100,A00,905686,Staff,9778,0,9999,221
1746613400496,ECE 45,A01,892618,Staff,0,0,65,65
1746613402549,ECE 111,A01,892719,Staff,6,0,65,59
1746613403579,ECE 197,001,957920,Mercier; Patrick Philip,9991,0,9999,8
1746613404671,ECON 178,A01,907814,Zhu; Ying,26,0,35,9
1746613405699,EDS 115,A00,895312,Staff,35,0,45,10
1746613406726,EDS 117,A01,895337,Staff,23,0,30,7
1746613407754,EDS 125,A00,895341,Jones; Gabrielle Anastasia,36,0,45,9
1746613408781,EDS 128A,A01,895459,Fargason; Sharon Gayle,44,0,45,1
1746613409810,EDS 128B,A01,895543,Pappas; Elizabeth,44,0,45,1
1746613410837,EDS 139,A00,897203,Pappas; Elizabeth,44,0,45,1
1746613410837,EDS 139,B00,897209,Fargason; Sharon Gayle,41,0,45,4
1746613411864,EDS 201,A00,895545,Staff,22,0,45,23
1746613412891,EDS 203,A01,895581,Halter; Christopher P.,22,0,45,23
1746613413917,EDS 204R,A01,895625,Heinzman; Erica M.,39,0,45,6
1746613413917,EDS 204R,B01,895693,Halter; Christopher P.,10,0,45,35
1746613414943,EDS 206R,A00,895694,Fargason; Sharon Gayle,1,0,30,29
1746613414943,EDS 206R,B00,895695,Choi; Bailey Miyeon,16,0,30,14
1746613415975,EDS 250,A00,895697,Hemans; Patricia Ann Benitez,22,0,45,23
1746613417004,EDS 281,A00,895701,Meyerott; Theresa Ann,1,0,15,14
1746613418028,EDS 284,A00,895736,Meyerott; Theresa Ann,1,0,15,14
1746613419055,EDS 286,A00,897210,Fine; Sarah,0,0,15,15
1746613420086,EDS 289C,A01,895770,Daly; Alan J.,1,0,15,14
1746613421115,EDS 290,A00,897211,Hofstetter; Carolyn,0,0,15,15
1746613422144,LIGM 5A,A00,896162,Fischer-Grunski; Eva K,12,0,20,8
1746613423172,LIGM 5B,A00,896260,Fischer-Grunski; Eva K,17,0,20,3
1746613424203,LIGM 5C,A00,896308,Fischer-Grunski; Eva K,18,0,20,2
1746613425232,LIIT 5AS,A00,896313,Carnelos; Chiara,18,0,20,2
1746613426259,LIIT 5BS,A00,896416,Carnelos; Chiara,20,0,20,0
1746613427286,LIIT 5CS,A00,896564,Carnelos; Chiara,20,0,20,0
1746613428317,LISP 5A,A00,896588,Munoz Sanchez; Alicia,2,0,20,18
1746613429344,LISP 5B,A00,896653,Munoz Sanchez; Alicia,7,0,20,13
1746613430371,LISP 5C,A00,896655,Munoz Sanchez; Alicia,0,1,20,20
1746613431400,MAE 197,001,957918,Kleissl; Jan,9996,0,9999,3
1746613431400,MAE 197,002,959806,Boechler; Nicholas Sebastia,9998,0,9999,1
1746613431400,MAE 197,003,959852,Mullin; Jennifer S,9998,0,9999,1
1746613432426,MATH 2,A01,957937,Staff,33,0,35,2
1746613433456,MATH 197,001,957876,Kedlaya; Kiran S.,9993,0,9999,6
1746613434484,MCWP 40,A00,892729,Duru; Nur,10,0,20,10
1746613434484,MCWP 40,B00,893304,Montejo; Carolina,14,0,20,6
1746613435515,MCWP 40R,A00,893757,Redela; Pamela Morgan,0,5,20,20
1746613436545,MCWP 50,A00,893758,Morshed; Michael James,0,0,20,20
1746613436545,MCWP 50,B00,893761,Bartulis; Jason Michael,16,0,20,4
1746613437580,MCWP 50R,A00,893766,Compas; Sean Matthew,0,1,20,20
1746613437580,MCWP 50R,B00,893769,Carter; Jennifer A,0,1,20,20
1746613437580,MCWP 50R,C00,893771,Krone; Jarret,0,3,20,20
1746613437580,MCWP 50R,D00,893772,Miller; Elizabeth Deen,0,0,20,20
1746613437580,MCWP 50R,E00,893775,Carter; Andrea L,0,1,20,20
1746613438612,MMW 11R,A01,892721,Herbst; Matthew,14,0,30,16
1746613438612,MMW 11R,A02,892722,Herbst; Matthew,0,0,0,3
1746613439639,MMW 12R,A01,892724,Herbst; Matthew,0,11,16,16
1746613439639,MMW 12R,A02,892725,Herbst; Matthew,0,10,16,16
1746613440667,MMW 13R,A01,892727,Staff,0,4,16,16
1746613440667,MMW 13R,A02,892728,Staff,0,4,16,16
1746613440667,MMW 13R,A03,958032,Staff,0,4,16,16
1746613440667,MMW 13R,A04,958033,Staff,0,4,16,16
1746613440667,MMW 13R,A05,958034,Staff,0,4,16,16
1746613441695,SIO 295LS,A00,894015,Staff,5,0,25,20
1746613442726,SIO 295S,A00,894020,Staff,5,0,25,20
1746613443754,SIOC 290S,B01,958918,Merrifield; Mark A,14,0,30,16
1746613444796,SIOC 291S,B01,958922,Gabriel; Corey John,14,0,30,16
1746613445823,SOCI 117,A01,895339,Staff,2,0,5,3
1746613446851,WES 237B,A00,894149,Staff,11,0,20,9
1746613448932,AESE 279B,A00,891859,Staff,13,0,35,22
1746613449964,AIP 197,001,891854,Vespa; Emanuel Ignacio,9999,0,9999,0
1746613450990,ANTH 289S,A00,891856,Gagneux; Pascal,12,0,12,0
1746613452019,BENG 196,001,957946,Engler; Adam J.,9996,0,9999,3
1746613453046,BISP 197,001,959851,Wilhelm; James E.,9998,0,9999,1
1746613454075,CAT 124RS,A01,956906,Staff,6,0,25,19
1746613455106,CAT 125RS,A01,922013,Staff,6,0,25,19
1746613456131,CLRE 250,A00,891860,Morris; Sheldon,9995,0,9999,4
1746613458193,CLRE 251R,A00,907817,Mehta; Ravindra L.,9994,0,9999,5
1746613459220,CLRE 252,A00,891864,Cuomo; Raphael Eduardo,9993,0,9999,6
1746613460248,CLRE 253,A00,891867,Vaida; Florin,9994,0,9999,5
1746613460248,CLRE 253,B00,907819,Staff,9999,0,9999,0
1746613461275,CLRE 259,A00,891868,Patel; Hemal,9998,0,9999,1
1746613462298,CLRE 260,A00,891872,Cuomo; Raphael Eduardo,9999,0,9999,0
1746613463327,CLRE 297,001,891888,Cuomo; Raphael Eduardo,9999,0,9999,0
1746613464359,CSE 191,A00,958773,Minnes Kemp; Mor Mia,9995,0,9999,4
1746613465384,CSE 197,001,959846,Minnes Kemp; Mor Mia,9990,0,9999,9
1746613466411,CSS 201S,A01,892054,Mignozzetti; Umberto,25,0,30,5
1746613467436,CSS 202S,A01,892056,Mignozzetti; Umberto,25,0,30,5
1746613468463,DSC 197,001,956898,Eldridge; Justin Matthew,9996,0,9999,3
1746613469491,DSC 297,001,958000,Mazumdar; Arya,9998,0,9999,1
1746613469491,DSC 297,002,959862,Wang; Yusu,9998,0,9999,1
1746613470516,EAP 100,A00,905686,Staff,9778,0,9999,221
1746613471546,ECE 45,A01,892618,Staff,0,0,65,65
1746613473603,ECE 111,A01,892719,Staff,6,0,65,59
1746613474630,ECE 197,001,957920,Mercier; Patrick Philip,9991,0,9999,8
1746613475657,ECON 178,A01,907814,Zhu; Ying,26,0,35,9
1746613476686,EDS 115,A00,895312,Staff,35,0,45,10
1746613477714,EDS 117,A01,895337,Staff,23,0,30,7
1746613478742,EDS 125,A00,895341,Jones; Gabrielle Anastasia,36,0,45,9
1746613479774,EDS 128A,A01,895459,Fargason; Sharon Gayle,44,0,45,1
1746613480804,EDS 128B,A01,895543,Pappas; Elizabeth,44,0,45,1
1746613481829,EDS 139,A00,897203,Pappas; Elizabeth,44,0,45,1
1746613481829,EDS 139,B00,897209,Fargason; Sharon Gayle,41,0,45,4
1746613482855,EDS 201,A00,895545,Staff,22,0,45,23
1746613483884,EDS 203,A01,895581,Halter; Christopher P.,22,0,45,23
1746613484910,EDS 204R,A01,895625,Heinzman; Erica M.,39,0,45,6
1746613484910,EDS 204R,B01,895693,Halter; Christopher P.,10,0,45,35
1746613485938,EDS 206R,A00,895694,Fargason; Sharon Gayle,1,0,30,29
1746613485938,EDS 206R,B00,895695,Choi; Bailey Miyeon,16,0,30,14
1746613486966,EDS 250,A00,895697,Hemans; Patricia Ann Benitez,22,0,45,23
1746613487994,EDS 281,A00,895701,Meyerott; Theresa Ann,1,0,15,14
1746613489023,EDS 284,A00,895736,Meyerott; Theresa Ann,1,0,15,14
1746613490051,EDS 286,A00,897210,Fine; Sarah,0,0,15,15
1746613491078,EDS 289C,A01,895770,Daly; Alan J.,1,0,15,14
1746613492108,EDS 290,A00,897211,Hofstetter; Carolyn,0,0,15,15
1746613493135,LIGM 5A,A00,896162,Fischer-Grunski; Eva K,12,0,20,8
1746613494167,LIGM 5B,A00,896260,Fischer-Grunski; Eva K,17,0,20,3
1746613495195,LIGM 5C,A00,896308,Fischer-Grunski; Eva K,18,0,20,2
1746613496219,LIIT 5AS,A00,896313,Carnelos; Chiara,18,0,20,2
1746613497246,LIIT 5BS,A00,896416,Carnelos; Chiara,20,0,20,0
1746613498273,LIIT 5CS,A00,896564,Carnelos; Chiara,20,0,20,0
1746613499302,LISP 5A,A00,896588,Munoz Sanchez; Alicia,2,0,20,18
1746613500330,LISP 5B,A00,896653,Munoz Sanchez; Alicia,7,0,20,13
1746613501360,LISP 5C,A00,896655,Munoz Sanchez; Alicia,0,1,20,20
1746613502393,MAE 197,001,957918,Kleissl; Jan,9996,0,9999,3
1746613502393,MAE 197,002,959806,Boechler; Nicholas Sebastia,9998,0,9999,1
1746613502393,MAE 197,003,959852,Mullin; Jennifer S,9998,0,9999,1
1746613503424,MATH 2,A01,957937,Staff,33,0,35,2
1746613504450,MATH 197,001,957876,Kedlaya; Kiran S.,9993,0,9999,6
1746613505476,MCWP 40,A00,892729,Duru; Nur,10,0,20,10
1746613505476,MCWP 40,B00,893304,Montejo; Carolina,14,0,20,6
1746613506503,MCWP 40R,A00,893757,Redela; Pamela Morgan,0,5,20,20
1746613507534,MCWP 50,A00,893758,Morshed; Michael James,0,0,20,20
1746613507534,MCWP 50,B00,893761,Bartulis; Jason Michael,16,0,20,4
1746613508567,MCWP 50R,A00,893766,Compas; Sean Matthew,0,1,20,20
1746613508567,MCWP 50R,B00,893769,Carter; Jennifer A,0,1,20,20
1746613508567,MCWP 50R,C00,893771,Krone; Jarret,0,3,20,20
1746613508567,MCWP 50R,D00,893772,Miller; Elizabeth Deen,0,0,20,20
1746613508567,MCWP 50R,E00,893775,Carter; Andrea L,0,1,20,20
1746613509596,MMW 11R,A01,892721,Herbst; Matthew,14,0,30,16
1746613509596,MMW 11R,A02,892722,Herbst; Matthew,0,0,0,3
1746613510622,MMW 12R,A01,892724,Herbst; Matthew,0,11,16,16
1746613510622,MMW 12R,A02,892725,Herbst; Matthew,0,10,16,16
1746613511652,MMW 13R,A01,892727,Staff,0,4,16,16
1746613511652,MMW 13R,A02,892728,Staff,0,4,16,16
1746613511652,MMW 13R,A03,958032,Staff,0,4,16,16
1746613511652,MMW 13R,A04,958033,Staff,0,4,16,16
1746613511652,MMW 13R,A05,958034,Staff,0,4,16,16
1746613512678,SIO 295LS,A00,894015,Staff,5,0,25,20
1746613513705,SIO 295S,A00,894020,Staff,5,0,25,20
1746613514738,SIOC 290S,B01,958918,Merrifield; Mark A,14,0,30,16
1746613515771,SIOC 291S,B01,958922,Gabriel; Corey John,14,0,30,16
1746613516798,SOCI 117,A01,895339,Staff,2,0,5,3
1746613517827,WES 237B,A00,894149,Staff,11,0,20,9
1746613519919,AESE 279B,A00,891859,Staff,13,0,35,22
1746613520947,AIP 197,001,891854,Vespa; Emanuel Ignacio,9999,0,9999,0
1746613521973,ANTH 289S,A00,891856,Gagneux; Pascal,12,0,12,0
1746613523004,BENG 196,001,957946,Engler; Adam J.,9996,0,9999,3
1746613524030,BISP 197,001,959851,Wilhelm; James E.,9998,0,9999,1
1746613525060,CAT 124RS,A01,956906,Staff,6,0,25,19
1746613526091,CAT 125RS,A01,922013,Staff,6,0,25,19
1746613527120,CLRE 250,A00,891860,Morris; Sheldon,9995,0,9999,4
1746613529170,CLRE 251R,A00,907817,Mehta; Ravindra L.,9994,0,9999,5
1746613530201,CLRE 252,A00,891864,Cuomo; Raphael Eduardo,9993,0,9999,6
1746613531227,CLRE 253,A00,891867,Vaida; Florin,9994,0,9999,5
1746613531227,CLRE 253,B00,907819,Staff,9999,0,9999,0
1746613532257,CLRE 259,A00,891868,Patel; Hemal,9998,0,9999,1
1746613533286,CLRE 260,A00,891872,Cuomo; Raphael Eduardo,9999,0,9999,0
1746613534312,CLRE 297,001,891888,Cuomo; Raphael Eduardo,9999,0,9999,0
1746613535340,CSE 191,A00,958773,Minnes Kemp; Mor Mia,9995,0,9999,4
1746613536366,CSE 197,001,959846,Minnes Kemp; Mor Mia,9990,0,9999,9
1746613537398,CSS 201S,A01,892054,Mignozzetti; Umberto,25,0,30,5
1746613538427,CSS 202S,A01,892056,Mignozzetti; Umberto,25,0,30,5
1746613539456,DSC 197,001,956898,Eldridge; Justin Matthew,9996,0,9999,3
1746613540482,DSC 297,001,958000,Mazumdar; Arya,9998,0,9999,1
1746613540482,DSC 297,002,959862,Wang; Yusu,9998,0,9999,1
1746613541508,EAP 100,A00,905686,Staff,9778,0,9999,221
1746613542535,ECE 45,A01,892618,Staff,0,0,65,65
1746613544589,ECE 111,A01,892719,Staff,6,0,65,59
1746613545620,ECE 197,001,957920,Mercier; Patrick Philip,9991,0,9999,8
1746613546661,ECON 178,A01,907814,Zhu; Ying,26,0,35,9
1746613547686,EDS 115,A00,895312,Staff,35,0,45,10
1746613548716,EDS 117,A01,895337,Staff,23,0,30,7
1746613549743,EDS 125,A00,895341,Jones; Gabrielle Anastasia,36,0,45,9
1746613550771,EDS 128A,A01,895459,Fargason; Sharon Gayle,44,0,45,1
1746613551803,EDS 128B,A01,895543,Pappas; Elizabeth,44,0,45,1
1746613552829,EDS 139,A00,897203,Pappas; Elizabeth,44,0,45,1
1746613552829,EDS 139,B00,897209,Fargason; Sharon Gayle,41,0,45,4
1746613553856,EDS 201,A00,895545,Staff,22,0,45,23
1746613554884,EDS 203,A01,895581,Halter; Christopher P.,22,0,45,23
1746613555912,EDS 204R,A01,895625,Heinzman; Erica M.,39,0,45,6
1746613555912,EDS 204R,B01,895693,Halter; Christopher P.,10,0,45,35
1746613556944,EDS 206R,A00,895694,Fargason; Sharon Gayle,1,0,30,29
1746613556944,EDS 206R,B00,895695,Choi; Bailey Miyeon,16,0,30,14
1746613557970,EDS 250,A00,895697,Hemans; Patricia Ann Benitez,22,0,45,23
1746613559000,EDS 281,A00,895701,Meyerott; Theresa Ann,1,0,15,14
1746613560028,EDS 284,A00,895736,Meyerott; Theresa Ann,1,0,15,14
1746613561054,EDS 286,A00,897210,Fine; Sarah,0,0,15,15
1746613562088,EDS 289C,A01,895770,Daly; Alan J.,1,0,15,14
1746613563117,EDS 290,A00,897211,Hofstetter; Carolyn,0,0,15,15
1746613564147,LIGM 5A,A00,896162,Fischer-Grunski; Eva K,12,0,20,8
1746613565176,LIGM 5B,A00,896260,Fischer-Grunski; Eva K,17,0,20,3
1746613566204,LIGM 5C,A00,896308,Fischer-Grunski; Eva K,18,0,20,2
1746613567229,LIIT 5AS,A00,896313,Carnelos; Chiara,18,0,20,2
1746613568262,LIIT 5BS,A00,896416,Carnelos; Chiara,20,0,20,0
1746613569287,LIIT 5CS,A00,896564,Carnelos; Chiara,20,0,20,0
1746613570321,LISP 5A,A00,896588,Munoz Sanchez; Alicia,2,0,20,18
1746613571348,LISP 5B,A00,896653,Munoz Sanchez; Alicia,7,0,20,13
1746613572379,LISP 5C,A00,896655,Munoz Sanchez; Alicia,0,1,20,20
1746613573407,MAE 197,001,957918,Kleissl; Jan,9996,0,9999,3
1746613573407,MAE 197,002,959806,Boechler; Nicholas Sebastia,9998,0,9999,1
1746613573407,MAE 197,003,959852,Mullin; Jennifer S,9998,0,9999,1
1746613574433,MATH 2,A01,957937,Staff,33,0,35,2
1746613575464,MATH 197,001,957876,Kedlaya; Kiran S.,9993,0,9999,6
1746613576502,MCWP 40,A00,892729,Duru; Nur,10,0,20,10
1746613576502,MCWP 40,B00,893304,Montejo; Carolina,14,0,20,6
1746613577530,MCWP 40R,A00,893757,Redela; Pamela Morgan,0,5,20,20
1746613578557,MCWP 50,A00,893758,Morshed; Michael James,0,0,20,20
1746613578557,MCWP 50,B00,893761,Bartulis; Jason Michael,16,0,20,4
1746613579596,MCWP 50R,A00,893766,Compas; Sean Matthew,0,1,20,20
1746613579596,MCWP 50R,B00,893769,Carter; Jennifer A,0,1,20,20
1746613579596,MCWP 50R,C00,893771,Krone; Jarret,0,3,20,20
1746613579596,MCWP 50R,D00,893772,Miller; Elizabeth Deen,0,0,20,20
1746613579596,MCWP 50R,E00,893775,Carter; Andrea L,0,1,20,20
1746613580626,MMW 11R,A01,892721,Herbst; Matthew,14,0,30,16
1746613580626,MMW 11R,A02,892722,Herbst; Matthew,0,0,0,3
1746613581652,MMW 12R,A01,892724,Herbst; Matthew,0,11,16,16
1746613581652,MMW 12R,A02,892725,Herbst; Matthew,0,10,16,16
1746613582679,MMW 13R,A01,892727,Staff,0,4,16,16
1746613582679,MMW 13R,A02,892728,Staff,0,4,16,16
1746613582679,MMW 13R,A03,958032,Staff,0,4,16,16
1746613582679,MMW 13R,A04,958033,Staff,0,4,16,16
1746613582679,MMW 13R,A05,958034,Staff,0,4,16,16
1746613583705,SIO 295LS,A00,894015,Staff,5,0,25,20
1746613584732,SIO 295S,A00,894020,Staff,5,0,25,20
1746613585759,SIOC 290S,B01,958918,Merrifield; Mark A,14,0,30,16
1746613586791,SIOC 291S,B01,958922,Gabriel; Corey John,14,0,30,16
1746613587826,SOCI 117,A01,895339,Staff,2,0,5,3
1746613588851,WES 237B,A00,894149,Staff,11,0,20,9
1746613590923,AESE 279B,A00,891859,Staff,13,0,35,22
1746613591949,AIP 197,001,891854,Vespa; Emanuel Ignacio,9999,0,9999,0
1746613592975,ANTH 289S,A00,891856,Gagneux; Pascal,12,0,12,0
1746613594002,BENG 196,001,957946,Engler; Adam J.,9996,0,9999,3
1746613595031,BISP 197,001,959851,Wilhelm; James E.,9998,0,9999,1
1746613596056,CAT 124RS,A01,956906,Staff,6,0,25,19
1746613597083,CAT 125RS,A01,922013,Staff,6,0,25,19
1746613598108,CLRE 250,A00,891860,Morris; Sheldon,9995,0,9999,4
1746613600164,CLRE 251R,A00,907817,Mehta; Ravindra L.,9994,0,9999,5
1746613601194,CLRE 252,A00,891864,Cuomo; Raphael Eduardo,9993,0,9999,6
1746613602224,CLRE 253,A00,891867,Vaida; Florin,9994,0,9999,5
1746613602224,CLRE 253,B00,907819,Staff,9999,0,9999,0
1746613603248,CLRE 259,A00,891868,Patel; Hemal,9998,0,9999,1
1746613604276,CLRE 260,A00,891872,Cuomo; Raphael Eduardo,9999,0,9999,0
1746613605316,CLRE 297,001,891888,Cuomo; Raphael Eduardo,9999,0,9999,0
1746613606343,CSE 191,A00,958773,Minnes Kemp; Mor Mia,9995,0,9999,4
1746613607368,CSE 197,001,959846,Minnes Kemp; Mor Mia,9990,0,9999,9
1746613608395,CSS 201S,A01,892054,Mignozzetti; Umberto,25,0,30,5
1746613609422,CSS 202S,A01,892056,Mignozzetti; Umberto,25,0,30,5
1746613610450,DSC 197,001,956898,Eldridge; Justin Matthew,9996,0,9999,3
1746613611475,DSC 297,001,958000,Mazumdar; Arya,9998,0,9999,1
1746613611475,DSC 297,002,959862,Wang; Yusu,9998,0,9999,1
1746613612540,EAP 100,A00,905686,Staff,9778,0,9999,221
1746613613567,ECE 45,A01,892618,Staff,0,0,65,65
1746613615624,ECE 111,A01,892719,Staff,6,0,65,59
1746613616654,ECE 197,001,957920,Mercier; Patrick Philip,9991,0,9999,8
1746613617687,ECON 178,A01,907814,Zhu; Ying,26,0,35,9
1746613618717,EDS 115,A00,895312,Staff,35,0,45,10
1746613619744,EDS 117,A01,895337,Staff,23,0,30,7
1746613620774,EDS 125,A00,895341,Jones; Gabrielle Anastasia,36,0,45,9
1746613621799,EDS 128A,A01,895459,Fargason; Sharon Gayle,44,0,45,1
1746613622828,EDS 128B,A01,895543,Pappas; Elizabeth,44,0,45,1
1746613623856,EDS 139,A00,897203,Pappas; Elizabeth,44,0,45,1
1746613623856,EDS 139,B00,897209,Fargason; Sharon Gayle,41,0,45,4
1746613624883,EDS 201,A00,895545,Staff,22,0,45,23
1746613625909,EDS 203,A01,895581,Halter; Christopher P.,22,0,45,23
1746613626938,EDS 204R,A01,895625,Heinzman; Erica M.,39,0,45,6
1746613626938,EDS 204R,B01,895693,Halter; Christopher P.,10,0,45,35
1746613627970,EDS 206R,A00,895694,Fargason; Sharon Gayle,1,0,30,29
1746613627970,EDS 206R,B00,895695,Choi; Bailey Miyeon,16,0,30,14
1746613629001,EDS 250,A00,895697,Hemans; Patricia Ann Benitez,22,0,45,23
1746613630033,EDS 281,A00,895701,Meyerott; Theresa Ann,1,0,15,14
1746613631062,EDS 284,A00,895736,Meyerott; Theresa Ann,1,0,15,14
1746613632091,EDS 286,A00,897210,Fine; Sarah,0,0,15,15
1746613633115,EDS 289C,A01,895770,Daly; Alan J.,1,0,15,14
1746613634141,EDS 290,A00,897211,Hofstetter; Carolyn,0,0,15,15
1746613635167,LIGM 5A,A00,896162,Fischer-Grunski; Eva K,12,0,20,8
1746613636198,LIGM 5B,A00,896260,Fischer-Grunski; Eva K,17,0,20,3
1746613637223,LIGM 5C,A00,896308,Fischer-Grunski; Eva K,18,0,20,2
1746613638249,LIIT 5AS,A00,896313,Carnelos; Chiara,18,0,20,2
1746613639278,LIIT 5BS,A00,896416,Carnelos; Chiara,20,0,20,0
1746613640303,LIIT 5CS,A00,896564,Carnelos; Chiara,20,0,20,0
1746613641333,LISP 5A,A00,896588,Munoz Sanchez; Alicia,2,0,20,18
1746613642362,LISP 5B,A00,896653,Munoz Sanchez; Alicia,7,0,20,13
1746613643391,LISP 5C,A00,896655,Munoz Sanchez; Alicia,0,1,20,20
1746613644417,MAE 197,001,957918,Kleissl; Jan,9996,0,9999,3
1746613644417,MAE 197,002,959806,Boechler; Nicholas Sebastia,9998,0,9999,1
1746613644417,MAE 197,003,959852,Mullin; Jennifer S,9998,0,9999,1
1746613645448,MATH 2,A01,957937,Staff,33,0,35,2
1746613646477,MATH 197,001,957876,Kedlaya; Kiran S.,9993,0,9999,6
1746613647505,MCWP 40,A00,892729,Duru; Nur,10,0,20,10
1746613647505,MCWP 40,B00,893304,Montejo; Carolina,14,0,20,6
1746613648534,MCWP 40R,A00,893757,Redela; Pamela Morgan,0,5,20,20
1746613649560,MCWP 50,A00,893758,Morshed; Michael James,0,0,20,20
1746613649560,MCWP 50,B00,893761,Bartulis; Jason Michael,16,0,20,4
1746613650587,MCWP 50R,A00,893766,Compas; Sean Matthew,0,1,20,20
1746613650587,MCWP 50R,B00,893769,Carter; Jennifer A,0,1,20,20
1746613650587,MCWP 50R,C00,893771,Krone; Jarret,0,3,20,20
1746613650587,MCWP 50R,D00,893772,Miller; Elizabeth Deen,0,0,20,20
1746613650587,MCWP 50R,E00,893775,Carter; Andrea L,0,1,20,20
1746613651615,MMW 11R,A01,892721,Herbst; Matthew,14,0,30,16
1746613651615,MMW 11R,A02,892722,Herbst; Matthew,0,0,0,3
1746613652641,MMW 12R,A01,892724,Herbst; Matthew,0,11,16,16
1746613652641,MMW 12R,A02,892725,Herbst; Matthew,0,10,16,16
1746613653671,MMW 13R,A01,892727,Staff,0,4,16,16
1746613653671,MMW 13R,A02,892728,Staff,0,4,16,16
1746613653671,MMW 13R,A03,958032,Staff,0,4,16,16
1746613653671,MMW 13R,A04,958033,Staff,0,4,16,16
1746613653671,MMW 13R,A05,958034,Staff,0,4,16,16
1746613654698,SIO 295LS,A00,894015,Staff,5,0,25,20
1746613655725,SIO 295S,A00,894020,Staff,5,0,25,20
1746613656753,SIOC 290S,B01,958918,Merrifield; Mark A,14,0,30,16
1746613657780,SIOC 291S,B01,958922,Gabriel; Corey John,14,0,30,16
1746613658808,SOCI 117,A01,895339,Staff,2,0,5,3
1746613659835,WES 237B,A00,894149,Staff,11,0,20,9
1746613661905,AESE 279B,A00,891859,Staff,13,0,35,22
1746613662931,AIP 197,001,891854,Vespa; Emanuel Ignacio,9999,0,9999,0
1746613663959,ANTH 289S,A00,891856,Gagneux; Pascal,12,0,12,0
1746613664987,BENG 196,001,957946,Engler; Adam J.,9996,0,9999,3
1746613666012,BISP 197,001,959851,Wilhelm; James E.,9998,0,9999,1
1746613667041,CAT 124RS,A01,956906,Staff,6,0,25,19
1746613668066,CAT 125RS,A01,922013,Staff,6,0,25,19
1746613669092,CLRE 250,A00,891860,Morris; Sheldon,9995,0,9999,4
1746613671151,CLRE 251R,A00,907817,Mehta; Ravindra L.,9994,0,9999,5
1746613672178,CLRE 252,A00,891864,Cuomo; Raphael Eduardo,9993,0,9999,6
1746613673207,CLRE 253,A00,891867,Vaida; Florin,9994,0,9999,5
1746613673207,CLRE 253,B00,907819,Staff,9999,0,9999,0
1746613674239,CLRE 259,A00,891868,Patel; Hemal,9998,0,9999,1
1746613675265,CLRE 260,A00,891872,Cuomo; Raphael Eduardo,9999,0,9999,0
1746613676289,CLRE 297,001,891888,Cuomo; Raphael Eduardo,9999,0,9999,0
1746613677316,CSE 191,A00,958773,Minnes Kemp; Mor Mia,9995,0,9999,4
1746613678351,CSE 197,001,959846,Minnes Kemp; Mor Mia,9990,0,9999,9
1746613679377,CSS 201S,A01,892054,Mignozzetti; Umberto,25,0,30,5
1746613680408,CSS 202S,A01,892056,Mignozzetti; Umberto,25,0,30,5
1746613681437,DSC 197,001,956898,Eldridge; Justin Matthew,9996,0,9999,3
1746613682462,DSC 297,001,958000,Mazumdar; Arya,9998,0,9999,1
1746613682462,DSC 297,002,959862,Wang; Yusu,9998,0,9999,1
1746613683490,EAP 100,A00,905686,Staff,9778,0,9999,221
1746613684521,ECE 45,A01,892618,Staff,0,0,65,65
1746613686580,ECE 111,A01,892719,Staff,6,0,65,59
1746613687613,ECE 197,001,957920,Mercier; Patrick Philip,9991,0,9999,8
1746613688644,ECON 178,A01,907814,Zhu; Ying,26,0,35,9
1746613689674,EDS 115,A00,895312,Staff,35,0,45,10
1746613690706,EDS 117,A01,895337,Staff,23,0,30,7
1746613691734,EDS 125,A00,895341,Jones; Gabrielle Anastasia,36,0,45,9
1746613692765,EDS 128A,A01,895459,Fargason; Sharon Gayle,44,0,45,1
1746613693790,EDS 128B,A01,895543,Pappas; Elizabeth,44,0,45,1
1746613694817,EDS 139,A00,897203,Pappas; Elizabeth,44,0,45,1
1746613694817,EDS 139,B00,897209,Fargason; Sharon Gayle,41,0,45,4
1746613695846,EDS 201,A00,895545,Staff,22,0,45,23
1746613696873,EDS 203,A01,895581,Halter; Christopher P.,22,0,45,23
1746613697906,EDS 204R,A01,895625,Heinzman; Erica M.,39,0,45,6
1746613697906,EDS 204R,B01,895693,Halter; Christopher P.,10,0,45,35
1746613698931,EDS 206R,A00,895694,Fargason; Sharon Gayle,1,0,30,29
1746613698931,EDS 206R,B00,895695,Choi; Bailey Miyeon,16,0,30,14
1746613699995,EDS 250,A00,895697,Hemans; Patricia Ann Benitez,22,0,45,23
1746613701022,EDS 281,A00,895701,Meyerott; Theresa Ann,1,0,15,14
1746613702050,EDS 284,A00,895736,Meyerott; Theresa Ann,1,0,15,14
1746613703076,EDS 286,A00,897210,Fine; Sarah,0,0,15,15
1746613704104,EDS 289C,A01,895770,Daly; Alan J.,1,0,15,14
1746613705130,EDS 290,A00,897211,Hofstetter; Carolyn,0,0,15,15
1746613706161,LIGM 5A,A00,896162,Fischer-Grunski; Eva K,12,0,20,8
1746613707192,LIGM 5B,A00,896260,Fischer-Grunski; Eva K,17,0,20,3
1746613708223,LIGM 5C,A00,896308,Fischer-Grunski; Eva K,18,0,20,2
1746613709250,LIIT 5AS,A00,896313,Carnelos; Chiara,18,0,20,2
1746613710279,LIIT 5BS,A00,896416,Carnelos; Chiara,20,0,20,0
1746613711306,LIIT 5CS,A00,896564,Carnelos; Chiara,20,0,20,0
1746613712332,LISP 5A,A00,896588,Munoz Sanchez; Alicia,2,0,20,18
1746613713365,LISP 5B,A00,896653,Munoz Sanchez; Alicia,7,0,20,13
1746613714390,LISP 5C,A00,896655,Munoz Sanchez; Alicia,0,1,20,20
1746613715426,MAE 197,001,957918,Kleissl; Jan,9996,0,9999,3
1746613715426,MAE 197,002,959806,Boechler; Nicholas Sebastia,9998,0,9999,1
1746613715426,MAE 197,003,959852,Mullin; Jennifer S,9998,0,9999,1
1746613716513,MATH 2,A01,957937,Staff,33,0,35,2
1746613717544,MATH 197,001,957876,Kedlaya; Kiran S.,9993,0,9999,6
1746613718572,MCWP 40,A00,892729,Duru; Nur,10,0,20,10
1746613718572,MCWP 40,B00,893304,Montejo; Carolina,14,0,20,6
1746613719599,MCWP 40R,A00,893757,Redela; Pamela Morgan,0,5,20,20
1746613720626,MCWP 50,A00,893758,Morshed; Michael James,0,0,20,20
1746613720626,MCWP 50,B00,893761,Bartulis; Jason Michael,16,0,20,4
1746613721654,MCWP 50R,A00,893766,Compas; Sean Matthew,0,1,20,20
1746613721654,MCWP 50R,B00,893769,Carter; Jennifer A,0,1,20,20
1746613721654,MCWP 50R,C00,893771,Krone; Jarret,0,3,20,20
1746613721654,MCWP 50R,D00,893772,Miller; Elizabeth Deen,0,0,20,20
1746613721654,MCWP 50R,E00,893775,Carter; Andrea L,0,1,20,20
1746613722684,MMW 11R,A01,892721,Herbst; Matthew,14,0,30,16
1746613722684,MMW 11R,A02,892722,Herbst; Matthew,0,0,0,3
1746613723708,MMW 12R,A01,892724,Herbst; Matthew,0,11,16,16
1746613723708,MMW 12R,A02,892725,Herbst; Matthew,0,10,16,16
1746613724740,MMW 13R,A01,892727,Staff,0,4,16,16
1746613724740,MMW 13R,A02,892728,Staff,0,4,16,16
1746613724740,MMW 13R,A03,958032,Staff,0,4,16,16
1746613724740,MMW 13R,A04,958033,Staff,0,4,16,16
1746613724740,MMW 13R,A05,958034,Staff,0,4,16,16
1746613725769,SIO 295LS,A00,894015,Staff,5,0,25,20
1746613726795,SIO 295S,A00,894020,Staff,5,0,25,20
1746613727823,SIOC 290S,B01,958918,Merrifield; Mark A,14,0,30,16
1746613728851,SIOC 291S,B01,958922,Gabriel; Corey John,14,0,30,16
1746613729881,SOCI 117,A01,895339,Staff,2,0,5,3
1746613730911,WES 237B,A00,894149,Staff,11,0,20,9
1746613732979,AESE 279B,A00,891859,Staff,13,0,35,22
1746613734006,AIP 197,001,891854,Vespa; Emanuel Ignacio,9999,0,9999,0
1746613735037,ANTH 289S,A00,891856,Gagneux; Pascal,12,0,12,0
1746613736066,BENG 196,001,957946,Engler; Adam J.,9996,0,9999,3
1746613737095,BISP 197,001,959851,Wilhelm; James E.,9998,0,9999,1
1746613738122,CAT 124RS,A01,956906,Staff,6,0,25,19
1746613739159,CAT 125RS,A01,922013,Staff,6,0,25,19
1746613740192,CLRE 250,A00,891860,Morris; Sheldon,9995,0,9999,4
1746613742250,CLRE 251R,A00,907817,Mehta; Ravindra L.,9994,0,9999,5
1746613743282,CLRE 252,A00,891864,Cuomo; Raphael Eduardo,9993,0,9999,6
1746613744313,CLRE 253,A00,891867,Vaida; Florin,9994,0,9999,5
1746613744313,CLRE 253,B00,907819,Staff,9999,0,9999,0
1746613745343,CLRE 259,A00,891868,Patel; Hemal,9998,0,9999,1
1746613746372,CLRE 260,A00,891872,Cuomo; Raphael Eduardo,9999,0,9999,0
1746613747399,CLRE 297,001,891888,Cuomo; Raphael Eduardo,9999,0,9999,0
1746613748429,CSE 191,A00,958773,Minnes Kemp; Mor Mia,9995,0,9999,4
1746613749458,CSE 197,001,959846,Minnes Kemp; Mor Mia,9990,0,9999,9
1746613750490,CSS 201S,A01,892054,Mignozzetti; Umberto,25,0,30,5
1746613751522,CSS 202S,A01,892056,Mignozzetti; Umberto,25,0,30,5
1746613752548,DSC 197,001,956898,Eldridge; Justin Matthew,9996,0,9999,3
1746613753577,DSC 297,001,958000,Mazumdar; Arya,9998,0,9999,1
1746613753577,DSC 297,002,959862,Wang; Yusu,9998,0,9999,1
1746613754606,EAP 100,A00,905686,Staff,9778,0,9999,221
1746613755633,ECE 45,A01,892618,Staff,0,0,65,65
1746613757691,ECE 111,A01,892719,Staff,6,0,65,59
1746613758717,ECE 197,001,957920,Mercier; Patrick Philip,9991,0,9999,8
1746613759746,ECON 178,A01,907814,Zhu; Ying,26,0,35,9
1746613760775,EDS 115,A00,895312,Staff,35,0,45,10
1746613761804,EDS 117,A01,895337,Staff,23,0,30,7
1746613762830,EDS 125,A00,895341,Jones; Gabrielle Anastasia,36,0,45,9
1746613763856,EDS 128A,A01,895459,Fargason; Sharon Gayle,44,0,45,1
1746613764883,EDS 128B,A01,895543,Pappas; Elizabeth,44,0,45,1
1746613765909,EDS 139,A00,897203,Pappas; Elizabeth,44,0,45,1
1746613765909,EDS 139,B00,897209,Fargason; Sharon Gayle,41,0,45,4
1746613766937,EDS 201,A00,895545,Staff,22,0,45,23
1746613767969,EDS 203,A01,895581,Halter; Christopher P.,22,0,45,23
1746613768998,EDS 204R,A01,895625,Heinzman; Erica M.,39,0,45,6
1746613768998,EDS 204R,B01,895693,Halter; Christopher P.,10,0,45,35
1746613770030,EDS 206R,A00,895694,Fargason; Sharon Gayle,1,0,30,29
1746613770030,EDS 206R,B00,895695,Choi; Bailey Miyeon,16,0,30,14
1746613771060,EDS 250,A00,895697,Hemans; Patricia Ann Benitez,22,0,45,23
1746613772091,EDS 281,A00,895701,Meyerott; Theresa Ann,1,0,15,14
1746613773117,EDS 284,A00,895736,Meyerott; Theresa Ann,1,0,15,14
1746613774145,EDS 286,A00,897210,Fine; Sarah,0,0,15,15
1746613775174,EDS 289C,A01,895770,Daly; Alan J.,1,0,15,14
1746613776203,EDS 290,A00,897211,Hofstetter; Carolyn,0,0,15,15
1746613777230,LIGM 5A,A00,896162,Fischer-Grunski; Eva K,12,0,20,8
1746613778261,LIGM 5B,A00,896260,Fischer-Grunski; Eva K,17,0,20,3
1746613779287,LIGM 5C,A00,896308,Fischer-Grunski; Eva K,18,0,20,2
1746613780316,LIIT 5AS,A00,896313,Carnelos; Chiara,18,0,20,2
1746613781342,LIIT 5BS,A00,896416,Carnelos; Chiara,20,0,20,0
1746613782372,LIIT 5CS,A00,896564,Carnelos; Chiara,20,0,20,0
1746613783402,LISP 5A,A00,896588,Munoz Sanchez; Alicia,2,0,20,18
1746613784429,LISP 5B,A00,896653,Munoz Sanchez; Alicia,7,0,20,13
1746613785467,LISP 5C,A00,896655,Munoz Sanchez; Alicia,0,1,20,20
1746613786495,MAE 197,001,957918,Kleissl; Jan,9996,0,9999,3
1746613786495,MAE 197,002,959806,Boechler; Nicholas Sebastia,9998,0,9999,1
1746613786495,MAE 197,003,959852,Mullin; Jennifer S,9998,0,9999,1
1746613787521,MATH 2,A01,957937,Staff,33,0,35,2
1746613788549,MATH 197,001,957876,Kedlaya; Kiran S.,9993,0,9999,6
1746613789578,MCWP 40,A00,892729,Duru; Nur,10,0,20,10
1746613789578,MCWP 40,B00,893304,Montejo; Carolina,14,0,20,6
1746613790606,MCWP 40R,A00,893757,Redela; Pamela Morgan,0,5,20,20
1746613791633,MCWP 50,A00,893758,Morshed; Michael James,0,0,20,20
1746613791633,MCWP 50,B00,893761,Bartulis; Jason Michael,16,0,20,4
1746613792662,MCWP 50R,A00,893766,Compas; Sean Matthew,0,1,20,20
1746613792662,MCWP 50R,B00,893769,Carter; Jennifer A,0,1,20,20
1746613792662,MCWP 50R,C00,893771,Krone; Jarret,0,3,20,20
1746613792662,MCWP 50R,D00,893772,Miller; Elizabeth Deen,0,0,20,20
1746613792662,MCWP 50R,E00,893775,Carter; Andrea L,0,1,20,20
1746613793691,MMW 11R,A01,892721,Herbst; Matthew,14,0,30,16
1746613793691,MMW 11R,A02,892722,Herbst; Matthew,0,0,0,3
1746613794718,MMW 12R,A01,892724,Herbst; Matthew,0,11,16,16
1746613794718,MMW 12R,A02,892725,Herbst; Matthew,0,10,16,16
1746613795749,MMW 13R,A01,892727,Staff,0,4,16,16
1746613795749,MMW 13R,A02,892728,Staff,0,4,16,16
1746613795749,MMW 13R,A03,958032,Staff,0,4,16,16
1746613795749,MMW 13R,A04,958033,Staff,0,4,16,16
1746613795749,MMW 13R,A05,958034,Staff,0,4,16,16
1746613796780,SIO 295LS,A00,894015,Staff,5,0,25,20
1746613797810,SIO 295S,A00,894020,Staff,5,0,25,20
1746613798845,SIOC 290S,B01,958918,Merrifield; Mark A,14,0,30,16
1746613799873,SIOC 291S,B01,958922,Gabriel; Corey John,14,0,30,16
1746613800900,SOCI 117,A01,895339,Staff,2,0,5,3
1746613801925,WES 237B,A00,894149,Staff,11,0,20,9
1746613804002,AESE 279B,A00,891859,Staff,13,0,35,22
1746613805062,AIP 197,001,891854,Vespa; Emanuel Ignacio,9999,0,9999,0
1746613806090,ANTH 289S,A00,891856,Gagneux; Pascal,12,0,12,0
1746613807118,BENG 196,001,957946,Engler; Adam J.,9996,0,9999,3
1746613808146,BISP 197,001,959851,Wilhelm; James E.,9998,0,9999,1
1746613809172,CAT 124RS,A01,956906,Staff,6,0,25,19
1746613810199,CAT 125RS,A01,922013,Staff,6,0,25,19
1746613811223,CLRE 250,A00,891860,Morris; Sheldon,9995,0,9999,4
1746613813280,CLRE 251R,A00,907817,Mehta; Ravindra L.,9994,0,9999,5
1746613814307,CLRE 252,A00,891864,Cuomo; Raphael Eduardo,9993,0,9999,6
1746613815335,CLRE 253,A00,891867,Vaida; Florin,9994,0,9999,5
1746613815335,CLRE 253,B00,907819,Staff,9999,0,9999,0
1746613816361,CLRE 259,A00,891868,Patel; Hemal,9998,0,9999,1
1746613817387,CLRE 260,A00,891872,Cuomo; Raphael Eduardo,9999,0,9999,0
1746613818413,CLRE 297,001,891888,Cuomo; Raphael Eduardo,9999,0,9999,0
1746613819441,CSE 191,A00,958773,Minnes Kemp; Mor Mia,9995,0,9999,4
1746613820471,CSE 197,001,959846,Minnes Kemp; Mor Mia,9990,0,9999,9
1746613821503,CSS 201S,A01,892054,Mignozzetti; Umberto,25,0,30,5
1746613822530,CSS 202S,A01,892056,Mignozzetti; Umberto,25,0,30,5
1746613823557,DSC 197,001,956898,Eldridge; Justin Matthew,9996,0,9999,3
1746613824586,DSC 297,001,958000,Mazumdar; Arya,9998,0,9999,1
1746613824586,DSC 297,002,959862,Wang; Yusu,9998,0,9999,1
1746613825616,EAP 100,A00,905686,Staff,9778,0,9999,221
1746613826643,ECE 45,A01,892618,Staff,0,0,65,65
1746613828701,ECE 111,A01,892719,Staff,6,0,65,59
1746613829729,ECE 197,001,957920,Mercier; Patrick Philip,9991,0,9999,8
1746613830757,ECON 178,A01,907814,Zhu; Ying,26,0,35,9
1746613831786,EDS 115,A00,895312,Staff,35,0,45,10
1746613832816,EDS 117,A01,895337,Staff,23,0,30,7
1746613833843,EDS 125,A00,895341,Jones; Gabrielle Anastasia,36,0,45,9
1746613834876,EDS 128A,A01,895459,Fargason; Sharon Gayle,44,0,45,1
1746613835903,EDS 128B,A01,895543,Pappas; Elizabeth,44,0,45,1
1746613836950,EDS 139,A00,897203,Pappas; Elizabeth,44,0,45,1
1746613836950,EDS 139,B00,897209,Fargason; Sharon Gayle,41,0,45,4
1746613837975,EDS 201,A00,895545,Staff,22,0,45,23
1746613839004,EDS 203,A01,895581,Halter; Christopher P.,22,0,45,23
1746613840033,EDS 204R,A01,895625,Heinzman; Erica M.,39,0,45,6
1746613840033,EDS 204R,B01,895693,Halter; Christopher P.,10,0,45,35
1746613841065,EDS 206R,A00,895694,Fargason; Sharon Gayle,1,0,30,29
1746613841065,EDS 206R,B00,895695,Choi; Bailey Miyeon,16,0,30,14
1746613842091,EDS 250,A00,895697,Hemans; Patricia Ann Benitez,22,0,45,23
1746613843119,EDS 281,A00,895701,Meyerott; Theresa Ann,1,0,15,14
1746613844149,EDS 284,A00,895736,Meyerott; Theresa Ann,1,0,15,14
1746613845186,EDS 286,A00,897210,Fine; Sarah,0,0,15,15
1746613846215,EDS 289C,A01,895770,Daly; Alan J.,1,0,15,14
1746613847241,EDS 290,A00,897211,Hofstetter; Carolyn,0,0,15,15
1746613848269,LIGM 5A,A00,896162,Fischer-Grunski; Eva K,12,0,20,8
1746613849296,LIGM 5B,A00,896260,Fischer-Grunski; Eva K,17,0,20,3
1746613850328,LIGM 5C,A00,896308,Fischer-Grunski; Eva K,18,0,20,2
1746613851358,LIIT 5AS,A00,896313,Carnelos; Chiara,18,0,20,2
1746613852383,LIIT 5BS,A00,896416,Carnelos; Chiara,20,0,20,0
1746613853413,LIIT 5CS,A00,896564,Carnelos; Chiara,20,0,20,0
1746613854446,LISP 5A,A00,896588,Munoz Sanchez; Alicia,2,0,20,18
1746613855475,LISP 5B,A00,896653,Munoz Sanchez; Alicia,7,0,20,13
1746613856503,LISP 5C,A00,896655,Munoz Sanchez; Alicia,0,1,20,20
1746613857530,MAE 197,001,957918,Kleissl; Jan,9996,0,9999,3
1746613857530,MAE 197,002,959806,Boechler; Nicholas Sebastia,9998,0,9999,1
1746613857530,MAE 197,003,959852,Mullin; Jennifer S,9998,0,9999,1
1746613858557,MATH 2,A01,957937,Staff,33,0,35,2
1746613859584,MATH 197,001,957876,Kedlaya; Kiran S.,9993,0,9999,6
1746613860613,MCWP 40,A00,892729,Duru; Nur,10,0,20,10
1746613860613,MCWP 40,B00,893304,Montejo; Carolina,14,0,20,6
1746613861642,MCWP 40R,A00,893757,Redela; Pamela Morgan,0,5,20,20
1746613862674,MCWP 50,A00,893758,Morshed; Michael James,0,0,20,20
1746613862674,MCWP 50,B00,893761,Bartulis; Jason Michael,16,0,20,4
1746613863705,MCWP 50R,A00,893766,Compas; Sean Matthew,0,1,20,20
1746613863705,MCWP 50R,B00,893769,Carter; Jennifer A,0,1,20,20
1746613863705,MCWP 50R,C00,893771,Krone; Jarret,0,3,20,20
1746613863705,MCWP 50R,D00,893772,Miller; Elizabeth Deen,0,0,20,20
1746613863705,MCWP 50R,E00,893775,Carter; Andrea L,0,1,20,20
1746613864741,MMW 11R,A01,892721,Herbst; Matthew,14,0,30,16
1746613864741,MMW 11R,A02,892722,Herbst; Matthew,0,0,0,3
1746613865768,MMW 12R,A01,892724,Herbst; Matthew,0,11,16,16
1746613865768,MMW 12R,A02,892725,Herbst; Matthew,0,10,16,16
1746613866798,MMW 13R,A01,892727,Staff,0,4,16,16
1746613866798,MMW 13R,A02,892728,Staff,0,4,16,16
1746613866798,MMW 13R,A03,958032,Staff,0,4,16,16
1746613866798,MMW 13R,A04,958033,Staff,0,4,16,16
1746613866798,MMW 13R,A05,958034,Staff,0,4,16,16
1746613867828,SIO 295LS,A00,894015,Staff,5,0,25,20
1746613868856,SIO 295S,A00,894020,Staff,5,0,25,20
1746613869895,SIOC 290S,B01,958918,Merrifield; Mark A,14,0,30,16
1746613870930,SIOC 291S,B01,958922,Gabriel; Corey John,14,0,30,16
1746613871956,SOCI 117,A01,895339,Staff,2,0,5,3
1746613872983,WES 237B,A00,894149,Staff,11,0,20,9
1746613875057,AESE 279B,A00,891859,Staff,13,0,35,22
1746613876085,AIP 197,001,891854,Vespa; Emanuel Ignacio,9999,0,9999,0
1746613877112,ANTH 289S,A00,891856,Gagneux; Pascal,12,0,12,0
1746613878141,BENG 196,001,957946,Engler; Adam J.,9996,0,9999,3
1746613879168,BISP 197,001,959851,Wilhelm; James E.,9998,0,9999,1
1746613880198,CAT 124RS,A01,956906,Staff,6,0,25,19
1746613881226,CAT 125RS,A01,922013,Staff,6,0,25,19
1746613882255,CLRE 250,A00,891860,Morris; Sheldon,9995,0,9999,4
1746613884307,CLRE 251R,A00,907817,Mehta; Ravindra L.,9994,0,9999,5
1746613885338,CLRE 252,A00,891864,Cuomo; Raphael Eduardo,9993,0,9999,6
1746613886365,CLRE 253,A00,891867,Vaida; Florin,9994,0,9999,5
1746613886365,CLRE 253,B00,907819,Staff,9999,0,9999,0
1746613887392,CLRE 259,A00,891868,Patel; Hemal,9998,0,9999,1
1746613888418,CLRE 260,A00,891872,Cuomo; Raphael Eduardo,9999,0,9999,0
1746613889448,CLRE 297,001,891888,Cuomo; Raphael Eduardo,9999,0,9999,0
1746613890481,CSE 191,A00,958773,Minnes Kemp; Mor Mia,9995,0,9999,4
1746613891508,CSE 197,001,959846,Minnes Kemp; Mor Mia,9990,0,9999,9
1746613892542,CSS 201S,A01,892054,Mignozzetti; Umberto,25,0,30,5
1746613893568,CSS 202S,A01,892056,Mignozzetti; Umberto,25,0,30,5
1746613894599,DSC 197,001,956898,Eldridge; Justin Matthew,9996,0,9999,3
1746613895626,DSC 297,001,958000,Mazumdar; Arya,9998,0,9999,1
1746613895626,DSC 297,002,959862,Wang; Yusu,9998,0,9999,1
1746613896652,EAP 100,A00,905686,Staff,9778,0,9999,221
1746613897686,ECE 45,A01,892618,Staff,0,0,65,65
1746613899739,ECE 111,A01,892719,Staff,6,0,65,59
1746613900766,ECE 197,001,957920,Mercier; Patrick Philip,9991,0,9999,8
1746613901795,ECON 178,A01,907814,Zhu; Ying,26,0,35,9
1746613902820,EDS 115,A00,895312,Staff,35,0,45,10
1746613903850,EDS 117,A01,895337,Staff,23,0,30,7
1746613904875,EDS 125,A00,895341,Jones; Gabrielle Anastasia,36,0,45,9
1746613905905,EDS 128A,A01,895459,Fargason; Sharon Gayle,44,0,45,1
1746613906934,EDS 128B,A01,895543,Pappas; Elizabeth,44,0,45,1
1746613907960,EDS 139,A00,897203,Pappas; Elizabeth,44,0,45,1
1746613907960,EDS 139,B00,897209,Fargason; Sharon Gayle,41,0,45,4
1746613908987,EDS 201,A00,895545,Staff,22,0,45,23
1746613910013,EDS 203,A01,895581,Halter; Christopher P.,22,0,45,23
1746613911040,EDS 204R,A01,895625,Heinzman; Erica M.,39,0,45,6
1746613911040,EDS 204R,B01,895693,Halter; Christopher P.,10,0,45,35
1746613912071,EDS 206R,A00,895694,Fargason; Sharon Gayle,1,0,30,29
1746613912071,EDS 206R,B00,895695,Choi; Bailey Miyeon,16,0,30,14
1746613913098,EDS 250,A00,895697,Hemans; Patricia Ann Benitez,22,0,45,23
1746613914127,EDS 281,A00,895701,Meyerott; Theresa Ann,1,0,15,14
1746613915159,EDS 284,A00,895736,Meyerott; Theresa Ann,1,0,15,14
1746613916190,EDS 286,A00,897210,Fine; Sarah,0,0,15,15
1746613917278,EDS 289C,A01,895770,Daly; Alan J.,1,0,15,14
1746613918304,EDS 290,A00,897211,Hofstetter; Carolyn,0,0,15,15
1746613919331,LIGM 5A,A00,896162,Fischer-Grunski; Eva K,12,0,20,8
1746613920360,LIGM 5B,A00,896260,Fischer-Grunski; Eva K,17,0,20,3
1746613921391,LIGM 5C,A00,896308,Fischer-Grunski; Eva K,18,0,20,2
1746613922424,LIIT 5AS,A00,896313,Carnelos; Chiara,18,0,20,2
1746613923457,LIIT 5BS,A00,896416,Carnelos; Chiara,20,0,20,0
1746613924483,LIIT 5CS,A00,896564,Carnelos; Chiara,20,0,20,0
1746613925514,LISP 5A,A00,896588,Munoz Sanchez; Alicia,2,0,20,18
1746613926546,LISP 5B,A00,896653,Munoz Sanchez; Alicia,7,0,20,13
1746613927571,LISP 5C,A00,896655,Munoz Sanchez; Alicia,0,1,20,20
1746613928598,MAE 197,001,957918,Kleissl; Jan,9996,0,9999,3
1746613928598,MAE 197,002,959806,Boechler; Nicholas Sebastia,9998,0,9999,1
1746613928598,MAE 197,003,959852,Mullin; Jennifer S,9998,0,9999,1
1746613929625,MATH 2,A01,957937,Staff,33,0,35,2
1746613930652,MATH 197,001,957876,Kedlaya; Kiran S.,9993,0,9999,6
1746613931681,MCWP 40,A00,892729,Duru; Nur,10,0,20,10
1746613931681,MCWP 40,B00,893304,Montejo; Carolina,14,0,20,6
1746613932708,MCWP 40R,A00,893757,Redela; Pamela Morgan,0,5,20,20
1746613933741,MCWP 50,A00,893758,Morshed; Michael James,0,0,20,20
1746613933741,MCWP 50,B00,893761,Bartulis; Jason Michael,16,0,20,4
1746613934770,MCWP 50R,A00,893766,Compas; Sean Matthew,0,1,20,20
1746613934770,MCWP 50R,B00,893769,Carter; Jennifer A,0,1,20,20
1746613934770,MCWP 50R,C00,893771,Krone; Jarret,0,3,20,20
1746613934770,MCWP 50R,D00,893772,Miller; Elizabeth Deen,0,0,20,20
1746613934770,MCWP 50R,E00,893775,Carter; Andrea L,0,1,20,20
1746613935802,MMW 11R,A01,892721,Herbst; Matthew,14,0,30,16
1746613935802,MMW 11R,A02,892722,Herbst; Matthew,0,0,0,3
1746613936832,MMW 12R,A01,892724,Herbst; Matthew,0,11,16,16
1746613936832,MMW 12R,A02,892725,Herbst; Matthew,0,10,16,16
1746613937859,MMW 13R,A01,892727,Staff,0,4,16,16
1746613937859,MMW 13R,A02,892728,Staff,0,4,16,16
1746613937859,MMW 13R,A03,958032,Staff,0,4,16,16
1746613937859,MMW 13R,A04,958033,Staff,0,4,16,16
1746613937859,MMW 13R,A05,958034,Staff,0,4,16,16
1746613938887,SIO 295LS,A00,894015,Staff,5,0,25,20
1746613939912,SIO 295S,A00,894020,Staff,5,0,25,20
1746613940940,SIOC 290S,B01,958918,Merrifield; Mark A,14,0,30,16
1746613941969,SIOC 291S,B01,958922,Gabriel; Corey John,14,0,30,16
1746613942995,SOCI 117,A01,895339,Staff,2,0,5,3
1746613944021,WES 237B,A00,894149,Staff,11,0,20,9
1746613946101,AESE 279B,A00,891859,Staff,13,0,35,22
1746613947130,AIP 197,001,891854,Vespa; Emanuel Ignacio,9999,0,9999,0
1746613948157,ANTH 289S,A00,891856,Gagneux; Pascal,12,0,12,0
1746613949188,BENG 196,001,957946,Engler; Adam J.,9996,0,9999,3
1746613950216,BISP 197,001,959851,Wilhelm; James E.,9998,0,9999,1
1746613951242,CAT 124RS,A01,956906,Staff,6,0,25,19
1746613952268,CAT 125RS,A01,922013,Staff,6,0,25,19
1746613953295,CLRE 250,A00,891860,Morris; Sheldon,9995,0,9999,4
1746613955351,CLRE 251R,A00,907817,Mehta; Ravindra L.,9994,0,9999,5
1746613956378,CLRE 252,A00,891864,Cuomo; Raphael Eduardo,9993,0,9999,6
1746613957406,CLRE 253,A00,891867,Vaida; Florin,9994,0,9999,5
1746613957406,CLRE 253,B00,907819,Staff,9999,0,9999,0
1746613958434,CLRE 259,A00,891868,Patel; Hemal,9998,0,9999,1
1746613959460,CLRE 260,A00,891872,Cuomo; Raphael Eduardo,9999,0,9999,0
1746613960486,CLRE 297,001,891888,Cuomo; Raphael Eduardo,9999,0,9999,0
1746613961512,CSE 191,A00,958773,Minnes Kemp; Mor Mia,9995,0,9999,4
1746613962540,CSE 197,001,959846,Minnes Kemp; Mor Mia,9990,0,9999,9
1746613963567,CSS 201S,A01,892054,Mignozzetti; Umberto,25,0,30,5
1746613964592,CSS 202S,A01,892056,Mignozzetti; Umberto,25,0,30,5
1746613965618,DSC 197,001,956898,Eldridge; Justin Matthew,9996,0,9999,3
1746613966647,DSC 297,001,958000,Mazumdar; Arya,9998,0,9999,1
1746613966647,DSC 297,002,959862,Wang; Yusu,9998,0,9999,1
1746613967676,EAP 100,A00,905686,Staff,9778,0,9999,221
1746613968703,ECE 45,A01,892618,Staff,0,0,65,65
1746613970778,ECE 111,A01,892719,Staff,6,0,65,59
1746613971809,ECE 197,001,957920,Mercier; Patrick Philip,9991,0,9999,8
1746613972841,ECON 178,A01,907814,Zhu; Ying,26,0,35,9
1746613973866,EDS 115,A00,895312,Staff,35,0,45,10
1746613974895,EDS 117,A01,895337,Staff,23,0,30,7
1746613975925,EDS 125,A00,895341,Jones; Gabrielle Anastasia,36,0,45,9
1746613976959,EDS 128A,A01,895459,Fargason; Sharon Gayle,44,0,45,1
1746613977984,EDS 128B,A01,895543,Pappas; Elizabeth,44,0,45,1
1746613979014,EDS 139,A00,897203,Pappas; Elizabeth,44,0,45,1
1746613979014,EDS 139,B00,897209,Fargason; Sharon Gayle,41,0,45,4
1746613980047,EDS 201,A00,895545,Staff,22,0,45,23
1746613981072,EDS 203,A01,895581,Halter; Christopher P.,22,0,45,23
1746613982104,EDS 204R,A01,895625,Heinzman; Erica M.,39,0,45,6
1746613982104,EDS 204R,B01,895693,Halter; Christopher P.,10,0,45,35
1746613983137,EDS 206R,A00,895694,Fargason; Sharon Gayle,1,0,30,29
1746613983137,EDS 206R,B00,895695,Choi; Bailey Miyeon,16,0,30,14
1746613984162,EDS 250,A00,895697,Hemans; Patricia Ann Benitez,22,0,45,23
1746613985186,EDS 281,A00,895701,Meyerott; Theresa Ann,1,0,15,14
1746613986229,EDS 284,A00,895736,Meyerott; Theresa Ann,1,0,15,14
1746613987267,EDS 286,A00,897210,Fine; Sarah,0,0,15,15
1746613988361,EDS 289C,A01,895770,Daly; Alan J.,1,0,15,14
1746613989385,EDS 290,A00,897211,Hofstetter; Carolyn,0,0,15,15
1746613990411,LIGM 5A,A00,896162,Fischer-Grunski; Eva K,12,0,20,8
1746613991437,LIGM 5B,A00,896260,Fischer-Grunski; Eva K,17,0,20,3
1746613992467,LIGM 5C,A00,896308,Fischer-Grunski; Eva K,18,0,20,2
1746613993498,LIIT 5AS,A00,896313,Carnelos; Chiara,18,0,20,2
1746613994525,LIIT 5BS,A00,896416,Carnelos; Chiara,20,0,20,0
1746613995551,LIIT 5CS,A00,896564,Carnelos; Chiara,20,0,20,0
1746613996580,LISP 5A,A00,896588,Munoz Sanchez; Alicia,2,0,20,18
1746613997606,LISP 5B,A00,896653,Munoz Sanchez; Alicia,7,0,20,13
1746613998637,LISP 5C,A00,896655,Munoz Sanchez; Alicia,0,1,20,20
1746613999664,MAE 197,001,957918,Kleissl; Jan,9996,0,9999,3
1746613999664,MAE 197,002,959806,Boechler; Nicholas Sebastia,9998,0,9999,1
1746613999664,MAE 197,003,959852,Mullin; Jennifer S,9998,0,9999,1
1746614000691,MATH 2,A01,957937,Staff,33,0,35,2
1746614001717,MATH 197,001,957876,Kedlaya; Kiran S.,9993,0,9999,6
1746614002744,MCWP 40,A00,892729,Duru; Nur,10,0,20,10
1746614002744,MCWP 40,B00,893304,Montejo; Carolina,14,0,20,6
1746614003771,MCWP 40R,A00,893757,Redela; Pamela Morgan,0,5,20,20
1746614004801,MCWP 50,A00,893758,Morshed; Michael James,0,0,20,20
1746614004801,MCWP 50,B00,893761,Bartulis; Jason Michael,16,0,20,4
1746614005833,MCWP 50R,A00,893766,Compas; Sean Matthew,0,1,20,20
1746614005833,MCWP 50R,B00,893769,Carter; Jennifer A,0,1,20,20
1746614005833,MCWP 50R,C00,893771,Krone; Jarret,0,3,20,20
1746614005833,MCWP 50R,D00,893772,Miller; Elizabeth Deen,0,0,20,20
1746614005833,MCWP 50R,E00,893775,Carter; Andrea L,0,1,20,20
1746614006861,MMW 11R,A01,892721,Herbst; Matthew,14,0,30,16
1746614006861,MMW 11R,A02,892722,Herbst; Matthew,0,0,0,3
1746614007891,MMW 12R,A01,892724,Herbst; Matthew,0,11,16,16
1746614007891,MMW 12R,A02,892725,Herbst; Matthew,0,10,16,16
1746614008918,MMW 13R,A01,892727,Staff,0,4,16,16
1746614008918,MMW 13R,A02,892728,Staff,0,4,16,16
1746614008918,MMW 13R,A03,958032,Staff,0,4,16,16
1746614008918,MMW 13R,A04,958033,Staff,0,4,16,16
1746614008918,MMW 13R,A05,958034,Staff,0,4,16,16
1746614009946,SIO 295LS,A00,894015,Staff,5,0,25,20
1746614010972,SIO 295S,A00,894020,Staff,5,0,25,20
1746614011999,SIOC 290S,B01,958918,Merrifield; Mark A,14,0,30,16
1746614013032,SIOC 291S,B01,958922,Gabriel; Corey John,14,0,30,16
1746614014065,SOCI 117,A01,895339,Staff,2,0,5,3
1746614015097,WES 237B,A00,894149,Staff,11,0,20,9
1746614017173,AESE 279B,A00,891859,Staff,13,0,35,22
1746614018200,AIP 197,001,891854,Vespa; Emanuel Ignacio,9999,0,9999,0
1746614019232,ANTH 289S,A00,891856,Gagneux; Pascal,12,0,12,0
1746614020259,BENG 196,001,957946,Engler; Adam J.,9996,0,9999,3
1746614021326,BISP 197,001,959851,Wilhelm; James E.,9998,0,9999,1
1746614022352,CAT 124RS,A01,956906,Staff,6,0,25,19
1746614023381,CAT 125RS,A01,922013,Staff,6,0,25,19
1746614024407,CLRE 250,A00,891860,Morris; Sheldon,9995,0,9999,4
1746614026462,CLRE 251R,A00,907817,Mehta; Ravindra L.,9994,0,9999,5
1746614027488,CLRE 252,A00,891864,Cuomo; Raphael Eduardo,9993,0,9999,6
1746614028519,CLRE 253,A00,891867,Vaida; Florin,9994,0,9999,5
1746614028519,CLRE 253,B00,907819,Staff,9999,0,9999,0
1746614029546,CLRE 259,A00,891868,Patel; Hemal,9998,0,9999,1
1746614030575,CLRE 260,A00,891872,Cuomo; Raphael Eduardo,9999,0,9999,0
1746614031604,CLRE 297,001,891888,Cuomo; Raphael Eduardo,9999,0,9999,0
1746614032635,CSE 191,A00,958773,Minnes Kemp; Mor Mia,9995,0,9999,4
1746614033661,CSE 197,001,959846,Minnes Kemp; Mor Mia,9990,0,9999,9
1746614034691,CSS 201S,A01,892054,Mignozzetti; Umberto,25,0,30,5
1746614035726,CSS 202S,A01,892056,Mignozzetti; Umberto,25,0,30,5
1746614036753,DSC 197,001,956898,Eldridge; Justin Matthew,9996,0,9999,3
1746614037783,DSC 297,001,958000,Mazumdar; Arya,9998,0,9999,1
1746614037783,DSC 297,002,959862,Wang; Yusu,9998,0,9999,1
1746614038816,EAP 100,A00,905686,Staff,9778,0,9999,221
1746614039843,ECE 45,A01,892618,Staff,0,0,65,65
1746614041903,ECE 111,A01,892719,Staff,6,0,65,59
1746614042928,ECE 197,001,957920,Mercier; Patrick Philip,9991,0,9999,8
1746614043957,ECON 178,A01,907814,Zhu; Ying,26,0,35,9
1746614044998,EDS 115,A00,895312,Staff,35,0,45,10
1746614046026,EDS 117,A01,895337,Staff,23,0,30,7
1746614047052,EDS 125,A00,895341,Jones; Gabrielle Anastasia,36,0,45,9
1746614048080,EDS 128A,A01,895459,Fargason; Sharon Gayle,44,0,45,1
1746614049108,EDS 128B,A01,895543,Pappas; Elizabeth,44,0,45,1
1746614050138,EDS 139,A00,897203,Pappas; Elizabeth,44,0,45,1
1746614050138,EDS 139,B00,897209,Fargason; Sharon Gayle,41,0,45,4
1746614051167,EDS 201,A00,895545,Staff,22,0,45,23
1746614052199,EDS 203,A01,895581,Halter; Christopher P.,22,0,45,23
1746614053225,EDS 204R,A01,895625,Heinzman; Erica M.,39,0,45,6
1746614053225,EDS 204R,B01,895693,Halter; Christopher P.,10,0,45,35
1746614054252,EDS 206R,A00,895694,Fargason; Sharon Gayle,1,0,30,29
1746614054252,EDS 206R,B00,895695,Choi; Bailey Miyeon,16,0,30,14
1746614055279,EDS 250,A00,895697,Hemans; Patricia Ann Benitez,22,0,45,23
1746614056306,EDS 281,A00,895701,Meyerott; Theresa Ann,1,0,15,14
1746614057332,EDS 284,A00,895736,Meyerott; Theresa Ann,1,0,15,14
1746614058360,EDS 286,A00,897210,Fine; Sarah,0,0,15,15
1746614059390,EDS 289C,A01,895770,Daly; Alan J.,1,0,15,14
1746614060419,EDS 290,A00,897211,Hofstetter; Carolyn,0,0,15,15
1746614061446,LIGM 5A,A00,896162,Fischer-Grunski; Eva K,12,0,20,8
1746614062472,LIGM 5B,A00,896260,Fischer-Grunski; Eva K,17,0,20,3
1746614063500,LIGM 5C,A00,896308,Fischer-Grunski; Eva K,18,0,20,2
1746614064527,LIIT 5AS,A00,896313,Carnelos; Chiara,18,0,20,2
1746614065558,LIIT 5BS,A00,896416,Carnelos; Chiara,20,0,20,0
1746614066586,LIIT 5CS,A00,896564,Carnelos; Chiara,20,0,20,0
1746614067614,LISP 5A,A00,896588,Munoz Sanchez; Alicia,2,0,20,18
1746614068644,LISP 5B,A00,896653,Munoz Sanchez; Alicia,7,0,20,13
1746614069672,LISP 5C,A00,896655,Munoz Sanchez; Alicia,0,1,20,20
1746614070700,MAE 197,001,957918,Kleissl; Jan,9996,0,9999,3
1746614070700,MAE 197,002,959806,Boechler; Nicholas Sebastia,9998,0,9999,1
1746614070700,MAE 197,003,959852,Mullin; Jennifer S,9998,0,9999,1
1746614071730,MATH 2,A01,957937,Staff,33,0,35,2
1746614072757,MATH 197,001,957876,Kedlaya; Kiran S.,9993,0,9999,6
1746614073786,MCWP 40,A00,892729,Duru; Nur,10,0,20,10
1746614073786,MCWP 40,B00,893304,Montejo; Carolina,14,0,20,6
1746614074815,MCWP 40R,A00,893757,Redela; Pamela Morgan,0,5,20,20
1746614075845,MCWP 50,A00,893758,Morshed; Michael James,0,0,20,20
1746614075845,MCWP 50,B00,893761,Bartulis; Jason Michael,16,0,20,4
1746614076879,MCWP 50R,A00,893766,Compas; Sean Matthew,0,1,20,20
1746614076879,MCWP 50R,B00,893769,Carter; Jennifer A,0,1,20,20
1746614076879,MCWP 50R,C00,893771,Krone; Jarret,0,3,20,20
1746614076879,MCWP 50R,D00,893772,Miller; Elizabeth Deen,0,0,20,20
1746614076879,MCWP 50R,E00,893775,Carter; Andrea L,0,1,20,20
1746614077911,MMW 11R,A01,892721,Herbst; Matthew,14,0,30,16
1746614077911,MMW 11R,A02,892722,Herbst; Matthew,0,0,0,3
1746614078937,MMW 12R,A01,892724,Herbst; Matthew,0,11,16,16
1746614078937,MMW 12R,A02,892725,Herbst; Matthew,0,10,16,16
1746614079965,MMW 13R,A01,892727,Staff,0,4,16,16
1746614079965,MMW 13R,A02,892728,Staff,0,4,16,16
1746614079965,MMW 13R,A03,958032,Staff,0,4,16,16
1746614079965,MMW 13R,A04,958033,Staff,0,4,16,16
1746614079965,MMW 13R,A05,958034,Staff,0,4,16,16
1746614080994,SIO 295LS,A00,894015,Staff,5,0,25,20
1746614082039,SIO 295S,A00,894020,Staff,5,0,25,20
1746614083068,SIOC 290S,B01,958918,Merrifield; Mark A,14,0,30,16
1746614084095,SIOC 291S,B01,958922,Gabriel; Corey John,14,0,30,16
1746614085120,SOCI 117,A01,895339,Staff,2,0,5,3
1746614086147,WES 237B,A00,894149,Staff,11,0,20,9
1746614088221,AESE 279B,A00,891859,Staff,13,0,35,22
1746614089248,AIP 197,001,891854,Vespa; Emanuel Ignacio,9999,0,9999,0
1746614090333,ANTH 289S,A00,891856,Gagneux; Pascal,12,0,12,0
1746614091360,BENG 196,001,957946,Engler; Adam J.,9996,0,9999,3
1746614092398,BISP 197,001,959851,Wilhelm; James E.,9998,0,9999,1
1746614093425,CAT 124RS,A01,956906,Staff,6,0,25,19
1746614094453,CAT 125RS,A01,922013,Staff,6,0,25,19
1746614095486,CLRE 250,A00,891860,Morris; Sheldon,9995,0,9999,4
1746614097547,CLRE 251R,A00,907817,Mehta; Ravindra L.,9994,0,9999,5
1746614098579,CLRE 252,A00,891864,Cuomo; Raphael Eduardo,9993,0,9999,6
1746614099607,CLRE 253,A00,891867,Vaida; Florin,9994,0,9999,5
1746614099607,CLRE 253,B00,907819,Staff,9999,0,9999,0
1746614100633,CLRE 259,A00,891868,Patel; Hemal,9998,0,9999,1
1746614101660,CLRE 260,A00,891872,Cuomo; Raphael Eduardo,9999,0,9999,0
1746614102689,CLRE 297,001,891888,Cuomo; Raphael Eduardo,9999,0,9999,0
1746614103724,CSE 191,A00,958773,Minnes Kemp; Mor Mia,9995,0,9999,4
1746614104756,CSE 197,001,959846,Minnes Kemp; Mor Mia,9990,0,9999,9
1746614105784,CSS 201S,A01,892054,Mignozzetti; Umberto,25,0,30,5
1746614106814,CSS 202S,A01,892056,Mignozzetti; Umberto,25,0,30,5
1746614107846,DSC 197,001,956898,Eldridge; Justin Matthew,9996,0,9999,3
1746614108874,DSC 297,001,958000,Mazumdar; Arya,9998,0,9999,1
1746614108874,DSC 297,002,959862,Wang; Yusu,9998,0,9999,1
1746614109903,EAP 100,A00,905686,Staff,9778,0,9999,221
1746614110933,ECE 45,A01,892618,Staff,0,0,65,65
1746614112990,ECE 111,A01,892719,Staff,6,0,65,59
1746614114022,ECE 197,001,957920,Mercier; Patrick Philip,9991,0,9999,8
1746614115053,ECON 178,A01,907814,Zhu; Ying,26,0,35,9
1746614116080,EDS 115,A00,895312,Staff,35,0,45,10
1746614117107,EDS 117,A01,895337,Staff,23,0,30,7
1746614118133,EDS 125,A00,895341,Jones; Gabrielle Anastasia,36,0,45,9
1746614119161,EDS 128A,A01,895459,Fargason; Sharon Gayle,44,0,45,1
1746614120194,EDS 128B,A01,895543,Pappas; Elizabeth,44,0,45,1
1746614121219,EDS 139,A00,897203,Pappas; Elizabeth,44,0,45,1
1746614121219,EDS 139,B00,897209,Fargason; Sharon Gayle,41,0,45,4
1746614122246,EDS 201,A00,895545,Staff,22,0,45,23
1746614123274,EDS 203,A01,895581,Halter; Christopher P.,22,0,45,23
1746614124308,EDS 204R,A01,895625,Heinzman; Erica M.,39,0,45,6
1746614124308,EDS 204R,B01,895693,Halter; Christopher P.,10,0,45,35
1746614125340,EDS 206R,A00,895694,Fargason; Sharon Gayle,1,0,30,29
1746614125340,EDS 206R,B00,895695,Choi; Bailey Miyeon,16,0,30,14
1746614126368,EDS 250,A00,895697,Hemans; Patricia Ann Benitez,22,0,45,23
1746614127395,EDS 281,A00,895701,Meyerott; Theresa Ann,1,0,15,14
1746614128421,EDS 284,A00,895736,Meyerott; Theresa Ann,1,0,15,14
1746614129448,EDS 286,A00,897210,Fine; Sarah,0,0,15,15
1746614130476,EDS 289C,A01,895770,Daly; Alan J.,1,0,15,14
1746614131506,EDS 290,A00,897211,Hofstetter; Carolyn,0,0,15,15
1746614132534,LIGM 5A,A00,896162,Fischer-Grunski; Eva K,12,0,20,8
1746614133562,LIGM 5B,A00,896260,Fischer-Grunski; Eva K,17,0,20,3
1746614134591,LIGM 5C,A00,896308,Fischer-Grunski; Eva K,18,0,20,2
1746614135628,LIIT 5AS,A00,896313,Carnelos; Chiara,18,0,20,2
1746614136658,LIIT 5BS,A00,896416,Carnelos; Chiara,20,0,20,0
1746614137684,LIIT 5CS,A00,896564,Carnelos; Chiara,20,0,20,0
1746614138713,LISP 5A,A00,896588,Munoz Sanchez; Alicia,2,0,20,18
1746614139748,LISP 5B,A00,896653,Munoz Sanchez; Alicia,7,0,20,13
1746614140778,LISP 5C,A00,896655,Munoz Sanchez; Alicia,0,1,20,20
1746614141805,MAE 197,001,957918,Kleissl; Jan,9996,0,9999,3
1746614141805,MAE 197,002,959806,Boechler; Nicholas Sebastia,9998,0,9999,1
1746614141805,MAE 197,003,959852,Mullin; Jennifer S,9998,0,9999,1
1746614142833,MATH 2,A01,957937,Staff,33,0,35,2
1746614143864,MATH 197,001,957876,Kedlaya; Kiran S.,9993,0,9999,6
1746614144900,MCWP 40,A00,892729,Duru; Nur,10,0,20,10
1746614144900,MCWP 40,B00,893304,Montejo; Carolina,14,0,20,6
1746614145933,MCWP 40R,A00,893757,Redela; Pamela Morgan,0,5,20,20
1746614146972,MCWP 50,A00,893758,Morshed; Michael James,0,0,20,20
1746614146972,MCWP 50,B00,893761,Bartulis; Jason Michael,16,0,20,4
1746614148004,MCWP 50R,A00,893766,Compas; Sean Matthew,0,1,20,20
1746614148004,MCWP 50R,B00,893769,Carter; Jennifer A,0,1,20,20
1746614148004,MCWP 50R,C00,893771,Krone; Jarret,0,3,20,20
1746614148004,MCWP 50R,D00,893772,Miller; Elizabeth Deen,0,0,20,20
1746614148004,MCWP 50R,E00,893775,Carter; Andrea L,0,1,20,20
1746614149035,MMW 11R,A01,892721,Herbst; Matthew,14,0,30,16
1746614149035,MMW 11R,A02,892722,Herbst; Matthew,0,0,0,3
1746614150062,MMW 12R,A01,892724,Herbst; Matthew,0,11,16,16
1746614150062,MMW 12R,A02,892725,Herbst; Matthew,0,10,16,16
1746614151095,MMW 13R,A01,892727,Staff,0,4,16,16
1746614151095,MMW 13R,A02,892728,Staff,0,4,16,16
1746614151095,MMW 13R,A03,958032,Staff,0,4,16,16
1746614151095,MMW 13R,A04,958033,Staff,0,4,16,16
1746614151095,MMW 13R,A05,958034,Staff,0,4,16,16
1746614152124,SIO 295LS,A00,894015,Staff,5,0,25,20
1746614153150,SIO 295S,A00,894020,Staff,5,0,25,20
1746614154180,SIOC 290S,B01,958918,Merrifield; Mark A,14,0,30,16
1746614155209,SIOC 291S,B01,958922,Gabriel; Corey John,14,0,30,16
1746614156237,SOCI 117,A01,895339,Staff,2,0,5,3
1746614157271,WES 237B,A00,894149,Staff,11,0,20,9
1746614159358,AESE 279B,A00,891859,Staff,13,0,35,22
1746614160392,AIP 197,001,891854,Vespa; Emanuel Ignacio,9999,0,9999,0
1746614161422,ANTH 289S,A00,891856,Gagneux; Pascal,12,0,12,0
1746614162450,BENG 196,001,957946,Engler; Adam J.,9996,0,9999,3
1746614163481,BISP 197,001,959851,Wilhelm; James E.,9998,0,9999,1
1746614164510,CAT 124RS,A01,956906,Staff,6,0,25,19
1746614165540,CAT 125RS,A01,922013,Staff,6,0,25,19
1746614166570,CLRE 250,A00,891860,Morris; Sheldon,9995,0,9999,4
1746614168622,CLRE 251R,A00,907817,Mehta; Ravindra L.,9994,0,9999,5
1746614169652,CLRE 252,A00,891864,Cuomo; Raphael Eduardo,9993,0,9999,6
1746614170684,CLRE 253,A00,891867,Vaida; Florin,9994,0,9999,5
1746614170684,CLRE 253,B00,907819,Staff,9999,0,9999,0
1746614171715,CLRE 259,A00,891868,Patel; Hemal,9998,0,9999,1
1746614172741,CLRE 260,A00,891872,Cuomo; Raphael Eduardo,9999,0,9999,0
1746614173772,CLRE 297,001,891888,Cuomo; Raphael Eduardo,9999,0,9999,0
1746614174799,CSE 191,A00,958773,Minnes Kemp; Mor Mia,9995,0,9999,4
1746614175830,CSE 197,001,959846,Minnes Kemp; Mor Mia,9990,0,9999,9
1746614176859,CSS 201S,A01,892054,Mignozzetti; Umberto,25,0,30,5
1746614177888,CSS 202S,A01,892056,Mignozzetti; Umberto,25,0,30,5
1746614178916,DSC 197,001,956898,Eldridge; Justin Matthew,9996,0,9999,3
1746614179944,DSC 297,001,958000,Mazumdar; Arya,9998,0,9999,1
1746614179944,DSC 297,002,959862,Wang; Yusu,9998,0,9999,1
1746614180971,EAP 100,A00,905686,Staff,9778,0,9999,221
1746614182001,ECE 45,A01,892618,Staff,0,0,65,65
1746614184056,ECE 111,A01,892719,Staff,6,0,65,59
1746614185083,ECE 197,001,957920,Mercier; Patrick Philip,9991,0,9999,8
1746614186130,ECON 178,A01,907814,Zhu; Ying,26,0,35,9
1746614187161,EDS 115,A00,895312,Staff,35,0,45,10
1746614188185,EDS 117,A01,895337,Staff,23,0,30,7
1746614189217,EDS 125,A00,895341,Jones; Gabrielle Anastasia,36,0,45,9
1746614190250,EDS 128A,A01,895459,Fargason; Sharon Gayle,44,0,45,1
1746614191278,EDS 128B,A01,895543,Pappas; Elizabeth,44,0,45,1
1746614192308,EDS 139,A00,897203,Pappas; Elizabeth,44,0,45,1
1746614192308,EDS 139,B00,897209,Fargason; Sharon Gayle,41,0,45,4
1746614193333,EDS 201,A00,895545,Staff,22,0,45,23
1746614194365,EDS 203,A01,895581,Halter; Christopher P.,22,0,45,23
1746614195398,EDS 204R,A01,895625,Heinzman; Erica M.,39,0,45,6
1746614195398,EDS 204R,B01,895693,Halter; Christopher P.,10,0,45,35
1746614196424,EDS 206R,A00,895694,Fargason; Sharon Gayle,1,0,30,29
1746614196424,EDS 206R,B00,895695,Choi; Bailey Miyeon,16,0,30,14
1746614197450,EDS 250,A00,895697,Hemans; Patricia Ann Benitez,22,0,45,23
1746614198490,EDS 281,A00,895701,Meyerott; Theresa Ann,1,0,15,14
1746614199518,EDS 284,A00,895736,Meyerott; Theresa Ann,1,0,15,14
1746614200549,EDS 286,A00,897210,Fine; Sarah,0,0,15,15
1746614201579,EDS 289C,A01,895770,Daly; Alan J.,1,0,15,14
1746614202604,EDS 290,A00,897211,Hofstetter; Carolyn,0,0,15,15
1746614203653,LIGM 5A,A00,896162,Fischer-Grunski; Eva K,12,0,20,8
1746614204680,LIGM 5B,A00,896260,Fischer-Grunski; Eva K,17,0,20,3
1746614205708,LIGM 5C,A00,896308,Fischer-Grunski; Eva K,18,0,20,2
1746614206737,LIIT 5AS,A00,896313,Carnelos; Chiara,18,0,20,2
1746614207763,LIIT 5BS,A00,896416,Carnelos; Chiara,20,0,20,0
1746614208789,LIIT 5CS,A00,896564,Carnelos; Chiara,20,0,20,0
1746614209818,LISP 5A,A00,896588,Munoz Sanchez; Alicia,2,0,20,18
1746614210845,LISP 5B,A00,896653,Munoz Sanchez; Alicia,7,0,20,13
1746614211871,LISP 5C,A00,896655,Munoz Sanchez; Alicia,0,1,20,20
1746614212903,MAE 197,001,957918,Kleissl; Jan,9996,0,9999,3
1746614212903,MAE 197,002,959806,Boechler; Nicholas Sebastia,9998,0,9999,1
1746614212903,MAE 197,003,959852,Mullin; Jennifer S,9998,0,9999,1
1746614213932,MATH 2,A01,957937,Staff,33,0,35,2
1746614214959,MATH 197,001,957876,Kedlaya; Kiran S.,9993,0,9999,6
1746614215986,MCWP 40,A00,892729,Duru; Nur,10,0,20,10
1746614215986,MCWP 40,B00,893304,Montejo; Carolina,14,0,20,6
1746614217020,MCWP 40R,A00,893757,Redela; Pamela Morgan,0,5,20,20
1746614218052,MCWP 50,A00,893758,Morshed; Michael James,0,0,20,20
1746614218052,MCWP 50,B00,893761,Bartulis; Jason Michael,16,0,20,4
1746614219089,MCWP 50R,A00,893766,Compas; Sean Matthew,0,1,20,20
1746614219089,MCWP 50R,B00,893769,Carter; Jennifer A,0,1,20,20
1746614219089,MCWP 50R,C00,893771,Krone; Jarret,0,3,20,20
1746614219089,MCWP 50R,D00,893772,Miller; Elizabeth Deen,0,0,20,20
1746614219089,MCWP 50R,E00,893775,Carter; Andrea L,0,1,20,20
1746614220115,MMW 11R,A01,892721,Herbst; Matthew,14,0,30,16
1746614220115,MMW 11R,A02,892722,Herbst; Matthew,0,0,0,3
1746614221143,MMW 12R,A01,892724,Herbst; Matthew,0,11,16,16
1746614221143,MMW 12R,A02,892725,Herbst; Matthew,0,10,16,16
1746614222171,MMW 13R,A01,892727,Staff,0,4,16,16
1746614222171,MMW 13R,A02,892728,Staff,0,4,16,16
1746614222171,MMW 13R,A03,958032,Staff,0,4,16,16
1746614222171,MMW 13R,A04,958033,Staff,0,4,16,16
1746614222171,MMW 13R,A05,958034,Staff,0,4,16,16
1746614223204,SIO 295LS,A00,894015,Staff,5,0,25,20
1746614224232,SIO 295S,A00,894020,Staff,5,0,25,20
1746614225264,SIOC 290S,B01,958918,Merrifield; Mark A,14,0,30,16
1746614226291,SIOC 291S,B01,958922,Gabriel; Corey John,14,0,30,16
1746614227317,SOCI 117,A01,895339,Staff,2,0,5,3
1746614228343,WES 237B,A00,894149,Staff,11,0,20,9
1746614230452,AESE 279B,A00,891859,Staff,13,0,35,22
1746614231478,AIP 197,001,891854,Vespa; Emanuel Ignacio,9999,0,9999,0
1746614232509,ANTH 289S,A00,891856,Gagneux; Pascal,12,0,12,0
1746614233542,BENG 196,001,957946,Engler; Adam J.,9996,0,9999,3
1746614234567,BISP 197,001,959851,Wilhelm; James E.,9998,0,9999,1
1746614235592,CAT 124RS,A01,956906,Staff,6,0,25,19
1746614236618,CAT 125RS,A01,922013,Staff,6,0,25,19
1746614237648,CLRE 250,A00,891860,Morris; Sheldon,9995,0,9999,4
1746614239702,CLRE 251R,A00,907817,Mehta; Ravindra L.,9994,0,9999,5
1746614240731,CLRE 252,A00,891864,Cuomo; Raphael Eduardo,9993,0,9999,6
1746614241763,CLRE 253,A00,891867,Vaida; Florin,9994,0,9999,5
1746614241763,CLRE 253,B00,907819,Staff,9999,0,9999,0
1746614242797,CLRE 259,A00,891868,Patel; Hemal,9998,0,9999,1
1746614243830,CLRE 260,A00,891872,Cuomo; Raphael Eduardo,9999,0,9999,0
1746614244856,CLRE 297,001,891888,Cuomo; Raphael Eduardo,9999,0,9999,0
1746614245888,CSE 191,A00,958773,Minnes Kemp; Mor Mia,9995,0,9999,4
1746614246915,CSE 197,001,959846,Minnes Kemp; Mor Mia,9990,0,9999,9
1746614247943,CSS 201S,A01,892054,Mignozzetti; Umberto,25,0,30,5
1746614248970,CSS 202S,A01,892056,Mignozzetti; Umberto,25,0,30,5
1746614250001,DSC 197,001,956898,Eldridge; Justin Matthew,9996,0,9999,3
1746614251039,DSC 297,001,958000,Mazumdar; Arya,9998,0,9999,1
1746614251039,DSC 297,002,959862,Wang; Yusu,9998,0,9999,1
1746614252069,EAP 100,A00,905686,Staff,9778,0,9999,221
1746614253108,ECE 45,A01,892618,Staff,0,0,65,65
1746614255168,ECE 111,A01,892719,Staff,6,0,65,59
1746614256202,ECE 197,001,957920,Mercier; Patrick Philip,9991,0,9999,8
1746614257229,ECON 178,A01,907814,Zhu; Ying,26,0,35,9
1746614258262,EDS 115,A00,895312,Staff,35,0,45,10
1746614259290,EDS 117,A01,895337,Staff,23,0,30,7
1746614260317,EDS 125,A00,895341,Jones; Gabrielle Anastasia,36,0,45,9
1746614261346,EDS 128A,A01,895459,Fargason; Sharon Gayle,44,0,45,1
1746614262373,EDS 128B,A01,895543,Pappas; Elizabeth,44,0,45,1
1746614263398,EDS 139,A00,897203,Pappas; Elizabeth,44,0,45,1
1746614263398,EDS 139,B00,897209,Fargason; Sharon Gayle,41,0,45,4
1746614264431,EDS 201,A00,895545,Staff,22,0,45,23
1746614265463,EDS 203,A01,895581,Halter; Christopher P.,22,0,45,23
1746614266491,EDS 204R,A01,895625,Heinzman; Erica M.,39,0,45,6
1746614266491,EDS 204R,B01,895693,Halter; Christopher P.,10,0,45,35
1746614267519,EDS 206R,A00,895694,Fargason; Sharon Gayle,1,0,30,29
1746614267519,EDS 206R,B00,895695,Choi; Bailey Miyeon,16,0,30,14
1746614268549,EDS 250,A00,895697,Hemans; Patricia Ann Benitez,22,0,45,23
1746614269580,EDS 281,A00,895701,Meyerott; Theresa Ann,1,0,15,14
1746614270612,EDS 284,A00,895736,Meyerott; Theresa Ann,1,0,15,14
1746614271645,EDS 286,A00,897210,Fine; Sarah,0,0,15,15
1746614272677,EDS 289C,A01,895770,Daly; Alan J.,1,0,15,14
1746614273706,EDS 290,A00,897211,Hofstetter; Carolyn,0,0,15,15
1746614274734,LIGM 5A,A00,896162,Fischer-Grunski; Eva K,12,0,20,8
1746614275766,LIGM 5B,A00,896260,Fischer-Grunski; Eva K,17,0,20,3
1746614276800,LIGM 5C,A00,896308,Fischer-Grunski; Eva K,18,0,20,2
1746614277833,LIIT 5AS,A00,896313,Carnelos; Chiara,18,0,20,2
1746614278860,LIIT 5BS,A00,896416,Carnelos; Chiara,20,0,20,0
1746614279889,LIIT 5CS,A00,896564,Carnelos; Chiara,20,0,20,0
1746614280923,LISP 5A,A00,896588,Munoz Sanchez; Alicia,2,0,20,18
1746614281951,LISP 5B,A00,896653,Munoz Sanchez; Alicia,7,0,20,13
1746614282977,LISP 5C,A00,896655,Munoz Sanchez; Alicia,0,1,20,20
1746614284005,MAE 197,001,957918,Kleissl; Jan,9996,0,9999,3
1746614284005,MAE 197,002,959806,Boechler; Nicholas Sebastia,9998,0,9999,1
1746614284005,MAE 197,003,959852,Mullin; Jennifer S,9998,0,9999,1
1746614285039,MATH 2,A01,957937,Staff,33,0,35,2
1746614286065,MATH 197,001,957876,Kedlaya; Kiran S.,9993,0,9999,6
1746614287097,MCWP 40,A00,892729,Duru; Nur,10,0,20,10
1746614287097,MCWP 40,B00,893304,Montejo; Carolina,14,0,20,6
1746614288127,MCWP 40R,A00,893757,Redela; Pamela Morgan,0,5,20,20
1746614289153,MCWP 50,A00,893758,Morshed; Michael James,0,0,20,20
1746614289153,MCWP 50,B00,893761,Bartulis; Jason Michael,16,0,20,4
1746614290189,MCWP 50R,A00,893766,Compas; Sean Matthew,0,1,20,20
1746614290189,MCWP 50R,B00,893769,Carter; Jennifer A,0,1,20,20
1746614290189,MCWP 50R,C00,893771,Krone; Jarret,0,3,20,20
1746614290189,MCWP 50R,D00,893772,Miller; Elizabeth Deen,0,0,20,20
1746614290189,MCWP 50R,E00,893775,Carter; Andrea L,0,1,20,20
1746614291223,MMW 11R,A01,892721,Herbst; Matthew,14,0,30,16
1746614291223,MMW 11R,A02,892722,Herbst; Matthew,0,0,0,3
1746614292251,MMW 12R,A01,892724,Herbst; Matthew,0,11,16,16
1746614292251,MMW 12R,A02,892725,Herbst; Matthew,0,10,16,16
1746614293276,MMW 13R,A01,892727,Staff,0,4,16,16
1746614293276,MMW 13R,A02,892728,Staff,0,4,16,16
1746614293276,MMW 13R,A03,958032,Staff,0,4,16,16
1746614293276,MMW 13R,A04,958033,Staff,0,4,16,16
1746614293276,MMW 13R,A05,958034,Staff,0,4,16,16
1746614294309,SIO 295LS,A00,894015,Staff,5,0,25,20
1746614295345,SIO 295S,A00,894020,Staff,5,0,25,20
1746614296381,SIOC 290S,B01,958918,Merrifield; Mark A,14,0,30,16
1746614297418,SIOC 291S,B01,958922,Gabriel; Corey John,14,0,30,16
1746614298449,SOCI 117,A01,895339,Staff,2,0,5,3
1746614299475,WES 237B,A00,894149,Staff,11,0,20,9
1746614301590,AESE 279B,A00,891859,Staff,13,0,35,22
1746614302618,AIP 197,001,891854,Vespa; Emanuel Ignacio,9999,0,9999,0
1746614303644,ANTH 289S,A00,891856,Gagneux; Pascal,12,0,12,0
1746614304670,BENG 196,001,957946,Engler; Adam J.,9996,0,9999,3
1746614305698,BISP 197,001,959851,Wilhelm; James E.,9998,0,9999,1
1746614306724,CAT 124RS,A01,956906,Staff,6,0,25,19
1746614307751,CAT 125RS,A01,922013,Staff,6,0,25,19
1746614308781,CLRE 250,A00,891860,Morris; Sheldon,9995,0,9999,4
1746614310837,CLRE 251R,A00,907817,Mehta; Ravindra L.,9994,0,9999,5
1746614311870,CLRE 252,A00,891864,Cuomo; Raphael Eduardo,9993,0,9999,6
1746614312902,CLRE 253,A00,891867,Vaida; Florin,9994,0,9999,5
1746614312902,CLRE 253,B00,907819,Staff,9999,0,9999,0
1746614313933,CLRE 259,A00,891868,Patel; Hemal,9998,0,9999,1
1746614314961,CLRE 260,A00,891872,Cuomo; Raphael Eduardo,9999,0,9999,0
1746614315991,CLRE 297,001,891888,Cuomo; Raphael Eduardo,9999,0,9999,0
1746614317024,CSE 191,A00,958773,Minnes Kemp; Mor Mia,9995,0,9999,4
1746614318053,CSE 197,001,959846,Minnes Kemp; Mor Mia,9990,0,9999,9
1746614319089,CSS 201S,A01,892054,Mignozzetti; Umberto,25,0,30,5
1746614320116,CSS 202S,A01,892056,Mignozzetti; Umberto,25,0,30,5
1746614321148,DSC 197,001,956898,Eldridge; Justin Matthew,9996,0,9999,3
1746614322175,DSC 297,001,958000,Mazumdar; Arya,9998,0,9999,1
1746614322175,DSC 297,002,959862,Wang; Yusu,9998,0,9999,1
1746614323201,EAP 100,A00,905686,Staff,9778,0,9999,221
1746614324232,ECE 45,A01,892618,Staff,0,0,65,65
1746614326284,ECE 111,A01,892719,Staff,6,0,65,59
1746614327318,ECE 197,001,957920,Mercier; Patrick Philip,9991,0,9999,8
1746614328346,ECON 178,A01,907814,Zhu; Ying,26,0,35,9
1746614329377,EDS 115,A00,895312,Staff,35,0,45,10
1746614330405,EDS 117,A01,895337,Staff,23,0,30,7
1746614331438,EDS 125,A00,895341,Jones; Gabrielle Anastasia,36,0,45,9
1746614332464,EDS 128A,A01,895459,Fargason; Sharon Gayle,44,0,45,1
1746614333490,EDS 128B,A01,895543,Pappas; Elizabeth,44,0,45,1
1746614334515,EDS 139,A00,897203,Pappas; Elizabeth,44,0,45,1
1746614334515,EDS 139,B00,897209,Fargason; Sharon Gayle,41,0,45,4
1746614335542,EDS 201,A00,895545,Staff,22,0,45,23
1746614336571,EDS 203,A01,895581,Halter; Christopher P.,22,0,45,23
1746614337603,EDS 204R,A01,895625,Heinzman; Erica M.,39,0,45,6
1746614337603,EDS 204R,B01,895693,Halter; Christopher P.,10,0,45,35
1746614338636,EDS 206R,A00,895694,Fargason; Sharon Gayle,1,0,30,29
1746614338636,EDS 206R,B00,895695,Choi; Bailey Miyeon,16,0,30,14
1746614339670,EDS 250,A00,895697,Hemans; Patricia Ann Benitez,22,0,45,23
1746614340698,EDS 281,A00,895701,Meyerott; Theresa Ann,1,0,15,14
1746614341728,EDS 284,A00,895736,Meyerott; Theresa Ann,1,0,15,14
1746614342755,EDS 286,A00,897210,Fine; Sarah,0,0,15,15
1746614343788,EDS 289C,A01,895770,Daly; Alan J.,1,0,15,14
1746614344815,EDS 290,A00,897211,Hofstetter; Carolyn,0,0,15,15
1746614345843,LIGM 5A,A00,896162,Fischer-Grunski; Eva K,12,0,20,8
1746614346870,LIGM 5B,A00,896260,Fischer-Grunski; Eva K,17,0,20,3
1746614347898,LIGM 5C,A00,896308,Fischer-Grunski; Eva K,18,0,20,2
1746614348928,LIIT 5AS,A00,896313,Carnelos; Chiara,18,0,20,2
1746614349961,LIIT 5BS,A00,896416,Carnelos; Chiara,20,0,20,0
1746614350989,LIIT 5CS,A00,896564,Carnelos; Chiara,20,0,20,0
1746614352019,LISP 5A,A00,896588,Munoz Sanchez; Alicia,2,0,20,18
1746614353045,LISP 5B,A00,896653,Munoz Sanchez; Alicia,7,0,20,13
1746614354071,LISP 5C,A00,896655,Munoz Sanchez; Alicia,0,1,20,20
1746614355100,MAE 197,001,957918,Kleissl; Jan,9996,0,9999,3
1746614355100,MAE 197,002,959806,Boechler; Nicholas Sebastia,9998,0,9999,1
1746614355100,MAE 197,003,959852,Mullin; Jennifer S,9998,0,9999,1
1746614356127,MATH 2,A01,957937,Staff,33,0,35,2
1746614357157,MATH 197,001,957876,Kedlaya; Kiran S.,9993,0,9999,6
1746614358184,MCWP 40,A00,892729,Duru; Nur,10,0,20,10
1746614358184,MCWP 40,B00,893304,Montejo; Carolina,14,0,20,6
1746614359218,MCWP 40R,A00,893757,Redela; Pamela Morgan,0,5,20,20
1746614360247,MCWP 50,A00,893758,Morshed; Michael James,0,0,20,20
1746614360247,MCWP 50,B00,893761,Bartulis; Jason Michael,16,0,20,4
1746614361283,MCWP 50R,A00,893766,Compas; Sean Matthew,0,1,20,20
1746614361283,MCWP 50R,B00,893769,Carter; Jennifer A,0,1,20,20
1746614361283,MCWP 50R,C00,893771,Krone; Jarret,0,3,20,20
1746614361283,MCWP 50R,D00,893772,Miller; Elizabeth Deen,0,0,20,20
1746614361283,MCWP 50R,E00,893775,Carter; Andrea L,0,1,20,20
1746614362311,MMW 11R,A01,892721,Herbst; Matthew,14,0,30,16
1746614362311,MMW 11R,A02,892722,Herbst; Matthew,0,0,0,3
1746614363344,MMW 12R,A01,892724,Herbst; Matthew,0,11,16,16
1746614363344,MMW 12R,A02,892725,Herbst; Matthew,0,10,16,16
1746614364374,MMW 13R,A01,892727,Staff,0,4,16,16
1746614364374,MMW 13R,A02,892728,Staff,0,4,16,16
1746614364374,MMW 13R,A03,958032,Staff,0,4,16,16
1746614364374,MMW 13R,A04,958033,Staff,0,4,16,16
1746614364374,MMW 13R,A05,958034,Staff,0,4,16,16
1746614365403,SIO 295LS,A00,894015,Staff,5,0,25,20
1746614366433,SIO 295S,A00,894020,Staff,5,0,25,20
1746614367462,SIOC 290S,B01,958918,Merrifield; Mark A,14,0,30,16
1746614368498,SIOC 291S,B01,958922,Gabriel; Corey John,14,0,30,16
1746614369526,SOCI 117,A01,895339,Staff,2,0,5,3
1746614370554,WES 237B,A00,894149,Staff,11,0,20,9
1746614372652,AESE 279B,A00,891859,Staff,13,0,35,22
1746614373679,AIP 197,001,891854,Vespa; Emanuel Ignacio,9999,0,9999,0
1746614374711,ANTH 289S,A00,891856,Gagneux; Pascal,12,0,12,0
1746614375738,BENG 196,001,957946,Engler; Adam J.,9996,0,9999,3
1746614376765,BISP 197,001,959851,Wilhelm; James E.,9998,0,9999,1
1746614377791,CAT 124RS,A01,956906,Staff,6,0,25,19
1746614378823,CAT 125RS,A01,922013,Staff,6,0,25,19
1746614379853,CLRE 250,A00,891860,Morris; Sheldon,9995,0,9999,4
1746614381909,CLRE 251R,A00,907817,Mehta; Ravindra L.,9994,0,9999,5
1746614382935,CLRE 252,A00,891864,Cuomo; Raphael Eduardo,9993,0,9999,6
1746614383966,CLRE 253,A00,891867,Vaida; Florin,9994,0,9999,5
1746614383966,CLRE 253,B00,907819,Staff,9999,0,9999,0
1746614384998,CLRE 259,A00,891868,Patel; Hemal,9998,0,9999,1
1746614386025,CLRE 260,A00,891872,Cuomo; Raphael Eduardo,9999,0,9999,0
1746614387052,CLRE 297,001,891888,Cuomo; Raphael Eduardo,9999,0,9999,0
1746614388083,CSE 191,A00,958773,Minnes Kemp; Mor Mia,9995,0,9999,4
1746614389108,CSE 197,001,959846,Minnes Kemp; Mor Mia,9990,0,9999,9
1746614390136,CSS 201S,A01,892054,Mignozzetti; Umberto,25,0,30,5
1746614391202,CSS 202S,A01,892056,Mignozzetti; Umberto,25,0,30,5
1746614392229,DSC 197,001,956898,Eldridge; Justin Matthew,9996,0,9999,3
1746614393256,DSC 297,001,958000,Mazumdar; Arya,9998,0,9999,1
1746614393256,DSC 297,002,959862,Wang; Yusu,9998,0,9999,1
1746614394522,EAP 100,A00,905686,Staff,9778,0,9999,221
1746614395550,ECE 45,A01,892618,Staff,0,0,65,65
1746614397602,ECE 111,A01,892719,Staff,6,0,65,59
1746614398634,ECE 197,001,957920,Mercier; Patrick Philip,9991,0,9999,8
1746614399665,ECON 178,A01,907814,Zhu; Ying,26,0,35,9
1746614400700,EDS 115,A00,895312,Staff,35,0,45,10
1746614401735,EDS 117,A01,895337,Staff,23,0,30,7
1746614402764,EDS 125,A00,895341,Jones; Gabrielle Anastasia,36,0,45,9
1746614403792,EDS 128A,A01,895459,Fargason; Sharon Gayle,44,0,45,1
1746614404821,EDS 128B,A01,895543,Pappas; Elizabeth,44,0,45,1
1746614405848,EDS 139,A00,897203,Pappas; Elizabeth,44,0,45,1
1746614405848,EDS 139,B00,897209,Fargason; Sharon Gayle,41,0,45,4
1746614406880,EDS 201,A00,895545,Staff,22,0,45,23
1746614407910,EDS 203,A01,895581,Halter; Christopher P.,22,0,45,23
1746614408942,EDS 204R,A01,895625,Heinzman; Erica M.,39,0,45,6
1746614408942,EDS 204R,B01,895693,Halter; Christopher P.,10,0,45,35
1746614409973,EDS 206R,A00,895694,Fargason; Sharon Gayle,1,0,30,29
1746614409973,EDS 206R,B00,895695,Choi; Bailey Miyeon,16,0,30,14
1746614411001,EDS 250,A00,895697,Hemans; Patricia Ann Benitez,22,0,45,23
1746614412031,EDS 281,A00,895701,Meyerott; Theresa Ann,1,0,15,14
1746614413059,EDS 284,A00,895736,Meyerott; Theresa Ann,1,0,15,14
1746614414092,EDS 286,A00,897210,Fine; Sarah,0,0,15,15
1746614415117,EDS 289C,A01,895770,Daly; Alan J.,1,0,15,14
1746614416145,EDS 290,A00,897211,Hofstetter; Carolyn,0,0,15,15
1746614417173,LIGM 5A,A00,896162,Fischer-Grunski; Eva K,12,0,20,8
1746614418201,LIGM 5B,A00,896260,Fischer-Grunski; Eva K,17,0,20,3
1746614419227,LIGM 5C,A00,896308,Fischer-Grunski; Eva K,18,0,20,2
1746614420260,LIIT 5AS,A00,896313,Carnelos; Chiara,18,0,20,2
1746614421291,LIIT 5BS,A00,896416,Carnelos; Chiara,20,0,20,0
1746614422322,LIIT 5CS,A00,896564,Carnelos; Chiara,20,0,20,0
1746614423350,LISP 5A,A00,896588,Munoz Sanchez; Alicia,2,0,20,18
1746614424375,LISP 5B,A00,896653,Munoz Sanchez; Alicia,7,0,20,13
1746614425406,LISP 5C,A00,896655,Munoz Sanchez; Alicia,0,1,20,20
1746614426438,MAE 197,001,957918,Kleissl; Jan,9996,0,9999,3
1746614426438,MAE 197,002,959806,Boechler; Nicholas Sebastia,9998,0,9999,1
1746614426438,MAE 197,003,959852,Mullin; Jennifer S,9998,0,9999,1
1746614427466,MATH 2,A01,957937,Staff,33,0,35,2
1746614428493,MATH 197,001,957876,Kedlaya; Kiran S.,9993,0,9999,6
1746614429524,MCWP 40,A00,892729,Duru; Nur,10,0,20,10
1746614429524,MCWP 40,B00,893304,Montejo; Carolina,14,0,20,6
1746614430556,MCWP 40R,A00,893757,Redela; Pamela Morgan,0,5,20,20
1746614431583,MCWP 50,A00,893758,Morshed; Michael James,0,0,20,20
1746614431583,MCWP 50,B00,893761,Bartulis; Jason Michael,16,0,20,4
1746614432612,MCWP 50R,A00,893766,Compas; Sean Matthew,0,1,20,20
1746614432612,MCWP 50R,B00,893769,Carter; Jennifer A,0,1,20,20
1746614432612,MCWP 50R,C00,893771,Krone; Jarret,0,3,20,20
1746614432612,MCWP 50R,D00,893772,Miller; Elizabeth Deen,0,0,20,20
1746614432612,MCWP 50R,E00,893775,Carter; Andrea L,0,1,20,20
1746614433639,MMW 11R,A01,892721,Herbst; Matthew,14,0,30,16
1746614433639,MMW 11R,A02,892722,Herbst; Matthew,0,0,0,3
1746614434664,MMW 12R,A01,892724,Herbst; Matthew,0,11,16,16
1746614434664,MMW 12R,A02,892725,Herbst; Matthew,0,10,16,16
1746614435690,MMW 13R,A01,892727,Staff,0,4,16,16
1746614435690,MMW 13R,A02,892728,Staff,0,4,16,16
1746614435690,MMW 13R,A03,958032,Staff,0,4,16,16
1746614435690,MMW 13R,A04,958033,Staff,0,4,16,16
1746614435690,MMW 13R,A05,958034,Staff,0,4,16,16
1746614436715,SIO 295LS,A00,894015,Staff,5,0,25,20
1746614437746,SIO 295S,A00,894020,Staff,5,0,25,20
1746614438781,SIOC 290S,B01,958918,Merrifield; Mark A,14,0,30,16
1746614439814,SIOC 291S,B01,958922,Gabriel; Corey John,14,0,30,16
1746614440841,SOCI 117,A01,895339,Staff,2,0,5,3
1746614441872,WES 237B,A00,894149,Staff,11,0,20,9
1746614443959,AESE 279B,A00,891859,Staff,13,0,35,22
1746614445017,AIP 197,001,891854,Vespa; Emanuel Ignacio,9999,0,9999,0
1746614446047,ANTH 289S,A00,891856,Gagneux; Pascal,12,0,12,0
1746614447073,BENG 196,001,957946,Engler; Adam J.,9996,0,9999,3
1746614448100,BISP 197,001,959851,Wilhelm; James E.,9998,0,9999,1
1746614449130,CAT 124RS,A01,956906,Staff,6,0,25,19
1746614450158,CAT 125RS,A01,922013,Staff,6,0,25,19
1746614451184,CLRE 250,A00,891860,Morris; Sheldon,9995,0,9999,4
1746614453237,CLRE 251R,A00,907817,Mehta; Ravindra L.,9994,0,9999,5
1746614454263,CLRE 252,A00,891864,Cuomo; Raphael Eduardo,9993,0,9999,6
1746614455291,CLRE 253,A00,891867,Vaida; Florin,9994,0,9999,5
1746614455291,CLRE 253,B00,907819,Staff,9999,0,9999,0
1746614456320,CLRE 259,A00,891868,Patel; Hemal,9998,0,9999,1
1746614457351,CLRE 260,A00,891872,Cuomo; Raphael Eduardo,9999,0,9999,0
1746614458379,CLRE 297,001,891888,Cuomo; Raphael Eduardo,9999,0,9999,0
1746614459408,CSE 191,A00,958773,Minnes Kemp; Mor Mia,9995,0,9999,4
1746614460438,CSE 197,001,959846,Minnes Kemp; Mor Mia,9990,0,9999,9
1746614461473,CSS 201S,A01,892054,Mignozzetti; Umberto,25,0,30,5
1746614462502,CSS 202S,A01,892056,Mignozzetti; Umberto,25,0,30,5
1746614463531,DSC 197,001,956898,Eldridge; Justin Matthew,9996,0,9999,3
1746614464561,DSC 297,001,958000,Mazumdar; Arya,9998,0,9999,1
1746614464561,DSC 297,002,959862,Wang; Yusu,9998,0,9999,1
1746614465591,EAP 100,A00,905686,Staff,9778,0,9999,221
1746614466624,ECE 45,A01,892618,Staff,0,0,65,65
1746614468719,ECE 111,A01,892719,Staff,6,0,65,59
1746614469748,ECE 197,001,957920,Mercier; Patrick Philip,9991,0,9999,8
1746614470781,ECON 178,A01,907814,Zhu; Ying,26,0,35,9
1746614471810,EDS 115,A00,895312,Staff,35,0,45,10
1746614472841,EDS 117,A01,895337,Staff,23,0,30,7
1746614473870,EDS 125,A00,895341,Jones; Gabrielle Anastasia,36,0,45,9
1746614474900,EDS 128A,A01,895459,Fargason; Sharon Gayle,44,0,45,1
1746614475928,EDS 128B,A01,895543,Pappas; Elizabeth,44,0,45,1
1746614476955,EDS 139,A00,897203,Pappas; Elizabeth,44,0,45,1
1746614476955,EDS 139,B00,897209,Fargason; Sharon Gayle,41,0,45,4
1746614477982,EDS 201,A00,895545,Staff,22,0,45,23
1746614479013,EDS 203,A01,895581,Halter; Christopher P.,22,0,45,23
1746614480040,EDS 204R,A01,895625,Heinzman; Erica M.,39,0,45,6
1746614480040,EDS 204R,B01,895693,Halter; Christopher P.,10,0,45,35
1746614481070,EDS 206R,A00,895694,Fargason; Sharon Gayle,1,0,30,29
1746614481070,EDS 206R,B00,895695,Choi; Bailey Miyeon,16,0,30,14
1746614482097,EDS 250,A00,895697,Hemans; Patricia Ann Benitez,22,0,45,23
1746614483126,EDS 281,A00,895701,Meyerott; Theresa Ann,1,0,15,14
1746614484156,EDS 284,A00,895736,Meyerott; Theresa Ann,1,0,15,14
1746614485186,EDS 286,A00,897210,Fine; Sarah,0,0,15,15
1746614486216,EDS 289C,A01,895770,Daly; Alan J.,1,0,15,14
1746614487243,EDS 290,A00,897211,Hofstetter; Carolyn,0,0,15,15
1746614488278,LIGM 5A,A00,896162,Fischer-Grunski; Eva K,12,0,20,8
1746614489303,LIGM 5B,A00,896260,Fischer-Grunski; Eva K,17,0,20,3
1746614490334,LIGM 5C,A00,896308,Fischer-Grunski; Eva K,18,0,20,2
1746614491362,LIIT 5AS,A00,896313,Carnelos; Chiara,18,0,20,2
1746614492390,LIIT 5BS,A00,896416,Carnelos; Chiara,20,0,20,0
1746614493419,LIIT 5CS,A00,896564,Carnelos; Chiara,20,0,20,0
1746614494445,LISP 5A,A00,896588,Munoz Sanchez; Alicia,2,0,20,18
1746614495473,LISP 5B,A00,896653,Munoz Sanchez; Alicia,7,0,20,13
1746614496499,LISP 5C,A00,896655,Munoz Sanchez; Alicia,0,1,20,20
1746614497528,MAE 197,001,957918,Kleissl; Jan,9996,0,9999,3
1746614497528,MAE 197,002,959806,Boechler; Nicholas Sebastia,9998,0,9999,1
1746614497528,MAE 197,003,959852,Mullin; Jennifer S,9998,0,9999,1
1746614498555,MATH 2,A01,957937,Staff,33,0,35,2
1746614499584,MATH 197,001,957876,Kedlaya; Kiran S.,9993,0,9999,6
1746614500612,MCWP 40,A00,892729,Duru; Nur,10,0,20,10
1746614500612,MCWP 40,B00,893304,Montejo; Carolina,14,0,20,6
1746614501642,MCWP 40R,A00,893757,Redela; Pamela Morgan,0,5,20,20
1746614502670,MCWP 50,A00,893758,Morshed; Michael James,0,0,20,20
1746614502670,MCWP 50,B00,893761,Bartulis; Jason Michael,16,0,20,4
1746614503698,MCWP 50R,A00,893766,Compas; Sean Matthew,0,1,20,20
1746614503698,MCWP 50R,B00,893769,Carter; Jennifer A,0,1,20,20
1746614503698,MCWP 50R,C00,893771,Krone; Jarret,0,3,20,20
1746614503698,MCWP 50R,D00,893772,Miller; Elizabeth Deen,0,0,20,20
1746614503698,MCWP 50R,E00,893775,Carter; Andrea L,0,1,20,20
1746614504730,MMW 11R,A01,892721,Herbst; Matthew,14,0,30,16
1746614504730,MMW 11R,A02,892722,Herbst; Matthew,0,0,0,3
1746614505759,MMW 12R,A01,892724,Herbst; Matthew,0,11,16,16
1746614505759,MMW 12R,A02,892725,Herbst; Matthew,0,10,16,16
1746614506787,MMW 13R,A01,892727,Staff,0,4,16,16
1746614506787,MMW 13R,A02,892728,Staff,0,4,16,16
1746614506787,MMW 13R,A03,958032,Staff,0,4,16,16
1746614506787,MMW 13R,A04,958033,Staff,0,4,16,16
1746614506787,MMW 13R,A05,958034,Staff,0,4,16,16
1746614507819,SIO 295LS,A00,894015,Staff,5,0,25,20
1746614508845,SIO 295S,A00,894020,Staff,5,0,25,20
1746614509874,SIOC 290S,B01,958918,Merrifield; Mark A,14,0,30,16
1746614510902,SIOC 291S,B01,958922,Gabriel; Corey John,14,0,30,16
1746614511927,SOCI 117,A01,895339,Staff,2,0,5,3
1746614512954,WES 237B,A00,894149,Staff,11,0,20,9
1746614515063,AESE 279B,A00,891859,Staff,13,0,35,22
1746614516094,AIP 197,001,891854,Vespa; Emanuel Ignacio,9999,0,9999,0
1746614517121,ANTH 289S,A00,891856,Gagneux; Pascal,12,0,12,0
1746614518151,BENG 196,001,957946,Engler; Adam J.,9996,0,9999,3
1746614519177,BISP 197,001,959851,Wilhelm; James E.,9998,0,9999,1
1746614520203,CAT 124RS,A01,956906,Staff,6,0,25,19
1746614521233,CAT 125RS,A01,922013,Staff,6,0,25,19
1746614522265,CLRE 250,A00,891860,Morris; Sheldon,9995,0,9999,4
1746614524317,CLRE 251R,A00,907817,Mehta; Ravindra L.,9994,0,9999,5
1746614525340,CLRE 252,A00,891864,Cuomo; Raphael Eduardo,9993,0,9999,6
1746614526371,CLRE 253,A00,891867,Vaida; Florin,9994,0,9999,5
1746614526371,CLRE 253,B00,907819,Staff,9999,0,9999,0
1746614527403,CLRE 259,A00,891868,Patel; Hemal,9998,0,9999,1
1746614528431,CLRE 260,A00,891872,Cuomo; Raphael Eduardo,9999,0,9999,0
1746614529460,CLRE 297,001,891888,Cuomo; Raphael Eduardo,9999,0,9999,0
1746614530487,CSE 191,A00,958773,Minnes Kemp; Mor Mia,9995,0,9999,4
1746614531514,CSE 197,001,959846,Minnes Kemp; Mor Mia,9990,0,9999,9
1746614532541,CSS 201S,A01,892054,Mignozzetti; Umberto,25,0,30,5
1746614533570,CSS 202S,A01,892056,Mignozzetti; Umberto,25,0,30,5
1746614534600,DSC 197,001,956898,Eldridge; Justin Matthew,9996,0,9999,3
1746614535627,DSC 297,001,958000,Mazumdar; Arya,9998,0,9999,1
1746614535627,DSC 297,002,959862,Wang; Yusu,9998,0,9999,1
1746614536656,EAP 100,A00,905686,Staff,9778,0,9999,221
1746614537690,ECE 45,A01,892618,Staff,0,0,65,65
1746614539752,ECE 111,A01,892719,Staff,6,0,65,59
1746614540779,ECE 197,001,957920,Mercier; Patrick Philip,9991,0,9999,8
1746614541809,ECON 178,A01,907814,Zhu; Ying,26,0,35,9
1746614542839,EDS 115,A00,895312,Staff,35,0,45,10
1746614543867,EDS 117,A01,895337,Staff,23,0,30,7
1746614544893,EDS 125,A00,895341,Jones; Gabrielle Anastasia,36,0,45,9
1746614545919,EDS 128A,A01,895459,Fargason; Sharon Gayle,44,0,45,1
1746614546948,EDS 128B,A01,895543,Pappas; Elizabeth,44,0,45,1
1746614547974,EDS 139,A00,897203,Pappas; Elizabeth,44,0,45,1
1746614547974,EDS 139,B00,897209,Fargason; Sharon Gayle,41,0,45,4
1746614549000,EDS 201,A00,895545,Staff,22,0,45,23
1746614550027,EDS 203,A01,895581,Halter; Christopher P.,22,0,45,23
1746614551058,EDS 204R,A01,895625,Heinzman; Erica M.,39,0,45,6
1746614551058,EDS 204R,B01,895693,Halter; Christopher P.,10,0,45,35
1746614552092,EDS 206R,A00,895694,Fargason; Sharon Gayle,1,0,30,29
1746614552092,EDS 206R,B00,895695,Choi; Bailey Miyeon,16,0,30,14
1746614553123,EDS 250,A00,895697,Hemans; Patricia Ann Benitez,22,0,45,23
1746614554152,EDS 281,A00,895701,Meyerott; Theresa Ann,1,0,15,14
1746614555178,EDS 284,A00,895736,Meyerott; Theresa Ann,1,0,15,14
1746614556206,EDS 286,A00,897210,Fine; Sarah,0,0,15,15
1746614557235,EDS 289C,A01,895770,Daly; Alan J.,1,0,15,14
1746614558264,EDS 290,A00,897211,Hofstetter; Carolyn,0,0,15,15
1746614559295,LIGM 5A,A00,896162,Fischer-Grunski; Eva K,12,0,20,8
1746614560326,LIGM 5B,A00,896260,Fischer-Grunski; Eva K,17,0,20,3
1746614561353,LIGM 5C,A00,896308,Fischer-Grunski; Eva K,18,0,20,2
1746614562384,LIIT 5AS,A00,896313,Carnelos; Chiara,18,0,20,2
1746614563414,LIIT 5BS,A00,896416,Carnelos; Chiara,20,0,20,0
1746614564446,LIIT 5CS,A00,896564,Carnelos; Chiara,20,0,20,0
1746614565473,LISP 5A,A00,896588,Munoz Sanchez; Alicia,2,0,20,18
1746614566506,LISP 5B,A00,896653,Munoz Sanchez; Alicia,7,0,20,13
1746614567535,LISP 5C,A00,896655,Munoz Sanchez; Alicia,0,1,20,20
1746614568562,MAE 197,001,957918,Kleissl; Jan,9996,0,9999,3
1746614568562,MAE 197,002,959806,Boechler; Nicholas Sebastia,9998,0,9999,1
1746614568562,MAE 197,003,959852,Mullin; Jennifer S,9998,0,9999,1
1746614569587,MATH 2,A01,957937,Staff,33,0,35,2
1746614570819,MATH 197,001,957876,Kedlaya; Kiran S.,9993,0,9999,6
1746614571846,MCWP 40,A00,892729,Duru; Nur,10,0,20,10
1746614571846,MCWP 40,B00,893304,Montejo; Carolina,14,0,20,6
1746614572878,MCWP 40R,A00,893757,Redela; Pamela Morgan,0,5,20,20
1746614573908,MCWP 50,A00,893758,Morshed; Michael James,0,0,20,20
1746614573908,MCWP 50,B00,893761,Bartulis; Jason Michael,16,0,20,4
1746614574937,MCWP 50R,A00,893766,Compas; Sean Matthew,0,1,20,20
1746614574937,MCWP 50R,B00,893769,Carter; Jennifer A,0,1,20,20
1746614574937,MCWP 50R,C00,893771,Krone; Jarret,0,3,20,20
1746614574937,MCWP 50R,D00,893772,Miller; Elizabeth Deen,0,0,20,20
1746614574937,MCWP 50R,E00,893775,Carter; Andrea L,0,1,20,20
1746614575969,MMW 11R,A01,892721,Herbst; Matthew,14,0,30,16
1746614575969,MMW 11R,A02,892722,Herbst; Matthew,0,0,0,3
1746614576999,MMW 12R,A01,892724,Herbst; Matthew,0,11,16,16
1746614576999,MMW 12R,A02,892725,Herbst; Matthew,0,10,16,16
1746614578030,MMW 13R,A01,892727,Staff,0,4,16,16
1746614578030,MMW 13R,A02,892728,Staff,0,4,16,16
1746614578030,MMW 13R,A03,958032,Staff,0,4,16,16
1746614578030,MMW 13R,A04,958033,Staff,0,4,16,16
1746614578030,MMW 13R,A05,958034,Staff,0,4,16,16
1746614579056,SIO 295LS,A00,894015,Staff,5,0,25,20
1746614580085,SIO 295S,A00,894020,Staff,5,0,25,20
1746614581123,SIOC 290S,B01,958918,Merrifield; Mark A,14,0,30,16
1746614582156,SIOC 291S,B01,958922,Gabriel; Corey John,14,0,30,16
1746614583183,SOCI 117,A01,895339,Staff,2,0,5,3
1746614584208,WES 237B,A00,894149,Staff,11,0,20,9
1746614586291,AESE 279B,A00,891859,Staff,13,0,35,22
1746614587320,AIP 197,001,891854,Vespa; Emanuel Ignacio,9999,0,9999,0
1746614588351,ANTH 289S,A00,891856,Gagneux; Pascal,12,0,12,0
1746614589381,BENG 196,001,957946,Engler; Adam J.,9996,0,9999,3
1746614590411,BISP 197,001,959851,Wilhelm; James E.,9998,0,9999,1
1746614591437,CAT 124RS,A01,956906,Staff,6,0,25,19
1746614592469,CAT 125RS,A01,922013,Staff,6,0,25,19
1746614593500,CLRE 250,A00,891860,Morris; Sheldon,9995,0,9999,4
1746614595560,CLRE 251R,A00,907817,Mehta; Ravindra L.,9994,0,9999,5
1746614596588,CLRE 252,A00,891864,Cuomo; Raphael Eduardo,9993,0,9999,6
1746614597616,CLRE 253,A00,891867,Vaida; Florin,9994,0,9999,5
1746614597616,CLRE 253,B00,907819,Staff,9999,0,9999,0
1746614598644,CLRE 259,A00,891868,Patel; Hemal,9998,0,9999,1
1746614599673,CLRE 260,A00,891872,Cuomo; Raphael Eduardo,9999,0,9999,0
1746614600704,CLRE 297,001,891888,Cuomo; Raphael Eduardo,9999,0,9999,0
1746614601735,CSE 191,A00,958773,Minnes Kemp; Mor Mia,9995,0,9999,4
1746614602764,CSE 197,001,959846,Minnes Kemp; Mor Mia,9990,0,9999,9
1746614603796,CSS 201S,A01,892054,Mignozzetti; Umberto,25,0,30,5
1746614604829,CSS 202S,A01,892056,Mignozzetti; Umberto,25,0,30,5
1746614605860,DSC 197,001,956898,Eldridge; Justin Matthew,9996,0,9999,3
1746614606889,DSC 297,001,958000,Mazumdar; Arya,9998,0,9999,1
1746614606889,DSC 297,002,959862,Wang; Yusu,9998,0,9999,1
1746614607914,EAP 100,A00,905686,Staff,9778,0,9999,221
1746614608947,ECE 45,A01,892618,Staff,0,0,65,65
1746614611001,ECE 111,A01,892719,Staff,6,0,65,59
1746614612031,ECE 197,001,957920,Mercier; Patrick Philip,9991,0,9999,8
1746614613059,ECON 178,A01,907814,Zhu; Ying,26,0,35,9
1746614614086,EDS 115,A00,895312,Staff,35,0,45,10
1746614615112,EDS 117,A01,895337,Staff,23,0,30,7
1746614616144,EDS 125,A00,895341,Jones; Gabrielle Anastasia,36,0,45,9
1746614617174,EDS 128A,A01,895459,Fargason; Sharon Gayle,44,0,45,1
1746614618202,EDS 128B,A01,895543,Pappas; Elizabeth,44,0,45,1
1746614619231,EDS 139,A00,897203,Pappas; Elizabeth,44,0,45,1
1746614619231,EDS 139,B00,897209,Fargason; Sharon Gayle,41,0,45,4
1746614620258,EDS 201,A00,895545,Staff,22,0,45,23
1746614621287,EDS 203,A01,895581,Halter; Christopher P.,22,0,45,23
1746614622316,EDS 204R,A01,895625,Heinzman; Erica M.,39,0,45,6
1746614622316,EDS 204R,B01,895693,Halter; Christopher P.,10,0,45,35
1746614623343,EDS 206R,A00,895694,Fargason; Sharon Gayle,1,0,30,29
1746614623343,EDS 206R,B00,895695,Choi; Bailey Miyeon,16,0,30,14
1746614624370,EDS 250,A00,895697,Hemans; Patricia Ann Benitez,22,0,45,23
1746614625397,EDS 281,A00,895701,Meyerott; Theresa Ann,1,0,15,14
1746614626423,EDS 284,A00,895736,Meyerott; Theresa Ann,1,0,15,14
1746614627451,EDS 286,A00,897210,Fine; Sarah,0,0,15,15
1746614628482,EDS 289C,A01,895770,Daly; Alan J.,1,0,15,14
1746614629513,EDS 290,A00,897211,Hofstetter; Carolyn,0,0,15,15
1746614630542,LIGM 5A,A00,896162,Fischer-Grunski; Eva K,12,0,20,8
1746614631573,LIGM 5B,A00,896260,Fischer-Grunski; Eva K,17,0,20,3
1746614632601,LIGM 5C,A00,896308,Fischer-Grunski; Eva K,18,0,20,2
1746614633630,LIIT 5AS,A00,896313,Carnelos; Chiara,18,0,20,2
1746614634656,LIIT 5BS,A00,896416,Carnelos; Chiara,20,0,20,0
1746614635685,LIIT 5CS,A00,896564,Carnelos; Chiara,20,0,20,0
1746614636715,LISP 5A,A00,896588,Munoz Sanchez; Alicia,2,0,20,18
1746614637743,LISP 5B,A00,896653,Munoz Sanchez; Alicia,7,0,20,13
1746614638775,LISP 5C,A00,896655,Munoz Sanchez; Alicia,0,1,20,20
1746614639804,MAE 197,001,957918,Kleissl; Jan,9996,0,9999,3
1746614639804,MAE 197,002,959806,Boechler; Nicholas Sebastia,9998,0,9999,1
1746614639804,MAE 197,003,959852,Mullin; Jennifer S,9998,0,9999,1
1746614640832,MATH 2,A01,957937,Staff,33,0,35,2
1746614641860,MATH 197,001,957876,Kedlaya; Kiran S.,9993,0,9999,6
1746614642890,MCWP 40,A00,892729,Duru; Nur,10,0,20,10
1746614642890,MCWP 40,B00,893304,Montejo; Carolina,14,0,20,6
1746614643917,MCWP 40R,A00,893757,Redela; Pamela Morgan,0,5,20,20
1746614645476,MCWP 50,A00,893758,Morshed; Michael James,0,0,20,20
1746614645476,MCWP 50,B00,893761,Bartulis; Jason Michael,16,0,20,4
1746614646506,MCWP 50R,A00,893766,Compas; Sean Matthew,0,1,20,20
1746614646506,MCWP 50R,B00,893769,Carter; Jennifer A,0,1,20,20
1746614646506,MCWP 50R,C00,893771,Krone; Jarret,0,3,20,20
1746614646506,MCWP 50R,D00,893772,Miller; Elizabeth Deen,0,0,20,20
1746614646506,MCWP 50R,E00,893775,Carter; Andrea L,0,1,20,20
1746614647533,MMW 11R,A01,892721,Herbst; Matthew,14,0,30,16
1746614647533,MMW 11R,A02,892722,Herbst; Matthew,0,0,0,3
1746614649599,MMW 12R,A01,892724,Herbst; Matthew,0,11,16,16
1746614649599,MMW 12R,A02,892725,Herbst; Matthew,0,10,16,16
1746614650627,MMW 13R,A01,892727,Staff,0,4,16,16
1746614650627,MMW 13R,A02,892728,Staff,0,4,16,16
1746614650627,MMW 13R,A03,958032,Staff,0,4,16,16
1746614650627,MMW 13R,A04,958033,Staff,0,4,16,16
1746614650627,MMW 13R,A05,958034,Staff,0,4,16,16
1746614651657,SIO 295LS,A00,894015,Staff,5,0,25,20
1746614652688,SIO 295S,A00,894020,Staff,5,0,25,20
1746614653723,SIOC 290S,B01,958918,Merrifield; Mark A,14,0,30,16
1746614654757,SIOC 291S,B01,958922,Gabriel; Corey John,14,0,30,16
1746614655784,SOCI 117,A01,895339,Staff,2,0,5,3
1746614656812,WES 237B,A00,894149,Staff,11,0,20,9
1746614658896,AESE 279B,A00,891859,Staff,13,0,35,22
1746614659923,AIP 197,001,891854,Vespa; Emanuel Ignacio,9999,0,9999,0
1746614660954,ANTH 289S,A00,891856,Gagneux; Pascal,12,0,12,0
1746614661985,BENG 196,001,957946,Engler; Adam J.,9996,0,9999,3
1746614663015,BISP 197,001,959851,Wilhelm; James E.,9998,0,9999,1
1746614664045,CAT 124RS,A01,956906,Staff,6,0,25,19
1746614665071,CAT 125RS,A01,922013,Staff,6,0,25,19
1746614666101,CLRE 250,A00,891860,Morris; Sheldon,9995,0,9999,4
1746614668156,CLRE 251R,A00,907817,Mehta; Ravindra L.,9994,0,9999,5
1746614669182,CLRE 252,A00,891864,Cuomo; Raphael Eduardo,9993,0,9999,6
1746614670213,CLRE 253,A00,891867,Vaida; Florin,9994,0,9999,5
1746614670213,CLRE 253,B00,907819,Staff,9999,0,9999,0
1746614671242,CLRE 259,A00,891868,Patel; Hemal,9998,0,9999,1
1746614672268,CLRE 260,A00,891872,Cuomo; Raphael Eduardo,9999,0,9999,0
1746614673298,CLRE 297,001,891888,Cuomo; Raphael Eduardo,9999,0,9999,0
1746614674324,CSE 191,A00,958773,Minnes Kemp; Mor Mia,9995,0,9999,4
1746614675350,CSE 197,001,959846,Minnes Kemp; Mor Mia,9990,0,9999,9
1746614676384,CSS 201S,A01,892054,Mignozzetti; Umberto,25,0,30,5
1746614677411,CSS 202S,A01,892056,Mignozzetti; Umberto,25,0,30,5
1746614678441,DSC 197,001,956898,Eldridge; Justin Matthew,9996,0,9999,3
1746614679470,DSC 297,001,958000,Mazumdar; Arya,9998,0,9999,1
1746614679470,DSC 297,002,959862,Wang; Yusu,9998,0,9999,1
1746614680499,EAP 100,A00,905686,Staff,9778,0,9999,221
1746614681530,ECE 45,A01,892618,Staff,0,0,65,65
1746614683591,ECE 111,A01,892719,Staff,6,0,65,59
1746614684618,ECE 197,001,957920,Mercier; Patrick Philip,9991,0,9999,8
1746614685650,ECON 178,A01,907814,Zhu; Ying,26,0,35,9
1746614686679,EDS 115,A00,895312,Staff,35,0,45,10
1746614687705,EDS 117,A01,895337,Staff,23,0,30,7
1746614688737,EDS 125,A00,895341,Jones; Gabrielle Anastasia,36,0,45,9
1746614689767,EDS 128A,A01,895459,Fargason; Sharon Gayle,44,0,45,1
1746614690797,EDS 128B,A01,895543,Pappas; Elizabeth,44,0,45,1
1746614691824,EDS 139,A00,897203,Pappas; Elizabeth,44,0,45,1
1746614691824,EDS 139,B00,897209,Fargason; Sharon Gayle,41,0,45,4
1746614692851,EDS 201,A00,895545,Staff,22,0,45,23
1746614693880,EDS 203,A01,895581,Halter; Christopher P.,22,0,45,23
1746614694912,EDS 204R,A01,895625,Heinzman; Erica M.,39,0,45,6
1746614694912,EDS 204R,B01,895693,Halter; Christopher P.,10,0,45,35
1746614695940,EDS 206R,A00,895694,Fargason; Sharon Gayle,1,0,30,29
1746614695940,EDS 206R,B00,895695,Choi; Bailey Miyeon,16,0,30,14
1746614696966,EDS 250,A00,895697,Hemans; Patricia Ann Benitez,22,0,45,23
1746614697999,EDS 281,A00,895701,Meyerott; Theresa Ann,1,0,15,14
1746614699042,EDS 284,A00,895736,Meyerott; Theresa Ann,1,0,15,14
1746614700088,EDS 286,A00,897210,Fine; Sarah,0,0,15,15
1746614701117,EDS 289C,A01,895770,Daly; Alan J.,1,0,15,14
1746614702145,EDS 290,A00,897211,Hofstetter; Carolyn,0,0,15,15
1746614703173,LIGM 5A,A00,896162,Fischer-Grunski; Eva K,12,0,20,8
1746614704201,LIGM 5B,A00,896260,Fischer-Grunski; Eva K,17,0,20,3
1746614705228,LIGM 5C,A00,896308,Fischer-Grunski; Eva K,18,0,20,2
1746614706261,LIIT 5AS,A00,896313,Carnelos; Chiara,18,0,20,2
1746614707287,LIIT 5BS,A00,896416,Carnelos; Chiara,20,0,20,0
1746614708313,LIIT 5CS,A00,896564,Carnelos; Chiara,20,0,20,0
1746614709344,LISP 5A,A00,896588,Munoz Sanchez; Alicia,2,0,20,18
1746614710374,LISP 5B,A00,896653,Munoz Sanchez; Alicia,7,0,20,13
1746614711400,LISP 5C,A00,896655,Munoz Sanchez; Alicia,0,1,20,20
1746614712430,MAE 197,001,957918,Kleissl; Jan,9996,0,9999,3
1746614712430,MAE 197,002,959806,Boechler; Nicholas Sebastia,9998,0,9999,1
1746614712430,MAE 197,003,959852,Mullin; Jennifer S,9998,0,9999,1
1746614713458,MATH 2,A01,957937,Staff,33,0,35,2
1746614714485,MATH 197,001,957876,Kedlaya; Kiran S.,9993,0,9999,6
1746614715521,MCWP 40,A00,892729,Duru; Nur,10,0,20,10
1746614715521,MCWP 40,B00,893304,Montejo; Carolina,14,0,20,6
1746614716548,MCWP 40R,A00,893757,Redela; Pamela Morgan,0,5,20,20
1746614717578,MCWP 50,A00,893758,Morshed; Michael James,0,0,20,20
1746614717578,MCWP 50,B00,893761,Bartulis; Jason Michael,16,0,20,4
1746614718605,MCWP 50R,A00,893766,Compas; Sean Matthew,0,1,20,20
1746614718605,MCWP 50R,B00,893769,Carter; Jennifer A,0,1,20,20
1746614718605,MCWP 50R,C00,893771,Krone; Jarret,0,3,20,20
1746614718605,MCWP 50R,D00,893772,Miller; Elizabeth Deen,0,0,20,20
1746614718605,MCWP 50R,E00,893775,Carter; Andrea L,0,1,20,20
1746614719638,MMW 11R,A01,892721,Herbst; Matthew,14,0,30,16
1746614719638,MMW 11R,A02,892722,Herbst; Matthew,0,0,0,3
1746614720706,MMW 12R,A01,892724,Herbst; Matthew,0,11,16,16
1746614720706,MMW 12R,A02,892725,Herbst; Matthew,0,10,16,16
1746614721736,MMW 13R,A01,892727,Staff,0,4,16,16
1746614721736,MMW 13R,A02,892728,Staff,0,4,16,16
1746614721736,MMW 13R,A03,958032,Staff,0,4,16,16
1746614721736,MMW 13R,A04,958033,Staff,0,4,16,16
1746614721736,MMW 13R,A05,958034,Staff,0,4,16,16
1746614722762,SIO 295LS,A00,894015,Staff,5,0,25,20
1746614723789,SIO 295S,A00,894020,Staff,5,0,25,20
1746614724816,SIOC 290S,B01,958918,Merrifield; Mark A,14,0,30,16
1746614725846,SIOC 291S,B01,958922,Gabriel; Corey John,14,0,30,16
1746614726872,SOCI 117,A01,895339,Staff,2,0,5,3
1746614727901,WES 237B,A00,894149,Staff,11,0,20,9
1746614730008,AESE 279B,A00,891859,Staff,13,0,35,22
1746614731037,AIP 197,001,891854,Vespa; Emanuel Ignacio,9999,0,9999,0
1746614732065,ANTH 289S,A00,891856,Gagneux; Pascal,12,0,12,0
1746614733093,BENG 196,001,957946,Engler; Adam J.,9996,0,9999,3
1746614734121,BISP 197,001,959851,Wilhelm; James E.,9998,0,9999,1
1746614735164,CAT 124RS,A01,956906,Staff,6,0,25,19
1746614736226,CAT 125RS,A01,922013,Staff,6,0,25,19
1746614737255,CLRE 250,A00,891860,Morris; Sheldon,9995,0,9999,4
1746614739310,CLRE 251R,A00,907817,Mehta; Ravindra L.,9994,0,9999,5
1746614740335,CLRE 252,A00,891864,Cuomo; Raphael Eduardo,9993,0,9999,6
1746614741365,CLRE 253,A00,891867,Vaida; Florin,9994,0,9999,5
1746614741365,CLRE 253,B00,907819,Staff,9999,0,9999,0
1746614742392,CLRE 259,A00,891868,Patel; Hemal,9998,0,9999,1
1746614743420,CLRE 260,A00,891872,Cuomo; Raphael Eduardo,9999,0,9999,0
1746614744450,CLRE 297,001,891888,Cuomo; Raphael Eduardo,9999,0,9999,0
1746614745477,CSE 191,A00,958773,Minnes Kemp; Mor Mia,9995,0,9999,4
1746614746505,CSE 197,001,959846,Minnes Kemp; Mor Mia,9990,0,9999,9
1746614747532,CSS 201S,A01,892054,Mignozzetti; Umberto,25,0,30,5
1746614748566,CSS 202S,A01,892056,Mignozzetti; Umberto,25,0,30,5
1746614749600,DSC 197,001,956898,Eldridge; Justin Matthew,9996,0,9999,3
1746614750631,DSC 297,001,958000,Mazumdar; Arya,9998,0,9999,1
1746614750631,DSC 297,002,959862,Wang; Yusu,9998,0,9999,1
1746614751660,EAP 100,A00,905686,Staff,9778,0,9999,221
1746614752693,ECE 45,A01,892618,Staff,0,0,65,65
1746614754749,ECE 111,A01,892719,Staff,6,0,65,59
1746614755777,ECE 197,001,957920,Mercier; Patrick Philip,9991,0,9999,8
1746614756805,ECON 178,A01,907814,Zhu; Ying,26,0,35,9
1746614757835,EDS 115,A00,895312,Staff,35,0,45,10
1746614758867,EDS 117,A01,895337,Staff,23,0,30,7
1746614759896,EDS 125,A00,895341,Jones; Gabrielle Anastasia,36,0,45,9
1746614760926,EDS 128A,A01,895459,Fargason; Sharon Gayle,44,0,45,1
1746614761957,EDS 128B,A01,895543,Pappas; Elizabeth,44,0,45,1
1746614762988,EDS 139,A00,897203,Pappas; Elizabeth,44,0,45,1
1746614762988,EDS 139,B00,897209,Fargason; Sharon Gayle,41,0,45,4
1746614764019,EDS 201,A00,895545,Staff,22,0,45,23
1746614765050,EDS 203,A01,895581,Halter; Christopher P.,22,0,45,23
1746614766082,EDS 204R,A01,895625,Heinzman; Erica M.,39,0,45,6
1746614766082,EDS 204R,B01,895693,Halter; Christopher P.,10,0,45,35
1746614767116,EDS 206R,A00,895694,Fargason; Sharon Gayle,1,0,30,29
1746614767116,EDS 206R,B00,895695,Choi; Bailey Miyeon,16,0,30,14
1746614768144,EDS 250,A00,895697,Hemans; Patricia Ann Benitez,22,0,45,23
1746614769173,EDS 281,A00,895701,Meyerott; Theresa Ann,1,0,15,14
1746614770201,EDS 284,A00,895736,Meyerott; Theresa Ann,1,0,15,14
1746614771226,EDS 286,A00,897210,Fine; Sarah,0,0,15,15
1746614772256,EDS 289C,A01,895770,Daly; Alan J.,1,0,15,14
1746614773284,EDS 290,A00,897211,Hofstetter; Carolyn,0,0,15,15
1746614774316,LIGM 5A,A00,896162,Fischer-Grunski; Eva K,12,0,20,8
1746614775343,LIGM 5B,A00,896260,Fischer-Grunski; Eva K,17,0,20,3
1746614776372,LIGM 5C,A00,896308,Fischer-Grunski; Eva K,18,0,20,2
1746614777405,LIIT 5AS,A00,896313,Carnelos; Chiara,18,0,20,2
1746614778431,LIIT 5BS,A00,896416,Carnelos; Chiara,20,0,20,0
1746614779461,LIIT 5CS,A00,896564,Carnelos; Chiara,20,0,20,0
1746614780492,LISP 5A,A00,896588,Munoz Sanchez; Alicia,2,0,20,18
1746614781519,LISP 5B,A00,896653,Munoz Sanchez; Alicia,7,0,20,13
1746614782546,LISP 5C,A00,896655,Munoz Sanchez; Alicia,0,1,20,20
1746614783577,MAE 197,001,957918,Kleissl; Jan,9996,0,9999,3
1746614783577,MAE 197,002,959806,Boechler; Nicholas Sebastia,9998,0,9999,1
1746614783577,MAE 197,003,959852,Mullin; Jennifer S,9998,0,9999,1
1746614784604,MATH 2,A01,957937,Staff,33,0,35,2
1746614785634,MATH 197,001,957876,Kedlaya; Kiran S.,9993,0,9999,6
1746614786667,MCWP 40,A00,892729,Duru; Nur,10,0,20,10
1746614786667,MCWP 40,B00,893304,Montejo; Carolina,14,0,20,6
1746614787694,MCWP 40R,A00,893757,Redela; Pamela Morgan,0,5,20,20
1746614788723,MCWP 50,A00,893758,Morshed; Michael James,0,0,20,20
1746614788723,MCWP 50,B00,893761,Bartulis; Jason Michael,16,0,20,4
1746614789757,MCWP 50R,A00,893766,Compas; Sean Matthew,0,1,20,20
1746614789757,MCWP 50R,B00,893769,Carter; Jennifer A,0,1,20,20
1746614789757,MCWP 50R,C00,893771,Krone; Jarret,0,3,20,20
1746614789757,MCWP 50R,D00,893772,Miller; Elizabeth Deen,0,0,20,20
1746614789757,MCWP 50R,E00,893775,Carter; Andrea L,0,1,20,20
1746614790784,MMW 11R,A01,892721,Herbst; Matthew,14,0,30,16
1746614790784,MMW 11R,A02,892722,Herbst; Matthew,0,0,0,3
1746614791810,MMW 12R,A01,892724,Herbst; Matthew,0,11,16,16
1746614791810,MMW 12R,A02,892725,Herbst; Matthew,0,10,16,16
1746614792838,MMW 13R,A01,892727,Staff,0,4,16,16
1746614792838,MMW 13R,A02,892728,Staff,0,4,16,16
1746614792838,MMW 13R,A03,958032,Staff,0,4,16,16
1746614792838,MMW 13R,A04,958033,Staff,0,4,16,16
1746614792838,MMW 13R,A05,958034,Staff,0,4,16,16
1746614793865,SIO 295LS,A00,894015,Staff,5,0,25,20
1746614794894,SIO 295S,A00,894020,Staff,5,0,25,20
1746614795927,SIOC 290S,B01,958918,Merrifield; Mark A,14,0,30,16
1746614796957,SIOC 291S,B01,958922,Gabriel; Corey John,14,0,30,16
1746614797985,SOCI 117,A01,895339,Staff,2,0,5,3
1746614799018,WES 237B,A00,894149,Staff,11,0,20,9
1746614801108,AESE 279B,A00,891859,Staff,13,0,35,22
1746614802136,AIP 197,001,891854,Vespa; Emanuel Ignacio,9999,0,9999,0
1746614803171,ANTH 289S,A00,891856,Gagneux; Pascal,12,0,12,0
1746614804210,BENG 196,001,957946,Engler; Adam J.,9996,0,9999,3
1746614805235,BISP 197,001,959851,Wilhelm; James E.,9998,0,9999,1
1746614806262,CAT 124RS,A01,956906,Staff,6,0,25,19
1746614807291,CAT 125RS,A01,922013,Staff,6,0,25,19
1746614808318,CLRE 250,A00,891860,Morris; Sheldon,9995,0,9999,4
1746614810378,CLRE 251R,A00,907817,Mehta; Ravindra L.,9994,0,9999,5
1746614811406,CLRE 252,A00,891864,Cuomo; Raphael Eduardo,9993,0,9999,6
1746614812434,CLRE 253,A00,891867,Vaida; Florin,9994,0,9999,5
1746614812434,CLRE 253,B00,907819,Staff,9999,0,9999,0
1746614813463,CLRE 259,A00,891868,Patel; Hemal,9998,0,9999,1
1746614814490,CLRE 260,A00,891872,Cuomo; Raphael Eduardo,9999,0,9999,0
1746614815518,CLRE 297,001,891888,Cuomo; Raphael Eduardo,9999,0,9999,0
1746614816543,CSE 191,A00,958773,Minnes Kemp; Mor Mia,9995,0,9999,4
1746614817570,CSE 197,001,959846,Minnes Kemp; Mor Mia,9990,0,9999,9
1746614818597,CSS 201S,A01,892054,Mignozzetti; Umberto,25,0,30,5
1746614819624,CSS 202S,A01,892056,Mignozzetti; Umberto,25,0,30,5
1746614820655,DSC 197,001,956898,Eldridge; Justin Matthew,9996,0,9999,3
1746614821685,DSC 297,001,958000,Mazumdar; Arya,9998,0,9999,1
1746614821685,DSC 297,002,959862,Wang; Yusu,9998,0,9999,1
1746614822712,EAP 100,A00,905686,Staff,9778,0,9999,221
1746614823743,ECE 45,A01,892618,Staff,0,0,65,65
1746614825855,ECE 111,A01,892719,Staff,6,0,65,59
1746614826882,ECE 197,001,957920,Mercier; Patrick Philip,9991,0,9999,8
1746614827912,ECON 178,A01,907814,Zhu; Ying,26,0,35,9
1746614828939,EDS 115,A00,895312,Staff,35,0,45,10
1746614829967,EDS 117,A01,895337,Staff,23,0,30,7
1746614830998,EDS 125,A00,895341,Jones; Gabrielle Anastasia,36,0,45,9
1746614832025,EDS 128A,A01,895459,Fargason; Sharon Gayle,44,0,45,1
1746614833051,EDS 128B,A01,895543,Pappas; Elizabeth,44,0,45,1
1746614834078,EDS 139,A00,897203,Pappas; Elizabeth,44,0,45,1
1746614834078,EDS 139,B00,897209,Fargason; Sharon Gayle,41,0,45,4
1746614835109,EDS 201,A00,895545,Staff,22,0,45,23
1746614836138,EDS 203,A01,895581,Halter; Christopher P.,22,0,45,23
1746614837168,EDS 204R,A01,895625,Heinzman; Erica M.,39,0,45,6
1746614837168,EDS 204R,B01,895693,Halter; Christopher P.,10,0,45,35
1746614838194,EDS 206R,A00,895694,Fargason; Sharon Gayle,1,0,30,29
1746614838194,EDS 206R,B00,895695,Choi; Bailey Miyeon,16,0,30,14
1746614839219,EDS 250,A00,895697,Hemans; Patricia Ann Benitez,22,0,45,23
1746614840247,EDS 281,A00,895701,Meyerott; Theresa Ann,1,0,15,14
1746614841277,EDS 284,A00,895736,Meyerott; Theresa Ann,1,0,15,14
1746614842304,EDS 286,A00,897210,Fine; Sarah,0,0,15,15
1746614843336,EDS 289C,A01,895770,Daly; Alan J.,1,0,15,14
1746614844364,EDS 290,A00,897211,Hofstetter; Carolyn,0,0,15,15
1746614845393,LIGM 5A,A00,896162,Fischer-Grunski; Eva K,12,0,20,8
1746614846419,LIGM 5B,A00,896260,Fischer-Grunski; Eva K,17,0,20,3
1746614847452,LIGM 5C,A00,896308,Fischer-Grunski; Eva K,18,0,20,2
1746614848478,LIIT 5AS,A00,896313,Carnelos; Chiara,18,0,20,2
1746614849506,LIIT 5BS,A00,896416,Carnelos; Chiara,20,0,20,0
1746614850532,LIIT 5CS,A00,896564,Carnelos; Chiara,20,0,20,0
1746614851563,LISP 5A,A00,896588,Munoz Sanchez; Alicia,2,0,20,18
1746614852590,LISP 5B,A00,896653,Munoz Sanchez; Alicia,7,0,20,13
1746614853618,LISP 5C,A00,896655,Munoz Sanchez; Alicia,0,1,20,20
1746614854648,MAE 197,001,957918,Kleissl; Jan,9996,0,9999,3
1746614854648,MAE 197,002,959806,Boechler; Nicholas Sebastia,9998,0,9999,1
1746614854648,MAE 197,003,959852,Mullin; Jennifer S,9998,0,9999,1
1746614855679,MATH 2,A01,957937,Staff,33,0,35,2
1746614856707,MATH 197,001,957876,Kedlaya; Kiran S.,9993,0,9999,6
1746614857736,MCWP 40,A00,892729,Duru; Nur,10,0,20,10
1746614857736,MCWP 40,B00,893304,Montejo; Carolina,14,0,20,6
1746614858763,MCWP 40R,A00,893757,Redela; Pamela Morgan,0,5,20,20
1746614859791,MCWP 50,A00,893758,Morshed; Michael James,0,0,20,20
1746614859791,MCWP 50,B00,893761,Bartulis; Jason Michael,16,0,20,4
1746614860821,MCWP 50R,A00,893766,Compas; Sean Matthew,0,1,20,20
1746614860821,MCWP 50R,B00,893769,Carter; Jennifer A,0,1,20,20
1746614860821,MCWP 50R,C00,893771,Krone; Jarret,0,3,20,20
1746614860821,MCWP 50R,D00,893772,Miller; Elizabeth Deen,0,0,20,20
1746614860821,MCWP 50R,E00,893775,Carter; Andrea L,0,1,20,20
1746614861846,MMW 11R,A01,892721,Herbst; Matthew,14,0,30,16
1746614861846,MMW 11R,A02,892722,Herbst; Matthew,0,0,0,3
1746614862873,MMW 12R,A01,892724,Herbst; Matthew,0,11,16,16
1746614862873,MMW 12R,A02,892725,Herbst; Matthew,0,10,16,16
1746614863901,MMW 13R,A01,892727,Staff,0,4,16,16
1746614863901,MMW 13R,A02,892728,Staff,0,4,16,16
1746614863901,MMW 13R,A03,958032,Staff,0,4,16,16
1746614863901,MMW 13R,A04,958033,Staff,0,4,16,16
1746614863901,MMW 13R,A05,958034,Staff,0,4,16,16
1746614864928,SIO 295LS,A00,894015,Staff,5,0,25,20
1746614865954,SIO 295S,A00,894020,Staff,5,0,25,20
1746614866983,SIOC 290S,B01,958918,Merrifield; Mark A,14,0,30,16
1746614868012,SIOC 291S,B01,958922,Gabriel; Corey John,14,0,30,16
1746614869038,SOCI 117,A01,895339,Staff,2,0,5,3
1746614870068,WES 237B,A00,894149,Staff,11,0,20,9
1746614872156,AESE 279B,A00,891859,Staff,13,0,35,22
1746614873184,AIP 197,001,891854,Vespa; Emanuel Ignacio,9999,0,9999,0
1746614874211,ANTH 289S,A00,891856,Gagneux; Pascal,12,0,12,0
1746614875241,BENG 196,001,957946,Engler; Adam J.,9996,0,9999,3
1746614876277,BISP 197,001,959851,Wilhelm; James E.,9998,0,9999,1
1746614877308,CAT 124RS,A01,956906,Staff,6,0,25,19
1746614878335,CAT 125RS,A01,922013,Staff,6,0,25,19
1746614879365,CLRE 250,A00,891860,Morris; Sheldon,9995,0,9999,4
1746614881420,CLRE 251R,A00,907817,Mehta; Ravindra L.,9994,0,9999,5
1746614882447,CLRE 252,A00,891864,Cuomo; Raphael Eduardo,9993,0,9999,6
1746614883476,CLRE 253,A00,891867,Vaida; Florin,9994,0,9999,5
1746614883476,CLRE 253,B00,907819,Staff,9999,0,9999,0
1746614884502,CLRE 259,A00,891868,Patel; Hemal,9998,0,9999,1
1746614885530,CLRE 260,A00,891872,Cuomo; Raphael Eduardo,9999,0,9999,0
1746614886555,CLRE 297,001,891888,Cuomo; Raphael Eduardo,9999,0,9999,0
1746614887586,CSE 191,A00,958773,Minnes Kemp; Mor Mia,9995,0,9999,4
1746614888611,CSE 197,001,959846,Minnes Kemp; Mor Mia,9990,0,9999,9
1746614889638,CSS 201S,A01,892054,Mignozzetti; Umberto,25,0,30,5
1746614890671,CSS 202S,A01,892056,Mignozzetti; Umberto,25,0,30,5
1746614891699,DSC 197,001,956898,Eldridge; Justin Matthew,9996,0,9999,3
1746614892730,DSC 297,001,958000,Mazumdar; Arya,9998,0,9999,1
1746614892730,DSC 297,002,959862,Wang; Yusu,9998,0,9999,1
1746614893758,EAP 100,A00,905686,Staff,9778,0,9999,221
1746614894789,ECE 45,A01,892618,Staff,0,0,65,65
1746614896843,ECE 111,A01,892719,Staff,6,0,65,59
1746614897871,ECE 197,001,957920,Mercier; Patrick Philip,9991,0,9999,8
1746614898899,ECON 178,A01,907814,Zhu; Ying,26,0,35,9
1746614899928,EDS 115,A00,895312,Staff,35,0,45,10
1746614900955,EDS 117,A01,895337,Staff,23,0,30,7
1746614901985,EDS 125,A00,895341,Jones; Gabrielle Anastasia,36,0,45,9
1746614903014,EDS 128A,A01,895459,Fargason; Sharon Gayle,44,0,45,1
1746614904041,EDS 128B,A01,895543,Pappas; Elizabeth,44,0,45,1
1746614905067,EDS 139,A00,897203,Pappas; Elizabeth,44,0,45,1
1746614905067,EDS 139,B00,897209,Fargason; Sharon Gayle,41,0,45,4
1746614906092,EDS 201,A00,895545,Staff,22,0,45,23
1746614907118,EDS 203,A01,895581,Halter; Christopher P.,22,0,45,23
1746614908142,EDS 204R,A01,895625,Heinzman; Erica M.,39,0,45,6
1746614908142,EDS 204R,B01,895693,Halter; Christopher P.,10,0,45,35
1746614909169,EDS 206R,A00,895694,Fargason; Sharon Gayle,1,0,30,29
1746614909169,EDS 206R,B00,895695,Choi; Bailey Miyeon,16,0,30,14
1746614910194,EDS 250,A00,895697,Hemans; Patricia Ann Benitez,22,0,45,23
1746614911222,EDS 281,A00,895701,Meyerott; Theresa Ann,1,0,15,14
1746614912247,EDS 284,A00,895736,Meyerott; Theresa Ann,1,0,15,14
1746614913273,EDS 286,A00,897210,Fine; Sarah,0,0,15,15
1746614914301,EDS 289C,A01,895770,Daly; Alan J.,1,0,15,14
1746614915330,EDS 290,A00,897211,Hofstetter; Carolyn,0,0,15,15
1746614916357,LIGM 5A,A00,896162,Fischer-Grunski; Eva K,12,0,20,8
1746614917385,LIGM 5B,A00,896260,Fischer-Grunski; Eva K,17,0,20,3
1746614918414,LIGM 5C,A00,896308,Fischer-Grunski; Eva K,18,0,20,2
1746614919446,LIIT 5AS,A00,896313,Carnelos; Chiara,18,0,20,2
1746614920477,LIIT 5BS,A00,896416,Carnelos; Chiara,20,0,20,0
1746614921505,LIIT 5CS,A00,896564,Carnelos; Chiara,20,0,20,0
1746614922531,LISP 5A,A00,896588,Munoz Sanchez; Alicia,2,0,20,18
1746614923563,LISP 5B,A00,896653,Munoz Sanchez; Alicia,7,0,20,13
1746614924596,LISP 5C,A00,896655,Munoz Sanchez; Alicia,0,1,20,20
1746614925664,MAE 197,001,957918,Kleissl; Jan,9996,0,9999,3
1746614925664,MAE 197,002,959806,Boechler; Nicholas Sebastia,9998,0,9999,1
1746614925664,MAE 197,003,959852,Mullin; Jennifer S,9998,0,9999,1
1746614926692,MATH 2,A01,957937,Staff,33,0,35,2
1746614927718,MATH 197,001,957876,Kedlaya; Kiran S.,9993,0,9999,6
1746614928746,MCWP 40,A00,892729,Duru; Nur,10,0,20,10
1746614928746,MCWP 40,B00,893304,Montejo; Carolina,14,0,20,6
1746614929779,MCWP 40R,A00,893757,Redela; Pamela Morgan,0,5,20,20
1746614930807,MCWP 50,A00,893758,Morshed; Michael James,0,0,20,20
1746614930807,MCWP 50,B00,893761,Bartulis; Jason Michael,16,0,20,4
1746614931835,MCWP 50R,A00,893766,Compas; Sean Matthew,0,1,20,20
1746614931835,MCWP 50R,B00,893769,Carter; Jennifer A,0,1,20,20
1746614931835,MCWP 50R,C00,893771,Krone; Jarret,0,3,20,20
1746614931835,MCWP 50R,D00,893772,Miller; Elizabeth Deen,0,0,20,20
1746614931835,MCWP 50R,E00,893775,Carter; Andrea L,0,1,20,20
1746614932864,MMW 11R,A01,892721,Herbst; Matthew,14,0,30,16
1746614932864,MMW 11R,A02,892722,Herbst; Matthew,0,0,0,3
1746614933888,MMW 12R,A01,892724,Herbst; Matthew,0,11,16,16
1746614933888,MMW 12R,A02,892725,Herbst; Matthew,0,10,16,16
1746614934918,MMW 13R,A01,892727,Staff,0,4,16,16
1746614934918,MMW 13R,A02,892728,Staff,0,4,16,16
1746614934918,MMW 13R,A03,958032,Staff,0,4,16,16
1746614934918,MMW 13R,A04,958033,Staff,0,4,16,16
1746614934918,MMW 13R,A05,958034,Staff,0,4,16,16
1746614935944,SIO 295LS,A00,894015,Staff,5,0,25,20
1746614936969,SIO 295S,A00,894020,Staff,5,0,25,20
1746614938002,SIOC 290S,B01,958918,Merrifield; Mark A,14,0,30,16
1746614939029,SIOC 291S,B01,958922,Gabriel; Corey John,14,0,30,16
1746614940057,SOCI 117,A01,895339,Staff,2,0,5,3
1746614941086,WES 237B,A00,894149,Staff,11,0,20,9
1746614943176,AESE 279B,A00,891859,Staff,13,0,35,22
1746614944201,AIP 197,001,891854,Vespa; Emanuel Ignacio,9999,0,9999,0
1746614945231,ANTH 289S,A00,891856,Gagneux; Pascal,12,0,12,0
1746614946256,BENG 196,001,957946,Engler; Adam J.,9996,0,9999,3
1746614947281,BISP 197,001,959851,Wilhelm; James E.,9998,0,9999,1
1746614948309,CAT 124RS,A01,956906,Staff,6,0,25,19
1746614949335,CAT 125RS,A01,922013,Staff,6,0,25,19
1746614950363,CLRE 250,A00,891860,Morris; Sheldon,9995,0,9999,4
1746614952420,CLRE 251R,A00,907817,Mehta; Ravindra L.,9994,0,9999,5
1746614953446,CLRE 252,A00,891864,Cuomo; Raphael Eduardo,9993,0,9999,6
1746614954472,CLRE 253,A00,891867,Vaida; Florin,9994,0,9999,5
1746614954472,CLRE 253,B00,907819,Staff,9999,0,9999,0
1746614955499,CLRE 259,A00,891868,Patel; Hemal,9998,0,9999,1
1746614956527,CLRE 260,A00,891872,Cuomo; Raphael Eduardo,9999,0,9999,0
1746614957557,CLRE 297,001,891888,Cuomo; Raphael Eduardo,9999,0,9999,0
1746614958585,CSE 191,A00,958773,Minnes Kemp; Mor Mia,9995,0,9999,4
1746614959614,CSE 197,001,959846,Minnes Kemp; Mor Mia,9990,0,9999,9
1746614960642,CSS 201S,A01,892054,Mignozzetti; Umberto,25,0,30,5
1746614961671,CSS 202S,A01,892056,Mignozzetti; Umberto,25,0,30,5
1746614962699,DSC 197,001,956898,Eldridge; Justin Matthew,9996,0,9999,3
1746614963742,DSC 297,001,958000,Mazumdar; Arya,9998,0,9999,1
1746614963742,DSC 297,002,959862,Wang; Yusu,9998,0,9999,1
1746614964769,EAP 100,A00,905686,Staff,9778,0,9999,221
1746614965796,ECE 45,A01,892618,Staff,0,0,65,65
1746614967852,ECE 111,A01,892719,Staff,6,0,65,59
1746614968879,ECE 197,001,957920,Mercier; Patrick Philip,9991,0,9999,8
1746614969905,ECON 178,A01,907814,Zhu; Ying,26,0,35,9
1746614970935,EDS 115,A00,895312,Staff,35,0,45,10
1746614971960,EDS 117,A01,895337,Staff,23,0,30,7
1746614972987,EDS 125,A00,895341,Jones; Gabrielle Anastasia,36,0,45,9
1746614974015,EDS 128A,A01,895459,Fargason; Sharon Gayle,44,0,45,1
1746614975041,EDS 128B,A01,895543,Pappas; Elizabeth,44,0,45,1
1746614976066,EDS 139,A00,897203,Pappas; Elizabeth,44,0,45,1
1746614976066,EDS 139,B00,897209,Fargason; Sharon Gayle,41,0,45,4
1746614977095,EDS 201,A00,895545,Staff,22,0,45,23
1746614978122,EDS 203,A01,895581,Halter; Christopher P.,22,0,45,23
1746614979151,EDS 204R,A01,895625,Heinzman; Erica M.,39,0,45,6
1746614979151,EDS 204R,B01,895693,Halter; Christopher P.,10,0,45,35
1746614980181,EDS 206R,A00,895694,Fargason; Sharon Gayle,1,0,30,29
1746614980181,EDS 206R,B00,895695,Choi; Bailey Miyeon,16,0,30,14
1746614981212,EDS 250,A00,895697,Hemans; Patricia Ann Benitez,22,0,45,23
1746614982239,EDS 281,A00,895701,Meyerott; Theresa Ann,1,0,15,14
1746614983265,EDS 284,A00,895736,Meyerott; Theresa Ann,1,0,15,14
1746614984292,EDS 286,A00,897210,Fine; Sarah,0,0,15,15
1746614985318,EDS 289C,A01,895770,Daly; Alan J.,1,0,15,14
1746614986356,EDS 290,A00,897211,Hofstetter; Carolyn,0,0,15,15
1746614987382,LIGM 5A,A00,896162,Fischer-Grunski; Eva K,12,0,20,8
1746614988409,LIGM 5B,A00,896260,Fischer-Grunski; Eva K,17,0,20,3
1746614989433,LIGM 5C,A00,896308,Fischer-Grunski; Eva K,18,0,20,2
1746614990460,LIIT 5AS,A00,896313,Carnelos; Chiara,18,0,20,2
1746614991487,LIIT 5BS,A00,896416,Carnelos; Chiara,20,0,20,0
1746614992515,LIIT 5CS,A00,896564,Carnelos; Chiara,20,0,20,0
1746614993543,LISP 5A,A00,896588,Munoz Sanchez; Alicia,2,0,20,18
1746614994570,LISP 5B,A00,896653,Munoz Sanchez; Alicia,7,0,20,13
1746614995596,LISP 5C,A00,896655,Munoz Sanchez; Alicia,0,1,20,20
1746614996625,MAE 197,001,957918,Kleissl; Jan,9996,0,9999,3
1746614996625,MAE 197,002,959806,Boechler; Nicholas Sebastia,9998,0,9999,1
1746614996625,MAE 197,003,959852,Mullin; Jennifer S,9998,0,9999,1
1746614997652,MATH 2,A01,957937,Staff,33,0,35,2
1746614998680,MATH 197,001,957876,Kedlaya; Kiran S.,9993,0,9999,6
1746614999707,MCWP 40,A00,892729,Duru; Nur,10,0,20,10
1746614999707,MCWP 40,B00,893304,Montejo; Carolina,14,0,20,6
1746615000738,MCWP 40R,A00,893757,Redela; Pamela Morgan,0,5,20,20
1746615001768,MCWP 50,A00,893758,Morshed; Michael James,0,0,20,20
1746615001768,MCWP 50,B00,893761,Bartulis; Jason Michael,16,0,20,4
1746615002799,MCWP 50R,A00,893766,Compas; Sean Matthew,0,1,20,20
1746615002799,MCWP 50R,B00,893769,Carter; Jennifer A,0,1,20,20
1746615002799,MCWP 50R,C00,893771,Krone; Jarret,0,3,20,20
1746615002799,MCWP 50R,D00,893772,Miller; Elizabeth Deen,0,0,20,20
1746615002799,MCWP 50R,E00,893775,Carter; Andrea L,0,1,20,20
1746615003826,MMW 11R,A01,892721,Herbst; Matthew,14,0,30,16
1746615003826,MMW 11R,A02,892722,Herbst; Matthew,0,0,0,3
1746615004854,MMW 12R,A01,892724,Herbst; Matthew,0,11,16,16
1746615004854,MMW 12R,A02,892725,Herbst; Matthew,0,10,16,16
1746615005883,MMW 13R,A01,892727,Staff,0,4,16,16
1746615005883,MMW 13R,A02,892728,Staff,0,4,16,16
1746615005883,MMW 13R,A03,958032,Staff,0,4,16,16
1746615005883,MMW 13R,A04,958033,Staff,0,4,16,16
1746615005883,MMW 13R,A05,958034,Staff,0,4,16,16
1746615006908,SIO 295LS,A00,894015,Staff,5,0,25,20
1746615007938,SIO 295S,A00,894020,Staff,5,0,25,20
1746615008970,SIOC 290S,B01,958918,Merrifield; Mark A,14,0,30,16
1746615009997,SIOC 291S,B01,958922,Gabriel; Corey John,14,0,30,16
1746615011028,SOCI 117,A01,895339,Staff,2,0,5,3
1746615012055,WES 237B,A00,894149,Staff,11,0,20,9
1746615014119,AESE 279B,A00,891859,Staff,13,0,35,22
1746615015146,AIP 197,001,891854,Vespa; Emanuel Ignacio,9999,0,9999,0
1746615016172,ANTH 289S,A00,891856,Gagneux; Pascal,12,0,12,0
1746615017198,BENG 196,001,957946,Engler; Adam J.,9996,0,9999,3
1746615018225,BISP 197,001,959851,Wilhelm; James E.,9998,0,9999,1
1746615019251,CAT 124RS,A01,956906,Staff,6,0,25,19
1746615020275,CAT 125RS,A01,922013,Staff,6,0,25,19
1746615021302,CLRE 250,A00,891860,Morris; Sheldon,9995,0,9999,4
1746615023353,CLRE 251R,A00,907817,Mehta; Ravindra L.,9994,0,9999,5
1746615024379,CLRE 252,A00,891864,Cuomo; Raphael Eduardo,9993,0,9999,6
1746615025403,CLRE 253,A00,891867,Vaida; Florin,9994,0,9999,5
1746615025403,CLRE 253,B00,907819,Staff,9999,0,9999,0
1746615026428,CLRE 259,A00,891868,Patel; Hemal,9998,0,9999,1
1746615027455,CLRE 260,A00,891872,Cuomo; Raphael Eduardo,9999,0,9999,0
1746615028481,CLRE 297,001,891888,Cuomo; Raphael Eduardo,9999,0,9999,0
1746615029507,CSE 191,A00,958773,Minnes Kemp; Mor Mia,9995,0,9999,4
1746615030536,CSE 197,001,959846,Minnes Kemp; Mor Mia,9990,0,9999,9
1746615031564,CSS 201S,A01,892054,Mignozzetti; Umberto,25,0,30,5
1746615032592,CSS 202S,A01,892056,Mignozzetti; Umberto,25,0,30,5
1746615033619,DSC 197,001,956898,Eldridge; Justin Matthew,9996,0,9999,3
1746615034647,DSC 297,001,958000,Mazumdar; Arya,9998,0,9999,1
1746615034647,DSC 297,002,959862,Wang; Yusu,9998,0,9999,1
1746615035675,EAP 100,A00,905686,Staff,9778,0,9999,221
1746615036704,ECE 45,A01,892618,Staff,0,0,65,65
1746615038757,ECE 111,A01,892719,Staff,6,0,65,59
1746615039786,ECE 197,001,957920,Mercier; Patrick Philip,9991,0,9999,8
1746615040812,ECON 178,A01,907814,Zhu; Ying,26,0,35,9
1746615041838,EDS 115,A00,895312,Staff,35,0,45,10
1746615042864,EDS 117,A01,895337,Staff,23,0,30,7
1746615043890,EDS 125,A00,895341,Jones; Gabrielle Anastasia,36,0,45,9
1746615044915,EDS 128A,A01,895459,Fargason; Sharon Gayle,44,0,45,1
1746615045941,EDS 128B,A01,895543,Pappas; Elizabeth,44,0,45,1
1746615046970,EDS 139,A00,897203,Pappas; Elizabeth,44,0,45,1
1746615046970,EDS 139,B00,897209,Fargason; Sharon Gayle,41,0,45,4
1746615048037,EDS 201,A00,895545,Staff,22,0,45,23
1746615049066,EDS 203,A01,895581,Halter; Christopher P.,22,0,45,23
1746615050093,EDS 204R,A01,895625,Heinzman; Erica M.,39,0,45,6
1746615050093,EDS 204R,B01,895693,Halter; Christopher P.,10,0,45,35
1746615051118,EDS 206R,A00,895694,Fargason; Sharon Gayle,1,0,30,29
1746615051118,EDS 206R,B00,895695,Choi; Bailey Miyeon,16,0,30,14
1746615052147,EDS 250,A00,895697,Hemans; Patricia Ann Benitez,22,0,45,23
1746615053175,EDS 281,A00,895701,Meyerott; Theresa Ann,1,0,15,14
1746615054202,EDS 284,A00,895736,Meyerott; Theresa Ann,1,0,15,14
1746615055229,EDS 286,A00,897210,Fine; Sarah,0,0,15,15
1746615056255,EDS 289C,A01,895770,Daly; Alan J.,1,0,15,14
1746615057280,EDS 290,A00,897211,Hofstetter; Carolyn,0,0,15,15
1746615058310,LIGM 5A,A00,896162,Fischer-Grunski; Eva K,12,0,20,8
1746615059339,LIGM 5B,A00,896260,Fischer-Grunski; Eva K,17,0,20,3
1746615060365,LIGM 5C,A00,896308,Fischer-Grunski; Eva K,18,0,20,2
1746615061392,LIIT 5AS,A00,896313,Carnelos; Chiara,18,0,20,2
1746615062426,LIIT 5BS,A00,896416,Carnelos; Chiara,20,0,20,0
1746615063454,LIIT 5CS,A00,896564,Carnelos; Chiara,20,0,20,0
1746615064480,LISP 5A,A00,896588,Munoz Sanchez; Alicia,2,0,20,18
1746615065507,LISP 5B,A00,896653,Munoz Sanchez; Alicia,7,0,20,13
1746615066534,LISP 5C,A00,896655,Munoz Sanchez; Alicia,0,1,20,20
1746615067559,MAE 197,001,957918,Kleissl; Jan,9996,0,9999,3
1746615067559,MAE 197,002,959806,Boechler; Nicholas Sebastia,9998,0,9999,1
1746615067559,MAE 197,003,959852,Mullin; Jennifer S,9998,0,9999,1
1746615068584,MATH 2,A01,957937,Staff,33,0,35,2
1746615069610,MATH 197,001,957876,Kedlaya; Kiran S.,9993,0,9999,6
1746615070637,MCWP 40,A00,892729,Duru; Nur,10,0,20,10
1746615070637,MCWP 40,B00,893304,Montejo; Carolina,14,0,20,6
1746615071663,MCWP 40R,A00,893757,Redela; Pamela Morgan,0,5,20,20
1746615072690,MCWP 50,A00,893758,Morshed; Michael James,0,0,20,20
1746615072690,MCWP 50,B00,893761,Bartulis; Jason Michael,16,0,20,4
1746615073717,MCWP 50R,A00,893766,Compas; Sean Matthew,0,1,20,20
1746615073717,MCWP 50R,B00,893769,Carter; Jennifer A,0,1,20,20
1746615073717,MCWP 50R,C00,893771,Krone; Jarret,0,3,20,20
1746615073717,MCWP 50R,D00,893772,Miller; Elizabeth Deen,0,0,20,20
1746615073717,MCWP 50R,E00,893775,Carter; Andrea L,0,1,20,20
1746615074747,MMW 11R,A01,892721,Herbst; Matthew,14,0,30,16
1746615074747,MMW 11R,A02,892722,Herbst; Matthew,0,0,0,3
1746615075774,MMW 12R,A01,892724,Herbst; Matthew,0,11,16,16
1746615075774,MMW 12R,A02,892725,Herbst; Matthew,0,10,16,16
1746615076798,MMW 13R,A01,892727,Staff,0,4,16,16
1746615076798,MMW 13R,A02,892728,Staff,0,4,16,16
1746615076798,MMW 13R,A03,958032,Staff,0,4,16,16
1746615076798,MMW 13R,A04,958033,Staff,0,4,16,16
1746615076798,MMW 13R,A05,958034,Staff,0,4,16,16
1746615077827,SIO 295LS,A00,894015,Staff,5,0,25,20
1746615078855,SIO 295S,A00,894020,Staff,5,0,25,20
1746615079887,SIOC 290S,B01,958918,Merrifield; Mark A,14,0,30,16
1746615080913,SIOC 291S,B01,958922,Gabriel; Corey John,14,0,30,16
1746615081941,SOCI 117,A01,895339,Staff,2,0,5,3
1746615082971,WES 237B,A00,894149,Staff,11,0,20,9
1746615085048,AESE 279B,A00,891859,Staff,13,0,35,22
1746615086074,AIP 197,001,891854,Vespa; Emanuel Ignacio,9999,0,9999,0
1746615087098,ANTH 289S,A00,891856,Gagneux; Pascal,12,0,12,0
1746615088126,BENG 196,001,957946,Engler; Adam J.,9996,0,9999,3
1746615089153,BISP 197,001,959851,Wilhelm; James E.,9998,0,9999,1
1746615090180,CAT 124RS,A01,956906,Staff,6,0,25,19
1746615091209,CAT 125RS,A01,922013,Staff,6,0,25,19
1746615092236,CLRE 250,A00,891860,Morris; Sheldon,9995,0,9999,4
1746615094299,CLRE 251R,A00,907817,Mehta; Ravindra L.,9994,0,9999,5
1746615095329,CLRE 252,A00,891864,Cuomo; Raphael Eduardo,9993,0,9999,6
1746615096358,CLRE 253,A00,891867,Vaida; Florin,9994,0,9999,5
1746615096358,CLRE 253,B00,907819,Staff,9999,0,9999,0
1746615097384,CLRE 259,A00,891868,Patel; Hemal,9998,0,9999,1
1746615098409,CLRE 260,A00,891872,Cuomo; Raphael Eduardo,9999,0,9999,0
1746615099435,CLRE 297,001,891888,Cuomo; Raphael Eduardo,9999,0,9999,0
1746615100464,CSE 191,A00,958773,Minnes Kemp; Mor Mia,9995,0,9999,4
1746615101492,CSE 197,001,959846,Minnes Kemp; Mor Mia,9990,0,9999,9
1746615102522,CSS 201S,A01,892054,Mignozzetti; Umberto,25,0,30,5
1746615103549,CSS 202S,A01,892056,Mignozzetti; Umberto,25,0,30,5
1746615104580,DSC 197,001,956898,Eldridge; Justin Matthew,9996,0,9999,3
1746615105611,DSC 297,001,958000,Mazumdar; Arya,9998,0,9999,1
1746615105611,DSC 297,002,959862,Wang; Yusu,9998,0,9999,1
1746615106637,EAP 100,A00,905686,Staff,9778,0,9999,221
1746615107668,ECE 45,A01,892618,Staff,0,0,65,65
1746615109723,ECE 111,A01,892719,Staff,6,0,65,59
1746615110750,ECE 197,001,957920,Mercier; Patrick Philip,9991,0,9999,8
1746615111777,ECON 178,A01,907814,Zhu; Ying,26,0,35,9
1746615112804,EDS 115,A00,895312,Staff,35,0,45,10
1746615113829,EDS 117,A01,895337,Staff,23,0,30,7
1746615114856,EDS 125,A00,895341,Jones; Gabrielle Anastasia,36,0,45,9
1746615115883,EDS 128A,A01,895459,Fargason; Sharon Gayle,44,0,45,1
1746615116912,EDS 128B,A01,895543,Pappas; Elizabeth,44,0,45,1
1746615117938,EDS 139,A00,897203,Pappas; Elizabeth,44,0,45,1
1746615117938,EDS 139,B00,897209,Fargason; Sharon Gayle,41,0,45,4
1746615118965,EDS 201,A00,895545,Staff,22,0,45,23
1746615119992,EDS 203,A01,895581,Halter; Christopher P.,22,0,45,23
1746615121017,EDS 204R,A01,895625,Heinzman; Erica M.,39,0,45,6
1746615121017,EDS 204R,B01,895693,Halter; Christopher P.,10,0,45,35
1746615122046,EDS 206R,A00,895694,Fargason; Sharon Gayle,1,0,30,29
1746615122046,EDS 206R,B00,895695,Choi; Bailey Miyeon,16,0,30,14
1746615123074,EDS 250,A00,895697,Hemans; Patricia Ann Benitez,22,0,45,23
1746615124104,EDS 281,A00,895701,Meyerott; Theresa Ann,1,0,15,14
1746615125133,EDS 284,A00,895736,Meyerott; Theresa Ann,1,0,15,14
1746615126163,EDS 286,A00,897210,Fine; Sarah,0,0,15,15
1746615127192,EDS 289C,A01,895770,Daly; Alan J.,1,0,15,14
1746615128218,EDS 290,A00,897211,Hofstetter; Carolyn,0,0,15,15
1746615129244,LIGM 5A,A00,896162,Fischer-Grunski; Eva K,12,0,20,8
1746615130269,LIGM 5B,A00,896260,Fischer-Grunski; Eva K,17,0,20,3
1746615131295,LIGM 5C,A00,896308,Fischer-Grunski; Eva K,18,0,20,2
1746615132321,LIIT 5AS,A00,896313,Carnelos; Chiara,18,0,20,2
1746615133347,LIIT 5BS,A00,896416,Carnelos; Chiara,20,0,20,0
1746615134375,LIIT 5CS,A00,896564,Carnelos; Chiara,20,0,20,0
1746615135404,LISP 5A,A00,896588,Munoz Sanchez; Alicia,2,0,20,18
1746615136430,LISP 5B,A00,896653,Munoz Sanchez; Alicia,7,0,20,13
1746615137456,LISP 5C,A00,896655,Munoz Sanchez; Alicia,0,1,20,20
1746615138483,MAE 197,001,957918,Kleissl; Jan,9996,0,9999,3
1746615138483,MAE 197,002,959806,Boechler; Nicholas Sebastia,9998,0,9999,1
1746615138483,MAE 197,003,959852,Mullin; Jennifer S,9998,0,9999,1
1746615139508,MATH 2,A01,957937,Staff,33,0,35,2
1746615140538,MATH 197,001,957876,Kedlaya; Kiran S.,9993,0,9999,6
1746615141569,MCWP 40,A00,892729,Duru; Nur,10,0,20,10
1746615141569,MCWP 40,B00,893304,Montejo; Carolina,14,0,20,6
1746615142599,MCWP 40R,A00,893757,Redela; Pamela Morgan,0,5,20,20
1746615143625,MCWP 50,A00,893758,Morshed; Michael James,0,0,20,20
1746615143625,MCWP 50,B00,893761,Bartulis; Jason Michael,16,0,20,4
1746615144657,MCWP 50R,A00,893766,Compas; Sean Matthew,0,1,20,20
1746615144657,MCWP 50R,B00,893769,Carter; Jennifer A,0,1,20,20
1746615144657,MCWP 50R,C00,893771,Krone; Jarret,0,3,20,20
1746615144657,MCWP 50R,D00,893772,Miller; Elizabeth Deen,0,0,20,20
1746615144657,MCWP 50R,E00,893775,Carter; Andrea L,0,1,20,20
1746615145683,MMW 11R,A01,892721,Herbst; Matthew,14,0,30,16
1746615145683,MMW 11R,A02,892722,Herbst; Matthew,0,0,0,3
1746615146714,MMW 12R,A01,892724,Herbst; Matthew,0,11,16,16
1746615146714,MMW 12R,A02,892725,Herbst; Matthew,0,10,16,16
1746615147740,MMW 13R,A01,892727,Staff,0,4,16,16
1746615147740,MMW 13R,A02,892728,Staff,0,4,16,16
1746615147740,MMW 13R,A03,958032,Staff,0,4,16,16
1746615147740,MMW 13R,A04,958033,Staff,0,4,16,16
1746615147740,MMW 13R,A05,958034,Staff,0,4,16,16
1746615148767,SIO 295LS,A00,894015,Staff,5,0,25,20
1746615149795,SIO 295S,A00,894020,Staff,5,0,25,20
1746615150824,SIOC 290S,B01,958918,Merrifield; Mark A,14,0,30,16
1746615151852,SIOC 291S,B01,958922,Gabriel; Corey John,14,0,30,16
1746615152881,SOCI 117,A01,895339,Staff,2,0,5,3
1746615153906,WES 237B,A00,894149,Staff,11,0,20,9
1746615156025,AESE 279B,A00,891859,Staff,13,0,35,22
1746615157050,AIP 197,001,891854,Vespa; Emanuel Ignacio,9999,0,9999,0
1746615158078,ANTH 289S,A00,891856,Gagneux; Pascal,12,0,12,0
1746615159103,BENG 196,001,957946,Engler; Adam J.,9996,0,9999,3
1746615160129,BISP 197,001,959851,Wilhelm; James E.,9998,0,9999,1
1746615161159,CAT 124RS,A01,956906,Staff,6,0,25,19
1746615162187,CAT 125RS,A01,922013,Staff,6,0,25,19
1746615163212,CLRE 250,A00,891860,Morris; Sheldon,9995,0,9999,4
1746615165272,CLRE 251R,A00,907817,Mehta; Ravindra L.,9994,0,9999,5
1746615166299,CLRE 252,A00,891864,Cuomo; Raphael Eduardo,9993,0,9999,6
1746615167326,CLRE 253,A00,891867,Vaida; Florin,9994,0,9999,5
1746615167326,CLRE 253,B00,907819,Staff,9999,0,9999,0
1746615168358,CLRE 259,A00,891868,Patel; Hemal,9998,0,9999,1
1746615169386,CLRE 260,A00,891872,Cuomo; Raphael Eduardo,9999,0,9999,0
1746615170412,CLRE 297,001,891888,Cuomo; Raphael Eduardo,9999,0,9999,0
1746615171440,CSE 191,A00,958773,Minnes Kemp; Mor Mia,9995,0,9999,4
1746615172467,CSE 197,001,959846,Minnes Kemp; Mor Mia,9990,0,9999,9
1746615173494,CSS 201S,A01,892054,Mignozzetti; Umberto,25,0,30,5
1746615174519,CSS 202S,A01,892056,Mignozzetti; Umberto,25,0,30,5
1746615175548,DSC 197,001,956898,Eldridge; Justin Matthew,9996,0,9999,3
1746615176574,DSC 297,001,958000,Mazumdar; Arya,9998,0,9999,1
1746615176574,DSC 297,002,959862,Wang; Yusu,9998,0,9999,1
1746615177601,EAP 100,A00,905686,Staff,9778,0,9999,221
1746615178631,ECE 45,A01,892618,Staff,0,0,65,65
1746615180688,ECE 111,A01,892719,Staff,6,0,65,59
1746615181713,ECE 197,001,957920,Mercier; Patrick Philip,9991,0,9999,8
1746615182744,ECON 178,A01,907814,Zhu; Ying,26,0,35,9
1746615183770,EDS 115,A00,895312,Staff,35,0,45,10
1746615184800,EDS 117,A01,895337,Staff,23,0,30,7
1746615185830,EDS 125,A00,895341,Jones; Gabrielle Anastasia,36,0,45,9
1746615186859,EDS 128A,A01,895459,Fargason; Sharon Gayle,44,0,45,1
1746615187887,EDS 128B,A01,895543,Pappas; Elizabeth,44,0,45,1
1746615188913,EDS 139,A00,897203,Pappas; Elizabeth,44,0,45,1
1746615188913,EDS 139,B00,897209,Fargason; Sharon Gayle,41,0,45,4
1746615189939,EDS 201,A00,895545,Staff,22,0,45,23
1746615190965,EDS 203,A01,895581,Halter; Christopher P.,22,0,45,23
1746615191992,EDS 204R,A01,895625,Heinzman; Erica M.,39,0,45,6
1746615191992,EDS 204R,B01,895693,Halter; Christopher P.,10,0,45,35
1746615193018,EDS 206R,A00,895694,Fargason; Sharon Gayle,1,0,30,29
1746615193018,EDS 206R,B00,895695,Choi; Bailey Miyeon,16,0,30,14
1746615194044,EDS 250,A00,895697,Hemans; Patricia Ann Benitez,22,0,45,23
1746615195071,EDS 281,A00,895701,Meyerott; Theresa Ann,1,0,15,14
1746615196101,EDS 284,A00,895736,Meyerott; Theresa Ann,1,0,15,14
1746615197127,EDS 286,A00,897210,Fine; Sarah,0,0,15,15
1746615198151,EDS 289C,A01,895770,Daly; Alan J.,1,0,15,14
1746615199178,EDS 290,A00,897211,Hofstetter; Carolyn,0,0,15,15
1746615200205,LIGM 5A,A00,896162,Fischer-Grunski; Eva K,12,0,20,8
1746615201232,LIGM 5B,A00,896260,Fischer-Grunski; Eva K,17,0,20,3
1746615202258,LIGM 5C,A00,896308,Fischer-Grunski; Eva K,18,0,20,2
1746615203283,LIIT 5AS,A00,896313,Carnelos; Chiara,18,0,20,2
1746615204317,LIIT 5BS,A00,896416,Carnelos; Chiara,20,0,20,0
1746615205344,LIIT 5CS,A00,896564,Carnelos; Chiara,20,0,20,0
1746615206370,LISP 5A,A00,896588,Munoz Sanchez; Alicia,2,0,20,18
1746615207398,LISP 5B,A00,896653,Munoz Sanchez; Alicia,7,0,20,13
1746615208427,LISP 5C,A00,896655,Munoz Sanchez; Alicia,0,1,20,20
1746615209457,MAE 197,001,957918,Kleissl; Jan,9996,0,9999,3
1746615209457,MAE 197,002,959806,Boechler; Nicholas Sebastia,9998,0,9999,1
1746615209457,MAE 197,003,959852,Mullin; Jennifer S,9998,0,9999,1
1746615210490,MATH 2,A01,957937,Staff,33,0,35,2
1746615211516,MATH 197,001,957876,Kedlaya; Kiran S.,9993,0,9999,6
1746615212546,MCWP 40,A00,892729,Duru; Nur,10,0,20,10
1746615212546,MCWP 40,B00,893304,Montejo; Carolina,14,0,20,6
1746615213571,MCWP 40R,A00,893757,Redela; Pamela Morgan,0,5,20,20
1746615214597,MCWP 50,A00,893758,Morshed; Michael James,0,0,20,20
1746615214597,MCWP 50,B00,893761,Bartulis; Jason Michael,16,0,20,4
1746615215628,MCWP 50R,A00,893766,Compas; Sean Matthew,0,1,20,20
1746615215628,MCWP 50R,B00,893769,Carter; Jennifer A,0,1,20,20
1746615215628,MCWP 50R,C00,893771,Krone; Jarret,0,3,20,20
1746615215628,MCWP 50R,D00,893772,Miller; Elizabeth Deen,0,0,20,20
1746615215628,MCWP 50R,E00,893775,Carter; Andrea L,0,1,20,20
1746615216659,MMW 11R,A01,892721,Herbst; Matthew,14,0,30,16
1746615216659,MMW 11R,A02,892722,Herbst; Matthew,0,0,0,3
1746615217690,MMW 12R,A01,892724,Herbst; Matthew,0,11,16,16
1746615217690,MMW 12R,A02,892725,Herbst; Matthew,0,10,16,16
1746615218717,MMW 13R,A01,892727,Staff,0,4,16,16
1746615218717,MMW 13R,A02,892728,Staff,0,4,16,16
1746615218717,MMW 13R,A03,958032,Staff,0,4,16,16
1746615218717,MMW 13R,A04,958033,Staff,0,4,16,16
1746615218717,MMW 13R,A05,958034,Staff,0,4,16,16
1746615219744,SIO 295LS,A00,894015,Staff,5,0,25,20
1746615220771,SIO 295S,A00,894020,Staff,5,0,25,20
1746615221799,SIOC 290S,B01,958918,Merrifield; Mark A,14,0,30,16
1746615222832,SIOC 291S,B01,958922,Gabriel; Corey John,14,0,30,16
1746615223859,SOCI 117,A01,895339,Staff,2,0,5,3
1746615224883,WES 237B,A00,894149,Staff,11,0,20,9
1746615226971,AESE 279B,A00,891859,Staff,13,0,35,22
1746615227998,AIP 197,001,891854,Vespa; Emanuel Ignacio,9999,0,9999,0
1746615229026,ANTH 289S,A00,891856,Gagneux; Pascal,12,0,12,0
1746615230054,BENG 196,001,957946,Engler; Adam J.,9996,0,9999,3
1746615231080,BISP 197,001,959851,Wilhelm; James E.,9998,0,9999,1
1746615232107,CAT 124RS,A01,956906,Staff,6,0,25,19
1746615233133,CAT 125RS,A01,922013,Staff,6,0,25,19
1746615234160,CLRE 250,A00,891860,Morris; Sheldon,9995,0,9999,4
1746615236215,CLRE 251R,A00,907817,Mehta; Ravindra L.,9994,0,9999,5
1746615237241,CLRE 252,A00,891864,Cuomo; Raphael Eduardo,9993,0,9999,6
1746615238269,CLRE 253,A00,891867,Vaida; Florin,9994,0,9999,5
1746615238269,CLRE 253,B00,907819,Staff,9999,0,9999,0
1746615239294,CLRE 259,A00,891868,Patel; Hemal,9998,0,9999,1
1746615240323,CLRE 260,A00,891872,Cuomo; Raphael Eduardo,9999,0,9999,0
1746615241350,CLRE 297,001,891888,Cuomo; Raphael Eduardo,9999,0,9999,0
1746615242377,CSE 191,A00,958773,Minnes Kemp; Mor Mia,9995,0,9999,4
1746615243405,CSE 197,001,959846,Minnes Kemp; Mor Mia,9990,0,9999,9
1746615244431,CSS 201S,A01,892054,Mignozzetti; Umberto,25,0,30,5
1746615245462,CSS 202S,A01,892056,Mignozzetti; Umberto,25,0,30,5
1746615246492,DSC 197,001,956898,Eldridge; Justin Matthew,9996,0,9999,3
1746615247522,DSC 297,001,958000,Mazumdar; Arya,9998,0,9999,1
1746615247522,DSC 297,002,959862,Wang; Yusu,9998,0,9999,1
1746615248550,EAP 100,A00,905686,Staff,9778,0,9999,221
1746615249581,ECE 45,A01,892618,Staff,0,0,65,65
1746615251638,ECE 111,A01,892719,Staff,6,0,65,59
1746615252663,ECE 197,001,957920,Mercier; Patrick Philip,9991,0,9999,8
1746615253689,ECON 178,A01,907814,Zhu; Ying,26,0,35,9
1746615254716,EDS 115,A00,895312,Staff,35,0,45,10
1746615255744,EDS 117,A01,895337,Staff,23,0,30,7
1746615256772,EDS 125,A00,895341,Jones; Gabrielle Anastasia,36,0,45,9
1746615257800,EDS 128A,A01,895459,Fargason; Sharon Gayle,44,0,45,1
1746615258869,EDS 128B,A01,895543,Pappas; Elizabeth,44,0,45,1
1746615259892,EDS 139,A00,897203,Pappas; Elizabeth,44,0,45,1
1746615259892,EDS 139,B00,897209,Fargason; Sharon Gayle,41,0,45,4
1746615260918,EDS 201,A00,895545,Staff,22,0,45,23
1746615261943,EDS 203,A01,895581,Halter; Christopher P.,22,0,45,23
1746615262969,EDS 204R,A01,895625,Heinzman; Erica M.,39,0,45,6
1746615262969,EDS 204R,B01,895693,Halter; Christopher P.,10,0,45,35
1746615263993,EDS 206R,A00,895694,Fargason; Sharon Gayle,1,0,30,29
1746615263993,EDS 206R,B00,895695,Choi; Bailey Miyeon,16,0,30,14
1746615265023,EDS 250,A00,895697,Hemans; Patricia Ann Benitez,22,0,45,23
1746615266047,EDS 281,A00,895701,Meyerott; Theresa Ann,1,0,15,14
1746615267076,EDS 284,A00,895736,Meyerott; Theresa Ann,1,0,15,14
1746615268104,EDS 286,A00,897210,Fine; Sarah,0,0,15,15
1746615269131,EDS 289C,A01,895770,Daly; Alan J.,1,0,15,14
1746615270159,EDS 290,A00,897211,Hofstetter; Carolyn,0,0,15,15
1746615271186,LIGM 5A,A00,896162,Fischer-Grunski; Eva K,12,0,20,8
1746615272212,LIGM 5B,A00,896260,Fischer-Grunski; Eva K,17,0,20,3
1746615273238,LIGM 5C,A00,896308,Fischer-Grunski; Eva K,18,0,20,2
1746615274263,LIIT 5AS,A00,896313,Carnelos; Chiara,18,0,20,2
1746615275295,LIIT 5BS,A00,896416,Carnelos; Chiara,20,0,20,0
1746615276325,LIIT 5CS,A00,896564,Carnelos; Chiara,20,0,20,0
1746615277354,LISP 5A,A00,896588,Munoz Sanchez; Alicia,2,0,20,18
1746615278379,LISP 5B,A00,896653,Munoz Sanchez; Alicia,7,0,20,13
1746615279409,LISP 5C,A00,896655,Munoz Sanchez; Alicia,0,1,20,20
1746615280437,MAE 197,001,957918,Kleissl; Jan,9996,0,9999,3
1746615280437,MAE 197,002,959806,Boechler; Nicholas Sebastia,9998,0,9999,1
1746615280437,MAE 197,003,959852,Mullin; Jennifer S,9998,0,9999,1
1746615281466,MATH 2,A01,957937,Staff,33,0,35,2
1746615282495,MATH 197,001,957876,Kedlaya; Kiran S.,9993,0,9999,6
1746615283524,MCWP 40,A00,892729,Duru; Nur,10,0,20,10
1746615283524,MCWP 40,B00,893304,Montejo; Carolina,14,0,20,6
1746615284554,MCWP 40R,A00,893757,Redela; Pamela Morgan,0,5,20,20
1746615285580,MCWP 50,A00,893758,Morshed; Michael James,0,0,20,20
1746615285580,MCWP 50,B00,893761,Bartulis; Jason Michael,16,0,20,4
1746615286609,MCWP 50R,A00,893766,Compas; Sean Matthew,0,1,20,20
1746615286609,MCWP 50R,B00,893769,Carter; Jennifer A,0,1,20,20
1746615286609,MCWP 50R,C00,893771,Krone; Jarret,0,3,20,20
1746615286609,MCWP 50R,D00,893772,Miller; Elizabeth Deen,0,0,20,20
1746615286609,MCWP 50R,E00,893775,Carter; Andrea L,0,1,20,20
1746615287638,MMW 11R,A01,892721,Herbst; Matthew,14,0,30,16
1746615287638,MMW 11R,A02,892722,Herbst; Matthew,0,0,0,3
1746615288667,MMW 12R,A01,892724,Herbst; Matthew,0,11,16,16
1746615288667,MMW 12R,A02,892725,Herbst; Matthew,0,10,16,16
1746615289696,MMW 13R,A01,892727,Staff,0,4,16,16
1746615289696,MMW 13R,A02,892728,Staff,0,4,16,16
1746615289696,MMW 13R,A03,958032,Staff,0,4,16,16
1746615289696,MMW 13R,A04,958033,Staff,0,4,16,16
1746615289696,MMW 13R,A05,958034,Staff,0,4,16,16
1746615290725,SIO 295LS,A00,894015,Staff,5,0,25,20
1746615291752,SIO 295S,A00,894020,Staff,5,0,25,20
1746615292786,SIOC 290S,B01,958918,Merrifield; Mark A,14,0,30,16
1746615293816,SIOC 291S,B01,958922,Gabriel; Corey John,14,0,30,16
1746615294844,SOCI 117,A01,895339,Staff,2,0,5,3
1746615295876,WES 237B,A00,894149,Staff,11,0,20,9
1746615297977,AESE 279B,A00,891859,Staff,13,0,35,22
1746615299007,AIP 197,001,891854,Vespa; Emanuel Ignacio,9999,0,9999,0
1746615300036,ANTH 289S,A00,891856,Gagneux; Pascal,12,0,12,0
1746615301066,BENG 196,001,957946,Engler; Adam J.,9996,0,9999,3
1746615302106,BISP 197,001,959851,Wilhelm; James E.,9998,0,9999,1
1746615303133,CAT 124RS,A01,956906,Staff,6,0,25,19
1746615304166,CAT 125RS,A01,922013,Staff,6,0,25,19
1746615305194,CLRE 250,A00,891860,Morris; Sheldon,9995,0,9999,4
1746615307250,CLRE 251R,A00,907817,Mehta; Ravindra L.,9994,0,9999,5
1746615308274,CLRE 252,A00,891864,Cuomo; Raphael Eduardo,9993,0,9999,6
1746615309304,CLRE 253,A00,891867,Vaida; Florin,9994,0,9999,5
1746615309304,CLRE 253,B00,907819,Staff,9999,0,9999,0
1746615310333,CLRE 259,A00,891868,Patel; Hemal,9998,0,9999,1
1746615311363,CLRE 260,A00,891872,Cuomo; Raphael Eduardo,9999,0,9999,0
1746615312402,CLRE 297,001,891888,Cuomo; Raphael Eduardo,9999,0,9999,0
1746615313429,CSE 191,A00,958773,Minnes Kemp; Mor Mia,9995,0,9999,4
1746615314458,CSE 197,001,959846,Minnes Kemp; Mor Mia,9990,0,9999,9
1746615315486,CSS 201S,A01,892054,Mignozzetti; Umberto,25,0,30,5
1746615316513,CSS 202S,A01,892056,Mignozzetti; Umberto,25,0,30,5
1746615317540,DSC 197,001,956898,Eldridge; Justin Matthew,9996,0,9999,3
1746615318569,DSC 297,001,958000,Mazumdar; Arya,9998,0,9999,1
1746615318569,DSC 297,002,959862,Wang; Yusu,9998,0,9999,1
1746615319596,EAP 100,A00,905686,Staff,9778,0,9999,221
1746615320627,ECE 45,A01,892618,Staff,0,0,65,65
1746615322690,ECE 111,A01,892719,Staff,6,0,65,59
1746615323719,ECE 197,001,957920,Mercier; Patrick Philip,9991,0,9999,8
1746615324748,ECON 178,A01,907814,Zhu; Ying,26,0,35,9
1746615325777,EDS 115,A00,895312,Staff,35,0,45,10
1746615326806,EDS 117,A01,895337,Staff,23,0,30,7
1746615327834,EDS 125,A00,895341,Jones; Gabrielle Anastasia,36,0,45,9
1746615328865,EDS 128A,A01,895459,Fargason; Sharon Gayle,44,0,45,1
1746615329890,EDS 128B,A01,895543,Pappas; Elizabeth,44,0,45,1
1746615330919,EDS 139,A00,897203,Pappas; Elizabeth,44,0,45,1
1746615330919,EDS 139,B00,897209,Fargason; Sharon Gayle,41,0,45,4
1746615331946,EDS 201,A00,895545,Staff,22,0,45,23
1746615332972,EDS 203,A01,895581,Halter; Christopher P.,22,0,45,23
1746615333998,EDS 204R,A01,895625,Heinzman; Erica M.,39,0,45,6
1746615333998,EDS 204R,B01,895693,Halter; Christopher P.,10,0,45,35
1746615335025,EDS 206R,A00,895694,Fargason; Sharon Gayle,1,0,30,29
1746615335025,EDS 206R,B00,895695,Choi; Bailey Miyeon,16,0,30,14
1746615336053,EDS 250,A00,895697,Hemans; Patricia Ann Benitez,22,0,45,23
1746615337079,EDS 281,A00,895701,Meyerott; Theresa Ann,1,0,15,14
1746615338105,EDS 284,A00,895736,Meyerott; Theresa Ann,1,0,15,14
1746615339133,EDS 286,A00,897210,Fine; Sarah,0,0,15,15
1746615340158,EDS 289C,A01,895770,Daly; Alan J.,1,0,15,14
1746615341186,EDS 290,A00,897211,Hofstetter; Carolyn,0,0,15,15
1746615342214,LIGM 5A,A00,896162,Fischer-Grunski; Eva K,12,0,20,8
1746615343240,LIGM 5B,A00,896260,Fischer-Grunski; Eva K,17,0,20,3
1746615344269,LIGM 5C,A00,896308,Fischer-Grunski; Eva K,18,0,20,2
1746615345297,LIIT 5AS,A00,896313,Carnelos; Chiara,18,0,20,2
1746615346322,LIIT 5BS,A00,896416,Carnelos; Chiara,20,0,20,0
1746615347351,LIIT 5CS,A00,896564,Carnelos; Chiara,20,0,20,0
1746615348377,LISP 5A,A00,896588,Munoz Sanchez; Alicia,2,0,20,18
1746615349406,LISP 5B,A00,896653,Munoz Sanchez; Alicia,7,0,20,13
1746615350436,LISP 5C,A00,896655,Munoz Sanchez; Alicia,0,1,20,20
1746615351467,MAE 197,001,957918,Kleissl; Jan,9996,0,9999,3
1746615351467,MAE 197,002,959806,Boechler; Nicholas Sebastia,9998,0,9999,1
1746615351467,MAE 197,003,959852,Mullin; Jennifer S,9998,0,9999,1
1746615352496,MATH 2,A01,957937,Staff,33,0,35,2
1746615353523,MATH 197,001,957876,Kedlaya; Kiran S.,9993,0,9999,6
1746615354553,MCWP 40,A00,892729,Duru; Nur,10,0,20,10
1746615354553,MCWP 40,B00,893304,Montejo; Carolina,14,0,20,6
1746615355579,MCWP 40R,A00,893757,Redela; Pamela Morgan,0,5,20,20
1746615356612,MCWP 50,A00,893758,Morshed; Michael James,0,0,20,20
1746615356612,MCWP 50,B00,893761,Bartulis; Jason Michael,16,0,20,4
1746615357645,MCWP 50R,A00,893766,Compas; Sean Matthew,0,1,20,20
1746615357645,MCWP 50R,B00,893769,Carter; Jennifer A,0,1,20,20
1746615357645,MCWP 50R,C00,893771,Krone; Jarret,0,3,20,20
1746615357645,MCWP 50R,D00,893772,Miller; Elizabeth Deen,0,0,20,20
1746615357645,MCWP 50R,E00,893775,Carter; Andrea L,0,1,20,20
1746615358671,MMW 11R,A01,892721,Herbst; Matthew,14,0,30,16
1746615358671,MMW 11R,A02,892722,Herbst; Matthew,0,0,0,3
1746615359697,MMW 12R,A01,892724,Herbst; Matthew,0,11,16,16
1746615359697,MMW 12R,A02,892725,Herbst; Matthew,0,10,16,16
1746615360724,MMW 13R,A01,892727,Staff,0,4,16,16
1746615360724,MMW 13R,A02,892728,Staff,0,4,16,16
1746615360724,MMW 13R,A03,958032,Staff,0,4,16,16
1746615360724,MMW 13R,A04,958033,Staff,0,4,16,16
1746615360724,MMW 13R,A05,958034,Staff,0,4,16,16
1746615361752,SIO 295LS,A00,894015,Staff,5,0,25,20
1746615362818,SIO 295S,A00,894020,Staff,5,0,25,20
1746615363844,SIOC 290S,B01,958918,Merrifield; Mark A,14,0,30,16
1746615364876,SIOC 291S,B01,958922,Gabriel; Corey John,14,0,30,16
1746615365900,SOCI 117,A01,895339,Staff,2,0,5,3
1746615366925,WES 237B,A00,894149,Staff,11,0,20,9
1746615369006,AESE 279B,A00,891859,Staff,13,0,35,22
1746615370050,AIP 197,001,891854,Vespa; Emanuel Ignacio,9999,0,9999,0
1746615371074,ANTH 289S,A00,891856,Gagneux; Pascal,12,0,12,0
1746615372101,BENG 196,001,957946,Engler; Adam J.,9996,0,9999,3
1746615373126,BISP 197,001,959851,Wilhelm; James E.,9998,0,9999,1
1746615374153,CAT 124RS,A01,956906,Staff,6,0,25,19
1746615375184,CAT 125RS,A01,922013,Staff,6,0,25,19
1746615376213,CLRE 250,A00,891860,Morris; Sheldon,9995,0,9999,4
1746615378270,CLRE 251R,A00,907817,Mehta; Ravindra L.,9994,0,9999,5
1746615379299,CLRE 252,A00,891864,Cuomo; Raphael Eduardo,9993,0,9999,6
1746615380323,CLRE 253,A00,891867,Vaida; Florin,9994,0,9999,5
1746615380323,CLRE 253,B00,907819,Staff,9999,0,9999,0
1746615381350,CLRE 259,A00,891868,Patel; Hemal,9998,0,9999,1
1746615382376,CLRE 260,A00,891872,Cuomo; Raphael Eduardo,9999,0,9999,0
1746615383401,CLRE 297,001,891888,Cuomo; Raphael Eduardo,9999,0,9999,0
1746615384426,CSE 191,A00,958773,Minnes Kemp; Mor Mia,9995,0,9999,4
1746615385454,CSE 197,001,959846,Minnes Kemp; Mor Mia,9990,0,9999,9
1746615386486,CSS 201S,A01,892054,Mignozzetti; Umberto,25,0,30,5
1746615387514,CSS 202S,A01,892056,Mignozzetti; Umberto,25,0,30,5
1746615388538,DSC 197,001,956898,Eldridge; Justin Matthew,9996,0,9999,3
1746615389565,DSC 297,001,958000,Mazumdar; Arya,9998,0,9999,1
1746615389565,DSC 297,002,959862,Wang; Yusu,9998,0,9999,1
1746615390595,EAP 100,A00,905686,Staff,9778,0,9999,221
1746615391624,ECE 45,A01,892618,Staff,0,0,65,65
1746615393678,ECE 111,A01,892719,Staff,6,0,65,59
1746615394704,ECE 197,001,957920,Mercier; Patrick Philip,9991,0,9999,8
1746615395730,ECON 178,A01,907814,Zhu; Ying,26,0,35,9
1746615396757,EDS 115,A00,895312,Staff,35,0,45,10
1746615397782,EDS 117,A01,895337,Staff,23,0,30,7
1746615398809,EDS 125,A00,895341,Jones; Gabrielle Anastasia,36,0,45,9
1746615399832,EDS 128A,A01,895459,Fargason; Sharon Gayle,44,0,45,1
1746615400858,EDS 128B,A01,895543,Pappas; Elizabeth,44,0,45,1
1746615401888,EDS 139,A00,897203,Pappas; Elizabeth,44,0,45,1
1746615401888,EDS 139,B00,897209,Fargason; Sharon Gayle,41,0,45,4
1746615402915,EDS 201,A00,895545,Staff,22,0,45,23
1746615403940,EDS 203,A01,895581,Halter; Christopher P.,22,0,45,23
1746615404967,EDS 204R,A01,895625,Heinzman; Erica M.,39,0,45,6
1746615404967,EDS 204R,B01,895693,Halter; Christopher P.,10,0,45,35
1746615405995,EDS 206R,A00,895694,Fargason; Sharon Gayle,1,0,30,29
1746615405995,EDS 206R,B00,895695,Choi; Bailey Miyeon,16,0,30,14
1746615407022,EDS 250,A00,895697,Hemans; Patricia Ann Benitez,22,0,45,23
1746615408049,EDS 281,A00,895701,Meyerott; Theresa Ann,1,0,15,14
1746615409076,EDS 284,A00,895736,Meyerott; Theresa Ann,1,0,15,14
1746615410103,EDS 286,A00,897210,Fine; Sarah,0,0,15,15
1746615411129,EDS 289C,A01,895770,Daly; Alan J.,1,0,15,14
1746615412155,EDS 290,A00,897211,Hofstetter; Carolyn,0,0,15,15
1746615413182,LIGM 5A,A00,896162,Fischer-Grunski; Eva K,12,0,20,8
1746615414211,LIGM 5B,A00,896260,Fischer-Grunski; Eva K,17,0,20,3
1746615415235,LIGM 5C,A00,896308,Fischer-Grunski; Eva K,18,0,20,2
1746615416265,LIIT 5AS,A00,896313,Carnelos; Chiara,18,0,20,2
1746615417292,LIIT 5BS,A00,896416,Carnelos; Chiara,20,0,20,0
1746615418321,LIIT 5CS,A00,896564,Carnelos; Chiara,20,0,20,0
1746615419348,LISP 5A,A00,896588,Munoz Sanchez; Alicia,2,0,20,18
1746615420380,LISP 5B,A00,896653,Munoz Sanchez; Alicia,7,0,20,13
1746615421405,LISP 5C,A00,896655,Munoz Sanchez; Alicia,0,1,20,20
1746615422435,MAE 197,001,957918,Kleissl; Jan,9996,0,9999,3
1746615422435,MAE 197,002,959806,Boechler; Nicholas Sebastia,9998,0,9999,1
1746615422435,MAE 197,003,959852,Mullin; Jennifer S,9998,0,9999,1
1746615423461,MATH 2,A01,957937,Staff,33,0,35,2
1746615424484,MATH 197,001,957876,Kedlaya; Kiran S.,9993,0,9999,6
1746615425511,MCWP 40,A00,892729,Duru; Nur,10,0,20,10
1746615425511,MCWP 40,B00,893304,Montejo; Carolina,14,0,20,6
1746615426539,MCWP 40R,A00,893757,Redela; Pamela Morgan,0,5,20,20
1746615427564,MCWP 50,A00,893758,Morshed; Michael James,0,0,20,20
1746615427564,MCWP 50,B00,893761,Bartulis; Jason Michael,16,0,20,4
1746615428596,MCWP 50R,A00,893766,Compas; Sean Matthew,0,1,20,20
1746615428596,MCWP 50R,B00,893769,Carter; Jennifer A,0,1,20,20
1746615428596,MCWP 50R,C00,893771,Krone; Jarret,0,3,20,20
1746615428596,MCWP 50R,D00,893772,Miller; Elizabeth Deen,0,0,20,20
1746615428596,MCWP 50R,E00,893775,Carter; Andrea L,0,1,20,20
1746615429623,MMW 11R,A01,892721,Herbst; Matthew,14,0,30,16
1746615429623,MMW 11R,A02,892722,Herbst; Matthew,0,0,0,3
1746615430652,MMW 12R,A01,892724,Herbst; Matthew,0,11,16,16
1746615430652,MMW 12R,A02,892725,Herbst; Matthew,0,10,16,16
1746615431679,MMW 13R,A01,892727,Staff,0,4,16,16
1746615431679,MMW 13R,A02,892728,Staff,0,4,16,16
1746615431679,MMW 13R,A03,958032,Staff,0,4,16,16
1746615431679,MMW 13R,A04,958033,Staff,0,4,16,16
1746615431679,MMW 13R,A05,958034,Staff,0,4,16,16
1746615432706,SIO 295LS,A00,894015,Staff,5,0,25,20
1746615433732,SIO 295S,A00,894020,Staff,5,0,25,20
1746615434765,SIOC 290S,B01,958918,Merrifield; Mark A,14,0,30,16
1746615435791,SIOC 291S,B01,958922,Gabriel; Corey John,14,0,30,16
1746615436819,SOCI 117,A01,895339,Staff,2,0,5,3
1746615437848,WES 237B,A00,894149,Staff,11,0,20,9
1746615439922,AESE 279B,A00,891859,Staff,13,0,35,22
1746615440949,AIP 197,001,891854,Vespa; Emanuel Ignacio,9999,0,9999,0
1746615441980,ANTH 289S,A00,891856,Gagneux; Pascal,12,0,12,0
1746615443007,BENG 196,001,957946,Engler; Adam J.,9996,0,9999,3
1746615444036,BISP 197,001,959851,Wilhelm; James E.,9998,0,9999,1
1746615445087,CAT 124RS,A01,956906,Staff,6,0,25,19
1746615446113,CAT 125RS,A01,922013,Staff,6,0,25,19
1746615447140,CLRE 250,A00,891860,Morris; Sheldon,9995,0,9999,4
1746615449201,CLRE 251R,A00,907817,Mehta; Ravindra L.,9994,0,9999,5
1746615450230,CLRE 252,A00,891864,Cuomo; Raphael Eduardo,9993,0,9999,6
1746615451254,CLRE 253,A00,891867,Vaida; Florin,9994,0,9999,5
1746615451254,CLRE 253,B00,907819,Staff,9999,0,9999,0
1746615452280,CLRE 259,A00,891868,Patel; Hemal,9998,0,9999,1
1746615453308,CLRE 260,A00,891872,Cuomo; Raphael Eduardo,9999,0,9999,0
1746615454333,CLRE 297,001,891888,Cuomo; Raphael Eduardo,9999,0,9999,0
1746615455360,CSE 191,A00,958773,Minnes Kemp; Mor Mia,9995,0,9999,4
1746615456387,CSE 197,001,959846,Minnes Kemp; Mor Mia,9990,0,9999,9
1746615457417,CSS 201S,A01,892054,Mignozzetti; Umberto,25,0,30,5
1746615458443,CSS 202S,A01,892056,Mignozzetti; Umberto,25,0,30,5
1746615459471,DSC 197,001,956898,Eldridge; Justin Matthew,9996,0,9999,3
1746615460499,DSC 297,001,958000,Mazumdar; Arya,9998,0,9999,1
1746615460499,DSC 297,002,959862,Wang; Yusu,9998,0,9999,1
1746615461524,EAP 100,A00,905686,Staff,9778,0,9999,221
1746615462558,ECE 45,A01,892618,Staff,0,0,65,65
1746615464611,ECE 111,A01,892719,Staff,6,0,65,59
1746615465642,ECE 197,001,957920,Mercier; Patrick Philip,9991,0,9999,8
1746615466669,ECON 178,A01,907814,Zhu; Ying,26,0,35,9
1746615467698,EDS 115,A00,895312,Staff,35,0,45,10
1746615468723,EDS 117,A01,895337,Staff,23,0,30,7
1746615469751,EDS 125,A00,895341,Jones; Gabrielle Anastasia,36,0,45,9
1746615470779,EDS 128A,A01,895459,Fargason; Sharon Gayle,44,0,45,1
1746615471807,EDS 128B,A01,895543,Pappas; Elizabeth,44,0,45,1
1746615472834,EDS 139,A00,897203,Pappas; Elizabeth,44,0,45,1
1746615472834,EDS 139,B00,897209,Fargason; Sharon Gayle,41,0,45,4
1746615473864,EDS 201,A00,895545,Staff,22,0,45,23
1746615474894,EDS 203,A01,895581,Halter; Christopher P.,22,0,45,23
1746615475922,EDS 204R,A01,895625,Heinzman; Erica M.,39,0,45,6
1746615475922,EDS 204R,B01,895693,Halter; Christopher P.,10,0,45,35
1746615476950,EDS 206R,A00,895694,Fargason; Sharon Gayle,1,0,30,29
1746615476950,EDS 206R,B00,895695,Choi; Bailey Miyeon,16,0,30,14
1746615477980,EDS 250,A00,895697,Hemans; Patricia Ann Benitez,22,0,45,23
1746615479006,EDS 281,A00,895701,Meyerott; Theresa Ann,1,0,15,14
1746615480034,EDS 284,A00,895736,Meyerott; Theresa Ann,1,0,15,14
1746615481063,EDS 286,A00,897210,Fine; Sarah,0,0,15,15
1746615482092,EDS 289C,A01,895770,Daly; Alan J.,1,0,15,14
1746615483121,EDS 290,A00,897211,Hofstetter; Carolyn,0,0,15,15
1746615484146,LIGM 5A,A00,896162,Fischer-Grunski; Eva K,12,0,20,8
1746615485176,LIGM 5B,A00,896260,Fischer-Grunski; Eva K,17,0,20,3
1746615486203,LIGM 5C,A00,896308,Fischer-Grunski; Eva K,18,0,20,2
1746615487230,LIIT 5AS,A00,896313,Carnelos; Chiara,18,0,20,2
1746615488256,LIIT 5BS,A00,896416,Carnelos; Chiara,20,0,20,0
1746615489282,LIIT 5CS,A00,896564,Carnelos; Chiara,20,0,20,0
1746615490312,LISP 5A,A00,896588,Munoz Sanchez; Alicia,2,0,20,18
1746615491339,LISP 5B,A00,896653,Munoz Sanchez; Alicia,7,0,20,13
1746615492367,LISP 5C,A00,896655,Munoz Sanchez; Alicia,0,1,20,20
1746615493395,MAE 197,001,957918,Kleissl; Jan,9996,0,9999,3
1746615493395,MAE 197,002,959806,Boechler; Nicholas Sebastia,9998,0,9999,1
1746615493395,MAE 197,003,959852,Mullin; Jennifer S,9998,0,9999,1
1746615494428,MATH 2,A01,957937,Staff,33,0,35,2
1746615495455,MATH 197,001,957876,Kedlaya; Kiran S.,9993,0,9999,6
1746615496482,MCWP 40,A00,892729,Duru; Nur,10,0,20,10
1746615496482,MCWP 40,B00,893304,Montejo; Carolina,14,0,20,6
1746615497513,MCWP 40R,A00,893757,Redela; Pamela Morgan,0,5,20,20
1746615498540,MCWP 50,A00,893758,Morshed; Michael James,0,0,20,20
1746615498540,MCWP 50,B00,893761,Bartulis; Jason Michael,16,0,20,4
1746615499568,MCWP 50R,A00,893766,Compas; Sean Matthew,0,1,20,20
1746615499568,MCWP 50R,B00,893769,Carter; Jennifer A,0,1,20,20
1746615499568,MCWP 50R,C00,893771,Krone; Jarret,0,3,20,20
1746615499568,MCWP 50R,D00,893772,Miller; Elizabeth Deen,0,0,20,20
1746615499568,MCWP 50R,E00,893775,Carter; Andrea L,0,1,20,20
1746615500593,MMW 11R,A01,892721,Herbst; Matthew,14,0,30,16
1746615500593,MMW 11R,A02,892722,Herbst; Matthew,0,0,0,3
1746615501620,MMW 12R,A01,892724,Herbst; Matthew,0,11,16,16
1746615501620,MMW 12R,A02,892725,Herbst; Matthew,0,10,16,16
1746615502646,MMW 13R,A01,892727,Staff,0,4,16,16
1746615502646,MMW 13R,A02,892728,Staff,0,4,16,16
1746615502646,MMW 13R,A03,958032,Staff,0,4,16,16
1746615502646,MMW 13R,A04,958033,Staff,0,4,16,16
1746615502646,MMW 13R,A05,958034,Staff,0,4,16,16
1746615503672,SIO 295LS,A00,894015,Staff,5,0,25,20
1746615504699,SIO 295S,A00,894020,Staff,5,0,25,20
1746615505728,SIOC 290S,B01,958918,Merrifield; Mark A,14,0,30,16
1746615506766,SIOC 291S,B01,958922,Gabriel; Corey John,14,0,30,16
1746615507793,SOCI 117,A01,895339,Staff,2,0,5,3
1746615508828,WES 237B,A00,894149,Staff,11,0,20,9
1746615510901,AESE 279B,A00,891859,Staff,13,0,35,22
1746615511926,AIP 197,001,891854,Vespa; Emanuel Ignacio,9999,0,9999,0
1746615512956,ANTH 289S,A00,891856,Gagneux; Pascal,12,0,12,0
1746615513982,BENG 196,001,957946,Engler; Adam J.,9996,0,9999,3
1746615515009,BISP 197,001,959851,Wilhelm; James E.,9998,0,9999,1
1746615516036,CAT 124RS,A01,956906,Staff,6,0,25,19
1746615517075,CAT 125RS,A01,922013,Staff,6,0,25,19
1746615518101,CLRE 250,A00,891860,Morris; Sheldon,9995,0,9999,4
1746615520158,CLRE 251R,A00,907817,Mehta; Ravindra L.,9994,0,9999,5
1746615521183,CLRE 252,A00,891864,Cuomo; Raphael Eduardo,9993,0,9999,6
1746615522210,CLRE 253,A00,891867,Vaida; Florin,9994,0,9999,5
1746615522210,CLRE 253,B00,907819,Staff,9999,0,9999,0
1746615523241,CLRE 259,A00,891868,Patel; Hemal,9998,0,9999,1
1746615524268,CLRE 260,A00,891872,Cuomo; Raphael Eduardo,9999,0,9999,0
1746615525297,CLRE 297,001,891888,Cuomo; Raphael Eduardo,9999,0,9999,0
1746615526323,CSE 191,A00,958773,Minnes Kemp; Mor Mia,9995,0,9999,4
1746615527351,CSE 197,001,959846,Minnes Kemp; Mor Mia,9990,0,9999,9
1746615528377,CSS 201S,A01,892054,Mignozzetti; Umberto,25,0,30,5
1746615529407,CSS 202S,A01,892056,Mignozzetti; Umberto,25,0,30,5
1746615530438,DSC 197,001,956898,Eldridge; Justin Matthew,9996,0,9999,3
1746615531466,DSC 297,001,958000,Mazumdar; Arya,9998,0,9999,1
1746615531466,DSC 297,002,959862,Wang; Yusu,9998,0,9999,1
1746615532491,EAP 100,A00,905686,Staff,9778,0,9999,221
1746615533523,ECE 45,A01,892618,Staff,0,0,65,65
1746615535579,ECE 111,A01,892719,Staff,6,0,65,59
1746615536608,ECE 197,001,957920,Mercier; Patrick Philip,9991,0,9999,8
1746615537638,ECON 178,A01,907814,Zhu; Ying,26,0,35,9
1746615538665,EDS 115,A00,895312,Staff,35,0,45,10
1746615539691,EDS 117,A01,895337,Staff,23,0,30,7
1746615540720,EDS 125,A00,895341,Jones; Gabrielle Anastasia,36,0,45,9
1746615541747,EDS 128A,A01,895459,Fargason; Sharon Gayle,44,0,45,1
1746615542776,EDS 128B,A01,895543,Pappas; Elizabeth,44,0,45,1
1746615543803,EDS 139,A00,897203,Pappas; Elizabeth,44,0,45,1
1746615543803,EDS 139,B00,897209,Fargason; Sharon Gayle,41,0,45,4
1746615544831,EDS 201,A00,895545,Staff,22,0,45,23
1746615545858,EDS 203,A01,895581,Halter; Christopher P.,22,0,45,23
1746615546884,EDS 204R,A01,895625,Heinzman; Erica M.,39,0,45,6
1746615546884,EDS 204R,B01,895693,Halter; Christopher P.,10,0,45,35
1746615547908,EDS 206R,A00,895694,Fargason; Sharon Gayle,1,0,30,29
1746615547908,EDS 206R,B00,895695,Choi; Bailey Miyeon,16,0,30,14
1746615548937,EDS 250,A00,895697,Hemans; Patricia Ann Benitez,22,0,45,23
1746615549965,EDS 281,A00,895701,Meyerott; Theresa Ann,1,0,15,14
1746615550991,EDS 284,A00,895736,Meyerott; Theresa Ann,1,0,15,14
1746615552017,EDS 286,A00,897210,Fine; Sarah,0,0,15,15
1746615553045,EDS 289C,A01,895770,Daly; Alan J.,1,0,15,14
1746615554074,EDS 290,A00,897211,Hofstetter; Carolyn,0,0,15,15
1746615555103,LIGM 5A,A00,896162,Fischer-Grunski; Eva K,12,0,20,8
1746615556129,LIGM 5B,A00,896260,Fischer-Grunski; Eva K,17,0,20,3
1746615557154,LIGM 5C,A00,896308,Fischer-Grunski; Eva K,18,0,20,2
1746615558183,LIIT 5AS,A00,896313,Carnelos; Chiara,18,0,20,2
1746615559208,LIIT 5BS,A00,896416,Carnelos; Chiara,20,0,20,0
1746615560233,LIIT 5CS,A00,896564,Carnelos; Chiara,20,0,20,0
1746615561258,LISP 5A,A00,896588,Munoz Sanchez; Alicia,2,0,20,18
1746615562285,LISP 5B,A00,896653,Munoz Sanchez; Alicia,7,0,20,13
1746615563311,LISP 5C,A00,896655,Munoz Sanchez; Alicia,0,1,20,20
1746615564340,MAE 197,001,957918,Kleissl; Jan,9996,0,9999,3
1746615564340,MAE 197,002,959806,Boechler; Nicholas Sebastia,9998,0,9999,1
1746615564340,MAE 197,003,959852,Mullin; Jennifer S,9998,0,9999,1
1746615565365,MATH 2,A01,957937,Staff,33,0,35,2
1746615566394,MATH 197,001,957876,Kedlaya; Kiran S.,9993,0,9999,6
1746615567420,MCWP 40,A00,892729,Duru; Nur,10,0,20,10
1746615567420,MCWP 40,B00,893304,Montejo; Carolina,14,0,20,6
1746615568450,MCWP 40R,A00,893757,Redela; Pamela Morgan,0,5,20,20
1746615569481,MCWP 50,A00,893758,Morshed; Michael James,0,0,20,20
1746615569481,MCWP 50,B00,893761,Bartulis; Jason Michael,16,0,20,4
1746615570513,MCWP 50R,A00,893766,Compas; Sean Matthew,0,1,20,20
1746615570513,MCWP 50R,B00,893769,Carter; Jennifer A,0,1,20,20
1746615570513,MCWP 50R,C00,893771,Krone; Jarret,0,3,20,20
1746615570513,MCWP 50R,D00,893772,Miller; Elizabeth Deen,0,0,20,20
1746615570513,MCWP 50R,E00,893775,Carter; Andrea L,0,1,20,20
1746615571543,MMW 11R,A01,892721,Herbst; Matthew,14,0,30,16
1746615571543,MMW 11R,A02,892722,Herbst; Matthew,0,0,0,3
1746615572569,MMW 12R,A01,892724,Herbst; Matthew,0,11,16,16
1746615572569,MMW 12R,A02,892725,Herbst; Matthew,0,10,16,16
1746615573598,MMW 13R,A01,892727,Staff,0,4,16,16
1746615573598,MMW 13R,A02,892728,Staff,0,4,16,16
1746615573598,MMW 13R,A03,958032,Staff,0,4,16,16
1746615573598,MMW 13R,A04,958033,Staff,0,4,16,16
1746615573598,MMW 13R,A05,958034,Staff,0,4,16,16
1746615574624,SIO 295LS,A00,894015,Staff,5,0,25,20
1746615575654,SIO 295S,A00,894020,Staff,5,0,25,20
1746615576685,SIOC 290S,B01,958918,Merrifield; Mark A,14,0,30,16
1746615577712,SIOC 291S,B01,958922,Gabriel; Corey John,14,0,30,16
1746615578737,SOCI 117,A01,895339,Staff,2,0,5,3
1746615579765,WES 237B,A00,894149,Staff,11,0,20,9
1746615581844,AESE 279B,A00,891859,Staff,13,0,35,22
1746615582870,AIP 197,001,891854,Vespa; Emanuel Ignacio,9999,0,9999,0
1746615583902,ANTH 289S,A00,891856,Gagneux; Pascal,12,0,12,0
1746615584925,BENG 196,001,957946,Engler; Adam J.,9996,0,9999,3
1746615585950,BISP 197,001,959851,Wilhelm; James E.,9998,0,9999,1
1746615586976,CAT 124RS,A01,956906,Staff,6,0,25,19
1746615588004,CAT 125RS,A01,922013,Staff,6,0,25,19
1746615589033,CLRE 250,A00,891860,Morris; Sheldon,9995,0,9999,4
1746615591088,CLRE 251R,A00,907817,Mehta; Ravindra L.,9994,0,9999,5
1746615592115,CLRE 252,A00,891864,Cuomo; Raphael Eduardo,9993,0,9999,6
1746615593140,CLRE 253,A00,891867,Vaida; Florin,9994,0,9999,5
1746615593140,CLRE 253,B00,907819,Staff,9999,0,9999,0
1746615594166,CLRE 259,A00,891868,Patel; Hemal,9998,0,9999,1
1746615595193,CLRE 260,A00,891872,Cuomo; Raphael Eduardo,9999,0,9999,0
1746615596232,CLRE 297,001,891888,Cuomo; Raphael Eduardo,9999,0,9999,0
1746615597260,CSE 191,A00,958773,Minnes Kemp; Mor Mia,9995,0,9999,4
1746615598287,CSE 197,001,959846,Minnes Kemp; Mor Mia,9990,0,9999,9
1746615599311,CSS 201S,A01,892054,Mignozzetti; Umberto,25,0,30,5
1746615600341,CSS 202S,A01,892056,Mignozzetti; Umberto,25,0,30,5
1746615601369,DSC 197,001,956898,Eldridge; Justin Matthew,9996,0,9999,3
1746615602408,DSC 297,001,958000,Mazumdar; Arya,9998,0,9999,1
1746615602408,DSC 297,002,959862,Wang; Yusu,9998,0,9999,1
1746615603435,EAP 100,A00,905686,Staff,9778,0,9999,221
1746615604462,ECE 45,A01,892618,Staff,0,0,65,65
1746615606522,ECE 111,A01,892719,Staff,6,0,65,59
1746615607548,ECE 197,001,957920,Mercier; Patrick Philip,9991,0,9999,8
1746615608573,ECON 178,A01,907814,Zhu; Ying,26,0,35,9
1746615609603,EDS 115,A00,895312,Staff,35,0,45,10
1746615610630,EDS 117,A01,895337,Staff,23,0,30,7
1746615611658,EDS 125,A00,895341,Jones; Gabrielle Anastasia,36,0,45,9
1746615612683,EDS 128A,A01,895459,Fargason; Sharon Gayle,44,0,45,1
1746615613707,EDS 128B,A01,895543,Pappas; Elizabeth,44,0,45,1
1746615614736,EDS 139,A00,897203,Pappas; Elizabeth,44,0,45,1
1746615614736,EDS 139,B00,897209,Fargason; Sharon Gayle,41,0,45,4
1746615615762,EDS 201,A00,895545,Staff,22,0,45,23
1746615616788,EDS 203,A01,895581,Halter; Christopher P.,22,0,45,23
1746615617813,EDS 204R,A01,895625,Heinzman; Erica M.,39,0,45,6
1746615617813,EDS 204R,B01,895693,Halter; Christopher P.,10,0,45,35
1746615618841,EDS 206R,A00,895694,Fargason; Sharon Gayle,1,0,30,29
1746615618841,EDS 206R,B00,895695,Choi; Bailey Miyeon,16,0,30,14
1746615619866,EDS 250,A00,895697,Hemans; Patricia Ann Benitez,22,0,45,23
1746615620892,EDS 281,A00,895701,Meyerott; Theresa Ann,1,0,15,14
1746615621919,EDS 284,A00,895736,Meyerott; Theresa Ann,1,0,15,14
1746615622944,EDS 286,A00,897210,Fine; Sarah,0,0,15,15
1746615623972,EDS 289C,A01,895770,Daly; Alan J.,1,0,15,14
1746615625002,EDS 290,A00,897211,Hofstetter; Carolyn,0,0,15,15
1746615626033,LIGM 5A,A00,896162,Fischer-Grunski; Eva K,12,0,20,8
1746615627062,LIGM 5B,A00,896260,Fischer-Grunski; Eva K,17,0,20,3
1746615628091,LIGM 5C,A00,896308,Fischer-Grunski; Eva K,18,0,20,2
1746615629120,LIIT 5AS,A00,896313,Carnelos; Chiara,18,0,20,2
1746615630147,LIIT 5BS,A00,896416,Carnelos; Chiara,20,0,20,0
1746615631173,LIIT 5CS,A00,896564,Carnelos; Chiara,20,0,20,0
1746615632202,LISP 5A,A00,896588,Munoz Sanchez; Alicia,2,0,20,18
1746615633232,LISP 5B,A00,896653,Munoz Sanchez; Alicia,7,0,20,13
1746615634256,LISP 5C,A00,896655,Munoz Sanchez; Alicia,0,1,20,20
1746615635282,MAE 197,001,957918,Kleissl; Jan,9996,0,9999,3
1746615635282,MAE 197,002,959806,Boechler; Nicholas Sebastia,9998,0,9999,1
1746615635282,MAE 197,003,959852,Mullin; Jennifer S,9998,0,9999,1
1746615636310,MATH 2,A01,957937,Staff,33,0,35,2
1746615637337,MATH 197,001,957876,Kedlaya; Kiran S.,9993,0,9999,6
1746615638365,MCWP 40,A00,892729,Duru; Nur,10,0,20,10
1746615638365,MCWP 40,B00,893304,Montejo; Carolina,14,0,20,6
1746615639394,MCWP 40R,A00,893757,Redela; Pamela Morgan,0,5,20,20
1746615640421,MCWP 50,A00,893758,Morshed; Michael James,0,0,20,20
1746615640421,MCWP 50,B00,893761,Bartulis; Jason Michael,16,0,20,4
1746615641453,MCWP 50R,A00,893766,Compas; Sean Matthew,0,1,20,20
1746615641453,MCWP 50R,B00,893769,Carter; Jennifer A,0,1,20,20
1746615641453,MCWP 50R,C00,893771,Krone; Jarret,0,3,20,20
1746615641453,MCWP 50R,D00,893772,Miller; Elizabeth Deen,0,0,20,20
1746615641453,MCWP 50R,E00,893775,Carter; Andrea L,0,1,20,20
1746615642484,MMW 11R,A01,892721,Herbst; Matthew,14,0,30,16
1746615642484,MMW 11R,A02,892722,Herbst; Matthew,0,0,0,3
1746615643511,MMW 12R,A01,892724,Herbst; Matthew,0,11,16,16
1746615643511,MMW 12R,A02,892725,Herbst; Matthew,0,10,16,16
1746615644538,MMW 13R,A01,892727,Staff,0,4,16,16
1746615644538,MMW 13R,A02,892728,Staff,0,4,16,16
1746615644538,MMW 13R,A03,958032,Staff,0,4,16,16
1746615644538,MMW 13R,A04,958033,Staff,0,4,16,16
1746615644538,MMW 13R,A05,958034,Staff,0,4,16,16
1746615645563,SIO 295LS,A00,894015,Staff,5,0,25,20
1746615646591,SIO 295S,A00,894020,Staff,5,0,25,20
1746615647626,SIOC 290S,B01,958918,Merrifield; Mark A,14,0,30,16
1746615648659,SIOC 291S,B01,958922,Gabriel; Corey John,14,0,30,16
1746615649684,SOCI 117,A01,895339,Staff,2,0,5,3
1746615650713,WES 237B,A00,894149,Staff,11,0,20,9
1746615652796,AESE 279B,A00,891859,Staff,13,0,35,22
1746615653826,AIP 197,001,891854,Vespa; Emanuel Ignacio,9999,0,9999,0
1746615654857,ANTH 289S,A00,891856,Gagneux; Pascal,12,0,12,0
1746615655884,BENG 196,001,957946,Engler; Adam J.,9996,0,9999,3
1746615656909,BISP 197,001,959851,Wilhelm; James E.,9998,0,9999,1
1746615657937,CAT 124RS,A01,956906,Staff,6,0,25,19
1746615659005,CAT 125RS,A01,922013,Staff,6,0,25,19
1746615660032,CLRE 250,A00,891860,Morris; Sheldon,9995,0,9999,4
1746615662149,CLRE 251R,A00,907817,Mehta; Ravindra L.,9994,0,9999,5
1746615663175,CLRE 252,A00,891864,Cuomo; Raphael Eduardo,9993,0,9999,6
1746615664204,CLRE 253,A00,891867,Vaida; Florin,9994,0,9999,5
1746615664204,CLRE 253,B00,907819,Staff,9999,0,9999,0
1746615665234,CLRE 259,A00,891868,Patel; Hemal,9998,0,9999,1
1746615666265,CLRE 260,A00,891872,Cuomo; Raphael Eduardo,9999,0,9999,0
1746615667292,CLRE 297,001,891888,Cuomo; Raphael Eduardo,9999,0,9999,0
1746615668321,CSE 191,A00,958773,Minnes Kemp; Mor Mia,9995,0,9999,4
1746615669348,CSE 197,001,959846,Minnes Kemp; Mor Mia,9990,0,9999,9
1746615670380,CSS 201S,A01,892054,Mignozzetti; Umberto,25,0,30,5
1746615671406,CSS 202S,A01,892056,Mignozzetti; Umberto,25,0,30,5
1746615672436,DSC 197,001,956898,Eldridge; Justin Matthew,9996,0,9999,3
1746615673466,DSC 297,001,958000,Mazumdar; Arya,9998,0,9999,1
1746615673466,DSC 297,002,959862,Wang; Yusu,9998,0,9999,1
1746615674492,EAP 100,A00,905686,Staff,9778,0,9999,221
1746615675525,ECE 45,A01,892618,Staff,0,0,65,65
1746615677580,ECE 111,A01,892719,Staff,6,0,65,59
1746615678606,ECE 197,001,957920,Mercier; Patrick Philip,9991,0,9999,8
1746615679633,ECON 178,A01,907814,Zhu; Ying,26,0,35,9
1746615680661,EDS 115,A00,895312,Staff,35,0,45,10
1746615681689,EDS 117,A01,895337,Staff,23,0,30,7
1746615682718,EDS 125,A00,895341,Jones; Gabrielle Anastasia,36,0,45,9
1746615683747,EDS 128A,A01,895459,Fargason; Sharon Gayle,44,0,45,1
1746615684779,EDS 128B,A01,895543,Pappas; Elizabeth,44,0,45,1
1746615685806,EDS 139,A00,897203,Pappas; Elizabeth,44,0,45,1
1746615685806,EDS 139,B00,897209,Fargason; Sharon Gayle,41,0,45,4
1746615686832,EDS 201,A00,895545,Staff,22,0,45,23
1746615687860,EDS 203,A01,895581,Halter; Christopher P.,22,0,45,23
1746615688887,EDS 204R,A01,895625,Heinzman; Erica M.,39,0,45,6
1746615688887,EDS 204R,B01,895693,Halter; Christopher P.,10,0,45,35
1746615689916,EDS 206R,A00,895694,Fargason; Sharon Gayle,1,0,30,29
1746615689916,EDS 206R,B00,895695,Choi; Bailey Miyeon,16,0,30,14
1746615690946,EDS 250,A00,895697,Hemans; Patricia Ann Benitez,22,0,45,23
1746615691974,EDS 281,A00,895701,Meyerott; Theresa Ann,1,0,15,14
1746615693000,EDS 284,A00,895736,Meyerott; Theresa Ann,1,0,15,14
1746615694025,EDS 286,A00,897210,Fine; Sarah,0,0,15,15
1746615695052,EDS 289C,A01,895770,Daly; Alan J.,1,0,15,14
1746615696084,EDS 290,A00,897211,Hofstetter; Carolyn,0,0,15,15
1746615697113,LIGM 5A,A00,896162,Fischer-Grunski; Eva K,12,0,20,8
1746615698142,LIGM 5B,A00,896260,Fischer-Grunski; Eva K,17,0,20,3
1746615699169,LIGM 5C,A00,896308,Fischer-Grunski; Eva K,18,0,20,2
1746615700199,LIIT 5AS,A00,896313,Carnelos; Chiara,18,0,20,2
1746615701228,LIIT 5BS,A00,896416,Carnelos; Chiara,20,0,20,0
1746615702255,LIIT 5CS,A00,896564,Carnelos; Chiara,20,0,20,0
1746615703282,LISP 5A,A00,896588,Munoz Sanchez; Alicia,2,0,20,18
1746615704310,LISP 5B,A00,896653,Munoz Sanchez; Alicia,7,0,20,13
1746615705337,LISP 5C,A00,896655,Munoz Sanchez; Alicia,0,1,20,20
1746615706365,MAE 197,001,957918,Kleissl; Jan,9996,0,9999,3
1746615706365,MAE 197,002,959806,Boechler; Nicholas Sebastia,9998,0,9999,1
1746615706365,MAE 197,003,959852,Mullin; Jennifer S,9998,0,9999,1
1746615707394,MATH 2,A01,957937,Staff,33,0,35,2
1746615708424,MATH 197,001,957876,Kedlaya; Kiran S.,9993,0,9999,6
1746615709455,MCWP 40,A00,892729,Duru; Nur,10,0,20,10
1746615709455,MCWP 40,B00,893304,Montejo; Carolina,14,0,20,6
1746615710484,MCWP 40R,A00,893757,Redela; Pamela Morgan,0,5,20,20
1746615711510,MCWP 50,A00,893758,Morshed; Michael James,0,0,20,20
1746615711510,MCWP 50,B00,893761,Bartulis; Jason Michael,16,0,20,4
1746615712541,MCWP 50R,A00,893766,Compas; Sean Matthew,0,1,20,20
1746615712541,MCWP 50R,B00,893769,Carter; Jennifer A,0,1,20,20
1746615712541,MCWP 50R,C00,893771,Krone; Jarret,0,3,20,20
1746615712541,MCWP 50R,D00,893772,Miller; Elizabeth Deen,0,0,20,20
1746615712541,MCWP 50R,E00,893775,Carter; Andrea L,0,1,20,20
1746615713569,MMW 11R,A01,892721,Herbst; Matthew,14,0,30,16
1746615713569,MMW 11R,A02,892722,Herbst; Matthew,0,0,0,3
1746615714595,MMW 12R,A01,892724,Herbst; Matthew,0,11,16,16
1746615714595,MMW 12R,A02,892725,Herbst; Matthew,0,10,16,16
1746615715620,MMW 13R,A01,892727,Staff,0,4,16,16
1746615715620,MMW 13R,A02,892728,Staff,0,4,16,16
1746615715620,MMW 13R,A03,958032,Staff,0,4,16,16
1746615715620,MMW 13R,A04,958033,Staff,0,4,16,16
1746615715620,MMW 13R,A05,958034,Staff,0,4,16,16
1746615716648,SIO 295LS,A00,894015,Staff,5,0,25,20
1746615717677,SIO 295S,A00,894020,Staff,5,0,25,20
1746615718703,SIOC 290S,B01,958918,Merrifield; Mark A,14,0,30,16
1746615719735,SIOC 291S,B01,958922,Gabriel; Corey John,14,0,30,16
1746615720762,SOCI 117,A01,895339,Staff,2,0,5,3
1746615721790,WES 237B,A00,894149,Staff,11,0,20,9
1746615723882,AESE 279B,A00,891859,Staff,13,0,35,22
1746615724929,AIP 197,001,891854,Vespa; Emanuel Ignacio,9999,0,9999,0
1746615725956,ANTH 289S,A00,891856,Gagneux; Pascal,12,0,12,0
1746615726997,BENG 196,001,957946,Engler; Adam J.,9996,0,9999,3
1746615728021,BISP 197,001,959851,Wilhelm; James E.,9998,0,9999,1
1746615729050,CAT 124RS,A01,956906,Staff,6,0,25,19
1746615730081,CAT 125RS,A01,922013,Staff,6,0,25,19
1746615731107,CLRE 250,A00,891860,Morris; Sheldon,9995,0,9999,4
1746615733733,CLRE 251R,A00,907817,Mehta; Ravindra L.,9994,0,9999,5
1746615734759,CLRE 252,A00,891864,Cuomo; Raphael Eduardo,9993,0,9999,6
1746615735784,CLRE 253,A00,891867,Vaida; Florin,9994,0,9999,5
1746615735784,CLRE 253,B00,907819,Staff,9999,0,9999,0
1746615736812,CLRE 259,A00,891868,Patel; Hemal,9998,0,9999,1
1746615737841,CLRE 260,A00,891872,Cuomo; Raphael Eduardo,9999,0,9999,0
1746615738872,CLRE 297,001,891888,Cuomo; Raphael Eduardo,9999,0,9999,0
1746615739898,CSE 191,A00,958773,Minnes Kemp; Mor Mia,9995,0,9999,4
1746615740924,CSE 197,001,959846,Minnes Kemp; Mor Mia,9990,0,9999,9
1746615741952,CSS 201S,A01,892054,Mignozzetti; Umberto,25,0,30,5
1746615742979,CSS 202S,A01,892056,Mignozzetti; Umberto,25,0,30,5
1746615744004,DSC 197,001,956898,Eldridge; Justin Matthew,9996,0,9999,3
1746615745033,DSC 297,001,958000,Mazumdar; Arya,9998,0,9999,1
1746615745033,DSC 297,002,959862,Wang; Yusu,9998,0,9999,1
1746615746061,EAP 100,A00,905686,Staff,9778,0,9999,221
1746615747089,ECE 45,A01,892618,Staff,0,0,65,65
1746615749142,ECE 111,A01,892719,Staff,6,0,65,59
1746615750171,ECE 197,001,957920,Mercier; Patrick Philip,9991,0,9999,8
1746615751202,ECON 178,A01,907814,Zhu; Ying,26,0,35,9
1746615752230,EDS 115,A00,895312,Staff,35,0,45,10
1746615753259,EDS 117,A01,895337,Staff,23,0,30,7
1746615754286,EDS 125,A00,895341,Jones; Gabrielle Anastasia,36,0,45,9
1746615755314,EDS 128A,A01,895459,Fargason; Sharon Gayle,44,0,45,1
1746615756344,EDS 128B,A01,895543,Pappas; Elizabeth,44,0,45,1
1746615757372,EDS 139,A00,897203,Pappas; Elizabeth,44,0,45,1
1746615757372,EDS 139,B00,897209,Fargason; Sharon Gayle,41,0,45,4
1746615758397,EDS 201,A00,895545,Staff,22,0,45,23
1746615759429,EDS 203,A01,895581,Halter; Christopher P.,22,0,45,23
1746615760454,EDS 204R,A01,895625,Heinzman; Erica M.,39,0,45,6
1746615760454,EDS 204R,B01,895693,Halter; Christopher P.,10,0,45,35
1746615761486,EDS 206R,A00,895694,Fargason; Sharon Gayle,1,0,30,29
1746615761486,EDS 206R,B00,895695,Choi; Bailey Miyeon,16,0,30,14
1746615762512,EDS 250,A00,895697,Hemans; Patricia Ann Benitez,22,0,45,23
1746615763536,EDS 281,A00,895701,Meyerott; Theresa Ann,1,0,15,14
1746615764566,EDS 284,A00,895736,Meyerott; Theresa Ann,1,0,15,14
1746615765591,EDS 286,A00,897210,Fine; Sarah,0,0,15,15
1746615766616,EDS 289C,A01,895770,Daly; Alan J.,1,0,15,14
1746615767643,EDS 290,A00,897211,Hofstetter; Carolyn,0,0,15,15
1746615768672,LIGM 5A,A00,896162,Fischer-Grunski; Eva K,12,0,20,8
1746615769698,LIGM 5B,A00,896260,Fischer-Grunski; Eva K,17,0,20,3
1746615770729,LIGM 5C,A00,896308,Fischer-Grunski; Eva K,18,0,20,2
1746615771759,LIIT 5AS,A00,896313,Carnelos; Chiara,18,0,20,2
1746615772786,LIIT 5BS,A00,896416,Carnelos; Chiara,20,0,20,0
1746615773811,LIIT 5CS,A00,896564,Carnelos; Chiara,20,0,20,0
1746615774838,LISP 5A,A00,896588,Munoz Sanchez; Alicia,2,0,20,18
1746615775865,LISP 5B,A00,896653,Munoz Sanchez; Alicia,7,0,20,13
1746615776895,LISP 5C,A00,896655,Munoz Sanchez; Alicia,0,1,20,20
1746615777922,MAE 197,001,957918,Kleissl; Jan,9996,0,9999,3
1746615777922,MAE 197,002,959806,Boechler; Nicholas Sebastia,9998,0,9999,1
1746615777922,MAE 197,003,959852,Mullin; Jennifer S,9998,0,9999,1
1746615778947,MATH 2,A01,957937,Staff,33,0,35,2
1746615779974,MATH 197,001,957876,Kedlaya; Kiran S.,9993,0,9999,6
1746615781003,MCWP 40,A00,892729,Duru; Nur,10,0,20,10
1746615781003,MCWP 40,B00,893304,Montejo; Carolina,14,0,20,6
1746615782050,MCWP 40R,A00,893757,Redela; Pamela Morgan,0,5,20,20
1746615783077,MCWP 50,A00,893758,Morshed; Michael James,0,0,20,20
1746615783077,MCWP 50,B00,893761,Bartulis; Jason Michael,16,0,20,4
1746615784103,MCWP 50R,A00,893766,Compas; Sean Matthew,0,1,20,20
1746615784103,MCWP 50R,B00,893769,Carter; Jennifer A,0,1,20,20
1746615784103,MCWP 50R,C00,893771,Krone; Jarret,0,3,20,20
1746615784103,MCWP 50R,D00,893772,Miller; Elizabeth Deen,0,0,20,20
1746615784103,MCWP 50R,E00,893775,Carter; Andrea L,0,1,20,20
1746615785128,MMW 11R,A01,892721,Herbst; Matthew,14,0,30,16
1746615785128,MMW 11R,A02,892722,Herbst; Matthew,0,0,0,3
1746615786156,MMW 12R,A01,892724,Herbst; Matthew,0,11,16,16
1746615786156,MMW 12R,A02,892725,Herbst; Matthew,0,10,16,16
1746615787180,MMW 13R,A01,892727,Staff,0,4,16,16
1746615787180,MMW 13R,A02,892728,Staff,0,4,16,16
1746615787180,MMW 13R,A03,958032,Staff,0,4,16,16
1746615787180,MMW 13R,A04,958033,Staff,0,4,16,16
1746615787180,MMW 13R,A05,958034,Staff,0,4,16,16
1746615788209,SIO 295LS,A00,894015,Staff,5,0,25,20
1746615789238,SIO 295S,A00,894020,Staff,5,0,25,20
1746615790265,SIOC 290S,B01,958918,Merrifield; Mark A,14,0,30,16
1746615791293,SIOC 291S,B01,958922,Gabriel; Corey John,14,0,30,16
1746615792318,SOCI 117,A01,895339,Staff,2,0,5,3
1746615793345,WES 237B,A00,894149,Staff,11,0,20,9
1746615795421,AESE 279B,A00,891859,Staff,13,0,35,22
1746615796446,AIP 197,001,891854,Vespa; Emanuel Ignacio,9999,0,9999,0
1746615797514,ANTH 289S,A00,891856,Gagneux; Pascal,12,0,12,0
1746615798540,BENG 196,001,957946,Engler; Adam J.,9996,0,9999,3
1746615799567,BISP 197,001,959851,Wilhelm; James E.,9998,0,9999,1
1746615800591,CAT 124RS,A01,956906,Staff,6,0,25,19
1746615801620,CAT 125RS,A01,922013,Staff,6,0,25,19
1746615802649,CLRE 250,A00,891860,Morris; Sheldon,9995,0,9999,4
1746615804702,CLRE 251R,A00,907817,Mehta; Ravindra L.,9994,0,9999,5
1746615805727,CLRE 252,A00,891864,Cuomo; Raphael Eduardo,9993,0,9999,6
1746615806754,CLRE 253,A00,891867,Vaida; Florin,9994,0,9999,5
1746615806754,CLRE 253,B00,907819,Staff,9999,0,9999,0
1746615807779,CLRE 259,A00,891868,Patel; Hemal,9998,0,9999,1
1746615808806,CLRE 260,A00,891872,Cuomo; Raphael Eduardo,9999,0,9999,0
1746615809831,CLRE 297,001,891888,Cuomo; Raphael Eduardo,9999,0,9999,0
1746615810864,CSE 191,A00,958773,Minnes Kemp; Mor Mia,9995,0,9999,4
1746615811890,CSE 197,001,959846,Minnes Kemp; Mor Mia,9990,0,9999,9
1746615812916,CSS 201S,A01,892054,Mignozzetti; Umberto,25,0,30,5
1746615813944,CSS 202S,A01,892056,Mignozzetti; Umberto,25,0,30,5
1746615814970,DSC 197,001,956898,Eldridge; Justin Matthew,9996,0,9999,3
1746615815998,DSC 297,001,958000,Mazumdar; Arya,9998,0,9999,1
1746615815998,DSC 297,002,959862,Wang; Yusu,9998,0,9999,1
1746615817064,EAP 100,A00,905686,Staff,9778,0,9999,221
1746615818096,ECE 45,A01,892618,Staff,0,0,65,65
1746615820151,ECE 111,A01,892719,Staff,6,0,65,59
1746615821177,ECE 197,001,957920,Mercier; Patrick Philip,9991,0,9999,8
1746615822205,ECON 178,A01,907814,Zhu; Ying,26,0,35,9
1746615823232,EDS 115,A00,895312,Staff,35,0,45,10
1746615824258,EDS 117,A01,895337,Staff,23,0,30,7
1746615825288,EDS 125,A00,895341,Jones; Gabrielle Anastasia,36,0,45,9
1746615826316,EDS 128A,A01,895459,Fargason; Sharon Gayle,44,0,45,1
1746615827344,EDS 128B,A01,895543,Pappas; Elizabeth,44,0,45,1
1746615828373,EDS 139,A00,897203,Pappas; Elizabeth,44,0,45,1
1746615828373,EDS 139,B00,897209,Fargason; Sharon Gayle,41,0,45,4
1746615829399,EDS 201,A00,895545,Staff,22,0,45,23
1746615830426,EDS 203,A01,895581,Halter; Christopher P.,22,0,45,23
1746615831457,EDS 204R,A01,895625,Heinzman; Erica M.,39,0,45,6
1746615831457,EDS 204R,B01,895693,Halter; Christopher P.,10,0,45,35
1746615832482,EDS 206R,A00,895694,Fargason; Sharon Gayle,1,0,30,29
1746615832482,EDS 206R,B00,895695,Choi; Bailey Miyeon,16,0,30,14
1746615833509,EDS 250,A00,895697,Hemans; Patricia Ann Benitez,22,0,45,23
1746615834537,EDS 281,A00,895701,Meyerott; Theresa Ann,1,0,15,14
1746615835564,EDS 284,A00,895736,Meyerott; Theresa Ann,1,0,15,14
1746615836596,EDS 286,A00,897210,Fine; Sarah,0,0,15,15
1746615837628,EDS 289C,A01,895770,Daly; Alan J.,1,0,15,14
1746615838655,EDS 290,A00,897211,Hofstetter; Carolyn,0,0,15,15
1746615839681,LIGM 5A,A00,896162,Fischer-Grunski; Eva K,12,0,20,8
1746615840709,LIGM 5B,A00,896260,Fischer-Grunski; Eva K,17,0,20,3
1746615841739,LIGM 5C,A00,896308,Fischer-Grunski; Eva K,18,0,20,2
1746615842766,LIIT 5AS,A00,896313,Carnelos; Chiara,18,0,20,2
1746615843792,LIIT 5BS,A00,896416,Carnelos; Chiara,20,0,20,0
1746615844819,LIIT 5CS,A00,896564,Carnelos; Chiara,20,0,20,0
1746615845847,LISP 5A,A00,896588,Munoz Sanchez; Alicia,2,0,20,18
1746615846877,LISP 5B,A00,896653,Munoz Sanchez; Alicia,7,0,20,13
1746615847906,LISP 5C,A00,896655,Munoz Sanchez; Alicia,0,1,20,20
1746615848937,MAE 197,001,957918,Kleissl; Jan,9996,0,9999,3
1746615848937,MAE 197,002,959806,Boechler; Nicholas Sebastia,9998,0,9999,1
1746615848937,MAE 197,003,959852,Mullin; Jennifer S,9998,0,9999,1
1746615849964,MATH 2,A01,957937,Staff,33,0,35,2
1746615850991,MATH 197,001,957876,Kedlaya; Kiran S.,9993,0,9999,6
1746615852023,MCWP 40,A00,892729,Duru; Nur,10,0,20,10
1746615852023,MCWP 40,B00,893304,Montejo; Carolina,14,0,20,6
1746615853050,MCWP 40R,A00,893757,Redela; Pamela Morgan,0,5,20,20
1746615854079,MCWP 50,A00,893758,Morshed; Michael James,0,0,20,20
1746615854079,MCWP 50,B00,893761,Bartulis; Jason Michael,16,0,20,4
1746615855106,MCWP 50R,A00,893766,Compas; Sean Matthew,0,1,20,20
1746615855106,MCWP 50R,B00,893769,Carter; Jennifer A,0,1,20,20
1746615855106,MCWP 50R,C00,893771,Krone; Jarret,0,3,20,20
1746615855106,MCWP 50R,D00,893772,Miller; Elizabeth Deen,0,0,20,20
1746615855106,MCWP 50R,E00,893775,Carter; Andrea L,0,1,20,20
1746615856135,MMW 11R,A01,892721,Herbst; Matthew,14,0,30,16
1746615856135,MMW 11R,A02,892722,Herbst; Matthew,0,0,0,3
1746615857160,MMW 12R,A01,892724,Herbst; Matthew,0,11,16,16
1746615857160,MMW 12R,A02,892725,Herbst; Matthew,0,10,16,16
1746615858192,MMW 13R,A01,892727,Staff,0,4,16,16
1746615858192,MMW 13R,A02,892728,Staff,0,4,16,16
1746615858192,MMW 13R,A03,958032,Staff,0,4,16,16
1746615858192,MMW 13R,A04,958033,Staff,0,4,16,16
1746615858192,MMW 13R,A05,958034,Staff,0,4,16,16
1746615859216,SIO 295LS,A00,894015,Staff,5,0,25,20
1746615860244,SIO 295S,A00,894020,Staff,5,0,25,20
1746615861284,SIOC 290S,B01,958918,Merrifield; Mark A,14,0,30,16
1746615862312,SIOC 291S,B01,958922,Gabriel; Corey John,14,0,30,16
1746615863343,SOCI 117,A01,895339,Staff,2,0,5,3
1746615864369,WES 237B,A00,894149,Staff,11,0,20,9
1746615866461,AESE 279B,A00,891859,Staff,13,0,35,22
1746615867490,AIP 197,001,891854,Vespa; Emanuel Ignacio,9999,0,9999,0
1746615868519,ANTH 289S,A00,891856,Gagneux; Pascal,12,0,12,0
1746615869545,BENG 196,001,957946,Engler; Adam J.,9996,0,9999,3
1746615870572,BISP 197,001,959851,Wilhelm; James E.,9998,0,9999,1
1746615871601,CAT 124RS,A01,956906,Staff,6,0,25,19
1746615872629,CAT 125RS,A01,922013,Staff,6,0,25,19
1746615873655,CLRE 250,A00,891860,Morris; Sheldon,9995,0,9999,4
1746615875717,CLRE 251R,A00,907817,Mehta; Ravindra L.,9994,0,9999,5
1746615876745,CLRE 252,A00,891864,Cuomo; Raphael Eduardo,9993,0,9999,6
1746615877772,CLRE 253,A00,891867,Vaida; Florin,9994,0,9999,5
1746615877772,CLRE 253,B00,907819,Staff,9999,0,9999,0
1746615878801,CLRE 259,A00,891868,Patel; Hemal,9998,0,9999,1
1746615879827,CLRE 260,A00,891872,Cuomo; Raphael Eduardo,9999,0,9999,0
1746615880853,CLRE 297,001,891888,Cuomo; Raphael Eduardo,9999,0,9999,0
1746615881880,CSE 191,A00,958773,Minnes Kemp; Mor Mia,9995,0,9999,4
1746615882911,CSE 197,001,959846,Minnes Kemp; Mor Mia,9990,0,9999,9
1746615883939,CSS 201S,A01,892054,Mignozzetti; Umberto,25,0,30,5
1746615884967,CSS 202S,A01,892056,Mignozzetti; Umberto,25,0,30,5
1746615885996,DSC 197,001,956898,Eldridge; Justin Matthew,9996,0,9999,3
1746615887026,DSC 297,001,958000,Mazumdar; Arya,9998,0,9999,1
1746615887026,DSC 297,002,959862,Wang; Yusu,9998,0,9999,1
1746615888053,EAP 100,A00,905686,Staff,9778,0,9999,221
1746615889088,ECE 45,A01,892618,Staff,0,0,65,65
1746615891152,ECE 111,A01,892719,Staff,6,0,65,59
1746615892177,ECE 197,001,957920,Mercier; Patrick Philip,9991,0,9999,8
1746615893216,ECON 178,A01,907814,Zhu; Ying,26,0,35,9
1746615894246,EDS 115,A00,895312,Staff,35,0,45,10
1746615895271,EDS 117,A01,895337,Staff,23,0,30,7
1746615896301,EDS 125,A00,895341,Jones; Gabrielle Anastasia,36,0,45,9
1746615897328,EDS 128A,A01,895459,Fargason; Sharon Gayle,44,0,45,1
1746615898360,EDS 128B,A01,895543,Pappas; Elizabeth,44,0,45,1
1746615899386,EDS 139,A00,897203,Pappas; Elizabeth,44,0,45,1
1746615899386,EDS 139,B00,897209,Fargason; Sharon Gayle,41,0,45,4
1746615900412,EDS 201,A00,895545,Staff,22,0,45,23
1746615901497,EDS 203,A01,895581,Halter; Christopher P.,22,0,45,23
1746615902525,EDS 204R,A01,895625,Heinzman; Erica M.,39,0,45,6
1746615902525,EDS 204R,B01,895693,Halter; Christopher P.,10,0,45,35
1746615903557,EDS 206R,A00,895694,Fargason; Sharon Gayle,1,0,30,29
1746615903557,EDS 206R,B00,895695,Choi; Bailey Miyeon,16,0,30,14
1746615904587,EDS 250,A00,895697,Hemans; Patricia Ann Benitez,22,0,45,23
1746615905617,EDS 281,A00,895701,Meyerott; Theresa Ann,1,0,15,14
1746615906647,EDS 284,A00,895736,Meyerott; Theresa Ann,1,0,15,14
1746615907674,EDS 286,A00,897210,Fine; Sarah,0,0,15,15
1746615908702,EDS 289C,A01,895770,Daly; Alan J.,1,0,15,14
1746615909729,EDS 290,A00,897211,Hofstetter; Carolyn,0,0,15,15
1746615910758,LIGM 5A,A00,896162,Fischer-Grunski; Eva K,12,0,20,8
1746615911784,LIGM 5B,A00,896260,Fischer-Grunski; Eva K,17,0,20,3
1746615912814,LIGM 5C,A00,896308,Fischer-Grunski; Eva K,18,0,20,2
1746615913844,LIIT 5AS,A00,896313,Carnelos; Chiara,18,0,20,2
1746615914876,LIIT 5BS,A00,896416,Carnelos; Chiara,20,0,20,0
1746615915906,LIIT 5CS,A00,896564,Carnelos; Chiara,20,0,20,0
1746615916932,LISP 5A,A00,896588,Munoz Sanchez; Alicia,2,0,20,18
1746615917958,LISP 5B,A00,896653,Munoz Sanchez; Alicia,7,0,20,13
1746615918989,LISP 5C,A00,896655,Munoz Sanchez; Alicia,0,1,20,20
1746615920025,MAE 197,001,957918,Kleissl; Jan,9996,0,9999,3
1746615920025,MAE 197,002,959806,Boechler; Nicholas Sebastia,9998,0,9999,1
1746615920025,MAE 197,003,959852,Mullin; Jennifer S,9998,0,9999,1
1746615921052,MATH 2,A01,957937,Staff,33,0,35,2
1746615922079,MATH 197,001,957876,Kedlaya; Kiran S.,9993,0,9999,6
1746615923107,MCWP 40,A00,892729,Duru; Nur,10,0,20,10
1746615923107,MCWP 40,B00,893304,Montejo; Carolina,14,0,20,6
1746615924134,MCWP 40R,A00,893757,Redela; Pamela Morgan,0,5,20,20
1746615925165,MCWP 50,A00,893758,Morshed; Michael James,0,0,20,20
1746615925165,MCWP 50,B00,893761,Bartulis; Jason Michael,16,0,20,4
1746615926201,MCWP 50R,A00,893766,Compas; Sean Matthew,0,1,20,20
1746615926201,MCWP 50R,B00,893769,Carter; Jennifer A,0,1,20,20
1746615926201,MCWP 50R,C00,893771,Krone; Jarret,0,3,20,20
1746615926201,MCWP 50R,D00,893772,Miller; Elizabeth Deen,0,0,20,20
1746615926201,MCWP 50R,E00,893775,Carter; Andrea L,0,1,20,20
1746615927233,MMW 11R,A01,892721,Herbst; Matthew,14,0,30,16
1746615927233,MMW 11R,A02,892722,Herbst; Matthew,0,0,0,3
1746615928263,MMW 12R,A01,892724,Herbst; Matthew,0,11,16,16
1746615928263,MMW 12R,A02,892725,Herbst; Matthew,0,10,16,16
1746615929288,MMW 13R,A01,892727,Staff,0,4,16,16
1746615929288,MMW 13R,A02,892728,Staff,0,4,16,16
1746615929288,MMW 13R,A03,958032,Staff,0,4,16,16
1746615929288,MMW 13R,A04,958033,Staff,0,4,16,16
1746615929288,MMW 13R,A05,958034,Staff,0,4,16,16
1746615930313,SIO 295LS,A00,894015,Staff,5,0,25,20
1746615931339,SIO 295S,A00,894020,Staff,5,0,25,20
1746615932370,SIOC 290S,B01,958918,Merrifield; Mark A,14,0,30,16
1746615933399,SIOC 291S,B01,958922,Gabriel; Corey John,14,0,30,16
1746615934424,SOCI 117,A01,895339,Staff,2,0,5,3
1746615935451,WES 237B,A00,894149,Staff,11,0,20,9
1746615937540,AESE 279B,A00,891859,Staff,13,0,35,22
1746615938568,AIP 197,001,891854,Vespa; Emanuel Ignacio,9999,0,9999,0
1746615939599,ANTH 289S,A00,891856,Gagneux; Pascal,12,0,12,0
1746615940626,BENG 196,001,957946,Engler; Adam J.,9996,0,9999,3
1746615941655,BISP 197,001,959851,Wilhelm; James E.,9998,0,9999,1
1746615942683,CAT 124RS,A01,956906,Staff,6,0,25,19
1746615943713,CAT 125RS,A01,922013,Staff,6,0,25,19
1746615944741,CLRE 250,A00,891860,Morris; Sheldon,9995,0,9999,4
1746615946799,CLRE 251R,A00,907817,Mehta; Ravindra L.,9994,0,9999,5
1746615947823,CLRE 252,A00,891864,Cuomo; Raphael Eduardo,9993,0,9999,6
1746615948856,CLRE 253,A00,891867,Vaida; Florin,9994,0,9999,5
1746615948856,CLRE 253,B00,907819,Staff,9999,0,9999,0
1746615949880,CLRE 259,A00,891868,Patel; Hemal,9998,0,9999,1
1746615950907,CLRE 260,A00,891872,Cuomo; Raphael Eduardo,9999,0,9999,0
1746615951936,CLRE 297,001,891888,Cuomo; Raphael Eduardo,9999,0,9999,0
1746615952964,CSE 191,A00,958773,Minnes Kemp; Mor Mia,9995,0,9999,4
1746615953991,CSE 197,001,959846,Minnes Kemp; Mor Mia,9990,0,9999,9
1746615955018,CSS 201S,A01,892054,Mignozzetti; Umberto,25,0,30,5
1746615956048,CSS 202S,A01,892056,Mignozzetti; Umberto,25,0,30,5
1746615957078,DSC 197,001,956898,Eldridge; Justin Matthew,9996,0,9999,3
1746615958103,DSC 297,001,958000,Mazumdar; Arya,9998,0,9999,1
1746615958103,DSC 297,002,959862,Wang; Yusu,9998,0,9999,1
1746615959133,EAP 100,A00,905686,Staff,9778,0,9999,221
1746615960159,ECE 45,A01,892618,Staff,0,0,65,65
1746615962214,ECE 111,A01,892719,Staff,6,0,65,59
1746615963241,ECE 197,001,957920,Mercier; Patrick Philip,9991,0,9999,8
1746615964265,ECON 178,A01,907814,Zhu; Ying,26,0,35,9
1746615965295,EDS 115,A00,895312,Staff,35,0,45,10
1746615966320,EDS 117,A01,895337,Staff,23,0,30,7
1746615967345,EDS 125,A00,895341,Jones; Gabrielle Anastasia,36,0,45,9
1746615968370,EDS 128A,A01,895459,Fargason; Sharon Gayle,44,0,45,1
1746615969399,EDS 128B,A01,895543,Pappas; Elizabeth,44,0,45,1
1746615970424,EDS 139,A00,897203,Pappas; Elizabeth,44,0,45,1
1746615970424,EDS 139,B00,897209,Fargason; Sharon Gayle,41,0,45,4
1746615971450,EDS 201,A00,895545,Staff,22,0,45,23
1746615972477,EDS 203,A01,895581,Halter; Christopher P.,22,0,45,23
1746615973504,EDS 204R,A01,895625,Heinzman; Erica M.,39,0,45,6
1746615973504,EDS 204R,B01,895693,Halter; Christopher P.,10,0,45,35
1746615974530,EDS 206R,A00,895694,Fargason; Sharon Gayle,1,0,30,29
1746615974530,EDS 206R,B00,895695,Choi; Bailey Miyeon,16,0,30,14
1746615975558,EDS 250,A00,895697,Hemans; Patricia Ann Benitez,22,0,45,23
1746615976583,EDS 281,A00,895701,Meyerott; Theresa Ann,1,0,15,14
1746615977609,EDS 284,A00,895736,Meyerott; Theresa Ann,1,0,15,14
1746615978639,EDS 286,A00,897210,Fine; Sarah,0,0,15,15
1746615979665,EDS 289C,A01,895770,Daly; Alan J.,1,0,15,14
1746615980693,EDS 290,A00,897211,Hofstetter; Carolyn,0,0,15,15
1746615981719,LIGM 5A,A00,896162,Fischer-Grunski; Eva K,12,0,20,8
1746615982748,LIGM 5B,A00,896260,Fischer-Grunski; Eva K,17,0,20,3
1746615983774,LIGM 5C,A00,896308,Fischer-Grunski; Eva K,18,0,20,2
1746615984807,LIIT 5AS,A00,896313,Carnelos; Chiara,18,0,20,2
1746615985837,LIIT 5BS,A00,896416,Carnelos; Chiara,20,0,20,0
1746615986865,LIIT 5CS,A00,896564,Carnelos; Chiara,20,0,20,0
1746615987893,LISP 5A,A00,896588,Munoz Sanchez; Alicia,2,0,20,18
1746615988922,LISP 5B,A00,896653,Munoz Sanchez; Alicia,7,0,20,13
1746615989949,LISP 5C,A00,896655,Munoz Sanchez; Alicia,0,1,20,20
1746615990978,MAE 197,001,957918,Kleissl; Jan,9996,0,9999,3
1746615990978,MAE 197,002,959806,Boechler; Nicholas Sebastia,9998,0,9999,1
1746615990978,MAE 197,003,959852,Mullin; Jennifer S,9998,0,9999,1
1746615992005,MATH 2,A01,957937,Staff,33,0,35,2
1746615993030,MATH 197,001,957876,Kedlaya; Kiran S.,9993,0,9999,6
1746615994060,MCWP 40,A00,892729,Duru; Nur,10,0,20,10
1746615994060,MCWP 40,B00,893304,Montejo; Carolina,14,0,20,6
1746615995089,MCWP 40R,A00,893757,Redela; Pamela Morgan,0,5,20,20
1746615996121,MCWP 50,A00,893758,Morshed; Michael James,0,0,20,20
1746615996121,MCWP 50,B00,893761,Bartulis; Jason Michael,16,0,20,4
1746615997151,MCWP 50R,A00,893766,Compas; Sean Matthew,0,1,20,20
1746615997151,MCWP 50R,B00,893769,Carter; Jennifer A,0,1,20,20
1746615997151,MCWP 50R,C00,893771,Krone; Jarret,0,3,20,20
1746615997151,MCWP 50R,D00,893772,Miller; Elizabeth Deen,0,0,20,20
1746615997151,MCWP 50R,E00,893775,Carter; Andrea L,0,1,20,20
1746615998176,MMW 11R,A01,892721,Herbst; Matthew,14,0,30,16
1746615998176,MMW 11R,A02,892722,Herbst; Matthew,0,0,0,3
1746615999204,MMW 12R,A01,892724,Herbst; Matthew,0,11,16,16
1746615999204,MMW 12R,A02,892725,Herbst; Matthew,0,10,16,16
1746616000230,MMW 13R,A01,892727,Staff,0,4,16,16
1746616000230,MMW 13R,A02,892728,Staff,0,4,16,16
1746616000230,MMW 13R,A03,958032,Staff,0,4,16,16
1746616000230,MMW 13R,A04,958033,Staff,0,4,16,16
1746616000230,MMW 13R,A05,958034,Staff,0,4,16,16
1746616001256,SIO 295LS,A00,894015,Staff,5,0,25,20
1746616002283,SIO 295S,A00,894020,Staff,5,0,25,20
1746616003312,SIOC 290S,B01,958918,Merrifield; Mark A,14,0,30,16
1746616004339,SIOC 291S,B01,958922,Gabriel; Corey John,14,0,30,16
1746616005365,SOCI 117,A01,895339,Staff,2,0,5,3
1746616006390,WES 237B,A00,894149,Staff,11,0,20,9
1746616008503,AESE 279B,A00,891859,Staff,13,0,35,22
1746616009532,AIP 197,001,891854,Vespa; Emanuel Ignacio,9999,0,9999,0
1746616010562,ANTH 289S,A00,891856,Gagneux; Pascal,12,0,12,0
1746616011591,BENG 196,001,957946,Engler; Adam J.,9996,0,9999,3
1746616012621,BISP 197,001,959851,Wilhelm; James E.,9998,0,9999,1
1746616013647,CAT 124RS,A01,956906,Staff,6,0,25,19
1746616014675,CAT 125RS,A01,922013,Staff,6,0,25,19
1746616015701,CLRE 250,A00,891860,Morris; Sheldon,9995,0,9999,4
1746616017756,CLRE 251R,A00,907817,Mehta; Ravindra L.,9994,0,9999,5
1746616018782,CLRE 252,A00,891864,Cuomo; Raphael Eduardo,9993,0,9999,6
1746616019807,CLRE 253,A00,891867,Vaida; Florin,9994,0,9999,5
1746616019807,CLRE 253,B00,907819,Staff,9999,0,9999,0
1746616020833,CLRE 259,A00,891868,Patel; Hemal,9998,0,9999,1
1746616021861,CLRE 260,A00,891872,Cuomo; Raphael Eduardo,9999,0,9999,0
1746616022887,CLRE 297,001,891888,Cuomo; Raphael Eduardo,9999,0,9999,0
1746616023917,CSE 191,A00,958773,Minnes Kemp; Mor Mia,9995,0,9999,4
1746616024959,CSE 197,001,959846,Minnes Kemp; Mor Mia,9990,0,9999,9
1746616025989,CSS 201S,A01,892054,Mignozzetti; Umberto,25,0,30,5
1746616027015,CSS 202S,A01,892056,Mignozzetti; Umberto,25,0,30,5
1746616028042,DSC 197,001,956898,Eldridge; Justin Matthew,9996,0,9999,3
1746616029068,DSC 297,001,958000,Mazumdar; Arya,9998,0,9999,1
1746616029068,DSC 297,002,959862,Wang; Yusu,9998,0,9999,1
1746616030093,EAP 100,A00,905686,Staff,9778,0,9999,221
1746616031121,ECE 45,A01,892618,Staff,0,0,65,65
1746616033178,ECE 111,A01,892719,Staff,6,0,65,59
1746616034204,ECE 197,001,957920,Mercier; Patrick Philip,9991,0,9999,8
1746616035237,ECON 178,A01,907814,Zhu; Ying,26,0,35,9
1746616036268,EDS 115,A00,895312,Staff,35,0,45,10
1746616037294,EDS 117,A01,895337,Staff,23,0,30,7
1746616038322,EDS 125,A00,895341,Jones; Gabrielle Anastasia,36,0,45,9
1746616039351,EDS 128A,A01,895459,Fargason; Sharon Gayle,44,0,45,1
1746616040380,EDS 128B,A01,895543,Pappas; Elizabeth,44,0,45,1
1746616041407,EDS 139,A00,897203,Pappas; Elizabeth,44,0,45,1
1746616041407,EDS 139,B00,897209,Fargason; Sharon Gayle,41,0,45,4
1746616042435,EDS 201,A00,895545,Staff,22,0,45,23
1746616043461,EDS 203,A01,895581,Halter; Christopher P.,22,0,45,23
1746616044501,EDS 204R,A01,895625,Heinzman; Erica M.,39,0,45,6
1746616044501,EDS 204R,B01,895693,Halter; Christopher P.,10,0,45,35
1746616045528,EDS 206R,A00,895694,Fargason; Sharon Gayle,1,0,30,29
1746616045528,EDS 206R,B00,895695,Choi; Bailey Miyeon,16,0,30,14
1746616046558,EDS 250,A00,895697,Hemans; Patricia Ann Benitez,22,0,45,23
1746616047583,EDS 281,A00,895701,Meyerott; Theresa Ann,1,0,15,14
1746616048609,EDS 284,A00,895736,Meyerott; Theresa Ann,1,0,15,14
1746616049638,EDS 286,A00,897210,Fine; Sarah,0,0,15,15
1746616050663,EDS 289C,A01,895770,Daly; Alan J.,1,0,15,14
1746616051689,EDS 290,A00,897211,Hofstetter; Carolyn,0,0,15,15
1746616052718,LIGM 5A,A00,896162,Fischer-Grunski; Eva K,12,0,20,8
1746616053744,LIGM 5B,A00,896260,Fischer-Grunski; Eva K,17,0,20,3
1746616054774,LIGM 5C,A00,896308,Fischer-Grunski; Eva K,18,0,20,2
1746616055806,LIIT 5AS,A00,896313,Carnelos; Chiara,18,0,20,2
1746616056832,LIIT 5BS,A00,896416,Carnelos; Chiara,20,0,20,0
1746616057865,LIIT 5CS,A00,896564,Carnelos; Chiara,20,0,20,0
1746616058931,LISP 5A,A00,896588,Munoz Sanchez; Alicia,2,0,20,18
1746616059960,LISP 5B,A00,896653,Munoz Sanchez; Alicia,7,0,20,13
1746616060990,LISP 5C,A00,896655,Munoz Sanchez; Alicia,0,1,20,20
1746616062020,MAE 197,001,957918,Kleissl; Jan,9996,0,9999,3
1746616062020,MAE 197,002,959806,Boechler; Nicholas Sebastia,9998,0,9999,1
1746616062020,MAE 197,003,959852,Mullin; Jennifer S,9998,0,9999,1
1746616063047,MATH 2,A01,957937,Staff,33,0,35,2
1746616064074,MATH 197,001,957876,Kedlaya; Kiran S.,9993,0,9999,6
1746616065102,MCWP 40,A00,892729,Duru; Nur,10,0,20,10
1746616065102,MCWP 40,B00,893304,Montejo; Carolina,14,0,20,6
1746616066132,MCWP 40R,A00,893757,Redela; Pamela Morgan,0,5,20,20
1746616067160,MCWP 50,A00,893758,Morshed; Michael James,0,0,20,20
1746616067160,MCWP 50,B00,893761,Bartulis; Jason Michael,16,0,20,4
1746616068187,MCWP 50R,A00,893766,Compas; Sean Matthew,0,1,20,20
1746616068187,MCWP 50R,B00,893769,Carter; Jennifer A,0,1,20,20
1746616068187,MCWP 50R,C00,893771,Krone; Jarret,0,3,20,20
1746616068187,MCWP 50R,D00,893772,Miller; Elizabeth Deen,0,0,20,20
1746616068187,MCWP 50R,E00,893775,Carter; Andrea L,0,1,20,20
1746616069215,MMW 11R,A01,892721,Herbst; Matthew,14,0,30,16
1746616069215,MMW 11R,A02,892722,Herbst; Matthew,0,0,0,3
1746616070696,MMW 12R,A01,892724,Herbst; Matthew,0,11,16,16
1746616070696,MMW 12R,A02,892725,Herbst; Matthew,0,10,16,16
1746616071724,MMW 13R,A01,892727,Staff,0,4,16,16
1746616071724,MMW 13R,A02,892728,Staff,0,4,16,16
1746616071724,MMW 13R,A03,958032,Staff,0,4,16,16
1746616071724,MMW 13R,A04,958033,Staff,0,4,16,16
1746616071724,MMW 13R,A05,958034,Staff,0,4,16,16
1746616072749,SIO 295LS,A00,894015,Staff,5,0,25,20
1746616073775,SIO 295S,A00,894020,Staff,5,0,25,20
1746616074805,SIOC 290S,B01,958918,Merrifield; Mark A,14,0,30,16
1746616075834,SIOC 291S,B01,958922,Gabriel; Corey John,14,0,30,16
1746616076864,SOCI 117,A01,895339,Staff,2,0,5,3
1746616077890,WES 237B,A00,894149,Staff,11,0,20,9
1746616080041,AESE 279B,A00,891859,Staff,13,0,35,22
1746616081068,AIP 197,001,891854,Vespa; Emanuel Ignacio,9999,0,9999,0
1746616082097,ANTH 289S,A00,891856,Gagneux; Pascal,12,0,12,0
1746616083122,BENG 196,001,957946,Engler; Adam J.,9996,0,9999,3
1746616084149,BISP 197,001,959851,Wilhelm; James E.,9998,0,9999,1
1746616085179,CAT 124RS,A01,956906,Staff,6,0,25,19
1746616086207,CAT 125RS,A01,922013,Staff,6,0,25,19
1746616087237,CLRE 250,A00,891860,Morris; Sheldon,9995,0,9999,4
1746616089289,CLRE 251R,A00,907817,Mehta; Ravindra L.,9994,0,9999,5
1746616090316,CLRE 252,A00,891864,Cuomo; Raphael Eduardo,9993,0,9999,6
1746616091348,CLRE 253,A00,891867,Vaida; Florin,9994,0,9999,5
1746616091348,CLRE 253,B00,907819,Staff,9999,0,9999,0
1746616092376,CLRE 259,A00,891868,Patel; Hemal,9998,0,9999,1
1746616093408,CLRE 260,A00,891872,Cuomo; Raphael Eduardo,9999,0,9999,0
1746616094436,CLRE 297,001,891888,Cuomo; Raphael Eduardo,9999,0,9999,0
1746616095462,CSE 191,A00,958773,Minnes Kemp; Mor Mia,9995,0,9999,4
1746616096488,CSE 197,001,959846,Minnes Kemp; Mor Mia,9990,0,9999,9
1746616097520,CSS 201S,A01,892054,Mignozzetti; Umberto,25,0,30,5
1746616098552,CSS 202S,A01,892056,Mignozzetti; Umberto,25,0,30,5
1746616099578,DSC 197,001,956898,Eldridge; Justin Matthew,9996,0,9999,3
1746616100606,DSC 297,001,958000,Mazumdar; Arya,9998,0,9999,1
1746616100606,DSC 297,002,959862,Wang; Yusu,9998,0,9999,1
1746616101635,EAP 100,A00,905686,Staff,9778,0,9999,221
1746616102666,ECE 45,A01,892618,Staff,0,0,65,65
1746616104720,ECE 111,A01,892719,Staff,6,0,65,59
1746616105747,ECE 197,001,957920,Mercier; Patrick Philip,9991,0,9999,8
1746616106775,ECON 178,A01,907814,Zhu; Ying,26,0,35,9
1746616107802,EDS 115,A00,895312,Staff,35,0,45,10
1746616108829,EDS 117,A01,895337,Staff,23,0,30,7
1746616109860,EDS 125,A00,895341,Jones; Gabrielle Anastasia,36,0,45,9
1746616110887,EDS 128A,A01,895459,Fargason; Sharon Gayle,44,0,45,1
1746616111919,EDS 128B,A01,895543,Pappas; Elizabeth,44,0,45,1
1746616112946,EDS 139,A00,897203,Pappas; Elizabeth,44,0,45,1
1746616112946,EDS 139,B00,897209,Fargason; Sharon Gayle,41,0,45,4
1746616113971,EDS 201,A00,895545,Staff,22,0,45,23
1746616115010,EDS 203,A01,895581,Halter; Christopher P.,22,0,45,23
1746616116043,EDS 204R,A01,895625,Heinzman; Erica M.,39,0,45,6
1746616116043,EDS 204R,B01,895693,Halter; Christopher P.,10,0,45,35
1746616117074,EDS 206R,A00,895694,Fargason; Sharon Gayle,1,0,30,29
1746616117074,EDS 206R,B00,895695,Choi; Bailey Miyeon,16,0,30,14
1746616118099,EDS 250,A00,895697,Hemans; Patricia Ann Benitez,22,0,45,23
1746616119130,EDS 281,A00,895701,Meyerott; Theresa Ann,1,0,15,14
1746616120156,EDS 284,A00,895736,Meyerott; Theresa Ann,1,0,15,14
1746616121182,EDS 286,A00,897210,Fine; Sarah,0,0,15,15
1746616122208,EDS 289C,A01,895770,Daly; Alan J.,1,0,15,14
1746616123232,EDS 290,A00,897211,Hofstetter; Carolyn,0,0,15,15
1746616124258,LIGM 5A,A00,896162,Fischer-Grunski; Eva K,12,0,20,8
1746616125286,LIGM 5B,A00,896260,Fischer-Grunski; Eva K,17,0,20,3
1746616126313,LIGM 5C,A00,896308,Fischer-Grunski; Eva K,18,0,20,2
1746616127348,LIIT 5AS,A00,896313,Carnelos; Chiara,18,0,20,2
1746616128373,LIIT 5BS,A00,896416,Carnelos; Chiara,20,0,20,0
1746616129401,LIIT 5CS,A00,896564,Carnelos; Chiara,20,0,20,0
1746616130430,LISP 5A,A00,896588,Munoz Sanchez; Alicia,2,0,20,18
1746616131456,LISP 5B,A00,896653,Munoz Sanchez; Alicia,7,0,20,13
1746616132488,LISP 5C,A00,896655,Munoz Sanchez; Alicia,0,1,20,20
1746616133518,MAE 197,001,957918,Kleissl; Jan,9996,0,9999,3
1746616133518,MAE 197,002,959806,Boechler; Nicholas Sebastia,9998,0,9999,1
1746616133518,MAE 197,003,959852,Mullin; Jennifer S,9998,0,9999,1
1746616134552,MATH 2,A01,957937,Staff,33,0,35,2
1746616135579,MATH 197,001,957876,Kedlaya; Kiran S.,9993,0,9999,6
1746616136614,MCWP 40,A00,892729,Duru; Nur,10,0,20,10
1746616136614,MCWP 40,B00,893304,Montejo; Carolina,14,0,20,6
1746616137640,MCWP 40R,A00,893757,Redela; Pamela Morgan,0,5,20,20
1746616138670,MCWP 50,A00,893758,Morshed; Michael James,0,0,20,20
1746616138670,MCWP 50,B00,893761,Bartulis; Jason Michael,16,0,20,4
1746616139698,MCWP 50R,A00,893766,Compas; Sean Matthew,0,1,20,20
1746616139698,MCWP 50R,B00,893769,Carter; Jennifer A,0,1,20,20
1746616139698,MCWP 50R,C00,893771,Krone; Jarret,0,3,20,20
1746616139698,MCWP 50R,D00,893772,Miller; Elizabeth Deen,0,0,20,20
1746616139698,MCWP 50R,E00,893775,Carter; Andrea L,0,1,20,20
1746616140725,MMW 11R,A01,892721,Herbst; Matthew,14,0,30,16
1746616140725,MMW 11R,A02,892722,Herbst; Matthew,0,0,0,3
1746616141751,MMW 12R,A01,892724,Herbst; Matthew,0,11,16,16
1746616141751,MMW 12R,A02,892725,Herbst; Matthew,0,10,16,16
1746616142778,MMW 13R,A01,892727,Staff,0,4,16,16
1746616142778,MMW 13R,A02,892728,Staff,0,4,16,16
1746616142778,MMW 13R,A03,958032,Staff,0,4,16,16
1746616142778,MMW 13R,A04,958033,Staff,0,4,16,16
1746616142778,MMW 13R,A05,958034,Staff,0,4,16,16
1746616143804,SIO 295LS,A00,894015,Staff,5,0,25,20
1746616144835,SIO 295S,A00,894020,Staff,5,0,25,20
1746616145863,SIOC 290S,B01,958918,Merrifield; Mark A,14,0,30,16
1746616146896,SIOC 291S,B01,958922,Gabriel; Corey John,14,0,30,16
1746616147928,SOCI 117,A01,895339,Staff,2,0,5,3
1746616149016,WES 237B,A00,894149,Staff,11,0,20,9
1746616151149,AESE 279B,A00,891859,Staff,13,0,35,22
1746616152180,AIP 197,001,891854,Vespa; Emanuel Ignacio,9999,0,9999,0
1746616153206,ANTH 289S,A00,891856,Gagneux; Pascal,12,0,12,0
1746616154239,BENG 196,001,957946,Engler; Adam J.,9996,0,9999,3
1746616155268,BISP 197,001,959851,Wilhelm; James E.,9998,0,9999,1
1746616156296,CAT 124RS,A01,956906,Staff,6,0,25,19
1746616157323,CAT 125RS,A01,922013,Staff,6,0,25,19
1746616158349,CLRE 250,A00,891860,Morris; Sheldon,9995,0,9999,4
1746616160400,CLRE 251R,A00,907817,Mehta; Ravindra L.,9994,0,9999,5
1746616161427,CLRE 252,A00,891864,Cuomo; Raphael Eduardo,9993,0,9999,6
1746616162452,CLRE 253,A00,891867,Vaida; Florin,9994,0,9999,5
1746616162452,CLRE 253,B00,907819,Staff,9999,0,9999,0
1746616163477,CLRE 259,A00,891868,Patel; Hemal,9998,0,9999,1
1746616164506,CLRE 260,A00,891872,Cuomo; Raphael Eduardo,9999,0,9999,0
1746616165535,CLRE 297,001,891888,Cuomo; Raphael Eduardo,9999,0,9999,0
1746616166563,CSE 191,A00,958773,Minnes Kemp; Mor Mia,9995,0,9999,4
1746616167589,CSE 197,001,959846,Minnes Kemp; Mor Mia,9990,0,9999,9
1746616168624,CSS 201S,A01,892054,Mignozzetti; Umberto,25,0,30,5
1746616169656,CSS 202S,A01,892056,Mignozzetti; Umberto,25,0,30,5
1746616170683,DSC 197,001,956898,Eldridge; Justin Matthew,9996,0,9999,3
1746616171711,DSC 297,001,958000,Mazumdar; Arya,9998,0,9999,1
1746616171711,DSC 297,002,959862,Wang; Yusu,9998,0,9999,1
1746616172737,EAP 100,A00,905686,Staff,9778,0,9999,221
1746616173766,ECE 45,A01,892618,Staff,0,0,65,65
1746616175819,ECE 111,A01,892719,Staff,6,0,65,59
1746616176845,ECE 197,001,957920,Mercier; Patrick Philip,9991,0,9999,8
1746616177882,ECON 178,A01,907814,Zhu; Ying,26,0,35,9
1746616178907,EDS 115,A00,895312,Staff,35,0,45,10
1746616179932,EDS 117,A01,895337,Staff,23,0,30,7
1746616180957,EDS 125,A00,895341,Jones; Gabrielle Anastasia,36,0,45,9
1746616181983,EDS 128A,A01,895459,Fargason; Sharon Gayle,44,0,45,1
1746616183025,EDS 128B,A01,895543,Pappas; Elizabeth,44,0,45,1
1746616184053,EDS 139,A00,897203,Pappas; Elizabeth,44,0,45,1
1746616184053,EDS 139,B00,897209,Fargason; Sharon Gayle,41,0,45,4
1746616185082,EDS 201,A00,895545,Staff,22,0,45,23
1746616186109,EDS 203,A01,895581,Halter; Christopher P.,22,0,45,23
1746616187134,EDS 204R,A01,895625,Heinzman; Erica M.,39,0,45,6
1746616187134,EDS 204R,B01,895693,Halter; Christopher P.,10,0,45,35
1746616188165,EDS 206R,A00,895694,Fargason; Sharon Gayle,1,0,30,29
1746616188165,EDS 206R,B00,895695,Choi; Bailey Miyeon,16,0,30,14
1746616189190,EDS 250,A00,895697,Hemans; Patricia Ann Benitez,22,0,45,23
1746616190216,EDS 281,A00,895701,Meyerott; Theresa Ann,1,0,15,14
1746616191242,EDS 284,A00,895736,Meyerott; Theresa Ann,1,0,15,14
1746616192269,EDS 286,A00,897210,Fine; Sarah,0,0,15,15
1746616193296,EDS 289C,A01,895770,Daly; Alan J.,1,0,15,14
1746616194321,EDS 290,A00,897211,Hofstetter; Carolyn,0,0,15,15
1746616195351,LIGM 5A,A00,896162,Fischer-Grunski; Eva K,12,0,20,8
1746616196377,LIGM 5B,A00,896260,Fischer-Grunski; Eva K,17,0,20,3
1746616197409,LIGM 5C,A00,896308,Fischer-Grunski; Eva K,18,0,20,2
1746616198435,LIIT 5AS,A00,896313,Carnelos; Chiara,18,0,20,2
1746616199465,LIIT 5BS,A00,896416,Carnelos; Chiara,20,0,20,0
1746616200493,LIIT 5CS,A00,896564,Carnelos; Chiara,20,0,20,0
1746616201525,LISP 5A,A00,896588,Munoz Sanchez; Alicia,2,0,20,18
1746616202553,LISP 5B,A00,896653,Munoz Sanchez; Alicia,7,0,20,13
1746616203583,LISP 5C,A00,896655,Munoz Sanchez; Alicia,0,1,20,20
1746616204614,MAE 197,001,957918,Kleissl; Jan,9996,0,9999,3
1746616204614,MAE 197,002,959806,Boechler; Nicholas Sebastia,9998,0,9999,1
1746616204614,MAE 197,003,959852,Mullin; Jennifer S,9998,0,9999,1
1746616205641,MATH 2,A01,957937,Staff,33,0,35,2
1746616206671,MATH 197,001,957876,Kedlaya; Kiran S.,9993,0,9999,6
1746616207710,MCWP 40,A00,892729,Duru; Nur,10,0,20,10
1746616207710,MCWP 40,B00,893304,Montejo; Carolina,14,0,20,6
1746616208741,MCWP 40R,A00,893757,Redela; Pamela Morgan,0,5,20,20
1746616209768,MCWP 50,A00,893758,Morshed; Michael James,0,0,20,20
1746616209768,MCWP 50,B00,893761,Bartulis; Jason Michael,16,0,20,4
1746616210796,MCWP 50R,A00,893766,Compas; Sean Matthew,0,1,20,20
1746616210796,MCWP 50R,B00,893769,Carter; Jennifer A,0,1,20,20
1746616210796,MCWP 50R,C00,893771,Krone; Jarret,0,3,20,20
1746616210796,MCWP 50R,D00,893772,Miller; Elizabeth Deen,0,0,20,20
1746616210796,MCWP 50R,E00,893775,Carter; Andrea L,0,1,20,20
1746616211823,MMW 11R,A01,892721,Herbst; Matthew,14,0,30,16
1746616211823,MMW 11R,A02,892722,Herbst; Matthew,0,0,0,3
1746616212848,MMW 12R,A01,892724,Herbst; Matthew,0,11,16,16
1746616212848,MMW 12R,A02,892725,Herbst; Matthew,0,10,16,16
1746616213876,MMW 13R,A01,892727,Staff,0,4,16,16
1746616213876,MMW 13R,A02,892728,Staff,0,4,16,16
1746616213876,MMW 13R,A03,958032,Staff,0,4,16,16
1746616213876,MMW 13R,A04,958033,Staff,0,4,16,16
1746616213876,MMW 13R,A05,958034,Staff,0,4,16,16
1746616214904,SIO 295LS,A00,894015,Staff,5,0,25,20
1746616215929,SIO 295S,A00,894020,Staff,5,0,25,20
1746616216967,SIOC 290S,B01,958918,Merrifield; Mark A,14,0,30,16
1746616217996,SIOC 291S,B01,958922,Gabriel; Corey John,14,0,30,16
1746616219027,SOCI 117,A01,895339,Staff,2,0,5,3
1746616220054,WES 237B,A00,894149,Staff,11,0,20,9
1746616222143,AESE 279B,A00,891859,Staff,13,0,35,22
1746616223172,AIP 197,001,891854,Vespa; Emanuel Ignacio,9999,0,9999,0
1746616224199,ANTH 289S,A00,891856,Gagneux; Pascal,12,0,12,0
1746616225226,BENG 196,001,957946,Engler; Adam J.,9996,0,9999,3
1746616226253,BISP 197,001,959851,Wilhelm; James E.,9998,0,9999,1
1746616227295,CAT 124RS,A01,956906,Staff,6,0,25,19
1746616228324,CAT 125RS,A01,922013,Staff,6,0,25,19
1746616229350,CLRE 250,A00,891860,Morris; Sheldon,9995,0,9999,4
1746616231405,CLRE 251R,A00,907817,Mehta; Ravindra L.,9994,0,9999,5
1746616232432,CLRE 252,A00,891864,Cuomo; Raphael Eduardo,9993,0,9999,6
1746616233459,CLRE 253,A00,891867,Vaida; Florin,9994,0,9999,5
1746616233459,CLRE 253,B00,907819,Staff,9999,0,9999,0
1746616234488,CLRE 259,A00,891868,Patel; Hemal,9998,0,9999,1
1746616235516,CLRE 260,A00,891872,Cuomo; Raphael Eduardo,9999,0,9999,0
1746616236542,CLRE 297,001,891888,Cuomo; Raphael Eduardo,9999,0,9999,0
1746616237571,CSE 191,A00,958773,Minnes Kemp; Mor Mia,9995,0,9999,4
1746616238596,CSE 197,001,959846,Minnes Kemp; Mor Mia,9990,0,9999,9
1746616239624,CSS 201S,A01,892054,Mignozzetti; Umberto,25,0,30,5
1746616240651,CSS 202S,A01,892056,Mignozzetti; Umberto,25,0,30,5
1746616241679,DSC 197,001,956898,Eldridge; Justin Matthew,9996,0,9999,3
1746616242705,DSC 297,001,958000,Mazumdar; Arya,9998,0,9999,1
1746616242705,DSC 297,002,959862,Wang; Yusu,9998,0,9999,1
1746616243732,EAP 100,A00,905686,Staff,9778,0,9999,221
1746616244761,ECE 45,A01,892618,Staff,0,0,65,65
1746616246813,ECE 111,A01,892719,Staff,6,0,65,59
1746616247841,ECE 197,001,957920,Mercier; Patrick Philip,9991,0,9999,8
1746616248876,ECON 178,A01,907814,Zhu; Ying,26,0,35,9
1746616249905,EDS 115,A00,895312,Staff,35,0,45,10
1746616250933,EDS 117,A01,895337,Staff,23,0,30,7
1746616251962,EDS 125,A00,895341,Jones; Gabrielle Anastasia,36,0,45,9
1746616252994,EDS 128A,A01,895459,Fargason; Sharon Gayle,44,0,45,1
1746616254026,EDS 128B,A01,895543,Pappas; Elizabeth,44,0,45,1
1746616255058,EDS 139,A00,897203,Pappas; Elizabeth,44,0,45,1
1746616255058,EDS 139,B00,897209,Fargason; Sharon Gayle,41,0,45,4
1746616256083,EDS 201,A00,895545,Staff,22,0,45,23
1746616257113,EDS 203,A01,895581,Halter; Christopher P.,22,0,45,23
1746616258139,EDS 204R,A01,895625,Heinzman; Erica M.,39,0,45,6
1746616258139,EDS 204R,B01,895693,Halter; Christopher P.,10,0,45,35
1746616259183,EDS 206R,A00,895694,Fargason; Sharon Gayle,1,0,30,29
1746616259183,EDS 206R,B00,895695,Choi; Bailey Miyeon,16,0,30,14
1746616260211,EDS 250,A00,895697,Hemans; Patricia Ann Benitez,22,0,45,23
1746616261241,EDS 281,A00,895701,Meyerott; Theresa Ann,1,0,15,14
1746616262268,EDS 284,A00,895736,Meyerott; Theresa Ann,1,0,15,14
1746616263296,EDS 286,A00,897210,Fine; Sarah,0,0,15,15
1746616264325,EDS 289C,A01,895770,Daly; Alan J.,1,0,15,14
1746616265353,EDS 290,A00,897211,Hofstetter; Carolyn,0,0,15,15
1746616266386,LIGM 5A,A00,896162,Fischer-Grunski; Eva K,12,0,20,8
1746616267418,LIGM 5B,A00,896260,Fischer-Grunski; Eva K,17,0,20,3
1746616268444,LIGM 5C,A00,896308,Fischer-Grunski; Eva K,18,0,20,2
1746616269476,LIIT 5AS,A00,896313,Carnelos; Chiara,18,0,20,2
1746616270503,LIIT 5BS,A00,896416,Carnelos; Chiara,20,0,20,0
1746616271532,LIIT 5CS,A00,896564,Carnelos; Chiara,20,0,20,0
1746616272558,LISP 5A,A00,896588,Munoz Sanchez; Alicia,2,0,20,18
1746616273587,LISP 5B,A00,896653,Munoz Sanchez; Alicia,7,0,20,13
1746616274615,LISP 5C,A00,896655,Munoz Sanchez; Alicia,0,1,20,20
1746616275644,MAE 197,001,957918,Kleissl; Jan,9996,0,9999,3
1746616275644,MAE 197,002,959806,Boechler; Nicholas Sebastia,9998,0,9999,1
1746616275644,MAE 197,003,959852,Mullin; Jennifer S,9998,0,9999,1
1746616276669,MATH 2,A01,957937,Staff,33,0,35,2
1746616277695,MATH 197,001,957876,Kedlaya; Kiran S.,9993,0,9999,6
1746616278726,MCWP 40,A00,892729,Duru; Nur,10,0,20,10
1746616278726,MCWP 40,B00,893304,Montejo; Carolina,14,0,20,6
1746616279758,MCWP 40R,A00,893757,Redela; Pamela Morgan,0,5,20,20
1746616280786,MCWP 50,A00,893758,Morshed; Michael James,0,0,20,20
1746616280786,MCWP 50,B00,893761,Bartulis; Jason Michael,16,0,20,4
1746616281816,MCWP 50R,A00,893766,Compas; Sean Matthew,0,1,20,20
1746616281816,MCWP 50R,B00,893769,Carter; Jennifer A,0,1,20,20
1746616281816,MCWP 50R,C00,893771,Krone; Jarret,0,3,20,20
1746616281816,MCWP 50R,D00,893772,Miller; Elizabeth Deen,0,0,20,20
1746616281816,MCWP 50R,E00,893775,Carter; Andrea L,0,1,20,20
1746616282842,MMW 11R,A01,892721,Herbst; Matthew,14,0,30,16
1746616282842,MMW 11R,A02,892722,Herbst; Matthew,0,0,0,3
1746616283870,MMW 12R,A01,892724,Herbst; Matthew,0,11,16,16
1746616283870,MMW 12R,A02,892725,Herbst; Matthew,0,10,16,16
1746616284901,MMW 13R,A01,892727,Staff,0,4,16,16
1746616284901,MMW 13R,A02,892728,Staff,0,4,16,16
1746616284901,MMW 13R,A03,958032,Staff,0,4,16,16
1746616284901,MMW 13R,A04,958033,Staff,0,4,16,16
1746616284901,MMW 13R,A05,958034,Staff,0,4,16,16
1746616285928,SIO 295LS,A00,894015,Staff,5,0,25,20
1746616286955,SIO 295S,A00,894020,Staff,5,0,25,20
1746616287984,SIOC 290S,B01,958918,Merrifield; Mark A,14,0,30,16
1746616289015,SIOC 291S,B01,958922,Gabriel; Corey John,14,0,30,16
1746616290048,SOCI 117,A01,895339,Staff,2,0,5,3
1746616291074,WES 237B,A00,894149,Staff,11,0,20,9
1746616293212,AESE 279B,A00,891859,Staff,13,0,35,22
1746616294237,AIP 197,001,891854,Vespa; Emanuel Ignacio,9999,0,9999,0
1746616295268,ANTH 289S,A00,891856,Gagneux; Pascal,12,0,12,0
1746616296295,BENG 196,001,957946,Engler; Adam J.,9996,0,9999,3
1746616297324,BISP 197,001,959851,Wilhelm; James E.,9998,0,9999,1
1746616298350,CAT 124RS,A01,956906,Staff,6,0,25,19
1746616299379,CAT 125RS,A01,922013,Staff,6,0,25,19
1746616300405,CLRE 250,A00,891860,Morris; Sheldon,9995,0,9999,4
1746616302461,CLRE 251R,A00,907817,Mehta; Ravindra L.,9994,0,9999,5
1746616303489,CLRE 252,A00,891864,Cuomo; Raphael Eduardo,9993,0,9999,6
1746616304517,CLRE 253,A00,891867,Vaida; Florin,9994,0,9999,5
1746616304517,CLRE 253,B00,907819,Staff,9999,0,9999,0
1746616305547,CLRE 259,A00,891868,Patel; Hemal,9998,0,9999,1
1746616306573,CLRE 260,A00,891872,Cuomo; Raphael Eduardo,9999,0,9999,0
1746616307598,CLRE 297,001,891888,Cuomo; Raphael Eduardo,9999,0,9999,0
1746616308628,CSE 191,A00,958773,Minnes Kemp; Mor Mia,9995,0,9999,4
1746616309656,CSE 197,001,959846,Minnes Kemp; Mor Mia,9990,0,9999,9
1746616310690,CSS 201S,A01,892054,Mignozzetti; Umberto,25,0,30,5
1746616311716,CSS 202S,A01,892056,Mignozzetti; Umberto,25,0,30,5
1746616312744,DSC 197,001,956898,Eldridge; Justin Matthew,9996,0,9999,3
1746616313774,DSC 297,001,958000,Mazumdar; Arya,9998,0,9999,1
1746616313774,DSC 297,002,959862,Wang; Yusu,9998,0,9999,1
1746616314804,EAP 100,A00,905686,Staff,9778,0,9999,221
1746616315833,ECE 45,A01,892618,Staff,0,0,65,65
1746616317889,ECE 111,A01,892719,Staff,6,0,65,59
1746616318920,ECE 197,001,957920,Mercier; Patrick Philip,9991,0,9999,8
1746616319952,ECON 178,A01,907814,Zhu; Ying,26,0,35,9
1746616320983,EDS 115,A00,895312,Staff,35,0,45,10
1746616322014,EDS 117,A01,895337,Staff,23,0,30,7
1746616323047,EDS 125,A00,895341,Jones; Gabrielle Anastasia,36,0,45,9
1746616324075,EDS 128A,A01,895459,Fargason; Sharon Gayle,44,0,45,1
1746616325103,EDS 128B,A01,895543,Pappas; Elizabeth,44,0,45,1
1746616326136,EDS 139,A00,897203,Pappas; Elizabeth,44,0,45,1
1746616326136,EDS 139,B00,897209,Fargason; Sharon Gayle,41,0,45,4
1746616327162,EDS 201,A00,895545,Staff,22,0,45,23
1746616328191,EDS 203,A01,895581,Halter; Christopher P.,22,0,45,23
1746616329219,EDS 204R,A01,895625,Heinzman; Erica M.,39,0,45,6
1746616329219,EDS 204R,B01,895693,Halter; Christopher P.,10,0,45,35
1746616330251,EDS 206R,A00,895694,Fargason; Sharon Gayle,1,0,30,29
1746616330251,EDS 206R,B00,895695,Choi; Bailey Miyeon,16,0,30,14
1746616331277,EDS 250,A00,895697,Hemans; Patricia Ann Benitez,22,0,45,23
1746616332304,EDS 281,A00,895701,Meyerott; Theresa Ann,1,0,15,14
1746616333330,EDS 284,A00,895736,Meyerott; Theresa Ann,1,0,15,14
1746616334357,EDS 286,A00,897210,Fine; Sarah,0,0,15,15
1746616335383,EDS 289C,A01,895770,Daly; Alan J.,1,0,15,14
1746616336412,EDS 290,A00,897211,Hofstetter; Carolyn,0,0,15,15
1746616337440,LIGM 5A,A00,896162,Fischer-Grunski; Eva K,12,0,20,8
1746616338468,LIGM 5B,A00,896260,Fischer-Grunski; Eva K,17,0,20,3
1746616339496,LIGM 5C,A00,896308,Fischer-Grunski; Eva K,18,0,20,2
1746616340528,LIIT 5AS,A00,896313,Carnelos; Chiara,18,0,20,2
1746616341554,LIIT 5BS,A00,896416,Carnelos; Chiara,20,0,20,0
1746616342583,LIIT 5CS,A00,896564,Carnelos; Chiara,20,0,20,0
1746616343614,LISP 5A,A00,896588,Munoz Sanchez; Alicia,2,0,20,18
1746616344639,LISP 5B,A00,896653,Munoz Sanchez; Alicia,7,0,20,13
1746616345666,LISP 5C,A00,896655,Munoz Sanchez; Alicia,0,1,20,20
1746616346692,MAE 197,001,957918,Kleissl; Jan,9996,0,9999,3
1746616346692,MAE 197,002,959806,Boechler; Nicholas Sebastia,9998,0,9999,1
1746616346692,MAE 197,003,959852,Mullin; Jennifer S,9998,0,9999,1
1746616347718,MATH 2,A01,957937,Staff,33,0,35,2
1746616348745,MATH 197,001,957876,Kedlaya; Kiran S.,9993,0,9999,6
1746616349775,MCWP 40,A00,892729,Duru; Nur,10,0,20,10
1746616349775,MCWP 40,B00,893304,Montejo; Carolina,14,0,20,6
1746616350801,MCWP 40R,A00,893757,Redela; Pamela Morgan,0,5,20,20
1746616351832,MCWP 50,A00,893758,Morshed; Michael James,0,0,20,20
1746616351832,MCWP 50,B00,893761,Bartulis; Jason Michael,16,0,20,4
1746616352864,MCWP 50R,A00,893766,Compas; Sean Matthew,0,1,20,20
1746616352864,MCWP 50R,B00,893769,Carter; Jennifer A,0,1,20,20
1746616352864,MCWP 50R,C00,893771,Krone; Jarret,0,3,20,20
1746616352864,MCWP 50R,D00,893772,Miller; Elizabeth Deen,0,0,20,20
1746616352864,MCWP 50R,E00,893775,Carter; Andrea L,0,1,20,20
1746616353890,MMW 11R,A01,892721,Herbst; Matthew,14,0,30,16
1746616353890,MMW 11R,A02,892722,Herbst; Matthew,0,0,0,3
1746616354919,MMW 12R,A01,892724,Herbst; Matthew,0,11,16,16
1746616354919,MMW 12R,A02,892725,Herbst; Matthew,0,10,16,16
1746616355945,MMW 13R,A01,892727,Staff,0,4,16,16
1746616355945,MMW 13R,A02,892728,Staff,0,4,16,16
1746616355945,MMW 13R,A03,958032,Staff,0,4,16,16
1746616355945,MMW 13R,A04,958033,Staff,0,4,16,16
1746616355945,MMW 13R,A05,958034,Staff,0,4,16,16
1746616356977,SIO 295LS,A00,894015,Staff,5,0,25,20
1746616358005,SIO 295S,A00,894020,Staff,5,0,25,20
1746616359097,SIOC 290S,B01,958918,Merrifield; Mark A,14,0,30,16
1746616360126,SIOC 291S,B01,958922,Gabriel; Corey John,14,0,30,16
1746616361154,SOCI 117,A01,895339,Staff,2,0,5,3
1746616362190,WES 237B,A00,894149,Staff,11,0,20,9
1746616364276,AESE 279B,A00,891859,Staff,13,0,35,22
1746616365303,AIP 197,001,891854,Vespa; Emanuel Ignacio,9999,0,9999,0
1746616366331,ANTH 289S,A00,891856,Gagneux; Pascal,12,0,12,0
1746616367357,BENG 196,001,957946,Engler; Adam J.,9996,0,9999,3
1746616368383,BISP 197,001,959851,Wilhelm; James E.,9998,0,9999,1
1746616369409,CAT 124RS,A01,956906,Staff,6,0,25,19
1746616370438,CAT 125RS,A01,922013,Staff,6,0,25,19
1746616371465,CLRE 250,A00,891860,Morris; Sheldon,9995,0,9999,4
1746616373530,CLRE 251R,A00,907817,Mehta; Ravindra L.,9994,0,9999,5
1746616374557,CLRE 252,A00,891864,Cuomo; Raphael Eduardo,9993,0,9999,6
1746616375588,CLRE 253,A00,891867,Vaida; Florin,9994,0,9999,5
1746616375588,CLRE 253,B00,907819,Staff,9999,0,9999,0
1746616376617,CLRE 259,A00,891868,Patel; Hemal,9998,0,9999,1
1746616377650,CLRE 260,A00,891872,Cuomo; Raphael Eduardo,9999,0,9999,0
1746616378675,CLRE 297,001,891888,Cuomo; Raphael Eduardo,9999,0,9999,0
1746616379702,CSE 191,A00,958773,Minnes Kemp; Mor Mia,9995,0,9999,4
1746616380729,CSE 197,001,959846,Minnes Kemp; Mor Mia,9990,0,9999,9
1746616381823,CSS 201S,A01,892054,Mignozzetti; Umberto,25,0,30,5
1746616382855,CSS 202S,A01,892056,Mignozzetti; Umberto,25,0,30,5
1746616383886,DSC 197,001,956898,Eldridge; Justin Matthew,9996,0,9999,3
1746616384917,DSC 297,001,958000,Mazumdar; Arya,9998,0,9999,1
1746616384917,DSC 297,002,959862,Wang; Yusu,9998,0,9999,1
1746616385948,EAP 100,A00,905686,Staff,9778,0,9999,221
1746616386976,ECE 45,A01,892618,Staff,0,0,65,65
1746616389028,ECE 111,A01,892719,Staff,6,0,65,59
1746616390056,ECE 197,001,957920,Mercier; Patrick Philip,9991,0,9999,8
1746616391087,ECON 178,A01,907814,Zhu; Ying,26,0,35,9
1746616392118,EDS 115,A00,895312,Staff,35,0,45,10
1746616393145,EDS 117,A01,895337,Staff,23,0,30,7
1746616394173,EDS 125,A00,895341,Jones; Gabrielle Anastasia,36,0,45,9
1746616395199,EDS 128A,A01,895459,Fargason; Sharon Gayle,44,0,45,1
1746616396225,EDS 128B,A01,895543,Pappas; Elizabeth,44,0,45,1
1746616397253,EDS 139,A00,897203,Pappas; Elizabeth,44,0,45,1
1746616397253,EDS 139,B00,897209,Fargason; Sharon Gayle,41,0,45,4
1746616398279,EDS 201,A00,895545,Staff,22,0,45,23
1746616399309,EDS 203,A01,895581,Halter; Christopher P.,22,0,45,23
1746616400336,EDS 204R,A01,895625,Heinzman; Erica M.,39,0,45,6
1746616400336,EDS 204R,B01,895693,Halter; Christopher P.,10,0,45,35
1746616401362,EDS 206R,A00,895694,Fargason; Sharon Gayle,1,0,30,29
1746616401362,EDS 206R,B00,895695,Choi; Bailey Miyeon,16,0,30,14
1746616402399,EDS 250,A00,895697,Hemans; Patricia Ann Benitez,22,0,45,23
1746616403428,EDS 281,A00,895701,Meyerott; Theresa Ann,1,0,15,14
1746616404456,EDS 284,A00,895736,Meyerott; Theresa Ann,1,0,15,14
1746616405486,EDS 286,A00,897210,Fine; Sarah,0,0,15,15
1746616406512,EDS 289C,A01,895770,Daly; Alan J.,1,0,15,14
1746616407540,EDS 290,A00,897211,Hofstetter; Carolyn,0,0,15,15
1746616408565,LIGM 5A,A00,896162,Fischer-Grunski; Eva K,12,0,20,8
1746616409593,LIGM 5B,A00,896260,Fischer-Grunski; Eva K,17,0,20,3
1746616410623,LIGM 5C,A00,896308,Fischer-Grunski; Eva K,18,0,20,2
1746616411652,LIIT 5AS,A00,896313,Carnelos; Chiara,18,0,20,2
1746616412677,LIIT 5BS,A00,896416,Carnelos; Chiara,20,0,20,0
1746616413706,LIIT 5CS,A00,896564,Carnelos; Chiara,20,0,20,0
1746616414733,LISP 5A,A00,896588,Munoz Sanchez; Alicia,2,0,20,18
1746616415760,LISP 5B,A00,896653,Munoz Sanchez; Alicia,7,0,20,13
1746616416786,LISP 5C,A00,896655,Munoz Sanchez; Alicia,0,1,20,20
1746616417816,MAE 197,001,957918,Kleissl; Jan,9996,0,9999,3
1746616417816,MAE 197,002,959806,Boechler; Nicholas Sebastia,9998,0,9999,1
1746616417816,MAE 197,003,959852,Mullin; Jennifer S,9998,0,9999,1
1746616418842,MATH 2,A01,957937,Staff,33,0,35,2
1746616419869,MATH 197,001,957876,Kedlaya; Kiran S.,9993,0,9999,6
1746616420902,MCWP 40,A00,892729,Duru; Nur,10,0,20,10
1746616420902,MCWP 40,B00,893304,Montejo; Carolina,14,0,20,6
1746616421928,MCWP 40R,A00,893757,Redela; Pamela Morgan,0,5,20,20
1746616422955,MCWP 50,A00,893758,Morshed; Michael James,0,0,20,20
1746616422955,MCWP 50,B00,893761,Bartulis; Jason Michael,16,0,20,4
1746616423984,MCWP 50R,A00,893766,Compas; Sean Matthew,0,1,20,20
1746616423984,MCWP 50R,B00,893769,Carter; Jennifer A,0,1,20,20
1746616423984,MCWP 50R,C00,893771,Krone; Jarret,0,3,20,20
1746616423984,MCWP 50R,D00,893772,Miller; Elizabeth Deen,0,0,20,20
1746616423984,MCWP 50R,E00,893775,Carter; Andrea L,0,1,20,20
1746616425015,MMW 11R,A01,892721,Herbst; Matthew,14,0,30,16
1746616425015,MMW 11R,A02,892722,Herbst; Matthew,0,0,0,3
1746616426044,MMW 12R,A01,892724,Herbst; Matthew,0,11,16,16
1746616426044,MMW 12R,A02,892725,Herbst; Matthew,0,10,16,16
1746616427069,MMW 13R,A01,892727,Staff,0,4,16,16
1746616427069,MMW 13R,A02,892728,Staff,0,4,16,16
1746616427069,MMW 13R,A03,958032,Staff,0,4,16,16
1746616427069,MMW 13R,A04,958033,Staff,0,4,16,16
1746616427069,MMW 13R,A05,958034,Staff,0,4,16,16
1746616428097,SIO 295LS,A00,894015,Staff,5,0,25,20
1746616429121,SIO 295S,A00,894020,Staff,5,0,25,20
1746616430151,SIOC 290S,B01,958918,Merrifield; Mark A,14,0,30,16
1746616431177,SIOC 291S,B01,958922,Gabriel; Corey John,14,0,30,16
1746616432206,SOCI 117,A01,895339,Staff,2,0,5,3
1746616433236,WES 237B,A00,894149,Staff,11,0,20,9
1746616435312,AESE 279B,A00,891859,Staff,13,0,35,22
1746616436339,AIP 197,001,891854,Vespa; Emanuel Ignacio,9999,0,9999,0
1746616437363,ANTH 289S,A00,891856,Gagneux; Pascal,12,0,12,0
1746616438388,BENG 196,001,957946,Engler; Adam J.,9996,0,9999,3
1746616439413,BISP 197,001,959851,Wilhelm; James E.,9998,0,9999,1
1746616440439,CAT 124RS,A01,956906,Staff,6,0,25,19
1746616441464,CAT 125RS,A01,922013,Staff,6,0,25,19
1746616442491,CLRE 250,A00,891860,Morris; Sheldon,9995,0,9999,4
1746616444547,CLRE 251R,A00,907817,Mehta; Ravindra L.,9994,0,9999,5
1746616445571,CLRE 252,A00,891864,Cuomo; Raphael Eduardo,9993,0,9999,6
1746616446601,CLRE 253,A00,891867,Vaida; Florin,9994,0,9999,5
1746616446601,CLRE 253,B00,907819,Staff,9999,0,9999,0
1746616447629,CLRE 259,A00,891868,Patel; Hemal,9998,0,9999,1
1746616448656,CLRE 260,A00,891872,Cuomo; Raphael Eduardo,9999,0,9999,0
1746616449681,CLRE 297,001,891888,Cuomo; Raphael Eduardo,9999,0,9999,0
1746616450711,CSE 191,A00,958773,Minnes Kemp; Mor Mia,9995,0,9999,4
1746616451741,CSE 197,001,959846,Minnes Kemp; Mor Mia,9990,0,9999,9
1746616452767,CSS 201S,A01,892054,Mignozzetti; Umberto,25,0,30,5
1746616453795,CSS 202S,A01,892056,Mignozzetti; Umberto,25,0,30,5
1746616454819,DSC 197,001,956898,Eldridge; Justin Matthew,9996,0,9999,3
1746616455848,DSC 297,001,958000,Mazumdar; Arya,9998,0,9999,1
1746616455848,DSC 297,002,959862,Wang; Yusu,9998,0,9999,1
1746616456876,EAP 100,A00,905686,Staff,9778,0,9999,221
1746616457900,ECE 45,A01,892618,Staff,0,0,65,65
1746616459957,ECE 111,A01,892719,Staff,6,0,65,59
1746616460981,ECE 197,001,957920,Mercier; Patrick Philip,9991,0,9999,8
1746616462011,ECON 178,A01,907814,Zhu; Ying,26,0,35,9
1746616463035,EDS 115,A00,895312,Staff,35,0,45,10
1746616464060,EDS 117,A01,895337,Staff,23,0,30,7
1746616465091,EDS 125,A00,895341,Jones; Gabrielle Anastasia,36,0,45,9
1746616466120,EDS 128A,A01,895459,Fargason; Sharon Gayle,44,0,45,1
1746616467146,EDS 128B,A01,895543,Pappas; Elizabeth,44,0,45,1
1746616468174,EDS 139,A00,897203,Pappas; Elizabeth,44,0,45,1
1746616468174,EDS 139,B00,897209,Fargason; Sharon Gayle,41,0,45,4
1746616469203,EDS 201,A00,895545,Staff,22,0,45,23
1746616470232,EDS 203,A01,895581,Halter; Christopher P.,22,0,45,23
1746616471260,EDS 204R,A01,895625,Heinzman; Erica M.,39,0,45,6
1746616471260,EDS 204R,B01,895693,Halter; Christopher P.,10,0,45,35
1746616472284,EDS 206R,A00,895694,Fargason; Sharon Gayle,1,0,30,29
1746616472284,EDS 206R,B00,895695,Choi; Bailey Miyeon,16,0,30,14
1746616473308,EDS 250,A00,895697,Hemans; Patricia Ann Benitez,22,0,45,23
1746616474334,EDS 281,A00,895701,Meyerott; Theresa Ann,1,0,15,14
1746616475364,EDS 284,A00,895736,Meyerott; Theresa Ann,1,0,15,14
1746616476389,EDS 286,A00,897210,Fine; Sarah,0,0,15,15
1746616477417,EDS 289C,A01,895770,Daly; Alan J.,1,0,15,14
1746616478445,EDS 290,A00,897211,Hofstetter; Carolyn,0,0,15,15
1746616479477,LIGM 5A,A00,896162,Fischer-Grunski; Eva K,12,0,20,8
1746616480503,LIGM 5B,A00,896260,Fischer-Grunski; Eva K,17,0,20,3
1746616481529,LIGM 5C,A00,896308,Fischer-Grunski; Eva K,18,0,20,2
1746616482556,LIIT 5AS,A00,896313,Carnelos; Chiara,18,0,20,2
1746616483583,LIIT 5BS,A00,896416,Carnelos; Chiara,20,0,20,0
1746616484608,LIIT 5CS,A00,896564,Carnelos; Chiara,20,0,20,0
1746616485635,LISP 5A,A00,896588,Munoz Sanchez; Alicia,2,0,20,18
1746616486702,LISP 5B,A00,896653,Munoz Sanchez; Alicia,7,0,20,13
1746616487733,LISP 5C,A00,896655,Munoz Sanchez; Alicia,0,1,20,20
1746616488758,MAE 197,001,957918,Kleissl; Jan,9996,0,9999,3
1746616488758,MAE 197,002,959806,Boechler; Nicholas Sebastia,9998,0,9999,1
1746616488758,MAE 197,003,959852,Mullin; Jennifer S,9998,0,9999,1
1746616489783,MATH 2,A01,957937,Staff,33,0,35,2
1746616490808,MATH 197,001,957876,Kedlaya; Kiran S.,9993,0,9999,6
1746616491836,MCWP 40,A00,892729,Duru; Nur,10,0,20,10
1746616491836,MCWP 40,B00,893304,Montejo; Carolina,14,0,20,6
1746616492860,MCWP 40R,A00,893757,Redela; Pamela Morgan,0,5,20,20
1746616493885,MCWP 50,A00,893758,Morshed; Michael James,0,0,20,20
1746616493885,MCWP 50,B00,893761,Bartulis; Jason Michael,16,0,20,4
1746616494911,MCWP 50R,A00,893766,Compas; Sean Matthew,0,1,20,20
1746616494911,MCWP 50R,B00,893769,Carter; Jennifer A,0,1,20,20
1746616494911,MCWP 50R,C00,893771,Krone; Jarret,0,3,20,20
1746616494911,MCWP 50R,D00,893772,Miller; Elizabeth Deen,0,0,20,20
1746616494911,MCWP 50R,E00,893775,Carter; Andrea L,0,1,20,20
1746616495937,MMW 11R,A01,892721,Herbst; Matthew,14,0,30,16
1746616495937,MMW 11R,A02,892722,Herbst; Matthew,0,0,0,3
1746616496966,MMW 12R,A01,892724,Herbst; Matthew,0,11,16,16
1746616496966,MMW 12R,A02,892725,Herbst; Matthew,0,10,16,16
1746616497994,MMW 13R,A01,892727,Staff,0,4,16,16
1746616497994,MMW 13R,A02,892728,Staff,0,4,16,16
1746616497994,MMW 13R,A03,958032,Staff,0,4,16,16
1746616497994,MMW 13R,A04,958033,Staff,0,4,16,16
1746616497994,MMW 13R,A05,958034,Staff,0,4,16,16
1746616499019,SIO 295LS,A00,894015,Staff,5,0,25,20
1746616500044,SIO 295S,A00,894020,Staff,5,0,25,20
1746616501071,SIOC 290S,B01,958918,Merrifield; Mark A,14,0,30,16
1746616502103,SIOC 291S,B01,958922,Gabriel; Corey John,14,0,30,16
1746616503131,SOCI 117,A01,895339,Staff,2,0,5,3
1746616504158,WES 237B,A00,894149,Staff,11,0,20,9
1746616506232,AESE 279B,A00,891859,Staff,13,0,35,22
1746616507258,AIP 197,001,891854,Vespa; Emanuel Ignacio,9999,0,9999,0
1746616508285,ANTH 289S,A00,891856,Gagneux; Pascal,12,0,12,0
1746616509311,BENG 196,001,957946,Engler; Adam J.,9996,0,9999,3
1746616510339,BISP 197,001,959851,Wilhelm; James E.,9998,0,9999,1
1746616511364,CAT 124RS,A01,956906,Staff,6,0,25,19
1746616512411,CAT 125RS,A01,922013,Staff,6,0,25,19
1746616513436,CLRE 250,A00,891860,Morris; Sheldon,9995,0,9999,4
1746616515489,CLRE 251R,A00,907817,Mehta; Ravindra L.,9994,0,9999,5
1746616516517,CLRE 252,A00,891864,Cuomo; Raphael Eduardo,9993,0,9999,6
1746616517544,CLRE 253,A00,891867,Vaida; Florin,9994,0,9999,5
1746616517544,CLRE 253,B00,907819,Staff,9999,0,9999,0
1746616518573,CLRE 259,A00,891868,Patel; Hemal,9998,0,9999,1
1746616519600,CLRE 260,A00,891872,Cuomo; Raphael Eduardo,9999,0,9999,0
1746616520624,CLRE 297,001,891888,Cuomo; Raphael Eduardo,9999,0,9999,0
1746616521652,CSE 191,A00,958773,Minnes Kemp; Mor Mia,9995,0,9999,4
1746616522681,CSE 197,001,959846,Minnes Kemp; Mor Mia,9990,0,9999,9
1746616523705,CSS 201S,A01,892054,Mignozzetti; Umberto,25,0,30,5
1746616524730,CSS 202S,A01,892056,Mignozzetti; Umberto,25,0,30,5
1746616525760,DSC 197,001,956898,Eldridge; Justin Matthew,9996,0,9999,3
1746616526787,DSC 297,001,958000,Mazumdar; Arya,9998,0,9999,1
1746616526787,DSC 297,002,959862,Wang; Yusu,9998,0,9999,1
1746616527813,EAP 100,A00,905686,Staff,9778,0,9999,221
1746616528845,ECE 45,A01,892618,Staff,0,0,65,65
1746616530904,ECE 111,A01,892719,Staff,6,0,65,59
1746616531928,ECE 197,001,957920,Mercier; Patrick Philip,9991,0,9999,8
1746616532955,ECON 178,A01,907814,Zhu; Ying,26,0,35,9
1746616533982,EDS 115,A00,895312,Staff,35,0,45,10
1746616535008,EDS 117,A01,895337,Staff,23,0,30,7
1746616536035,EDS 125,A00,895341,Jones; Gabrielle Anastasia,36,0,45,9
1746616537064,EDS 128A,A01,895459,Fargason; Sharon Gayle,44,0,45,1
1746616538099,EDS 128B,A01,895543,Pappas; Elizabeth,44,0,45,1
1746616539125,EDS 139,A00,897203,Pappas; Elizabeth,44,0,45,1
1746616539125,EDS 139,B00,897209,Fargason; Sharon Gayle,41,0,45,4
1746616540155,EDS 201,A00,895545,Staff,22,0,45,23
1746616541181,EDS 203,A01,895581,Halter; Christopher P.,22,0,45,23
1746616542208,EDS 204R,A01,895625,Heinzman; Erica M.,39,0,45,6
1746616542208,EDS 204R,B01,895693,Halter; Christopher P.,10,0,45,35
1746616543236,EDS 206R,A00,895694,Fargason; Sharon Gayle,1,0,30,29
1746616543236,EDS 206R,B00,895695,Choi; Bailey Miyeon,16,0,30,14
1746616544262,EDS 250,A00,895697,Hemans; Patricia Ann Benitez,22,0,45,23
1746616545287,EDS 281,A00,895701,Meyerott; Theresa Ann,1,0,15,14
1746616546311,EDS 284,A00,895736,Meyerott; Theresa Ann,1,0,15,14
1746616547336,EDS 286,A00,897210,Fine; Sarah,0,0,15,15
1746616548362,EDS 289C,A01,895770,Daly; Alan J.,1,0,15,14
1746616549390,EDS 290,A00,897211,Hofstetter; Carolyn,0,0,15,15
1746616550415,LIGM 5A,A00,896162,Fischer-Grunski; Eva K,12,0,20,8
1746616551445,LIGM 5B,A00,896260,Fischer-Grunski; Eva K,17,0,20,3
1746616552475,LIGM 5C,A00,896308,Fischer-Grunski; Eva K,18,0,20,2
1746616553501,LIIT 5AS,A00,896313,Carnelos; Chiara,18,0,20,2
1746616554527,LIIT 5BS,A00,896416,Carnelos; Chiara,20,0,20,0
1746616555557,LIIT 5CS,A00,896564,Carnelos; Chiara,20,0,20,0
1746616556587,LISP 5A,A00,896588,Munoz Sanchez; Alicia,2,0,20,18
1746616557612,LISP 5B,A00,896653,Munoz Sanchez; Alicia,7,0,20,13
1746616558638,LISP 5C,A00,896655,Munoz Sanchez; Alicia,0,1,20,20
1746616559663,MAE 197,001,957918,Kleissl; Jan,9996,0,9999,3
1746616559663,MAE 197,002,959806,Boechler; Nicholas Sebastia,9998,0,9999,1
1746616559663,MAE 197,003,959852,Mullin; Jennifer S,9998,0,9999,1
1746616560688,MATH 2,A01,957937,Staff,33,0,35,2
1746616561712,MATH 197,001,957876,Kedlaya; Kiran S.,9993,0,9999,6
1746616562741,MCWP 40,A00,892729,Duru; Nur,10,0,20,10
1746616562741,MCWP 40,B00,893304,Montejo; Carolina,14,0,20,6
1746616563766,MCWP 40R,A00,893757,Redela; Pamela Morgan,0,5,20,20
1746616564794,MCWP 50,A00,893758,Morshed; Michael James,0,0,20,20
1746616564794,MCWP 50,B00,893761,Bartulis; Jason Michael,16,0,20,4
1746616565821,MCWP 50R,A00,893766,Compas; Sean Matthew,0,1,20,20
1746616565821,MCWP 50R,B00,893769,Carter; Jennifer A,0,1,20,20
1746616565821,MCWP 50R,C00,893771,Krone; Jarret,0,3,20,20
1746616565821,MCWP 50R,D00,893772,Miller; Elizabeth Deen,0,0,20,20
1746616565821,MCWP 50R,E00,893775,Carter; Andrea L,0,1,20,20
1746616566850,MMW 11R,A01,892721,Herbst; Matthew,14,0,30,16
1746616566850,MMW 11R,A02,892722,Herbst; Matthew,0,0,0,3
1746616567878,MMW 12R,A01,892724,Herbst; Matthew,0,11,16,16
1746616567878,MMW 12R,A02,892725,Herbst; Matthew,0,10,16,16
1746616568905,MMW 13R,A01,892727,Staff,0,4,16,16
1746616568905,MMW 13R,A02,892728,Staff,0,4,16,16
1746616568905,MMW 13R,A03,958032,Staff,0,4,16,16
1746616568905,MMW 13R,A04,958033,Staff,0,4,16,16
1746616568905,MMW 13R,A05,958034,Staff,0,4,16,16
1746616569934,SIO 295LS,A00,894015,Staff,5,0,25,20
1746616570958,SIO 295S,A00,894020,Staff,5,0,25,20
1746616571988,SIOC 290S,B01,958918,Merrifield; Mark A,14,0,30,16
1746616573017,SIOC 291S,B01,958922,Gabriel; Corey John,14,0,30,16
1746616574042,SOCI 117,A01,895339,Staff,2,0,5,3
1746616575071,WES 237B,A00,894149,Staff,11,0,20,9
1746616577151,AESE 279B,A00,891859,Staff,13,0,35,22
1746616578177,AIP 197,001,891854,Vespa; Emanuel Ignacio,9999,0,9999,0
