time,subj_course_id,sec_code,sec_id,prof,available,waitlist,total,enrolled_ct
1745135425538,AESE 279B,A00,891859,Staff,35,0,35,0
1745135426565,AIP 197,001,891854,Staff,70,0,70,0
1745135427596,ANTH 289S,A00,891856,Gagneux; Pascal,12,0,12,0
1745135428628,BENG 196,001,957946,Engler; Adam J.,9996,0,9999,3
1745135429655,CAT 124RS,A01,956906,Staff,8,0,25,17
1745135430682,CAT 125RS,A01,922013,Staff,8,0,25,17
1745135431708,CLRE 250,A00,891860,Morris; Sheldon,9996,0,9999,3
1745135433771,CLRE 251R,A00,907817,Mehta; Ravindra L.,9995,0,9999,4
1745135434797,CLRE 252,A00,891864,Cuomo; Raphael Eduardo,9994,0,9999,5
1745135435826,CLRE 253,A00,891867,Vaida; Florin,9995,0,9999,4
1745135435826,CLRE 253,B00,907819,Staff,9999,0,9999,0
1745135436853,CLRE 259,A00,891868,Patel; Hemal,9998,0,9999,1
1745135437890,CLRE 260,A00,891872,Cuomo; Raphael Eduardo,9999,0,9999,0
1745135438920,CLRE 297,001,891888,Cuomo; Raphael Eduardo,9999,0,9999,0
1745135439952,CSS 201S,A01,892054,Mignozzetti; Umberto,30,0,30,0
1745135440978,CSS 202S,A01,892056,Mignozzetti; Umberto,30,0,30,0
1745135442005,DSC 197,001,956898,Eldridge; Justin Matthew,9998,0,9999,1
1745135443034,DSC 297,001,958000,Mazumdar; Arya,9999,0,9999,0
1745135444061,EAP 100,A00,905686,Staff,9774,0,9999,225
1745135445087,ECE 45,A01,892618,Staff,0,2,50,50
1745135446119,ECE 109,A01,892620,Staff,0,44,0,0
1745135447152,ECE 111,A01,892719,Staff,0,0,50,50
1745135448179,ECE 197,001,957920,Mercier; Patrick Philip,9992,0,9999,7
1745135449211,ECON 178,A01,907814,Zhu; Ying,29,0,35,6
1745135450243,EDS 115,A00,895312,Staff,42,0,45,3
1745135451272,EDS 117,A01,895337,Staff,30,0,30,0
1745135452304,EDS 125,A00,895341,Jones; Gabrielle Anastasia,43,0,45,2
1745135453331,EDS 128A,A01,895459,Fargason; Sharon Gayle,45,0,45,0
1745135454359,EDS 128B,A01,895543,Pappas; Elizabeth,45,0,45,0
1745135455385,EDS 139,A00,897203,Pappas; Elizabeth,45,0,45,0
1745135455385,EDS 139,B00,897209,Fargason; Sharon Gayle,45,0,45,0
1745135456411,EDS 201,A00,895545,Staff,44,0,45,1
1745135457439,EDS 203,A01,895581,Halter; Christopher P.,44,0,45,1
1745135458472,EDS 204R,A01,895625,Heinzman; Erica M.,45,0,45,0
1745135458472,EDS 204R,B01,895693,Halter; Christopher P.,28,0,45,17
1745135459500,EDS 206R,A00,895694,Fargason; Sharon Gayle,22,0,30,8
1745135459500,EDS 206R,B00,895695,Choi; Bailey Miyeon,21,0,30,9
1745135460531,EDS 250,A00,895697,Hemans; Patricia Ann Benitez,44,0,45,1
1745135461570,EDS 281,A00,895701,Meyerott; Theresa Ann,15,0,15,0
1745135462598,EDS 284,A00,895736,Meyerott; Theresa Ann,15,0,15,0
1745135463625,EDS 286,A00,897210,Fine; Sarah,15,0,15,0
1745135464666,EDS 289C,A01,895770,Daly; Alan J.,15,0,15,0
1745135465699,EDS 290,A00,897211,Hofstetter; Carolyn,15,0,15,0
1745135466728,LIGM 5A,A00,896162,Fischer-Grunski; Eva K,16,0,20,4
1745135467755,LIGM 5B,A00,896260,Fischer-Grunski; Eva K,19,0,20,1
1745135468786,LIGM 5C,A00,896308,Fischer-Grunski; Eva K,19,0,20,1
1745135469813,LIIT 5AS,A00,896313,Carnelos; Chiara,18,0,20,2
1745135470846,LIIT 5BS,A00,896416,Carnelos; Chiara,20,0,20,0
1745135471877,LIIT 5CS,A00,896564,Carnelos; Chiara,20,0,20,0
1745135472909,LISP 5A,A00,896588,Munoz Sanchez; Alicia,7,0,20,13
1745135473936,LISP 5B,A00,896653,Munoz Sanchez; Alicia,10,0,20,10
1745135474962,LISP 5C,A00,896655,Munoz Sanchez; Alicia,9,0,20,11
1745135475989,MAE 197,001,957918,Kleissl; Jan,9998,0,9999,1
1745135477015,MATH 2,A01,957937,Staff,34,0,35,1
1745135478045,MATH 197,001,957876,Kedlaya; Kiran S.,9996,0,9999,3
1745135479072,MCWP 40,A00,892729,Duru; Nur,16,0,20,4
1745135479072,MCWP 40,B00,893304,Montejo; Carolina,20,0,20,0
1745135480100,MCWP 40R,A00,893757,Redela; Pamela Morgan,0,3,20,20
1745135481132,MCWP 50,A00,893758,Morshed; Michael James,4,0,20,16
1745135481132,MCWP 50,B00,893761,Bartulis; Jason Michael,18,0,20,2
1745135482160,MCWP 50R,A00,893766,Compas; Sean Matthew,0,1,20,20
1745135482160,MCWP 50R,B00,893769,Carter; Jennifer A,5,0,20,15
1745135482160,MCWP 50R,C00,893771,Krone; Jarret,0,3,20,20
1745135482160,MCWP 50R,D00,893772,Miller; Elizabeth Deen,4,0,20,16
1745135482160,MCWP 50R,E00,893775,Carter; Andrea L,0,0,20,20
1745135483187,MMW 11R,A01,892721,Herbst; Matthew,22,0,30,8
1745135483187,MMW 11R,A02,892722,Herbst; Matthew,28,0,30,2
1745135484213,MMW 12R,A01,892724,Herbst; Matthew,0,4,16,16
1745135484213,MMW 12R,A02,892725,Herbst; Matthew,0,4,16,16
1745135485239,MMW 13R,A01,892727,Staff,0,29,16,16
1745135485239,MMW 13R,A02,892728,Staff,0,28,16,16
1745135486268,SIO 295LS,A00,894015,Staff,9,0,25,16
1745135487297,SIO 295S,A00,894020,Staff,9,0,25,16
1745135488329,SIOC 290S,A01,894063,Merrifield; Mark A,23,0,25,2
1745135489356,SIOC 291S,A01,894137,Gabriel; Corey John,23,0,25,2
1745135490383,SOCI 117,A01,895339,Staff,5,0,5,0
1745135491420,WES 237B,A00,894149,Staff,20,0,20,0
1745135493485,AESE 279B,A00,891859,Staff,35,0,35,0
1745135494509,AIP 197,001,891854,Staff,70,0,70,0
1745135495537,ANTH 289S,A00,891856,Gagneux; Pascal,12,0,12,0
1745135496564,BENG 196,001,957946,Engler; Adam J.,9996,0,9999,3
1745135497592,CAT 124RS,A01,956906,Staff,8,0,25,17
1745135498623,CAT 125RS,A01,922013,Staff,8,0,25,17
1745135499675,CLRE 250,A00,891860,Morris; Sheldon,9996,0,9999,3
1745135501732,CLRE 251R,A00,907817,Mehta; Ravindra L.,9995,0,9999,4
1745135502762,CLRE 252,A00,891864,Cuomo; Raphael Eduardo,9994,0,9999,5
1745135503787,CLRE 253,A00,891867,Vaida; Florin,9995,0,9999,4
1745135503787,CLRE 253,B00,907819,Staff,9999,0,9999,0
1745135504818,CLRE 259,A00,891868,Patel; Hemal,9998,0,9999,1
1745135505844,CLRE 260,A00,891872,Cuomo; Raphael Eduardo,9999,0,9999,0
1745135506871,CLRE 297,001,891888,Cuomo; Raphael Eduardo,9999,0,9999,0
1745135507900,CSS 201S,A01,892054,Mignozzetti; Umberto,30,0,30,0
1745135508925,CSS 202S,A01,892056,Mignozzetti; Umberto,30,0,30,0
1745135509956,DSC 197,001,956898,Eldridge; Justin Matthew,9998,0,9999,1
1745135510980,DSC 297,001,958000,Mazumdar; Arya,9999,0,9999,0
1745135512008,EAP 100,A00,905686,Staff,9774,0,9999,225
1745135513034,ECE 45,A01,892618,Staff,0,2,50,50
1745135514064,ECE 109,A01,892620,Staff,0,44,0,0
1745135515090,ECE 111,A01,892719,Staff,0,0,50,50
1745135516116,ECE 197,001,957920,Mercier; Patrick Philip,9992,0,9999,7
1745135517143,ECON 178,A01,907814,Zhu; Ying,29,0,35,6
1745135518170,EDS 115,A00,895312,Staff,42,0,45,3
1745135519195,EDS 117,A01,895337,Staff,30,0,30,0
1745135520221,EDS 125,A00,895341,Jones; Gabrielle Anastasia,43,0,45,2
1745135521248,EDS 128A,A01,895459,Fargason; Sharon Gayle,45,0,45,0
1745135522278,EDS 128B,A01,895543,Pappas; Elizabeth,45,0,45,0
1745135523303,EDS 139,A00,897203,Pappas; Elizabeth,45,0,45,0
1745135523303,EDS 139,B00,897209,Fargason; Sharon Gayle,45,0,45,0
1745135524331,EDS 201,A00,895545,Staff,44,0,45,1
1745135525359,EDS 203,A01,895581,Halter; Christopher P.,44,0,45,1
1745135526387,EDS 204R,A01,895625,Heinzman; Erica M.,45,0,45,0
1745135526387,EDS 204R,B01,895693,Halter; Christopher P.,28,0,45,17
1745135527417,EDS 206R,A00,895694,Fargason; Sharon Gayle,22,0,30,8
1745135527417,EDS 206R,B00,895695,Choi; Bailey Miyeon,21,0,30,9
1745135528447,EDS 250,A00,895697,Hemans; Patricia Ann Benitez,44,0,45,1
1745135529474,EDS 281,A00,895701,Meyerott; Theresa Ann,15,0,15,0
1745135530504,EDS 284,A00,895736,Meyerott; Theresa Ann,15,0,15,0
1745135531531,EDS 286,A00,897210,Fine; Sarah,15,0,15,0
1745135532564,EDS 289C,A01,895770,Daly; Alan J.,15,0,15,0
1745135533593,EDS 290,A00,897211,Hofstetter; Carolyn,15,0,15,0
1745135534619,LIGM 5A,A00,896162,Fischer-Grunski; Eva K,16,0,20,4
1745135535660,LIGM 5B,A00,896260,Fischer-Grunski; Eva K,19,0,20,1
1745135536691,LIGM 5C,A00,896308,Fischer-Grunski; Eva K,19,0,20,1
1745135537718,LIIT 5AS,A00,896313,Carnelos; Chiara,18,0,20,2
1745135538746,LIIT 5BS,A00,896416,Carnelos; Chiara,20,0,20,0
1745135539772,LIIT 5CS,A00,896564,Carnelos; Chiara,20,0,20,0
1745135540801,LISP 5A,A00,896588,Munoz Sanchez; Alicia,7,0,20,13
1745135541827,LISP 5B,A00,896653,Munoz Sanchez; Alicia,10,0,20,10
1745135542852,LISP 5C,A00,896655,Munoz Sanchez; Alicia,9,0,20,11
1745135543882,MAE 197,001,957918,Kleissl; Jan,9998,0,9999,1
1745135544911,MATH 2,A01,957937,Staff,34,0,35,1
1745135545938,MATH 197,001,957876,Kedlaya; Kiran S.,9996,0,9999,3
1745135546967,MCWP 40,A00,892729,Duru; Nur,16,0,20,4
1745135546967,MCWP 40,B00,893304,Montejo; Carolina,20,0,20,0
1745135547996,MCWP 40R,A00,893757,Redela; Pamela Morgan,0,3,20,20
1745135549023,MCWP 50,A00,893758,Morshed; Michael James,4,0,20,16
1745135549023,MCWP 50,B00,893761,Bartulis; Jason Michael,18,0,20,2
1745135550059,MCWP 50R,A00,893766,Compas; Sean Matthew,0,1,20,20
1745135550059,MCWP 50R,B00,893769,Carter; Jennifer A,5,0,20,15
1745135550059,MCWP 50R,C00,893771,Krone; Jarret,0,3,20,20
1745135550059,MCWP 50R,D00,893772,Miller; Elizabeth Deen,4,0,20,16
1745135550059,MCWP 50R,E00,893775,Carter; Andrea L,0,0,20,20
1745135551087,MMW 11R,A01,892721,Herbst; Matthew,22,0,30,8
1745135551087,MMW 11R,A02,892722,Herbst; Matthew,28,0,30,2
1745135552113,MMW 12R,A01,892724,Herbst; Matthew,0,4,16,16
1745135552113,MMW 12R,A02,892725,Herbst; Matthew,0,4,16,16
1745135553138,MMW 13R,A01,892727,Staff,0,29,16,16
1745135553138,MMW 13R,A02,892728,Staff,0,28,16,16
1745135554168,SIO 295LS,A00,894015,Staff,9,0,25,16
1745135555194,SIO 295S,A00,894020,Staff,9,0,25,16
1745135556225,SIOC 290S,A01,894063,Merrifield; Mark A,23,0,25,2
1745135557252,SIOC 291S,A01,894137,Gabriel; Corey John,23,0,25,2
1745135558279,SOCI 117,A01,895339,Staff,5,0,5,0
1745135559305,WES 237B,A00,894149,Staff,20,0,20,0
1745135561384,AESE 279B,A00,891859,Staff,35,0,35,0
1745135562410,AIP 197,001,891854,Staff,70,0,70,0
1745135563436,ANTH 289S,A00,891856,Gagneux; Pascal,12,0,12,0
1745135564463,BENG 196,001,957946,Engler; Adam J.,9996,0,9999,3
1745135565497,CAT 124RS,A01,956906,Staff,8,0,25,17
1745135566525,CAT 125RS,A01,922013,Staff,8,0,25,17
1745135567550,CLRE 250,A00,891860,Morris; Sheldon,9996,0,9999,3
1745135569606,CLRE 251R,A00,907817,Mehta; Ravindra L.,9995,0,9999,4
1745135570634,CLRE 252,A00,891864,Cuomo; Raphael Eduardo,9994,0,9999,5
1745135571663,CLRE 253,A00,891867,Vaida; Florin,9995,0,9999,4
1745135571663,CLRE 253,B00,907819,Staff,9999,0,9999,0
1745135572689,CLRE 259,A00,891868,Patel; Hemal,9998,0,9999,1
1745135573716,CLRE 260,A00,891872,Cuomo; Raphael Eduardo,9999,0,9999,0
1745135574743,CLRE 297,001,891888,Cuomo; Raphael Eduardo,9999,0,9999,0
1745135575776,CSS 201S,A01,892054,Mignozzetti; Umberto,30,0,30,0
1745135576807,CSS 202S,A01,892056,Mignozzetti; Umberto,30,0,30,0
1745135577835,DSC 197,001,956898,Eldridge; Justin Matthew,9998,0,9999,1
1745135578869,DSC 297,001,958000,Mazumdar; Arya,9999,0,9999,0
1745135579893,EAP 100,A00,905686,Staff,9774,0,9999,225
1745135580924,ECE 45,A01,892618,Staff,0,2,50,50
1745135581949,ECE 109,A01,892620,Staff,0,44,0,0
1745135582977,ECE 111,A01,892719,Staff,0,0,50,50
1745135584005,ECE 197,001,957920,Mercier; Patrick Philip,9992,0,9999,7
1745135585055,ECON 178,A01,907814,Zhu; Ying,29,0,35,6
1745135586084,EDS 115,A00,895312,Staff,42,0,45,3
1745135587109,EDS 117,A01,895337,Staff,30,0,30,0
1745135588141,EDS 125,A00,895341,Jones; Gabrielle Anastasia,43,0,45,2
1745135589169,EDS 128A,A01,895459,Fargason; Sharon Gayle,45,0,45,0
1745135590195,EDS 128B,A01,895543,Pappas; Elizabeth,45,0,45,0
1745135591226,EDS 139,A00,897203,Pappas; Elizabeth,45,0,45,0
1745135591226,EDS 139,B00,897209,Fargason; Sharon Gayle,45,0,45,0
1745135592255,EDS 201,A00,895545,Staff,44,0,45,1
1745135593281,EDS 203,A01,895581,Halter; Christopher P.,44,0,45,1
1745135594308,EDS 204R,A01,895625,Heinzman; Erica M.,45,0,45,0
1745135594308,EDS 204R,B01,895693,Halter; Christopher P.,28,0,45,17
1745135595333,EDS 206R,A00,895694,Fargason; Sharon Gayle,22,0,30,8
1745135595333,EDS 206R,B00,895695,Choi; Bailey Miyeon,21,0,30,9
1745135596359,EDS 250,A00,895697,Hemans; Patricia Ann Benitez,44,0,45,1
1745135597386,EDS 281,A00,895701,Meyerott; Theresa Ann,15,0,15,0
1745135598415,EDS 284,A00,895736,Meyerott; Theresa Ann,15,0,15,0
1745135599447,EDS 286,A00,897210,Fine; Sarah,15,0,15,0
1745135600478,EDS 289C,A01,895770,Daly; Alan J.,15,0,15,0
1745135601505,EDS 290,A00,897211,Hofstetter; Carolyn,15,0,15,0
1745135602534,LIGM 5A,A00,896162,Fischer-Grunski; Eva K,16,0,20,4
1745135603560,LIGM 5B,A00,896260,Fischer-Grunski; Eva K,19,0,20,1
1745135604588,LIGM 5C,A00,896308,Fischer-Grunski; Eva K,19,0,20,1
1745135605615,LIIT 5AS,A00,896313,Carnelos; Chiara,18,0,20,2
1745135606641,LIIT 5BS,A00,896416,Carnelos; Chiara,20,0,20,0
1745135607672,LIIT 5CS,A00,896564,Carnelos; Chiara,20,0,20,0
1745135608701,LISP 5A,A00,896588,Munoz Sanchez; Alicia,7,0,20,13
1745135609727,LISP 5B,A00,896653,Munoz Sanchez; Alicia,10,0,20,10
1745135610755,LISP 5C,A00,896655,Munoz Sanchez; Alicia,9,0,20,11
1745135611783,MAE 197,001,957918,Kleissl; Jan,9998,0,9999,1
1745135612810,MATH 2,A01,957937,Staff,34,0,35,1
1745135613837,MATH 197,001,957876,Kedlaya; Kiran S.,9996,0,9999,3
1745135614864,MCWP 40,A00,892729,Duru; Nur,16,0,20,4
1745135614864,MCWP 40,B00,893304,Montejo; Carolina,20,0,20,0
1745135615890,MCWP 40R,A00,893757,Redela; Pamela Morgan,0,3,20,20
1745135616924,MCWP 50,A00,893758,Morshed; Michael James,4,0,20,16
1745135616924,MCWP 50,B00,893761,Bartulis; Jason Michael,18,0,20,2
1745135617955,MCWP 50R,A00,893766,Compas; Sean Matthew,0,1,20,20
1745135617955,MCWP 50R,B00,893769,Carter; Jennifer A,5,0,20,15
1745135617955,MCWP 50R,C00,893771,Krone; Jarret,0,3,20,20
1745135617955,MCWP 50R,D00,893772,Miller; Elizabeth Deen,4,0,20,16
1745135617955,MCWP 50R,E00,893775,Carter; Andrea L,0,0,20,20
1745135618984,MMW 11R,A01,892721,Herbst; Matthew,22,0,30,8
1745135618984,MMW 11R,A02,892722,Herbst; Matthew,28,0,30,2
1745135620013,MMW 12R,A01,892724,Herbst; Matthew,0,4,16,16
1745135620013,MMW 12R,A02,892725,Herbst; Matthew,0,4,16,16
1745135621040,MMW 13R,A01,892727,Staff,0,29,16,16
1745135621040,MMW 13R,A02,892728,Staff,0,28,16,16
1745135622068,SIO 295LS,A00,894015,Staff,9,0,25,16
1745135623093,SIO 295S,A00,894020,Staff,9,0,25,16
1745135624118,SIOC 290S,A01,894063,Merrifield; Mark A,23,0,25,2
1745135625149,SIOC 291S,A01,894137,Gabriel; Corey John,23,0,25,2
1745135626178,SOCI 117,A01,895339,Staff,5,0,5,0
1745135627207,WES 237B,A00,894149,Staff,20,0,20,0
1745135629278,AESE 279B,A00,891859,Staff,35,0,35,0
1745135630304,AIP 197,001,891854,Staff,70,0,70,0
1745135631329,ANTH 289S,A00,891856,Gagneux; Pascal,12,0,12,0
1745135632354,BENG 196,001,957946,Engler; Adam J.,9996,0,9999,3
1745135633383,CAT 124RS,A01,956906,Staff,8,0,25,17
1745135634408,CAT 125RS,A01,922013,Staff,8,0,25,17
1745135635437,CLRE 250,A00,891860,Morris; Sheldon,9996,0,9999,3
1745135637495,CLRE 251R,A00,907817,Mehta; Ravindra L.,9995,0,9999,4
1745135638523,CLRE 252,A00,891864,Cuomo; Raphael Eduardo,9994,0,9999,5
1745135639550,CLRE 253,A00,891867,Vaida; Florin,9995,0,9999,4
1745135639550,CLRE 253,B00,907819,Staff,9999,0,9999,0
1745135640578,CLRE 259,A00,891868,Patel; Hemal,9998,0,9999,1
1745135641604,CLRE 260,A00,891872,Cuomo; Raphael Eduardo,9999,0,9999,0
1745135642630,CLRE 297,001,891888,Cuomo; Raphael Eduardo,9999,0,9999,0
1745135643659,CSS 201S,A01,892054,Mignozzetti; Umberto,30,0,30,0
1745135644685,CSS 202S,A01,892056,Mignozzetti; Umberto,30,0,30,0
1745135645714,DSC 197,001,956898,Eldridge; Justin Matthew,9998,0,9999,1
1745135646745,DSC 297,001,958000,Mazumdar; Arya,9999,0,9999,0
1745135647773,EAP 100,A00,905686,Staff,9774,0,9999,225
1745135648799,ECE 45,A01,892618,Staff,0,2,50,50
1745135649828,ECE 109,A01,892620,Staff,0,44,0,0
1745135650858,ECE 111,A01,892719,Staff,0,0,50,50
1745135651889,ECE 197,001,957920,Mercier; Patrick Philip,9992,0,9999,7
1745135652916,ECON 178,A01,907814,Zhu; Ying,29,0,35,6
1745135653943,EDS 115,A00,895312,Staff,42,0,45,3
1745135654968,EDS 117,A01,895337,Staff,30,0,30,0
1745135656001,EDS 125,A00,895341,Jones; Gabrielle Anastasia,43,0,45,2
1745135657030,EDS 128A,A01,895459,Fargason; Sharon Gayle,45,0,45,0
1745135658061,EDS 128B,A01,895543,Pappas; Elizabeth,45,0,45,0
1745135659088,EDS 139,A00,897203,Pappas; Elizabeth,45,0,45,0
1745135659088,EDS 139,B00,897209,Fargason; Sharon Gayle,45,0,45,0
1745135660115,EDS 201,A00,895545,Staff,44,0,45,1
1745135661144,EDS 203,A01,895581,Halter; Christopher P.,44,0,45,1
1745135662169,EDS 204R,A01,895625,Heinzman; Erica M.,45,0,45,0
1745135662169,EDS 204R,B01,895693,Halter; Christopher P.,28,0,45,17
1745135663196,EDS 206R,A00,895694,Fargason; Sharon Gayle,22,0,30,8
1745135663196,EDS 206R,B00,895695,Choi; Bailey Miyeon,21,0,30,9
1745135664223,EDS 250,A00,895697,Hemans; Patricia Ann Benitez,44,0,45,1
1745135665250,EDS 281,A00,895701,Meyerott; Theresa Ann,15,0,15,0
1745135666277,EDS 284,A00,895736,Meyerott; Theresa Ann,15,0,15,0
1745135667303,EDS 286,A00,897210,Fine; Sarah,15,0,15,0
1745135668333,EDS 289C,A01,895770,Daly; Alan J.,15,0,15,0
1745135669360,EDS 290,A00,897211,Hofstetter; Carolyn,15,0,15,0
1745135670386,LIGM 5A,A00,896162,Fischer-Grunski; Eva K,16,0,20,4
1745135671417,LIGM 5B,A00,896260,Fischer-Grunski; Eva K,19,0,20,1
1745135672445,LIGM 5C,A00,896308,Fischer-Grunski; Eva K,19,0,20,1
1745135673474,LIIT 5AS,A00,896313,Carnelos; Chiara,18,0,20,2
1745135674500,LIIT 5BS,A00,896416,Carnelos; Chiara,20,0,20,0
1745135675540,LIIT 5CS,A00,896564,Carnelos; Chiara,20,0,20,0
1745135676577,LISP 5A,A00,896588,Munoz Sanchez; Alicia,7,0,20,13
1745135677609,LISP 5B,A00,896653,Munoz Sanchez; Alicia,10,0,20,10
1745135678636,LISP 5C,A00,896655,Munoz Sanchez; Alicia,9,0,20,11
1745135679666,MAE 197,001,957918,Kleissl; Jan,9998,0,9999,1
1745135680694,MATH 2,A01,957937,Staff,34,0,35,1
1745135681722,MATH 197,001,957876,Kedlaya; Kiran S.,9996,0,9999,3
1745135682749,MCWP 40,A00,892729,Duru; Nur,16,0,20,4
1745135682749,MCWP 40,B00,893304,Montejo; Carolina,20,0,20,0
1745135683783,MCWP 40R,A00,893757,Redela; Pamela Morgan,0,3,20,20
1745135684809,MCWP 50,A00,893758,Morshed; Michael James,4,0,20,16
1745135684809,MCWP 50,B00,893761,Bartulis; Jason Michael,18,0,20,2
1745135685843,MCWP 50R,A00,893766,Compas; Sean Matthew,0,1,20,20
1745135685843,MCWP 50R,B00,893769,Carter; Jennifer A,5,0,20,15
1745135685843,MCWP 50R,C00,893771,Krone; Jarret,0,3,20,20
1745135685843,MCWP 50R,D00,893772,Miller; Elizabeth Deen,4,0,20,16
1745135685843,MCWP 50R,E00,893775,Carter; Andrea L,0,0,20,20
1745135686871,MMW 11R,A01,892721,Herbst; Matthew,22,0,30,8
1745135686871,MMW 11R,A02,892722,Herbst; Matthew,28,0,30,2
1745135687900,MMW 12R,A01,892724,Herbst; Matthew,0,4,16,16
1745135687900,MMW 12R,A02,892725,Herbst; Matthew,0,4,16,16
1745135688923,MMW 13R,A01,892727,Staff,0,29,16,16
1745135688923,MMW 13R,A02,892728,Staff,0,28,16,16
1745135689955,SIO 295LS,A00,894015,Staff,9,0,25,16
1745135690981,SIO 295S,A00,894020,Staff,9,0,25,16
1745135692006,SIOC 290S,A01,894063,Merrifield; Mark A,23,0,25,2
1745135693037,SIOC 291S,A01,894137,Gabriel; Corey John,23,0,25,2
1745135694062,SOCI 117,A01,895339,Staff,5,0,5,0
1745135695088,WES 237B,A00,894149,Staff,20,0,20,0
1745135697150,AESE 279B,A00,891859,Staff,35,0,35,0
1745135698176,AIP 197,001,891854,Staff,70,0,70,0
1745135699204,ANTH 289S,A00,891856,Gagneux; Pascal,12,0,12,0
1745135700232,BENG 196,001,957946,Engler; Adam J.,9996,0,9999,3
1745135701258,CAT 124RS,A01,956906,Staff,8,0,25,17
1745135702287,CAT 125RS,A01,922013,Staff,8,0,25,17
1745135703316,CLRE 250,A00,891860,Morris; Sheldon,9996,0,9999,3
1745135705373,CLRE 251R,A00,907817,Mehta; Ravindra L.,9995,0,9999,4
1745135706400,CLRE 252,A00,891864,Cuomo; Raphael Eduardo,9994,0,9999,5
1745135707424,CLRE 253,A00,891867,Vaida; Florin,9995,0,9999,4
1745135707424,CLRE 253,B00,907819,Staff,9999,0,9999,0
1745135708452,CLRE 259,A00,891868,Patel; Hemal,9998,0,9999,1
1745135709479,CLRE 260,A00,891872,Cuomo; Raphael Eduardo,9999,0,9999,0
1745135710506,CLRE 297,001,891888,Cuomo; Raphael Eduardo,9999,0,9999,0
1745135711531,CSS 201S,A01,892054,Mignozzetti; Umberto,30,0,30,0
1745135712559,CSS 202S,A01,892056,Mignozzetti; Umberto,30,0,30,0
1745135713588,DSC 197,001,956898,Eldridge; Justin Matthew,9998,0,9999,1
1745135714615,DSC 297,001,958000,Mazumdar; Arya,9999,0,9999,0
1745135715646,EAP 100,A00,905686,Staff,9774,0,9999,225
1745135716671,ECE 45,A01,892618,Staff,0,2,50,50
1745135717699,ECE 109,A01,892620,Staff,0,44,0,0
1745135718729,ECE 111,A01,892719,Staff,0,0,50,50
1745135719755,ECE 197,001,957920,Mercier; Patrick Philip,9992,0,9999,7
1745135720783,ECON 178,A01,907814,Zhu; Ying,29,0,35,6
1745135721811,EDS 115,A00,895312,Staff,42,0,45,3
1745135722839,EDS 117,A01,895337,Staff,30,0,30,0
1745135723867,EDS 125,A00,895341,Jones; Gabrielle Anastasia,43,0,45,2
1745135724892,EDS 128A,A01,895459,Fargason; Sharon Gayle,45,0,45,0
1745135725917,EDS 128B,A01,895543,Pappas; Elizabeth,45,0,45,0
1745135726946,EDS 139,A00,897203,Pappas; Elizabeth,45,0,45,0
1745135726946,EDS 139,B00,897209,Fargason; Sharon Gayle,45,0,45,0
1745135727974,EDS 201,A00,895545,Staff,44,0,45,1
1745135729003,EDS 203,A01,895581,Halter; Christopher P.,44,0,45,1
1745135730031,EDS 204R,A01,895625,Heinzman; Erica M.,45,0,45,0
1745135730031,EDS 204R,B01,895693,Halter; Christopher P.,28,0,45,17
1745135731058,EDS 206R,A00,895694,Fargason; Sharon Gayle,22,0,30,8
1745135731058,EDS 206R,B00,895695,Choi; Bailey Miyeon,21,0,30,9
1745135732087,EDS 250,A00,895697,Hemans; Patricia Ann Benitez,44,0,45,1
1745135733113,EDS 281,A00,895701,Meyerott; Theresa Ann,15,0,15,0
1745135734142,EDS 284,A00,895736,Meyerott; Theresa Ann,15,0,15,0
1745135735169,EDS 286,A00,897210,Fine; Sarah,15,0,15,0
1745135736196,EDS 289C,A01,895770,Daly; Alan J.,15,0,15,0
1745135737224,EDS 290,A00,897211,Hofstetter; Carolyn,15,0,15,0
1745135738254,LIGM 5A,A00,896162,Fischer-Grunski; Eva K,16,0,20,4
1745135739285,LIGM 5B,A00,896260,Fischer-Grunski; Eva K,19,0,20,1
1745135740315,LIGM 5C,A00,896308,Fischer-Grunski; Eva K,19,0,20,1
1745135741341,LIIT 5AS,A00,896313,Carnelos; Chiara,18,0,20,2
1745135742379,LIIT 5BS,A00,896416,Carnelos; Chiara,20,0,20,0
1745135743406,LIIT 5CS,A00,896564,Carnelos; Chiara,20,0,20,0
1745135744435,LISP 5A,A00,896588,Munoz Sanchez; Alicia,7,0,20,13
1745135745465,LISP 5B,A00,896653,Munoz Sanchez; Alicia,10,0,20,10
1745135746496,LISP 5C,A00,896655,Munoz Sanchez; Alicia,9,0,20,11
1745135747523,MAE 197,001,957918,Kleissl; Jan,9998,0,9999,1
1745135748551,MATH 2,A01,957937,Staff,34,0,35,1
1745135749578,MATH 197,001,957876,Kedlaya; Kiran S.,9996,0,9999,3
1745135750608,MCWP 40,A00,892729,Duru; Nur,16,0,20,4
1745135750608,MCWP 40,B00,893304,Montejo; Carolina,20,0,20,0
1745135751637,MCWP 40R,A00,893757,Redela; Pamela Morgan,0,3,20,20
1745135752667,MCWP 50,A00,893758,Morshed; Michael James,4,0,20,16
1745135752667,MCWP 50,B00,893761,Bartulis; Jason Michael,18,0,20,2
1745135753698,MCWP 50R,A00,893766,Compas; Sean Matthew,0,1,20,20
1745135753698,MCWP 50R,B00,893769,Carter; Jennifer A,5,0,20,15
1745135753698,MCWP 50R,C00,893771,Krone; Jarret,0,3,20,20
1745135753698,MCWP 50R,D00,893772,Miller; Elizabeth Deen,4,0,20,16
1745135753698,MCWP 50R,E00,893775,Carter; Andrea L,0,0,20,20
1745135754726,MMW 11R,A01,892721,Herbst; Matthew,22,0,30,8
1745135754726,MMW 11R,A02,892722,Herbst; Matthew,28,0,30,2
1745135755753,MMW 12R,A01,892724,Herbst; Matthew,0,4,16,16
1745135755753,MMW 12R,A02,892725,Herbst; Matthew,0,4,16,16
1745135756783,MMW 13R,A01,892727,Staff,0,29,16,16
1745135756783,MMW 13R,A02,892728,Staff,0,28,16,16
1745135757811,SIO 295LS,A00,894015,Staff,9,0,25,16
1745135758839,SIO 295S,A00,894020,Staff,9,0,25,16
1745135759868,SIOC 290S,A01,894063,Merrifield; Mark A,23,0,25,2
1745135760895,SIOC 291S,A01,894137,Gabriel; Corey John,23,0,25,2
1745135761925,SOCI 117,A01,895339,Staff,5,0,5,0
1745135762952,WES 237B,A00,894149,Staff,20,0,20,0
1745135765016,AESE 279B,A00,891859,Staff,35,0,35,0
1745135766042,AIP 197,001,891854,Staff,70,0,70,0
1745135767071,ANTH 289S,A00,891856,Gagneux; Pascal,12,0,12,0
1745135768099,BENG 196,001,957946,Engler; Adam J.,9996,0,9999,3
1745135769127,CAT 124RS,A01,956906,Staff,8,0,25,17
1745135770156,CAT 125RS,A01,922013,Staff,8,0,25,17
1745135771184,CLRE 250,A00,891860,Morris; Sheldon,9996,0,9999,3
1745135773238,CLRE 251R,A00,907817,Mehta; Ravindra L.,9995,0,9999,4
1745135774264,CLRE 252,A00,891864,Cuomo; Raphael Eduardo,9994,0,9999,5
1745135775293,CLRE 253,A00,891867,Vaida; Florin,9995,0,9999,4
1745135775293,CLRE 253,B00,907819,Staff,9999,0,9999,0
1745135776320,CLRE 259,A00,891868,Patel; Hemal,9998,0,9999,1
1745135777347,CLRE 260,A00,891872,Cuomo; Raphael Eduardo,9999,0,9999,0
1745135778375,CLRE 297,001,891888,Cuomo; Raphael Eduardo,9999,0,9999,0
1745135779405,CSS 201S,A01,892054,Mignozzetti; Umberto,30,0,30,0
1745135780434,CSS 202S,A01,892056,Mignozzetti; Umberto,30,0,30,0
1745135781462,DSC 197,001,956898,Eldridge; Justin Matthew,9998,0,9999,1
1745135782488,DSC 297,001,958000,Mazumdar; Arya,9999,0,9999,0
1745135783517,EAP 100,A00,905686,Staff,9774,0,9999,225
1745135784546,ECE 45,A01,892618,Staff,0,2,50,50
1745135785576,ECE 109,A01,892620,Staff,0,44,0,0
1745135786605,ECE 111,A01,892719,Staff,0,0,50,50
1745135787632,ECE 197,001,957920,Mercier; Patrick Philip,9992,0,9999,7
1745135788660,ECON 178,A01,907814,Zhu; Ying,29,0,35,6
1745135789687,EDS 115,A00,895312,Staff,42,0,45,3
1745135790714,EDS 117,A01,895337,Staff,30,0,30,0
1745135791740,EDS 125,A00,895341,Jones; Gabrielle Anastasia,43,0,45,2
1745135792768,EDS 128A,A01,895459,Fargason; Sharon Gayle,45,0,45,0
1745135793793,EDS 128B,A01,895543,Pappas; Elizabeth,45,0,45,0
1745135794819,EDS 139,A00,897203,Pappas; Elizabeth,45,0,45,0
1745135794819,EDS 139,B00,897209,Fargason; Sharon Gayle,45,0,45,0
1745135795845,EDS 201,A00,895545,Staff,44,0,45,1
1745135796873,EDS 203,A01,895581,Halter; Christopher P.,44,0,45,1
1745135797902,EDS 204R,A01,895625,Heinzman; Erica M.,45,0,45,0
1745135797902,EDS 204R,B01,895693,Halter; Christopher P.,28,0,45,17
1745135798930,EDS 206R,A00,895694,Fargason; Sharon Gayle,22,0,30,8
1745135798930,EDS 206R,B00,895695,Choi; Bailey Miyeon,21,0,30,9
1745135799956,EDS 250,A00,895697,Hemans; Patricia Ann Benitez,44,0,45,1
1745135800984,EDS 281,A00,895701,Meyerott; Theresa Ann,15,0,15,0
1745135802009,EDS 284,A00,895736,Meyerott; Theresa Ann,15,0,15,0
1745135803038,EDS 286,A00,897210,Fine; Sarah,15,0,15,0
1745135804067,EDS 289C,A01,895770,Daly; Alan J.,15,0,15,0
1745135805092,EDS 290,A00,897211,Hofstetter; Carolyn,15,0,15,0
1745135806123,LIGM 5A,A00,896162,Fischer-Grunski; Eva K,16,0,20,4
1745135807148,LIGM 5B,A00,896260,Fischer-Grunski; Eva K,19,0,20,1
1745135808179,LIGM 5C,A00,896308,Fischer-Grunski; Eva K,19,0,20,1
1745135809205,LIIT 5AS,A00,896313,Carnelos; Chiara,18,0,20,2
1745135810234,LIIT 5BS,A00,896416,Carnelos; Chiara,20,0,20,0
1745135811264,LIIT 5CS,A00,896564,Carnelos; Chiara,20,0,20,0
1745135812293,LISP 5A,A00,896588,Munoz Sanchez; Alicia,7,0,20,13
1745135813319,LISP 5B,A00,896653,Munoz Sanchez; Alicia,10,0,20,10
1745135814350,LISP 5C,A00,896655,Munoz Sanchez; Alicia,9,0,20,11
1745135815378,MAE 197,001,957918,Kleissl; Jan,9998,0,9999,1
1745135816407,MATH 2,A01,957937,Staff,34,0,35,1
1745135817433,MATH 197,001,957876,Kedlaya; Kiran S.,9996,0,9999,3
1745135818462,MCWP 40,A00,892729,Duru; Nur,16,0,20,4
1745135818462,MCWP 40,B00,893304,Montejo; Carolina,20,0,20,0
1745135819490,MCWP 40R,A00,893757,Redela; Pamela Morgan,0,3,20,20
1745135820517,MCWP 50,A00,893758,Morshed; Michael James,4,0,20,16
1745135820517,MCWP 50,B00,893761,Bartulis; Jason Michael,18,0,20,2
1745135821550,MCWP 50R,A00,893766,Compas; Sean Matthew,0,1,20,20
1745135821550,MCWP 50R,B00,893769,Carter; Jennifer A,5,0,20,15
1745135821550,MCWP 50R,C00,893771,Krone; Jarret,0,3,20,20
1745135821550,MCWP 50R,D00,893772,Miller; Elizabeth Deen,4,0,20,16
1745135821550,MCWP 50R,E00,893775,Carter; Andrea L,0,0,20,20
1745135822580,MMW 11R,A01,892721,Herbst; Matthew,22,0,30,8
1745135822580,MMW 11R,A02,892722,Herbst; Matthew,28,0,30,2
1745135823605,MMW 12R,A01,892724,Herbst; Matthew,0,4,16,16
1745135823605,MMW 12R,A02,892725,Herbst; Matthew,0,4,16,16
1745135824632,MMW 13R,A01,892727,Staff,0,29,16,16
1745135824632,MMW 13R,A02,892728,Staff,0,28,16,16
1745135825661,SIO 295LS,A00,894015,Staff,9,0,25,16
1745135826688,SIO 295S,A00,894020,Staff,9,0,25,16
1745135827714,SIOC 290S,A01,894063,Merrifield; Mark A,23,0,25,2
1745135828745,SIOC 291S,A01,894137,Gabriel; Corey John,23,0,25,2
1745135829773,SOCI 117,A01,895339,Staff,5,0,5,0
1745135830799,WES 237B,A00,894149,Staff,20,0,20,0
1745135832896,AESE 279B,A00,891859,Staff,35,0,35,0
1745135833924,AIP 197,001,891854,Staff,70,0,70,0
1745135834950,ANTH 289S,A00,891856,Gagneux; Pascal,12,0,12,0
1745135835977,BENG 196,001,957946,Engler; Adam J.,9996,0,9999,3
1745135837006,CAT 124RS,A01,956906,Staff,8,0,25,17
1745135838031,CAT 125RS,A01,922013,Staff,8,0,25,17
1745135839059,CLRE 250,A00,891860,Morris; Sheldon,9996,0,9999,3
1745135841112,CLRE 251R,A00,907817,Mehta; Ravindra L.,9995,0,9999,4
1745135842141,CLRE 252,A00,891864,Cuomo; Raphael Eduardo,9994,0,9999,5
1745135843172,CLRE 253,A00,891867,Vaida; Florin,9995,0,9999,4
1745135843172,CLRE 253,B00,907819,Staff,9999,0,9999,0
1745135844197,CLRE 259,A00,891868,Patel; Hemal,9998,0,9999,1
1745135845223,CLRE 260,A00,891872,Cuomo; Raphael Eduardo,9999,0,9999,0
1745135846249,CLRE 297,001,891888,Cuomo; Raphael Eduardo,9999,0,9999,0
1745135847280,CSS 201S,A01,892054,Mignozzetti; Umberto,30,0,30,0
1745135848310,CSS 202S,A01,892056,Mignozzetti; Umberto,30,0,30,0
1745135849339,DSC 197,001,956898,Eldridge; Justin Matthew,9998,0,9999,1
1745135850364,DSC 297,001,958000,Mazumdar; Arya,9999,0,9999,0
1745135851390,EAP 100,A00,905686,Staff,9774,0,9999,225
1745135852415,ECE 45,A01,892618,Staff,0,2,50,50
1745135853444,ECE 109,A01,892620,Staff,0,44,0,0
1745135854472,ECE 111,A01,892719,Staff,0,0,50,50
1745135855503,ECE 197,001,957920,Mercier; Patrick Philip,9992,0,9999,7
1745135856534,ECON 178,A01,907814,Zhu; Ying,29,0,35,6
1745135857563,EDS 115,A00,895312,Staff,42,0,45,3
1745135858588,EDS 117,A01,895337,Staff,30,0,30,0
1745135859614,EDS 125,A00,895341,Jones; Gabrielle Anastasia,43,0,45,2
1745135860644,EDS 128A,A01,895459,Fargason; Sharon Gayle,45,0,45,0
1745135861669,EDS 128B,A01,895543,Pappas; Elizabeth,45,0,45,0
1745135862695,EDS 139,A00,897203,Pappas; Elizabeth,45,0,45,0
1745135862695,EDS 139,B00,897209,Fargason; Sharon Gayle,45,0,45,0
1745135863720,EDS 201,A00,895545,Staff,44,0,45,1
1745135864746,EDS 203,A01,895581,Halter; Christopher P.,44,0,45,1
1745135865773,EDS 204R,A01,895625,Heinzman; Erica M.,45,0,45,0
1745135865773,EDS 204R,B01,895693,Halter; Christopher P.,28,0,45,17
1745135866803,EDS 206R,A00,895694,Fargason; Sharon Gayle,22,0,30,8
1745135866803,EDS 206R,B00,895695,Choi; Bailey Miyeon,21,0,30,9
1745135867831,EDS 250,A00,895697,Hemans; Patricia Ann Benitez,44,0,45,1
1745135868860,EDS 281,A00,895701,Meyerott; Theresa Ann,15,0,15,0
1745135869890,EDS 284,A00,895736,Meyerott; Theresa Ann,15,0,15,0
1745135870915,EDS 286,A00,897210,Fine; Sarah,15,0,15,0
1745135871940,EDS 289C,A01,895770,Daly; Alan J.,15,0,15,0
1745135872966,EDS 290,A00,897211,Hofstetter; Carolyn,15,0,15,0
1745135873990,LIGM 5A,A00,896162,Fischer-Grunski; Eva K,16,0,20,4
1745135875026,LIGM 5B,A00,896260,Fischer-Grunski; Eva K,19,0,20,1
1745135876058,LIGM 5C,A00,896308,Fischer-Grunski; Eva K,19,0,20,1
1745135877084,LIIT 5AS,A00,896313,Carnelos; Chiara,18,0,20,2
1745135878114,LIIT 5BS,A00,896416,Carnelos; Chiara,20,0,20,0
1745135879140,LIIT 5CS,A00,896564,Carnelos; Chiara,20,0,20,0
1745135880170,LISP 5A,A00,896588,Munoz Sanchez; Alicia,7,0,20,13
1745135881196,LISP 5B,A00,896653,Munoz Sanchez; Alicia,10,0,20,10
1745135882220,LISP 5C,A00,896655,Munoz Sanchez; Alicia,9,0,20,11
1745135883245,MAE 197,001,957918,Kleissl; Jan,9998,0,9999,1
1745135884271,MATH 2,A01,957937,Staff,34,0,35,1
1745135885301,MATH 197,001,957876,Kedlaya; Kiran S.,9996,0,9999,3
1745135886329,MCWP 40,A00,892729,Duru; Nur,16,0,20,4
1745135886329,MCWP 40,B00,893304,Montejo; Carolina,20,0,20,0
1745135887356,MCWP 40R,A00,893757,Redela; Pamela Morgan,0,3,20,20
1745135888389,MCWP 50,A00,893758,Morshed; Michael James,4,0,20,16
1745135888389,MCWP 50,B00,893761,Bartulis; Jason Michael,18,0,20,2
1745135889418,MCWP 50R,A00,893766,Compas; Sean Matthew,0,1,20,20
1745135889418,MCWP 50R,B00,893769,Carter; Jennifer A,5,0,20,15
1745135889418,MCWP 50R,C00,893771,Krone; Jarret,0,3,20,20
1745135889418,MCWP 50R,D00,893772,Miller; Elizabeth Deen,4,0,20,16
1745135889418,MCWP 50R,E00,893775,Carter; Andrea L,0,0,20,20
1745135890444,MMW 11R,A01,892721,Herbst; Matthew,22,0,30,8
1745135890444,MMW 11R,A02,892722,Herbst; Matthew,28,0,30,2
1745135891471,MMW 12R,A01,892724,Herbst; Matthew,0,4,16,16
1745135891471,MMW 12R,A02,892725,Herbst; Matthew,0,4,16,16
1745135892495,MMW 13R,A01,892727,Staff,0,29,16,16
1745135892495,MMW 13R,A02,892728,Staff,0,28,16,16
1745135893521,SIO 295LS,A00,894015,Staff,9,0,25,16
1745135894550,SIO 295S,A00,894020,Staff,9,0,25,16
1745135895576,SIOC 290S,A01,894063,Merrifield; Mark A,23,0,25,2
1745135896605,SIOC 291S,A01,894137,Gabriel; Corey John,23,0,25,2
1745135897635,SOCI 117,A01,895339,Staff,5,0,5,0
1745135898659,WES 237B,A00,894149,Staff,20,0,20,0
1745135900737,AESE 279B,A00,891859,Staff,35,0,35,0
1745135901762,AIP 197,001,891854,Staff,70,0,70,0
1745135902791,ANTH 289S,A00,891856,Gagneux; Pascal,12,0,12,0
1745135903817,BENG 196,001,957946,Engler; Adam J.,9996,0,9999,3
1745135904847,CAT 124RS,A01,956906,Staff,8,0,25,17
1745135905930,CAT 125RS,A01,922013,Staff,8,0,25,17
1745135906961,CLRE 250,A00,891860,Morris; Sheldon,9996,0,9999,3
1745135909011,CLRE 251R,A00,907817,Mehta; Ravindra L.,9995,0,9999,4
1745135910037,CLRE 252,A00,891864,Cuomo; Raphael Eduardo,9994,0,9999,5
1745135911064,CLRE 253,A00,891867,Vaida; Florin,9995,0,9999,4
1745135911064,CLRE 253,B00,907819,Staff,9999,0,9999,0
1745135912090,CLRE 259,A00,891868,Patel; Hemal,9998,0,9999,1
1745135913115,CLRE 260,A00,891872,Cuomo; Raphael Eduardo,9999,0,9999,0
1745135914145,CLRE 297,001,891888,Cuomo; Raphael Eduardo,9999,0,9999,0
1745135915177,CSS 201S,A01,892054,Mignozzetti; Umberto,30,0,30,0
1745135916203,CSS 202S,A01,892056,Mignozzetti; Umberto,30,0,30,0
1745135917229,DSC 197,001,956898,Eldridge; Justin Matthew,9998,0,9999,1
1745135918259,DSC 297,001,958000,Mazumdar; Arya,9999,0,9999,0
1745135919284,EAP 100,A00,905686,Staff,9774,0,9999,225
1745135920310,ECE 45,A01,892618,Staff,0,2,50,50
1745135921339,ECE 109,A01,892620,Staff,0,44,0,0
1745135922367,ECE 111,A01,892719,Staff,0,0,50,50
1745135923392,ECE 197,001,957920,Mercier; Patrick Philip,9992,0,9999,7
1745135924425,ECON 178,A01,907814,Zhu; Ying,29,0,35,6
1745135925451,EDS 115,A00,895312,Staff,42,0,45,3
1745135926479,EDS 117,A01,895337,Staff,30,0,30,0
1745135927505,EDS 125,A00,895341,Jones; Gabrielle Anastasia,43,0,45,2
1745135928535,EDS 128A,A01,895459,Fargason; Sharon Gayle,45,0,45,0
1745135929563,EDS 128B,A01,895543,Pappas; Elizabeth,45,0,45,0
1745135930589,EDS 139,A00,897203,Pappas; Elizabeth,45,0,45,0
1745135930589,EDS 139,B00,897209,Fargason; Sharon Gayle,45,0,45,0
1745135931618,EDS 201,A00,895545,Staff,44,0,45,1
1745135932649,EDS 203,A01,895581,Halter; Christopher P.,44,0,45,1
1745135933684,EDS 204R,A01,895625,Heinzman; Erica M.,45,0,45,0
1745135933684,EDS 204R,B01,895693,Halter; Christopher P.,28,0,45,17
1745135934710,EDS 206R,A00,895694,Fargason; Sharon Gayle,22,0,30,8
1745135934710,EDS 206R,B00,895695,Choi; Bailey Miyeon,21,0,30,9
1745135935736,EDS 250,A00,895697,Hemans; Patricia Ann Benitez,44,0,45,1
1745135936763,EDS 281,A00,895701,Meyerott; Theresa Ann,15,0,15,0
1745135937790,EDS 284,A00,895736,Meyerott; Theresa Ann,15,0,15,0
1745135938818,EDS 286,A00,897210,Fine; Sarah,15,0,15,0
1745135939845,EDS 289C,A01,895770,Daly; Alan J.,15,0,15,0
1745135940873,EDS 290,A00,897211,Hofstetter; Carolyn,15,0,15,0
1745135941903,LIGM 5A,A00,896162,Fischer-Grunski; Eva K,16,0,20,4
1745135942933,LIGM 5B,A00,896260,Fischer-Grunski; Eva K,19,0,20,1
1745135943961,LIGM 5C,A00,896308,Fischer-Grunski; Eva K,19,0,20,1
1745135944989,LIIT 5AS,A00,896313,Carnelos; Chiara,18,0,20,2
1745135946021,LIIT 5BS,A00,896416,Carnelos; Chiara,20,0,20,0
1745135947051,LIIT 5CS,A00,896564,Carnelos; Chiara,20,0,20,0
1745135948079,LISP 5A,A00,896588,Munoz Sanchez; Alicia,7,0,20,13
1745135949104,LISP 5B,A00,896653,Munoz Sanchez; Alicia,10,0,20,10
1745135950132,LISP 5C,A00,896655,Munoz Sanchez; Alicia,9,0,20,11
1745135951160,MAE 197,001,957918,Kleissl; Jan,9998,0,9999,1
1745135952185,MATH 2,A01,957937,Staff,34,0,35,1
1745135953211,MATH 197,001,957876,Kedlaya; Kiran S.,9996,0,9999,3
1745135954243,MCWP 40,A00,892729,Duru; Nur,16,0,20,4
1745135954243,MCWP 40,B00,893304,Montejo; Carolina,20,0,20,0
1745135955269,MCWP 40R,A00,893757,Redela; Pamela Morgan,0,3,20,20
1745135956295,MCWP 50,A00,893758,Morshed; Michael James,4,0,20,16
1745135956295,MCWP 50,B00,893761,Bartulis; Jason Michael,18,0,20,2
1745135957324,MCWP 50R,A00,893766,Compas; Sean Matthew,0,1,20,20
1745135957324,MCWP 50R,B00,893769,Carter; Jennifer A,5,0,20,15
1745135957324,MCWP 50R,C00,893771,Krone; Jarret,0,3,20,20
1745135957324,MCWP 50R,D00,893772,Miller; Elizabeth Deen,4,0,20,16
1745135957324,MCWP 50R,E00,893775,Carter; Andrea L,0,0,20,20
1745135958350,MMW 11R,A01,892721,Herbst; Matthew,22,0,30,8
1745135958350,MMW 11R,A02,892722,Herbst; Matthew,28,0,30,2
1745135959380,MMW 12R,A01,892724,Herbst; Matthew,0,4,16,16
1745135959380,MMW 12R,A02,892725,Herbst; Matthew,0,4,16,16
1745135960406,MMW 13R,A01,892727,Staff,0,29,16,16
1745135960406,MMW 13R,A02,892728,Staff,0,28,16,16
1745135961435,SIO 295LS,A00,894015,Staff,9,0,25,16
1745135962464,SIO 295S,A00,894020,Staff,9,0,25,16
1745135963491,SIOC 290S,A01,894063,Merrifield; Mark A,23,0,25,2
1745135964523,SIOC 291S,A01,894137,Gabriel; Corey John,23,0,25,2
1745135965550,SOCI 117,A01,895339,Staff,5,0,5,0
1745135966577,WES 237B,A00,894149,Staff,20,0,20,0
1745135968659,AESE 279B,A00,891859,Staff,35,0,35,0
1745135969689,AIP 197,001,891854,Staff,70,0,70,0
1745135970716,ANTH 289S,A00,891856,Gagneux; Pascal,12,0,12,0
1745135971746,BENG 196,001,957946,Engler; Adam J.,9996,0,9999,3
1745135972776,CAT 124RS,A01,956906,Staff,8,0,25,17
1745135973803,CAT 125RS,A01,922013,Staff,8,0,25,17
1745135974832,CLRE 250,A00,891860,Morris; Sheldon,9996,0,9999,3
1745135976890,CLRE 251R,A00,907817,Mehta; Ravindra L.,9995,0,9999,4
1745135977915,CLRE 252,A00,891864,Cuomo; Raphael Eduardo,9994,0,9999,5
1745135978946,CLRE 253,A00,891867,Vaida; Florin,9995,0,9999,4
1745135978946,CLRE 253,B00,907819,Staff,9999,0,9999,0
1745135979975,CLRE 259,A00,891868,Patel; Hemal,9998,0,9999,1
1745135981001,CLRE 260,A00,891872,Cuomo; Raphael Eduardo,9999,0,9999,0
1745135982029,CLRE 297,001,891888,Cuomo; Raphael Eduardo,9999,0,9999,0
1745135983062,CSS 201S,A01,892054,Mignozzetti; Umberto,30,0,30,0
1745135984092,CSS 202S,A01,892056,Mignozzetti; Umberto,30,0,30,0
1745135985117,DSC 197,001,956898,Eldridge; Justin Matthew,9998,0,9999,1
1745135986147,DSC 297,001,958000,Mazumdar; Arya,9999,0,9999,0
1745135987178,EAP 100,A00,905686,Staff,9774,0,9999,225
1745135988204,ECE 45,A01,892618,Staff,0,2,50,50
1745135989232,ECE 109,A01,892620,Staff,0,44,0,0
1745135990258,ECE 111,A01,892719,Staff,0,0,50,50
1745135991285,ECE 197,001,957920,Mercier; Patrick Philip,9992,0,9999,7
1745135992317,ECON 178,A01,907814,Zhu; Ying,29,0,35,6
1745135993343,EDS 115,A00,895312,Staff,42,0,45,3
1745135994368,EDS 117,A01,895337,Staff,30,0,30,0
1745135995398,EDS 125,A00,895341,Jones; Gabrielle Anastasia,43,0,45,2
1745135996428,EDS 128A,A01,895459,Fargason; Sharon Gayle,45,0,45,0
1745135997455,EDS 128B,A01,895543,Pappas; Elizabeth,45,0,45,0
1745135998483,EDS 139,A00,897203,Pappas; Elizabeth,45,0,45,0
1745135998483,EDS 139,B00,897209,Fargason; Sharon Gayle,45,0,45,0
1745135999511,EDS 201,A00,895545,Staff,44,0,45,1
1745136000538,EDS 203,A01,895581,Halter; Christopher P.,44,0,45,1
1745136001566,EDS 204R,A01,895625,Heinzman; Erica M.,45,0,45,0
1745136001566,EDS 204R,B01,895693,Halter; Christopher P.,28,0,45,17
1745136002590,EDS 206R,A00,895694,Fargason; Sharon Gayle,22,0,30,8
1745136002590,EDS 206R,B00,895695,Choi; Bailey Miyeon,21,0,30,9
1745136003617,EDS 250,A00,895697,Hemans; Patricia Ann Benitez,44,0,45,1
1745136004649,EDS 281,A00,895701,Meyerott; Theresa Ann,15,0,15,0
1745136005674,EDS 284,A00,895736,Meyerott; Theresa Ann,15,0,15,0
1745136006699,EDS 286,A00,897210,Fine; Sarah,15,0,15,0
1745136007726,EDS 289C,A01,895770,Daly; Alan J.,15,0,15,0
1745136008858,EDS 290,A00,897211,Hofstetter; Carolyn,15,0,15,0
1745136009926,LIGM 5A,A00,896162,Fischer-Grunski; Eva K,16,0,20,4
1745136010953,LIGM 5B,A00,896260,Fischer-Grunski; Eva K,19,0,20,1
1745136011982,LIGM 5C,A00,896308,Fischer-Grunski; Eva K,19,0,20,1
1745136013013,LIIT 5AS,A00,896313,Carnelos; Chiara,18,0,20,2
1745136014038,LIIT 5BS,A00,896416,Carnelos; Chiara,20,0,20,0
1745136015063,LIIT 5CS,A00,896564,Carnelos; Chiara,20,0,20,0
1745136016091,LISP 5A,A00,896588,Munoz Sanchez; Alicia,7,0,20,13
1745136017118,LISP 5B,A00,896653,Munoz Sanchez; Alicia,10,0,20,10
1745136018148,LISP 5C,A00,896655,Munoz Sanchez; Alicia,9,0,20,11
1745136019175,MAE 197,001,957918,Kleissl; Jan,9998,0,9999,1
1745136020203,MATH 2,A01,957937,Staff,34,0,35,1
1745136021229,MATH 197,001,957876,Kedlaya; Kiran S.,9996,0,9999,3
1745136022261,MCWP 40,A00,892729,Duru; Nur,16,0,20,4
1745136022261,MCWP 40,B00,893304,Montejo; Carolina,20,0,20,0
1745136023287,MCWP 40R,A00,893757,Redela; Pamela Morgan,0,3,20,20
1745136024315,MCWP 50,A00,893758,Morshed; Michael James,4,0,20,16
1745136024315,MCWP 50,B00,893761,Bartulis; Jason Michael,18,0,20,2
1745136025343,MCWP 50R,A00,893766,Compas; Sean Matthew,0,1,20,20
1745136025343,MCWP 50R,B00,893769,Carter; Jennifer A,5,0,20,15
1745136025343,MCWP 50R,C00,893771,Krone; Jarret,0,3,20,20
1745136025343,MCWP 50R,D00,893772,Miller; Elizabeth Deen,4,0,20,16
1745136025343,MCWP 50R,E00,893775,Carter; Andrea L,0,0,20,20
1745136026371,MMW 11R,A01,892721,Herbst; Matthew,22,0,30,8
1745136026371,MMW 11R,A02,892722,Herbst; Matthew,28,0,30,2
1745136027400,MMW 12R,A01,892724,Herbst; Matthew,0,4,16,16
1745136027400,MMW 12R,A02,892725,Herbst; Matthew,0,4,16,16
1745136028428,MMW 13R,A01,892727,Staff,0,29,16,16
1745136028428,MMW 13R,A02,892728,Staff,0,28,16,16
1745136029454,SIO 295LS,A00,894015,Staff,9,0,25,16
1745136030480,SIO 295S,A00,894020,Staff,9,0,25,16
1745136031511,SIOC 290S,A01,894063,Merrifield; Mark A,23,0,25,2
1745136032544,SIOC 291S,A01,894137,Gabriel; Corey John,23,0,25,2
1745136033568,SOCI 117,A01,895339,Staff,5,0,5,0
1745136034596,WES 237B,A00,894149,Staff,20,0,20,0
1745136036675,AESE 279B,A00,891859,Staff,35,0,35,0
1745136037700,AIP 197,001,891854,Staff,70,0,70,0
1745136038730,ANTH 289S,A00,891856,Gagneux; Pascal,12,0,12,0
1745136039757,BENG 196,001,957946,Engler; Adam J.,9996,0,9999,3
1745136040782,CAT 124RS,A01,956906,Staff,8,0,25,17
1745136041809,CAT 125RS,A01,922013,Staff,8,0,25,17
1745136042836,CLRE 250,A00,891860,Morris; Sheldon,9996,0,9999,3
1745136044890,CLRE 251R,A00,907817,Mehta; Ravindra L.,9995,0,9999,4
1745136045920,CLRE 252,A00,891864,Cuomo; Raphael Eduardo,9994,0,9999,5
1745136046945,CLRE 253,A00,891867,Vaida; Florin,9995,0,9999,4
1745136046945,CLRE 253,B00,907819,Staff,9999,0,9999,0
1745136047969,CLRE 259,A00,891868,Patel; Hemal,9998,0,9999,1
1745136048999,CLRE 260,A00,891872,Cuomo; Raphael Eduardo,9999,0,9999,0
1745136050027,CLRE 297,001,891888,Cuomo; Raphael Eduardo,9999,0,9999,0
1745136051056,CSS 201S,A01,892054,Mignozzetti; Umberto,30,0,30,0
1745136052086,CSS 202S,A01,892056,Mignozzetti; Umberto,30,0,30,0
1745136053116,DSC 197,001,956898,Eldridge; Justin Matthew,9998,0,9999,1
1745136054141,DSC 297,001,958000,Mazumdar; Arya,9999,0,9999,0
1745136055166,EAP 100,A00,905686,Staff,9774,0,9999,225
1745136056197,ECE 45,A01,892618,Staff,0,2,50,50
1745136057226,ECE 109,A01,892620,Staff,0,44,0,0
1745136058252,ECE 111,A01,892719,Staff,0,0,50,50
1745136059278,ECE 197,001,957920,Mercier; Patrick Philip,9992,0,9999,7
1745136060307,ECON 178,A01,907814,Zhu; Ying,29,0,35,6
1745136061331,EDS 115,A00,895312,Staff,42,0,45,3
1745136062357,EDS 117,A01,895337,Staff,30,0,30,0
1745136063385,EDS 125,A00,895341,Jones; Gabrielle Anastasia,43,0,45,2
1745136064411,EDS 128A,A01,895459,Fargason; Sharon Gayle,45,0,45,0
1745136065437,EDS 128B,A01,895543,Pappas; Elizabeth,45,0,45,0
1745136066461,EDS 139,A00,897203,Pappas; Elizabeth,45,0,45,0
1745136066461,EDS 139,B00,897209,Fargason; Sharon Gayle,45,0,45,0
1745136067489,EDS 201,A00,895545,Staff,44,0,45,1
1745136068514,EDS 203,A01,895581,Halter; Christopher P.,44,0,45,1
1745136069542,EDS 204R,A01,895625,Heinzman; Erica M.,45,0,45,0
1745136069542,EDS 204R,B01,895693,Halter; Christopher P.,28,0,45,17
1745136070569,EDS 206R,A00,895694,Fargason; Sharon Gayle,22,0,30,8
1745136070569,EDS 206R,B00,895695,Choi; Bailey Miyeon,21,0,30,9
1745136071636,EDS 250,A00,895697,Hemans; Patricia Ann Benitez,44,0,45,1
1745136072664,EDS 281,A00,895701,Meyerott; Theresa Ann,15,0,15,0
1745136073691,EDS 284,A00,895736,Meyerott; Theresa Ann,15,0,15,0
1745136074717,EDS 286,A00,897210,Fine; Sarah,15,0,15,0
1745136075743,EDS 289C,A01,895770,Daly; Alan J.,15,0,15,0
1745136076770,EDS 290,A00,897211,Hofstetter; Carolyn,15,0,15,0
1745136077797,LIGM 5A,A00,896162,Fischer-Grunski; Eva K,16,0,20,4
1745136078822,LIGM 5B,A00,896260,Fischer-Grunski; Eva K,19,0,20,1
1745136079848,LIGM 5C,A00,896308,Fischer-Grunski; Eva K,19,0,20,1
1745136080877,LIIT 5AS,A00,896313,Carnelos; Chiara,18,0,20,2
1745136081903,LIIT 5BS,A00,896416,Carnelos; Chiara,20,0,20,0
1745136082932,LIIT 5CS,A00,896564,Carnelos; Chiara,20,0,20,0
1745136083959,LISP 5A,A00,896588,Munoz Sanchez; Alicia,7,0,20,13
1745136084985,LISP 5B,A00,896653,Munoz Sanchez; Alicia,10,0,20,10
1745136086011,LISP 5C,A00,896655,Munoz Sanchez; Alicia,9,0,20,11
1745136087037,MAE 197,001,957918,Kleissl; Jan,9998,0,9999,1
1745136088064,MATH 2,A01,957937,Staff,34,0,35,1
1745136089095,MATH 197,001,957876,Kedlaya; Kiran S.,9996,0,9999,3
1745136090123,MCWP 40,A00,892729,Duru; Nur,16,0,20,4
1745136090123,MCWP 40,B00,893304,Montejo; Carolina,20,0,20,0
1745136091148,MCWP 40R,A00,893757,Redela; Pamela Morgan,0,3,20,20
1745136092173,MCWP 50,A00,893758,Morshed; Michael James,4,0,20,16
1745136092173,MCWP 50,B00,893761,Bartulis; Jason Michael,18,0,20,2
1745136093198,MCWP 50R,A00,893766,Compas; Sean Matthew,0,1,20,20
1745136093198,MCWP 50R,B00,893769,Carter; Jennifer A,5,0,20,15
1745136093198,MCWP 50R,C00,893771,Krone; Jarret,0,3,20,20
1745136093198,MCWP 50R,D00,893772,Miller; Elizabeth Deen,4,0,20,16
1745136093198,MCWP 50R,E00,893775,Carter; Andrea L,0,0,20,20
1745136094225,MMW 11R,A01,892721,Herbst; Matthew,22,0,30,8
1745136094225,MMW 11R,A02,892722,Herbst; Matthew,28,0,30,2
1745136095253,MMW 12R,A01,892724,Herbst; Matthew,0,4,16,16
1745136095253,MMW 12R,A02,892725,Herbst; Matthew,0,4,16,16
1745136096279,MMW 13R,A01,892727,Staff,0,29,16,16
1745136096279,MMW 13R,A02,892728,Staff,0,28,16,16
1745136097304,SIO 295LS,A00,894015,Staff,9,0,25,16
1745136098333,SIO 295S,A00,894020,Staff,9,0,25,16
1745136099358,SIOC 290S,A01,894063,Merrifield; Mark A,23,0,25,2
1745136100387,SIOC 291S,A01,894137,Gabriel; Corey John,23,0,25,2
1745136101416,SOCI 117,A01,895339,Staff,5,0,5,0
1745136102442,WES 237B,A00,894149,Staff,20,0,20,0
1745136104521,AESE 279B,A00,891859,Staff,35,0,35,0
1745136105552,AIP 197,001,891854,Staff,70,0,70,0
1745136106577,ANTH 289S,A00,891856,Gagneux; Pascal,12,0,12,0
1745136107604,BENG 196,001,957946,Engler; Adam J.,9996,0,9999,3
1745136108629,CAT 124RS,A01,956906,Staff,8,0,25,17
1745136109657,CAT 125RS,A01,922013,Staff,8,0,25,17
1745136110685,CLRE 250,A00,891860,Morris; Sheldon,9996,0,9999,3
1745136112738,CLRE 251R,A00,907817,Mehta; Ravindra L.,9995,0,9999,4
1745136113822,CLRE 252,A00,891864,Cuomo; Raphael Eduardo,9994,0,9999,5
1745136114851,CLRE 253,A00,891867,Vaida; Florin,9995,0,9999,4
1745136114851,CLRE 253,B00,907819,Staff,9999,0,9999,0
1745136115883,CLRE 259,A00,891868,Patel; Hemal,9998,0,9999,1
1745136116906,CLRE 260,A00,891872,Cuomo; Raphael Eduardo,9999,0,9999,0
1745136117934,CLRE 297,001,891888,Cuomo; Raphael Eduardo,9999,0,9999,0
1745136118966,CSS 201S,A01,892054,Mignozzetti; Umberto,30,0,30,0
1745136119995,CSS 202S,A01,892056,Mignozzetti; Umberto,30,0,30,0
1745136121020,DSC 197,001,956898,Eldridge; Justin Matthew,9998,0,9999,1
1745136122045,DSC 297,001,958000,Mazumdar; Arya,9999,0,9999,0
1745136123072,EAP 100,A00,905686,Staff,9774,0,9999,225
1745136124102,ECE 45,A01,892618,Staff,0,2,50,50
1745136125126,ECE 109,A01,892620,Staff,0,44,0,0
1745136126154,ECE 111,A01,892719,Staff,0,0,50,50
1745136127182,ECE 197,001,957920,Mercier; Patrick Philip,9992,0,9999,7
1745136128208,ECON 178,A01,907814,Zhu; Ying,29,0,35,6
1745136129233,EDS 115,A00,895312,Staff,42,0,45,3
1745136130257,EDS 117,A01,895337,Staff,30,0,30,0
1745136131285,EDS 125,A00,895341,Jones; Gabrielle Anastasia,43,0,45,2
1745136132313,EDS 128A,A01,895459,Fargason; Sharon Gayle,45,0,45,0
1745136133339,EDS 128B,A01,895543,Pappas; Elizabeth,45,0,45,0
1745136134368,EDS 139,A00,897203,Pappas; Elizabeth,45,0,45,0
1745136134368,EDS 139,B00,897209,Fargason; Sharon Gayle,45,0,45,0
1745136135393,EDS 201,A00,895545,Staff,44,0,45,1
1745136136419,EDS 203,A01,895581,Halter; Christopher P.,44,0,45,1
1745136137448,EDS 204R,A01,895625,Heinzman; Erica M.,45,0,45,0
1745136137448,EDS 204R,B01,895693,Halter; Christopher P.,28,0,45,17
1745136138474,EDS 206R,A00,895694,Fargason; Sharon Gayle,22,0,30,8
1745136138474,EDS 206R,B00,895695,Choi; Bailey Miyeon,21,0,30,9
1745136139504,EDS 250,A00,895697,Hemans; Patricia Ann Benitez,44,0,45,1
1745136140529,EDS 281,A00,895701,Meyerott; Theresa Ann,15,0,15,0
1745136141558,EDS 284,A00,895736,Meyerott; Theresa Ann,15,0,15,0
1745136142584,EDS 286,A00,897210,Fine; Sarah,15,0,15,0
1745136143611,EDS 289C,A01,895770,Daly; Alan J.,15,0,15,0
1745136144638,EDS 290,A00,897211,Hofstetter; Carolyn,15,0,15,0
1745136145667,LIGM 5A,A00,896162,Fischer-Grunski; Eva K,16,0,20,4
1745136146695,LIGM 5B,A00,896260,Fischer-Grunski; Eva K,19,0,20,1
1745136147725,LIGM 5C,A00,896308,Fischer-Grunski; Eva K,19,0,20,1
1745136148751,LIIT 5AS,A00,896313,Carnelos; Chiara,18,0,20,2
1745136149777,LIIT 5BS,A00,896416,Carnelos; Chiara,20,0,20,0
1745136150803,LIIT 5CS,A00,896564,Carnelos; Chiara,20,0,20,0
1745136151829,LISP 5A,A00,896588,Munoz Sanchez; Alicia,7,0,20,13
1745136152855,LISP 5B,A00,896653,Munoz Sanchez; Alicia,10,0,20,10
1745136153880,LISP 5C,A00,896655,Munoz Sanchez; Alicia,9,0,20,11
1745136154905,MAE 197,001,957918,Kleissl; Jan,9998,0,9999,1
1745136155930,MATH 2,A01,957937,Staff,34,0,35,1
1745136156956,MATH 197,001,957876,Kedlaya; Kiran S.,9996,0,9999,3
1745136157983,MCWP 40,A00,892729,Duru; Nur,16,0,20,4
1745136157983,MCWP 40,B00,893304,Montejo; Carolina,20,0,20,0
1745136159009,MCWP 40R,A00,893757,Redela; Pamela Morgan,0,3,20,20
1745136160035,MCWP 50,A00,893758,Morshed; Michael James,4,0,20,16
1745136160035,MCWP 50,B00,893761,Bartulis; Jason Michael,18,0,20,2
1745136161068,MCWP 50R,A00,893766,Compas; Sean Matthew,0,1,20,20
1745136161068,MCWP 50R,B00,893769,Carter; Jennifer A,5,0,20,15
1745136161068,MCWP 50R,C00,893771,Krone; Jarret,0,3,20,20
1745136161068,MCWP 50R,D00,893772,Miller; Elizabeth Deen,4,0,20,16
1745136161068,MCWP 50R,E00,893775,Carter; Andrea L,0,0,20,20
1745136162095,MMW 11R,A01,892721,Herbst; Matthew,22,0,30,8
1745136162095,MMW 11R,A02,892722,Herbst; Matthew,28,0,30,2
1745136163121,MMW 12R,A01,892724,Herbst; Matthew,0,4,16,16
1745136163121,MMW 12R,A02,892725,Herbst; Matthew,0,4,16,16
1745136164147,MMW 13R,A01,892727,Staff,0,29,16,16
1745136164147,MMW 13R,A02,892728,Staff,0,28,16,16
1745136165172,SIO 295LS,A00,894015,Staff,9,0,25,16
1745136166198,SIO 295S,A00,894020,Staff,9,0,25,16
1745136167223,SIOC 290S,A01,894063,Merrifield; Mark A,23,0,25,2
1745136168253,SIOC 291S,A01,894137,Gabriel; Corey John,23,0,25,2
1745136169280,SOCI 117,A01,895339,Staff,5,0,5,0
1745136170306,WES 237B,A00,894149,Staff,20,0,20,0
1745136172371,AESE 279B,A00,891859,Staff,35,0,35,0
1745136173399,AIP 197,001,891854,Staff,70,0,70,0
1745136174424,ANTH 289S,A00,891856,Gagneux; Pascal,12,0,12,0
1745136175453,BENG 196,001,957946,Engler; Adam J.,9996,0,9999,3
1745136176478,CAT 124RS,A01,956906,Staff,8,0,25,17
1745136177503,CAT 125RS,A01,922013,Staff,8,0,25,17
1745136178533,CLRE 250,A00,891860,Morris; Sheldon,9996,0,9999,3
1745136180585,CLRE 251R,A00,907817,Mehta; Ravindra L.,9995,0,9999,4
1745136181612,CLRE 252,A00,891864,Cuomo; Raphael Eduardo,9994,0,9999,5
1745136182641,CLRE 253,A00,891867,Vaida; Florin,9995,0,9999,4
1745136182641,CLRE 253,B00,907819,Staff,9999,0,9999,0
1745136183666,CLRE 259,A00,891868,Patel; Hemal,9998,0,9999,1
1745136184693,CLRE 260,A00,891872,Cuomo; Raphael Eduardo,9999,0,9999,0
1745136185722,CLRE 297,001,891888,Cuomo; Raphael Eduardo,9999,0,9999,0
1745136186810,CSS 201S,A01,892054,Mignozzetti; Umberto,30,0,30,0
1745136187834,CSS 202S,A01,892056,Mignozzetti; Umberto,30,0,30,0
1745136188859,DSC 197,001,956898,Eldridge; Justin Matthew,9998,0,9999,1
1745136189883,DSC 297,001,958000,Mazumdar; Arya,9999,0,9999,0
1745136190909,EAP 100,A00,905686,Staff,9774,0,9999,225
1745136191939,ECE 45,A01,892618,Staff,0,2,50,50
1745136192972,ECE 109,A01,892620,Staff,0,44,0,0
1745136194002,ECE 111,A01,892719,Staff,0,0,50,50
1745136195029,ECE 197,001,957920,Mercier; Patrick Philip,9992,0,9999,7
1745136196056,ECON 178,A01,907814,Zhu; Ying,29,0,35,6
1745136197085,EDS 115,A00,895312,Staff,42,0,45,3
1745136198112,EDS 117,A01,895337,Staff,30,0,30,0
1745136199138,EDS 125,A00,895341,Jones; Gabrielle Anastasia,43,0,45,2
1745136200168,EDS 128A,A01,895459,Fargason; Sharon Gayle,45,0,45,0
1745136201195,EDS 128B,A01,895543,Pappas; Elizabeth,45,0,45,0
1745136202222,EDS 139,A00,897203,Pappas; Elizabeth,45,0,45,0
1745136202222,EDS 139,B00,897209,Fargason; Sharon Gayle,45,0,45,0
1745136203252,EDS 201,A00,895545,Staff,44,0,45,1
1745136204277,EDS 203,A01,895581,Halter; Christopher P.,44,0,45,1
1745136205307,EDS 204R,A01,895625,Heinzman; Erica M.,45,0,45,0
1745136205307,EDS 204R,B01,895693,Halter; Christopher P.,28,0,45,17
1745136206332,EDS 206R,A00,895694,Fargason; Sharon Gayle,22,0,30,8
1745136206332,EDS 206R,B00,895695,Choi; Bailey Miyeon,21,0,30,9
1745136207362,EDS 250,A00,895697,Hemans; Patricia Ann Benitez,44,0,45,1
1745136208387,EDS 281,A00,895701,Meyerott; Theresa Ann,15,0,15,0
1745136209413,EDS 284,A00,895736,Meyerott; Theresa Ann,15,0,15,0
1745136210441,EDS 286,A00,897210,Fine; Sarah,15,0,15,0
1745136211465,EDS 289C,A01,895770,Daly; Alan J.,15,0,15,0
1745136212491,EDS 290,A00,897211,Hofstetter; Carolyn,15,0,15,0
1745136213520,LIGM 5A,A00,896162,Fischer-Grunski; Eva K,16,0,20,4
1745136214547,LIGM 5B,A00,896260,Fischer-Grunski; Eva K,19,0,20,1
1745136215572,LIGM 5C,A00,896308,Fischer-Grunski; Eva K,19,0,20,1
1745136216602,LIIT 5AS,A00,896313,Carnelos; Chiara,18,0,20,2
1745136217630,LIIT 5BS,A00,896416,Carnelos; Chiara,20,0,20,0
1745136218654,LIIT 5CS,A00,896564,Carnelos; Chiara,20,0,20,0
1745136219683,LISP 5A,A00,896588,Munoz Sanchez; Alicia,7,0,20,13
1745136220708,LISP 5B,A00,896653,Munoz Sanchez; Alicia,10,0,20,10
1745136221734,LISP 5C,A00,896655,Munoz Sanchez; Alicia,9,0,20,11
1745136222762,MAE 197,001,957918,Kleissl; Jan,9998,0,9999,1
1745136223788,MATH 2,A01,957937,Staff,34,0,35,1
1745136224814,MATH 197,001,957876,Kedlaya; Kiran S.,9996,0,9999,3
1745136225844,MCWP 40,A00,892729,Duru; Nur,16,0,20,4
1745136225844,MCWP 40,B00,893304,Montejo; Carolina,20,0,20,0
1745136226869,MCWP 40R,A00,893757,Redela; Pamela Morgan,0,3,20,20
1745136227895,MCWP 50,A00,893758,Morshed; Michael James,4,0,20,16
1745136227895,MCWP 50,B00,893761,Bartulis; Jason Michael,18,0,20,2
1745136228921,MCWP 50R,A00,893766,Compas; Sean Matthew,0,1,20,20
1745136228921,MCWP 50R,B00,893769,Carter; Jennifer A,5,0,20,15
1745136228921,MCWP 50R,C00,893771,Krone; Jarret,0,3,20,20
1745136228921,MCWP 50R,D00,893772,Miller; Elizabeth Deen,4,0,20,16
1745136228921,MCWP 50R,E00,893775,Carter; Andrea L,0,0,20,20
1745136229949,MMW 11R,A01,892721,Herbst; Matthew,22,0,30,8
1745136229949,MMW 11R,A02,892722,Herbst; Matthew,28,0,30,2
1745136230975,MMW 12R,A01,892724,Herbst; Matthew,0,4,16,16
1745136230975,MMW 12R,A02,892725,Herbst; Matthew,0,4,16,16
1745136232002,MMW 13R,A01,892727,Staff,0,29,16,16
1745136232002,MMW 13R,A02,892728,Staff,0,28,16,16
1745136233028,SIO 295LS,A00,894015,Staff,9,0,25,16
1745136234056,SIO 295S,A00,894020,Staff,9,0,25,16
1745136235085,SIOC 290S,A01,894063,Merrifield; Mark A,23,0,25,2
1745136236113,SIOC 291S,A01,894137,Gabriel; Corey John,23,0,25,2
1745136237140,SOCI 117,A01,895339,Staff,5,0,5,0
1745136238213,WES 237B,A00,894149,Staff,20,0,20,0
1745136240290,AESE 279B,A00,891859,Staff,35,0,35,0
1745136241317,AIP 197,001,891854,Staff,70,0,70,0
1745136242344,ANTH 289S,A00,891856,Gagneux; Pascal,12,0,12,0
1745136243370,BENG 196,001,957946,Engler; Adam J.,9996,0,9999,3
1745136244397,CAT 124RS,A01,956906,Staff,8,0,25,17
1745136245423,CAT 125RS,A01,922013,Staff,8,0,25,17
1745136246450,CLRE 250,A00,891860,Morris; Sheldon,9996,0,9999,3
1745136248501,CLRE 251R,A00,907817,Mehta; Ravindra L.,9995,0,9999,4
1745136249530,CLRE 252,A00,891864,Cuomo; Raphael Eduardo,9994,0,9999,5
1745136250559,CLRE 253,A00,891867,Vaida; Florin,9995,0,9999,4
1745136250559,CLRE 253,B00,907819,Staff,9999,0,9999,0
1745136251588,CLRE 259,A00,891868,Patel; Hemal,9998,0,9999,1
1745136252614,CLRE 260,A00,891872,Cuomo; Raphael Eduardo,9999,0,9999,0
1745136253643,CLRE 297,001,891888,Cuomo; Raphael Eduardo,9999,0,9999,0
1745136254672,CSS 201S,A01,892054,Mignozzetti; Umberto,30,0,30,0
1745136255696,CSS 202S,A01,892056,Mignozzetti; Umberto,30,0,30,0
1745136256726,DSC 197,001,956898,Eldridge; Justin Matthew,9998,0,9999,1
1745136257755,DSC 297,001,958000,Mazumdar; Arya,9999,0,9999,0
1745136258785,EAP 100,A00,905686,Staff,9774,0,9999,225
1745136259813,ECE 45,A01,892618,Staff,0,2,50,50
1745136260838,ECE 109,A01,892620,Staff,0,44,0,0
1745136261863,ECE 111,A01,892719,Staff,0,0,50,50
1745136262888,ECE 197,001,957920,Mercier; Patrick Philip,9992,0,9999,7
1745136263917,ECON 178,A01,907814,Zhu; Ying,29,0,35,6
1745136264943,EDS 115,A00,895312,Staff,42,0,45,3
1745136265970,EDS 117,A01,895337,Staff,30,0,30,0
1745136266999,EDS 125,A00,895341,Jones; Gabrielle Anastasia,43,0,45,2
1745136268028,EDS 128A,A01,895459,Fargason; Sharon Gayle,45,0,45,0
1745136269058,EDS 128B,A01,895543,Pappas; Elizabeth,45,0,45,0
1745136270082,EDS 139,A00,897203,Pappas; Elizabeth,45,0,45,0
1745136270082,EDS 139,B00,897209,Fargason; Sharon Gayle,45,0,45,0
1745136271112,EDS 201,A00,895545,Staff,44,0,45,1
1745136272141,EDS 203,A01,895581,Halter; Christopher P.,44,0,45,1
1745136273164,EDS 204R,A01,895625,Heinzman; Erica M.,45,0,45,0
1745136273164,EDS 204R,B01,895693,Halter; Christopher P.,28,0,45,17
1745136274217,EDS 206R,A00,895694,Fargason; Sharon Gayle,22,0,30,8
1745136274217,EDS 206R,B00,895695,Choi; Bailey Miyeon,21,0,30,9
1745136275242,EDS 250,A00,895697,Hemans; Patricia Ann Benitez,44,0,45,1
1745136276267,EDS 281,A00,895701,Meyerott; Theresa Ann,15,0,15,0
1745136277297,EDS 284,A00,895736,Meyerott; Theresa Ann,15,0,15,0
1745136278324,EDS 286,A00,897210,Fine; Sarah,15,0,15,0
1745136279410,EDS 289C,A01,895770,Daly; Alan J.,15,0,15,0
1745136280437,EDS 290,A00,897211,Hofstetter; Carolyn,15,0,15,0
1745136281466,LIGM 5A,A00,896162,Fischer-Grunski; Eva K,16,0,20,4
1745136282495,LIGM 5B,A00,896260,Fischer-Grunski; Eva K,19,0,20,1
1745136283523,LIGM 5C,A00,896308,Fischer-Grunski; Eva K,19,0,20,1
1745136284552,LIIT 5AS,A00,896313,Carnelos; Chiara,18,0,20,2
1745136285577,LIIT 5BS,A00,896416,Carnelos; Chiara,20,0,20,0
1745136286603,LIIT 5CS,A00,896564,Carnelos; Chiara,20,0,20,0
1745136287632,LISP 5A,A00,896588,Munoz Sanchez; Alicia,7,0,20,13
1745136288658,LISP 5B,A00,896653,Munoz Sanchez; Alicia,10,0,20,10
1745136289685,LISP 5C,A00,896655,Munoz Sanchez; Alicia,9,0,20,11
1745136290714,MAE 197,001,957918,Kleissl; Jan,9998,0,9999,1
1745136291741,MATH 2,A01,957937,Staff,34,0,35,1
1745136292773,MATH 197,001,957876,Kedlaya; Kiran S.,9996,0,9999,3
1745136293797,MCWP 40,A00,892729,Duru; Nur,16,0,20,4
1745136293797,MCWP 40,B00,893304,Montejo; Carolina,20,0,20,0
1745136294824,MCWP 40R,A00,893757,Redela; Pamela Morgan,0,3,20,20
1745136295849,MCWP 50,A00,893758,Morshed; Michael James,4,0,20,16
1745136295849,MCWP 50,B00,893761,Bartulis; Jason Michael,18,0,20,2
1745136296879,MCWP 50R,A00,893766,Compas; Sean Matthew,0,1,20,20
1745136296879,MCWP 50R,B00,893769,Carter; Jennifer A,5,0,20,15
1745136296879,MCWP 50R,C00,893771,Krone; Jarret,0,3,20,20
1745136296879,MCWP 50R,D00,893772,Miller; Elizabeth Deen,4,0,20,16
1745136296879,MCWP 50R,E00,893775,Carter; Andrea L,0,0,20,20
1745136297909,MMW 11R,A01,892721,Herbst; Matthew,22,0,30,8
1745136297909,MMW 11R,A02,892722,Herbst; Matthew,28,0,30,2
1745136298939,MMW 12R,A01,892724,Herbst; Matthew,0,4,16,16
1745136298939,MMW 12R,A02,892725,Herbst; Matthew,0,4,16,16
1745136299967,MMW 13R,A01,892727,Staff,0,29,16,16
1745136299967,MMW 13R,A02,892728,Staff,0,28,16,16
1745136300997,SIO 295LS,A00,894015,Staff,9,0,25,16
1745136302024,SIO 295S,A00,894020,Staff,9,0,25,16
1745136303048,SIOC 290S,A01,894063,Merrifield; Mark A,23,0,25,2
1745136304076,SIOC 291S,A01,894137,Gabriel; Corey John,23,0,25,2
1745136305103,SOCI 117,A01,895339,Staff,5,0,5,0
1745136306129,WES 237B,A00,894149,Staff,20,0,20,0
1745136308198,AESE 279B,A00,891859,Staff,35,0,35,0
1745136309224,AIP 197,001,891854,Staff,70,0,70,0
1745136310249,ANTH 289S,A00,891856,Gagneux; Pascal,12,0,12,0
1745136311277,BENG 196,001,957946,Engler; Adam J.,9996,0,9999,3
1745136312304,CAT 124RS,A01,956906,Staff,8,0,25,17
1745136313332,CAT 125RS,A01,922013,Staff,8,0,25,17
1745136314361,CLRE 250,A00,891860,Morris; Sheldon,9996,0,9999,3
1745136316415,CLRE 251R,A00,907817,Mehta; Ravindra L.,9995,0,9999,4
1745136317443,CLRE 252,A00,891864,Cuomo; Raphael Eduardo,9994,0,9999,5
1745136318468,CLRE 253,A00,891867,Vaida; Florin,9995,0,9999,4
1745136318468,CLRE 253,B00,907819,Staff,9999,0,9999,0
1745136319493,CLRE 259,A00,891868,Patel; Hemal,9998,0,9999,1
1745136320520,CLRE 260,A00,891872,Cuomo; Raphael Eduardo,9999,0,9999,0
1745136321546,CLRE 297,001,891888,Cuomo; Raphael Eduardo,9999,0,9999,0
1745136322579,CSS 201S,A01,892054,Mignozzetti; Umberto,30,0,30,0
1745136323603,CSS 202S,A01,892056,Mignozzetti; Umberto,30,0,30,0
1745136324629,DSC 197,001,956898,Eldridge; Justin Matthew,9998,0,9999,1
1745136325653,DSC 297,001,958000,Mazumdar; Arya,9999,0,9999,0
1745136326678,EAP 100,A00,905686,Staff,9774,0,9999,225
1745136327705,ECE 45,A01,892618,Staff,0,2,50,50
1745136328732,ECE 109,A01,892620,Staff,0,44,0,0
1745136329757,ECE 111,A01,892719,Staff,0,0,50,50
1745136330782,ECE 197,001,957920,Mercier; Patrick Philip,9992,0,9999,7
1745136331808,ECON 178,A01,907814,Zhu; Ying,29,0,35,6
1745136332834,EDS 115,A00,895312,Staff,42,0,45,3
1745136333862,EDS 117,A01,895337,Staff,30,0,30,0
1745136334890,EDS 125,A00,895341,Jones; Gabrielle Anastasia,43,0,45,2
1745136335914,EDS 128A,A01,895459,Fargason; Sharon Gayle,45,0,45,0
1745136336940,EDS 128B,A01,895543,Pappas; Elizabeth,45,0,45,0
1745136337968,EDS 139,A00,897203,Pappas; Elizabeth,45,0,45,0
1745136337968,EDS 139,B00,897209,Fargason; Sharon Gayle,45,0,45,0
1745136338994,EDS 201,A00,895545,Staff,44,0,45,1
1745136340021,EDS 203,A01,895581,Halter; Christopher P.,44,0,45,1
1745136341049,EDS 204R,A01,895625,Heinzman; Erica M.,45,0,45,0
1745136341049,EDS 204R,B01,895693,Halter; Christopher P.,28,0,45,17
1745136342075,EDS 206R,A00,895694,Fargason; Sharon Gayle,22,0,30,8
1745136342075,EDS 206R,B00,895695,Choi; Bailey Miyeon,21,0,30,9
1745136343100,EDS 250,A00,895697,Hemans; Patricia Ann Benitez,44,0,45,1
1745136344128,EDS 281,A00,895701,Meyerott; Theresa Ann,15,0,15,0
1745136345153,EDS 284,A00,895736,Meyerott; Theresa Ann,15,0,15,0
1745136346179,EDS 286,A00,897210,Fine; Sarah,15,0,15,0
1745136347207,EDS 289C,A01,895770,Daly; Alan J.,15,0,15,0
1745136348232,EDS 290,A00,897211,Hofstetter; Carolyn,15,0,15,0
1745136349264,LIGM 5A,A00,896162,Fischer-Grunski; Eva K,16,0,20,4
1745136350291,LIGM 5B,A00,896260,Fischer-Grunski; Eva K,19,0,20,1
1745136351318,LIGM 5C,A00,896308,Fischer-Grunski; Eva K,19,0,20,1
1745136352344,LIIT 5AS,A00,896313,Carnelos; Chiara,18,0,20,2
1745136353368,LIIT 5BS,A00,896416,Carnelos; Chiara,20,0,20,0
1745136354393,LIIT 5CS,A00,896564,Carnelos; Chiara,20,0,20,0
1745136355417,LISP 5A,A00,896588,Munoz Sanchez; Alicia,7,0,20,13
1745136356447,LISP 5B,A00,896653,Munoz Sanchez; Alicia,10,0,20,10
1745136357473,LISP 5C,A00,896655,Munoz Sanchez; Alicia,9,0,20,11
1745136358497,MAE 197,001,957918,Kleissl; Jan,9998,0,9999,1
1745136359523,MATH 2,A01,957937,Staff,34,0,35,1
1745136360551,MATH 197,001,957876,Kedlaya; Kiran S.,9996,0,9999,3
1745136361579,MCWP 40,A00,892729,Duru; Nur,16,0,20,4
1745136361579,MCWP 40,B00,893304,Montejo; Carolina,20,0,20,0
1745136362607,MCWP 40R,A00,893757,Redela; Pamela Morgan,0,3,20,20
1745136363633,MCWP 50,A00,893758,Morshed; Michael James,4,0,20,16
1745136363633,MCWP 50,B00,893761,Bartulis; Jason Michael,18,0,20,2
1745136364663,MCWP 50R,A00,893766,Compas; Sean Matthew,0,1,20,20
1745136364663,MCWP 50R,B00,893769,Carter; Jennifer A,5,0,20,15
1745136364663,MCWP 50R,C00,893771,Krone; Jarret,0,3,20,20
1745136364663,MCWP 50R,D00,893772,Miller; Elizabeth Deen,4,0,20,16
1745136364663,MCWP 50R,E00,893775,Carter; Andrea L,0,0,20,20
1745136365688,MMW 11R,A01,892721,Herbst; Matthew,22,0,30,8
1745136365688,MMW 11R,A02,892722,Herbst; Matthew,28,0,30,2
1745136366714,MMW 12R,A01,892724,Herbst; Matthew,0,4,16,16
1745136366714,MMW 12R,A02,892725,Herbst; Matthew,0,4,16,16
1745136367741,MMW 13R,A01,892727,Staff,0,29,16,16
1745136367741,MMW 13R,A02,892728,Staff,0,28,16,16
1745136368767,SIO 295LS,A00,894015,Staff,9,0,25,16
1745136369795,SIO 295S,A00,894020,Staff,9,0,25,16
1745136370824,SIOC 290S,A01,894063,Merrifield; Mark A,23,0,25,2
1745136371848,SIOC 291S,A01,894137,Gabriel; Corey John,23,0,25,2
1745136372874,SOCI 117,A01,895339,Staff,5,0,5,0
1745136373900,WES 237B,A00,894149,Staff,20,0,20,0
1745136375965,AESE 279B,A00,891859,Staff,35,0,35,0
1745136376993,AIP 197,001,891854,Staff,70,0,70,0
1745136378021,ANTH 289S,A00,891856,Gagneux; Pascal,12,0,12,0
1745136379050,BENG 196,001,957946,Engler; Adam J.,9996,0,9999,3
1745136380077,CAT 124RS,A01,956906,Staff,8,0,25,17
1745136381103,CAT 125RS,A01,922013,Staff,8,0,25,17
1745136382129,CLRE 250,A00,891860,Morris; Sheldon,9996,0,9999,3
1745136384182,CLRE 251R,A00,907817,Mehta; Ravindra L.,9995,0,9999,4
1745136385209,CLRE 252,A00,891864,Cuomo; Raphael Eduardo,9994,0,9999,5
1745136386235,CLRE 253,A00,891867,Vaida; Florin,9995,0,9999,4
1745136386235,CLRE 253,B00,907819,Staff,9999,0,9999,0
1745136387263,CLRE 259,A00,891868,Patel; Hemal,9998,0,9999,1
1745136388289,CLRE 260,A00,891872,Cuomo; Raphael Eduardo,9999,0,9999,0
1745136389314,CLRE 297,001,891888,Cuomo; Raphael Eduardo,9999,0,9999,0
1745136390339,CSS 201S,A01,892054,Mignozzetti; Umberto,30,0,30,0
1745136391365,CSS 202S,A01,892056,Mignozzetti; Umberto,30,0,30,0
1745136392391,DSC 197,001,956898,Eldridge; Justin Matthew,9998,0,9999,1
1745136393417,DSC 297,001,958000,Mazumdar; Arya,9999,0,9999,0
1745136394444,EAP 100,A00,905686,Staff,9774,0,9999,225
1745136395470,ECE 45,A01,892618,Staff,0,2,50,50
1745136396495,ECE 109,A01,892620,Staff,0,44,0,0
1745136397522,ECE 111,A01,892719,Staff,0,0,50,50
1745136398548,ECE 197,001,957920,Mercier; Patrick Philip,9992,0,9999,7
1745136399573,ECON 178,A01,907814,Zhu; Ying,29,0,35,6
1745136400599,EDS 115,A00,895312,Staff,42,0,45,3
1745136401625,EDS 117,A01,895337,Staff,30,0,30,0
1745136402650,EDS 125,A00,895341,Jones; Gabrielle Anastasia,43,0,45,2
1745136403676,EDS 128A,A01,895459,Fargason; Sharon Gayle,45,0,45,0
1745136404703,EDS 128B,A01,895543,Pappas; Elizabeth,45,0,45,0
1745136405729,EDS 139,A00,897203,Pappas; Elizabeth,45,0,45,0
1745136405729,EDS 139,B00,897209,Fargason; Sharon Gayle,45,0,45,0
1745136406755,EDS 201,A00,895545,Staff,44,0,45,1
1745136407780,EDS 203,A01,895581,Halter; Christopher P.,44,0,45,1
1745136408808,EDS 204R,A01,895625,Heinzman; Erica M.,45,0,45,0
1745136408808,EDS 204R,B01,895693,Halter; Christopher P.,28,0,45,17
1745136409837,EDS 206R,A00,895694,Fargason; Sharon Gayle,22,0,30,8
1745136409837,EDS 206R,B00,895695,Choi; Bailey Miyeon,21,0,30,9
1745136410865,EDS 250,A00,895697,Hemans; Patricia Ann Benitez,44,0,45,1
1745136411892,EDS 281,A00,895701,Meyerott; Theresa Ann,15,0,15,0
1745136412918,EDS 284,A00,895736,Meyerott; Theresa Ann,15,0,15,0
1745136413944,EDS 286,A00,897210,Fine; Sarah,15,0,15,0
1745136414975,EDS 289C,A01,895770,Daly; Alan J.,15,0,15,0
1745136416000,EDS 290,A00,897211,Hofstetter; Carolyn,15,0,15,0
1745136417030,LIGM 5A,A00,896162,Fischer-Grunski; Eva K,16,0,20,4
1745136418056,LIGM 5B,A00,896260,Fischer-Grunski; Eva K,19,0,20,1
1745136419081,LIGM 5C,A00,896308,Fischer-Grunski; Eva K,19,0,20,1
1745136420107,LIIT 5AS,A00,896313,Carnelos; Chiara,18,0,20,2
1745136421132,LIIT 5BS,A00,896416,Carnelos; Chiara,20,0,20,0
1745136422158,LIIT 5CS,A00,896564,Carnelos; Chiara,20,0,20,0
1745136423186,LISP 5A,A00,896588,Munoz Sanchez; Alicia,7,0,20,13
1745136424212,LISP 5B,A00,896653,Munoz Sanchez; Alicia,10,0,20,10
1745136425237,LISP 5C,A00,896655,Munoz Sanchez; Alicia,9,0,20,11
1745136426263,MAE 197,001,957918,Kleissl; Jan,9998,0,9999,1
1745136427291,MATH 2,A01,957937,Staff,34,0,35,1
1745136428318,MATH 197,001,957876,Kedlaya; Kiran S.,9996,0,9999,3
1745136429344,MCWP 40,A00,892729,Duru; Nur,16,0,20,4
1745136429344,MCWP 40,B00,893304,Montejo; Carolina,20,0,20,0
1745136430370,MCWP 40R,A00,893757,Redela; Pamela Morgan,0,3,20,20
1745136431397,MCWP 50,A00,893758,Morshed; Michael James,4,0,20,16
1745136431397,MCWP 50,B00,893761,Bartulis; Jason Michael,18,0,20,2
1745136432426,MCWP 50R,A00,893766,Compas; Sean Matthew,0,1,20,20
1745136432426,MCWP 50R,B00,893769,Carter; Jennifer A,5,0,20,15
1745136432426,MCWP 50R,C00,893771,Krone; Jarret,0,3,20,20
1745136432426,MCWP 50R,D00,893772,Miller; Elizabeth Deen,4,0,20,16
1745136432426,MCWP 50R,E00,893775,Carter; Andrea L,0,0,20,20
1745136433455,MMW 11R,A01,892721,Herbst; Matthew,22,0,30,8
1745136433455,MMW 11R,A02,892722,Herbst; Matthew,28,0,30,2
1745136434484,MMW 12R,A01,892724,Herbst; Matthew,0,4,16,16
1745136434484,MMW 12R,A02,892725,Herbst; Matthew,0,4,16,16
1745136435511,MMW 13R,A01,892727,Staff,0,29,16,16
1745136435511,MMW 13R,A02,892728,Staff,0,28,16,16
1745136436539,SIO 295LS,A00,894015,Staff,9,0,25,16
1745136437565,SIO 295S,A00,894020,Staff,9,0,25,16
1745136438594,SIOC 290S,A01,894063,Merrifield; Mark A,23,0,25,2
1745136439621,SIOC 291S,A01,894137,Gabriel; Corey John,23,0,25,2
1745136440647,SOCI 117,A01,895339,Staff,5,0,5,0
1745136441671,WES 237B,A00,894149,Staff,20,0,20,0
1745136443748,AESE 279B,A00,891859,Staff,35,0,35,0
1745136444777,AIP 197,001,891854,Staff,70,0,70,0
1745136445801,ANTH 289S,A00,891856,Gagneux; Pascal,12,0,12,0
1745136446827,BENG 196,001,957946,Engler; Adam J.,9996,0,9999,3
1745136447853,CAT 124RS,A01,956906,Staff,8,0,25,17
1745136448881,CAT 125RS,A01,922013,Staff,8,0,25,17
1745136449906,CLRE 250,A00,891860,Morris; Sheldon,9996,0,9999,3
1745136451958,CLRE 251R,A00,907817,Mehta; Ravindra L.,9995,0,9999,4
1745136452983,CLRE 252,A00,891864,Cuomo; Raphael Eduardo,9994,0,9999,5
1745136454010,CLRE 253,A00,891867,Vaida; Florin,9995,0,9999,4
1745136454010,CLRE 253,B00,907819,Staff,9999,0,9999,0
1745136455036,CLRE 259,A00,891868,Patel; Hemal,9998,0,9999,1
1745136456061,CLRE 260,A00,891872,Cuomo; Raphael Eduardo,9999,0,9999,0
1745136457085,CLRE 297,001,891888,Cuomo; Raphael Eduardo,9999,0,9999,0
1745136458111,CSS 201S,A01,892054,Mignozzetti; Umberto,30,0,30,0
1745136459139,CSS 202S,A01,892056,Mignozzetti; Umberto,30,0,30,0
1745136460163,DSC 197,001,956898,Eldridge; Justin Matthew,9998,0,9999,1
1745136461191,DSC 297,001,958000,Mazumdar; Arya,9999,0,9999,0
1745136462219,EAP 100,A00,905686,Staff,9774,0,9999,225
1745136463245,ECE 45,A01,892618,Staff,0,2,50,50
1745136464273,ECE 109,A01,892620,Staff,0,44,0,0
1745136465297,ECE 111,A01,892719,Staff,0,0,50,50
1745136466358,ECE 197,001,957920,Mercier; Patrick Philip,9992,0,9999,7
1745136467383,ECON 178,A01,907814,Zhu; Ying,29,0,35,6
1745136468423,EDS 115,A00,895312,Staff,42,0,45,3
1745136469449,EDS 117,A01,895337,Staff,30,0,30,0
1745136470479,EDS 125,A00,895341,Jones; Gabrielle Anastasia,43,0,45,2
1745136471507,EDS 128A,A01,895459,Fargason; Sharon Gayle,45,0,45,0
1745136472533,EDS 128B,A01,895543,Pappas; Elizabeth,45,0,45,0
1745136473559,EDS 139,A00,897203,Pappas; Elizabeth,45,0,45,0
1745136473559,EDS 139,B00,897209,Fargason; Sharon Gayle,45,0,45,0
1745136474587,EDS 201,A00,895545,Staff,44,0,45,1
1745136475612,EDS 203,A01,895581,Halter; Christopher P.,44,0,45,1
1745136476639,EDS 204R,A01,895625,Heinzman; Erica M.,45,0,45,0
1745136476639,EDS 204R,B01,895693,Halter; Christopher P.,28,0,45,17
1745136477665,EDS 206R,A00,895694,Fargason; Sharon Gayle,22,0,30,8
1745136477665,EDS 206R,B00,895695,Choi; Bailey Miyeon,21,0,30,9
1745136478691,EDS 250,A00,895697,Hemans; Patricia Ann Benitez,44,0,45,1
1745136479720,EDS 281,A00,895701,Meyerott; Theresa Ann,15,0,15,0
1745136480747,EDS 284,A00,895736,Meyerott; Theresa Ann,15,0,15,0
1745136481772,EDS 286,A00,897210,Fine; Sarah,15,0,15,0
1745136482800,EDS 289C,A01,895770,Daly; Alan J.,15,0,15,0
1745136483826,EDS 290,A00,897211,Hofstetter; Carolyn,15,0,15,0
1745136484852,LIGM 5A,A00,896162,Fischer-Grunski; Eva K,16,0,20,4
1745136485880,LIGM 5B,A00,896260,Fischer-Grunski; Eva K,19,0,20,1
1745136486909,LIGM 5C,A00,896308,Fischer-Grunski; Eva K,19,0,20,1
1745136487938,LIIT 5AS,A00,896313,Carnelos; Chiara,18,0,20,2
1745136488965,LIIT 5BS,A00,896416,Carnelos; Chiara,20,0,20,0
1745136489993,LIIT 5CS,A00,896564,Carnelos; Chiara,20,0,20,0
1745136491020,LISP 5A,A00,896588,Munoz Sanchez; Alicia,7,0,20,13
1745136492046,LISP 5B,A00,896653,Munoz Sanchez; Alicia,10,0,20,10
1745136493071,LISP 5C,A00,896655,Munoz Sanchez; Alicia,9,0,20,11
1745136494098,MAE 197,001,957918,Kleissl; Jan,9998,0,9999,1
1745136495123,MATH 2,A01,957937,Staff,34,0,35,1
1745136496148,MATH 197,001,957876,Kedlaya; Kiran S.,9996,0,9999,3
1745136497174,MCWP 40,A00,892729,Duru; Nur,16,0,20,4
1745136497174,MCWP 40,B00,893304,Montejo; Carolina,20,0,20,0
1745136498200,MCWP 40R,A00,893757,Redela; Pamela Morgan,0,3,20,20
1745136499225,MCWP 50,A00,893758,Morshed; Michael James,4,0,20,16
1745136499225,MCWP 50,B00,893761,Bartulis; Jason Michael,18,0,20,2
1745136500250,MCWP 50R,A00,893766,Compas; Sean Matthew,0,1,20,20
1745136500250,MCWP 50R,B00,893769,Carter; Jennifer A,5,0,20,15
1745136500250,MCWP 50R,C00,893771,Krone; Jarret,0,3,20,20
1745136500250,MCWP 50R,D00,893772,Miller; Elizabeth Deen,4,0,20,16
1745136500250,MCWP 50R,E00,893775,Carter; Andrea L,0,0,20,20
1745136501278,MMW 11R,A01,892721,Herbst; Matthew,22,0,30,8
1745136501278,MMW 11R,A02,892722,Herbst; Matthew,28,0,30,2
1745136502306,MMW 12R,A01,892724,Herbst; Matthew,0,4,16,16
1745136502306,MMW 12R,A02,892725,Herbst; Matthew,0,4,16,16
1745136503334,MMW 13R,A01,892727,Staff,0,29,16,16
1745136503334,MMW 13R,A02,892728,Staff,0,28,16,16
1745136504361,SIO 295LS,A00,894015,Staff,9,0,25,16
1745136505387,SIO 295S,A00,894020,Staff,9,0,25,16
1745136506416,SIOC 290S,A01,894063,Merrifield; Mark A,23,0,25,2
1745136507442,SIOC 291S,A01,894137,Gabriel; Corey John,23,0,25,2
1745136508470,SOCI 117,A01,895339,Staff,5,0,5,0
1745136509495,WES 237B,A00,894149,Staff,20,0,20,0
1745136511572,AESE 279B,A00,891859,Staff,35,0,35,0
1745136512598,AIP 197,001,891854,Staff,70,0,70,0
1745136513626,ANTH 289S,A00,891856,Gagneux; Pascal,12,0,12,0
1745136514655,BENG 196,001,957946,Engler; Adam J.,9996,0,9999,3
1745136515681,CAT 124RS,A01,956906,Staff,8,0,25,17
1745136516706,CAT 125RS,A01,922013,Staff,8,0,25,17
1745136517733,CLRE 250,A00,891860,Morris; Sheldon,9996,0,9999,3
1745136519783,CLRE 251R,A00,907817,Mehta; Ravindra L.,9995,0,9999,4
1745136520812,CLRE 252,A00,891864,Cuomo; Raphael Eduardo,9994,0,9999,5
1745136521838,CLRE 253,A00,891867,Vaida; Florin,9995,0,9999,4
1745136521838,CLRE 253,B00,907819,Staff,9999,0,9999,0
1745136522870,CLRE 259,A00,891868,Patel; Hemal,9998,0,9999,1
1745136523896,CLRE 260,A00,891872,Cuomo; Raphael Eduardo,9999,0,9999,0
1745136524923,CLRE 297,001,891888,Cuomo; Raphael Eduardo,9999,0,9999,0
1745136525950,CSS 201S,A01,892054,Mignozzetti; Umberto,30,0,30,0
1745136526980,CSS 202S,A01,892056,Mignozzetti; Umberto,30,0,30,0
1745136528006,DSC 197,001,956898,Eldridge; Justin Matthew,9998,0,9999,1
1745136529034,DSC 297,001,958000,Mazumdar; Arya,9999,0,9999,0
1745136530059,EAP 100,A00,905686,Staff,9774,0,9999,225
1745136531084,ECE 45,A01,892618,Staff,0,2,50,50
1745136532109,ECE 109,A01,892620,Staff,0,44,0,0
1745136533134,ECE 111,A01,892719,Staff,0,0,50,50
1745136534174,ECE 197,001,957920,Mercier; Patrick Philip,9992,0,9999,7
1745136535200,ECON 178,A01,907814,Zhu; Ying,29,0,35,6
1745136536228,EDS 115,A00,895312,Staff,42,0,45,3
1745136537253,EDS 117,A01,895337,Staff,30,0,30,0
1745136538284,EDS 125,A00,895341,Jones; Gabrielle Anastasia,43,0,45,2
1745136539313,EDS 128A,A01,895459,Fargason; Sharon Gayle,45,0,45,0
1745136540338,EDS 128B,A01,895543,Pappas; Elizabeth,45,0,45,0
1745136541364,EDS 139,A00,897203,Pappas; Elizabeth,45,0,45,0
1745136541364,EDS 139,B00,897209,Fargason; Sharon Gayle,45,0,45,0
1745136542390,EDS 201,A00,895545,Staff,44,0,45,1
1745136543418,EDS 203,A01,895581,Halter; Christopher P.,44,0,45,1
1745136544447,EDS 204R,A01,895625,Heinzman; Erica M.,45,0,45,0
1745136544447,EDS 204R,B01,895693,Halter; Christopher P.,28,0,45,17
1745136545477,EDS 206R,A00,895694,Fargason; Sharon Gayle,22,0,30,8
1745136545477,EDS 206R,B00,895695,Choi; Bailey Miyeon,21,0,30,9
1745136546501,EDS 250,A00,895697,Hemans; Patricia Ann Benitez,44,0,45,1
1745136547528,EDS 281,A00,895701,Meyerott; Theresa Ann,15,0,15,0
1745136548557,EDS 284,A00,895736,Meyerott; Theresa Ann,15,0,15,0
1745136549583,EDS 286,A00,897210,Fine; Sarah,15,0,15,0
1745136550611,EDS 289C,A01,895770,Daly; Alan J.,15,0,15,0
1745136551639,EDS 290,A00,897211,Hofstetter; Carolyn,15,0,15,0
1745136552669,LIGM 5A,A00,896162,Fischer-Grunski; Eva K,16,0,20,4
1745136553698,LIGM 5B,A00,896260,Fischer-Grunski; Eva K,19,0,20,1
1745136554727,LIGM 5C,A00,896308,Fischer-Grunski; Eva K,19,0,20,1
1745136555758,LIIT 5AS,A00,896313,Carnelos; Chiara,18,0,20,2
1745136556784,LIIT 5BS,A00,896416,Carnelos; Chiara,20,0,20,0
1745136557812,LIIT 5CS,A00,896564,Carnelos; Chiara,20,0,20,0
1745136558838,LISP 5A,A00,896588,Munoz Sanchez; Alicia,7,0,20,13
1745136559866,LISP 5B,A00,896653,Munoz Sanchez; Alicia,10,0,20,10
1745136560893,LISP 5C,A00,896655,Munoz Sanchez; Alicia,9,0,20,11
1745136561922,MAE 197,001,957918,Kleissl; Jan,9998,0,9999,1
1745136562947,MATH 2,A01,957937,Staff,34,0,35,1
1745136563976,MATH 197,001,957876,Kedlaya; Kiran S.,9996,0,9999,3
1745136565002,MCWP 40,A00,892729,Duru; Nur,16,0,20,4
1745136565002,MCWP 40,B00,893304,Montejo; Carolina,20,0,20,0
1745136566028,MCWP 40R,A00,893757,Redela; Pamela Morgan,0,3,20,20
1745136567056,MCWP 50,A00,893758,Morshed; Michael James,4,0,20,16
1745136567056,MCWP 50,B00,893761,Bartulis; Jason Michael,18,0,20,2
1745136568081,MCWP 50R,A00,893766,Compas; Sean Matthew,0,1,20,20
1745136568081,MCWP 50R,B00,893769,Carter; Jennifer A,5,0,20,15
1745136568081,MCWP 50R,C00,893771,Krone; Jarret,0,3,20,20
1745136568081,MCWP 50R,D00,893772,Miller; Elizabeth Deen,4,0,20,16
1745136568081,MCWP 50R,E00,893775,Carter; Andrea L,0,0,20,20
1745136569113,MMW 11R,A01,892721,Herbst; Matthew,22,0,30,8
1745136569113,MMW 11R,A02,892722,Herbst; Matthew,28,0,30,2
1745136570182,MMW 12R,A01,892724,Herbst; Matthew,0,4,16,16
1745136570182,MMW 12R,A02,892725,Herbst; Matthew,0,4,16,16
1745136571208,MMW 13R,A01,892727,Staff,0,29,16,16
1745136571208,MMW 13R,A02,892728,Staff,0,28,16,16
1745136572235,SIO 295LS,A00,894015,Staff,9,0,25,16
1745136573261,SIO 295S,A00,894020,Staff,9,0,25,16
1745136574286,SIOC 290S,A01,894063,Merrifield; Mark A,23,0,25,2
1745136575316,SIOC 291S,A01,894137,Gabriel; Corey John,23,0,25,2
1745136576342,SOCI 117,A01,895339,Staff,5,0,5,0
1745136577368,WES 237B,A00,894149,Staff,20,0,20,0
1745136579436,AESE 279B,A00,891859,Staff,35,0,35,0
1745136580465,AIP 197,001,891854,Staff,70,0,70,0
1745136581493,ANTH 289S,A00,891856,Gagneux; Pascal,12,0,12,0
1745136582521,BENG 196,001,957946,Engler; Adam J.,9996,0,9999,3
1745136583550,CAT 124RS,A01,956906,Staff,8,0,25,17
1745136584580,CAT 125RS,A01,922013,Staff,8,0,25,17
1745136585606,CLRE 250,A00,891860,Morris; Sheldon,9996,0,9999,3
1745136587659,CLRE 251R,A00,907817,Mehta; Ravindra L.,9995,0,9999,4
1745136588686,CLRE 252,A00,891864,Cuomo; Raphael Eduardo,9994,0,9999,5
1745136589715,CLRE 253,A00,891867,Vaida; Florin,9995,0,9999,4
1745136589715,CLRE 253,B00,907819,Staff,9999,0,9999,0
1745136590742,CLRE 259,A00,891868,Patel; Hemal,9998,0,9999,1
1745136591766,CLRE 260,A00,891872,Cuomo; Raphael Eduardo,9999,0,9999,0
1745136592790,CLRE 297,001,891888,Cuomo; Raphael Eduardo,9999,0,9999,0
1745136593814,CSS 201S,A01,892054,Mignozzetti; Umberto,30,0,30,0
1745136594841,CSS 202S,A01,892056,Mignozzetti; Umberto,30,0,30,0
1745136595867,DSC 197,001,956898,Eldridge; Justin Matthew,9998,0,9999,1
1745136596893,DSC 297,001,958000,Mazumdar; Arya,9999,0,9999,0
1745136597919,EAP 100,A00,905686,Staff,9774,0,9999,225
1745136598946,ECE 45,A01,892618,Staff,0,2,50,50
1745136599970,ECE 109,A01,892620,Staff,0,44,0,0
1745136601022,ECE 111,A01,892719,Staff,0,0,50,50
1745136602045,ECE 197,001,957920,Mercier; Patrick Philip,9992,0,9999,7
1745136603070,ECON 178,A01,907814,Zhu; Ying,29,0,35,6
1745136604099,EDS 115,A00,895312,Staff,42,0,45,3
1745136605126,EDS 117,A01,895337,Staff,30,0,30,0
1745136606150,EDS 125,A00,895341,Jones; Gabrielle Anastasia,43,0,45,2
1745136607176,EDS 128A,A01,895459,Fargason; Sharon Gayle,45,0,45,0
1745136608203,EDS 128B,A01,895543,Pappas; Elizabeth,45,0,45,0
1745136609227,EDS 139,A00,897203,Pappas; Elizabeth,45,0,45,0
1745136609227,EDS 139,B00,897209,Fargason; Sharon Gayle,45,0,45,0
1745136610255,EDS 201,A00,895545,Staff,44,0,45,1
1745136611283,EDS 203,A01,895581,Halter; Christopher P.,44,0,45,1
1745136612311,EDS 204R,A01,895625,Heinzman; Erica M.,45,0,45,0
1745136612311,EDS 204R,B01,895693,Halter; Christopher P.,28,0,45,17
1745136613338,EDS 206R,A00,895694,Fargason; Sharon Gayle,22,0,30,8
1745136613338,EDS 206R,B00,895695,Choi; Bailey Miyeon,21,0,30,9
1745136614367,EDS 250,A00,895697,Hemans; Patricia Ann Benitez,44,0,45,1
1745136615393,EDS 281,A00,895701,Meyerott; Theresa Ann,15,0,15,0
1745136616418,EDS 284,A00,895736,Meyerott; Theresa Ann,15,0,15,0
1745136617443,EDS 286,A00,897210,Fine; Sarah,15,0,15,0
1745136618469,EDS 289C,A01,895770,Daly; Alan J.,15,0,15,0
1745136619497,EDS 290,A00,897211,Hofstetter; Carolyn,15,0,15,0
1745136620524,LIGM 5A,A00,896162,Fischer-Grunski; Eva K,16,0,20,4
1745136621551,LIGM 5B,A00,896260,Fischer-Grunski; Eva K,19,0,20,1
1745136622576,LIGM 5C,A00,896308,Fischer-Grunski; Eva K,19,0,20,1
1745136623605,LIIT 5AS,A00,896313,Carnelos; Chiara,18,0,20,2
1745136624631,LIIT 5BS,A00,896416,Carnelos; Chiara,20,0,20,0
1745136625657,LIIT 5CS,A00,896564,Carnelos; Chiara,20,0,20,0
1745136626686,LISP 5A,A00,896588,Munoz Sanchez; Alicia,7,0,20,13
1745136627714,LISP 5B,A00,896653,Munoz Sanchez; Alicia,10,0,20,10
1745136628741,LISP 5C,A00,896655,Munoz Sanchez; Alicia,9,0,20,11
1745136629770,MAE 197,001,957918,Kleissl; Jan,9998,0,9999,1
1745136630796,MATH 2,A01,957937,Staff,34,0,35,1
1745136631821,MATH 197,001,957876,Kedlaya; Kiran S.,9996,0,9999,3
1745136632847,MCWP 40,A00,892729,Duru; Nur,16,0,20,4
1745136632847,MCWP 40,B00,893304,Montejo; Carolina,20,0,20,0
1745136633873,MCWP 40R,A00,893757,Redela; Pamela Morgan,0,3,20,20
1745136634902,MCWP 50,A00,893758,Morshed; Michael James,4,0,20,16
1745136634902,MCWP 50,B00,893761,Bartulis; Jason Michael,18,0,20,2
1745136635927,MCWP 50R,A00,893766,Compas; Sean Matthew,0,1,20,20
1745136635927,MCWP 50R,B00,893769,Carter; Jennifer A,5,0,20,15
1745136635927,MCWP 50R,C00,893771,Krone; Jarret,0,3,20,20
1745136635927,MCWP 50R,D00,893772,Miller; Elizabeth Deen,4,0,20,16
1745136635927,MCWP 50R,E00,893775,Carter; Andrea L,0,0,20,20
1745136636955,MMW 11R,A01,892721,Herbst; Matthew,22,0,30,8
1745136636955,MMW 11R,A02,892722,Herbst; Matthew,28,0,30,2
1745136637982,MMW 12R,A01,892724,Herbst; Matthew,0,4,16,16
1745136637982,MMW 12R,A02,892725,Herbst; Matthew,0,4,16,16
1745136639008,MMW 13R,A01,892727,Staff,0,29,16,16
1745136639008,MMW 13R,A02,892728,Staff,0,28,16,16
1745136640037,SIO 295LS,A00,894015,Staff,9,0,25,16
1745136641064,SIO 295S,A00,894020,Staff,9,0,25,16
1745136642093,SIOC 290S,A01,894063,Merrifield; Mark A,23,0,25,2
1745136643124,SIOC 291S,A01,894137,Gabriel; Corey John,23,0,25,2
1745136644149,SOCI 117,A01,895339,Staff,5,0,5,0
1745136645177,WES 237B,A00,894149,Staff,20,0,20,0
1745136647244,AESE 279B,A00,891859,Staff,35,0,35,0
1745136648269,AIP 197,001,891854,Staff,70,0,70,0
1745136649294,ANTH 289S,A00,891856,Gagneux; Pascal,12,0,12,0
1745136650321,BENG 196,001,957946,Engler; Adam J.,9996,0,9999,3
1745136651344,CAT 124RS,A01,956906,Staff,8,0,25,17
1745136652373,CAT 125RS,A01,922013,Staff,8,0,25,17
1745136653398,CLRE 250,A00,891860,Morris; Sheldon,9996,0,9999,3
1745136655456,CLRE 251R,A00,907817,Mehta; Ravindra L.,9995,0,9999,4
1745136656485,CLRE 252,A00,891864,Cuomo; Raphael Eduardo,9994,0,9999,5
1745136657515,CLRE 253,A00,891867,Vaida; Florin,9995,0,9999,4
1745136657515,CLRE 253,B00,907819,Staff,9999,0,9999,0
1745136658541,CLRE 259,A00,891868,Patel; Hemal,9998,0,9999,1
1745136659566,CLRE 260,A00,891872,Cuomo; Raphael Eduardo,9999,0,9999,0
1745136660591,CLRE 297,001,891888,Cuomo; Raphael Eduardo,9999,0,9999,0
1745136661617,CSS 201S,A01,892054,Mignozzetti; Umberto,30,0,30,0
1745136662642,CSS 202S,A01,892056,Mignozzetti; Umberto,30,0,30,0
1745136663669,DSC 197,001,956898,Eldridge; Justin Matthew,9998,0,9999,1
1745136664696,DSC 297,001,958000,Mazumdar; Arya,9999,0,9999,0
1745136665722,EAP 100,A00,905686,Staff,9774,0,9999,225
1745136666747,ECE 45,A01,892618,Staff,0,2,50,50
1745136667773,ECE 109,A01,892620,Staff,0,44,0,0
1745136668799,ECE 111,A01,892719,Staff,0,0,50,50
1745136669825,ECE 197,001,957920,Mercier; Patrick Philip,9992,0,9999,7
1745136670850,ECON 178,A01,907814,Zhu; Ying,29,0,35,6
1745136671875,EDS 115,A00,895312,Staff,42,0,45,3
1745136672903,EDS 117,A01,895337,Staff,30,0,30,0
1745136673927,EDS 125,A00,895341,Jones; Gabrielle Anastasia,43,0,45,2
1745136674952,EDS 128A,A01,895459,Fargason; Sharon Gayle,45,0,45,0
1745136675978,EDS 128B,A01,895543,Pappas; Elizabeth,45,0,45,0
1745136677006,EDS 139,A00,897203,Pappas; Elizabeth,45,0,45,0
1745136677006,EDS 139,B00,897209,Fargason; Sharon Gayle,45,0,45,0
1745136678034,EDS 201,A00,895545,Staff,44,0,45,1
1745136679060,EDS 203,A01,895581,Halter; Christopher P.,44,0,45,1
1745136680089,EDS 204R,A01,895625,Heinzman; Erica M.,45,0,45,0
1745136680089,EDS 204R,B01,895693,Halter; Christopher P.,28,0,45,17
1745136681113,EDS 206R,A00,895694,Fargason; Sharon Gayle,22,0,30,8
1745136681113,EDS 206R,B00,895695,Choi; Bailey Miyeon,21,0,30,9
1745136682138,EDS 250,A00,895697,Hemans; Patricia Ann Benitez,44,0,45,1
1745136683166,EDS 281,A00,895701,Meyerott; Theresa Ann,15,0,15,0
1745136684194,EDS 284,A00,895736,Meyerott; Theresa Ann,15,0,15,0
1745136685218,EDS 286,A00,897210,Fine; Sarah,15,0,15,0
1745136686243,EDS 289C,A01,895770,Daly; Alan J.,15,0,15,0
1745136687268,EDS 290,A00,897211,Hofstetter; Carolyn,15,0,15,0
1745136688293,LIGM 5A,A00,896162,Fischer-Grunski; Eva K,16,0,20,4
1745136689322,LIGM 5B,A00,896260,Fischer-Grunski; Eva K,19,0,20,1
1745136690352,LIGM 5C,A00,896308,Fischer-Grunski; Eva K,19,0,20,1
1745136691380,LIIT 5AS,A00,896313,Carnelos; Chiara,18,0,20,2
1745136692405,LIIT 5BS,A00,896416,Carnelos; Chiara,20,0,20,0
1745136693430,LIIT 5CS,A00,896564,Carnelos; Chiara,20,0,20,0
1745136694456,LISP 5A,A00,896588,Munoz Sanchez; Alicia,7,0,20,13
1745136695485,LISP 5B,A00,896653,Munoz Sanchez; Alicia,10,0,20,10
1745136696512,LISP 5C,A00,896655,Munoz Sanchez; Alicia,9,0,20,11
1745136697536,MAE 197,001,957918,Kleissl; Jan,9998,0,9999,1
1745136698621,MATH 2,A01,957937,Staff,34,0,35,1
1745136699646,MATH 197,001,957876,Kedlaya; Kiran S.,9996,0,9999,3
1745136700671,MCWP 40,A00,892729,Duru; Nur,16,0,20,4
1745136700671,MCWP 40,B00,893304,Montejo; Carolina,20,0,20,0
1745136701697,MCWP 40R,A00,893757,Redela; Pamela Morgan,0,3,20,20
1745136702721,MCWP 50,A00,893758,Morshed; Michael James,4,0,20,16
1745136702721,MCWP 50,B00,893761,Bartulis; Jason Michael,18,0,20,2
1745136703750,MCWP 50R,A00,893766,Compas; Sean Matthew,0,1,20,20
1745136703750,MCWP 50R,B00,893769,Carter; Jennifer A,5,0,20,15
1745136703750,MCWP 50R,C00,893771,Krone; Jarret,0,3,20,20
1745136703750,MCWP 50R,D00,893772,Miller; Elizabeth Deen,4,0,20,16
1745136703750,MCWP 50R,E00,893775,Carter; Andrea L,0,0,20,20
1745136704778,MMW 11R,A01,892721,Herbst; Matthew,22,0,30,8
1745136704778,MMW 11R,A02,892722,Herbst; Matthew,28,0,30,2
1745136705805,MMW 12R,A01,892724,Herbst; Matthew,0,4,16,16
1745136705805,MMW 12R,A02,892725,Herbst; Matthew,0,4,16,16
1745136706831,MMW 13R,A01,892727,Staff,0,29,16,16
1745136706831,MMW 13R,A02,892728,Staff,0,28,16,16
1745136707860,SIO 295LS,A00,894015,Staff,9,0,25,16
1745136708890,SIO 295S,A00,894020,Staff,9,0,25,16
1745136709915,SIOC 290S,A01,894063,Merrifield; Mark A,23,0,25,2
1745136710942,SIOC 291S,A01,894137,Gabriel; Corey John,23,0,25,2
1745136711969,SOCI 117,A01,895339,Staff,5,0,5,0
1745136712995,WES 237B,A00,894149,Staff,20,0,20,0
1745136715068,AESE 279B,A00,891859,Staff,35,0,35,0
1745136716094,AIP 197,001,891854,Staff,70,0,70,0
1745136717118,ANTH 289S,A00,891856,Gagneux; Pascal,12,0,12,0
1745136718143,BENG 196,001,957946,Engler; Adam J.,9996,0,9999,3
1745136719171,CAT 124RS,A01,956906,Staff,8,0,25,17
1745136720199,CAT 125RS,A01,922013,Staff,8,0,25,17
1745136721227,CLRE 250,A00,891860,Morris; Sheldon,9996,0,9999,3
1745136723281,CLRE 251R,A00,907817,Mehta; Ravindra L.,9995,0,9999,4
1745136724308,CLRE 252,A00,891864,Cuomo; Raphael Eduardo,9994,0,9999,5
1745136725334,CLRE 253,A00,891867,Vaida; Florin,9995,0,9999,4
1745136725334,CLRE 253,B00,907819,Staff,9999,0,9999,0
1745136726364,CLRE 259,A00,891868,Patel; Hemal,9998,0,9999,1
1745136727389,CLRE 260,A00,891872,Cuomo; Raphael Eduardo,9999,0,9999,0
1745136728414,CLRE 297,001,891888,Cuomo; Raphael Eduardo,9999,0,9999,0
1745136729440,CSS 201S,A01,892054,Mignozzetti; Umberto,30,0,30,0
1745136730469,CSS 202S,A01,892056,Mignozzetti; Umberto,30,0,30,0
1745136731496,DSC 197,001,956898,Eldridge; Justin Matthew,9998,0,9999,1
1745136732521,DSC 297,001,958000,Mazumdar; Arya,9999,0,9999,0
1745136733547,EAP 100,A00,905686,Staff,9774,0,9999,225
1745136734573,ECE 45,A01,892618,Staff,0,2,50,50
1745136735598,ECE 109,A01,892620,Staff,0,44,0,0
1745136736623,ECE 111,A01,892719,Staff,0,0,50,50
1745136737651,ECE 197,001,957920,Mercier; Patrick Philip,9992,0,9999,7
1745136738678,ECON 178,A01,907814,Zhu; Ying,29,0,35,6
1745136739702,EDS 115,A00,895312,Staff,42,0,45,3
1745136740731,EDS 117,A01,895337,Staff,30,0,30,0
1745136741757,EDS 125,A00,895341,Jones; Gabrielle Anastasia,43,0,45,2
1745136742783,EDS 128A,A01,895459,Fargason; Sharon Gayle,45,0,45,0
1745136743810,EDS 128B,A01,895543,Pappas; Elizabeth,45,0,45,0
1745136744837,EDS 139,A00,897203,Pappas; Elizabeth,45,0,45,0
1745136744837,EDS 139,B00,897209,Fargason; Sharon Gayle,45,0,45,0
1745136745865,EDS 201,A00,895545,Staff,44,0,45,1
1745136746890,EDS 203,A01,895581,Halter; Christopher P.,44,0,45,1
1745136747945,EDS 204R,A01,895625,Heinzman; Erica M.,45,0,45,0
1745136747945,EDS 204R,B01,895693,Halter; Christopher P.,28,0,45,17
1745136748972,EDS 206R,A00,895694,Fargason; Sharon Gayle,22,0,30,8
1745136748972,EDS 206R,B00,895695,Choi; Bailey Miyeon,21,0,30,9
1745136749997,EDS 250,A00,895697,Hemans; Patricia Ann Benitez,44,0,45,1
1745136751021,EDS 281,A00,895701,Meyerott; Theresa Ann,15,0,15,0
1745136752047,EDS 284,A00,895736,Meyerott; Theresa Ann,15,0,15,0
1745136753074,EDS 286,A00,897210,Fine; Sarah,15,0,15,0
1745136754102,EDS 289C,A01,895770,Daly; Alan J.,15,0,15,0
1745136755128,EDS 290,A00,897211,Hofstetter; Carolyn,15,0,15,0
1745136756156,LIGM 5A,A00,896162,Fischer-Grunski; Eva K,16,0,20,4
1745136757181,LIGM 5B,A00,896260,Fischer-Grunski; Eva K,19,0,20,1
1745136758210,LIGM 5C,A00,896308,Fischer-Grunski; Eva K,19,0,20,1
1745136759236,LIIT 5AS,A00,896313,Carnelos; Chiara,18,0,20,2
1745136760260,LIIT 5BS,A00,896416,Carnelos; Chiara,20,0,20,0
1745136761289,LIIT 5CS,A00,896564,Carnelos; Chiara,20,0,20,0
1745136762315,LISP 5A,A00,896588,Munoz Sanchez; Alicia,7,0,20,13
1745136763340,LISP 5B,A00,896653,Munoz Sanchez; Alicia,10,0,20,10
1745136764369,LISP 5C,A00,896655,Munoz Sanchez; Alicia,9,0,20,11
1745136765394,MAE 197,001,957918,Kleissl; Jan,9998,0,9999,1
1745136766421,MATH 2,A01,957937,Staff,34,0,35,1
1745136767445,MATH 197,001,957876,Kedlaya; Kiran S.,9996,0,9999,3
1745136768471,MCWP 40,A00,892729,Duru; Nur,16,0,20,4
1745136768471,MCWP 40,B00,893304,Montejo; Carolina,20,0,20,0
1745136769498,MCWP 40R,A00,893757,Redela; Pamela Morgan,0,3,20,20
1745136770524,MCWP 50,A00,893758,Morshed; Michael James,4,0,20,16
1745136770524,MCWP 50,B00,893761,Bartulis; Jason Michael,18,0,20,2
1745136771551,MCWP 50R,A00,893766,Compas; Sean Matthew,0,1,20,20
1745136771551,MCWP 50R,B00,893769,Carter; Jennifer A,5,0,20,15
1745136771551,MCWP 50R,C00,893771,Krone; Jarret,0,3,20,20
1745136771551,MCWP 50R,D00,893772,Miller; Elizabeth Deen,4,0,20,16
1745136771551,MCWP 50R,E00,893775,Carter; Andrea L,0,0,20,20
1745136772579,MMW 11R,A01,892721,Herbst; Matthew,22,0,30,8
1745136772579,MMW 11R,A02,892722,Herbst; Matthew,28,0,30,2
1745136773606,MMW 12R,A01,892724,Herbst; Matthew,0,4,16,16
1745136773606,MMW 12R,A02,892725,Herbst; Matthew,0,4,16,16
1745136774633,MMW 13R,A01,892727,Staff,0,29,16,16
1745136774633,MMW 13R,A02,892728,Staff,0,28,16,16
1745136775661,SIO 295LS,A00,894015,Staff,9,0,25,16
1745136776688,SIO 295S,A00,894020,Staff,9,0,25,16
1745136777718,SIOC 290S,A01,894063,Merrifield; Mark A,23,0,25,2
1745136778747,SIOC 291S,A01,894137,Gabriel; Corey John,23,0,25,2
1745136779774,SOCI 117,A01,895339,Staff,5,0,5,0
1745136780799,WES 237B,A00,894149,Staff,20,0,20,0
1745136782878,AESE 279B,A00,891859,Staff,35,0,35,0
1745136783903,AIP 197,001,891854,Staff,70,0,70,0
1745136784930,ANTH 289S,A00,891856,Gagneux; Pascal,12,0,12,0
1745136785953,BENG 196,001,957946,Engler; Adam J.,9996,0,9999,3
1745136786978,CAT 124RS,A01,956906,Staff,8,0,25,17
1745136788005,CAT 125RS,A01,922013,Staff,8,0,25,17
1745136789029,CLRE 250,A00,891860,Morris; Sheldon,9996,0,9999,3
1745136791084,CLRE 251R,A00,907817,Mehta; Ravindra L.,9995,0,9999,4
1745136792109,CLRE 252,A00,891864,Cuomo; Raphael Eduardo,9994,0,9999,5
1745136793136,CLRE 253,A00,891867,Vaida; Florin,9995,0,9999,4
1745136793136,CLRE 253,B00,907819,Staff,9999,0,9999,0
1745136794164,CLRE 259,A00,891868,Patel; Hemal,9998,0,9999,1
1745136795191,CLRE 260,A00,891872,Cuomo; Raphael Eduardo,9999,0,9999,0
1745136796221,CLRE 297,001,891888,Cuomo; Raphael Eduardo,9999,0,9999,0
1745136797251,CSS 201S,A01,892054,Mignozzetti; Umberto,30,0,30,0
1745136798276,CSS 202S,A01,892056,Mignozzetti; Umberto,30,0,30,0
1745136799304,DSC 197,001,956898,Eldridge; Justin Matthew,9998,0,9999,1
1745136800329,DSC 297,001,958000,Mazumdar; Arya,9999,0,9999,0
1745136801355,EAP 100,A00,905686,Staff,9774,0,9999,225
1745136802393,ECE 45,A01,892618,Staff,0,2,50,50
1745136803419,ECE 109,A01,892620,Staff,0,44,0,0
1745136804446,ECE 111,A01,892719,Staff,0,0,50,50
1745136805470,ECE 197,001,957920,Mercier; Patrick Philip,9992,0,9999,7
1745136806501,ECON 178,A01,907814,Zhu; Ying,29,0,35,6
1745136807525,EDS 115,A00,895312,Staff,42,0,45,3
1745136808550,EDS 117,A01,895337,Staff,30,0,30,0
1745136809574,EDS 125,A00,895341,Jones; Gabrielle Anastasia,43,0,45,2
1745136810602,EDS 128A,A01,895459,Fargason; Sharon Gayle,45,0,45,0
1745136811630,EDS 128B,A01,895543,Pappas; Elizabeth,45,0,45,0
1745136812657,EDS 139,A00,897203,Pappas; Elizabeth,45,0,45,0
1745136812657,EDS 139,B00,897209,Fargason; Sharon Gayle,45,0,45,0
1745136813685,EDS 201,A00,895545,Staff,44,0,45,1
1745136814710,EDS 203,A01,895581,Halter; Christopher P.,44,0,45,1
1745136815740,EDS 204R,A01,895625,Heinzman; Erica M.,45,0,45,0
1745136815740,EDS 204R,B01,895693,Halter; Christopher P.,28,0,45,17
1745136816767,EDS 206R,A00,895694,Fargason; Sharon Gayle,22,0,30,8
1745136816767,EDS 206R,B00,895695,Choi; Bailey Miyeon,21,0,30,9
1745136817793,EDS 250,A00,895697,Hemans; Patricia Ann Benitez,44,0,45,1
1745136818820,EDS 281,A00,895701,Meyerott; Theresa Ann,15,0,15,0
1745136819847,EDS 284,A00,895736,Meyerott; Theresa Ann,15,0,15,0
1745136820872,EDS 286,A00,897210,Fine; Sarah,15,0,15,0
1745136821898,EDS 289C,A01,895770,Daly; Alan J.,15,0,15,0
1745136822924,EDS 290,A00,897211,Hofstetter; Carolyn,15,0,15,0
1745136823949,LIGM 5A,A00,896162,Fischer-Grunski; Eva K,16,0,20,4
1745136824974,LIGM 5B,A00,896260,Fischer-Grunski; Eva K,19,0,20,1
1745136826004,LIGM 5C,A00,896308,Fischer-Grunski; Eva K,19,0,20,1
1745136827030,LIIT 5AS,A00,896313,Carnelos; Chiara,18,0,20,2
1745136828055,LIIT 5BS,A00,896416,Carnelos; Chiara,20,0,20,0
1745136829084,LIIT 5CS,A00,896564,Carnelos; Chiara,20,0,20,0
1745136830110,LISP 5A,A00,896588,Munoz Sanchez; Alicia,7,0,20,13
1745136831138,LISP 5B,A00,896653,Munoz Sanchez; Alicia,10,0,20,10
1745136832167,LISP 5C,A00,896655,Munoz Sanchez; Alicia,9,0,20,11
1745136833192,MAE 197,001,957918,Kleissl; Jan,9998,0,9999,1
1745136834217,MATH 2,A01,957937,Staff,34,0,35,1
1745136835244,MATH 197,001,957876,Kedlaya; Kiran S.,9996,0,9999,3
1745136836269,MCWP 40,A00,892729,Duru; Nur,16,0,20,4
1745136836269,MCWP 40,B00,893304,Montejo; Carolina,20,0,20,0
1745136837297,MCWP 40R,A00,893757,Redela; Pamela Morgan,0,3,20,20
1745136838326,MCWP 50,A00,893758,Morshed; Michael James,4,0,20,16
1745136838326,MCWP 50,B00,893761,Bartulis; Jason Michael,18,0,20,2
1745136839350,MCWP 50R,A00,893766,Compas; Sean Matthew,0,1,20,20
1745136839350,MCWP 50R,B00,893769,Carter; Jennifer A,5,0,20,15
1745136839350,MCWP 50R,C00,893771,Krone; Jarret,0,3,20,20
1745136839350,MCWP 50R,D00,893772,Miller; Elizabeth Deen,4,0,20,16
1745136839350,MCWP 50R,E00,893775,Carter; Andrea L,0,0,20,20
1745136840375,MMW 11R,A01,892721,Herbst; Matthew,22,0,30,8
1745136840375,MMW 11R,A02,892722,Herbst; Matthew,28,0,30,2
1745136841401,MMW 12R,A01,892724,Herbst; Matthew,0,4,16,16
1745136841401,MMW 12R,A02,892725,Herbst; Matthew,0,4,16,16
1745136842427,MMW 13R,A01,892727,Staff,0,29,16,16
1745136842427,MMW 13R,A02,892728,Staff,0,28,16,16
1745136843452,SIO 295LS,A00,894015,Staff,9,0,25,16
1745136844479,SIO 295S,A00,894020,Staff,9,0,25,16
1745136845547,SIOC 290S,A01,894063,Merrifield; Mark A,23,0,25,2
1745136846575,SIOC 291S,A01,894137,Gabriel; Corey John,23,0,25,2
1745136847603,SOCI 117,A01,895339,Staff,5,0,5,0
1745136848631,WES 237B,A00,894149,Staff,20,0,20,0
1745136850699,AESE 279B,A00,891859,Staff,35,0,35,0
1745136851728,AIP 197,001,891854,Staff,70,0,70,0
1745136852753,ANTH 289S,A00,891856,Gagneux; Pascal,12,0,12,0
1745136853781,BENG 196,001,957946,Engler; Adam J.,9996,0,9999,3
1745136854810,CAT 124RS,A01,956906,Staff,8,0,25,17
1745136855835,CAT 125RS,A01,922013,Staff,8,0,25,17
1745136856864,CLRE 250,A00,891860,Morris; Sheldon,9996,0,9999,3
1745136858918,CLRE 251R,A00,907817,Mehta; Ravindra L.,9995,0,9999,4
1745136859944,CLRE 252,A00,891864,Cuomo; Raphael Eduardo,9994,0,9999,5
1745136860970,CLRE 253,A00,891867,Vaida; Florin,9995,0,9999,4
1745136860970,CLRE 253,B00,907819,Staff,9999,0,9999,0
1745136861997,CLRE 259,A00,891868,Patel; Hemal,9998,0,9999,1
1745136863023,CLRE 260,A00,891872,Cuomo; Raphael Eduardo,9999,0,9999,0
1745136864047,CLRE 297,001,891888,Cuomo; Raphael Eduardo,9999,0,9999,0
1745136865078,CSS 201S,A01,892054,Mignozzetti; Umberto,30,0,30,0
1745136866105,CSS 202S,A01,892056,Mignozzetti; Umberto,30,0,30,0
1745136867131,DSC 197,001,956898,Eldridge; Justin Matthew,9998,0,9999,1
1745136868155,DSC 297,001,958000,Mazumdar; Arya,9999,0,9999,0
1745136869184,EAP 100,A00,905686,Staff,9774,0,9999,225
1745136870210,ECE 45,A01,892618,Staff,0,2,50,50
1745136871239,ECE 109,A01,892620,Staff,0,44,0,0
1745136872268,ECE 111,A01,892719,Staff,0,0,50,50
1745136873292,ECE 197,001,957920,Mercier; Patrick Philip,9992,0,9999,7
1745136874323,ECON 178,A01,907814,Zhu; Ying,29,0,35,6
1745136875349,EDS 115,A00,895312,Staff,42,0,45,3
1745136876377,EDS 117,A01,895337,Staff,30,0,30,0
1745136877402,EDS 125,A00,895341,Jones; Gabrielle Anastasia,43,0,45,2
1745136878430,EDS 128A,A01,895459,Fargason; Sharon Gayle,45,0,45,0
1745136879458,EDS 128B,A01,895543,Pappas; Elizabeth,45,0,45,0
1745136880484,EDS 139,A00,897203,Pappas; Elizabeth,45,0,45,0
1745136880484,EDS 139,B00,897209,Fargason; Sharon Gayle,45,0,45,0
1745136881512,EDS 201,A00,895545,Staff,44,0,45,1
1745136882540,EDS 203,A01,895581,Halter; Christopher P.,44,0,45,1
1745136883567,EDS 204R,A01,895625,Heinzman; Erica M.,45,0,45,0
1745136883567,EDS 204R,B01,895693,Halter; Christopher P.,28,0,45,17
1745136884594,EDS 206R,A00,895694,Fargason; Sharon Gayle,22,0,30,8
1745136884594,EDS 206R,B00,895695,Choi; Bailey Miyeon,21,0,30,9
1745136885620,EDS 250,A00,895697,Hemans; Patricia Ann Benitez,44,0,45,1
1745136886646,EDS 281,A00,895701,Meyerott; Theresa Ann,15,0,15,0
1745136887672,EDS 284,A00,895736,Meyerott; Theresa Ann,15,0,15,0
1745136888699,EDS 286,A00,897210,Fine; Sarah,15,0,15,0
1745136889725,EDS 289C,A01,895770,Daly; Alan J.,15,0,15,0
1745136890755,EDS 290,A00,897211,Hofstetter; Carolyn,15,0,15,0
1745136891784,LIGM 5A,A00,896162,Fischer-Grunski; Eva K,16,0,20,4
1745136892810,LIGM 5B,A00,896260,Fischer-Grunski; Eva K,19,0,20,1
1745136893839,LIGM 5C,A00,896308,Fischer-Grunski; Eva K,19,0,20,1
1745136894870,LIIT 5AS,A00,896313,Carnelos; Chiara,18,0,20,2
1745136895896,LIIT 5BS,A00,896416,Carnelos; Chiara,20,0,20,0
1745136896925,LIIT 5CS,A00,896564,Carnelos; Chiara,20,0,20,0
1745136897955,LISP 5A,A00,896588,Munoz Sanchez; Alicia,7,0,20,13
1745136898982,LISP 5B,A00,896653,Munoz Sanchez; Alicia,10,0,20,10
1745136900006,LISP 5C,A00,896655,Munoz Sanchez; Alicia,9,0,20,11
1745136901033,MAE 197,001,957918,Kleissl; Jan,9998,0,9999,1
1745136902061,MATH 2,A01,957937,Staff,34,0,35,1
1745136903088,MATH 197,001,957876,Kedlaya; Kiran S.,9996,0,9999,3
1745136904111,MCWP 40,A00,892729,Duru; Nur,16,0,20,4
1745136904111,MCWP 40,B00,893304,Montejo; Carolina,20,0,20,0
1745136905139,MCWP 40R,A00,893757,Redela; Pamela Morgan,0,3,20,20
1745136906168,MCWP 50,A00,893758,Morshed; Michael James,4,0,20,16
1745136906168,MCWP 50,B00,893761,Bartulis; Jason Michael,18,0,20,2
1745136907195,MCWP 50R,A00,893766,Compas; Sean Matthew,0,1,20,20
1745136907195,MCWP 50R,B00,893769,Carter; Jennifer A,5,0,20,15
1745136907195,MCWP 50R,C00,893771,Krone; Jarret,0,3,20,20
1745136907195,MCWP 50R,D00,893772,Miller; Elizabeth Deen,4,0,20,16
1745136907195,MCWP 50R,E00,893775,Carter; Andrea L,0,0,20,20
1745136908223,MMW 11R,A01,892721,Herbst; Matthew,22,0,30,8
1745136908223,MMW 11R,A02,892722,Herbst; Matthew,28,0,30,2
1745136909253,MMW 12R,A01,892724,Herbst; Matthew,0,4,16,16
1745136909253,MMW 12R,A02,892725,Herbst; Matthew,0,4,16,16
1745136910279,MMW 13R,A01,892727,Staff,0,29,16,16
1745136910279,MMW 13R,A02,892728,Staff,0,28,16,16
1745136911306,SIO 295LS,A00,894015,Staff,9,0,25,16
1745136912336,SIO 295S,A00,894020,Staff,9,0,25,16
1745136913362,SIOC 290S,A01,894063,Merrifield; Mark A,23,0,25,2
1745136914389,SIOC 291S,A01,894137,Gabriel; Corey John,23,0,25,2
1745136915434,SOCI 117,A01,895339,Staff,5,0,5,0
1745136916462,WES 237B,A00,894149,Staff,20,0,20,0
1745136918534,AESE 279B,A00,891859,Staff,35,0,35,0
1745136919560,AIP 197,001,891854,Staff,70,0,70,0
1745136920589,ANTH 289S,A00,891856,Gagneux; Pascal,12,0,12,0
1745136921614,BENG 196,001,957946,Engler; Adam J.,9996,0,9999,3
1745136922642,CAT 124RS,A01,956906,Staff,8,0,25,17
1745136923672,CAT 125RS,A01,922013,Staff,8,0,25,17
1745136924698,CLRE 250,A00,891860,Morris; Sheldon,9996,0,9999,3
1745136926753,CLRE 251R,A00,907817,Mehta; Ravindra L.,9995,0,9999,4
1745136927781,CLRE 252,A00,891864,Cuomo; Raphael Eduardo,9994,0,9999,5
1745136928806,CLRE 253,A00,891867,Vaida; Florin,9995,0,9999,4
1745136928806,CLRE 253,B00,907819,Staff,9999,0,9999,0
1745136929834,CLRE 259,A00,891868,Patel; Hemal,9998,0,9999,1
1745136930860,CLRE 260,A00,891872,Cuomo; Raphael Eduardo,9999,0,9999,0
1745136931886,CLRE 297,001,891888,Cuomo; Raphael Eduardo,9999,0,9999,0
1745136932916,CSS 201S,A01,892054,Mignozzetti; Umberto,30,0,30,0
1745136933946,CSS 202S,A01,892056,Mignozzetti; Umberto,30,0,30,0
1745136934975,DSC 197,001,956898,Eldridge; Justin Matthew,9998,0,9999,1
1745136936002,DSC 297,001,958000,Mazumdar; Arya,9999,0,9999,0
1745136937027,EAP 100,A00,905686,Staff,9774,0,9999,225
1745136938055,ECE 45,A01,892618,Staff,0,2,50,50
1745136939081,ECE 109,A01,892620,Staff,0,44,0,0
1745136940107,ECE 111,A01,892719,Staff,0,0,50,50
1745136941135,ECE 197,001,957920,Mercier; Patrick Philip,9992,0,9999,7
1745136942159,ECON 178,A01,907814,Zhu; Ying,29,0,35,6
1745136943188,EDS 115,A00,895312,Staff,42,0,45,3
1745136944215,EDS 117,A01,895337,Staff,30,0,30,0
1745136945244,EDS 125,A00,895341,Jones; Gabrielle Anastasia,43,0,45,2
1745136946274,EDS 128A,A01,895459,Fargason; Sharon Gayle,45,0,45,0
1745136947305,EDS 128B,A01,895543,Pappas; Elizabeth,45,0,45,0
1745136948334,EDS 139,A00,897203,Pappas; Elizabeth,45,0,45,0
1745136948334,EDS 139,B00,897209,Fargason; Sharon Gayle,45,0,45,0
1745136949363,EDS 201,A00,895545,Staff,44,0,45,1
1745136950388,EDS 203,A01,895581,Halter; Christopher P.,44,0,45,1
1745136951426,EDS 204R,A01,895625,Heinzman; Erica M.,45,0,45,0
1745136951426,EDS 204R,B01,895693,Halter; Christopher P.,28,0,45,17
1745136952451,EDS 206R,A00,895694,Fargason; Sharon Gayle,22,0,30,8
1745136952451,EDS 206R,B00,895695,Choi; Bailey Miyeon,21,0,30,9
1745136953479,EDS 250,A00,895697,Hemans; Patricia Ann Benitez,44,0,45,1
1745136954505,EDS 281,A00,895701,Meyerott; Theresa Ann,15,0,15,0
1745136955533,EDS 284,A00,895736,Meyerott; Theresa Ann,15,0,15,0
1745136956561,EDS 286,A00,897210,Fine; Sarah,15,0,15,0
1745136957588,EDS 289C,A01,895770,Daly; Alan J.,15,0,15,0
1745136958613,EDS 290,A00,897211,Hofstetter; Carolyn,15,0,15,0
1745136959642,LIGM 5A,A00,896162,Fischer-Grunski; Eva K,16,0,20,4
1745136960669,LIGM 5B,A00,896260,Fischer-Grunski; Eva K,19,0,20,1
1745136961695,LIGM 5C,A00,896308,Fischer-Grunski; Eva K,19,0,20,1
1745136962721,LIIT 5AS,A00,896313,Carnelos; Chiara,18,0,20,2
1745136963749,LIIT 5BS,A00,896416,Carnelos; Chiara,20,0,20,0
1745136964774,LIIT 5CS,A00,896564,Carnelos; Chiara,20,0,20,0
1745136965799,LISP 5A,A00,896588,Munoz Sanchez; Alicia,7,0,20,13
1745136966828,LISP 5B,A00,896653,Munoz Sanchez; Alicia,10,0,20,10
1745136967853,LISP 5C,A00,896655,Munoz Sanchez; Alicia,9,0,20,11
1745136968879,MAE 197,001,957918,Kleissl; Jan,9998,0,9999,1
1745136969904,MATH 2,A01,957937,Staff,34,0,35,1
1745136970931,MATH 197,001,957876,Kedlaya; Kiran S.,9996,0,9999,3
1745136971958,MCWP 40,A00,892729,Duru; Nur,16,0,20,4
1745136971958,MCWP 40,B00,893304,Montejo; Carolina,20,0,20,0
1745136972983,MCWP 40R,A00,893757,Redela; Pamela Morgan,0,3,20,20
1745136974009,MCWP 50,A00,893758,Morshed; Michael James,4,0,20,16
1745136974009,MCWP 50,B00,893761,Bartulis; Jason Michael,18,0,20,2
1745136975037,MCWP 50R,A00,893766,Compas; Sean Matthew,0,1,20,20
1745136975037,MCWP 50R,B00,893769,Carter; Jennifer A,5,0,20,15
1745136975037,MCWP 50R,C00,893771,Krone; Jarret,0,3,20,20
1745136975037,MCWP 50R,D00,893772,Miller; Elizabeth Deen,4,0,20,16
1745136975037,MCWP 50R,E00,893775,Carter; Andrea L,0,0,20,20
1745136976062,MMW 11R,A01,892721,Herbst; Matthew,22,0,30,8
1745136976062,MMW 11R,A02,892722,Herbst; Matthew,28,0,30,2
1745136977089,MMW 12R,A01,892724,Herbst; Matthew,0,4,16,16
1745136977089,MMW 12R,A02,892725,Herbst; Matthew,0,4,16,16
1745136978114,MMW 13R,A01,892727,Staff,0,29,16,16
1745136978114,MMW 13R,A02,892728,Staff,0,28,16,16
1745136979139,SIO 295LS,A00,894015,Staff,9,0,25,16
1745136980168,SIO 295S,A00,894020,Staff,9,0,25,16
1745136981196,SIOC 290S,A01,894063,Merrifield; Mark A,23,0,25,2
1745136982221,SIOC 291S,A01,894137,Gabriel; Corey John,23,0,25,2
1745136983249,SOCI 117,A01,895339,Staff,5,0,5,0
1745136984276,WES 237B,A00,894149,Staff,20,0,20,0
1745136986344,AESE 279B,A00,891859,Staff,35,0,35,0
1745136987370,AIP 197,001,891854,Staff,70,0,70,0
1745136988399,ANTH 289S,A00,891856,Gagneux; Pascal,12,0,12,0
1745136989424,BENG 196,001,957946,Engler; Adam J.,9996,0,9999,3
1745136990450,CAT 124RS,A01,956906,Staff,8,0,25,17
1745136991478,CAT 125RS,A01,922013,Staff,8,0,25,17
1745136992506,CLRE 250,A00,891860,Morris; Sheldon,9996,0,9999,3
1745136994561,CLRE 251R,A00,907817,Mehta; Ravindra L.,9995,0,9999,4
1745136995589,CLRE 252,A00,891864,Cuomo; Raphael Eduardo,9994,0,9999,5
1745136996616,CLRE 253,A00,891867,Vaida; Florin,9995,0,9999,4
1745136996616,CLRE 253,B00,907819,Staff,9999,0,9999,0
1745136997641,CLRE 259,A00,891868,Patel; Hemal,9998,0,9999,1
1745136998669,CLRE 260,A00,891872,Cuomo; Raphael Eduardo,9999,0,9999,0
1745136999696,CLRE 297,001,891888,Cuomo; Raphael Eduardo,9999,0,9999,0
1745137000721,CSS 201S,A01,892054,Mignozzetti; Umberto,30,0,30,0
1745137001747,CSS 202S,A01,892056,Mignozzetti; Umberto,30,0,30,0
1745137002775,DSC 197,001,956898,Eldridge; Justin Matthew,9998,0,9999,1
1745137003801,DSC 297,001,958000,Mazumdar; Arya,9999,0,9999,0
1745137004830,EAP 100,A00,905686,Staff,9774,0,9999,225
1745137005856,ECE 45,A01,892618,Staff,0,2,50,50
1745137006888,ECE 109,A01,892620,Staff,0,44,0,0
1745137007916,ECE 111,A01,892719,Staff,0,0,50,50
1745137008941,ECE 197,001,957920,Mercier; Patrick Philip,9992,0,9999,7
1745137009968,ECON 178,A01,907814,Zhu; Ying,29,0,35,6
1745137010992,EDS 115,A00,895312,Staff,42,0,45,3
1745137012018,EDS 117,A01,895337,Staff,30,0,30,0
1745137013044,EDS 125,A00,895341,Jones; Gabrielle Anastasia,43,0,45,2
1745137014070,EDS 128A,A01,895459,Fargason; Sharon Gayle,45,0,45,0
1745137015094,EDS 128B,A01,895543,Pappas; Elizabeth,45,0,45,0
1745137016120,EDS 139,A00,897203,Pappas; Elizabeth,45,0,45,0
1745137016120,EDS 139,B00,897209,Fargason; Sharon Gayle,45,0,45,0
1745137017149,EDS 201,A00,895545,Staff,44,0,45,1
1745137018174,EDS 203,A01,895581,Halter; Christopher P.,44,0,45,1
1745137019200,EDS 204R,A01,895625,Heinzman; Erica M.,45,0,45,0
1745137019200,EDS 204R,B01,895693,Halter; Christopher P.,28,0,45,17
1745137020229,EDS 206R,A00,895694,Fargason; Sharon Gayle,22,0,30,8
1745137020229,EDS 206R,B00,895695,Choi; Bailey Miyeon,21,0,30,9
1745137021257,EDS 250,A00,895697,Hemans; Patricia Ann Benitez,44,0,45,1
1745137022284,EDS 281,A00,895701,Meyerott; Theresa Ann,15,0,15,0
1745137023312,EDS 284,A00,895736,Meyerott; Theresa Ann,15,0,15,0
1745137024338,EDS 286,A00,897210,Fine; Sarah,15,0,15,0
1745137025367,EDS 289C,A01,895770,Daly; Alan J.,15,0,15,0
1745137026394,EDS 290,A00,897211,Hofstetter; Carolyn,15,0,15,0
1745137027420,LIGM 5A,A00,896162,Fischer-Grunski; Eva K,16,0,20,4
1745137028447,LIGM 5B,A00,896260,Fischer-Grunski; Eva K,19,0,20,1
1745137029472,LIGM 5C,A00,896308,Fischer-Grunski; Eva K,19,0,20,1
1745137030498,LIIT 5AS,A00,896313,Carnelos; Chiara,18,0,20,2
1745137031524,LIIT 5BS,A00,896416,Carnelos; Chiara,20,0,20,0
1745137032550,LIIT 5CS,A00,896564,Carnelos; Chiara,20,0,20,0
1745137033574,LISP 5A,A00,896588,Munoz Sanchez; Alicia,7,0,20,13
1745137034600,LISP 5B,A00,896653,Munoz Sanchez; Alicia,10,0,20,10
1745137035630,LISP 5C,A00,896655,Munoz Sanchez; Alicia,9,0,20,11
1745137036658,MAE 197,001,957918,Kleissl; Jan,9998,0,9999,1
1745137037684,MATH 2,A01,957937,Staff,34,0,35,1
1745137038710,MATH 197,001,957876,Kedlaya; Kiran S.,9996,0,9999,3
1745137039740,MCWP 40,A00,892729,Duru; Nur,16,0,20,4
1745137039740,MCWP 40,B00,893304,Montejo; Carolina,20,0,20,0
1745137040767,MCWP 40R,A00,893757,Redela; Pamela Morgan,0,3,20,20
1745137041796,MCWP 50,A00,893758,Morshed; Michael James,4,0,20,16
1745137041796,MCWP 50,B00,893761,Bartulis; Jason Michael,18,0,20,2
1745137042826,MCWP 50R,A00,893766,Compas; Sean Matthew,0,1,20,20
1745137042826,MCWP 50R,B00,893769,Carter; Jennifer A,5,0,20,15
1745137042826,MCWP 50R,C00,893771,Krone; Jarret,0,3,20,20
1745137042826,MCWP 50R,D00,893772,Miller; Elizabeth Deen,4,0,20,16
1745137042826,MCWP 50R,E00,893775,Carter; Andrea L,0,0,20,20
1745137043852,MMW 11R,A01,892721,Herbst; Matthew,22,0,30,8
1745137043852,MMW 11R,A02,892722,Herbst; Matthew,28,0,30,2
1745137044877,MMW 12R,A01,892724,Herbst; Matthew,0,4,16,16
1745137044877,MMW 12R,A02,892725,Herbst; Matthew,0,4,16,16
1745137045923,MMW 13R,A01,892727,Staff,0,29,16,16
1745137045923,MMW 13R,A02,892728,Staff,0,28,16,16
1745137046949,SIO 295LS,A00,894015,Staff,9,0,25,16
1745137047975,SIO 295S,A00,894020,Staff,9,0,25,16
1745137049004,SIOC 290S,A01,894063,Merrifield; Mark A,23,0,25,2
1745137050036,SIOC 291S,A01,894137,Gabriel; Corey John,23,0,25,2
1745137051063,SOCI 117,A01,895339,Staff,5,0,5,0
1745137052089,WES 237B,A00,894149,Staff,20,0,20,0
1745137054155,AESE 279B,A00,891859,Staff,35,0,35,0
1745137055184,AIP 197,001,891854,Staff,70,0,70,0
1745137056209,ANTH 289S,A00,891856,Gagneux; Pascal,12,0,12,0
1745137057241,BENG 196,001,957946,Engler; Adam J.,9996,0,9999,3
1745137058269,CAT 124RS,A01,956906,Staff,8,0,25,17
1745137059293,CAT 125RS,A01,922013,Staff,8,0,25,17
1745137060317,CLRE 250,A00,891860,Morris; Sheldon,9996,0,9999,3
1745137062379,CLRE 251R,A00,907817,Mehta; Ravindra L.,9995,0,9999,4
1745137063407,CLRE 252,A00,891864,Cuomo; Raphael Eduardo,9994,0,9999,5
1745137064438,CLRE 253,A00,891867,Vaida; Florin,9995,0,9999,4
1745137064438,CLRE 253,B00,907819,Staff,9999,0,9999,0
1745137065463,CLRE 259,A00,891868,Patel; Hemal,9998,0,9999,1
1745137066488,CLRE 260,A00,891872,Cuomo; Raphael Eduardo,9999,0,9999,0
1745137067516,CLRE 297,001,891888,Cuomo; Raphael Eduardo,9999,0,9999,0
1745137068540,CSS 201S,A01,892054,Mignozzetti; Umberto,30,0,30,0
1745137069566,CSS 202S,A01,892056,Mignozzetti; Umberto,30,0,30,0
1745137070595,DSC 197,001,956898,Eldridge; Justin Matthew,9998,0,9999,1
1745137071622,DSC 297,001,958000,Mazumdar; Arya,9999,0,9999,0
1745137072647,EAP 100,A00,905686,Staff,9774,0,9999,225
1745137073676,ECE 45,A01,892618,Staff,0,2,50,50
1745137074701,ECE 109,A01,892620,Staff,0,44,0,0
1745137075729,ECE 111,A01,892719,Staff,0,0,50,50
1745137076754,ECE 197,001,957920,Mercier; Patrick Philip,9992,0,9999,7
1745137077784,ECON 178,A01,907814,Zhu; Ying,29,0,35,6
1745137078816,EDS 115,A00,895312,Staff,42,0,45,3
1745137079841,EDS 117,A01,895337,Staff,30,0,30,0
1745137080866,EDS 125,A00,895341,Jones; Gabrielle Anastasia,43,0,45,2
1745137081893,EDS 128A,A01,895459,Fargason; Sharon Gayle,45,0,45,0
1745137082921,EDS 128B,A01,895543,Pappas; Elizabeth,45,0,45,0
1745137083948,EDS 139,A00,897203,Pappas; Elizabeth,45,0,45,0
1745137083948,EDS 139,B00,897209,Fargason; Sharon Gayle,45,0,45,0
1745137084972,EDS 201,A00,895545,Staff,44,0,45,1
1745137086001,EDS 203,A01,895581,Halter; Christopher P.,44,0,45,1
1745137087030,EDS 204R,A01,895625,Heinzman; Erica M.,45,0,45,0
1745137087030,EDS 204R,B01,895693,Halter; Christopher P.,28,0,45,17
1745137088056,EDS 206R,A00,895694,Fargason; Sharon Gayle,22,0,30,8
1745137088056,EDS 206R,B00,895695,Choi; Bailey Miyeon,21,0,30,9
1745137089082,EDS 250,A00,895697,Hemans; Patricia Ann Benitez,44,0,45,1
1745137090110,EDS 281,A00,895701,Meyerott; Theresa Ann,15,0,15,0
1745137091136,EDS 284,A00,895736,Meyerott; Theresa Ann,15,0,15,0
1745137092162,EDS 286,A00,897210,Fine; Sarah,15,0,15,0
1745137093190,EDS 289C,A01,895770,Daly; Alan J.,15,0,15,0
1745137094218,EDS 290,A00,897211,Hofstetter; Carolyn,15,0,15,0
1745137095243,LIGM 5A,A00,896162,Fischer-Grunski; Eva K,16,0,20,4
1745137096267,LIGM 5B,A00,896260,Fischer-Grunski; Eva K,19,0,20,1
1745137097293,LIGM 5C,A00,896308,Fischer-Grunski; Eva K,19,0,20,1
1745137098318,LIIT 5AS,A00,896313,Carnelos; Chiara,18,0,20,2
1745137099344,LIIT 5BS,A00,896416,Carnelos; Chiara,20,0,20,0
1745137100370,LIIT 5CS,A00,896564,Carnelos; Chiara,20,0,20,0
1745137101397,LISP 5A,A00,896588,Munoz Sanchez; Alicia,7,0,20,13
1745137102425,LISP 5B,A00,896653,Munoz Sanchez; Alicia,10,0,20,10
1745137103454,LISP 5C,A00,896655,Munoz Sanchez; Alicia,9,0,20,11
1745137104482,MAE 197,001,957918,Kleissl; Jan,9998,0,9999,1
1745137105509,MATH 2,A01,957937,Staff,34,0,35,1
1745137106537,MATH 197,001,957876,Kedlaya; Kiran S.,9996,0,9999,3
1745137107566,MCWP 40,A00,892729,Duru; Nur,16,0,20,4
1745137107566,MCWP 40,B00,893304,Montejo; Carolina,20,0,20,0
1745137108594,MCWP 40R,A00,893757,Redela; Pamela Morgan,0,3,20,20
1745137109624,MCWP 50,A00,893758,Morshed; Michael James,4,0,20,16
1745137109624,MCWP 50,B00,893761,Bartulis; Jason Michael,18,0,20,2
1745137110654,MCWP 50R,A00,893766,Compas; Sean Matthew,0,1,20,20
1745137110654,MCWP 50R,B00,893769,Carter; Jennifer A,5,0,20,15
1745137110654,MCWP 50R,C00,893771,Krone; Jarret,0,3,20,20
1745137110654,MCWP 50R,D00,893772,Miller; Elizabeth Deen,4,0,20,16
1745137110654,MCWP 50R,E00,893775,Carter; Andrea L,0,0,20,20
1745137111678,MMW 11R,A01,892721,Herbst; Matthew,22,0,30,8
1745137111678,MMW 11R,A02,892722,Herbst; Matthew,28,0,30,2
1745137112705,MMW 12R,A01,892724,Herbst; Matthew,0,4,16,16
1745137112705,MMW 12R,A02,892725,Herbst; Matthew,0,4,16,16
1745137113730,MMW 13R,A01,892727,Staff,0,29,16,16
1745137113730,MMW 13R,A02,892728,Staff,0,28,16,16
1745137114755,SIO 295LS,A00,894015,Staff,9,0,25,16
1745137115781,SIO 295S,A00,894020,Staff,9,0,25,16
1745137116808,SIOC 290S,A01,894063,Merrifield; Mark A,23,0,25,2
1745137117834,SIOC 291S,A01,894137,Gabriel; Corey John,23,0,25,2
1745137118860,SOCI 117,A01,895339,Staff,5,0,5,0
1745137119886,WES 237B,A00,894149,Staff,20,0,20,0
1745137121953,AESE 279B,A00,891859,Staff,35,0,35,0
1745137122980,AIP 197,001,891854,Staff,70,0,70,0
1745137124008,ANTH 289S,A00,891856,Gagneux; Pascal,12,0,12,0
1745137125032,BENG 196,001,957946,Engler; Adam J.,9996,0,9999,3
1745137126060,CAT 124RS,A01,956906,Staff,8,0,25,17
1745137127085,CAT 125RS,A01,922013,Staff,8,0,25,17
1745137128111,CLRE 250,A00,891860,Morris; Sheldon,9996,0,9999,3
1745137130162,CLRE 251R,A00,907817,Mehta; Ravindra L.,9995,0,9999,4
1745137131186,CLRE 252,A00,891864,Cuomo; Raphael Eduardo,9994,0,9999,5
1745137132212,CLRE 253,A00,891867,Vaida; Florin,9995,0,9999,4
1745137132212,CLRE 253,B00,907819,Staff,9999,0,9999,0
1745137133240,CLRE 259,A00,891868,Patel; Hemal,9998,0,9999,1
1745137134263,CLRE 260,A00,891872,Cuomo; Raphael Eduardo,9999,0,9999,0
1745137135289,CLRE 297,001,891888,Cuomo; Raphael Eduardo,9999,0,9999,0
1745137136315,CSS 201S,A01,892054,Mignozzetti; Umberto,30,0,30,0
1745137137345,CSS 202S,A01,892056,Mignozzetti; Umberto,30,0,30,0
1745137138370,DSC 197,001,956898,Eldridge; Justin Matthew,9998,0,9999,1
1745137139400,DSC 297,001,958000,Mazumdar; Arya,9999,0,9999,0
1745137140425,EAP 100,A00,905686,Staff,9774,0,9999,225
1745137141452,ECE 45,A01,892618,Staff,0,2,50,50
1745137142481,ECE 109,A01,892620,Staff,0,44,0,0
1745137143506,ECE 111,A01,892719,Staff,0,0,50,50
1745137144533,ECE 197,001,957920,Mercier; Patrick Philip,9992,0,9999,7
1745137145561,ECON 178,A01,907814,Zhu; Ying,29,0,35,6
1745137146590,EDS 115,A00,895312,Staff,42,0,45,3
1745137147617,EDS 117,A01,895337,Staff,30,0,30,0
1745137148645,EDS 125,A00,895341,Jones; Gabrielle Anastasia,43,0,45,2
1745137149675,EDS 128A,A01,895459,Fargason; Sharon Gayle,45,0,45,0
1745137150701,EDS 128B,A01,895543,Pappas; Elizabeth,45,0,45,0
1745137151728,EDS 139,A00,897203,Pappas; Elizabeth,45,0,45,0
1745137151728,EDS 139,B00,897209,Fargason; Sharon Gayle,45,0,45,0
1745137152753,EDS 201,A00,895545,Staff,44,0,45,1
1745137153782,EDS 203,A01,895581,Halter; Christopher P.,44,0,45,1
1745137154809,EDS 204R,A01,895625,Heinzman; Erica M.,45,0,45,0
1745137154809,EDS 204R,B01,895693,Halter; Christopher P.,28,0,45,17
1745137155838,EDS 206R,A00,895694,Fargason; Sharon Gayle,22,0,30,8
1745137155838,EDS 206R,B00,895695,Choi; Bailey Miyeon,21,0,30,9
1745137156867,EDS 250,A00,895697,Hemans; Patricia Ann Benitez,44,0,45,1
1745137157892,EDS 281,A00,895701,Meyerott; Theresa Ann,15,0,15,0
1745137158919,EDS 284,A00,895736,Meyerott; Theresa Ann,15,0,15,0
1745137159947,EDS 286,A00,897210,Fine; Sarah,15,0,15,0
1745137160974,EDS 289C,A01,895770,Daly; Alan J.,15,0,15,0
1745137162005,EDS 290,A00,897211,Hofstetter; Carolyn,15,0,15,0
1745137163034,LIGM 5A,A00,896162,Fischer-Grunski; Eva K,16,0,20,4
1745137164062,LIGM 5B,A00,896260,Fischer-Grunski; Eva K,19,0,20,1
1745137165088,LIGM 5C,A00,896308,Fischer-Grunski; Eva K,19,0,20,1
1745137166113,LIIT 5AS,A00,896313,Carnelos; Chiara,18,0,20,2
1745137167144,LIIT 5BS,A00,896416,Carnelos; Chiara,20,0,20,0
1745137168170,LIIT 5CS,A00,896564,Carnelos; Chiara,20,0,20,0
1745137169200,LISP 5A,A00,896588,Munoz Sanchez; Alicia,7,0,20,13
1745137170226,LISP 5B,A00,896653,Munoz Sanchez; Alicia,10,0,20,10
1745137171256,LISP 5C,A00,896655,Munoz Sanchez; Alicia,9,0,20,11
1745137172283,MAE 197,001,957918,Kleissl; Jan,9998,0,9999,1
1745137173312,MATH 2,A01,957937,Staff,34,0,35,1
1745137174338,MATH 197,001,957876,Kedlaya; Kiran S.,9996,0,9999,3
1745137175368,MCWP 40,A00,892729,Duru; Nur,16,0,20,4
1745137175368,MCWP 40,B00,893304,Montejo; Carolina,20,0,20,0
1745137176394,MCWP 40R,A00,893757,Redela; Pamela Morgan,0,3,20,20
1745137177419,MCWP 50,A00,893758,Morshed; Michael James,4,0,20,16
1745137177419,MCWP 50,B00,893761,Bartulis; Jason Michael,18,0,20,2
1745137178444,MCWP 50R,A00,893766,Compas; Sean Matthew,0,1,20,20
1745137178444,MCWP 50R,B00,893769,Carter; Jennifer A,5,0,20,15
1745137178444,MCWP 50R,C00,893771,Krone; Jarret,0,3,20,20
1745137178444,MCWP 50R,D00,893772,Miller; Elizabeth Deen,4,0,20,16
1745137178444,MCWP 50R,E00,893775,Carter; Andrea L,0,0,20,20
1745137179472,MMW 11R,A01,892721,Herbst; Matthew,22,0,30,8
1745137179472,MMW 11R,A02,892722,Herbst; Matthew,28,0,30,2
1745137180498,MMW 12R,A01,892724,Herbst; Matthew,0,5,16,16
1745137180498,MMW 12R,A02,892725,Herbst; Matthew,0,4,16,16
1745137181525,MMW 13R,A01,892727,Staff,0,29,16,16
1745137181525,MMW 13R,A02,892728,Staff,0,28,16,16
1745137182548,SIO 295LS,A00,894015,Staff,9,0,25,16
1745137183573,SIO 295S,A00,894020,Staff,9,0,25,16
1745137184602,SIOC 290S,A01,894063,Merrifield; Mark A,23,0,25,2
1745137185632,SIOC 291S,A01,894137,Gabriel; Corey John,23,0,25,2
1745137186657,SOCI 117,A01,895339,Staff,5,0,5,0
1745137187684,WES 237B,A00,894149,Staff,20,0,20,0
1745137189758,AESE 279B,A00,891859,Staff,35,0,35,0
1745137190785,AIP 197,001,891854,Staff,70,0,70,0
1745137191811,ANTH 289S,A00,891856,Gagneux; Pascal,12,0,12,0
1745137192838,BENG 196,001,957946,Engler; Adam J.,9996,0,9999,3
1745137193867,CAT 124RS,A01,956906,Staff,8,0,25,17
1745137194893,CAT 125RS,A01,922013,Staff,8,0,25,17
1745137195919,CLRE 250,A00,891860,Morris; Sheldon,9996,0,9999,3
1745137197974,CLRE 251R,A00,907817,Mehta; Ravindra L.,9995,0,9999,4
1745137199001,CLRE 252,A00,891864,Cuomo; Raphael Eduardo,9994,0,9999,5
1745137200027,CLRE 253,A00,891867,Vaida; Florin,9995,0,9999,4
1745137200027,CLRE 253,B00,907819,Staff,9999,0,9999,0
1745137201054,CLRE 259,A00,891868,Patel; Hemal,9998,0,9999,1
1745137202078,CLRE 260,A00,891872,Cuomo; Raphael Eduardo,9999,0,9999,0
1745137203102,CLRE 297,001,891888,Cuomo; Raphael Eduardo,9999,0,9999,0
1745137204132,CSS 201S,A01,892054,Mignozzetti; Umberto,30,0,30,0
1745137205156,CSS 202S,A01,892056,Mignozzetti; Umberto,30,0,30,0
1745137206185,DSC 197,001,956898,Eldridge; Justin Matthew,9998,0,9999,1
1745137207212,DSC 297,001,958000,Mazumdar; Arya,9999,0,9999,0
1745137208237,EAP 100,A00,905686,Staff,9774,0,9999,225
1745137209264,ECE 45,A01,892618,Staff,0,2,50,50
1745137210290,ECE 109,A01,892620,Staff,0,44,0,0
1745137211316,ECE 111,A01,892719,Staff,0,0,50,50
1745137212342,ECE 197,001,957920,Mercier; Patrick Philip,9992,0,9999,7
1745137213368,ECON 178,A01,907814,Zhu; Ying,29,0,35,6
1745137214396,EDS 115,A00,895312,Staff,42,0,45,3
1745137215420,EDS 117,A01,895337,Staff,30,0,30,0
1745137216445,EDS 125,A00,895341,Jones; Gabrielle Anastasia,43,0,45,2
1745137217473,EDS 128A,A01,895459,Fargason; Sharon Gayle,45,0,45,0
1745137218498,EDS 128B,A01,895543,Pappas; Elizabeth,45,0,45,0
1745137219524,EDS 139,A00,897203,Pappas; Elizabeth,45,0,45,0
1745137219524,EDS 139,B00,897209,Fargason; Sharon Gayle,45,0,45,0
1745137220548,EDS 201,A00,895545,Staff,44,0,45,1
1745137221576,EDS 203,A01,895581,Halter; Christopher P.,44,0,45,1
1745137222606,EDS 204R,A01,895625,Heinzman; Erica M.,45,0,45,0
1745137222606,EDS 204R,B01,895693,Halter; Christopher P.,28,0,45,17
1745137223630,EDS 206R,A00,895694,Fargason; Sharon Gayle,22,0,30,8
1745137223630,EDS 206R,B00,895695,Choi; Bailey Miyeon,21,0,30,9
1745137224661,EDS 250,A00,895697,Hemans; Patricia Ann Benitez,44,0,45,1
1745137225687,EDS 281,A00,895701,Meyerott; Theresa Ann,15,0,15,0
1745137226712,EDS 284,A00,895736,Meyerott; Theresa Ann,15,0,15,0
1745137227738,EDS 286,A00,897210,Fine; Sarah,15,0,15,0
1745137228764,EDS 289C,A01,895770,Daly; Alan J.,15,0,15,0
1745137229794,EDS 290,A00,897211,Hofstetter; Carolyn,15,0,15,0
1745137230819,LIGM 5A,A00,896162,Fischer-Grunski; Eva K,16,0,20,4
1745137231844,LIGM 5B,A00,896260,Fischer-Grunski; Eva K,19,0,20,1
1745137232870,LIGM 5C,A00,896308,Fischer-Grunski; Eva K,19,0,20,1
1745137233896,LIIT 5AS,A00,896313,Carnelos; Chiara,18,0,20,2
1745137234922,LIIT 5BS,A00,896416,Carnelos; Chiara,20,0,20,0
1745137235946,LIIT 5CS,A00,896564,Carnelos; Chiara,20,0,20,0
1745137236976,LISP 5A,A00,896588,Munoz Sanchez; Alicia,7,0,20,13
1745137238003,LISP 5B,A00,896653,Munoz Sanchez; Alicia,10,0,20,10
1745137239027,LISP 5C,A00,896655,Munoz Sanchez; Alicia,9,0,20,11
1745137240053,MAE 197,001,957918,Kleissl; Jan,9998,0,9999,1
1745137241078,MATH 2,A01,957937,Staff,34,0,35,1
1745137242102,MATH 197,001,957876,Kedlaya; Kiran S.,9996,0,9999,3
1745137243128,MCWP 40,A00,892729,Duru; Nur,16,0,20,4
1745137243128,MCWP 40,B00,893304,Montejo; Carolina,20,0,20,0
1745137244156,MCWP 40R,A00,893757,Redela; Pamela Morgan,0,3,20,20
1745137245184,MCWP 50,A00,893758,Morshed; Michael James,4,0,20,16
1745137245184,MCWP 50,B00,893761,Bartulis; Jason Michael,18,0,20,2
1745137246210,MCWP 50R,A00,893766,Compas; Sean Matthew,0,1,20,20
1745137246210,MCWP 50R,B00,893769,Carter; Jennifer A,5,0,20,15
1745137246210,MCWP 50R,C00,893771,Krone; Jarret,0,3,20,20
1745137246210,MCWP 50R,D00,893772,Miller; Elizabeth Deen,4,0,20,16
1745137246210,MCWP 50R,E00,893775,Carter; Andrea L,0,0,20,20
1745137247276,MMW 11R,A01,892721,Herbst; Matthew,22,0,30,8
1745137247276,MMW 11R,A02,892722,Herbst; Matthew,28,0,30,2
1745137248302,MMW 12R,A01,892724,Herbst; Matthew,0,5,16,16
1745137248302,MMW 12R,A02,892725,Herbst; Matthew,0,4,16,16
1745137249328,MMW 13R,A01,892727,Staff,0,29,16,16
1745137249328,MMW 13R,A02,892728,Staff,0,28,16,16
1745137250353,SIO 295LS,A00,894015,Staff,9,0,25,16
1745137251380,SIO 295S,A00,894020,Staff,9,0,25,16
1745137252407,SIOC 290S,A01,894063,Merrifield; Mark A,23,0,25,2
1745137253433,SIOC 291S,A01,894137,Gabriel; Corey John,23,0,25,2
1745137254459,SOCI 117,A01,895339,Staff,5,0,5,0
1745137255490,WES 237B,A00,894149,Staff,20,0,20,0
1745137257559,AESE 279B,A00,891859,Staff,35,0,35,0
1745137258583,AIP 197,001,891854,Staff,70,0,70,0
1745137259612,ANTH 289S,A00,891856,Gagneux; Pascal,12,0,12,0
1745137260640,BENG 196,001,957946,Engler; Adam J.,9996,0,9999,3
1745137261666,CAT 124RS,A01,956906,Staff,8,0,25,17
1745137262693,CAT 125RS,A01,922013,Staff,8,0,25,17
1745137263719,CLRE 250,A00,891860,Morris; Sheldon,9996,0,9999,3
1745137265773,CLRE 251R,A00,907817,Mehta; Ravindra L.,9995,0,9999,4
1745137266802,CLRE 252,A00,891864,Cuomo; Raphael Eduardo,9994,0,9999,5
1745137267825,CLRE 253,A00,891867,Vaida; Florin,9995,0,9999,4
1745137267825,CLRE 253,B00,907819,Staff,9999,0,9999,0
1745137268851,CLRE 259,A00,891868,Patel; Hemal,9998,0,9999,1
1745137269879,CLRE 260,A00,891872,Cuomo; Raphael Eduardo,9999,0,9999,0
1745137270903,CLRE 297,001,891888,Cuomo; Raphael Eduardo,9999,0,9999,0
1745137271933,CSS 201S,A01,892054,Mignozzetti; Umberto,30,0,30,0
1745137272962,CSS 202S,A01,892056,Mignozzetti; Umberto,30,0,30,0
1745137273989,DSC 197,001,956898,Eldridge; Justin Matthew,9998,0,9999,1
1745137275016,DSC 297,001,958000,Mazumdar; Arya,9999,0,9999,0
1745137276041,EAP 100,A00,905686,Staff,9774,0,9999,225
1745137277070,ECE 45,A01,892618,Staff,0,2,50,50
1745137278098,ECE 109,A01,892620,Staff,0,44,0,0
1745137279124,ECE 111,A01,892719,Staff,0,0,50,50
1745137280151,ECE 197,001,957920,Mercier; Patrick Philip,9992,0,9999,7
1745137281177,ECON 178,A01,907814,Zhu; Ying,29,0,35,6
1745137282202,EDS 115,A00,895312,Staff,42,0,45,3
1745137283226,EDS 117,A01,895337,Staff,30,0,30,0
1745137284252,EDS 125,A00,895341,Jones; Gabrielle Anastasia,43,0,45,2
1745137285280,EDS 128A,A01,895459,Fargason; Sharon Gayle,45,0,45,0
1745137286304,EDS 128B,A01,895543,Pappas; Elizabeth,45,0,45,0
1745137287329,EDS 139,A00,897203,Pappas; Elizabeth,45,0,45,0
1745137287329,EDS 139,B00,897209,Fargason; Sharon Gayle,45,0,45,0
1745137288356,EDS 201,A00,895545,Staff,44,0,45,1
1745137289383,EDS 203,A01,895581,Halter; Christopher P.,44,0,45,1
1745137290408,EDS 204R,A01,895625,Heinzman; Erica M.,45,0,45,0
1745137290408,EDS 204R,B01,895693,Halter; Christopher P.,28,0,45,17
1745137291436,EDS 206R,A00,895694,Fargason; Sharon Gayle,22,0,30,8
1745137291436,EDS 206R,B00,895695,Choi; Bailey Miyeon,21,0,30,9
1745137292460,EDS 250,A00,895697,Hemans; Patricia Ann Benitez,44,0,45,1
1745137293488,EDS 281,A00,895701,Meyerott; Theresa Ann,15,0,15,0
1745137294516,EDS 284,A00,895736,Meyerott; Theresa Ann,15,0,15,0
1745137295541,EDS 286,A00,897210,Fine; Sarah,15,0,15,0
1745137296567,EDS 289C,A01,895770,Daly; Alan J.,15,0,15,0
1745137297595,EDS 290,A00,897211,Hofstetter; Carolyn,15,0,15,0
1745137298622,LIGM 5A,A00,896162,Fischer-Grunski; Eva K,16,0,20,4
1745137299646,LIGM 5B,A00,896260,Fischer-Grunski; Eva K,19,0,20,1
1745137300671,LIGM 5C,A00,896308,Fischer-Grunski; Eva K,19,0,20,1
1745137301699,LIIT 5AS,A00,896313,Carnelos; Chiara,18,0,20,2
1745137302724,LIIT 5BS,A00,896416,Carnelos; Chiara,20,0,20,0
1745137303752,LIIT 5CS,A00,896564,Carnelos; Chiara,20,0,20,0
1745137304778,LISP 5A,A00,896588,Munoz Sanchez; Alicia,7,0,20,13
1745137305803,LISP 5B,A00,896653,Munoz Sanchez; Alicia,10,0,20,10
1745137306829,LISP 5C,A00,896655,Munoz Sanchez; Alicia,9,0,20,11
1745137307855,MAE 197,001,957918,Kleissl; Jan,9998,0,9999,1
1745137308883,MATH 2,A01,957937,Staff,34,0,35,1
1745137309910,MATH 197,001,957876,Kedlaya; Kiran S.,9996,0,9999,3
1745137310936,MCWP 40,A00,892729,Duru; Nur,16,0,20,4
1745137310936,MCWP 40,B00,893304,Montejo; Carolina,20,0,20,0
1745137311962,MCWP 40R,A00,893757,Redela; Pamela Morgan,0,3,20,20
1745137312988,MCWP 50,A00,893758,Morshed; Michael James,4,0,20,16
1745137312988,MCWP 50,B00,893761,Bartulis; Jason Michael,18,0,20,2
1745137314013,MCWP 50R,A00,893766,Compas; Sean Matthew,0,1,20,20
1745137314013,MCWP 50R,B00,893769,Carter; Jennifer A,5,0,20,15
1745137314013,MCWP 50R,C00,893771,Krone; Jarret,0,3,20,20
1745137314013,MCWP 50R,D00,893772,Miller; Elizabeth Deen,4,0,20,16
1745137314013,MCWP 50R,E00,893775,Carter; Andrea L,0,0,20,20
1745137315038,MMW 11R,A01,892721,Herbst; Matthew,22,0,30,8
1745137315038,MMW 11R,A02,892722,Herbst; Matthew,28,0,30,2
1745137316064,MMW 12R,A01,892724,Herbst; Matthew,0,5,16,16
1745137316064,MMW 12R,A02,892725,Herbst; Matthew,0,4,16,16
1745137317087,MMW 13R,A01,892727,Staff,0,29,16,16
1745137317087,MMW 13R,A02,892728,Staff,0,28,16,16
1745137318112,SIO 295LS,A00,894015,Staff,9,0,25,16
1745137319142,SIO 295S,A00,894020,Staff,9,0,25,16
1745137320167,SIOC 290S,A01,894063,Merrifield; Mark A,23,0,25,2
1745137321192,SIOC 291S,A01,894137,Gabriel; Corey John,23,0,25,2
1745137322220,SOCI 117,A01,895339,Staff,5,0,5,0
1745137323247,WES 237B,A00,894149,Staff,20,0,20,0
1745137325359,AESE 279B,A00,891859,Staff,35,0,35,0
1745137326387,AIP 197,001,891854,Staff,70,0,70,0
1745137327412,ANTH 289S,A00,891856,Gagneux; Pascal,12,0,12,0
1745137328437,BENG 196,001,957946,Engler; Adam J.,9996,0,9999,3
1745137329463,CAT 124RS,A01,956906,Staff,8,0,25,17
1745137330488,CAT 125RS,A01,922013,Staff,8,0,25,17
1745137331512,CLRE 250,A00,891860,Morris; Sheldon,9996,0,9999,3
1745137333565,CLRE 251R,A00,907817,Mehta; Ravindra L.,9995,0,9999,4
1745137334592,CLRE 252,A00,891864,Cuomo; Raphael Eduardo,9994,0,9999,5
1745137335620,CLRE 253,A00,891867,Vaida; Florin,9995,0,9999,4
1745137335620,CLRE 253,B00,907819,Staff,9999,0,9999,0
1745137336646,CLRE 259,A00,891868,Patel; Hemal,9998,0,9999,1
1745137337674,CLRE 260,A00,891872,Cuomo; Raphael Eduardo,9999,0,9999,0
1745137338700,CLRE 297,001,891888,Cuomo; Raphael Eduardo,9999,0,9999,0
1745137339730,CSS 201S,A01,892054,Mignozzetti; Umberto,30,0,30,0
1745137340755,CSS 202S,A01,892056,Mignozzetti; Umberto,30,0,30,0
1745137341780,DSC 197,001,956898,Eldridge; Justin Matthew,9998,0,9999,1
1745137342817,DSC 297,001,958000,Mazumdar; Arya,9999,0,9999,0
1745137343844,EAP 100,A00,905686,Staff,9774,0,9999,225
1745137344869,ECE 45,A01,892618,Staff,0,2,50,50
1745137345897,ECE 109,A01,892620,Staff,0,44,0,0
1745137346923,ECE 111,A01,892719,Staff,0,0,50,50
1745137347949,ECE 197,001,957920,Mercier; Patrick Philip,9992,0,9999,7
1745137348973,ECON 178,A01,907814,Zhu; Ying,29,0,35,6
1745137349997,EDS 115,A00,895312,Staff,42,0,45,3
1745137351024,EDS 117,A01,895337,Staff,30,0,30,0
1745137352051,EDS 125,A00,895341,Jones; Gabrielle Anastasia,43,0,45,2
1745137353077,EDS 128A,A01,895459,Fargason; Sharon Gayle,45,0,45,0
1745137354104,EDS 128B,A01,895543,Pappas; Elizabeth,45,0,45,0
1745137355131,EDS 139,A00,897203,Pappas; Elizabeth,45,0,45,0
1745137355131,EDS 139,B00,897209,Fargason; Sharon Gayle,45,0,45,0
1745137356156,EDS 201,A00,895545,Staff,44,0,45,1
1745137357181,EDS 203,A01,895581,Halter; Christopher P.,44,0,45,1
1745137358207,EDS 204R,A01,895625,Heinzman; Erica M.,45,0,45,0
1745137358207,EDS 204R,B01,895693,Halter; Christopher P.,28,0,45,17
1745137359233,EDS 206R,A00,895694,Fargason; Sharon Gayle,22,0,30,8
1745137359233,EDS 206R,B00,895695,Choi; Bailey Miyeon,21,0,30,9
1745137360258,EDS 250,A00,895697,Hemans; Patricia Ann Benitez,44,0,45,1
1745137361286,EDS 281,A00,895701,Meyerott; Theresa Ann,15,0,15,0
1745137362312,EDS 284,A00,895736,Meyerott; Theresa Ann,15,0,15,0
1745137363335,EDS 286,A00,897210,Fine; Sarah,15,0,15,0
1745137364364,EDS 289C,A01,895770,Daly; Alan J.,15,0,15,0
1745137365388,EDS 290,A00,897211,Hofstetter; Carolyn,15,0,15,0
1745137366413,LIGM 5A,A00,896162,Fischer-Grunski; Eva K,16,0,20,4
1745137367438,LIGM 5B,A00,896260,Fischer-Grunski; Eva K,19,0,20,1
1745137368470,LIGM 5C,A00,896308,Fischer-Grunski; Eva K,19,0,20,1
1745137369494,LIIT 5AS,A00,896313,Carnelos; Chiara,18,0,20,2
1745137370519,LIIT 5BS,A00,896416,Carnelos; Chiara,20,0,20,0
1745137371545,LIIT 5CS,A00,896564,Carnelos; Chiara,20,0,20,0
1745137372570,LISP 5A,A00,896588,Munoz Sanchez; Alicia,7,0,20,13
1745137373598,LISP 5B,A00,896653,Munoz Sanchez; Alicia,10,0,20,10
1745137374629,LISP 5C,A00,896655,Munoz Sanchez; Alicia,9,0,20,11
1745137375654,MAE 197,001,957918,Kleissl; Jan,9998,0,9999,1
1745137376678,MATH 2,A01,957937,Staff,34,0,35,1
1745137377703,MATH 197,001,957876,Kedlaya; Kiran S.,9996,0,9999,3
1745137378727,MCWP 40,A00,892729,Duru; Nur,16,0,20,4
1745137378727,MCWP 40,B00,893304,Montejo; Carolina,20,0,20,0
1745137379752,MCWP 40R,A00,893757,Redela; Pamela Morgan,0,3,20,20
1745137380780,MCWP 50,A00,893758,Morshed; Michael James,4,0,20,16
1745137380780,MCWP 50,B00,893761,Bartulis; Jason Michael,18,0,20,2
1745137381809,MCWP 50R,A00,893766,Compas; Sean Matthew,0,1,20,20
1745137381809,MCWP 50R,B00,893769,Carter; Jennifer A,5,0,20,15
1745137381809,MCWP 50R,C00,893771,Krone; Jarret,0,3,20,20
1745137381809,MCWP 50R,D00,893772,Miller; Elizabeth Deen,4,0,20,16
1745137381809,MCWP 50R,E00,893775,Carter; Andrea L,0,0,20,20
1745137382834,MMW 11R,A01,892721,Herbst; Matthew,22,0,30,8
1745137382834,MMW 11R,A02,892722,Herbst; Matthew,28,0,30,2
1745137383861,MMW 12R,A01,892724,Herbst; Matthew,0,5,16,16
1745137383861,MMW 12R,A02,892725,Herbst; Matthew,0,4,16,16
1745137384885,MMW 13R,A01,892727,Staff,0,29,16,16
1745137384885,MMW 13R,A02,892728,Staff,0,28,16,16
1745137385912,SIO 295LS,A00,894015,Staff,9,0,25,16
1745137386938,SIO 295S,A00,894020,Staff,9,0,25,16
1745137387962,SIOC 290S,A01,894063,Merrifield; Mark A,23,0,25,2
1745137388988,SIOC 291S,A01,894137,Gabriel; Corey John,23,0,25,2
1745137390013,SOCI 117,A01,895339,Staff,5,0,5,0
1745137391038,WES 237B,A00,894149,Staff,20,0,20,0
1745137393100,AESE 279B,A00,891859,Staff,35,0,35,0
1745137394127,AIP 197,001,891854,Staff,70,0,70,0
1745137395155,ANTH 289S,A00,891856,Gagneux; Pascal,12,0,12,0
1745137396183,BENG 196,001,957946,Engler; Adam J.,9996,0,9999,3
1745137397208,CAT 124RS,A01,956906,Staff,8,0,25,17
1745137398232,CAT 125RS,A01,922013,Staff,8,0,25,17
1745137399259,CLRE 250,A00,891860,Morris; Sheldon,9996,0,9999,3
1745137401311,CLRE 251R,A00,907817,Mehta; Ravindra L.,9995,0,9999,4
1745137402338,CLRE 252,A00,891864,Cuomo; Raphael Eduardo,9994,0,9999,5
1745137403364,CLRE 253,A00,891867,Vaida; Florin,9995,0,9999,4
1745137403364,CLRE 253,B00,907819,Staff,9999,0,9999,0
1745137404390,CLRE 259,A00,891868,Patel; Hemal,9998,0,9999,1
1745137405418,CLRE 260,A00,891872,Cuomo; Raphael Eduardo,9999,0,9999,0
1745137406442,CLRE 297,001,891888,Cuomo; Raphael Eduardo,9999,0,9999,0
1745137407472,CSS 201S,A01,892054,Mignozzetti; Umberto,30,0,30,0
1745137408501,CSS 202S,A01,892056,Mignozzetti; Umberto,30,0,30,0
1745137409526,DSC 197,001,956898,Eldridge; Justin Matthew,9998,0,9999,1
1745137410549,DSC 297,001,958000,Mazumdar; Arya,9999,0,9999,0
1745137411575,EAP 100,A00,905686,Staff,9774,0,9999,225
1745137412600,ECE 45,A01,892618,Staff,0,2,50,50
1745137413626,ECE 109,A01,892620,Staff,0,44,0,0
1745137414651,ECE 111,A01,892719,Staff,0,0,50,50
1745137415676,ECE 197,001,957920,Mercier; Patrick Philip,9992,0,9999,7
1745137416701,ECON 178,A01,907814,Zhu; Ying,29,0,35,6
1745137417726,EDS 115,A00,895312,Staff,42,0,45,3
1745137418752,EDS 117,A01,895337,Staff,30,0,30,0
1745137419779,EDS 125,A00,895341,Jones; Gabrielle Anastasia,43,0,45,2
1745137420806,EDS 128A,A01,895459,Fargason; Sharon Gayle,45,0,45,0
1745137421831,EDS 128B,A01,895543,Pappas; Elizabeth,45,0,45,0
1745137422857,EDS 139,A00,897203,Pappas; Elizabeth,45,0,45,0
1745137422857,EDS 139,B00,897209,Fargason; Sharon Gayle,45,0,45,0
1745137423884,EDS 201,A00,895545,Staff,44,0,45,1
1745137424911,EDS 203,A01,895581,Halter; Christopher P.,44,0,45,1
1745137425936,EDS 204R,A01,895625,Heinzman; Erica M.,45,0,45,0
1745137425936,EDS 204R,B01,895693,Halter; Christopher P.,28,0,45,17
1745137426961,EDS 206R,A00,895694,Fargason; Sharon Gayle,22,0,30,8
1745137426961,EDS 206R,B00,895695,Choi; Bailey Miyeon,21,0,30,9
1745137427984,EDS 250,A00,895697,Hemans; Patricia Ann Benitez,44,0,45,1
1745137429009,EDS 281,A00,895701,Meyerott; Theresa Ann,15,0,15,0
1745137430035,EDS 284,A00,895736,Meyerott; Theresa Ann,15,0,15,0
1745137431063,EDS 286,A00,897210,Fine; Sarah,15,0,15,0
1745137432089,EDS 289C,A01,895770,Daly; Alan J.,15,0,15,0
1745137433116,EDS 290,A00,897211,Hofstetter; Carolyn,15,0,15,0
1745137434139,LIGM 5A,A00,896162,Fischer-Grunski; Eva K,16,0,20,4
1745137435165,LIGM 5B,A00,896260,Fischer-Grunski; Eva K,19,0,20,1
1745137436190,LIGM 5C,A00,896308,Fischer-Grunski; Eva K,19,0,20,1
1745137437216,LIIT 5AS,A00,896313,Carnelos; Chiara,18,0,20,2
1745137438243,LIIT 5BS,A00,896416,Carnelos; Chiara,20,0,20,0
1745137439272,LIIT 5CS,A00,896564,Carnelos; Chiara,20,0,20,0
1745137440300,LISP 5A,A00,896588,Munoz Sanchez; Alicia,7,0,20,13
1745137441326,LISP 5B,A00,896653,Munoz Sanchez; Alicia,10,0,20,10
1745137442353,LISP 5C,A00,896655,Munoz Sanchez; Alicia,9,0,20,11
1745137443378,MAE 197,001,957918,Kleissl; Jan,9998,0,9999,1
1745137444404,MATH 2,A01,957937,Staff,34,0,35,1
1745137445430,MATH 197,001,957876,Kedlaya; Kiran S.,9996,0,9999,3
1745137446508,MCWP 40,A00,892729,Duru; Nur,16,0,20,4
1745137446508,MCWP 40,B00,893304,Montejo; Carolina,20,0,20,0
1745137447535,MCWP 40R,A00,893757,Redela; Pamela Morgan,0,3,20,20
1745137448559,MCWP 50,A00,893758,Morshed; Michael James,4,0,20,16
1745137448559,MCWP 50,B00,893761,Bartulis; Jason Michael,18,0,20,2
1745137449585,MCWP 50R,A00,893766,Compas; Sean Matthew,0,1,20,20
1745137449585,MCWP 50R,B00,893769,Carter; Jennifer A,5,0,20,15
1745137449585,MCWP 50R,C00,893771,Krone; Jarret,0,3,20,20
1745137449585,MCWP 50R,D00,893772,Miller; Elizabeth Deen,4,0,20,16
1745137449585,MCWP 50R,E00,893775,Carter; Andrea L,0,0,20,20
1745137450609,MMW 11R,A01,892721,Herbst; Matthew,22,0,30,8
1745137450609,MMW 11R,A02,892722,Herbst; Matthew,28,0,30,2
1745137451638,MMW 12R,A01,892724,Herbst; Matthew,0,5,16,16
1745137451638,MMW 12R,A02,892725,Herbst; Matthew,0,4,16,16
1745137452665,MMW 13R,A01,892727,Staff,0,29,16,16
1745137452665,MMW 13R,A02,892728,Staff,0,28,16,16
1745137453693,SIO 295LS,A00,894015,Staff,9,0,25,16
1745137454719,SIO 295S,A00,894020,Staff,9,0,25,16
1745137455745,SIOC 290S,A01,894063,Merrifield; Mark A,23,0,25,2
1745137456771,SIOC 291S,A01,894137,Gabriel; Corey John,23,0,25,2
1745137457797,SOCI 117,A01,895339,Staff,5,0,5,0
1745137458824,WES 237B,A00,894149,Staff,20,0,20,0
1745137460907,AESE 279B,A00,891859,Staff,35,0,35,0
1745137461932,AIP 197,001,891854,Staff,70,0,70,0
1745137462957,ANTH 289S,A00,891856,Gagneux; Pascal,12,0,12,0
1745137463982,BENG 196,001,957946,Engler; Adam J.,9996,0,9999,3
1745137465008,CAT 124RS,A01,956906,Staff,8,0,25,17
1745137466036,CAT 125RS,A01,922013,Staff,8,0,25,17
1745137467060,CLRE 250,A00,891860,Morris; Sheldon,9996,0,9999,3
1745137469112,CLRE 251R,A00,907817,Mehta; Ravindra L.,9995,0,9999,4
1745137470138,CLRE 252,A00,891864,Cuomo; Raphael Eduardo,9994,0,9999,5
1745137471166,CLRE 253,A00,891867,Vaida; Florin,9995,0,9999,4
1745137471166,CLRE 253,B00,907819,Staff,9999,0,9999,0
1745137472194,CLRE 259,A00,891868,Patel; Hemal,9998,0,9999,1
1745137473221,CLRE 260,A00,891872,Cuomo; Raphael Eduardo,9999,0,9999,0
1745137474248,CLRE 297,001,891888,Cuomo; Raphael Eduardo,9999,0,9999,0
1745137475273,CSS 201S,A01,892054,Mignozzetti; Umberto,30,0,30,0
1745137476299,CSS 202S,A01,892056,Mignozzetti; Umberto,30,0,30,0
1745137477327,DSC 197,001,956898,Eldridge; Justin Matthew,9998,0,9999,1
1745137478351,DSC 297,001,958000,Mazumdar; Arya,9999,0,9999,0
1745137479377,EAP 100,A00,905686,Staff,9774,0,9999,225
1745137480402,ECE 45,A01,892618,Staff,0,2,50,50
1745137481429,ECE 109,A01,892620,Staff,0,44,0,0
1745137482454,ECE 111,A01,892719,Staff,0,0,50,50
1745137483479,ECE 197,001,957920,Mercier; Patrick Philip,9992,0,9999,7
1745137484506,ECON 178,A01,907814,Zhu; Ying,29,0,35,6
1745137485532,EDS 115,A00,895312,Staff,42,0,45,3
1745137486560,EDS 117,A01,895337,Staff,30,0,30,0
1745137487586,EDS 125,A00,895341,Jones; Gabrielle Anastasia,43,0,45,2
1745137488611,EDS 128A,A01,895459,Fargason; Sharon Gayle,45,0,45,0
1745137489637,EDS 128B,A01,895543,Pappas; Elizabeth,45,0,45,0
1745137490667,EDS 139,A00,897203,Pappas; Elizabeth,45,0,45,0
1745137490667,EDS 139,B00,897209,Fargason; Sharon Gayle,45,0,45,0
1745137491691,EDS 201,A00,895545,Staff,44,0,45,1
1745137492720,EDS 203,A01,895581,Halter; Christopher P.,44,0,45,1
1745137493749,EDS 204R,A01,895625,Heinzman; Erica M.,45,0,45,0
1745137493749,EDS 204R,B01,895693,Halter; Christopher P.,28,0,45,17
1745137494777,EDS 206R,A00,895694,Fargason; Sharon Gayle,22,0,30,8
1745137494777,EDS 206R,B00,895695,Choi; Bailey Miyeon,21,0,30,9
1745137495804,EDS 250,A00,895697,Hemans; Patricia Ann Benitez,44,0,45,1
1745137496829,EDS 281,A00,895701,Meyerott; Theresa Ann,15,0,15,0
1745137497854,EDS 284,A00,895736,Meyerott; Theresa Ann,15,0,15,0
1745137498880,EDS 286,A00,897210,Fine; Sarah,15,0,15,0
1745137499904,EDS 289C,A01,895770,Daly; Alan J.,15,0,15,0
1745137500932,EDS 290,A00,897211,Hofstetter; Carolyn,15,0,15,0
1745137501961,LIGM 5A,A00,896162,Fischer-Grunski; Eva K,16,0,20,4
1745137502986,LIGM 5B,A00,896260,Fischer-Grunski; Eva K,19,0,20,1
1745137504020,LIGM 5C,A00,896308,Fischer-Grunski; Eva K,19,0,20,1
1745137505049,LIIT 5AS,A00,896313,Carnelos; Chiara,18,0,20,2
1745137506075,LIIT 5BS,A00,896416,Carnelos; Chiara,20,0,20,0
1745137507107,LIIT 5CS,A00,896564,Carnelos; Chiara,20,0,20,0
1745137508134,LISP 5A,A00,896588,Munoz Sanchez; Alicia,7,0,20,13
1745137509164,LISP 5B,A00,896653,Munoz Sanchez; Alicia,10,0,20,10
1745137510192,LISP 5C,A00,896655,Munoz Sanchez; Alicia,9,0,20,11
1745137511221,MAE 197,001,957918,Kleissl; Jan,9998,0,9999,1
1745137512244,MATH 2,A01,957937,Staff,34,0,35,1
1745137513272,MATH 197,001,957876,Kedlaya; Kiran S.,9996,0,9999,3
1745137514304,MCWP 40,A00,892729,Duru; Nur,16,0,20,4
1745137514304,MCWP 40,B00,893304,Montejo; Carolina,20,0,20,0
1745137515329,MCWP 40R,A00,893757,Redela; Pamela Morgan,0,3,20,20
1745137516358,MCWP 50,A00,893758,Morshed; Michael James,4,0,20,16
1745137516358,MCWP 50,B00,893761,Bartulis; Jason Michael,18,0,20,2
1745137517389,MCWP 50R,A00,893766,Compas; Sean Matthew,0,1,20,20
1745137517389,MCWP 50R,B00,893769,Carter; Jennifer A,5,0,20,15
1745137517389,MCWP 50R,C00,893771,Krone; Jarret,0,3,20,20
1745137517389,MCWP 50R,D00,893772,Miller; Elizabeth Deen,4,0,20,16
1745137517389,MCWP 50R,E00,893775,Carter; Andrea L,0,0,20,20
1745137518419,MMW 11R,A01,892721,Herbst; Matthew,22,0,30,8
1745137518419,MMW 11R,A02,892722,Herbst; Matthew,28,0,30,2
1745137519445,MMW 12R,A01,892724,Herbst; Matthew,0,5,16,16
1745137519445,MMW 12R,A02,892725,Herbst; Matthew,0,4,16,16
1745137520471,MMW 13R,A01,892727,Staff,0,29,16,16
1745137520471,MMW 13R,A02,892728,Staff,0,28,16,16
1745137521498,SIO 295LS,A00,894015,Staff,9,0,25,16
1745137522524,SIO 295S,A00,894020,Staff,9,0,25,16
1745137523549,SIOC 290S,A01,894063,Merrifield; Mark A,23,0,25,2
1745137524576,SIOC 291S,A01,894137,Gabriel; Corey John,23,0,25,2
1745137525602,SOCI 117,A01,895339,Staff,5,0,5,0
1745137526626,WES 237B,A00,894149,Staff,20,0,20,0
1745137528688,AESE 279B,A00,891859,Staff,35,0,35,0
1745137529716,AIP 197,001,891854,Staff,70,0,70,0
1745137530742,ANTH 289S,A00,891856,Gagneux; Pascal,12,0,12,0
1745137531766,BENG 196,001,957946,Engler; Adam J.,9996,0,9999,3
1745137532793,CAT 124RS,A01,956906,Staff,8,0,25,17
1745137533819,CAT 125RS,A01,922013,Staff,8,0,25,17
1745137534846,CLRE 250,A00,891860,Morris; Sheldon,9996,0,9999,3
1745137536901,CLRE 251R,A00,907817,Mehta; Ravindra L.,9995,0,9999,4
1745137537925,CLRE 252,A00,891864,Cuomo; Raphael Eduardo,9994,0,9999,5
1745137538950,CLRE 253,A00,891867,Vaida; Florin,9995,0,9999,4
1745137538950,CLRE 253,B00,907819,Staff,9999,0,9999,0
1745137539974,CLRE 259,A00,891868,Patel; Hemal,9998,0,9999,1
1745137540998,CLRE 260,A00,891872,Cuomo; Raphael Eduardo,9999,0,9999,0
1745137542024,CLRE 297,001,891888,Cuomo; Raphael Eduardo,9999,0,9999,0
1745137543049,CSS 201S,A01,892054,Mignozzetti; Umberto,30,0,30,0
1745137544079,CSS 202S,A01,892056,Mignozzetti; Umberto,30,0,30,0
1745137545106,DSC 197,001,956898,Eldridge; Justin Matthew,9998,0,9999,1
1745137546131,DSC 297,001,958000,Mazumdar; Arya,9999,0,9999,0
1745137547156,EAP 100,A00,905686,Staff,9774,0,9999,225
1745137548182,ECE 45,A01,892618,Staff,0,2,50,50
1745137549207,ECE 109,A01,892620,Staff,0,44,0,0
1745137550236,ECE 111,A01,892719,Staff,0,0,50,50
1745137551260,ECE 197,001,957920,Mercier; Patrick Philip,9992,0,9999,7
1745137552286,ECON 178,A01,907814,Zhu; Ying,29,0,35,6
1745137553313,EDS 115,A00,895312,Staff,42,0,45,3
1745137554337,EDS 117,A01,895337,Staff,30,0,30,0
1745137555366,EDS 125,A00,895341,Jones; Gabrielle Anastasia,43,0,45,2
1745137556395,EDS 128A,A01,895459,Fargason; Sharon Gayle,45,0,45,0
1745137557421,EDS 128B,A01,895543,Pappas; Elizabeth,45,0,45,0
1745137558446,EDS 139,A00,897203,Pappas; Elizabeth,45,0,45,0
1745137558446,EDS 139,B00,897209,Fargason; Sharon Gayle,45,0,45,0
1745137559474,EDS 201,A00,895545,Staff,44,0,45,1
1745137560497,EDS 203,A01,895581,Halter; Christopher P.,44,0,45,1
1745137561524,EDS 204R,A01,895625,Heinzman; Erica M.,45,0,45,0
1745137561524,EDS 204R,B01,895693,Halter; Christopher P.,28,0,45,17
1745137562551,EDS 206R,A00,895694,Fargason; Sharon Gayle,22,0,30,8
1745137562551,EDS 206R,B00,895695,Choi; Bailey Miyeon,21,0,30,9
1745137563576,EDS 250,A00,895697,Hemans; Patricia Ann Benitez,44,0,45,1
1745137564606,EDS 281,A00,895701,Meyerott; Theresa Ann,15,0,15,0
1745137565634,EDS 284,A00,895736,Meyerott; Theresa Ann,15,0,15,0
1745137566661,EDS 286,A00,897210,Fine; Sarah,15,0,15,0
1745137567690,EDS 289C,A01,895770,Daly; Alan J.,15,0,15,0
1745137568718,EDS 290,A00,897211,Hofstetter; Carolyn,15,0,15,0
1745137569741,LIGM 5A,A00,896162,Fischer-Grunski; Eva K,16,0,20,4
1745137570767,LIGM 5B,A00,896260,Fischer-Grunski; Eva K,19,0,20,1
1745137571792,LIGM 5C,A00,896308,Fischer-Grunski; Eva K,19,0,20,1
1745137572816,LIIT 5AS,A00,896313,Carnelos; Chiara,18,0,20,2
1745137573842,LIIT 5BS,A00,896416,Carnelos; Chiara,20,0,20,0
1745137574868,LIIT 5CS,A00,896564,Carnelos; Chiara,20,0,20,0
1745137575896,LISP 5A,A00,896588,Munoz Sanchez; Alicia,7,0,20,13
1745137576921,LISP 5B,A00,896653,Munoz Sanchez; Alicia,10,0,20,10
1745137577946,LISP 5C,A00,896655,Munoz Sanchez; Alicia,9,0,20,11
1745137578973,MAE 197,001,957918,Kleissl; Jan,9998,0,9999,1
1745137580001,MATH 2,A01,957937,Staff,34,0,35,1
1745137581027,MATH 197,001,957876,Kedlaya; Kiran S.,9996,0,9999,3
1745137582053,MCWP 40,A00,892729,Duru; Nur,16,0,20,4
1745137582053,MCWP 40,B00,893304,Montejo; Carolina,20,0,20,0
1745137583079,MCWP 40R,A00,893757,Redela; Pamela Morgan,0,3,20,20
1745137584107,MCWP 50,A00,893758,Morshed; Michael James,4,0,20,16
1745137584107,MCWP 50,B00,893761,Bartulis; Jason Michael,18,0,20,2
1745137585136,MCWP 50R,A00,893766,Compas; Sean Matthew,0,1,20,20
1745137585136,MCWP 50R,B00,893769,Carter; Jennifer A,5,0,20,15
1745137585136,MCWP 50R,C00,893771,Krone; Jarret,0,3,20,20
1745137585136,MCWP 50R,D00,893772,Miller; Elizabeth Deen,4,0,20,16
1745137585136,MCWP 50R,E00,893775,Carter; Andrea L,0,0,20,20
1745137586162,MMW 11R,A01,892721,Herbst; Matthew,22,0,30,8
1745137586162,MMW 11R,A02,892722,Herbst; Matthew,28,0,30,2
1745137587187,MMW 12R,A01,892724,Herbst; Matthew,0,5,16,16
1745137587187,MMW 12R,A02,892725,Herbst; Matthew,0,4,16,16
1745137588214,MMW 13R,A01,892727,Staff,0,29,16,16
1745137588214,MMW 13R,A02,892728,Staff,0,28,16,16
1745137589238,SIO 295LS,A00,894015,Staff,9,0,25,16
1745137590265,SIO 295S,A00,894020,Staff,9,0,25,16
1745137591295,SIOC 290S,A01,894063,Merrifield; Mark A,23,0,25,2
1745137592320,SIOC 291S,A01,894137,Gabriel; Corey John,23,0,25,2
1745137593345,SOCI 117,A01,895339,Staff,5,0,5,0
1745137594373,WES 237B,A00,894149,Staff,20,0,20,0
1745137596430,AESE 279B,A00,891859,Staff,35,0,35,0
1745137597453,AIP 197,001,891854,Staff,70,0,70,0
1745137598484,ANTH 289S,A00,891856,Gagneux; Pascal,12,0,12,0
1745137599508,BENG 196,001,957946,Engler; Adam J.,9996,0,9999,3
1745137600535,CAT 124RS,A01,956906,Staff,8,0,25,17
1745137601558,CAT 125RS,A01,922013,Staff,8,0,25,17
1745137602583,CLRE 250,A00,891860,Morris; Sheldon,9996,0,9999,3
1745137604637,CLRE 251R,A00,907817,Mehta; Ravindra L.,9995,0,9999,4
1745137605664,CLRE 252,A00,891864,Cuomo; Raphael Eduardo,9994,0,9999,5
1745137606690,CLRE 253,A00,891867,Vaida; Florin,9995,0,9999,4
1745137606690,CLRE 253,B00,907819,Staff,9999,0,9999,0
1745137607716,CLRE 259,A00,891868,Patel; Hemal,9998,0,9999,1
1745137608740,CLRE 260,A00,891872,Cuomo; Raphael Eduardo,9999,0,9999,0
1745137609765,CLRE 297,001,891888,Cuomo; Raphael Eduardo,9999,0,9999,0
1745137610793,CSS 201S,A01,892054,Mignozzetti; Umberto,30,0,30,0
1745137611822,CSS 202S,A01,892056,Mignozzetti; Umberto,30,0,30,0
1745137612850,DSC 197,001,956898,Eldridge; Justin Matthew,9998,0,9999,1
1745137613875,DSC 297,001,958000,Mazumdar; Arya,9999,0,9999,0
1745137614901,EAP 100,A00,905686,Staff,9774,0,9999,225
1745137615926,ECE 45,A01,892618,Staff,0,2,50,50
1745137616951,ECE 109,A01,892620,Staff,0,44,0,0
1745137617977,ECE 111,A01,892719,Staff,0,0,50,50
1745137619003,ECE 197,001,957920,Mercier; Patrick Philip,9992,0,9999,7
1745137620031,ECON 178,A01,907814,Zhu; Ying,29,0,35,6
1745137621059,EDS 115,A00,895312,Staff,42,0,45,3
1745137622084,EDS 117,A01,895337,Staff,30,0,30,0
1745137623109,EDS 125,A00,895341,Jones; Gabrielle Anastasia,43,0,45,2
1745137624135,EDS 128A,A01,895459,Fargason; Sharon Gayle,45,0,45,0
1745137625161,EDS 128B,A01,895543,Pappas; Elizabeth,45,0,45,0
1745137626185,EDS 139,A00,897203,Pappas; Elizabeth,45,0,45,0
1745137626185,EDS 139,B00,897209,Fargason; Sharon Gayle,45,0,45,0
1745137627210,EDS 201,A00,895545,Staff,44,0,45,1
1745137628239,EDS 203,A01,895581,Halter; Christopher P.,44,0,45,1
1745137629267,EDS 204R,A01,895625,Heinzman; Erica M.,45,0,45,0
1745137629267,EDS 204R,B01,895693,Halter; Christopher P.,28,0,45,17
1745137630293,EDS 206R,A00,895694,Fargason; Sharon Gayle,22,0,30,8
1745137630293,EDS 206R,B00,895695,Choi; Bailey Miyeon,21,0,30,9
1745137631318,EDS 250,A00,895697,Hemans; Patricia Ann Benitez,44,0,45,1
1745137632344,EDS 281,A00,895701,Meyerott; Theresa Ann,15,0,15,0
1745137633369,EDS 284,A00,895736,Meyerott; Theresa Ann,15,0,15,0
1745137634395,EDS 286,A00,897210,Fine; Sarah,15,0,15,0
1745137635424,EDS 289C,A01,895770,Daly; Alan J.,15,0,15,0
1745137636449,EDS 290,A00,897211,Hofstetter; Carolyn,15,0,15,0
1745137637477,LIGM 5A,A00,896162,Fischer-Grunski; Eva K,16,0,20,4
1745137638505,LIGM 5B,A00,896260,Fischer-Grunski; Eva K,19,0,20,1
1745137639530,LIGM 5C,A00,896308,Fischer-Grunski; Eva K,19,0,20,1
1745137640557,LIIT 5AS,A00,896313,Carnelos; Chiara,18,0,20,2
1745137641582,LIIT 5BS,A00,896416,Carnelos; Chiara,20,0,20,0
1745137642611,LIIT 5CS,A00,896564,Carnelos; Chiara,20,0,20,0
1745137643636,LISP 5A,A00,896588,Munoz Sanchez; Alicia,7,0,20,13
1745137644664,LISP 5B,A00,896653,Munoz Sanchez; Alicia,10,0,20,10
1745137645692,LISP 5C,A00,896655,Munoz Sanchez; Alicia,9,0,20,11
1745137646718,MAE 197,001,957918,Kleissl; Jan,9998,0,9999,1
1745137647743,MATH 2,A01,957937,Staff,34,0,35,1
1745137648773,MATH 197,001,957876,Kedlaya; Kiran S.,9996,0,9999,3
1745137649797,MCWP 40,A00,892729,Duru; Nur,16,0,20,4
1745137649797,MCWP 40,B00,893304,Montejo; Carolina,20,0,20,0
1745137650825,MCWP 40R,A00,893757,Redela; Pamela Morgan,0,3,20,20
1745137651849,MCWP 50,A00,893758,Morshed; Michael James,4,0,20,16
1745137651849,MCWP 50,B00,893761,Bartulis; Jason Michael,18,0,20,2
1745137652873,MCWP 50R,A00,893766,Compas; Sean Matthew,0,1,20,20
1745137652873,MCWP 50R,B00,893769,Carter; Jennifer A,5,0,20,15
1745137652873,MCWP 50R,C00,893771,Krone; Jarret,0,3,20,20
1745137652873,MCWP 50R,D00,893772,Miller; Elizabeth Deen,4,0,20,16
1745137652873,MCWP 50R,E00,893775,Carter; Andrea L,0,0,20,20
1745137653898,MMW 11R,A01,892721,Herbst; Matthew,22,0,30,8
1745137653898,MMW 11R,A02,892722,Herbst; Matthew,28,0,30,2
1745137654924,MMW 12R,A01,892724,Herbst; Matthew,0,5,16,16
1745137654924,MMW 12R,A02,892725,Herbst; Matthew,0,4,16,16
1745137655949,MMW 13R,A01,892727,Staff,0,29,16,16
1745137655949,MMW 13R,A02,892728,Staff,0,28,16,16
1745137656974,SIO 295LS,A00,894015,Staff,9,0,25,16
1745137657999,SIO 295S,A00,894020,Staff,9,0,25,16
1745137659028,SIOC 290S,A01,894063,Merrifield; Mark A,23,0,25,2
1745137660053,SIOC 291S,A01,894137,Gabriel; Corey John,23,0,25,2
1745137661079,SOCI 117,A01,895339,Staff,5,0,5,0
1745137662103,WES 237B,A00,894149,Staff,20,0,20,0
1745137664161,AESE 279B,A00,891859,Staff,35,0,35,0
1745137665185,AIP 197,001,891854,Staff,70,0,70,0
1745137666214,ANTH 289S,A00,891856,Gagneux; Pascal,12,0,12,0
1745137667237,BENG 196,001,957946,Engler; Adam J.,9996,0,9999,3
1745137668264,CAT 124RS,A01,956906,Staff,8,0,25,17
1745137669291,CAT 125RS,A01,922013,Staff,8,0,25,17
1745137670316,CLRE 250,A00,891860,Morris; Sheldon,9996,0,9999,3
1745137672370,CLRE 251R,A00,907817,Mehta; Ravindra L.,9995,0,9999,4
1745137673395,CLRE 252,A00,891864,Cuomo; Raphael Eduardo,9994,0,9999,5
1745137674421,CLRE 253,A00,891867,Vaida; Florin,9995,0,9999,4
1745137674421,CLRE 253,B00,907819,Staff,9999,0,9999,0
1745137675446,CLRE 259,A00,891868,Patel; Hemal,9998,0,9999,1
1745137676472,CLRE 260,A00,891872,Cuomo; Raphael Eduardo,9999,0,9999,0
1745137677496,CLRE 297,001,891888,Cuomo; Raphael Eduardo,9999,0,9999,0
1745137678522,CSS 201S,A01,892054,Mignozzetti; Umberto,30,0,30,0
1745137679552,CSS 202S,A01,892056,Mignozzetti; Umberto,30,0,30,0
1745137680577,DSC 197,001,956898,Eldridge; Justin Matthew,9998,0,9999,1
1745137681603,DSC 297,001,958000,Mazumdar; Arya,9999,0,9999,0
1745137682629,EAP 100,A00,905686,Staff,9774,0,9999,225
1745137683654,ECE 45,A01,892618,Staff,0,2,50,50
1745137684679,ECE 109,A01,892620,Staff,0,44,0,0
1745137685704,ECE 111,A01,892719,Staff,0,0,50,50
1745137686733,ECE 197,001,957920,Mercier; Patrick Philip,9992,0,9999,7
1745137687760,ECON 178,A01,907814,Zhu; Ying,29,0,35,6
1745137688785,EDS 115,A00,895312,Staff,42,0,45,3
1745137689811,EDS 117,A01,895337,Staff,30,0,30,0
1745137690839,EDS 125,A00,895341,Jones; Gabrielle Anastasia,43,0,45,2
1745137691867,EDS 128A,A01,895459,Fargason; Sharon Gayle,45,0,45,0
1745137692893,EDS 128B,A01,895543,Pappas; Elizabeth,45,0,45,0
1745137693920,EDS 139,A00,897203,Pappas; Elizabeth,45,0,45,0
1745137693920,EDS 139,B00,897209,Fargason; Sharon Gayle,45,0,45,0
1745137694948,EDS 201,A00,895545,Staff,44,0,45,1
1745137695974,EDS 203,A01,895581,Halter; Christopher P.,44,0,45,1
1745137697004,EDS 204R,A01,895625,Heinzman; Erica M.,45,0,45,0
1745137697004,EDS 204R,B01,895693,Halter; Christopher P.,28,0,45,17
1745137698030,EDS 206R,A00,895694,Fargason; Sharon Gayle,22,0,30,8
1745137698030,EDS 206R,B00,895695,Choi; Bailey Miyeon,21,0,30,9
1745137699057,EDS 250,A00,895697,Hemans; Patricia Ann Benitez,44,0,45,1
1745137700085,EDS 281,A00,895701,Meyerott; Theresa Ann,15,0,15,0
1745137701112,EDS 284,A00,895736,Meyerott; Theresa Ann,15,0,15,0
1745137702137,EDS 286,A00,897210,Fine; Sarah,15,0,15,0
1745137703163,EDS 289C,A01,895770,Daly; Alan J.,15,0,15,0
1745137704190,EDS 290,A00,897211,Hofstetter; Carolyn,15,0,15,0
1745137705269,LIGM 5A,A00,896162,Fischer-Grunski; Eva K,16,0,20,4
1745137706297,LIGM 5B,A00,896260,Fischer-Grunski; Eva K,19,0,20,1
1745137707324,LIGM 5C,A00,896308,Fischer-Grunski; Eva K,19,0,20,1
1745137708350,LIIT 5AS,A00,896313,Carnelos; Chiara,18,0,20,2
1745137709376,LIIT 5BS,A00,896416,Carnelos; Chiara,20,0,20,0
1745137710402,LIIT 5CS,A00,896564,Carnelos; Chiara,20,0,20,0
1745137711428,LISP 5A,A00,896588,Munoz Sanchez; Alicia,7,0,20,13
1745137712455,LISP 5B,A00,896653,Munoz Sanchez; Alicia,10,0,20,10
1745137713481,LISP 5C,A00,896655,Munoz Sanchez; Alicia,9,0,20,11
1745137714507,MAE 197,001,957918,Kleissl; Jan,9998,0,9999,1
1745137715534,MATH 2,A01,957937,Staff,34,0,35,1
1745137716561,MATH 197,001,957876,Kedlaya; Kiran S.,9996,0,9999,3
1745137717587,MCWP 40,A00,892729,Duru; Nur,16,0,20,4
1745137717587,MCWP 40,B00,893304,Montejo; Carolina,20,0,20,0
1745137718613,MCWP 40R,A00,893757,Redela; Pamela Morgan,0,3,20,20
1745137719638,MCWP 50,A00,893758,Morshed; Michael James,4,0,20,16
1745137719638,MCWP 50,B00,893761,Bartulis; Jason Michael,18,0,20,2
1745137720664,MCWP 50R,A00,893766,Compas; Sean Matthew,0,1,20,20
1745137720664,MCWP 50R,B00,893769,Carter; Jennifer A,5,0,20,15
1745137720664,MCWP 50R,C00,893771,Krone; Jarret,0,3,20,20
1745137720664,MCWP 50R,D00,893772,Miller; Elizabeth Deen,4,0,20,16
1745137720664,MCWP 50R,E00,893775,Carter; Andrea L,0,0,20,20
1745137721691,MMW 11R,A01,892721,Herbst; Matthew,22,0,30,8
1745137721691,MMW 11R,A02,892722,Herbst; Matthew,28,0,30,2
1745137722717,MMW 12R,A01,892724,Herbst; Matthew,0,5,16,16
1745137722717,MMW 12R,A02,892725,Herbst; Matthew,0,4,16,16
1745137723743,MMW 13R,A01,892727,Staff,0,29,16,16
1745137723743,MMW 13R,A02,892728,Staff,0,28,16,16
1745137724771,SIO 295LS,A00,894015,Staff,9,0,25,16
1745137725797,SIO 295S,A00,894020,Staff,9,0,25,16
1745137726823,SIOC 290S,A01,894063,Merrifield; Mark A,23,0,25,2
1745137727848,SIOC 291S,A01,894137,Gabriel; Corey John,23,0,25,2
1745137728874,SOCI 117,A01,895339,Staff,5,0,5,0
1745137729899,WES 237B,A00,894149,Staff,20,0,20,0
1745137731968,AESE 279B,A00,891859,Staff,35,0,35,0
1745137732994,AIP 197,001,891854,Staff,70,0,70,0
1745137734019,ANTH 289S,A00,891856,Gagneux; Pascal,12,0,12,0
1745137735046,BENG 196,001,957946,Engler; Adam J.,9996,0,9999,3
1745137736074,CAT 124RS,A01,956906,Staff,8,0,25,17
1745137737098,CAT 125RS,A01,922013,Staff,8,0,25,17
1745137738127,CLRE 250,A00,891860,Morris; Sheldon,9996,0,9999,3
1745137740185,CLRE 251R,A00,907817,Mehta; Ravindra L.,9995,0,9999,4
1745137741213,CLRE 252,A00,891864,Cuomo; Raphael Eduardo,9994,0,9999,5
1745137742239,CLRE 253,A00,891867,Vaida; Florin,9995,0,9999,4
1745137742239,CLRE 253,B00,907819,Staff,9999,0,9999,0
1745137743297,CLRE 259,A00,891868,Patel; Hemal,9998,0,9999,1
1745137744327,CLRE 260,A00,891872,Cuomo; Raphael Eduardo,9999,0,9999,0
1745137745357,CLRE 297,001,891888,Cuomo; Raphael Eduardo,9999,0,9999,0
1745137746387,CSS 201S,A01,892054,Mignozzetti; Umberto,30,0,30,0
1745137747421,CSS 202S,A01,892056,Mignozzetti; Umberto,30,0,30,0
1745137748446,DSC 197,001,956898,Eldridge; Justin Matthew,9998,0,9999,1
1745137749473,DSC 297,001,958000,Mazumdar; Arya,9999,0,9999,0
1745137750502,EAP 100,A00,905686,Staff,9774,0,9999,225
1745137751530,ECE 45,A01,892618,Staff,0,2,50,50
1745137752558,ECE 109,A01,892620,Staff,0,44,0,0
1745137753588,ECE 111,A01,892719,Staff,0,0,50,50
1745137754613,ECE 197,001,957920,Mercier; Patrick Philip,9992,0,9999,7
1745137755639,ECON 178,A01,907814,Zhu; Ying,29,0,35,6
1745137756667,EDS 115,A00,895312,Staff,42,0,45,3
1745137757693,EDS 117,A01,895337,Staff,30,0,30,0
1745137758719,EDS 125,A00,895341,Jones; Gabrielle Anastasia,43,0,45,2
1745137759747,EDS 128A,A01,895459,Fargason; Sharon Gayle,45,0,45,0
1745137760773,EDS 128B,A01,895543,Pappas; Elizabeth,45,0,45,0
1745137761798,EDS 139,A00,897203,Pappas; Elizabeth,45,0,45,0
1745137761798,EDS 139,B00,897209,Fargason; Sharon Gayle,45,0,45,0
1745137762826,EDS 201,A00,895545,Staff,44,0,45,1
1745137763853,EDS 203,A01,895581,Halter; Christopher P.,44,0,45,1
1745137764881,EDS 204R,A01,895625,Heinzman; Erica M.,45,0,45,0
1745137764881,EDS 204R,B01,895693,Halter; Christopher P.,28,0,45,17
1745137765909,EDS 206R,A00,895694,Fargason; Sharon Gayle,22,0,30,8
1745137765909,EDS 206R,B00,895695,Choi; Bailey Miyeon,21,0,30,9
1745137766938,EDS 250,A00,895697,Hemans; Patricia Ann Benitez,44,0,45,1
1745137767964,EDS 281,A00,895701,Meyerott; Theresa Ann,15,0,15,0
1745137768992,EDS 284,A00,895736,Meyerott; Theresa Ann,15,0,15,0
1745137770022,EDS 286,A00,897210,Fine; Sarah,15,0,15,0
1745137771052,EDS 289C,A01,895770,Daly; Alan J.,15,0,15,0
1745137772082,EDS 290,A00,897211,Hofstetter; Carolyn,15,0,15,0
1745137773109,LIGM 5A,A00,896162,Fischer-Grunski; Eva K,16,0,20,4
1745137774137,LIGM 5B,A00,896260,Fischer-Grunski; Eva K,19,0,20,1
1745137775164,LIGM 5C,A00,896308,Fischer-Grunski; Eva K,19,0,20,1
1745137776196,LIIT 5AS,A00,896313,Carnelos; Chiara,18,0,20,2
1745137777224,LIIT 5BS,A00,896416,Carnelos; Chiara,20,0,20,0
1745137778252,LIIT 5CS,A00,896564,Carnelos; Chiara,20,0,20,0
1745137779279,LISP 5A,A00,896588,Munoz Sanchez; Alicia,7,0,20,13
1745137780306,LISP 5B,A00,896653,Munoz Sanchez; Alicia,10,0,20,10
1745137781335,LISP 5C,A00,896655,Munoz Sanchez; Alicia,9,0,20,11
1745137782360,MAE 197,001,957918,Kleissl; Jan,9998,0,9999,1
1745137783392,MATH 2,A01,957937,Staff,34,0,35,1
1745137784418,MATH 197,001,957876,Kedlaya; Kiran S.,9996,0,9999,3
1745137785448,MCWP 40,A00,892729,Duru; Nur,16,0,20,4
1745137785448,MCWP 40,B00,893304,Montejo; Carolina,20,0,20,0
1745137786473,MCWP 40R,A00,893757,Redela; Pamela Morgan,0,3,20,20
1745137787524,MCWP 50,A00,893758,Morshed; Michael James,4,0,20,16
1745137787524,MCWP 50,B00,893761,Bartulis; Jason Michael,18,0,20,2
1745137788557,MCWP 50R,A00,893766,Compas; Sean Matthew,0,1,20,20
1745137788557,MCWP 50R,B00,893769,Carter; Jennifer A,5,0,20,15
1745137788557,MCWP 50R,C00,893771,Krone; Jarret,0,3,20,20
1745137788557,MCWP 50R,D00,893772,Miller; Elizabeth Deen,4,0,20,16
1745137788557,MCWP 50R,E00,893775,Carter; Andrea L,0,0,20,20
1745137789583,MMW 11R,A01,892721,Herbst; Matthew,22,0,30,8
1745137789583,MMW 11R,A02,892722,Herbst; Matthew,28,0,30,2
1745137790607,MMW 12R,A01,892724,Herbst; Matthew,0,5,16,16
1745137790607,MMW 12R,A02,892725,Herbst; Matthew,0,4,16,16
1745137791636,MMW 13R,A01,892727,Staff,0,29,16,16
1745137791636,MMW 13R,A02,892728,Staff,0,28,16,16
1745137792665,SIO 295LS,A00,894015,Staff,9,0,25,16
1745137793690,SIO 295S,A00,894020,Staff,9,0,25,16
1745137794716,SIOC 290S,A01,894063,Merrifield; Mark A,23,0,25,2
1745137795745,SIOC 291S,A01,894137,Gabriel; Corey John,23,0,25,2
1745137796773,SOCI 117,A01,895339,Staff,5,0,5,0
1745137797797,WES 237B,A00,894149,Staff,20,0,20,0
1745137799851,AESE 279B,A00,891859,Staff,35,0,35,0
1745137800880,AIP 197,001,891854,Staff,70,0,70,0
1745137801917,ANTH 289S,A00,891856,Gagneux; Pascal,12,0,12,0
1745137802942,BENG 196,001,957946,Engler; Adam J.,9996,0,9999,3
1745137803969,CAT 124RS,A01,956906,Staff,8,0,25,17
1745137804999,CAT 125RS,A01,922013,Staff,8,0,25,17
1745137806027,CLRE 250,A00,891860,Morris; Sheldon,9996,0,9999,3
1745137808079,CLRE 251R,A00,907817,Mehta; Ravindra L.,9995,0,9999,4
1745137809104,CLRE 252,A00,891864,Cuomo; Raphael Eduardo,9994,0,9999,5
1745137810129,CLRE 253,A00,891867,Vaida; Florin,9995,0,9999,4
1745137810129,CLRE 253,B00,907819,Staff,9999,0,9999,0
1745137811159,CLRE 259,A00,891868,Patel; Hemal,9998,0,9999,1
1745137812186,CLRE 260,A00,891872,Cuomo; Raphael Eduardo,9999,0,9999,0
1745137813209,CLRE 297,001,891888,Cuomo; Raphael Eduardo,9999,0,9999,0
1745137814235,CSS 201S,A01,892054,Mignozzetti; Umberto,30,0,30,0
1745137815286,CSS 202S,A01,892056,Mignozzetti; Umberto,30,0,30,0
1745137816312,DSC 197,001,956898,Eldridge; Justin Matthew,9998,0,9999,1
1745137817339,DSC 297,001,958000,Mazumdar; Arya,9999,0,9999,0
1745137818366,EAP 100,A00,905686,Staff,9774,0,9999,225
1745137819391,ECE 45,A01,892618,Staff,0,2,50,50
1745137820419,ECE 109,A01,892620,Staff,0,44,0,0
1745137821445,ECE 111,A01,892719,Staff,0,0,50,50
1745137822474,ECE 197,001,957920,Mercier; Patrick Philip,9992,0,9999,7
1745137823503,ECON 178,A01,907814,Zhu; Ying,29,0,35,6
1745137824529,EDS 115,A00,895312,Staff,42,0,45,3
1745137825556,EDS 117,A01,895337,Staff,30,0,30,0
1745137826582,EDS 125,A00,895341,Jones; Gabrielle Anastasia,43,0,45,2
1745137827610,EDS 128A,A01,895459,Fargason; Sharon Gayle,45,0,45,0
1745137828637,EDS 128B,A01,895543,Pappas; Elizabeth,45,0,45,0
1745137829663,EDS 139,A00,897203,Pappas; Elizabeth,45,0,45,0
1745137829663,EDS 139,B00,897209,Fargason; Sharon Gayle,45,0,45,0
1745137830692,EDS 201,A00,895545,Staff,44,0,45,1
1745137831721,EDS 203,A01,895581,Halter; Christopher P.,44,0,45,1
1745137832756,EDS 204R,A01,895625,Heinzman; Erica M.,45,0,45,0
1745137832756,EDS 204R,B01,895693,Halter; Christopher P.,28,0,45,17
1745137833784,EDS 206R,A00,895694,Fargason; Sharon Gayle,22,0,30,8
1745137833784,EDS 206R,B00,895695,Choi; Bailey Miyeon,21,0,30,9
1745137834810,EDS 250,A00,895697,Hemans; Patricia Ann Benitez,44,0,45,1
1745137835834,EDS 281,A00,895701,Meyerott; Theresa Ann,15,0,15,0
1745137836860,EDS 284,A00,895736,Meyerott; Theresa Ann,15,0,15,0
1745137837885,EDS 286,A00,897210,Fine; Sarah,15,0,15,0
1745137838909,EDS 289C,A01,895770,Daly; Alan J.,15,0,15,0
1745137839936,EDS 290,A00,897211,Hofstetter; Carolyn,15,0,15,0
1745137840962,LIGM 5A,A00,896162,Fischer-Grunski; Eva K,16,0,20,4
1745137841986,LIGM 5B,A00,896260,Fischer-Grunski; Eva K,19,0,20,1
1745137843019,LIGM 5C,A00,896308,Fischer-Grunski; Eva K,19,0,20,1
1745137844045,LIIT 5AS,A00,896313,Carnelos; Chiara,18,0,20,2
1745137845070,LIIT 5BS,A00,896416,Carnelos; Chiara,20,0,20,0
1745137846096,LIIT 5CS,A00,896564,Carnelos; Chiara,20,0,20,0
1745137847121,LISP 5A,A00,896588,Munoz Sanchez; Alicia,7,0,20,13
1745137848148,LISP 5B,A00,896653,Munoz Sanchez; Alicia,10,0,20,10
1745137849173,LISP 5C,A00,896655,Munoz Sanchez; Alicia,9,0,20,11
1745137850198,MAE 197,001,957918,Kleissl; Jan,9998,0,9999,1
1745137851225,MATH 2,A01,957937,Staff,34,0,35,1
1745137852254,MATH 197,001,957876,Kedlaya; Kiran S.,9996,0,9999,3
1745137853284,MCWP 40,A00,892729,Duru; Nur,16,0,20,4
1745137853284,MCWP 40,B00,893304,Montejo; Carolina,20,0,20,0
1745137854310,MCWP 40R,A00,893757,Redela; Pamela Morgan,0,3,20,20
1745137855341,MCWP 50,A00,893758,Morshed; Michael James,4,0,20,16
1745137855341,MCWP 50,B00,893761,Bartulis; Jason Michael,18,0,20,2
1745137856372,MCWP 50R,A00,893766,Compas; Sean Matthew,0,1,20,20
1745137856372,MCWP 50R,B00,893769,Carter; Jennifer A,5,0,20,15
1745137856372,MCWP 50R,C00,893771,Krone; Jarret,0,3,20,20
1745137856372,MCWP 50R,D00,893772,Miller; Elizabeth Deen,4,0,20,16
1745137856372,MCWP 50R,E00,893775,Carter; Andrea L,0,0,20,20
1745137857398,MMW 11R,A01,892721,Herbst; Matthew,22,0,30,8
1745137857398,MMW 11R,A02,892722,Herbst; Matthew,28,0,30,2
1745137858422,MMW 12R,A01,892724,Herbst; Matthew,0,5,16,16
1745137858422,MMW 12R,A02,892725,Herbst; Matthew,0,4,16,16
1745137859457,MMW 13R,A01,892727,Staff,0,29,16,16
1745137859457,MMW 13R,A02,892728,Staff,0,28,16,16
1745137860488,SIO 295LS,A00,894015,Staff,9,0,25,16
1745137861517,SIO 295S,A00,894020,Staff,9,0,25,16
1745137862541,SIOC 290S,A01,894063,Merrifield; Mark A,23,0,25,2
1745137863567,SIOC 291S,A01,894137,Gabriel; Corey John,23,0,25,2
1745137864591,SOCI 117,A01,895339,Staff,5,0,5,0
1745137865618,WES 237B,A00,894149,Staff,20,0,20,0
1745137867698,AESE 279B,A00,891859,Staff,35,0,35,0
1745137868728,AIP 197,001,891854,Staff,70,0,70,0
1745137869758,ANTH 289S,A00,891856,Gagneux; Pascal,12,0,12,0
1745137870785,BENG 196,001,957946,Engler; Adam J.,9996,0,9999,3
1745137871809,CAT 124RS,A01,956906,Staff,8,0,25,17
1745137872840,CAT 125RS,A01,922013,Staff,8,0,25,17
1745137873865,CLRE 250,A00,891860,Morris; Sheldon,9996,0,9999,3
1745137875921,CLRE 251R,A00,907817,Mehta; Ravindra L.,9995,0,9999,4
1745137876946,CLRE 252,A00,891864,Cuomo; Raphael Eduardo,9994,0,9999,5
1745137877973,CLRE 253,A00,891867,Vaida; Florin,9995,0,9999,4
1745137877973,CLRE 253,B00,907819,Staff,9999,0,9999,0
1745137878999,CLRE 259,A00,891868,Patel; Hemal,9998,0,9999,1
1745137880025,CLRE 260,A00,891872,Cuomo; Raphael Eduardo,9999,0,9999,0
1745137881050,CLRE 297,001,891888,Cuomo; Raphael Eduardo,9999,0,9999,0
1745137882082,CSS 201S,A01,892054,Mignozzetti; Umberto,30,0,30,0
1745137883107,CSS 202S,A01,892056,Mignozzetti; Umberto,30,0,30,0
1745137884132,DSC 197,001,956898,Eldridge; Justin Matthew,9998,0,9999,1
1745137885161,DSC 297,001,958000,Mazumdar; Arya,9999,0,9999,0
1745137886187,EAP 100,A00,905686,Staff,9774,0,9999,225
1745137887212,ECE 45,A01,892618,Staff,0,2,50,50
1745137888239,ECE 109,A01,892620,Staff,0,44,0,0
1745137889272,ECE 111,A01,892719,Staff,0,0,50,50
1745137890298,ECE 197,001,957920,Mercier; Patrick Philip,9992,0,9999,7
1745137891325,ECON 178,A01,907814,Zhu; Ying,29,0,35,6
1745137892355,EDS 115,A00,895312,Staff,42,0,45,3
1745137893385,EDS 117,A01,895337,Staff,30,0,30,0
1745137894411,EDS 125,A00,895341,Jones; Gabrielle Anastasia,43,0,45,2
1745137895435,EDS 128A,A01,895459,Fargason; Sharon Gayle,45,0,45,0
1745137896462,EDS 128B,A01,895543,Pappas; Elizabeth,45,0,45,0
1745137897487,EDS 139,A00,897203,Pappas; Elizabeth,45,0,45,0
1745137897487,EDS 139,B00,897209,Fargason; Sharon Gayle,45,0,45,0
1745137898513,EDS 201,A00,895545,Staff,44,0,45,1
1745137899539,EDS 203,A01,895581,Halter; Christopher P.,44,0,45,1
1745137900564,EDS 204R,A01,895625,Heinzman; Erica M.,45,0,45,0
1745137900564,EDS 204R,B01,895693,Halter; Christopher P.,28,0,45,17
1745137901590,EDS 206R,A00,895694,Fargason; Sharon Gayle,22,0,30,8
1745137901590,EDS 206R,B00,895695,Choi; Bailey Miyeon,21,0,30,9
1745137902616,EDS 250,A00,895697,Hemans; Patricia Ann Benitez,44,0,45,1
1745137903641,EDS 281,A00,895701,Meyerott; Theresa Ann,15,0,15,0
1745137904667,EDS 284,A00,895736,Meyerott; Theresa Ann,15,0,15,0
1745137905693,EDS 286,A00,897210,Fine; Sarah,15,0,15,0
1745137906718,EDS 289C,A01,895770,Daly; Alan J.,15,0,15,0
1745137907745,EDS 290,A00,897211,Hofstetter; Carolyn,15,0,15,0
1745137908775,LIGM 5A,A00,896162,Fischer-Grunski; Eva K,16,0,20,4
1745137909801,LIGM 5B,A00,896260,Fischer-Grunski; Eva K,19,0,20,1
1745137910830,LIGM 5C,A00,896308,Fischer-Grunski; Eva K,19,0,20,1
1745137911859,LIIT 5AS,A00,896313,Carnelos; Chiara,18,0,20,2
1745137912889,LIIT 5BS,A00,896416,Carnelos; Chiara,20,0,20,0
1745137913913,LIIT 5CS,A00,896564,Carnelos; Chiara,20,0,20,0
1745137914943,LISP 5A,A00,896588,Munoz Sanchez; Alicia,7,0,20,13
1745137915969,LISP 5B,A00,896653,Munoz Sanchez; Alicia,10,0,20,10
1745137916994,LISP 5C,A00,896655,Munoz Sanchez; Alicia,9,0,20,11
1745137918023,MAE 197,001,957918,Kleissl; Jan,9998,0,9999,1
1745137919049,MATH 2,A01,957937,Staff,34,0,35,1
1745137920075,MATH 197,001,957876,Kedlaya; Kiran S.,9996,0,9999,3
1745137921102,MCWP 40,A00,892729,Duru; Nur,16,0,20,4
1745137921102,MCWP 40,B00,893304,Montejo; Carolina,20,0,20,0
1745137922127,MCWP 40R,A00,893757,Redela; Pamela Morgan,0,3,20,20
1745137923150,MCWP 50,A00,893758,Morshed; Michael James,4,0,20,16
1745137923150,MCWP 50,B00,893761,Bartulis; Jason Michael,18,0,20,2
1745137924181,MCWP 50R,A00,893766,Compas; Sean Matthew,0,1,20,20
1745137924181,MCWP 50R,B00,893769,Carter; Jennifer A,5,0,20,15
1745137924181,MCWP 50R,C00,893771,Krone; Jarret,0,3,20,20
1745137924181,MCWP 50R,D00,893772,Miller; Elizabeth Deen,4,0,20,16
1745137924181,MCWP 50R,E00,893775,Carter; Andrea L,0,0,20,20
1745137925207,MMW 11R,A01,892721,Herbst; Matthew,22,0,30,8
1745137925207,MMW 11R,A02,892722,Herbst; Matthew,28,0,30,2
1745137926236,MMW 12R,A01,892724,Herbst; Matthew,0,5,16,16
1745137926236,MMW 12R,A02,892725,Herbst; Matthew,0,4,16,16
1745137927263,MMW 13R,A01,892727,Staff,0,29,16,16
1745137927263,MMW 13R,A02,892728,Staff,0,28,16,16
1745137928287,SIO 295LS,A00,894015,Staff,9,0,25,16
1745137929317,SIO 295S,A00,894020,Staff,9,0,25,16
1745137930343,SIOC 290S,A01,894063,Merrifield; Mark A,23,0,25,2
1745137931369,SIOC 291S,A01,894137,Gabriel; Corey John,23,0,25,2
1745137932394,SOCI 117,A01,895339,Staff,5,0,5,0
1745137933421,WES 237B,A00,894149,Staff,20,0,20,0
1745137935483,AESE 279B,A00,891859,Staff,35,0,35,0
1745137936512,AIP 197,001,891854,Staff,70,0,70,0
1745137937538,ANTH 289S,A00,891856,Gagneux; Pascal,12,0,12,0
1745137938566,BENG 196,001,957946,Engler; Adam J.,9996,0,9999,3
1745137939595,CAT 124RS,A01,956906,Staff,8,0,25,17
1745137940622,CAT 125RS,A01,922013,Staff,8,0,25,17
1745137941649,CLRE 250,A00,891860,Morris; Sheldon,9996,0,9999,3
1745137943706,CLRE 251R,A00,907817,Mehta; Ravindra L.,9995,0,9999,4
1745137944733,CLRE 252,A00,891864,Cuomo; Raphael Eduardo,9994,0,9999,5
1745137945763,CLRE 253,A00,891867,Vaida; Florin,9995,0,9999,4
1745137945763,CLRE 253,B00,907819,Staff,9999,0,9999,0
1745137946791,CLRE 259,A00,891868,Patel; Hemal,9998,0,9999,1
1745137947817,CLRE 260,A00,891872,Cuomo; Raphael Eduardo,9999,0,9999,0
1745137948845,CLRE 297,001,891888,Cuomo; Raphael Eduardo,9999,0,9999,0
1745137949875,CSS 201S,A01,892054,Mignozzetti; Umberto,30,0,30,0
1745137950902,CSS 202S,A01,892056,Mignozzetti; Umberto,30,0,30,0
1745137951926,DSC 197,001,956898,Eldridge; Justin Matthew,9998,0,9999,1
1745137952951,DSC 297,001,958000,Mazumdar; Arya,9999,0,9999,0
1745137953975,EAP 100,A00,905686,Staff,9774,0,9999,225
1745137955001,ECE 45,A01,892618,Staff,0,2,50,50
1745137956027,ECE 109,A01,892620,Staff,0,44,0,0
1745137957054,ECE 111,A01,892719,Staff,0,0,50,50
1745137958081,ECE 197,001,957920,Mercier; Patrick Philip,9992,0,9999,7
1745137959109,ECON 178,A01,907814,Zhu; Ying,29,0,35,6
1745137960133,EDS 115,A00,895312,Staff,42,0,45,3
1745137961158,EDS 117,A01,895337,Staff,30,0,30,0
1745137962183,EDS 125,A00,895341,Jones; Gabrielle Anastasia,43,0,45,2
1745137963208,EDS 128A,A01,895459,Fargason; Sharon Gayle,45,0,45,0
1745137964235,EDS 128B,A01,895543,Pappas; Elizabeth,45,0,45,0
1745137965263,EDS 139,A00,897203,Pappas; Elizabeth,45,0,45,0
1745137965263,EDS 139,B00,897209,Fargason; Sharon Gayle,45,0,45,0
1745137966288,EDS 201,A00,895545,Staff,44,0,45,1
1745137967317,EDS 203,A01,895581,Halter; Christopher P.,44,0,45,1
1745137968347,EDS 204R,A01,895625,Heinzman; Erica M.,45,0,45,0
1745137968347,EDS 204R,B01,895693,Halter; Christopher P.,28,0,45,17
1745137969374,EDS 206R,A00,895694,Fargason; Sharon Gayle,22,0,30,8
1745137969374,EDS 206R,B00,895695,Choi; Bailey Miyeon,21,0,30,9
1745137970400,EDS 250,A00,895697,Hemans; Patricia Ann Benitez,44,0,45,1
1745137971429,EDS 281,A00,895701,Meyerott; Theresa Ann,15,0,15,0
1745137972455,EDS 284,A00,895736,Meyerott; Theresa Ann,15,0,15,0
1745137973481,EDS 286,A00,897210,Fine; Sarah,15,0,15,0
1745137974508,EDS 289C,A01,895770,Daly; Alan J.,15,0,15,0
1745137975534,EDS 290,A00,897211,Hofstetter; Carolyn,15,0,15,0
1745137976564,LIGM 5A,A00,896162,Fischer-Grunski; Eva K,16,0,20,4
1745137977593,LIGM 5B,A00,896260,Fischer-Grunski; Eva K,19,0,20,1
1745137978621,LIGM 5C,A00,896308,Fischer-Grunski; Eva K,19,0,20,1
1745137979650,LIIT 5AS,A00,896313,Carnelos; Chiara,18,0,20,2
1745137980676,LIIT 5BS,A00,896416,Carnelos; Chiara,20,0,20,0
1745137981703,LIIT 5CS,A00,896564,Carnelos; Chiara,20,0,20,0
1745137982726,LISP 5A,A00,896588,Munoz Sanchez; Alicia,7,0,20,13
1745137983759,LISP 5B,A00,896653,Munoz Sanchez; Alicia,10,0,20,10
1745137984789,LISP 5C,A00,896655,Munoz Sanchez; Alicia,9,0,20,11
1745137985816,MAE 197,001,957918,Kleissl; Jan,9998,0,9999,1
1745137986840,MATH 2,A01,957937,Staff,34,0,35,1
1745137987863,MATH 197,001,957876,Kedlaya; Kiran S.,9996,0,9999,3
1745137988890,MCWP 40,A00,892729,Duru; Nur,16,0,20,4
1745137988890,MCWP 40,B00,893304,Montejo; Carolina,20,0,20,0
1745137989913,MCWP 40R,A00,893757,Redela; Pamela Morgan,0,3,20,20
1745137990939,MCWP 50,A00,893758,Morshed; Michael James,4,0,20,16
1745137990939,MCWP 50,B00,893761,Bartulis; Jason Michael,18,0,20,2
1745137991967,MCWP 50R,A00,893766,Compas; Sean Matthew,0,1,20,20
1745137991967,MCWP 50R,B00,893769,Carter; Jennifer A,5,0,20,15
1745137991967,MCWP 50R,C00,893771,Krone; Jarret,0,3,20,20
1745137991967,MCWP 50R,D00,893772,Miller; Elizabeth Deen,4,0,20,16
1745137991967,MCWP 50R,E00,893775,Carter; Andrea L,0,0,20,20
1745137992990,MMW 11R,A01,892721,Herbst; Matthew,22,0,30,8
1745137992990,MMW 11R,A02,892722,Herbst; Matthew,28,0,30,2
1745137994014,MMW 12R,A01,892724,Herbst; Matthew,0,5,16,16
1745137994014,MMW 12R,A02,892725,Herbst; Matthew,0,4,16,16
1745137995040,MMW 13R,A01,892727,Staff,0,29,16,16
1745137995040,MMW 13R,A02,892728,Staff,0,28,16,16
1745137996067,SIO 295LS,A00,894015,Staff,9,0,25,16
1745137997098,SIO 295S,A00,894020,Staff,9,0,25,16
1745137998122,SIOC 290S,A01,894063,Merrifield; Mark A,23,0,25,2
1745137999149,SIOC 291S,A01,894137,Gabriel; Corey John,23,0,25,2
1745138000180,SOCI 117,A01,895339,Staff,5,0,5,0
1745138001206,WES 237B,A00,894149,Staff,20,0,20,0
1745138003275,AESE 279B,A00,891859,Staff,35,0,35,0
1745138004302,AIP 197,001,891854,Staff,70,0,70,0
1745138005331,ANTH 289S,A00,891856,Gagneux; Pascal,12,0,12,0
1745138006360,BENG 196,001,957946,Engler; Adam J.,9996,0,9999,3
1745138007388,CAT 124RS,A01,956906,Staff,8,0,25,17
1745138008420,CAT 125RS,A01,922013,Staff,8,0,25,17
1745138009445,CLRE 250,A00,891860,Morris; Sheldon,9996,0,9999,3
1745138011502,CLRE 251R,A00,907817,Mehta; Ravindra L.,9995,0,9999,4
1745138012531,CLRE 252,A00,891864,Cuomo; Raphael Eduardo,9994,0,9999,5
1745138013556,CLRE 253,A00,891867,Vaida; Florin,9995,0,9999,4
1745138013556,CLRE 253,B00,907819,Staff,9999,0,9999,0
1745138014582,CLRE 259,A00,891868,Patel; Hemal,9998,0,9999,1
1745138015608,CLRE 260,A00,891872,Cuomo; Raphael Eduardo,9999,0,9999,0
1745138016634,CLRE 297,001,891888,Cuomo; Raphael Eduardo,9999,0,9999,0
1745138017658,CSS 201S,A01,892054,Mignozzetti; Umberto,30,0,30,0
1745138018687,CSS 202S,A01,892056,Mignozzetti; Umberto,30,0,30,0
1745138019713,DSC 197,001,956898,Eldridge; Justin Matthew,9998,0,9999,1
1745138020739,DSC 297,001,958000,Mazumdar; Arya,9999,0,9999,0
1745138021766,EAP 100,A00,905686,Staff,9774,0,9999,225
1745138022791,ECE 45,A01,892618,Staff,0,2,50,50
1745138023820,ECE 109,A01,892620,Staff,0,44,0,0
1745138024844,ECE 111,A01,892719,Staff,0,0,50,50
1745138025873,ECE 197,001,957920,Mercier; Patrick Philip,9992,0,9999,7
1745138026896,ECON 178,A01,907814,Zhu; Ying,29,0,35,6
1745138027922,EDS 115,A00,895312,Staff,42,0,45,3
1745138028950,EDS 117,A01,895337,Staff,30,0,30,0
1745138029975,EDS 125,A00,895341,Jones; Gabrielle Anastasia,43,0,45,2
1745138031000,EDS 128A,A01,895459,Fargason; Sharon Gayle,45,0,45,0
1745138032026,EDS 128B,A01,895543,Pappas; Elizabeth,45,0,45,0
1745138033053,EDS 139,A00,897203,Pappas; Elizabeth,45,0,45,0
1745138033053,EDS 139,B00,897209,Fargason; Sharon Gayle,45,0,45,0
1745138034078,EDS 201,A00,895545,Staff,44,0,45,1
1745138035105,EDS 203,A01,895581,Halter; Christopher P.,44,0,45,1
1745138036135,EDS 204R,A01,895625,Heinzman; Erica M.,45,0,45,0
1745138036135,EDS 204R,B01,895693,Halter; Christopher P.,28,0,45,17
1745138037175,EDS 206R,A00,895694,Fargason; Sharon Gayle,22,0,30,8
1745138037175,EDS 206R,B00,895695,Choi; Bailey Miyeon,21,0,30,9
1745138038199,EDS 250,A00,895697,Hemans; Patricia Ann Benitez,44,0,45,1
1745138039226,EDS 281,A00,895701,Meyerott; Theresa Ann,15,0,15,0
1745138040252,EDS 284,A00,895736,Meyerott; Theresa Ann,15,0,15,0
1745138041284,EDS 286,A00,897210,Fine; Sarah,15,0,15,0
1745138042314,EDS 289C,A01,895770,Daly; Alan J.,15,0,15,0
1745138043343,EDS 290,A00,897211,Hofstetter; Carolyn,15,0,15,0
1745138044369,LIGM 5A,A00,896162,Fischer-Grunski; Eva K,16,0,20,4
1745138045396,LIGM 5B,A00,896260,Fischer-Grunski; Eva K,19,0,20,1
1745138046425,LIGM 5C,A00,896308,Fischer-Grunski; Eva K,19,0,20,1
1745138047453,LIIT 5AS,A00,896313,Carnelos; Chiara,18,0,20,2
1745138048481,LIIT 5BS,A00,896416,Carnelos; Chiara,20,0,20,0
1745138049512,LIIT 5CS,A00,896564,Carnelos; Chiara,20,0,20,0
1745138050536,LISP 5A,A00,896588,Munoz Sanchez; Alicia,7,0,20,13
1745138051562,LISP 5B,A00,896653,Munoz Sanchez; Alicia,10,0,20,10
1745138052593,LISP 5C,A00,896655,Munoz Sanchez; Alicia,9,0,20,11
1745138053620,MAE 197,001,957918,Kleissl; Jan,9998,0,9999,1
1745138054647,MATH 2,A01,957937,Staff,34,0,35,1
1745138055676,MATH 197,001,957876,Kedlaya; Kiran S.,9996,0,9999,3
1745138056701,MCWP 40,A00,892729,Duru; Nur,16,0,20,4
1745138056701,MCWP 40,B00,893304,Montejo; Carolina,20,0,20,0
1745138057726,MCWP 40R,A00,893757,Redela; Pamela Morgan,0,3,20,20
1745138058753,MCWP 50,A00,893758,Morshed; Michael James,4,0,20,16
1745138058753,MCWP 50,B00,893761,Bartulis; Jason Michael,18,0,20,2
1745138059780,MCWP 50R,A00,893766,Compas; Sean Matthew,0,1,20,20
1745138059780,MCWP 50R,B00,893769,Carter; Jennifer A,5,0,20,15
1745138059780,MCWP 50R,C00,893771,Krone; Jarret,0,3,20,20
1745138059780,MCWP 50R,D00,893772,Miller; Elizabeth Deen,4,0,20,16
1745138059780,MCWP 50R,E00,893775,Carter; Andrea L,0,0,20,20
1745138060809,MMW 11R,A01,892721,Herbst; Matthew,22,0,30,8
1745138060809,MMW 11R,A02,892722,Herbst; Matthew,28,0,30,2
1745138061837,MMW 12R,A01,892724,Herbst; Matthew,0,5,16,16
1745138061837,MMW 12R,A02,892725,Herbst; Matthew,0,4,16,16
1745138062863,MMW 13R,A01,892727,Staff,0,29,16,16
1745138062863,MMW 13R,A02,892728,Staff,0,28,16,16
1745138063889,SIO 295LS,A00,894015,Staff,9,0,25,16
1745138064916,SIO 295S,A00,894020,Staff,9,0,25,16
1745138065941,SIOC 290S,A01,894063,Merrifield; Mark A,23,0,25,2
1745138066966,SIOC 291S,A01,894137,Gabriel; Corey John,23,0,25,2
1745138067992,SOCI 117,A01,895339,Staff,5,0,5,0
1745138069018,WES 237B,A00,894149,Staff,20,0,20,0
1745138071076,AESE 279B,A00,891859,Staff,35,0,35,0
1745138072102,AIP 197,001,891854,Staff,70,0,70,0
1745138073127,ANTH 289S,A00,891856,Gagneux; Pascal,12,0,12,0
1745138074154,BENG 196,001,957946,Engler; Adam J.,9996,0,9999,3
1745138075183,CAT 124RS,A01,956906,Staff,8,0,25,17
1745138076212,CAT 125RS,A01,922013,Staff,8,0,25,17
1745138077238,CLRE 250,A00,891860,Morris; Sheldon,9996,0,9999,3
1745138079296,CLRE 251R,A00,907817,Mehta; Ravindra L.,9995,0,9999,4
1745138080322,CLRE 252,A00,891864,Cuomo; Raphael Eduardo,9994,0,9999,5
1745138081349,CLRE 253,A00,891867,Vaida; Florin,9995,0,9999,4
1745138081349,CLRE 253,B00,907819,Staff,9999,0,9999,0
1745138082387,CLRE 259,A00,891868,Patel; Hemal,9998,0,9999,1
1745138083415,CLRE 260,A00,891872,Cuomo; Raphael Eduardo,9999,0,9999,0
1745138084446,CLRE 297,001,891888,Cuomo; Raphael Eduardo,9999,0,9999,0
1745138085476,CSS 201S,A01,892054,Mignozzetti; Umberto,30,0,30,0
1745138086503,CSS 202S,A01,892056,Mignozzetti; Umberto,30,0,30,0
1745138087531,DSC 197,001,956898,Eldridge; Justin Matthew,9998,0,9999,1
1745138088558,DSC 297,001,958000,Mazumdar; Arya,9999,0,9999,0
1745138089585,EAP 100,A00,905686,Staff,9774,0,9999,225
1745138090613,ECE 45,A01,892618,Staff,0,2,50,50
1745138091640,ECE 109,A01,892620,Staff,0,44,0,0
1745138092666,ECE 111,A01,892719,Staff,0,0,50,50
1745138093692,ECE 197,001,957920,Mercier; Patrick Philip,9992,0,9999,7
1745138094717,ECON 178,A01,907814,Zhu; Ying,29,0,35,6
1745138095745,EDS 115,A00,895312,Staff,42,0,45,3
1745138096776,EDS 117,A01,895337,Staff,30,0,30,0
1745138097805,EDS 125,A00,895341,Jones; Gabrielle Anastasia,43,0,45,2
1745138098832,EDS 128A,A01,895459,Fargason; Sharon Gayle,45,0,45,0
1745138099859,EDS 128B,A01,895543,Pappas; Elizabeth,45,0,45,0
1745138100890,EDS 139,A00,897203,Pappas; Elizabeth,45,0,45,0
1745138100890,EDS 139,B00,897209,Fargason; Sharon Gayle,45,0,45,0
1745138101919,EDS 201,A00,895545,Staff,44,0,45,1
1745138102945,EDS 203,A01,895581,Halter; Christopher P.,44,0,45,1
1745138103970,EDS 204R,A01,895625,Heinzman; Erica M.,45,0,45,0
1745138103970,EDS 204R,B01,895693,Halter; Christopher P.,28,0,45,17
1745138104996,EDS 206R,A00,895694,Fargason; Sharon Gayle,22,0,30,8
1745138104996,EDS 206R,B00,895695,Choi; Bailey Miyeon,21,0,30,9
1745138106028,EDS 250,A00,895697,Hemans; Patricia Ann Benitez,44,0,45,1
1745138107053,EDS 281,A00,895701,Meyerott; Theresa Ann,15,0,15,0
1745138108084,EDS 284,A00,895736,Meyerott; Theresa Ann,15,0,15,0
1745138109108,EDS 286,A00,897210,Fine; Sarah,15,0,15,0
1745138110135,EDS 289C,A01,895770,Daly; Alan J.,15,0,15,0
1745138111166,EDS 290,A00,897211,Hofstetter; Carolyn,15,0,15,0
1745138112197,LIGM 5A,A00,896162,Fischer-Grunski; Eva K,16,0,20,4
1745138113231,LIGM 5B,A00,896260,Fischer-Grunski; Eva K,19,0,20,1
1745138114262,LIGM 5C,A00,896308,Fischer-Grunski; Eva K,19,0,20,1
1745138115288,LIIT 5AS,A00,896313,Carnelos; Chiara,18,0,20,2
1745138116315,LIIT 5BS,A00,896416,Carnelos; Chiara,20,0,20,0
1745138117342,LIIT 5CS,A00,896564,Carnelos; Chiara,20,0,20,0
1745138118372,LISP 5A,A00,896588,Munoz Sanchez; Alicia,7,0,20,13
1745138119402,LISP 5B,A00,896653,Munoz Sanchez; Alicia,10,0,20,10
1745138120429,LISP 5C,A00,896655,Munoz Sanchez; Alicia,9,0,20,11
1745138121458,MAE 197,001,957918,Kleissl; Jan,9998,0,9999,1
1745138122483,MATH 2,A01,957937,Staff,34,0,35,1
1745138123514,MATH 197,001,957876,Kedlaya; Kiran S.,9996,0,9999,3
1745138124544,MCWP 40,A00,892729,Duru; Nur,16,0,20,4
1745138124544,MCWP 40,B00,893304,Montejo; Carolina,20,0,20,0
1745138125572,MCWP 40R,A00,893757,Redela; Pamela Morgan,0,3,20,20
1745138126603,MCWP 50,A00,893758,Morshed; Michael James,4,0,20,16
1745138126603,MCWP 50,B00,893761,Bartulis; Jason Michael,18,0,20,2
1745138127629,MCWP 50R,A00,893766,Compas; Sean Matthew,0,1,20,20
1745138127629,MCWP 50R,B00,893769,Carter; Jennifer A,5,0,20,15
1745138127629,MCWP 50R,C00,893771,Krone; Jarret,0,3,20,20
1745138127629,MCWP 50R,D00,893772,Miller; Elizabeth Deen,4,0,20,16
1745138127629,MCWP 50R,E00,893775,Carter; Andrea L,0,0,20,20
1745138128655,MMW 11R,A01,892721,Herbst; Matthew,22,0,30,8
1745138128655,MMW 11R,A02,892722,Herbst; Matthew,28,0,30,2
1745138129682,MMW 12R,A01,892724,Herbst; Matthew,0,5,16,16
1745138129682,MMW 12R,A02,892725,Herbst; Matthew,0,4,16,16
1745138130709,MMW 13R,A01,892727,Staff,0,29,16,16
1745138130709,MMW 13R,A02,892728,Staff,0,28,16,16
1745138131738,SIO 295LS,A00,894015,Staff,9,0,25,16
1745138132766,SIO 295S,A00,894020,Staff,9,0,25,16
1745138133799,SIOC 290S,A01,894063,Merrifield; Mark A,23,0,25,2
1745138134832,SIOC 291S,A01,894137,Gabriel; Corey John,23,0,25,2
1745138135857,SOCI 117,A01,895339,Staff,5,0,5,0
1745138136888,WES 237B,A00,894149,Staff,20,0,20,0
1745138138964,AESE 279B,A00,891859,Staff,35,0,35,0
1745138139988,AIP 197,001,891854,Staff,70,0,70,0
1745138141015,ANTH 289S,A00,891856,Gagneux; Pascal,12,0,12,0
1745138142043,BENG 196,001,957946,Engler; Adam J.,9996,0,9999,3
1745138143068,CAT 124RS,A01,956906,Staff,8,0,25,17
1745138144097,CAT 125RS,A01,922013,Staff,8,0,25,17
1745138145121,CLRE 250,A00,891860,Morris; Sheldon,9996,0,9999,3
1745138147171,CLRE 251R,A00,907817,Mehta; Ravindra L.,9995,0,9999,4
1745138148197,CLRE 252,A00,891864,Cuomo; Raphael Eduardo,9994,0,9999,5
1745138149226,CLRE 253,A00,891867,Vaida; Florin,9995,0,9999,4
1745138149226,CLRE 253,B00,907819,Staff,9999,0,9999,0
1745138150253,CLRE 259,A00,891868,Patel; Hemal,9998,0,9999,1
1745138151280,CLRE 260,A00,891872,Cuomo; Raphael Eduardo,9999,0,9999,0
1745138152306,CLRE 297,001,891888,Cuomo; Raphael Eduardo,9999,0,9999,0
1745138153332,CSS 201S,A01,892054,Mignozzetti; Umberto,30,0,30,0
1745138154358,CSS 202S,A01,892056,Mignozzetti; Umberto,30,0,30,0
1745138155385,DSC 197,001,956898,Eldridge; Justin Matthew,9998,0,9999,1
1745138156410,DSC 297,001,958000,Mazumdar; Arya,9999,0,9999,0
1745138157435,EAP 100,A00,905686,Staff,9774,0,9999,225
1745138158466,ECE 45,A01,892618,Staff,0,2,50,50
1745138159496,ECE 109,A01,892620,Staff,0,44,0,0
1745138160524,ECE 111,A01,892719,Staff,0,0,50,50
1745138161552,ECE 197,001,957920,Mercier; Patrick Philip,9992,0,9999,7
1745138162579,ECON 178,A01,907814,Zhu; Ying,29,0,35,6
1745138163633,EDS 115,A00,895312,Staff,42,0,45,3
1745138164662,EDS 117,A01,895337,Staff,30,0,30,0
1745138165691,EDS 125,A00,895341,Jones; Gabrielle Anastasia,43,0,45,2
1745138166720,EDS 128A,A01,895459,Fargason; Sharon Gayle,45,0,45,0
1745138167745,EDS 128B,A01,895543,Pappas; Elizabeth,45,0,45,0
1745138168774,EDS 139,A00,897203,Pappas; Elizabeth,45,0,45,0
1745138168774,EDS 139,B00,897209,Fargason; Sharon Gayle,45,0,45,0
1745138169801,EDS 201,A00,895545,Staff,44,0,45,1
1745138170830,EDS 203,A01,895581,Halter; Christopher P.,44,0,45,1
1745138171855,EDS 204R,A01,895625,Heinzman; Erica M.,45,0,45,0
1745138171855,EDS 204R,B01,895693,Halter; Christopher P.,28,0,45,17
1745138172878,EDS 206R,A00,895694,Fargason; Sharon Gayle,22,0,30,8
1745138172878,EDS 206R,B00,895695,Choi; Bailey Miyeon,21,0,30,9
1745138173908,EDS 250,A00,895697,Hemans; Patricia Ann Benitez,44,0,45,1
1745138174933,EDS 281,A00,895701,Meyerott; Theresa Ann,15,0,15,0
1745138175959,EDS 284,A00,895736,Meyerott; Theresa Ann,15,0,15,0
1745138176987,EDS 286,A00,897210,Fine; Sarah,15,0,15,0
1745138178012,EDS 289C,A01,895770,Daly; Alan J.,15,0,15,0
1745138179045,EDS 290,A00,897211,Hofstetter; Carolyn,15,0,15,0
1745138180078,LIGM 5A,A00,896162,Fischer-Grunski; Eva K,16,0,20,4
1745138181106,LIGM 5B,A00,896260,Fischer-Grunski; Eva K,19,0,20,1
1745138182134,LIGM 5C,A00,896308,Fischer-Grunski; Eva K,19,0,20,1
1745138183160,LIIT 5AS,A00,896313,Carnelos; Chiara,18,0,20,2
1745138184184,LIIT 5BS,A00,896416,Carnelos; Chiara,20,0,20,0
1745138185215,LIIT 5CS,A00,896564,Carnelos; Chiara,20,0,20,0
1745138186246,LISP 5A,A00,896588,Munoz Sanchez; Alicia,7,0,20,13
1745138187276,LISP 5B,A00,896653,Munoz Sanchez; Alicia,10,0,20,10
1745138188302,LISP 5C,A00,896655,Munoz Sanchez; Alicia,9,0,20,11
1745138189329,MAE 197,001,957918,Kleissl; Jan,9998,0,9999,1
1745138190356,MATH 2,A01,957937,Staff,34,0,35,1
1745138191388,MATH 197,001,957876,Kedlaya; Kiran S.,9996,0,9999,3
1745138192429,MCWP 40,A00,892729,Duru; Nur,16,0,20,4
1745138192429,MCWP 40,B00,893304,Montejo; Carolina,20,0,20,0
1745138193465,MCWP 40R,A00,893757,Redela; Pamela Morgan,0,3,20,20
1745138194491,MCWP 50,A00,893758,Morshed; Michael James,4,0,20,16
1745138194491,MCWP 50,B00,893761,Bartulis; Jason Michael,18,0,20,2
1745138195526,MCWP 50R,A00,893766,Compas; Sean Matthew,0,1,20,20
1745138195526,MCWP 50R,B00,893769,Carter; Jennifer A,5,0,20,15
1745138195526,MCWP 50R,C00,893771,Krone; Jarret,0,3,20,20
1745138195526,MCWP 50R,D00,893772,Miller; Elizabeth Deen,4,0,20,16
1745138195526,MCWP 50R,E00,893775,Carter; Andrea L,0,0,20,20
1745138196560,MMW 11R,A01,892721,Herbst; Matthew,22,0,30,8
1745138196560,MMW 11R,A02,892722,Herbst; Matthew,28,0,30,2
1745138198344,MMW 12R,A01,892724,Herbst; Matthew,0,5,16,16
1745138198344,MMW 12R,A02,892725,Herbst; Matthew,0,4,16,16
1745138207372,MMW 13R,A01,892727,Staff,0,29,16,16
1745138207372,MMW 13R,A02,892728,Staff,0,28,16,16
1745138208398,SIO 295LS,A00,894015,Staff,9,0,25,16
1745138209423,SIO 295S,A00,894020,Staff,9,0,25,16
1745138210459,SIOC 290S,A01,894063,Merrifield; Mark A,23,0,25,2
1745138211513,SIOC 291S,A01,894137,Gabriel; Corey John,23,0,25,2
1745138213177,SOCI 117,A01,895339,Staff,5,0,5,0
1745138214203,WES 237B,A00,894149,Staff,20,0,20,0
1745138216358,AESE 279B,A00,891859,Staff,35,0,35,0
1745138217383,AIP 197,001,891854,Staff,70,0,70,0
1745138218408,ANTH 289S,A00,891856,Gagneux; Pascal,12,0,12,0
1745138219443,BENG 196,001,957946,Engler; Adam J.,9996,0,9999,3
1745138220475,CAT 124RS,A01,956906,Staff,8,0,25,17
1745138221501,CAT 125RS,A01,922013,Staff,8,0,25,17
1745138222528,CLRE 250,A00,891860,Morris; Sheldon,9996,0,9999,3
1745138224581,CLRE 251R,A00,907817,Mehta; Ravindra L.,9995,0,9999,4
1745138225608,CLRE 252,A00,891864,Cuomo; Raphael Eduardo,9994,0,9999,5
1745138226642,CLRE 253,A00,891867,Vaida; Florin,9995,0,9999,4
1745138226642,CLRE 253,B00,907819,Staff,9999,0,9999,0
1745138227675,CLRE 259,A00,891868,Patel; Hemal,9998,0,9999,1
1745138228705,CLRE 260,A00,891872,Cuomo; Raphael Eduardo,9999,0,9999,0
1745138229732,CLRE 297,001,891888,Cuomo; Raphael Eduardo,9999,0,9999,0
1745138230767,CSS 201S,A01,892054,Mignozzetti; Umberto,30,0,30,0
1745138231794,CSS 202S,A01,892056,Mignozzetti; Umberto,30,0,30,0
1745138232821,DSC 197,001,956898,Eldridge; Justin Matthew,9998,0,9999,1
1745138233847,DSC 297,001,958000,Mazumdar; Arya,9999,0,9999,0
1745138234873,EAP 100,A00,905686,Staff,9774,0,9999,225
1745138235900,ECE 45,A01,892618,Staff,0,2,50,50
1745138236930,ECE 109,A01,892620,Staff,0,44,0,0
1745138237955,ECE 111,A01,892719,Staff,0,0,50,50
1745138238979,ECE 197,001,957920,Mercier; Patrick Philip,9992,0,9999,7
1745138240028,ECON 178,A01,907814,Zhu; Ying,29,0,35,6
1745138241054,EDS 115,A00,895312,Staff,42,0,45,3
1745138242082,EDS 117,A01,895337,Staff,30,0,30,0
1745138243116,EDS 125,A00,895341,Jones; Gabrielle Anastasia,43,0,45,2
1745138244141,EDS 128A,A01,895459,Fargason; Sharon Gayle,45,0,45,0
1745138245176,EDS 128B,A01,895543,Pappas; Elizabeth,45,0,45,0
1745138246206,EDS 139,A00,897203,Pappas; Elizabeth,45,0,45,0
1745138246206,EDS 139,B00,897209,Fargason; Sharon Gayle,45,0,45,0
1745138247233,EDS 201,A00,895545,Staff,44,0,45,1
1745138248260,EDS 203,A01,895581,Halter; Christopher P.,44,0,45,1
1745138251093,EDS 204R,A01,895625,Heinzman; Erica M.,45,0,45,0
1745138251093,EDS 204R,B01,895693,Halter; Christopher P.,28,0,45,17
1745138252120,EDS 206R,A00,895694,Fargason; Sharon Gayle,22,0,30,8
1745138252120,EDS 206R,B00,895695,Choi; Bailey Miyeon,21,0,30,9
1745138253167,EDS 250,A00,895697,Hemans; Patricia Ann Benitez,44,0,45,1
1745138254247,EDS 281,A00,895701,Meyerott; Theresa Ann,15,0,15,0
1745138255273,EDS 284,A00,895736,Meyerott; Theresa Ann,15,0,15,0
1745138256333,EDS 286,A00,897210,Fine; Sarah,15,0,15,0
1745138257357,EDS 289C,A01,895770,Daly; Alan J.,15,0,15,0
1745138258384,EDS 290,A00,897211,Hofstetter; Carolyn,15,0,15,0
1745138259411,LIGM 5A,A00,896162,Fischer-Grunski; Eva K,16,0,20,4
1745138260437,LIGM 5B,A00,896260,Fischer-Grunski; Eva K,19,0,20,1
1745138261463,LIGM 5C,A00,896308,Fischer-Grunski; Eva K,19,0,20,1
1745138262491,LIIT 5AS,A00,896313,Carnelos; Chiara,18,0,20,2
1745138263516,LIIT 5BS,A00,896416,Carnelos; Chiara,20,0,20,0
1745138264541,LIIT 5CS,A00,896564,Carnelos; Chiara,20,0,20,0
1745138265567,LISP 5A,A00,896588,Munoz Sanchez; Alicia,7,0,20,13
1745138266612,LISP 5B,A00,896653,Munoz Sanchez; Alicia,10,0,20,10
1745138267645,LISP 5C,A00,896655,Munoz Sanchez; Alicia,9,0,20,11
1745138268673,MAE 197,001,957918,Kleissl; Jan,9998,0,9999,1
1745138269708,MATH 2,A01,957937,Staff,34,0,35,1
1745138270743,MATH 197,001,957876,Kedlaya; Kiran S.,9996,0,9999,3
1745138271770,MCWP 40,A00,892729,Duru; Nur,16,0,20,4
1745138271770,MCWP 40,B00,893304,Montejo; Carolina,20,0,20,0
1745138272797,MCWP 40R,A00,893757,Redela; Pamela Morgan,0,3,20,20
1745138273824,MCWP 50,A00,893758,Morshed; Michael James,4,0,20,16
1745138273824,MCWP 50,B00,893761,Bartulis; Jason Michael,18,0,20,2
1745138274859,MCWP 50R,A00,893766,Compas; Sean Matthew,0,1,20,20
1745138274859,MCWP 50R,B00,893769,Carter; Jennifer A,5,0,20,15
1745138274859,MCWP 50R,C00,893771,Krone; Jarret,0,3,20,20
1745138274859,MCWP 50R,D00,893772,Miller; Elizabeth Deen,4,0,20,16
1745138274859,MCWP 50R,E00,893775,Carter; Andrea L,0,0,20,20
1745138275896,MMW 11R,A01,892721,Herbst; Matthew,22,0,30,8
1745138275896,MMW 11R,A02,892722,Herbst; Matthew,28,0,30,2
1745138276922,MMW 12R,A01,892724,Herbst; Matthew,0,5,16,16
1745138276922,MMW 12R,A02,892725,Herbst; Matthew,0,4,16,16
1745138277949,MMW 13R,A01,892727,Staff,0,29,16,16
1745138277949,MMW 13R,A02,892728,Staff,0,28,16,16
1745138278974,SIO 295LS,A00,894015,Staff,9,0,25,16
1745138280002,SIO 295S,A00,894020,Staff,9,0,25,16
1745138281029,SIOC 290S,A01,894063,Merrifield; Mark A,23,0,25,2
1745138282058,SIOC 291S,A01,894137,Gabriel; Corey John,23,0,25,2
1745138283082,SOCI 117,A01,895339,Staff,5,0,5,0
1745138284108,WES 237B,A00,894149,Staff,20,0,20,0
1745138286186,AESE 279B,A00,891859,Staff,35,0,35,0
1745138287214,AIP 197,001,891854,Staff,70,0,70,0
1745138288239,ANTH 289S,A00,891856,Gagneux; Pascal,12,0,12,0
1745138289266,BENG 196,001,957946,Engler; Adam J.,9996,0,9999,3
1745138290292,CAT 124RS,A01,956906,Staff,8,0,25,17
1745138291318,CAT 125RS,A01,922013,Staff,8,0,25,17
1745138292344,CLRE 250,A00,891860,Morris; Sheldon,9996,0,9999,3
1745138294403,CLRE 251R,A00,907817,Mehta; Ravindra L.,9995,0,9999,4
1745138295428,CLRE 252,A00,891864,Cuomo; Raphael Eduardo,9994,0,9999,5
1745138296457,CLRE 253,A00,891867,Vaida; Florin,9995,0,9999,4
1745138296457,CLRE 253,B00,907819,Staff,9999,0,9999,0
1745138297487,CLRE 259,A00,891868,Patel; Hemal,9998,0,9999,1
1745138298513,CLRE 260,A00,891872,Cuomo; Raphael Eduardo,9999,0,9999,0
1745138299543,CLRE 297,001,891888,Cuomo; Raphael Eduardo,9999,0,9999,0
1745138300570,CSS 201S,A01,892054,Mignozzetti; Umberto,30,0,30,0
1745138301601,CSS 202S,A01,892056,Mignozzetti; Umberto,30,0,30,0
1745138302628,DSC 197,001,956898,Eldridge; Justin Matthew,9998,0,9999,1
1745138303655,DSC 297,001,958000,Mazumdar; Arya,9999,0,9999,0
1745138304700,EAP 100,A00,905686,Staff,9774,0,9999,225
1745138305725,ECE 45,A01,892618,Staff,0,2,50,50
1745138306751,ECE 109,A01,892620,Staff,0,44,0,0
1745138307780,ECE 111,A01,892719,Staff,0,0,50,50
1745138308817,ECE 197,001,957920,Mercier; Patrick Philip,9992,0,9999,7
1745138309843,ECON 178,A01,907814,Zhu; Ying,29,0,35,6
1745138310872,EDS 115,A00,895312,Staff,42,0,45,3
1745138311897,EDS 117,A01,895337,Staff,30,0,30,0
1745138312923,EDS 125,A00,895341,Jones; Gabrielle Anastasia,43,0,45,2
1745138313951,EDS 128A,A01,895459,Fargason; Sharon Gayle,45,0,45,0
1745138314978,EDS 128B,A01,895543,Pappas; Elizabeth,45,0,45,0
1745138316005,EDS 139,A00,897203,Pappas; Elizabeth,45,0,45,0
1745138316005,EDS 139,B00,897209,Fargason; Sharon Gayle,45,0,45,0
1745138317033,EDS 201,A00,895545,Staff,44,0,45,1
1745138318063,EDS 203,A01,895581,Halter; Christopher P.,44,0,45,1
1745138319093,EDS 204R,A01,895625,Heinzman; Erica M.,45,0,45,0
1745138319093,EDS 204R,B01,895693,Halter; Christopher P.,28,0,45,17
1745138320125,EDS 206R,A00,895694,Fargason; Sharon Gayle,22,0,30,8
1745138320125,EDS 206R,B00,895695,Choi; Bailey Miyeon,21,0,30,9
1745138321156,EDS 250,A00,895697,Hemans; Patricia Ann Benitez,44,0,45,1
1745138322180,EDS 281,A00,895701,Meyerott; Theresa Ann,15,0,15,0
1745138323206,EDS 284,A00,895736,Meyerott; Theresa Ann,15,0,15,0
1745138324230,EDS 286,A00,897210,Fine; Sarah,15,0,15,0
1745138325259,EDS 289C,A01,895770,Daly; Alan J.,15,0,15,0
1745138326284,EDS 290,A00,897211,Hofstetter; Carolyn,15,0,15,0
1745138327311,LIGM 5A,A00,896162,Fischer-Grunski; Eva K,16,0,20,4
1745138328344,LIGM 5B,A00,896260,Fischer-Grunski; Eva K,19,0,20,1
1745138329369,LIGM 5C,A00,896308,Fischer-Grunski; Eva K,19,0,20,1
1745138330395,LIIT 5AS,A00,896313,Carnelos; Chiara,18,0,20,2
1745138331431,LIIT 5BS,A00,896416,Carnelos; Chiara,20,0,20,0
1745138332458,LIIT 5CS,A00,896564,Carnelos; Chiara,20,0,20,0
1745138333484,LISP 5A,A00,896588,Munoz Sanchez; Alicia,7,0,20,13
1745138334513,LISP 5B,A00,896653,Munoz Sanchez; Alicia,10,0,20,10
1745138335542,LISP 5C,A00,896655,Munoz Sanchez; Alicia,9,0,20,11
1745138336573,MAE 197,001,957918,Kleissl; Jan,9998,0,9999,1
1745138337598,MATH 2,A01,957937,Staff,34,0,35,1
1745138338629,MATH 197,001,957876,Kedlaya; Kiran S.,9996,0,9999,3
1745138339657,MCWP 40,A00,892729,Duru; Nur,16,0,20,4
1745138339657,MCWP 40,B00,893304,Montejo; Carolina,20,0,20,0
1745138340685,MCWP 40R,A00,893757,Redela; Pamela Morgan,0,3,20,20
1745138341716,MCWP 50,A00,893758,Morshed; Michael James,4,0,20,16
1745138341716,MCWP 50,B00,893761,Bartulis; Jason Michael,18,0,20,2
1745138342753,MCWP 50R,A00,893766,Compas; Sean Matthew,0,1,20,20
1745138342753,MCWP 50R,B00,893769,Carter; Jennifer A,5,0,20,15
1745138342753,MCWP 50R,C00,893771,Krone; Jarret,0,3,20,20
1745138342753,MCWP 50R,D00,893772,Miller; Elizabeth Deen,4,0,20,16
1745138342753,MCWP 50R,E00,893775,Carter; Andrea L,0,0,20,20
1745138343782,MMW 11R,A01,892721,Herbst; Matthew,22,0,30,8
1745138343782,MMW 11R,A02,892722,Herbst; Matthew,28,0,30,2
1745138344813,MMW 12R,A01,892724,Herbst; Matthew,0,5,16,16
1745138344813,MMW 12R,A02,892725,Herbst; Matthew,0,4,16,16
1745138345845,MMW 13R,A01,892727,Staff,0,29,16,16
1745138345845,MMW 13R,A02,892728,Staff,0,28,16,16
1745138346876,SIO 295LS,A00,894015,Staff,9,0,25,16
1745138347905,SIO 295S,A00,894020,Staff,9,0,25,16
1745138348940,SIOC 290S,A01,894063,Merrifield; Mark A,23,0,25,2
1745138349966,SIOC 291S,A01,894137,Gabriel; Corey John,23,0,25,2
1745138350992,SOCI 117,A01,895339,Staff,5,0,5,0
1745138352021,WES 237B,A00,894149,Staff,20,0,20,0
1745138354090,AESE 279B,A00,891859,Staff,35,0,35,0
1745138355115,AIP 197,001,891854,Staff,70,0,70,0
1745138356146,ANTH 289S,A00,891856,Gagneux; Pascal,12,0,12,0
1745138357175,BENG 196,001,957946,Engler; Adam J.,9996,0,9999,3
1745138358208,CAT 124RS,A01,956906,Staff,8,0,25,17
1745138359235,CAT 125RS,A01,922013,Staff,8,0,25,17
1745138360286,CLRE 250,A00,891860,Morris; Sheldon,9996,0,9999,3
1745138362831,CLRE 251R,A00,907817,Mehta; Ravindra L.,9995,0,9999,4
1745138367405,CLRE 252,A00,891864,Cuomo; Raphael Eduardo,9994,0,9999,5
1745138368430,CLRE 253,A00,891867,Vaida; Florin,9995,0,9999,4
1745138368430,CLRE 253,B00,907819,Staff,9999,0,9999,0
1745138369457,CLRE 259,A00,891868,Patel; Hemal,9998,0,9999,1
1745138370488,CLRE 260,A00,891872,Cuomo; Raphael Eduardo,9999,0,9999,0
1745138371515,CLRE 297,001,891888,Cuomo; Raphael Eduardo,9999,0,9999,0
1745138372543,CSS 201S,A01,892054,Mignozzetti; Umberto,30,0,30,0
1745138373569,CSS 202S,A01,892056,Mignozzetti; Umberto,30,0,30,0
1745138374617,DSC 197,001,956898,Eldridge; Justin Matthew,9998,0,9999,1
1745138375645,DSC 297,001,958000,Mazumdar; Arya,9999,0,9999,0
1745138376678,EAP 100,A00,905686,Staff,9774,0,9999,225
1745138377707,ECE 45,A01,892618,Staff,0,2,50,50
1745138378732,ECE 109,A01,892620,Staff,0,44,0,0
1745138379758,ECE 111,A01,892719,Staff,0,0,50,50
1745138380786,ECE 197,001,957920,Mercier; Patrick Philip,9992,0,9999,7
1745138381814,ECON 178,A01,907814,Zhu; Ying,29,0,35,6
1745138382840,EDS 115,A00,895312,Staff,42,0,45,3
1745138383880,EDS 117,A01,895337,Staff,30,0,30,0
1745138384913,EDS 125,A00,895341,Jones; Gabrielle Anastasia,43,0,45,2
1745138385951,EDS 128A,A01,895459,Fargason; Sharon Gayle,45,0,45,0
1745138386976,EDS 128B,A01,895543,Pappas; Elizabeth,45,0,45,0
1745138388001,EDS 139,A00,897203,Pappas; Elizabeth,45,0,45,0
1745138388001,EDS 139,B00,897209,Fargason; Sharon Gayle,45,0,45,0
1745138389033,EDS 201,A00,895545,Staff,44,0,45,1
1745138390062,EDS 203,A01,895581,Halter; Christopher P.,44,0,45,1
1745138391108,EDS 204R,A01,895625,Heinzman; Erica M.,45,0,45,0
1745138391108,EDS 204R,B01,895693,Halter; Christopher P.,28,0,45,17
1745138392133,EDS 206R,A00,895694,Fargason; Sharon Gayle,22,0,30,8
1745138392133,EDS 206R,B00,895695,Choi; Bailey Miyeon,21,0,30,9
1745138393159,EDS 250,A00,895697,Hemans; Patricia Ann Benitez,44,0,45,1
1745138394183,EDS 281,A00,895701,Meyerott; Theresa Ann,15,0,15,0
1745138395216,EDS 284,A00,895736,Meyerott; Theresa Ann,15,0,15,0
1745138396240,EDS 286,A00,897210,Fine; Sarah,15,0,15,0
1745138397273,EDS 289C,A01,895770,Daly; Alan J.,15,0,15,0
1745138398297,EDS 290,A00,897211,Hofstetter; Carolyn,15,0,15,0
1745138399325,LIGM 5A,A00,896162,Fischer-Grunski; Eva K,16,0,20,4
1745138400351,LIGM 5B,A00,896260,Fischer-Grunski; Eva K,19,0,20,1
1745138401397,LIGM 5C,A00,896308,Fischer-Grunski; Eva K,19,0,20,1
1745138402424,LIIT 5AS,A00,896313,Carnelos; Chiara,18,0,20,2
1745138403466,LIIT 5BS,A00,896416,Carnelos; Chiara,20,0,20,0
1745138404490,LIIT 5CS,A00,896564,Carnelos; Chiara,20,0,20,0
1745138405517,LISP 5A,A00,896588,Munoz Sanchez; Alicia,7,0,20,13
1745138406543,LISP 5B,A00,896653,Munoz Sanchez; Alicia,10,0,20,10
1745138407578,LISP 5C,A00,896655,Munoz Sanchez; Alicia,9,0,20,11
1745138408604,MAE 197,001,957918,Kleissl; Jan,9998,0,9999,1
1745138409629,MATH 2,A01,957937,Staff,34,0,35,1
1745138410671,MATH 197,001,957876,Kedlaya; Kiran S.,9996,0,9999,3
1745138411697,MCWP 40,A00,892729,Duru; Nur,16,0,20,4
1745138411697,MCWP 40,B00,893304,Montejo; Carolina,20,0,20,0
1745138412721,MCWP 40R,A00,893757,Redela; Pamela Morgan,0,3,20,20
1745138413758,MCWP 50,A00,893758,Morshed; Michael James,4,0,20,16
1745138413758,MCWP 50,B00,893761,Bartulis; Jason Michael,18,0,20,2
1745138414797,MCWP 50R,A00,893766,Compas; Sean Matthew,0,1,20,20
1745138414797,MCWP 50R,B00,893769,Carter; Jennifer A,5,0,20,15
1745138414797,MCWP 50R,C00,893771,Krone; Jarret,0,3,20,20
1745138414797,MCWP 50R,D00,893772,Miller; Elizabeth Deen,4,0,20,16
1745138414797,MCWP 50R,E00,893775,Carter; Andrea L,0,0,20,20
1745138415822,MMW 11R,A01,892721,Herbst; Matthew,22,0,30,8
1745138415822,MMW 11R,A02,892722,Herbst; Matthew,28,0,30,2
1745138416855,MMW 12R,A01,892724,Herbst; Matthew,0,5,16,16
1745138416855,MMW 12R,A02,892725,Herbst; Matthew,0,4,16,16
1745138417894,MMW 13R,A01,892727,Staff,0,29,16,16
1745138417894,MMW 13R,A02,892728,Staff,0,28,16,16
1745138418918,SIO 295LS,A00,894015,Staff,9,0,25,16
1745138419947,SIO 295S,A00,894020,Staff,9,0,25,16
1745138420972,SIOC 290S,A01,894063,Merrifield; Mark A,23,0,25,2
1745138422000,SIOC 291S,A01,894137,Gabriel; Corey John,23,0,25,2
1745138423027,SOCI 117,A01,895339,Staff,5,0,5,0
1745138424053,WES 237B,A00,894149,Staff,20,0,20,0
1745138426143,AESE 279B,A00,891859,Staff,35,0,35,0
1745138427170,AIP 197,001,891854,Staff,70,0,70,0
1745138432160,ANTH 289S,A00,891856,Gagneux; Pascal,12,0,12,0
1745138433187,BENG 196,001,957946,Engler; Adam J.,9996,0,9999,3
1745138434214,CAT 124RS,A01,956906,Staff,8,0,25,17
1745138437466,CAT 125RS,A01,922013,Staff,8,0,25,17
1745138438493,CLRE 250,A00,891860,Morris; Sheldon,9996,0,9999,3
1745138440559,CLRE 251R,A00,907817,Mehta; Ravindra L.,9995,0,9999,4
1745138441583,CLRE 252,A00,891864,Cuomo; Raphael Eduardo,9994,0,9999,5
1745138442623,CLRE 253,A00,891867,Vaida; Florin,9995,0,9999,4
1745138442623,CLRE 253,B00,907819,Staff,9999,0,9999,0
1745138443651,CLRE 259,A00,891868,Patel; Hemal,9998,0,9999,1
1745138444679,CLRE 260,A00,891872,Cuomo; Raphael Eduardo,9999,0,9999,0
1745138445705,CLRE 297,001,891888,Cuomo; Raphael Eduardo,9999,0,9999,0
1745138446731,CSS 201S,A01,892054,Mignozzetti; Umberto,30,0,30,0
1745138447758,CSS 202S,A01,892056,Mignozzetti; Umberto,30,0,30,0
1745138448783,DSC 197,001,956898,Eldridge; Justin Matthew,9998,0,9999,1
1745138449809,DSC 297,001,958000,Mazumdar; Arya,9999,0,9999,0
1745138450839,EAP 100,A00,905686,Staff,9774,0,9999,225
1745138451866,ECE 45,A01,892618,Staff,0,2,50,50
1745138452905,ECE 109,A01,892620,Staff,0,44,0,0
1745138453930,ECE 111,A01,892719,Staff,0,0,50,50
1745138455104,ECE 197,001,957920,Mercier; Patrick Philip,9992,0,9999,7
1745138456133,ECON 178,A01,907814,Zhu; Ying,29,0,35,6
1745138457165,EDS 115,A00,895312,Staff,42,0,45,3
1745138458205,EDS 117,A01,895337,Staff,30,0,30,0
1745138459455,EDS 125,A00,895341,Jones; Gabrielle Anastasia,43,0,45,2
1745138460484,EDS 128A,A01,895459,Fargason; Sharon Gayle,45,0,45,0
1745138461520,EDS 128B,A01,895543,Pappas; Elizabeth,45,0,45,0
1745138462547,EDS 139,A00,897203,Pappas; Elizabeth,45,0,45,0
1745138462547,EDS 139,B00,897209,Fargason; Sharon Gayle,45,0,45,0
1745138463582,EDS 201,A00,895545,Staff,44,0,45,1
1745138464610,EDS 203,A01,895581,Halter; Christopher P.,44,0,45,1
1745138465636,EDS 204R,A01,895625,Heinzman; Erica M.,45,0,45,0
1745138465636,EDS 204R,B01,895693,Halter; Christopher P.,28,0,45,17
1745138466663,EDS 206R,A00,895694,Fargason; Sharon Gayle,22,0,30,8
1745138466663,EDS 206R,B00,895695,Choi; Bailey Miyeon,21,0,30,9
1745138467689,EDS 250,A00,895697,Hemans; Patricia Ann Benitez,44,0,45,1
1745138468727,EDS 281,A00,895701,Meyerott; Theresa Ann,15,0,15,0
1745138469757,EDS 284,A00,895736,Meyerott; Theresa Ann,15,0,15,0
1745138470793,EDS 286,A00,897210,Fine; Sarah,15,0,15,0
1745138471829,EDS 289C,A01,895770,Daly; Alan J.,15,0,15,0
1745138472861,EDS 290,A00,897211,Hofstetter; Carolyn,15,0,15,0
1745138473890,LIGM 5A,A00,896162,Fischer-Grunski; Eva K,16,0,20,4
1745138474915,LIGM 5B,A00,896260,Fischer-Grunski; Eva K,19,0,20,1
1745138475942,LIGM 5C,A00,896308,Fischer-Grunski; Eva K,19,0,20,1
1745138476966,LIIT 5AS,A00,896313,Carnelos; Chiara,18,0,20,2
1745138478003,LIIT 5BS,A00,896416,Carnelos; Chiara,20,0,20,0
1745138479040,LIIT 5CS,A00,896564,Carnelos; Chiara,20,0,20,0
1745138480068,LISP 5A,A00,896588,Munoz Sanchez; Alicia,7,0,20,13
1745138481094,LISP 5B,A00,896653,Munoz Sanchez; Alicia,10,0,20,10
1745138482129,LISP 5C,A00,896655,Munoz Sanchez; Alicia,9,0,20,11
1745138483165,MAE 197,001,957918,Kleissl; Jan,9998,0,9999,1
1745138484191,MATH 2,A01,957937,Staff,34,0,35,1
1745138485236,MATH 197,001,957876,Kedlaya; Kiran S.,9996,0,9999,3
1745138486264,MCWP 40,A00,892729,Duru; Nur,16,0,20,4
1745138486264,MCWP 40,B00,893304,Montejo; Carolina,20,0,20,0
1745138487292,MCWP 40R,A00,893757,Redela; Pamela Morgan,0,3,20,20
1745138488319,MCWP 50,A00,893758,Morshed; Michael James,4,0,20,16
1745138488319,MCWP 50,B00,893761,Bartulis; Jason Michael,18,0,20,2
1745138489347,MCWP 50R,A00,893766,Compas; Sean Matthew,0,1,20,20
1745138489347,MCWP 50R,B00,893769,Carter; Jennifer A,5,0,20,15
1745138489347,MCWP 50R,C00,893771,Krone; Jarret,0,3,20,20
1745138489347,MCWP 50R,D00,893772,Miller; Elizabeth Deen,4,0,20,16
1745138489347,MCWP 50R,E00,893775,Carter; Andrea L,0,0,20,20
1745138490414,MMW 11R,A01,892721,Herbst; Matthew,22,0,30,8
1745138490414,MMW 11R,A02,892722,Herbst; Matthew,28,0,30,2
1745138491442,MMW 12R,A01,892724,Herbst; Matthew,0,5,16,16
1745138491442,MMW 12R,A02,892725,Herbst; Matthew,0,4,16,16
1745138492467,MMW 13R,A01,892727,Staff,0,29,16,16
1745138492467,MMW 13R,A02,892728,Staff,0,28,16,16
1745138493493,SIO 295LS,A00,894015,Staff,9,0,25,16
1745138495669,SIO 295S,A00,894020,Staff,9,0,25,16
1745138496696,SIOC 290S,A01,894063,Merrifield; Mark A,23,0,25,2
1745138497734,SIOC 291S,A01,894137,Gabriel; Corey John,23,0,25,2
1745138498762,SOCI 117,A01,895339,Staff,5,0,5,0
1745138499788,WES 237B,A00,894149,Staff,20,0,20,0
1745138501963,AESE 279B,A00,891859,Staff,35,0,35,0
1745138502989,AIP 197,001,891854,Staff,70,0,70,0
1745138504027,ANTH 289S,A00,891856,Gagneux; Pascal,12,0,12,0
1745138505069,BENG 196,001,957946,Engler; Adam J.,9996,0,9999,3
1745138506095,CAT 124RS,A01,956906,Staff,8,0,25,17
1745138507121,CAT 125RS,A01,922013,Staff,8,0,25,17
1745138508155,CLRE 250,A00,891860,Morris; Sheldon,9996,0,9999,3
1745138510215,CLRE 251R,A00,907817,Mehta; Ravindra L.,9995,0,9999,4
1745138511255,CLRE 252,A00,891864,Cuomo; Raphael Eduardo,9994,0,9999,5
1745138512290,CLRE 253,A00,891867,Vaida; Florin,9995,0,9999,4
1745138512290,CLRE 253,B00,907819,Staff,9999,0,9999,0
1745138513326,CLRE 259,A00,891868,Patel; Hemal,9998,0,9999,1
1745138514356,CLRE 260,A00,891872,Cuomo; Raphael Eduardo,9999,0,9999,0
1745138515382,CLRE 297,001,891888,Cuomo; Raphael Eduardo,9999,0,9999,0
1745138516409,CSS 201S,A01,892054,Mignozzetti; Umberto,30,0,30,0
1745138517435,CSS 202S,A01,892056,Mignozzetti; Umberto,30,0,30,0
1745138518461,DSC 197,001,956898,Eldridge; Justin Matthew,9998,0,9999,1
1745138519497,DSC 297,001,958000,Mazumdar; Arya,9999,0,9999,0
1745138520524,EAP 100,A00,905686,Staff,9774,0,9999,225
1745138521557,ECE 45,A01,892618,Staff,0,2,50,50
1745138522584,ECE 109,A01,892620,Staff,0,44,0,0
1745138523609,ECE 111,A01,892719,Staff,0,0,50,50
1745138524644,ECE 197,001,957920,Mercier; Patrick Philip,9992,0,9999,7
1745138525672,ECON 178,A01,907814,Zhu; Ying,29,0,35,6
1745138526699,EDS 115,A00,895312,Staff,42,0,45,3
1745138527733,EDS 117,A01,895337,Staff,30,0,30,0
1745138528759,EDS 125,A00,895341,Jones; Gabrielle Anastasia,43,0,45,2
1745138529785,EDS 128A,A01,895459,Fargason; Sharon Gayle,45,0,45,0
1745138530813,EDS 128B,A01,895543,Pappas; Elizabeth,45,0,45,0
1745138531847,EDS 139,A00,897203,Pappas; Elizabeth,45,0,45,0
1745138531847,EDS 139,B00,897209,Fargason; Sharon Gayle,45,0,45,0
1745138532881,EDS 201,A00,895545,Staff,44,0,45,1
1745138533919,EDS 203,A01,895581,Halter; Christopher P.,44,0,45,1
1745138534946,EDS 204R,A01,895625,Heinzman; Erica M.,45,0,45,0
1745138534946,EDS 204R,B01,895693,Halter; Christopher P.,28,0,45,17
1745138535973,EDS 206R,A00,895694,Fargason; Sharon Gayle,22,0,30,8
1745138535973,EDS 206R,B00,895695,Choi; Bailey Miyeon,21,0,30,9
1745138537007,EDS 250,A00,895697,Hemans; Patricia Ann Benitez,44,0,45,1
1745138538033,EDS 281,A00,895701,Meyerott; Theresa Ann,15,0,15,0
1745138539070,EDS 284,A00,895736,Meyerott; Theresa Ann,15,0,15,0
1745138540097,EDS 286,A00,897210,Fine; Sarah,15,0,15,0
1745138541125,EDS 289C,A01,895770,Daly; Alan J.,15,0,15,0
1745138542151,EDS 290,A00,897211,Hofstetter; Carolyn,15,0,15,0
1745138543179,LIGM 5A,A00,896162,Fischer-Grunski; Eva K,16,0,20,4
1745138544211,LIGM 5B,A00,896260,Fischer-Grunski; Eva K,19,0,20,1
1745138545238,LIGM 5C,A00,896308,Fischer-Grunski; Eva K,19,0,20,1
1745138546271,LIIT 5AS,A00,896313,Carnelos; Chiara,18,0,20,2
1745138547307,LIIT 5BS,A00,896416,Carnelos; Chiara,20,0,20,0
1745138548350,LIIT 5CS,A00,896564,Carnelos; Chiara,20,0,20,0
1745138549378,LISP 5A,A00,896588,Munoz Sanchez; Alicia,7,0,20,13
1745138550412,LISP 5B,A00,896653,Munoz Sanchez; Alicia,10,0,20,10
1745138551444,LISP 5C,A00,896655,Munoz Sanchez; Alicia,9,0,20,11
1745138552478,MAE 197,001,957918,Kleissl; Jan,9998,0,9999,1
1745138553502,MATH 2,A01,957937,Staff,34,0,35,1
1745138554529,MATH 197,001,957876,Kedlaya; Kiran S.,9996,0,9999,3
1745138555559,MCWP 40,A00,892729,Duru; Nur,16,0,20,4
1745138555559,MCWP 40,B00,893304,Montejo; Carolina,20,0,20,0
1745138556593,MCWP 40R,A00,893757,Redela; Pamela Morgan,0,3,20,20
1745138557630,MCWP 50,A00,893758,Morshed; Michael James,4,0,20,16
1745138557630,MCWP 50,B00,893761,Bartulis; Jason Michael,18,0,20,2
1745138558667,MCWP 50R,A00,893766,Compas; Sean Matthew,0,1,20,20
1745138558667,MCWP 50R,B00,893769,Carter; Jennifer A,5,0,20,15
1745138558667,MCWP 50R,C00,893771,Krone; Jarret,0,3,20,20
1745138558667,MCWP 50R,D00,893772,Miller; Elizabeth Deen,4,0,20,16
1745138558667,MCWP 50R,E00,893775,Carter; Andrea L,0,0,20,20
1745138559694,MMW 11R,A01,892721,Herbst; Matthew,22,0,30,8
1745138559694,MMW 11R,A02,892722,Herbst; Matthew,28,0,30,2
1745138560759,MMW 12R,A01,892724,Herbst; Matthew,0,5,16,16
1745138560759,MMW 12R,A02,892725,Herbst; Matthew,0,4,16,16
1745138561791,MMW 13R,A01,892727,Staff,0,29,16,16
1745138561791,MMW 13R,A02,892728,Staff,0,28,16,16
1745138562818,SIO 295LS,A00,894015,Staff,9,0,25,16
1745138563842,SIO 295S,A00,894020,Staff,9,0,25,16
1745138564868,SIOC 290S,A01,894063,Merrifield; Mark A,23,0,25,2
1745138565895,SIOC 291S,A01,894137,Gabriel; Corey John,23,0,25,2
1745138566920,SOCI 117,A01,895339,Staff,5,0,5,0
1745138567946,WES 237B,A00,894149,Staff,20,0,20,0
1745138570062,AESE 279B,A00,891859,Staff,35,0,35,0
1745138571091,AIP 197,001,891854,Staff,70,0,70,0
1745138572117,ANTH 289S,A00,891856,Gagneux; Pascal,12,0,12,0
1745138573150,BENG 196,001,957946,Engler; Adam J.,9996,0,9999,3
1745138574176,CAT 124RS,A01,956906,Staff,8,0,25,17
1745138575207,CAT 125RS,A01,922013,Staff,8,0,25,17
1745138576233,CLRE 250,A00,891860,Morris; Sheldon,9996,0,9999,3
1745138578297,CLRE 251R,A00,907817,Mehta; Ravindra L.,9995,0,9999,4
1745138579323,CLRE 252,A00,891864,Cuomo; Raphael Eduardo,9994,0,9999,5
1745138580349,CLRE 253,A00,891867,Vaida; Florin,9995,0,9999,4
1745138580349,CLRE 253,B00,907819,Staff,9999,0,9999,0
1745138581375,CLRE 259,A00,891868,Patel; Hemal,9998,0,9999,1
1745138582401,CLRE 260,A00,891872,Cuomo; Raphael Eduardo,9999,0,9999,0
1745138583427,CLRE 297,001,891888,Cuomo; Raphael Eduardo,9999,0,9999,0
1745138584453,CSS 201S,A01,892054,Mignozzetti; Umberto,30,0,30,0
1745138585489,CSS 202S,A01,892056,Mignozzetti; Umberto,30,0,30,0
1745138586515,DSC 197,001,956898,Eldridge; Justin Matthew,9998,0,9999,1
1745138589469,DSC 297,001,958000,Mazumdar; Arya,9999,0,9999,0
1745138590495,EAP 100,A00,905686,Staff,9774,0,9999,225
1745138591522,ECE 45,A01,892618,Staff,0,2,50,50
1745138592835,ECE 109,A01,892620,Staff,0,44,0,0
1745138593863,ECE 111,A01,892719,Staff,0,0,50,50
1745138594889,ECE 197,001,957920,Mercier; Patrick Philip,9992,0,9999,7
1745138597576,ECON 178,A01,907814,Zhu; Ying,29,0,35,6
1745138598604,EDS 115,A00,895312,Staff,42,0,45,3
1745138599641,EDS 117,A01,895337,Staff,30,0,30,0
1745138600668,EDS 125,A00,895341,Jones; Gabrielle Anastasia,43,0,45,2
1745138601694,EDS 128A,A01,895459,Fargason; Sharon Gayle,45,0,45,0
1745138602721,EDS 128B,A01,895543,Pappas; Elizabeth,45,0,45,0
1745138603749,EDS 139,A00,897203,Pappas; Elizabeth,45,0,45,0
1745138603749,EDS 139,B00,897209,Fargason; Sharon Gayle,45,0,45,0
1745138604787,EDS 201,A00,895545,Staff,44,0,45,1
1745138605814,EDS 203,A01,895581,Halter; Christopher P.,44,0,45,1
1745138606841,EDS 204R,A01,895625,Heinzman; Erica M.,45,0,45,0
1745138606841,EDS 204R,B01,895693,Halter; Christopher P.,28,0,45,17
1745138607867,EDS 206R,A00,895694,Fargason; Sharon Gayle,22,0,30,8
1745138607867,EDS 206R,B00,895695,Choi; Bailey Miyeon,21,0,30,9
1745138608894,EDS 250,A00,895697,Hemans; Patricia Ann Benitez,44,0,45,1
1745138609918,EDS 281,A00,895701,Meyerott; Theresa Ann,15,0,15,0
1745138610944,EDS 284,A00,895736,Meyerott; Theresa Ann,15,0,15,0
1745138611971,EDS 286,A00,897210,Fine; Sarah,15,0,15,0
1745138612997,EDS 289C,A01,895770,Daly; Alan J.,15,0,15,0
1745138614029,EDS 290,A00,897211,Hofstetter; Carolyn,15,0,15,0
1745138615063,LIGM 5A,A00,896162,Fischer-Grunski; Eva K,16,0,20,4
1745138616090,LIGM 5B,A00,896260,Fischer-Grunski; Eva K,19,0,20,1
1745138617123,LIGM 5C,A00,896308,Fischer-Grunski; Eva K,19,0,20,1
1745138618156,LIIT 5AS,A00,896313,Carnelos; Chiara,18,0,20,2
1745138619183,LIIT 5BS,A00,896416,Carnelos; Chiara,20,0,20,0
1745138620219,LIIT 5CS,A00,896564,Carnelos; Chiara,20,0,20,0
1745138621246,LISP 5A,A00,896588,Munoz Sanchez; Alicia,7,0,20,13
1745138622279,LISP 5B,A00,896653,Munoz Sanchez; Alicia,10,0,20,10
1745138623306,LISP 5C,A00,896655,Munoz Sanchez; Alicia,9,0,20,11
1745138624332,MAE 197,001,957918,Kleissl; Jan,9998,0,9999,1
1745138625357,MATH 2,A01,957937,Staff,34,0,35,1
1745138626392,MATH 197,001,957876,Kedlaya; Kiran S.,9996,0,9999,3
1745138627417,MCWP 40,A00,892729,Duru; Nur,16,0,20,4
1745138627417,MCWP 40,B00,893304,Montejo; Carolina,20,0,20,0
1745138628449,MCWP 40R,A00,893757,Redela; Pamela Morgan,0,3,20,20
1745138629485,MCWP 50,A00,893758,Morshed; Michael James,4,0,20,16
1745138629485,MCWP 50,B00,893761,Bartulis; Jason Michael,18,0,20,2
1745138630524,MCWP 50R,A00,893766,Compas; Sean Matthew,0,1,20,20
1745138630524,MCWP 50R,B00,893769,Carter; Jennifer A,5,0,20,15
1745138630524,MCWP 50R,C00,893771,Krone; Jarret,0,3,20,20
1745138630524,MCWP 50R,D00,893772,Miller; Elizabeth Deen,4,0,20,16
1745138630524,MCWP 50R,E00,893775,Carter; Andrea L,0,0,20,20
1745138631551,MMW 11R,A01,892721,Herbst; Matthew,22,0,30,8
1745138631551,MMW 11R,A02,892722,Herbst; Matthew,28,0,30,2
1745138632578,MMW 12R,A01,892724,Herbst; Matthew,0,5,16,16
1745138632578,MMW 12R,A02,892725,Herbst; Matthew,0,4,16,16
1745138633617,MMW 13R,A01,892727,Staff,0,29,16,16
1745138633617,MMW 13R,A02,892728,Staff,0,28,16,16
1745138634643,SIO 295LS,A00,894015,Staff,9,0,25,16
1745138635678,SIO 295S,A00,894020,Staff,9,0,25,16
1745138636706,SIOC 290S,A01,894063,Merrifield; Mark A,23,0,25,2
1745138637738,SIOC 291S,A01,894137,Gabriel; Corey John,23,0,25,2
1745138638768,SOCI 117,A01,895339,Staff,5,0,5,0
1745138639795,WES 237B,A00,894149,Staff,20,0,20,0
1745138641871,AESE 279B,A00,891859,Staff,35,0,35,0
1745138642908,AIP 197,001,891854,Staff,70,0,70,0
1745138643932,ANTH 289S,A00,891856,Gagneux; Pascal,12,0,12,0
1745138644958,BENG 196,001,957946,Engler; Adam J.,9996,0,9999,3
1745138645983,CAT 124RS,A01,956906,Staff,8,0,25,17
1745138647008,CAT 125RS,A01,922013,Staff,8,0,25,17
1745138648033,CLRE 250,A00,891860,Morris; Sheldon,9996,0,9999,3
1745138650089,CLRE 251R,A00,907817,Mehta; Ravindra L.,9995,0,9999,4
1745138651116,CLRE 252,A00,891864,Cuomo; Raphael Eduardo,9994,0,9999,5
1745138652145,CLRE 253,A00,891867,Vaida; Florin,9995,0,9999,4
1745138652145,CLRE 253,B00,907819,Staff,9999,0,9999,0
1745138653169,CLRE 259,A00,891868,Patel; Hemal,9998,0,9999,1
1745138654197,CLRE 260,A00,891872,Cuomo; Raphael Eduardo,9999,0,9999,0
1745138655222,CLRE 297,001,891888,Cuomo; Raphael Eduardo,9999,0,9999,0
1745138656253,CSS 201S,A01,892054,Mignozzetti; Umberto,30,0,30,0
1745138657280,CSS 202S,A01,892056,Mignozzetti; Umberto,30,0,30,0
1745138658307,DSC 197,001,956898,Eldridge; Justin Matthew,9998,0,9999,1
1745138659338,DSC 297,001,958000,Mazumdar; Arya,9999,0,9999,0
1745138660364,EAP 100,A00,905686,Staff,9774,0,9999,225
1745138661397,ECE 45,A01,892618,Staff,0,2,50,50
1745138662428,ECE 109,A01,892620,Staff,0,44,0,0
1745138663455,ECE 111,A01,892719,Staff,0,0,50,50
1745138664479,ECE 197,001,957920,Mercier; Patrick Philip,9992,0,9999,7
1745138665504,ECON 178,A01,907814,Zhu; Ying,29,0,35,6
1745138666531,EDS 115,A00,895312,Staff,42,0,45,3
1745138667556,EDS 117,A01,895337,Staff,30,0,30,0
1745138668583,EDS 125,A00,895341,Jones; Gabrielle Anastasia,43,0,45,2
1745138669616,EDS 128A,A01,895459,Fargason; Sharon Gayle,45,0,45,0
1745138670643,EDS 128B,A01,895543,Pappas; Elizabeth,45,0,45,0
1745138671667,EDS 139,A00,897203,Pappas; Elizabeth,45,0,45,0
1745138671667,EDS 139,B00,897209,Fargason; Sharon Gayle,45,0,45,0
1745138672693,EDS 201,A00,895545,Staff,44,0,45,1
1745138673718,EDS 203,A01,895581,Halter; Christopher P.,44,0,45,1
1745138674753,EDS 204R,A01,895625,Heinzman; Erica M.,45,0,45,0
1745138674753,EDS 204R,B01,895693,Halter; Christopher P.,28,0,45,17
1745138675781,EDS 206R,A00,895694,Fargason; Sharon Gayle,22,0,30,8
1745138675781,EDS 206R,B00,895695,Choi; Bailey Miyeon,21,0,30,9
1745138676810,EDS 250,A00,895697,Hemans; Patricia Ann Benitez,44,0,45,1
1745138677838,EDS 281,A00,895701,Meyerott; Theresa Ann,15,0,15,0
1745138678868,EDS 284,A00,895736,Meyerott; Theresa Ann,15,0,15,0
1745138679900,EDS 286,A00,897210,Fine; Sarah,15,0,15,0
1745138680926,EDS 289C,A01,895770,Daly; Alan J.,15,0,15,0
1745138681951,EDS 290,A00,897211,Hofstetter; Carolyn,15,0,15,0
1745138682984,LIGM 5A,A00,896162,Fischer-Grunski; Eva K,16,0,20,4
1745138684015,LIGM 5B,A00,896260,Fischer-Grunski; Eva K,19,0,20,1
1745138685046,LIGM 5C,A00,896308,Fischer-Grunski; Eva K,19,0,20,1
1745138686073,LIIT 5AS,A00,896313,Carnelos; Chiara,18,0,20,2
1745138687100,LIIT 5BS,A00,896416,Carnelos; Chiara,20,0,20,0
1745138688125,LIIT 5CS,A00,896564,Carnelos; Chiara,20,0,20,0
1745138689151,LISP 5A,A00,896588,Munoz Sanchez; Alicia,7,0,20,13
1745138690189,LISP 5B,A00,896653,Munoz Sanchez; Alicia,10,0,20,10
1745138691219,LISP 5C,A00,896655,Munoz Sanchez; Alicia,9,0,20,11
1745138692247,MAE 197,001,957918,Kleissl; Jan,9998,0,9999,1
1745138693275,MATH 2,A01,957937,Staff,34,0,35,1
1745138694301,MATH 197,001,957876,Kedlaya; Kiran S.,9996,0,9999,3
1745138695336,MCWP 40,A00,892729,Duru; Nur,16,0,20,4
1745138695336,MCWP 40,B00,893304,Montejo; Carolina,20,0,20,0
1745138696365,MCWP 40R,A00,893757,Redela; Pamela Morgan,0,3,20,20
1745138697391,MCWP 50,A00,893758,Morshed; Michael James,4,0,20,16
1745138697391,MCWP 50,B00,893761,Bartulis; Jason Michael,18,0,20,2
1745138698458,MCWP 50R,A00,893766,Compas; Sean Matthew,0,1,20,20
1745138698458,MCWP 50R,B00,893769,Carter; Jennifer A,5,0,20,15
1745138698458,MCWP 50R,C00,893771,Krone; Jarret,0,3,20,20
1745138698458,MCWP 50R,D00,893772,Miller; Elizabeth Deen,4,0,20,16
1745138698458,MCWP 50R,E00,893775,Carter; Andrea L,0,0,20,20
1745138699483,MMW 11R,A01,892721,Herbst; Matthew,22,0,30,8
1745138699483,MMW 11R,A02,892722,Herbst; Matthew,28,0,30,2
1745138700510,MMW 12R,A01,892724,Herbst; Matthew,0,5,16,16
1745138700510,MMW 12R,A02,892725,Herbst; Matthew,0,4,16,16
1745138701538,MMW 13R,A01,892727,Staff,0,29,16,16
1745138701538,MMW 13R,A02,892728,Staff,0,28,16,16
1745138702563,SIO 295LS,A00,894015,Staff,9,0,25,16
1745138703593,SIO 295S,A00,894020,Staff,9,0,25,16
1745138704627,SIOC 290S,A01,894063,Merrifield; Mark A,23,0,25,2
1745138705653,SIOC 291S,A01,894137,Gabriel; Corey John,23,0,25,2
1745138706680,SOCI 117,A01,895339,Staff,5,0,5,0
1745138707710,WES 237B,A00,894149,Staff,20,0,20,0
1745138709777,AESE 279B,A00,891859,Staff,35,0,35,0
1745138710808,AIP 197,001,891854,Staff,70,0,70,0
1745138711838,ANTH 289S,A00,891856,Gagneux; Pascal,12,0,12,0
1745138712871,BENG 196,001,957946,Engler; Adam J.,9996,0,9999,3
1745138713901,CAT 124RS,A01,956906,Staff,8,0,25,17
1745138714928,CAT 125RS,A01,922013,Staff,8,0,25,17
1745138715954,CLRE 250,A00,891860,Morris; Sheldon,9996,0,9999,3
1745138718014,CLRE 251R,A00,907817,Mehta; Ravindra L.,9995,0,9999,4
1745138719042,CLRE 252,A00,891864,Cuomo; Raphael Eduardo,9994,0,9999,5
1745138720096,CLRE 253,A00,891867,Vaida; Florin,9995,0,9999,4
1745138720096,CLRE 253,B00,907819,Staff,9999,0,9999,0
1745138721126,CLRE 259,A00,891868,Patel; Hemal,9998,0,9999,1
1745138722155,CLRE 260,A00,891872,Cuomo; Raphael Eduardo,9999,0,9999,0
1745138723183,CLRE 297,001,891888,Cuomo; Raphael Eduardo,9999,0,9999,0
1745138724211,CSS 201S,A01,892054,Mignozzetti; Umberto,30,0,30,0
1745138725238,CSS 202S,A01,892056,Mignozzetti; Umberto,30,0,30,0
1745138726267,DSC 197,001,956898,Eldridge; Justin Matthew,9998,0,9999,1
1745138727294,DSC 297,001,958000,Mazumdar; Arya,9999,0,9999,0
1745138728317,EAP 100,A00,905686,Staff,9774,0,9999,225
1745138729346,ECE 45,A01,892618,Staff,0,2,50,50
1745138730371,ECE 109,A01,892620,Staff,0,44,0,0
1745138731400,ECE 111,A01,892719,Staff,0,0,50,50
1745138732432,ECE 197,001,957920,Mercier; Patrick Philip,9992,0,9999,7
1745138733463,ECON 178,A01,907814,Zhu; Ying,29,0,35,6
1745138734493,EDS 115,A00,895312,Staff,42,0,45,3
1745138735519,EDS 117,A01,895337,Staff,30,0,30,0
1745138736548,EDS 125,A00,895341,Jones; Gabrielle Anastasia,43,0,45,2
1745138737573,EDS 128A,A01,895459,Fargason; Sharon Gayle,45,0,45,0
1745138738599,EDS 128B,A01,895543,Pappas; Elizabeth,45,0,45,0
1745138739640,EDS 139,A00,897203,Pappas; Elizabeth,45,0,45,0
1745138739640,EDS 139,B00,897209,Fargason; Sharon Gayle,45,0,45,0
1745138740673,EDS 201,A00,895545,Staff,44,0,45,1
1745138741714,EDS 203,A01,895581,Halter; Christopher P.,44,0,45,1
1745138742740,EDS 204R,A01,895625,Heinzman; Erica M.,45,0,45,0
1745138742740,EDS 204R,B01,895693,Halter; Christopher P.,28,0,45,17
1745138743775,EDS 206R,A00,895694,Fargason; Sharon Gayle,22,0,30,8
1745138743775,EDS 206R,B00,895695,Choi; Bailey Miyeon,21,0,30,9
1745138744815,EDS 250,A00,895697,Hemans; Patricia Ann Benitez,44,0,45,1
1745138745850,EDS 281,A00,895701,Meyerott; Theresa Ann,15,0,15,0
1745138746876,EDS 284,A00,895736,Meyerott; Theresa Ann,15,0,15,0
1745138747904,EDS 286,A00,897210,Fine; Sarah,15,0,15,0
1745138754181,EDS 289C,A01,895770,Daly; Alan J.,15,0,15,0
1745138755316,EDS 290,A00,897211,Hofstetter; Carolyn,15,0,15,0
1745138757781,LIGM 5A,A00,896162,Fischer-Grunski; Eva K,16,0,20,4
1745138758807,LIGM 5B,A00,896260,Fischer-Grunski; Eva K,19,0,20,1
1745138759835,LIGM 5C,A00,896308,Fischer-Grunski; Eva K,19,0,20,1
1745138760861,LIIT 5AS,A00,896313,Carnelos; Chiara,18,0,20,2
1745138761887,LIIT 5BS,A00,896416,Carnelos; Chiara,20,0,20,0
1745138762912,LIIT 5CS,A00,896564,Carnelos; Chiara,20,0,20,0
1745138763953,LISP 5A,A00,896588,Munoz Sanchez; Alicia,7,0,20,13
1745138764999,LISP 5B,A00,896653,Munoz Sanchez; Alicia,10,0,20,10
1745138766034,LISP 5C,A00,896655,Munoz Sanchez; Alicia,9,0,20,11
1745138767071,MAE 197,001,957918,Kleissl; Jan,9998,0,9999,1
1745138768097,MATH 2,A01,957937,Staff,34,0,35,1
1745138769136,MATH 197,001,957876,Kedlaya; Kiran S.,9996,0,9999,3
1745138770163,MCWP 40,A00,892729,Duru; Nur,16,0,20,4
1745138770163,MCWP 40,B00,893304,Montejo; Carolina,20,0,20,0
1745138771191,MCWP 40R,A00,893757,Redela; Pamela Morgan,0,3,20,20
1745138772233,MCWP 50,A00,893758,Morshed; Michael James,4,0,20,16
1745138772233,MCWP 50,B00,893761,Bartulis; Jason Michael,18,0,20,2
1745138773263,MCWP 50R,A00,893766,Compas; Sean Matthew,0,1,20,20
1745138773263,MCWP 50R,B00,893769,Carter; Jennifer A,5,0,20,15
1745138773263,MCWP 50R,C00,893771,Krone; Jarret,0,3,20,20
1745138773263,MCWP 50R,D00,893772,Miller; Elizabeth Deen,4,0,20,16
1745138773263,MCWP 50R,E00,893775,Carter; Andrea L,0,0,20,20
1745138774302,MMW 11R,A01,892721,Herbst; Matthew,22,0,30,8
1745138774302,MMW 11R,A02,892722,Herbst; Matthew,28,0,30,2
1745138775338,MMW 12R,A01,892724,Herbst; Matthew,0,5,16,16
1745138775338,MMW 12R,A02,892725,Herbst; Matthew,0,4,16,16
1745138776365,MMW 13R,A01,892727,Staff,0,29,16,16
1745138776365,MMW 13R,A02,892728,Staff,0,28,16,16
1745138777393,SIO 295LS,A00,894015,Staff,9,0,25,16
1745138778426,SIO 295S,A00,894020,Staff,9,0,25,16
1745138779469,SIOC 290S,A01,894063,Merrifield; Mark A,23,0,25,2
1745138780496,SIOC 291S,A01,894137,Gabriel; Corey John,23,0,25,2
1745138781523,SOCI 117,A01,895339,Staff,5,0,5,0
1745138782554,WES 237B,A00,894149,Staff,20,0,20,0
1745138784695,AESE 279B,A00,891859,Staff,35,0,35,0
1745138785727,AIP 197,001,891854,Staff,70,0,70,0
1745138786753,ANTH 289S,A00,891856,Gagneux; Pascal,12,0,12,0
1745138787779,BENG 196,001,957946,Engler; Adam J.,9996,0,9999,3
1745138797819,CAT 124RS,A01,956906,Staff,8,0,25,17
1745138798857,CAT 125RS,A01,922013,Staff,8,0,25,17
1745138799884,CLRE 250,A00,891860,Morris; Sheldon,9996,0,9999,3
1745138801939,CLRE 251R,A00,907817,Mehta; Ravindra L.,9995,0,9999,4
1745138802966,CLRE 252,A00,891864,Cuomo; Raphael Eduardo,9994,0,9999,5
1745138803992,CLRE 253,A00,891867,Vaida; Florin,9995,0,9999,4
1745138803992,CLRE 253,B00,907819,Staff,9999,0,9999,0
1745138805040,CLRE 259,A00,891868,Patel; Hemal,9998,0,9999,1
1745138806075,CLRE 260,A00,891872,Cuomo; Raphael Eduardo,9999,0,9999,0
1745138807101,CLRE 297,001,891888,Cuomo; Raphael Eduardo,9999,0,9999,0
1745138808130,CSS 201S,A01,892054,Mignozzetti; Umberto,30,0,30,0
1745138809170,CSS 202S,A01,892056,Mignozzetti; Umberto,30,0,30,0
1745138810197,DSC 197,001,956898,Eldridge; Justin Matthew,9998,0,9999,1
1745138811238,DSC 297,001,958000,Mazumdar; Arya,9999,0,9999,0
1745138812263,EAP 100,A00,905686,Staff,9774,0,9999,225
1745138813310,ECE 45,A01,892618,Staff,0,2,50,50
1745138814340,ECE 109,A01,892620,Staff,0,44,0,0
1745138815369,ECE 111,A01,892719,Staff,0,0,50,50
1745138816420,ECE 197,001,957920,Mercier; Patrick Philip,9992,0,9999,7
1745138817448,ECON 178,A01,907814,Zhu; Ying,29,0,35,6
1745138818474,EDS 115,A00,895312,Staff,42,0,45,3
1745138819501,EDS 117,A01,895337,Staff,30,0,30,0
1745138820549,EDS 125,A00,895341,Jones; Gabrielle Anastasia,43,0,45,2
1745138821577,EDS 128A,A01,895459,Fargason; Sharon Gayle,45,0,45,0
1745138822619,EDS 128B,A01,895543,Pappas; Elizabeth,45,0,45,0
1745138823647,EDS 139,A00,897203,Pappas; Elizabeth,45,0,45,0
1745138823647,EDS 139,B00,897209,Fargason; Sharon Gayle,45,0,45,0
1745138824672,EDS 201,A00,895545,Staff,44,0,45,1
1745138825699,EDS 203,A01,895581,Halter; Christopher P.,44,0,45,1
1745138826733,EDS 204R,A01,895625,Heinzman; Erica M.,45,0,45,0
1745138826733,EDS 204R,B01,895693,Halter; Christopher P.,28,0,45,17
1745138827760,EDS 206R,A00,895694,Fargason; Sharon Gayle,22,0,30,8
1745138827760,EDS 206R,B00,895695,Choi; Bailey Miyeon,21,0,30,9
1745138828787,EDS 250,A00,895697,Hemans; Patricia Ann Benitez,44,0,45,1
1745138829826,EDS 281,A00,895701,Meyerott; Theresa Ann,15,0,15,0
1745138830859,EDS 284,A00,895736,Meyerott; Theresa Ann,15,0,15,0
1745138831886,EDS 286,A00,897210,Fine; Sarah,15,0,15,0
1745138832936,EDS 289C,A01,895770,Daly; Alan J.,15,0,15,0
1745138833980,EDS 290,A00,897211,Hofstetter; Carolyn,15,0,15,0
1745138835066,LIGM 5A,A00,896162,Fischer-Grunski; Eva K,16,0,20,4
1745138836105,LIGM 5B,A00,896260,Fischer-Grunski; Eva K,19,0,20,1
1745138837152,LIGM 5C,A00,896308,Fischer-Grunski; Eva K,19,0,20,1
1745138838179,LIIT 5AS,A00,896313,Carnelos; Chiara,18,0,20,2
1745138839247,LIIT 5BS,A00,896416,Carnelos; Chiara,20,0,20,0
1745138840274,LIIT 5CS,A00,896564,Carnelos; Chiara,20,0,20,0
1745138841301,LISP 5A,A00,896588,Munoz Sanchez; Alicia,7,0,20,13
1745138842328,LISP 5B,A00,896653,Munoz Sanchez; Alicia,10,0,20,10
1745138847844,LISP 5C,A00,896655,Munoz Sanchez; Alicia,9,0,20,11
1745138848872,MAE 197,001,957918,Kleissl; Jan,9998,0,9999,1
1745138849922,MATH 2,A01,957937,Staff,34,0,35,1
1745138850961,MATH 197,001,957876,Kedlaya; Kiran S.,9996,0,9999,3
1745138851987,MCWP 40,A00,892729,Duru; Nur,16,0,20,4
1745138851987,MCWP 40,B00,893304,Montejo; Carolina,20,0,20,0
1745138853027,MCWP 40R,A00,893757,Redela; Pamela Morgan,0,3,20,20
1745138854055,MCWP 50,A00,893758,Morshed; Michael James,4,0,20,16
1745138854055,MCWP 50,B00,893761,Bartulis; Jason Michael,18,0,20,2
1745138855084,MCWP 50R,A00,893766,Compas; Sean Matthew,0,1,20,20
1745138855084,MCWP 50R,B00,893769,Carter; Jennifer A,5,0,20,15
1745138855084,MCWP 50R,C00,893771,Krone; Jarret,0,3,20,20
1745138855084,MCWP 50R,D00,893772,Miller; Elizabeth Deen,4,0,20,16
1745138855084,MCWP 50R,E00,893775,Carter; Andrea L,0,0,20,20
1745138856122,MMW 11R,A01,892721,Herbst; Matthew,22,0,30,8
1745138856122,MMW 11R,A02,892722,Herbst; Matthew,28,0,30,2
1745138857155,MMW 12R,A01,892724,Herbst; Matthew,0,5,16,16
1745138857155,MMW 12R,A02,892725,Herbst; Matthew,0,4,16,16
1745138858179,MMW 13R,A01,892727,Staff,0,29,16,16
1745138858179,MMW 13R,A02,892728,Staff,0,28,16,16
1745138859206,SIO 295LS,A00,894015,Staff,9,0,25,16
1745138860243,SIO 295S,A00,894020,Staff,9,0,25,16
1745138861269,SIOC 290S,A01,894063,Merrifield; Mark A,23,0,25,2
1745138862298,SIOC 291S,A01,894137,Gabriel; Corey John,23,0,25,2
1745138863325,SOCI 117,A01,895339,Staff,5,0,5,0
1745138864352,WES 237B,A00,894149,Staff,20,0,20,0
1745138866450,AESE 279B,A00,891859,Staff,35,0,35,0
1745138867474,AIP 197,001,891854,Staff,70,0,70,0
1745138868504,ANTH 289S,A00,891856,Gagneux; Pascal,12,0,12,0
1745138869532,BENG 196,001,957946,Engler; Adam J.,9996,0,9999,3
1745138870560,CAT 124RS,A01,956906,Staff,8,0,25,17
1745138871586,CAT 125RS,A01,922013,Staff,8,0,25,17
1745138872613,CLRE 250,A00,891860,Morris; Sheldon,9996,0,9999,3
1745138874712,CLRE 251R,A00,907817,Mehta; Ravindra L.,9995,0,9999,4
1745138875738,CLRE 252,A00,891864,Cuomo; Raphael Eduardo,9994,0,9999,5
1745138876765,CLRE 253,A00,891867,Vaida; Florin,9995,0,9999,4
1745138876765,CLRE 253,B00,907819,Staff,9999,0,9999,0
1745138877804,CLRE 259,A00,891868,Patel; Hemal,9998,0,9999,1
1745138878829,CLRE 260,A00,891872,Cuomo; Raphael Eduardo,9999,0,9999,0
1745138879859,CLRE 297,001,891888,Cuomo; Raphael Eduardo,9999,0,9999,0
1745138880889,CSS 201S,A01,892054,Mignozzetti; Umberto,30,0,30,0
1745138881917,CSS 202S,A01,892056,Mignozzetti; Umberto,30,0,30,0
1745138882942,DSC 197,001,956898,Eldridge; Justin Matthew,9998,0,9999,1
1745138883969,DSC 297,001,958000,Mazumdar; Arya,9999,0,9999,0
1745138885033,EAP 100,A00,905686,Staff,9774,0,9999,225
1745138886093,ECE 45,A01,892618,Staff,0,2,50,50
1745138887120,ECE 109,A01,892620,Staff,0,44,0,0
1745138888147,ECE 111,A01,892719,Staff,0,0,50,50
1745138889192,ECE 197,001,957920,Mercier; Patrick Philip,9992,0,9999,7
1745138890219,ECON 178,A01,907814,Zhu; Ying,29,0,35,6
1745138891247,EDS 115,A00,895312,Staff,42,0,45,3
1745138892275,EDS 117,A01,895337,Staff,30,0,30,0
1745138893326,EDS 125,A00,895341,Jones; Gabrielle Anastasia,43,0,45,2
1745138894368,EDS 128A,A01,895459,Fargason; Sharon Gayle,45,0,45,0
1745138895410,EDS 128B,A01,895543,Pappas; Elizabeth,45,0,45,0
1745138896461,EDS 139,A00,897203,Pappas; Elizabeth,45,0,45,0
1745138896461,EDS 139,B00,897209,Fargason; Sharon Gayle,45,0,45,0
1745138897499,EDS 201,A00,895545,Staff,44,0,45,1
1745138898527,EDS 203,A01,895581,Halter; Christopher P.,44,0,45,1
1745138899555,EDS 204R,A01,895625,Heinzman; Erica M.,45,0,45,0
1745138899555,EDS 204R,B01,895693,Halter; Christopher P.,28,0,45,17
1745138900583,EDS 206R,A00,895694,Fargason; Sharon Gayle,22,0,30,8
1745138900583,EDS 206R,B00,895695,Choi; Bailey Miyeon,21,0,30,9
1745138901607,EDS 250,A00,895697,Hemans; Patricia Ann Benitez,44,0,45,1
1745138902649,EDS 281,A00,895701,Meyerott; Theresa Ann,15,0,15,0
1745138903730,EDS 284,A00,895736,Meyerott; Theresa Ann,15,0,15,0
1745138904758,EDS 286,A00,897210,Fine; Sarah,15,0,15,0
1745138905785,EDS 289C,A01,895770,Daly; Alan J.,15,0,15,0
1745138906816,EDS 290,A00,897211,Hofstetter; Carolyn,15,0,15,0
1745138907844,LIGM 5A,A00,896162,Fischer-Grunski; Eva K,16,0,20,4
1745138908878,LIGM 5B,A00,896260,Fischer-Grunski; Eva K,19,0,20,1
1745138909905,LIGM 5C,A00,896308,Fischer-Grunski; Eva K,19,0,20,1
1745138910933,LIIT 5AS,A00,896313,Carnelos; Chiara,18,0,20,2
1745138911958,LIIT 5BS,A00,896416,Carnelos; Chiara,20,0,20,0
1745138912985,LIIT 5CS,A00,896564,Carnelos; Chiara,20,0,20,0
1745138914016,LISP 5A,A00,896588,Munoz Sanchez; Alicia,7,0,20,13
1745138915047,LISP 5B,A00,896653,Munoz Sanchez; Alicia,10,0,20,10
1745138916074,LISP 5C,A00,896655,Munoz Sanchez; Alicia,9,0,20,11
1745138917105,MAE 197,001,957918,Kleissl; Jan,9998,0,9999,1
1745138918140,MATH 2,A01,957937,Staff,34,0,35,1
1745138919166,MATH 197,001,957876,Kedlaya; Kiran S.,9996,0,9999,3
1745138920197,MCWP 40,A00,892729,Duru; Nur,16,0,20,4
1745138920197,MCWP 40,B00,893304,Montejo; Carolina,20,0,20,0
1745138921228,MCWP 40R,A00,893757,Redela; Pamela Morgan,0,3,20,20
1745138922260,MCWP 50,A00,893758,Morshed; Michael James,4,0,20,16
1745138922260,MCWP 50,B00,893761,Bartulis; Jason Michael,18,0,20,2
1745138923289,MCWP 50R,A00,893766,Compas; Sean Matthew,0,1,20,20
1745138923289,MCWP 50R,B00,893769,Carter; Jennifer A,5,0,20,15
1745138923289,MCWP 50R,C00,893771,Krone; Jarret,0,3,20,20
1745138923289,MCWP 50R,D00,893772,Miller; Elizabeth Deen,4,0,20,16
1745138923289,MCWP 50R,E00,893775,Carter; Andrea L,0,0,20,20
1745138924316,MMW 11R,A01,892721,Herbst; Matthew,22,0,30,8
1745138924316,MMW 11R,A02,892722,Herbst; Matthew,28,0,30,2
1745138925343,MMW 12R,A01,892724,Herbst; Matthew,0,5,16,16
1745138925343,MMW 12R,A02,892725,Herbst; Matthew,0,4,16,16
1745138926371,MMW 13R,A01,892727,Staff,0,29,16,16
1745138926371,MMW 13R,A02,892728,Staff,0,28,16,16
1745138927400,SIO 295LS,A00,894015,Staff,9,0,25,16
1745138928435,SIO 295S,A00,894020,Staff,9,0,25,16
1745138929463,SIOC 290S,A01,894063,Merrifield; Mark A,23,0,25,2
1745138930513,SIOC 291S,A01,894137,Gabriel; Corey John,23,0,25,2
1745138931553,SOCI 117,A01,895339,Staff,5,0,5,0
1745138932580,WES 237B,A00,894149,Staff,20,0,20,0
1745138934675,AESE 279B,A00,891859,Staff,35,0,35,0
1745138935702,AIP 197,001,891854,Staff,70,0,70,0
1745138936727,ANTH 289S,A00,891856,Gagneux; Pascal,12,0,12,0
1745138937765,BENG 196,001,957946,Engler; Adam J.,9996,0,9999,3
1745138938790,CAT 124RS,A01,956906,Staff,8,0,25,17
1745138939816,CAT 125RS,A01,922013,Staff,8,0,25,17
1745138940854,CLRE 250,A00,891860,Morris; Sheldon,9996,0,9999,3
1745138942921,CLRE 251R,A00,907817,Mehta; Ravindra L.,9995,0,9999,4
1745138943946,CLRE 252,A00,891864,Cuomo; Raphael Eduardo,9994,0,9999,5
1745138944985,CLRE 253,A00,891867,Vaida; Florin,9995,0,9999,4
1745138944985,CLRE 253,B00,907819,Staff,9999,0,9999,0
1745138946010,CLRE 259,A00,891868,Patel; Hemal,9998,0,9999,1
1745138947037,CLRE 260,A00,891872,Cuomo; Raphael Eduardo,9999,0,9999,0
1745138956470,CLRE 297,001,891888,Cuomo; Raphael Eduardo,9999,0,9999,0
1745138957498,CSS 201S,A01,892054,Mignozzetti; Umberto,30,0,30,0
1745138958524,CSS 202S,A01,892056,Mignozzetti; Umberto,30,0,30,0
1745138959557,DSC 197,001,956898,Eldridge; Justin Matthew,9998,0,9999,1
1745138960588,DSC 297,001,958000,Mazumdar; Arya,9999,0,9999,0
1745138961615,EAP 100,A00,905686,Staff,9774,0,9999,225
1745138962653,ECE 45,A01,892618,Staff,0,2,50,50
1745138963689,ECE 109,A01,892620,Staff,0,44,0,0
1745138964717,ECE 111,A01,892719,Staff,0,0,50,50
1745138965756,ECE 197,001,957920,Mercier; Patrick Philip,9992,0,9999,7
1745138966793,ECON 178,A01,907814,Zhu; Ying,29,0,35,6
1745138967844,EDS 115,A00,895312,Staff,42,0,45,3
1745138968871,EDS 117,A01,895337,Staff,30,0,30,0
1745138969906,EDS 125,A00,895341,Jones; Gabrielle Anastasia,43,0,45,2
1745138970932,EDS 128A,A01,895459,Fargason; Sharon Gayle,45,0,45,0
1745138971957,EDS 128B,A01,895543,Pappas; Elizabeth,45,0,45,0
1745138972982,EDS 139,A00,897203,Pappas; Elizabeth,45,0,45,0
1745138972982,EDS 139,B00,897209,Fargason; Sharon Gayle,45,0,45,0
1745138974020,EDS 201,A00,895545,Staff,44,0,45,1
1745138975064,EDS 203,A01,895581,Halter; Christopher P.,44,0,45,1
1745138976090,EDS 204R,A01,895625,Heinzman; Erica M.,45,0,45,0
1745138976090,EDS 204R,B01,895693,Halter; Christopher P.,28,0,45,17
1745138977118,EDS 206R,A00,895694,Fargason; Sharon Gayle,22,0,30,8
1745138977118,EDS 206R,B00,895695,Choi; Bailey Miyeon,21,0,30,9
1745138978145,EDS 250,A00,895697,Hemans; Patricia Ann Benitez,44,0,45,1
1745138979178,EDS 281,A00,895701,Meyerott; Theresa Ann,15,0,15,0
1745138980206,EDS 284,A00,895736,Meyerott; Theresa Ann,15,0,15,0
1745138981238,EDS 286,A00,897210,Fine; Sarah,15,0,15,0
1745138982266,EDS 289C,A01,895770,Daly; Alan J.,15,0,15,0
1745138983304,EDS 290,A00,897211,Hofstetter; Carolyn,15,0,15,0
1745138984343,LIGM 5A,A00,896162,Fischer-Grunski; Eva K,16,0,20,4
1745138985370,LIGM 5B,A00,896260,Fischer-Grunski; Eva K,19,0,20,1
1745138986408,LIGM 5C,A00,896308,Fischer-Grunski; Eva K,19,0,20,1
1745138987436,LIIT 5AS,A00,896313,Carnelos; Chiara,18,0,20,2
1745138988462,LIIT 5BS,A00,896416,Carnelos; Chiara,20,0,20,0
1745138989503,LIIT 5CS,A00,896564,Carnelos; Chiara,20,0,20,0
1745138990540,LISP 5A,A00,896588,Munoz Sanchez; Alicia,7,0,20,13
1745138991566,LISP 5B,A00,896653,Munoz Sanchez; Alicia,10,0,20,10
1745138992602,LISP 5C,A00,896655,Munoz Sanchez; Alicia,9,0,20,11
1745138993638,MAE 197,001,957918,Kleissl; Jan,9998,0,9999,1
1745138994663,MATH 2,A01,957937,Staff,34,0,35,1
1745138995689,MATH 197,001,957876,Kedlaya; Kiran S.,9996,0,9999,3
1745138996717,MCWP 40,A00,892729,Duru; Nur,16,0,20,4
1745138996717,MCWP 40,B00,893304,Montejo; Carolina,20,0,20,0
1745138997756,MCWP 40R,A00,893757,Redela; Pamela Morgan,0,3,20,20
1745139007963,MCWP 50,A00,893758,Morshed; Michael James,4,0,20,16
1745139007963,MCWP 50,B00,893761,Bartulis; Jason Michael,18,0,20,2
1745139009025,MCWP 50R,A00,893766,Compas; Sean Matthew,0,1,20,20
1745139009025,MCWP 50R,B00,893769,Carter; Jennifer A,5,0,20,15
1745139009025,MCWP 50R,C00,893771,Krone; Jarret,0,3,20,20
1745139009025,MCWP 50R,D00,893772,Miller; Elizabeth Deen,4,0,20,16
1745139009025,MCWP 50R,E00,893775,Carter; Andrea L,0,0,20,20
1745139010053,MMW 11R,A01,892721,Herbst; Matthew,22,0,30,8
1745139010053,MMW 11R,A02,892722,Herbst; Matthew,28,0,30,2
1745139011080,MMW 12R,A01,892724,Herbst; Matthew,0,5,16,16
1745139011080,MMW 12R,A02,892725,Herbst; Matthew,0,4,16,16
1745139012105,MMW 13R,A01,892727,Staff,0,29,16,16
1745139012105,MMW 13R,A02,892728,Staff,0,28,16,16
1745139013132,SIO 295LS,A00,894015,Staff,9,0,25,16
1745139014176,SIO 295S,A00,894020,Staff,9,0,25,16
1745139015204,SIOC 290S,A01,894063,Merrifield; Mark A,23,0,25,2
1745139016244,SIOC 291S,A01,894137,Gabriel; Corey John,23,0,25,2
1745139017272,SOCI 117,A01,895339,Staff,5,0,5,0
1745139018298,WES 237B,A00,894149,Staff,20,0,20,0
1745139020384,AESE 279B,A00,891859,Staff,35,0,35,0
1745139021421,AIP 197,001,891854,Staff,70,0,70,0
1745139022456,ANTH 289S,A00,891856,Gagneux; Pascal,12,0,12,0
1745139023482,BENG 196,001,957946,Engler; Adam J.,9996,0,9999,3
1745139024508,CAT 124RS,A01,956906,Staff,8,0,25,17
1745139025543,CAT 125RS,A01,922013,Staff,8,0,25,17
1745139026570,CLRE 250,A00,891860,Morris; Sheldon,9996,0,9999,3
1745139028644,CLRE 251R,A00,907817,Mehta; Ravindra L.,9995,0,9999,4
1745139029681,CLRE 252,A00,891864,Cuomo; Raphael Eduardo,9994,0,9999,5
1745139030733,CLRE 253,A00,891867,Vaida; Florin,9995,0,9999,4
1745139030733,CLRE 253,B00,907819,Staff,9999,0,9999,0
1745139031778,CLRE 259,A00,891868,Patel; Hemal,9998,0,9999,1
1745139032814,CLRE 260,A00,891872,Cuomo; Raphael Eduardo,9999,0,9999,0
1745139033847,CLRE 297,001,891888,Cuomo; Raphael Eduardo,9999,0,9999,0
1745139034893,CSS 201S,A01,892054,Mignozzetti; Umberto,30,0,30,0
1745139035922,CSS 202S,A01,892056,Mignozzetti; Umberto,30,0,30,0
1745139036950,DSC 197,001,956898,Eldridge; Justin Matthew,9998,0,9999,1
1745139037990,DSC 297,001,958000,Mazumdar; Arya,9999,0,9999,0
1745139039016,EAP 100,A00,905686,Staff,9774,0,9999,225
1745139040063,ECE 45,A01,892618,Staff,0,2,50,50
1745139041089,ECE 109,A01,892620,Staff,0,44,0,0
1745139042121,ECE 111,A01,892719,Staff,0,0,50,50
1745139043148,ECE 197,001,957920,Mercier; Patrick Philip,9992,0,9999,7
1745139044177,ECON 178,A01,907814,Zhu; Ying,29,0,35,6
1745139045204,EDS 115,A00,895312,Staff,42,0,45,3
1745139046238,EDS 117,A01,895337,Staff,30,0,30,0
1745139047275,EDS 125,A00,895341,Jones; Gabrielle Anastasia,43,0,45,2
1745139048313,EDS 128A,A01,895459,Fargason; Sharon Gayle,45,0,45,0
1745139049353,EDS 128B,A01,895543,Pappas; Elizabeth,45,0,45,0
1745139050397,EDS 139,A00,897203,Pappas; Elizabeth,45,0,45,0
1745139050397,EDS 139,B00,897209,Fargason; Sharon Gayle,45,0,45,0
1745139051422,EDS 201,A00,895545,Staff,44,0,45,1
1745139052451,EDS 203,A01,895581,Halter; Christopher P.,44,0,45,1
1745139053476,EDS 204R,A01,895625,Heinzman; Erica M.,45,0,45,0
1745139053476,EDS 204R,B01,895693,Halter; Christopher P.,28,0,45,17
1745139054517,EDS 206R,A00,895694,Fargason; Sharon Gayle,22,0,30,8
1745139054517,EDS 206R,B00,895695,Choi; Bailey Miyeon,21,0,30,9
1745139055558,EDS 250,A00,895697,Hemans; Patricia Ann Benitez,44,0,45,1
1745139056592,EDS 281,A00,895701,Meyerott; Theresa Ann,15,0,15,0
1745139057620,EDS 284,A00,895736,Meyerott; Theresa Ann,15,0,15,0
1745139058649,EDS 286,A00,897210,Fine; Sarah,15,0,15,0
1745139059706,EDS 289C,A01,895770,Daly; Alan J.,15,0,15,0
1745139060734,EDS 290,A00,897211,Hofstetter; Carolyn,15,0,15,0
1745139061774,LIGM 5A,A00,896162,Fischer-Grunski; Eva K,16,0,20,4
1745139062814,LIGM 5B,A00,896260,Fischer-Grunski; Eva K,19,0,20,1
1745139063868,LIGM 5C,A00,896308,Fischer-Grunski; Eva K,19,0,20,1
1745139064895,LIIT 5AS,A00,896313,Carnelos; Chiara,18,0,20,2
1745139065921,LIIT 5BS,A00,896416,Carnelos; Chiara,20,0,20,0
1745139066958,LIIT 5CS,A00,896564,Carnelos; Chiara,20,0,20,0
1745139067983,LISP 5A,A00,896588,Munoz Sanchez; Alicia,7,0,20,13
1745139069033,LISP 5B,A00,896653,Munoz Sanchez; Alicia,10,0,20,10
1745139070060,LISP 5C,A00,896655,Munoz Sanchez; Alicia,9,0,20,11
1745139071086,MAE 197,001,957918,Kleissl; Jan,9998,0,9999,1
1745139072111,MATH 2,A01,957937,Staff,34,0,35,1
1745139073136,MATH 197,001,957876,Kedlaya; Kiran S.,9996,0,9999,3
1745139074168,MCWP 40,A00,892729,Duru; Nur,16,0,20,4
1745139074168,MCWP 40,B00,893304,Montejo; Carolina,20,0,20,0
1745139075194,MCWP 40R,A00,893757,Redela; Pamela Morgan,0,3,20,20
1745139076233,MCWP 50,A00,893758,Morshed; Michael James,4,0,20,16
1745139076233,MCWP 50,B00,893761,Bartulis; Jason Michael,18,0,20,2
1745139077261,MCWP 50R,A00,893766,Compas; Sean Matthew,0,1,20,20
1745139077261,MCWP 50R,B00,893769,Carter; Jennifer A,5,0,20,15
1745139077261,MCWP 50R,C00,893771,Krone; Jarret,0,3,20,20
1745139077261,MCWP 50R,D00,893772,Miller; Elizabeth Deen,4,0,20,16
1745139077261,MCWP 50R,E00,893775,Carter; Andrea L,0,0,20,20
1745139078289,MMW 11R,A01,892721,Herbst; Matthew,22,0,30,8
1745139078289,MMW 11R,A02,892722,Herbst; Matthew,28,0,30,2
1745139079556,MMW 12R,A01,892724,Herbst; Matthew,0,5,16,16
1745139079556,MMW 12R,A02,892725,Herbst; Matthew,0,4,16,16
1745139084020,MMW 13R,A01,892727,Staff,0,29,16,16
1745139084020,MMW 13R,A02,892728,Staff,0,28,16,16
1745139085047,SIO 295LS,A00,894015,Staff,9,0,25,16
1745139088011,SIO 295S,A00,894020,Staff,9,0,25,16
1745139089052,SIOC 290S,A01,894063,Merrifield; Mark A,23,0,25,2
1745139090093,SIOC 291S,A01,894137,Gabriel; Corey John,23,0,25,2
1745139091125,SOCI 117,A01,895339,Staff,5,0,5,0
1745139092151,WES 237B,A00,894149,Staff,20,0,20,0
1745139094232,AESE 279B,A00,891859,Staff,35,0,35,0
1745139095257,AIP 197,001,891854,Staff,70,0,70,0
1745139096291,ANTH 289S,A00,891856,Gagneux; Pascal,12,0,12,0
1745139097316,BENG 196,001,957946,Engler; Adam J.,9996,0,9999,3
1745139098342,CAT 124RS,A01,956906,Staff,8,0,25,17
1745139099368,CAT 125RS,A01,922013,Staff,8,0,25,17
1745139100394,CLRE 250,A00,891860,Morris; Sheldon,9996,0,9999,3
1745139102453,CLRE 251R,A00,907817,Mehta; Ravindra L.,9995,0,9999,4
1745139103479,CLRE 252,A00,891864,Cuomo; Raphael Eduardo,9994,0,9999,5
1745139104513,CLRE 253,A00,891867,Vaida; Florin,9995,0,9999,4
1745139104513,CLRE 253,B00,907819,Staff,9999,0,9999,0
1745139105538,CLRE 259,A00,891868,Patel; Hemal,9998,0,9999,1
1745139106570,CLRE 260,A00,891872,Cuomo; Raphael Eduardo,9999,0,9999,0
1745139107604,CLRE 297,001,891888,Cuomo; Raphael Eduardo,9999,0,9999,0
1745139108650,CSS 201S,A01,892054,Mignozzetti; Umberto,30,0,30,0
1745139109694,CSS 202S,A01,892056,Mignozzetti; Umberto,30,0,30,0
1745139110718,DSC 197,001,956898,Eldridge; Justin Matthew,9998,0,9999,1
1745139111743,DSC 297,001,958000,Mazumdar; Arya,9999,0,9999,0
1745139112772,EAP 100,A00,905686,Staff,9774,0,9999,225
1745139113812,ECE 45,A01,892618,Staff,0,2,50,50
1745139114835,ECE 109,A01,892620,Staff,0,44,0,0
1745139115863,ECE 111,A01,892719,Staff,0,0,50,50
1745139116898,ECE 197,001,957920,Mercier; Patrick Philip,9992,0,9999,7
1745139117981,ECON 178,A01,907814,Zhu; Ying,29,0,35,6
1745139119007,EDS 115,A00,895312,Staff,42,0,45,3
1745139120050,EDS 117,A01,895337,Staff,30,0,30,0
1745139121082,EDS 125,A00,895341,Jones; Gabrielle Anastasia,43,0,45,2
1745139122107,EDS 128A,A01,895459,Fargason; Sharon Gayle,45,0,45,0
1745139123133,EDS 128B,A01,895543,Pappas; Elizabeth,45,0,45,0
1745139124158,EDS 139,A00,897203,Pappas; Elizabeth,45,0,45,0
1745139124158,EDS 139,B00,897209,Fargason; Sharon Gayle,45,0,45,0
1745139125186,EDS 201,A00,895545,Staff,44,0,45,1
1745139126220,EDS 203,A01,895581,Halter; Christopher P.,44,0,45,1
1745139127246,EDS 204R,A01,895625,Heinzman; Erica M.,45,0,45,0
1745139127246,EDS 204R,B01,895693,Halter; Christopher P.,28,0,45,17
1745139128270,EDS 206R,A00,895694,Fargason; Sharon Gayle,22,0,30,8
1745139128270,EDS 206R,B00,895695,Choi; Bailey Miyeon,21,0,30,9
1745139129297,EDS 250,A00,895697,Hemans; Patricia Ann Benitez,44,0,45,1
1745139130333,EDS 281,A00,895701,Meyerott; Theresa Ann,15,0,15,0
1745139131360,EDS 284,A00,895736,Meyerott; Theresa Ann,15,0,15,0
1745139132387,EDS 286,A00,897210,Fine; Sarah,15,0,15,0
1745139133414,EDS 289C,A01,895770,Daly; Alan J.,15,0,15,0
1745139134440,EDS 290,A00,897211,Hofstetter; Carolyn,15,0,15,0
1745139135480,LIGM 5A,A00,896162,Fischer-Grunski; Eva K,16,0,20,4
1745139136517,LIGM 5B,A00,896260,Fischer-Grunski; Eva K,19,0,20,1
1745139137558,LIGM 5C,A00,896308,Fischer-Grunski; Eva K,19,0,20,1
1745139138595,LIIT 5AS,A00,896313,Carnelos; Chiara,18,0,20,2
1745139139624,LIIT 5BS,A00,896416,Carnelos; Chiara,20,0,20,0
1745139140662,LIIT 5CS,A00,896564,Carnelos; Chiara,20,0,20,0
1745139141688,LISP 5A,A00,896588,Munoz Sanchez; Alicia,7,0,20,13
1745139142715,LISP 5B,A00,896653,Munoz Sanchez; Alicia,10,0,20,10
1745139143740,LISP 5C,A00,896655,Munoz Sanchez; Alicia,9,0,20,11
1745139144765,MAE 197,001,957918,Kleissl; Jan,9998,0,9999,1
1745139145801,MATH 2,A01,957937,Staff,34,0,35,1
1745139146827,MATH 197,001,957876,Kedlaya; Kiran S.,9996,0,9999,3
1745139147854,MCWP 40,A00,892729,Duru; Nur,16,0,20,4
1745139147854,MCWP 40,B00,893304,Montejo; Carolina,20,0,20,0
1745139148880,MCWP 40R,A00,893757,Redela; Pamela Morgan,0,3,20,20
1745139149907,MCWP 50,A00,893758,Morshed; Michael James,4,0,20,16
1745139149907,MCWP 50,B00,893761,Bartulis; Jason Michael,18,0,20,2
1745139150946,MCWP 50R,A00,893766,Compas; Sean Matthew,0,1,20,20
1745139150946,MCWP 50R,B00,893769,Carter; Jennifer A,5,0,20,15
1745139150946,MCWP 50R,C00,893771,Krone; Jarret,0,3,20,20
1745139150946,MCWP 50R,D00,893772,Miller; Elizabeth Deen,4,0,20,16
1745139150946,MCWP 50R,E00,893775,Carter; Andrea L,0,0,20,20
1745139151973,MMW 11R,A01,892721,Herbst; Matthew,22,0,30,8
1745139151973,MMW 11R,A02,892722,Herbst; Matthew,28,0,30,2
1745139153012,MMW 12R,A01,892724,Herbst; Matthew,0,5,16,16
1745139153012,MMW 12R,A02,892725,Herbst; Matthew,0,4,16,16
1745139154039,MMW 13R,A01,892727,Staff,0,29,16,16
1745139154039,MMW 13R,A02,892728,Staff,0,28,16,16
1745139155066,SIO 295LS,A00,894015,Staff,9,0,25,16
1745139156093,SIO 295S,A00,894020,Staff,9,0,25,16
1745139157131,SIOC 290S,A01,894063,Merrifield; Mark A,23,0,25,2
1745139158158,SIOC 291S,A01,894137,Gabriel; Corey John,23,0,25,2
1745139159184,SOCI 117,A01,895339,Staff,5,0,5,0
1745139160208,WES 237B,A00,894149,Staff,20,0,20,0
1745139162273,AESE 279B,A00,891859,Staff,35,0,35,0
1745139163304,AIP 197,001,891854,Staff,70,0,70,0
1745139164331,ANTH 289S,A00,891856,Gagneux; Pascal,12,0,12,0
1745139165357,BENG 196,001,957946,Engler; Adam J.,9996,0,9999,3
1745139166390,CAT 124RS,A01,956906,Staff,8,0,25,17
1745139167415,CAT 125RS,A01,922013,Staff,8,0,25,17
1745139178071,CLRE 250,A00,891860,Morris; Sheldon,9996,0,9999,3
1745139180140,CLRE 251R,A00,907817,Mehta; Ravindra L.,9995,0,9999,4
1745139181167,CLRE 252,A00,891864,Cuomo; Raphael Eduardo,9994,0,9999,5
1745139182192,CLRE 253,A00,891867,Vaida; Florin,9995,0,9999,4
1745139182192,CLRE 253,B00,907819,Staff,9999,0,9999,0
1745139183230,CLRE 259,A00,891868,Patel; Hemal,9998,0,9999,1
1745139184265,CLRE 260,A00,891872,Cuomo; Raphael Eduardo,9999,0,9999,0
1745139185298,CLRE 297,001,891888,Cuomo; Raphael Eduardo,9999,0,9999,0
1745139186327,CSS 201S,A01,892054,Mignozzetti; Umberto,30,0,30,0
1745139187365,CSS 202S,A01,892056,Mignozzetti; Umberto,30,0,30,0
1745139188396,DSC 197,001,956898,Eldridge; Justin Matthew,9998,0,9999,1
1745139189430,DSC 297,001,958000,Mazumdar; Arya,9999,0,9999,0
1745139190461,EAP 100,A00,905686,Staff,9774,0,9999,225
1745139191486,ECE 45,A01,892618,Staff,0,2,50,50
1745139192512,ECE 109,A01,892620,Staff,0,44,0,0
1745139193538,ECE 111,A01,892719,Staff,0,0,50,50
1745139194562,ECE 197,001,957920,Mercier; Patrick Philip,9992,0,9999,7
1745139195596,ECON 178,A01,907814,Zhu; Ying,29,0,35,6
1745139196628,EDS 115,A00,895312,Staff,42,0,45,3
1745139197653,EDS 117,A01,895337,Staff,30,0,30,0
1745139198680,EDS 125,A00,895341,Jones; Gabrielle Anastasia,43,0,45,2
1745139199719,EDS 128A,A01,895459,Fargason; Sharon Gayle,45,0,45,0
1745139200746,EDS 128B,A01,895543,Pappas; Elizabeth,45,0,45,0
1745139201773,EDS 139,A00,897203,Pappas; Elizabeth,45,0,45,0
1745139201773,EDS 139,B00,897209,Fargason; Sharon Gayle,45,0,45,0
1745139202800,EDS 201,A00,895545,Staff,44,0,45,1
1745139203826,EDS 203,A01,895581,Halter; Christopher P.,44,0,45,1
1745139204868,EDS 204R,A01,895625,Heinzman; Erica M.,45,0,45,0
1745139204868,EDS 204R,B01,895693,Halter; Christopher P.,28,0,45,17
1745139205902,EDS 206R,A00,895694,Fargason; Sharon Gayle,22,0,30,8
1745139205902,EDS 206R,B00,895695,Choi; Bailey Miyeon,21,0,30,9
1745139206927,EDS 250,A00,895697,Hemans; Patricia Ann Benitez,44,0,45,1
1745139207959,EDS 281,A00,895701,Meyerott; Theresa Ann,15,0,15,0
1745139208988,EDS 284,A00,895736,Meyerott; Theresa Ann,15,0,15,0
1745139210014,EDS 286,A00,897210,Fine; Sarah,15,0,15,0
1745139211051,EDS 289C,A01,895770,Daly; Alan J.,15,0,15,0
1745139212077,EDS 290,A00,897211,Hofstetter; Carolyn,15,0,15,0
1745139213103,LIGM 5A,A00,896162,Fischer-Grunski; Eva K,16,0,20,4
1745139214129,LIGM 5B,A00,896260,Fischer-Grunski; Eva K,19,0,20,1
1745139215167,LIGM 5C,A00,896308,Fischer-Grunski; Eva K,19,0,20,1
1745139216194,LIIT 5AS,A00,896313,Carnelos; Chiara,18,0,20,2
1745139217223,LIIT 5BS,A00,896416,Carnelos; Chiara,20,0,20,0
1745139218270,LIIT 5CS,A00,896564,Carnelos; Chiara,20,0,20,0
1745139219297,LISP 5A,A00,896588,Munoz Sanchez; Alicia,7,0,20,13
1745139220345,LISP 5B,A00,896653,Munoz Sanchez; Alicia,10,0,20,10
1745139221373,LISP 5C,A00,896655,Munoz Sanchez; Alicia,9,0,20,11
1745139222411,MAE 197,001,957918,Kleissl; Jan,9998,0,9999,1
1745139223443,MATH 2,A01,957937,Staff,34,0,35,1
1745139224470,MATH 197,001,957876,Kedlaya; Kiran S.,9996,0,9999,3
1745139225499,MCWP 40,A00,892729,Duru; Nur,16,0,20,4
1745139225499,MCWP 40,B00,893304,Montejo; Carolina,20,0,20,0
1745139226555,MCWP 40R,A00,893757,Redela; Pamela Morgan,0,3,20,20
1745139227583,MCWP 50,A00,893758,Morshed; Michael James,4,0,20,16
1745139227583,MCWP 50,B00,893761,Bartulis; Jason Michael,18,0,20,2
1745139228626,MCWP 50R,A00,893766,Compas; Sean Matthew,0,1,20,20
1745139228626,MCWP 50R,B00,893769,Carter; Jennifer A,5,0,20,15
1745139228626,MCWP 50R,C00,893771,Krone; Jarret,0,3,20,20
1745139228626,MCWP 50R,D00,893772,Miller; Elizabeth Deen,4,0,20,16
1745139228626,MCWP 50R,E00,893775,Carter; Andrea L,0,0,20,20
1745139229652,MMW 11R,A01,892721,Herbst; Matthew,22,0,30,8
1745139229652,MMW 11R,A02,892722,Herbst; Matthew,28,0,30,2
1745139230688,MMW 12R,A01,892724,Herbst; Matthew,0,5,16,16
1745139230688,MMW 12R,A02,892725,Herbst; Matthew,0,4,16,16
1745139231714,MMW 13R,A01,892727,Staff,0,29,16,16
1745139231714,MMW 13R,A02,892728,Staff,0,28,16,16
1745139232740,SIO 295LS,A00,894015,Staff,9,0,25,16
1745139233766,SIO 295S,A00,894020,Staff,9,0,25,16
1745139234819,SIOC 290S,A01,894063,Merrifield; Mark A,23,0,25,2
1745139235857,SIOC 291S,A01,894137,Gabriel; Corey John,23,0,25,2
1745139236894,SOCI 117,A01,895339,Staff,5,0,5,0
1745139237926,WES 237B,A00,894149,Staff,20,0,20,0
1745139240019,AESE 279B,A00,891859,Staff,35,0,35,0
1745139241045,AIP 197,001,891854,Staff,70,0,70,0
1745139242072,ANTH 289S,A00,891856,Gagneux; Pascal,12,0,12,0
1745139243098,BENG 196,001,957946,Engler; Adam J.,9996,0,9999,3
1745139244138,CAT 124RS,A01,956906,Staff,8,0,25,17
1745139245183,CAT 125RS,A01,922013,Staff,8,0,25,17
1745139246218,CLRE 250,A00,891860,Morris; Sheldon,9996,0,9999,3
1745139248279,CLRE 251R,A00,907817,Mehta; Ravindra L.,9995,0,9999,4
1745139252462,CLRE 252,A00,891864,Cuomo; Raphael Eduardo,9994,0,9999,5
1745139253490,CLRE 253,A00,891867,Vaida; Florin,9995,0,9999,4
1745139253490,CLRE 253,B00,907819,Staff,9999,0,9999,0
1745139258173,CLRE 259,A00,891868,Patel; Hemal,9998,0,9999,1
1745139259203,CLRE 260,A00,891872,Cuomo; Raphael Eduardo,9999,0,9999,0
1745139260236,CLRE 297,001,891888,Cuomo; Raphael Eduardo,9999,0,9999,0
1745139261265,CSS 201S,A01,892054,Mignozzetti; Umberto,30,0,30,0
1745139262310,CSS 202S,A01,892056,Mignozzetti; Umberto,30,0,30,0
1745139263337,DSC 197,001,956898,Eldridge; Justin Matthew,9998,0,9999,1
1745139264370,DSC 297,001,958000,Mazumdar; Arya,9999,0,9999,0
1745139265396,EAP 100,A00,905686,Staff,9774,0,9999,225
1745139266424,ECE 45,A01,892618,Staff,0,2,50,50
1745139267449,ECE 109,A01,892620,Staff,0,44,0,0
1745139268476,ECE 111,A01,892719,Staff,0,0,50,50
1745139269505,ECE 197,001,957920,Mercier; Patrick Philip,9992,0,9999,7
1745139270534,ECON 178,A01,907814,Zhu; Ying,29,0,35,6
1745139271561,EDS 115,A00,895312,Staff,42,0,45,3
1745139272588,EDS 117,A01,895337,Staff,30,0,30,0
1745139273616,EDS 125,A00,895341,Jones; Gabrielle Anastasia,43,0,45,2
1745139274643,EDS 128A,A01,895459,Fargason; Sharon Gayle,45,0,45,0
1745139275670,EDS 128B,A01,895543,Pappas; Elizabeth,45,0,45,0
1745139276708,EDS 139,A00,897203,Pappas; Elizabeth,45,0,45,0
1745139276708,EDS 139,B00,897209,Fargason; Sharon Gayle,45,0,45,0
1745139277761,EDS 201,A00,895545,Staff,44,0,45,1
1745139278790,EDS 203,A01,895581,Halter; Christopher P.,44,0,45,1
1745139279855,EDS 204R,A01,895625,Heinzman; Erica M.,45,0,45,0
1745139279855,EDS 204R,B01,895693,Halter; Christopher P.,28,0,45,17
1745139280901,EDS 206R,A00,895694,Fargason; Sharon Gayle,22,0,30,8
1745139280901,EDS 206R,B00,895695,Choi; Bailey Miyeon,21,0,30,9
1745139281929,EDS 250,A00,895697,Hemans; Patricia Ann Benitez,44,0,45,1
1745139282967,EDS 281,A00,895701,Meyerott; Theresa Ann,15,0,15,0
1745139283992,EDS 284,A00,895736,Meyerott; Theresa Ann,15,0,15,0
1745139285062,EDS 286,A00,897210,Fine; Sarah,15,0,15,0
1745139286088,EDS 289C,A01,895770,Daly; Alan J.,15,0,15,0
1745139287125,EDS 290,A00,897211,Hofstetter; Carolyn,15,0,15,0
1745139288189,LIGM 5A,A00,896162,Fischer-Grunski; Eva K,16,0,20,4
1745139289238,LIGM 5B,A00,896260,Fischer-Grunski; Eva K,19,0,20,1
1745139290280,LIGM 5C,A00,896308,Fischer-Grunski; Eva K,19,0,20,1
1745139291330,LIIT 5AS,A00,896313,Carnelos; Chiara,18,0,20,2
1745139292375,LIIT 5BS,A00,896416,Carnelos; Chiara,20,0,20,0
1745139293401,LIIT 5CS,A00,896564,Carnelos; Chiara,20,0,20,0
1745139294444,LISP 5A,A00,896588,Munoz Sanchez; Alicia,7,0,20,13
1745139295470,LISP 5B,A00,896653,Munoz Sanchez; Alicia,10,0,20,10
1745139296506,LISP 5C,A00,896655,Munoz Sanchez; Alicia,9,0,20,11
1745139297535,MAE 197,001,957918,Kleissl; Jan,9998,0,9999,1
1745139298561,MATH 2,A01,957937,Staff,34,0,35,1
1745139299597,MATH 197,001,957876,Kedlaya; Kiran S.,9996,0,9999,3
1745139300623,MCWP 40,A00,892729,Duru; Nur,16,0,20,4
1745139300623,MCWP 40,B00,893304,Montejo; Carolina,20,0,20,0
1745139301666,MCWP 40R,A00,893757,Redela; Pamela Morgan,0,3,20,20
1745139302693,MCWP 50,A00,893758,Morshed; Michael James,4,0,20,16
1745139302693,MCWP 50,B00,893761,Bartulis; Jason Michael,18,0,20,2
1745139303719,MCWP 50R,A00,893766,Compas; Sean Matthew,0,1,20,20
1745139303719,MCWP 50R,B00,893769,Carter; Jennifer A,5,0,20,15
1745139303719,MCWP 50R,C00,893771,Krone; Jarret,0,3,20,20
1745139303719,MCWP 50R,D00,893772,Miller; Elizabeth Deen,4,0,20,16
1745139303719,MCWP 50R,E00,893775,Carter; Andrea L,0,0,20,20
1745139304762,MMW 11R,A01,892721,Herbst; Matthew,22,0,30,8
1745139304762,MMW 11R,A02,892722,Herbst; Matthew,28,0,30,2
1745139305788,MMW 12R,A01,892724,Herbst; Matthew,0,5,16,16
1745139305788,MMW 12R,A02,892725,Herbst; Matthew,0,4,16,16
1745139306815,MMW 13R,A01,892727,Staff,0,29,16,16
1745139306815,MMW 13R,A02,892728,Staff,0,28,16,16
1745139307852,SIO 295LS,A00,894015,Staff,9,0,25,16
1745139308879,SIO 295S,A00,894020,Staff,9,0,25,16
1745139309905,SIOC 290S,A01,894063,Merrifield; Mark A,23,0,25,2
1745139310931,SIOC 291S,A01,894137,Gabriel; Corey John,23,0,25,2
1745139311971,SOCI 117,A01,895339,Staff,5,0,5,0
1745139312996,WES 237B,A00,894149,Staff,20,0,20,0
1745139315086,AESE 279B,A00,891859,Staff,35,0,35,0
1745139316112,AIP 197,001,891854,Staff,70,0,70,0
1745139317137,ANTH 289S,A00,891856,Gagneux; Pascal,12,0,12,0
1745139318205,BENG 196,001,957946,Engler; Adam J.,9996,0,9999,3
1745139319232,CAT 124RS,A01,956906,Staff,8,0,25,17
1745139320272,CAT 125RS,A01,922013,Staff,8,0,25,17
1745139321298,CLRE 250,A00,891860,Morris; Sheldon,9996,0,9999,3
1745139323350,CLRE 251R,A00,907817,Mehta; Ravindra L.,9995,0,9999,4
1745139324377,CLRE 252,A00,891864,Cuomo; Raphael Eduardo,9994,0,9999,5
1745139325402,CLRE 253,A00,891867,Vaida; Florin,9995,0,9999,4
1745139325402,CLRE 253,B00,907819,Staff,9999,0,9999,0
1745139326429,CLRE 259,A00,891868,Patel; Hemal,9998,0,9999,1
1745139327463,CLRE 260,A00,891872,Cuomo; Raphael Eduardo,9999,0,9999,0
1745139328490,CLRE 297,001,891888,Cuomo; Raphael Eduardo,9999,0,9999,0
1745139338240,CSS 201S,A01,892054,Mignozzetti; Umberto,30,0,30,0
1745139339266,CSS 202S,A01,892056,Mignozzetti; Umberto,30,0,30,0
1745139340293,DSC 197,001,956898,Eldridge; Justin Matthew,9998,0,9999,1
1745139341328,DSC 297,001,958000,Mazumdar; Arya,9999,0,9999,0
1745139342364,EAP 100,A00,905686,Staff,9774,0,9999,225
1745139343398,ECE 45,A01,892618,Staff,0,2,50,50
1745139344422,ECE 109,A01,892620,Staff,0,44,0,0
1745139345455,ECE 111,A01,892719,Staff,0,0,50,50
1745139346494,ECE 197,001,957920,Mercier; Patrick Philip,9992,0,9999,7
1745139347521,ECON 178,A01,907814,Zhu; Ying,29,0,35,6
1745139348547,EDS 115,A00,895312,Staff,42,0,45,3
1745139349572,EDS 117,A01,895337,Staff,30,0,30,0
1745139350606,EDS 125,A00,895341,Jones; Gabrielle Anastasia,43,0,45,2
1745139351632,EDS 128A,A01,895459,Fargason; Sharon Gayle,45,0,45,0
1745139352667,EDS 128B,A01,895543,Pappas; Elizabeth,45,0,45,0
1745139353703,EDS 139,A00,897203,Pappas; Elizabeth,45,0,45,0
1745139353703,EDS 139,B00,897209,Fargason; Sharon Gayle,45,0,45,0
1745139354735,EDS 201,A00,895545,Staff,44,0,45,1
1745139355772,EDS 203,A01,895581,Halter; Christopher P.,44,0,45,1
1745139356804,EDS 204R,A01,895625,Heinzman; Erica M.,45,0,45,0
1745139356804,EDS 204R,B01,895693,Halter; Christopher P.,28,0,45,17
1745139357832,EDS 206R,A00,895694,Fargason; Sharon Gayle,22,0,30,8
1745139357832,EDS 206R,B00,895695,Choi; Bailey Miyeon,21,0,30,9
1745139358859,EDS 250,A00,895697,Hemans; Patricia Ann Benitez,44,0,45,1
1745139359886,EDS 281,A00,895701,Meyerott; Theresa Ann,15,0,15,0
1745139360921,EDS 284,A00,895736,Meyerott; Theresa Ann,15,0,15,0
1745139361948,EDS 286,A00,897210,Fine; Sarah,15,0,15,0
1745139362973,EDS 289C,A01,895770,Daly; Alan J.,15,0,15,0
1745139364008,EDS 290,A00,897211,Hofstetter; Carolyn,15,0,15,0
1745139365058,LIGM 5A,A00,896162,Fischer-Grunski; Eva K,16,0,20,4
1745139366085,LIGM 5B,A00,896260,Fischer-Grunski; Eva K,19,0,20,1
1745139367115,LIGM 5C,A00,896308,Fischer-Grunski; Eva K,19,0,20,1
1745139368141,LIIT 5AS,A00,896313,Carnelos; Chiara,18,0,20,2
1745139369169,LIIT 5BS,A00,896416,Carnelos; Chiara,20,0,20,0
1745139370197,LIIT 5CS,A00,896564,Carnelos; Chiara,20,0,20,0
1745139371239,LISP 5A,A00,896588,Munoz Sanchez; Alicia,7,0,20,13
1745139372276,LISP 5B,A00,896653,Munoz Sanchez; Alicia,10,0,20,10
1745139373303,LISP 5C,A00,896655,Munoz Sanchez; Alicia,9,0,20,11
1745139374336,MAE 197,001,957918,Kleissl; Jan,9998,0,9999,1
1745139375362,MATH 2,A01,957937,Staff,34,0,35,1
1745139376389,MATH 197,001,957876,Kedlaya; Kiran S.,9996,0,9999,3
1745139377415,MCWP 40,A00,892729,Duru; Nur,16,0,20,4
1745139377415,MCWP 40,B00,893304,Montejo; Carolina,20,0,20,0
1745139378442,MCWP 40R,A00,893757,Redela; Pamela Morgan,0,3,20,20
1745139379469,MCWP 50,A00,893758,Morshed; Michael James,4,0,20,16
1745139379469,MCWP 50,B00,893761,Bartulis; Jason Michael,18,0,20,2
1745139380496,MCWP 50R,A00,893766,Compas; Sean Matthew,0,1,20,20
1745139380496,MCWP 50R,B00,893769,Carter; Jennifer A,5,0,20,15
1745139380496,MCWP 50R,C00,893771,Krone; Jarret,0,3,20,20
1745139380496,MCWP 50R,D00,893772,Miller; Elizabeth Deen,4,0,20,16
1745139380496,MCWP 50R,E00,893775,Carter; Andrea L,0,0,20,20
1745139381523,MMW 11R,A01,892721,Herbst; Matthew,22,0,30,8
1745139381523,MMW 11R,A02,892722,Herbst; Matthew,28,0,30,2
1745139382548,MMW 12R,A01,892724,Herbst; Matthew,0,5,16,16
1745139382548,MMW 12R,A02,892725,Herbst; Matthew,0,4,16,16
1745139383581,MMW 13R,A01,892727,Staff,0,29,16,16
1745139383581,MMW 13R,A02,892728,Staff,0,28,16,16
1745139384608,SIO 295LS,A00,894015,Staff,9,0,25,16
1745139385634,SIO 295S,A00,894020,Staff,9,0,25,16
1745139386664,SIOC 290S,A01,894063,Merrifield; Mark A,23,0,25,2
1745139387695,SIOC 291S,A01,894137,Gabriel; Corey John,23,0,25,2
1745139388725,SOCI 117,A01,895339,Staff,5,0,5,0
1745139389752,WES 237B,A00,894149,Staff,20,0,20,0
1745139391828,AESE 279B,A00,891859,Staff,35,0,35,0
1745139392861,AIP 197,001,891854,Staff,70,0,70,0
1745139393897,ANTH 289S,A00,891856,Gagneux; Pascal,12,0,12,0
1745139394924,BENG 196,001,957946,Engler; Adam J.,9996,0,9999,3
1745139395949,CAT 124RS,A01,956906,Staff,8,0,25,17
1745139396977,CAT 125RS,A01,922013,Staff,8,0,25,17
1745139398002,CLRE 250,A00,891860,Morris; Sheldon,9996,0,9999,3
1745139400057,CLRE 251R,A00,907817,Mehta; Ravindra L.,9995,0,9999,4
1745139401084,CLRE 252,A00,891864,Cuomo; Raphael Eduardo,9994,0,9999,5
1745139402110,CLRE 253,A00,891867,Vaida; Florin,9995,0,9999,4
1745139402110,CLRE 253,B00,907819,Staff,9999,0,9999,0
1745139403138,CLRE 259,A00,891868,Patel; Hemal,9998,0,9999,1
1745139404163,CLRE 260,A00,891872,Cuomo; Raphael Eduardo,9999,0,9999,0
1745139405189,CLRE 297,001,891888,Cuomo; Raphael Eduardo,9999,0,9999,0
1745139406216,CSS 201S,A01,892054,Mignozzetti; Umberto,30,0,30,0
1745139407242,CSS 202S,A01,892056,Mignozzetti; Umberto,30,0,30,0
1745139408286,DSC 197,001,956898,Eldridge; Justin Matthew,9998,0,9999,1
1745139409316,DSC 297,001,958000,Mazumdar; Arya,9999,0,9999,0
1745139410348,EAP 100,A00,905686,Staff,9774,0,9999,225
1745139411373,ECE 45,A01,892618,Staff,0,2,50,50
1745139412400,ECE 109,A01,892620,Staff,0,44,0,0
1745139413430,ECE 111,A01,892719,Staff,0,0,50,50
1745139414463,ECE 197,001,957920,Mercier; Patrick Philip,9992,0,9999,7
1745139415490,ECON 178,A01,907814,Zhu; Ying,29,0,35,6
1745139416520,EDS 115,A00,895312,Staff,42,0,45,3
1745139417545,EDS 117,A01,895337,Staff,30,0,30,0
1745139418571,EDS 125,A00,895341,Jones; Gabrielle Anastasia,43,0,45,2
1745139419604,EDS 128A,A01,895459,Fargason; Sharon Gayle,45,0,45,0
1745139420632,EDS 128B,A01,895543,Pappas; Elizabeth,45,0,45,0
1745139421665,EDS 139,A00,897203,Pappas; Elizabeth,45,0,45,0
1745139421665,EDS 139,B00,897209,Fargason; Sharon Gayle,45,0,45,0
1745139422696,EDS 201,A00,895545,Staff,44,0,45,1
1745139423724,EDS 203,A01,895581,Halter; Christopher P.,44,0,45,1
1745139424752,EDS 204R,A01,895625,Heinzman; Erica M.,45,0,45,0
1745139424752,EDS 204R,B01,895693,Halter; Christopher P.,28,0,45,17
1745139425784,EDS 206R,A00,895694,Fargason; Sharon Gayle,22,0,30,8
1745139425784,EDS 206R,B00,895695,Choi; Bailey Miyeon,21,0,30,9
1745139426810,EDS 250,A00,895697,Hemans; Patricia Ann Benitez,44,0,45,1
1745139427836,EDS 281,A00,895701,Meyerott; Theresa Ann,15,0,15,0
1745139428861,EDS 284,A00,895736,Meyerott; Theresa Ann,15,0,15,0
1745139429888,EDS 286,A00,897210,Fine; Sarah,15,0,15,0
1745139430914,EDS 289C,A01,895770,Daly; Alan J.,15,0,15,0
1745139431940,EDS 290,A00,897211,Hofstetter; Carolyn,15,0,15,0
1745139432976,LIGM 5A,A00,896162,Fischer-Grunski; Eva K,16,0,20,4
1745139434006,LIGM 5B,A00,896260,Fischer-Grunski; Eva K,19,0,20,1
1745139435033,LIGM 5C,A00,896308,Fischer-Grunski; Eva K,19,0,20,1
1745139436061,LIIT 5AS,A00,896313,Carnelos; Chiara,18,0,20,2
1745139437088,LIIT 5BS,A00,896416,Carnelos; Chiara,20,0,20,0
1745139438119,LIIT 5CS,A00,896564,Carnelos; Chiara,20,0,20,0
1745139439151,LISP 5A,A00,896588,Munoz Sanchez; Alicia,7,0,20,13
1745139440177,LISP 5B,A00,896653,Munoz Sanchez; Alicia,10,0,20,10
1745139441205,LISP 5C,A00,896655,Munoz Sanchez; Alicia,9,0,20,11
1745139442231,MAE 197,001,957918,Kleissl; Jan,9998,0,9999,1
1745139443258,MATH 2,A01,957937,Staff,34,0,35,1
1745139444287,MATH 197,001,957876,Kedlaya; Kiran S.,9996,0,9999,3
1745139445316,MCWP 40,A00,892729,Duru; Nur,16,0,20,4
1745139445316,MCWP 40,B00,893304,Montejo; Carolina,20,0,20,0
1745139446348,MCWP 40R,A00,893757,Redela; Pamela Morgan,0,3,20,20
1745139447375,MCWP 50,A00,893758,Morshed; Michael James,4,0,20,16
1745139447375,MCWP 50,B00,893761,Bartulis; Jason Michael,18,0,20,2
1745139448404,MCWP 50R,A00,893766,Compas; Sean Matthew,0,1,20,20
1745139448404,MCWP 50R,B00,893769,Carter; Jennifer A,5,0,20,15
1745139448404,MCWP 50R,C00,893771,Krone; Jarret,0,3,20,20
1745139448404,MCWP 50R,D00,893772,Miller; Elizabeth Deen,4,0,20,16
1745139448404,MCWP 50R,E00,893775,Carter; Andrea L,0,0,20,20
1745139449431,MMW 11R,A01,892721,Herbst; Matthew,22,0,30,8
1745139449431,MMW 11R,A02,892722,Herbst; Matthew,28,0,30,2
1745139450457,MMW 12R,A01,892724,Herbst; Matthew,0,5,16,16
1745139450457,MMW 12R,A02,892725,Herbst; Matthew,0,4,16,16
1745139451484,MMW 13R,A01,892727,Staff,0,29,16,16
1745139451484,MMW 13R,A02,892728,Staff,0,28,16,16
1745139452509,SIO 295LS,A00,894015,Staff,9,0,25,16
1745139453535,SIO 295S,A00,894020,Staff,9,0,25,16
1745139454562,SIOC 290S,A01,894063,Merrifield; Mark A,23,0,25,2
1745139455592,SIOC 291S,A01,894137,Gabriel; Corey John,23,0,25,2
1745139456618,SOCI 117,A01,895339,Staff,5,0,5,0
1745139457646,WES 237B,A00,894149,Staff,20,0,20,0
1745139459726,AESE 279B,A00,891859,Staff,35,0,35,0
1745139460755,AIP 197,001,891854,Staff,70,0,70,0
1745139461781,ANTH 289S,A00,891856,Gagneux; Pascal,12,0,12,0
1745139462808,BENG 196,001,957946,Engler; Adam J.,9996,0,9999,3
1745139463832,CAT 124RS,A01,956906,Staff,8,0,25,17
1745139464864,CAT 125RS,A01,922013,Staff,8,0,25,17
1745139465890,CLRE 250,A00,891860,Morris; Sheldon,9996,0,9999,3
1745139467945,CLRE 251R,A00,907817,Mehta; Ravindra L.,9995,0,9999,4
1745139468974,CLRE 252,A00,891864,Cuomo; Raphael Eduardo,9994,0,9999,5
1745139470001,CLRE 253,A00,891867,Vaida; Florin,9995,0,9999,4
1745139470001,CLRE 253,B00,907819,Staff,9999,0,9999,0
1745139471028,CLRE 259,A00,891868,Patel; Hemal,9998,0,9999,1
1745139472054,CLRE 260,A00,891872,Cuomo; Raphael Eduardo,9999,0,9999,0
1745139473084,CLRE 297,001,891888,Cuomo; Raphael Eduardo,9999,0,9999,0
1745139474113,CSS 201S,A01,892054,Mignozzetti; Umberto,30,0,30,0
1745139475144,CSS 202S,A01,892056,Mignozzetti; Umberto,30,0,30,0
1745139476170,DSC 197,001,956898,Eldridge; Justin Matthew,9998,0,9999,1
1745139477196,DSC 297,001,958000,Mazumdar; Arya,9999,0,9999,0
1745139478220,EAP 100,A00,905686,Staff,9774,0,9999,225
1745139479244,ECE 45,A01,892618,Staff,0,2,50,50
1745139480274,ECE 109,A01,892620,Staff,0,44,0,0
1745139481300,ECE 111,A01,892719,Staff,0,0,50,50
1745139482328,ECE 197,001,957920,Mercier; Patrick Philip,9992,0,9999,7
1745139483356,ECON 178,A01,907814,Zhu; Ying,29,0,35,6
1745139484385,EDS 115,A00,895312,Staff,42,0,45,3
1745139485415,EDS 117,A01,895337,Staff,30,0,30,0
1745139486442,EDS 125,A00,895341,Jones; Gabrielle Anastasia,43,0,45,2
1745139487470,EDS 128A,A01,895459,Fargason; Sharon Gayle,45,0,45,0
1745139488497,EDS 128B,A01,895543,Pappas; Elizabeth,45,0,45,0
1745139489528,EDS 139,A00,897203,Pappas; Elizabeth,45,0,45,0
1745139489528,EDS 139,B00,897209,Fargason; Sharon Gayle,45,0,45,0
1745139490558,EDS 201,A00,895545,Staff,44,0,45,1
1745139491588,EDS 203,A01,895581,Halter; Christopher P.,44,0,45,1
1745139492616,EDS 204R,A01,895625,Heinzman; Erica M.,45,0,45,0
1745139492616,EDS 204R,B01,895693,Halter; Christopher P.,28,0,45,17
1745139493641,EDS 206R,A00,895694,Fargason; Sharon Gayle,22,0,30,8
1745139493641,EDS 206R,B00,895695,Choi; Bailey Miyeon,21,0,30,9
1745139494669,EDS 250,A00,895697,Hemans; Patricia Ann Benitez,44,0,45,1
1745139495697,EDS 281,A00,895701,Meyerott; Theresa Ann,15,0,15,0
1745139496723,EDS 284,A00,895736,Meyerott; Theresa Ann,15,0,15,0
1745139497789,EDS 286,A00,897210,Fine; Sarah,15,0,15,0
1745139498817,EDS 289C,A01,895770,Daly; Alan J.,15,0,15,0
1745139499845,EDS 290,A00,897211,Hofstetter; Carolyn,15,0,15,0
1745139500872,LIGM 5A,A00,896162,Fischer-Grunski; Eva K,16,0,20,4
1745139501900,LIGM 5B,A00,896260,Fischer-Grunski; Eva K,19,0,20,1
1745139502925,LIGM 5C,A00,896308,Fischer-Grunski; Eva K,19,0,20,1
1745139503950,LIIT 5AS,A00,896313,Carnelos; Chiara,18,0,20,2
1745139504978,LIIT 5BS,A00,896416,Carnelos; Chiara,20,0,20,0
1745139506008,LIIT 5CS,A00,896564,Carnelos; Chiara,20,0,20,0
1745139507037,LISP 5A,A00,896588,Munoz Sanchez; Alicia,7,0,20,13
1745139508069,LISP 5B,A00,896653,Munoz Sanchez; Alicia,10,0,20,10
1745139509095,LISP 5C,A00,896655,Munoz Sanchez; Alicia,9,0,20,11
1745139510125,MAE 197,001,957918,Kleissl; Jan,9998,0,9999,1
1745139511155,MATH 2,A01,957937,Staff,34,0,35,1
1745139512188,MATH 197,001,957876,Kedlaya; Kiran S.,9996,0,9999,3
1745139513242,MCWP 40,A00,892729,Duru; Nur,16,0,20,4
1745139513242,MCWP 40,B00,893304,Montejo; Carolina,20,0,20,0
1745139514269,MCWP 40R,A00,893757,Redela; Pamela Morgan,0,3,20,20
1745139515298,MCWP 50,A00,893758,Morshed; Michael James,4,0,20,16
1745139515298,MCWP 50,B00,893761,Bartulis; Jason Michael,18,0,20,2
1745139516330,MCWP 50R,A00,893766,Compas; Sean Matthew,0,1,20,20
1745139516330,MCWP 50R,B00,893769,Carter; Jennifer A,5,0,20,15
1745139516330,MCWP 50R,C00,893771,Krone; Jarret,0,3,20,20
1745139516330,MCWP 50R,D00,893772,Miller; Elizabeth Deen,4,0,20,16
1745139516330,MCWP 50R,E00,893775,Carter; Andrea L,0,0,20,20
1745139517357,MMW 11R,A01,892721,Herbst; Matthew,22,0,30,8
1745139517357,MMW 11R,A02,892722,Herbst; Matthew,28,0,30,2
1745139518384,MMW 12R,A01,892724,Herbst; Matthew,0,5,16,16
1745139518384,MMW 12R,A02,892725,Herbst; Matthew,0,4,16,16
1745139519411,MMW 13R,A01,892727,Staff,0,29,16,16
1745139519411,MMW 13R,A02,892728,Staff,0,28,16,16
1745139520438,SIO 295LS,A00,894015,Staff,9,0,25,16
1745139521464,SIO 295S,A00,894020,Staff,9,0,25,16
1745139522492,SIOC 290S,A01,894063,Merrifield; Mark A,23,0,25,2
1745139523520,SIOC 291S,A01,894137,Gabriel; Corey John,23,0,25,2
1745139524547,SOCI 117,A01,895339,Staff,5,0,5,0
1745139525574,WES 237B,A00,894149,Staff,20,0,20,0
1745139527639,AESE 279B,A00,891859,Staff,35,0,35,0
1745139528664,AIP 197,001,891854,Staff,70,0,70,0
1745139529693,ANTH 289S,A00,891856,Gagneux; Pascal,12,0,12,0
1745139530719,BENG 196,001,957946,Engler; Adam J.,9996,0,9999,3
1745139531749,CAT 124RS,A01,956906,Staff,8,0,25,17
1745139532779,CAT 125RS,A01,922013,Staff,8,0,25,17
1745139533811,CLRE 250,A00,891860,Morris; Sheldon,9996,0,9999,3
1745139535862,CLRE 251R,A00,907817,Mehta; Ravindra L.,9995,0,9999,4
1745139536889,CLRE 252,A00,891864,Cuomo; Raphael Eduardo,9994,0,9999,5
1745139537921,CLRE 253,A00,891867,Vaida; Florin,9995,0,9999,4
1745139537921,CLRE 253,B00,907819,Staff,9999,0,9999,0
1745139538949,CLRE 259,A00,891868,Patel; Hemal,9998,0,9999,1
1745139539975,CLRE 260,A00,891872,Cuomo; Raphael Eduardo,9999,0,9999,0
1745139541002,CLRE 297,001,891888,Cuomo; Raphael Eduardo,9999,0,9999,0
1745139542030,CSS 201S,A01,892054,Mignozzetti; Umberto,30,0,30,0
1745139543055,CSS 202S,A01,892056,Mignozzetti; Umberto,30,0,30,0
1745139544080,DSC 197,001,956898,Eldridge; Justin Matthew,9998,0,9999,1
1745139545107,DSC 297,001,958000,Mazumdar; Arya,9999,0,9999,0
1745139546133,EAP 100,A00,905686,Staff,9774,0,9999,225
1745139547165,ECE 45,A01,892618,Staff,0,2,50,50
1745139548194,ECE 109,A01,892620,Staff,0,44,0,0
1745139549221,ECE 111,A01,892719,Staff,0,0,50,50
1745139550249,ECE 197,001,957920,Mercier; Patrick Philip,9992,0,9999,7
1745139551280,ECON 178,A01,907814,Zhu; Ying,29,0,35,6
1745139552311,EDS 115,A00,895312,Staff,42,0,45,3
1745139553337,EDS 117,A01,895337,Staff,30,0,30,0
1745139554369,EDS 125,A00,895341,Jones; Gabrielle Anastasia,43,0,45,2
1745139555399,EDS 128A,A01,895459,Fargason; Sharon Gayle,45,0,45,0
1745139556428,EDS 128B,A01,895543,Pappas; Elizabeth,45,0,45,0
1745139557455,EDS 139,A00,897203,Pappas; Elizabeth,45,0,45,0
1745139557455,EDS 139,B00,897209,Fargason; Sharon Gayle,45,0,45,0
1745139558484,EDS 201,A00,895545,Staff,44,0,45,1
1745139559512,EDS 203,A01,895581,Halter; Christopher P.,44,0,45,1
1745139560540,EDS 204R,A01,895625,Heinzman; Erica M.,45,0,45,0
1745139560540,EDS 204R,B01,895693,Halter; Christopher P.,28,0,45,17
1745139561567,EDS 206R,A00,895694,Fargason; Sharon Gayle,22,0,30,8
1745139561567,EDS 206R,B00,895695,Choi; Bailey Miyeon,21,0,30,9
1745139562594,EDS 250,A00,895697,Hemans; Patricia Ann Benitez,44,0,45,1
1745139563621,EDS 281,A00,895701,Meyerott; Theresa Ann,15,0,15,0
1745139564650,EDS 284,A00,895736,Meyerott; Theresa Ann,15,0,15,0
1745139565680,EDS 286,A00,897210,Fine; Sarah,15,0,15,0
1745139566708,EDS 289C,A01,895770,Daly; Alan J.,15,0,15,0
1745139567735,EDS 290,A00,897211,Hofstetter; Carolyn,15,0,15,0
1745139568763,LIGM 5A,A00,896162,Fischer-Grunski; Eva K,16,0,20,4
1745139569795,LIGM 5B,A00,896260,Fischer-Grunski; Eva K,19,0,20,1
1745139570822,LIGM 5C,A00,896308,Fischer-Grunski; Eva K,19,0,20,1
1745139571848,LIIT 5AS,A00,896313,Carnelos; Chiara,18,0,20,2
1745139572879,LIIT 5BS,A00,896416,Carnelos; Chiara,20,0,20,0
1745139573909,LIIT 5CS,A00,896564,Carnelos; Chiara,20,0,20,0
1745139574942,LISP 5A,A00,896588,Munoz Sanchez; Alicia,7,0,20,13
1745139575971,LISP 5B,A00,896653,Munoz Sanchez; Alicia,10,0,20,10
1745139576998,LISP 5C,A00,896655,Munoz Sanchez; Alicia,9,0,20,11
1745139578030,MAE 197,001,957918,Kleissl; Jan,9998,0,9999,1
1745139579062,MATH 2,A01,957937,Staff,34,0,35,1
1745139580090,MATH 197,001,957876,Kedlaya; Kiran S.,9996,0,9999,3
1745139581122,MCWP 40,A00,892729,Duru; Nur,16,0,20,4
1745139581122,MCWP 40,B00,893304,Montejo; Carolina,20,0,20,0
1745139582151,MCWP 40R,A00,893757,Redela; Pamela Morgan,0,3,20,20
1745139583183,MCWP 50,A00,893758,Morshed; Michael James,4,0,20,16
1745139583183,MCWP 50,B00,893761,Bartulis; Jason Michael,18,0,20,2
1745139584219,MCWP 50R,A00,893766,Compas; Sean Matthew,0,1,20,20
1745139584219,MCWP 50R,B00,893769,Carter; Jennifer A,5,0,20,15
1745139584219,MCWP 50R,C00,893771,Krone; Jarret,0,3,20,20
1745139584219,MCWP 50R,D00,893772,Miller; Elizabeth Deen,4,0,20,16
1745139584219,MCWP 50R,E00,893775,Carter; Andrea L,0,0,20,20
1745139585246,MMW 11R,A01,892721,Herbst; Matthew,22,0,30,8
1745139585246,MMW 11R,A02,892722,Herbst; Matthew,28,0,30,2
1745139586273,MMW 12R,A01,892724,Herbst; Matthew,0,5,16,16
1745139586273,MMW 12R,A02,892725,Herbst; Matthew,0,4,16,16
1745139587300,MMW 13R,A01,892727,Staff,0,29,16,16
1745139587300,MMW 13R,A02,892728,Staff,0,28,16,16
1745139588332,SIO 295LS,A00,894015,Staff,9,0,25,16
1745139589358,SIO 295S,A00,894020,Staff,9,0,25,16
1745139590388,SIOC 290S,A01,894063,Merrifield; Mark A,23,0,25,2
1745139591419,SIOC 291S,A01,894137,Gabriel; Corey John,23,0,25,2
1745139592447,SOCI 117,A01,895339,Staff,5,0,5,0
1745139593475,WES 237B,A00,894149,Staff,20,0,20,0
1745139595553,AESE 279B,A00,891859,Staff,35,0,35,0
1745139596584,AIP 197,001,891854,Staff,70,0,70,0
1745139597611,ANTH 289S,A00,891856,Gagneux; Pascal,12,0,12,0
1745139598639,BENG 196,001,957946,Engler; Adam J.,9996,0,9999,3
1745139599666,CAT 124RS,A01,956906,Staff,8,0,25,17
1745139600692,CAT 125RS,A01,922013,Staff,8,0,25,17
1745139601761,CLRE 250,A00,891860,Morris; Sheldon,9996,0,9999,3
1745139603826,CLRE 251R,A00,907817,Mehta; Ravindra L.,9995,0,9999,4
1745139604854,CLRE 252,A00,891864,Cuomo; Raphael Eduardo,9994,0,9999,5
1745139605883,CLRE 253,A00,891867,Vaida; Florin,9995,0,9999,4
1745139605883,CLRE 253,B00,907819,Staff,9999,0,9999,0
1745139606909,CLRE 259,A00,891868,Patel; Hemal,9998,0,9999,1
1745139607935,CLRE 260,A00,891872,Cuomo; Raphael Eduardo,9999,0,9999,0
1745139608962,CLRE 297,001,891888,Cuomo; Raphael Eduardo,9999,0,9999,0
1745139610001,CSS 201S,A01,892054,Mignozzetti; Umberto,30,0,30,0
1745139611028,CSS 202S,A01,892056,Mignozzetti; Umberto,30,0,30,0
1745139612054,DSC 197,001,956898,Eldridge; Justin Matthew,9998,0,9999,1
1745139613080,DSC 297,001,958000,Mazumdar; Arya,9999,0,9999,0
1745139614106,EAP 100,A00,905686,Staff,9774,0,9999,225
1745139615136,ECE 45,A01,892618,Staff,0,2,50,50
1745139616164,ECE 109,A01,892620,Staff,0,44,0,0
1745139617192,ECE 111,A01,892719,Staff,0,0,50,50
1745139618218,ECE 197,001,957920,Mercier; Patrick Philip,9992,0,9999,7
1745139619245,ECON 178,A01,907814,Zhu; Ying,29,0,35,6
1745139620276,EDS 115,A00,895312,Staff,42,0,45,3
1745139621308,EDS 117,A01,895337,Staff,30,0,30,0
1745139622341,EDS 125,A00,895341,Jones; Gabrielle Anastasia,43,0,45,2
1745139623368,EDS 128A,A01,895459,Fargason; Sharon Gayle,45,0,45,0
1745139624400,EDS 128B,A01,895543,Pappas; Elizabeth,45,0,45,0
1745139625431,EDS 139,A00,897203,Pappas; Elizabeth,45,0,45,0
1745139625431,EDS 139,B00,897209,Fargason; Sharon Gayle,45,0,45,0
1745139626458,EDS 201,A00,895545,Staff,44,0,45,1
1745139627484,EDS 203,A01,895581,Halter; Christopher P.,44,0,45,1
1745139628518,EDS 204R,A01,895625,Heinzman; Erica M.,45,0,45,0
1745139628518,EDS 204R,B01,895693,Halter; Christopher P.,28,0,45,17
1745139629545,EDS 206R,A00,895694,Fargason; Sharon Gayle,22,0,30,8
1745139629545,EDS 206R,B00,895695,Choi; Bailey Miyeon,21,0,30,9
1745139630576,EDS 250,A00,895697,Hemans; Patricia Ann Benitez,44,0,45,1
1745139631606,EDS 281,A00,895701,Meyerott; Theresa Ann,15,0,15,0
1745139632633,EDS 284,A00,895736,Meyerott; Theresa Ann,15,0,15,0
1745139633660,EDS 286,A00,897210,Fine; Sarah,15,0,15,0
1745139634695,EDS 289C,A01,895770,Daly; Alan J.,15,0,15,0
1745139635721,EDS 290,A00,897211,Hofstetter; Carolyn,15,0,15,0
1745139636750,LIGM 5A,A00,896162,Fischer-Grunski; Eva K,16,0,20,4
1745139637781,LIGM 5B,A00,896260,Fischer-Grunski; Eva K,19,0,20,1
1745139638812,LIGM 5C,A00,896308,Fischer-Grunski; Eva K,19,0,20,1
1745139639839,LIIT 5AS,A00,896313,Carnelos; Chiara,18,0,20,2
1745139640864,LIIT 5BS,A00,896416,Carnelos; Chiara,20,0,20,0
1745139641892,LIIT 5CS,A00,896564,Carnelos; Chiara,20,0,20,0
1745139642920,LISP 5A,A00,896588,Munoz Sanchez; Alicia,7,0,20,13
1745139643945,LISP 5B,A00,896653,Munoz Sanchez; Alicia,10,0,20,10
1745139644970,LISP 5C,A00,896655,Munoz Sanchez; Alicia,9,0,20,11
1745139645998,MAE 197,001,957918,Kleissl; Jan,9998,0,9999,1
1745139647024,MATH 2,A01,957937,Staff,34,0,35,1
1745139648056,MATH 197,001,957876,Kedlaya; Kiran S.,9996,0,9999,3
1745139649085,MCWP 40,A00,892729,Duru; Nur,16,0,20,4
1745139649085,MCWP 40,B00,893304,Montejo; Carolina,20,0,20,0
1745139650114,MCWP 40R,A00,893757,Redela; Pamela Morgan,0,3,20,20
1745139651141,MCWP 50,A00,893758,Morshed; Michael James,4,0,20,16
1745139651141,MCWP 50,B00,893761,Bartulis; Jason Michael,18,0,20,2
1745139652170,MCWP 50R,A00,893766,Compas; Sean Matthew,0,1,20,20
1745139652170,MCWP 50R,B00,893769,Carter; Jennifer A,5,0,20,15
1745139652170,MCWP 50R,C00,893771,Krone; Jarret,0,3,20,20
1745139652170,MCWP 50R,D00,893772,Miller; Elizabeth Deen,4,0,20,16
1745139652170,MCWP 50R,E00,893775,Carter; Andrea L,0,0,20,20
1745139653197,MMW 11R,A01,892721,Herbst; Matthew,22,0,30,8
1745139653197,MMW 11R,A02,892722,Herbst; Matthew,28,0,30,2
1745139654227,MMW 12R,A01,892724,Herbst; Matthew,0,5,16,16
1745139654227,MMW 12R,A02,892725,Herbst; Matthew,0,4,16,16
1745139655254,MMW 13R,A01,892727,Staff,0,29,16,16
1745139655254,MMW 13R,A02,892728,Staff,0,28,16,16
1745139656282,SIO 295LS,A00,894015,Staff,9,0,25,16
1745139657312,SIO 295S,A00,894020,Staff,9,0,25,16
1745139658343,SIOC 290S,A01,894063,Merrifield; Mark A,23,0,25,2
1745139659374,SIOC 291S,A01,894137,Gabriel; Corey John,23,0,25,2
1745139660401,SOCI 117,A01,895339,Staff,5,0,5,0
1745139661425,WES 237B,A00,894149,Staff,20,0,20,0
1745139663512,AESE 279B,A00,891859,Staff,35,0,35,0
1745139664538,AIP 197,001,891854,Staff,70,0,70,0
1745139665571,ANTH 289S,A00,891856,Gagneux; Pascal,12,0,12,0
1745139666597,BENG 196,001,957946,Engler; Adam J.,9996,0,9999,3
1745139667627,CAT 124RS,A01,956906,Staff,8,0,25,17
1745139668659,CAT 125RS,A01,922013,Staff,8,0,25,17
1745139669687,CLRE 250,A00,891860,Morris; Sheldon,9996,0,9999,3
1745139671748,CLRE 251R,A00,907817,Mehta; Ravindra L.,9995,0,9999,4
1745139672775,CLRE 252,A00,891864,Cuomo; Raphael Eduardo,9994,0,9999,5
1745139673808,CLRE 253,A00,891867,Vaida; Florin,9995,0,9999,4
1745139673808,CLRE 253,B00,907819,Staff,9999,0,9999,0
1745139674833,CLRE 259,A00,891868,Patel; Hemal,9998,0,9999,1
1745139675864,CLRE 260,A00,891872,Cuomo; Raphael Eduardo,9999,0,9999,0
1745139676895,CLRE 297,001,891888,Cuomo; Raphael Eduardo,9999,0,9999,0
1745139677928,CSS 201S,A01,892054,Mignozzetti; Umberto,30,0,30,0
1745139678961,CSS 202S,A01,892056,Mignozzetti; Umberto,30,0,30,0
1745139679994,DSC 197,001,956898,Eldridge; Justin Matthew,9998,0,9999,1
1745139681025,DSC 297,001,958000,Mazumdar; Arya,9999,0,9999,0
1745139682051,EAP 100,A00,905686,Staff,9774,0,9999,225
1745139683076,ECE 45,A01,892618,Staff,0,2,50,50
1745139684103,ECE 109,A01,892620,Staff,0,44,0,0
1745139685128,ECE 111,A01,892719,Staff,0,0,50,50
1745139686154,ECE 197,001,957920,Mercier; Patrick Philip,9992,0,9999,7
1745139687185,ECON 178,A01,907814,Zhu; Ying,29,0,35,6
1745139688215,EDS 115,A00,895312,Staff,42,0,45,3
1745139689246,EDS 117,A01,895337,Staff,30,0,30,0
1745139690274,EDS 125,A00,895341,Jones; Gabrielle Anastasia,43,0,45,2
1745139691306,EDS 128A,A01,895459,Fargason; Sharon Gayle,45,0,45,0
1745139692338,EDS 128B,A01,895543,Pappas; Elizabeth,45,0,45,0
1745139693365,EDS 139,A00,897203,Pappas; Elizabeth,45,0,45,0
1745139693365,EDS 139,B00,897209,Fargason; Sharon Gayle,45,0,45,0
1745139694392,EDS 201,A00,895545,Staff,44,0,45,1
1745139695418,EDS 203,A01,895581,Halter; Christopher P.,44,0,45,1
1745139696450,EDS 204R,A01,895625,Heinzman; Erica M.,45,0,45,0
1745139696450,EDS 204R,B01,895693,Halter; Christopher P.,28,0,45,17
1745139697481,EDS 206R,A00,895694,Fargason; Sharon Gayle,22,0,30,8
1745139697481,EDS 206R,B00,895695,Choi; Bailey Miyeon,21,0,30,9
1745139698508,EDS 250,A00,895697,Hemans; Patricia Ann Benitez,44,0,45,1
1745139699535,EDS 281,A00,895701,Meyerott; Theresa Ann,15,0,15,0
1745139700566,EDS 284,A00,895736,Meyerott; Theresa Ann,15,0,15,0
1745139701595,EDS 286,A00,897210,Fine; Sarah,15,0,15,0
1745139702623,EDS 289C,A01,895770,Daly; Alan J.,15,0,15,0
1745139703649,EDS 290,A00,897211,Hofstetter; Carolyn,15,0,15,0
1745139704679,LIGM 5A,A00,896162,Fischer-Grunski; Eva K,16,0,20,4
1745139705746,LIGM 5B,A00,896260,Fischer-Grunski; Eva K,19,0,20,1
1745139706778,LIGM 5C,A00,896308,Fischer-Grunski; Eva K,19,0,20,1
1745139707804,LIIT 5AS,A00,896313,Carnelos; Chiara,18,0,20,2
1745139708831,LIIT 5BS,A00,896416,Carnelos; Chiara,20,0,20,0
1745139709859,LIIT 5CS,A00,896564,Carnelos; Chiara,20,0,20,0
1745139710883,LISP 5A,A00,896588,Munoz Sanchez; Alicia,7,0,20,13
1745139711910,LISP 5B,A00,896653,Munoz Sanchez; Alicia,10,0,20,10
1745139712940,LISP 5C,A00,896655,Munoz Sanchez; Alicia,9,0,20,11
1745139713966,MAE 197,001,957918,Kleissl; Jan,9998,0,9999,1
1745139714994,MATH 2,A01,957937,Staff,34,0,35,1
1745139716024,MATH 197,001,957876,Kedlaya; Kiran S.,9996,0,9999,3
1745139717052,MCWP 40,A00,892729,Duru; Nur,16,0,20,4
1745139717052,MCWP 40,B00,893304,Montejo; Carolina,20,0,20,0
1745139718081,MCWP 40R,A00,893757,Redela; Pamela Morgan,0,3,20,20
1745139719109,MCWP 50,A00,893758,Morshed; Michael James,4,0,20,16
1745139719109,MCWP 50,B00,893761,Bartulis; Jason Michael,18,0,20,2
1745139720143,MCWP 50R,A00,893766,Compas; Sean Matthew,0,1,20,20
1745139720143,MCWP 50R,B00,893769,Carter; Jennifer A,5,0,20,15
1745139720143,MCWP 50R,C00,893771,Krone; Jarret,0,3,20,20
1745139720143,MCWP 50R,D00,893772,Miller; Elizabeth Deen,4,0,20,16
1745139720143,MCWP 50R,E00,893775,Carter; Andrea L,0,0,20,20
1745139721172,MMW 11R,A01,892721,Herbst; Matthew,22,0,30,8
1745139721172,MMW 11R,A02,892722,Herbst; Matthew,28,0,30,2
1745139722203,MMW 12R,A01,892724,Herbst; Matthew,0,5,16,16
1745139722203,MMW 12R,A02,892725,Herbst; Matthew,0,4,16,16
1745139723232,MMW 13R,A01,892727,Staff,0,29,16,16
1745139723232,MMW 13R,A02,892728,Staff,0,28,16,16
1745139724261,SIO 295LS,A00,894015,Staff,9,0,25,16
1745139725291,SIO 295S,A00,894020,Staff,9,0,25,16
1745139726322,SIOC 290S,A01,894063,Merrifield; Mark A,23,0,25,2
1745139727354,SIOC 291S,A01,894137,Gabriel; Corey John,23,0,25,2
1745139728386,SOCI 117,A01,895339,Staff,5,0,5,0
1745139729416,WES 237B,A00,894149,Staff,20,0,20,0
1745139731486,AESE 279B,A00,891859,Staff,35,0,35,0
1745139732511,AIP 197,001,891854,Staff,70,0,70,0
1745139733541,ANTH 289S,A00,891856,Gagneux; Pascal,12,0,12,0
1745139734574,BENG 196,001,957946,Engler; Adam J.,9996,0,9999,3
1745139735601,CAT 124RS,A01,956906,Staff,8,0,25,17
1745139736628,CAT 125RS,A01,922013,Staff,8,0,25,17
1745139737656,CLRE 250,A00,891860,Morris; Sheldon,9996,0,9999,3
1745139739710,CLRE 251R,A00,907817,Mehta; Ravindra L.,9995,0,9999,4
1745139740738,CLRE 252,A00,891864,Cuomo; Raphael Eduardo,9994,0,9999,5
1745139741769,CLRE 253,A00,891867,Vaida; Florin,9995,0,9999,4
1745139741769,CLRE 253,B00,907819,Staff,9999,0,9999,0
1745139742799,CLRE 259,A00,891868,Patel; Hemal,9998,0,9999,1
1745139743826,CLRE 260,A00,891872,Cuomo; Raphael Eduardo,9999,0,9999,0
1745139744853,CLRE 297,001,891888,Cuomo; Raphael Eduardo,9999,0,9999,0
1745139745882,CSS 201S,A01,892054,Mignozzetti; Umberto,30,0,30,0
1745139746907,CSS 202S,A01,892056,Mignozzetti; Umberto,30,0,30,0
1745139747933,DSC 197,001,956898,Eldridge; Justin Matthew,9998,0,9999,1
1745139748960,DSC 297,001,958000,Mazumdar; Arya,9999,0,9999,0
1745139749990,EAP 100,A00,905686,Staff,9774,0,9999,225
1745139751017,ECE 45,A01,892618,Staff,0,2,50,50
1745139752048,ECE 109,A01,892620,Staff,0,44,0,0
1745139753073,ECE 111,A01,892719,Staff,0,0,50,50
1745139754098,ECE 197,001,957920,Mercier; Patrick Philip,9992,0,9999,7
1745139755126,ECON 178,A01,907814,Zhu; Ying,29,0,35,6
1745139756156,EDS 115,A00,895312,Staff,42,0,45,3
1745139757181,EDS 117,A01,895337,Staff,30,0,30,0
1745139758211,EDS 125,A00,895341,Jones; Gabrielle Anastasia,43,0,45,2
1745139759237,EDS 128A,A01,895459,Fargason; Sharon Gayle,45,0,45,0
1745139760266,EDS 128B,A01,895543,Pappas; Elizabeth,45,0,45,0
1745139761298,EDS 139,A00,897203,Pappas; Elizabeth,45,0,45,0
1745139761298,EDS 139,B00,897209,Fargason; Sharon Gayle,45,0,45,0
1745139762326,EDS 201,A00,895545,Staff,44,0,45,1
1745139763354,EDS 203,A01,895581,Halter; Christopher P.,44,0,45,1
1745139764387,EDS 204R,A01,895625,Heinzman; Erica M.,45,0,45,0
1745139764387,EDS 204R,B01,895693,Halter; Christopher P.,28,0,45,17
1745139765421,EDS 206R,A00,895694,Fargason; Sharon Gayle,22,0,30,8
1745139765421,EDS 206R,B00,895695,Choi; Bailey Miyeon,21,0,30,9
1745139766477,EDS 250,A00,895697,Hemans; Patricia Ann Benitez,44,0,45,1
1745139767506,EDS 281,A00,895701,Meyerott; Theresa Ann,15,0,15,0
1745139768532,EDS 284,A00,895736,Meyerott; Theresa Ann,15,0,15,0
1745139769558,EDS 286,A00,897210,Fine; Sarah,15,0,15,0
1745139770585,EDS 289C,A01,895770,Daly; Alan J.,15,0,15,0
1745139771616,EDS 290,A00,897211,Hofstetter; Carolyn,15,0,15,0
1745139772642,LIGM 5A,A00,896162,Fischer-Grunski; Eva K,16,0,20,4
1745139773672,LIGM 5B,A00,896260,Fischer-Grunski; Eva K,19,0,20,1
1745139774703,LIGM 5C,A00,896308,Fischer-Grunski; Eva K,19,0,20,1
1745139775730,LIIT 5AS,A00,896313,Carnelos; Chiara,18,0,20,2
1745139776758,LIIT 5BS,A00,896416,Carnelos; Chiara,20,0,20,0
1745139777784,LIIT 5CS,A00,896564,Carnelos; Chiara,20,0,20,0
1745139778810,LISP 5A,A00,896588,Munoz Sanchez; Alicia,7,0,20,13
1745139779839,LISP 5B,A00,896653,Munoz Sanchez; Alicia,10,0,20,10
1745139780867,LISP 5C,A00,896655,Munoz Sanchez; Alicia,9,0,20,11
1745139781894,MAE 197,001,957918,Kleissl; Jan,9998,0,9999,1
1745139782925,MATH 2,A01,957937,Staff,34,0,35,1
1745139783957,MATH 197,001,957876,Kedlaya; Kiran S.,9996,0,9999,3
1745139784984,MCWP 40,A00,892729,Duru; Nur,16,0,20,4
1745139784984,MCWP 40,B00,893304,Montejo; Carolina,20,0,20,0
1745139786036,MCWP 40R,A00,893757,Redela; Pamela Morgan,0,3,20,20
1745139787067,MCWP 50,A00,893758,Morshed; Michael James,4,0,20,16
1745139787067,MCWP 50,B00,893761,Bartulis; Jason Michael,18,0,20,2
1745139788094,MCWP 50R,A00,893766,Compas; Sean Matthew,0,1,20,20
1745139788094,MCWP 50R,B00,893769,Carter; Jennifer A,5,0,20,15
1745139788094,MCWP 50R,C00,893771,Krone; Jarret,0,3,20,20
1745139788094,MCWP 50R,D00,893772,Miller; Elizabeth Deen,4,0,20,16
1745139788094,MCWP 50R,E00,893775,Carter; Andrea L,0,0,20,20
1745139789121,MMW 11R,A01,892721,Herbst; Matthew,22,0,30,8
1745139789121,MMW 11R,A02,892722,Herbst; Matthew,28,0,30,2
1745139790146,MMW 12R,A01,892724,Herbst; Matthew,0,5,16,16
1745139790146,MMW 12R,A02,892725,Herbst; Matthew,0,4,16,16
1745139791172,MMW 13R,A01,892727,Staff,0,29,16,16
1745139791172,MMW 13R,A02,892728,Staff,0,28,16,16
1745139792201,SIO 295LS,A00,894015,Staff,9,0,25,16
1745139793229,SIO 295S,A00,894020,Staff,9,0,25,16
1745139794256,SIOC 290S,A01,894063,Merrifield; Mark A,23,0,25,2
1745139795281,SIOC 291S,A01,894137,Gabriel; Corey John,23,0,25,2
1745139796308,SOCI 117,A01,895339,Staff,5,0,5,0
1745139797334,WES 237B,A00,894149,Staff,20,0,20,0
1745139799421,AESE 279B,A00,891859,Staff,35,0,35,0
1745139800450,AIP 197,001,891854,Staff,70,0,70,0
1745139801477,ANTH 289S,A00,891856,Gagneux; Pascal,12,0,12,0
1745139802505,BENG 196,001,957946,Engler; Adam J.,9996,0,9999,3
1745139803533,CAT 124RS,A01,956906,Staff,8,0,25,17
1745139804561,CAT 125RS,A01,922013,Staff,8,0,25,17
1745139805587,CLRE 250,A00,891860,Morris; Sheldon,9996,0,9999,3
1745139807639,CLRE 251R,A00,907817,Mehta; Ravindra L.,9995,0,9999,4
1745139808666,CLRE 252,A00,891864,Cuomo; Raphael Eduardo,9994,0,9999,5
1745139809703,CLRE 253,A00,891867,Vaida; Florin,9995,0,9999,4
1745139809703,CLRE 253,B00,907819,Staff,9999,0,9999,0
1745139810729,CLRE 259,A00,891868,Patel; Hemal,9998,0,9999,1
1745139811758,CLRE 260,A00,891872,Cuomo; Raphael Eduardo,9999,0,9999,0
1745139812788,CLRE 297,001,891888,Cuomo; Raphael Eduardo,9999,0,9999,0
1745139813821,CSS 201S,A01,892054,Mignozzetti; Umberto,30,0,30,0
1745139814852,CSS 202S,A01,892056,Mignozzetti; Umberto,30,0,30,0
1745139815878,DSC 197,001,956898,Eldridge; Justin Matthew,9998,0,9999,1
1745139816909,DSC 297,001,958000,Mazumdar; Arya,9999,0,9999,0
1745139817938,EAP 100,A00,905686,Staff,9774,0,9999,225
1745139818971,ECE 45,A01,892618,Staff,0,2,50,50
1745139819998,ECE 109,A01,892620,Staff,0,44,0,0
1745139821029,ECE 111,A01,892719,Staff,0,0,50,50
1745139822055,ECE 197,001,957920,Mercier; Patrick Philip,9992,0,9999,7
1745139823086,ECON 178,A01,907814,Zhu; Ying,29,0,35,6
1745139824113,EDS 115,A00,895312,Staff,42,0,45,3
1745139825140,EDS 117,A01,895337,Staff,30,0,30,0
1745139826172,EDS 125,A00,895341,Jones; Gabrielle Anastasia,43,0,45,2
1745139827197,EDS 128A,A01,895459,Fargason; Sharon Gayle,45,0,45,0
1745139828224,EDS 128B,A01,895543,Pappas; Elizabeth,45,0,45,0
1745139829250,EDS 139,A00,897203,Pappas; Elizabeth,45,0,45,0
1745139829250,EDS 139,B00,897209,Fargason; Sharon Gayle,45,0,45,0
1745139830276,EDS 201,A00,895545,Staff,44,0,45,1
1745139831302,EDS 203,A01,895581,Halter; Christopher P.,44,0,45,1
1745139832336,EDS 204R,A01,895625,Heinzman; Erica M.,45,0,45,0
1745139832336,EDS 204R,B01,895693,Halter; Christopher P.,28,0,45,17
1745139833362,EDS 206R,A00,895694,Fargason; Sharon Gayle,22,0,30,8
1745139833362,EDS 206R,B00,895695,Choi; Bailey Miyeon,21,0,30,9
1745139834389,EDS 250,A00,895697,Hemans; Patricia Ann Benitez,44,0,45,1
1745139835415,EDS 281,A00,895701,Meyerott; Theresa Ann,15,0,15,0
1745139836443,EDS 284,A00,895736,Meyerott; Theresa Ann,15,0,15,0
1745139837473,EDS 286,A00,897210,Fine; Sarah,15,0,15,0
1745139838501,EDS 289C,A01,895770,Daly; Alan J.,15,0,15,0
1745139839527,EDS 290,A00,897211,Hofstetter; Carolyn,15,0,15,0
1745139840555,LIGM 5A,A00,896162,Fischer-Grunski; Eva K,16,0,20,4
1745139841582,LIGM 5B,A00,896260,Fischer-Grunski; Eva K,19,0,20,1
1745139842607,LIGM 5C,A00,896308,Fischer-Grunski; Eva K,19,0,20,1
1745139843638,LIIT 5AS,A00,896313,Carnelos; Chiara,18,0,20,2
1745139844673,LIIT 5BS,A00,896416,Carnelos; Chiara,20,0,20,0
1745139845704,LIIT 5CS,A00,896564,Carnelos; Chiara,20,0,20,0
1745139846731,LISP 5A,A00,896588,Munoz Sanchez; Alicia,7,0,20,13
1745139847757,LISP 5B,A00,896653,Munoz Sanchez; Alicia,10,0,20,10
1745139848782,LISP 5C,A00,896655,Munoz Sanchez; Alicia,9,0,20,11
1745139849813,MAE 197,001,957918,Kleissl; Jan,9998,0,9999,1
1745139850844,MATH 2,A01,957937,Staff,34,0,35,1
1745139851873,MATH 197,001,957876,Kedlaya; Kiran S.,9996,0,9999,3
1745139852904,MCWP 40,A00,892729,Duru; Nur,16,0,20,4
1745139852904,MCWP 40,B00,893304,Montejo; Carolina,20,0,20,0
1745139853934,MCWP 40R,A00,893757,Redela; Pamela Morgan,0,3,20,20
1745139854965,MCWP 50,A00,893758,Morshed; Michael James,4,0,20,16
1745139854965,MCWP 50,B00,893761,Bartulis; Jason Michael,18,0,20,2
1745139855996,MCWP 50R,A00,893766,Compas; Sean Matthew,0,1,20,20
1745139855996,MCWP 50R,B00,893769,Carter; Jennifer A,5,0,20,15
1745139855996,MCWP 50R,C00,893771,Krone; Jarret,0,3,20,20
1745139855996,MCWP 50R,D00,893772,Miller; Elizabeth Deen,4,0,20,16
1745139855996,MCWP 50R,E00,893775,Carter; Andrea L,0,0,20,20
1745139857023,MMW 11R,A01,892721,Herbst; Matthew,22,0,30,8
1745139857023,MMW 11R,A02,892722,Herbst; Matthew,28,0,30,2
1745139858048,MMW 12R,A01,892724,Herbst; Matthew,0,5,16,16
1745139858048,MMW 12R,A02,892725,Herbst; Matthew,0,4,16,16
1745139859073,MMW 13R,A01,892727,Staff,0,29,16,16
1745139859073,MMW 13R,A02,892728,Staff,0,28,16,16
1745139860100,SIO 295LS,A00,894015,Staff,9,0,25,16
1745139861128,SIO 295S,A00,894020,Staff,9,0,25,16
1745139862161,SIOC 290S,A01,894063,Merrifield; Mark A,23,0,25,2
1745139863190,SIOC 291S,A01,894137,Gabriel; Corey John,23,0,25,2
1745139864216,SOCI 117,A01,895339,Staff,5,0,5,0
1745139865243,WES 237B,A00,894149,Staff,20,0,20,0
1745139867314,AESE 279B,A00,891859,Staff,35,0,35,0
1745139868338,AIP 197,001,891854,Staff,70,0,70,0
1745139869362,ANTH 289S,A00,891856,Gagneux; Pascal,12,0,12,0
1745139870390,BENG 196,001,957946,Engler; Adam J.,9996,0,9999,3
1745139871415,CAT 124RS,A01,956906,Staff,8,0,25,17
1745139872442,CAT 125RS,A01,922013,Staff,8,0,25,17
1745139873470,CLRE 250,A00,891860,Morris; Sheldon,9996,0,9999,3
1745139875528,CLRE 251R,A00,907817,Mehta; Ravindra L.,9995,0,9999,4
1745139876558,CLRE 252,A00,891864,Cuomo; Raphael Eduardo,9994,0,9999,5
1745139877588,CLRE 253,A00,891867,Vaida; Florin,9995,0,9999,4
1745139877588,CLRE 253,B00,907819,Staff,9999,0,9999,0
1745139878616,CLRE 259,A00,891868,Patel; Hemal,9998,0,9999,1
1745139879642,CLRE 260,A00,891872,Cuomo; Raphael Eduardo,9999,0,9999,0
1745139880725,CLRE 297,001,891888,Cuomo; Raphael Eduardo,9999,0,9999,0
1745139881752,CSS 201S,A01,892054,Mignozzetti; Umberto,30,0,30,0
1745139882783,CSS 202S,A01,892056,Mignozzetti; Umberto,30,0,30,0
1745139883810,DSC 197,001,956898,Eldridge; Justin Matthew,9998,0,9999,1
1745139884837,DSC 297,001,958000,Mazumdar; Arya,9999,0,9999,0
1745139885865,EAP 100,A00,905686,Staff,9774,0,9999,225
1745139886896,ECE 45,A01,892618,Staff,0,2,50,50
1745139887924,ECE 109,A01,892620,Staff,0,44,0,0
1745139888951,ECE 111,A01,892719,Staff,0,0,50,50
1745139889978,ECE 197,001,957920,Mercier; Patrick Philip,9992,0,9999,7
1745139891004,ECON 178,A01,907814,Zhu; Ying,29,0,35,6
1745139892034,EDS 115,A00,895312,Staff,42,0,45,3
1745139893062,EDS 117,A01,895337,Staff,30,0,30,0
1745139894086,EDS 125,A00,895341,Jones; Gabrielle Anastasia,43,0,45,2
1745139895112,EDS 128A,A01,895459,Fargason; Sharon Gayle,45,0,45,0
1745139896142,EDS 128B,A01,895543,Pappas; Elizabeth,45,0,45,0
1745139897170,EDS 139,A00,897203,Pappas; Elizabeth,45,0,45,0
1745139897170,EDS 139,B00,897209,Fargason; Sharon Gayle,45,0,45,0
1745139898198,EDS 201,A00,895545,Staff,44,0,45,1
1745139899224,EDS 203,A01,895581,Halter; Christopher P.,44,0,45,1
1745139900250,EDS 204R,A01,895625,Heinzman; Erica M.,45,0,45,0
1745139900250,EDS 204R,B01,895693,Halter; Christopher P.,28,0,45,17
1745139901277,EDS 206R,A00,895694,Fargason; Sharon Gayle,22,0,30,8
1745139901277,EDS 206R,B00,895695,Choi; Bailey Miyeon,21,0,30,9
1745139902308,EDS 250,A00,895697,Hemans; Patricia Ann Benitez,44,0,45,1
1745139903339,EDS 281,A00,895701,Meyerott; Theresa Ann,15,0,15,0
1745139904366,EDS 284,A00,895736,Meyerott; Theresa Ann,15,0,15,0
1745139905397,EDS 286,A00,897210,Fine; Sarah,15,0,15,0
1745139906429,EDS 289C,A01,895770,Daly; Alan J.,15,0,15,0
1745139907460,EDS 290,A00,897211,Hofstetter; Carolyn,15,0,15,0
1745139908530,LIGM 5A,A00,896162,Fischer-Grunski; Eva K,16,0,20,4
1745139909557,LIGM 5B,A00,896260,Fischer-Grunski; Eva K,19,0,20,1
1745139910586,LIGM 5C,A00,896308,Fischer-Grunski; Eva K,19,0,20,1
1745139911612,LIIT 5AS,A00,896313,Carnelos; Chiara,18,0,20,2
1745139912645,LIIT 5BS,A00,896416,Carnelos; Chiara,20,0,20,0
1745139913675,LIIT 5CS,A00,896564,Carnelos; Chiara,20,0,20,0
1745139914709,LISP 5A,A00,896588,Munoz Sanchez; Alicia,7,0,20,13
1745139915741,LISP 5B,A00,896653,Munoz Sanchez; Alicia,10,0,20,10
1745139916768,LISP 5C,A00,896655,Munoz Sanchez; Alicia,9,0,20,11
1745139917800,MAE 197,001,957918,Kleissl; Jan,9998,0,9999,1
1745139918827,MATH 2,A01,957937,Staff,34,0,35,1
1745139919858,MATH 197,001,957876,Kedlaya; Kiran S.,9996,0,9999,3
1745139920891,MCWP 40,A00,892729,Duru; Nur,16,0,20,4
1745139920891,MCWP 40,B00,893304,Montejo; Carolina,20,0,20,0
1745139921919,MCWP 40R,A00,893757,Redela; Pamela Morgan,0,3,20,20
1745139922947,MCWP 50,A00,893758,Morshed; Michael James,4,0,20,16
1745139922947,MCWP 50,B00,893761,Bartulis; Jason Michael,18,0,20,2
1745139923975,MCWP 50R,A00,893766,Compas; Sean Matthew,0,1,20,20
1745139923975,MCWP 50R,B00,893769,Carter; Jennifer A,5,0,20,15
1745139923975,MCWP 50R,C00,893771,Krone; Jarret,0,3,20,20
1745139923975,MCWP 50R,D00,893772,Miller; Elizabeth Deen,4,0,20,16
1745139923975,MCWP 50R,E00,893775,Carter; Andrea L,0,0,20,20
1745139925009,MMW 11R,A01,892721,Herbst; Matthew,22,0,30,8
1745139925009,MMW 11R,A02,892722,Herbst; Matthew,28,0,30,2
1745139926040,MMW 12R,A01,892724,Herbst; Matthew,0,5,16,16
1745139926040,MMW 12R,A02,892725,Herbst; Matthew,0,4,16,16
1745139927064,MMW 13R,A01,892727,Staff,0,29,16,16
1745139927064,MMW 13R,A02,892728,Staff,0,28,16,16
1745139928092,SIO 295LS,A00,894015,Staff,9,0,25,16
1745139929117,SIO 295S,A00,894020,Staff,9,0,25,16
1745139930143,SIOC 290S,A01,894063,Merrifield; Mark A,23,0,25,2
1745139931171,SIOC 291S,A01,894137,Gabriel; Corey John,23,0,25,2
1745139932202,SOCI 117,A01,895339,Staff,5,0,5,0
1745139933231,WES 237B,A00,894149,Staff,20,0,20,0
1745139935325,AESE 279B,A00,891859,Staff,35,0,35,0
1745139936354,AIP 197,001,891854,Staff,70,0,70,0
1745139937382,ANTH 289S,A00,891856,Gagneux; Pascal,12,0,12,0
1745139938413,BENG 196,001,957946,Engler; Adam J.,9996,0,9999,3
1745139939439,CAT 124RS,A01,956906,Staff,8,0,25,17
1745139940464,CAT 125RS,A01,922013,Staff,8,0,25,17
1745139941492,CLRE 250,A00,891860,Morris; Sheldon,9996,0,9999,3
1745139943548,CLRE 251R,A00,907817,Mehta; Ravindra L.,9995,0,9999,4
1745139944573,CLRE 252,A00,891864,Cuomo; Raphael Eduardo,9994,0,9999,5
1745139945604,CLRE 253,A00,891867,Vaida; Florin,9995,0,9999,4
1745139945604,CLRE 253,B00,907819,Staff,9999,0,9999,0
1745139946630,CLRE 259,A00,891868,Patel; Hemal,9998,0,9999,1
1745139947659,CLRE 260,A00,891872,Cuomo; Raphael Eduardo,9999,0,9999,0
1745139948685,CLRE 297,001,891888,Cuomo; Raphael Eduardo,9999,0,9999,0
1745139949750,CSS 201S,A01,892054,Mignozzetti; Umberto,30,0,30,0
1745139950781,CSS 202S,A01,892056,Mignozzetti; Umberto,30,0,30,0
1745139951808,DSC 197,001,956898,Eldridge; Justin Matthew,9998,0,9999,1
1745139952838,DSC 297,001,958000,Mazumdar; Arya,9999,0,9999,0
1745139953864,EAP 100,A00,905686,Staff,9774,0,9999,225
1745139954897,ECE 45,A01,892618,Staff,0,2,50,50
1745139955924,ECE 109,A01,892620,Staff,0,44,0,0
1745139956950,ECE 111,A01,892719,Staff,0,0,50,50
1745139957976,ECE 197,001,957920,Mercier; Patrick Philip,9992,0,9999,7
1745139959004,ECON 178,A01,907814,Zhu; Ying,29,0,35,6
1745139960038,EDS 115,A00,895312,Staff,42,0,45,3
1745139961069,EDS 117,A01,895337,Staff,30,0,30,0
1745139962100,EDS 125,A00,895341,Jones; Gabrielle Anastasia,43,0,45,2
1745139963129,EDS 128A,A01,895459,Fargason; Sharon Gayle,45,0,45,0
1745139964161,EDS 128B,A01,895543,Pappas; Elizabeth,45,0,45,0
1745139965187,EDS 139,A00,897203,Pappas; Elizabeth,45,0,45,0
1745139965187,EDS 139,B00,897209,Fargason; Sharon Gayle,45,0,45,0
1745139966217,EDS 201,A00,895545,Staff,44,0,45,1
1745139967243,EDS 203,A01,895581,Halter; Christopher P.,44,0,45,1
1745139968273,EDS 204R,A01,895625,Heinzman; Erica M.,45,0,45,0
1745139968273,EDS 204R,B01,895693,Halter; Christopher P.,28,0,45,17
1745139969300,EDS 206R,A00,895694,Fargason; Sharon Gayle,22,0,30,8
1745139969300,EDS 206R,B00,895695,Choi; Bailey Miyeon,21,0,30,9
1745139970325,EDS 250,A00,895697,Hemans; Patricia Ann Benitez,44,0,45,1
1745139971350,EDS 281,A00,895701,Meyerott; Theresa Ann,15,0,15,0
1745139972390,EDS 284,A00,895736,Meyerott; Theresa Ann,15,0,15,0
1745139973420,EDS 286,A00,897210,Fine; Sarah,15,0,15,0
1745139974451,EDS 289C,A01,895770,Daly; Alan J.,15,0,15,0
1745139975477,EDS 290,A00,897211,Hofstetter; Carolyn,15,0,15,0
1745139976509,LIGM 5A,A00,896162,Fischer-Grunski; Eva K,16,0,20,4
1745139977535,LIGM 5B,A00,896260,Fischer-Grunski; Eva K,19,0,20,1
1745139978564,LIGM 5C,A00,896308,Fischer-Grunski; Eva K,19,0,20,1
1745139979591,LIIT 5AS,A00,896313,Carnelos; Chiara,18,0,20,2
1745139980622,LIIT 5BS,A00,896416,Carnelos; Chiara,20,0,20,0
1745139981652,LIIT 5CS,A00,896564,Carnelos; Chiara,20,0,20,0
1745139982677,LISP 5A,A00,896588,Munoz Sanchez; Alicia,7,0,20,13
1745139983703,LISP 5B,A00,896653,Munoz Sanchez; Alicia,10,0,20,10
1745139984732,LISP 5C,A00,896655,Munoz Sanchez; Alicia,9,0,20,11
1745139985762,MAE 197,001,957918,Kleissl; Jan,9998,0,9999,1
1745139986792,MATH 2,A01,957937,Staff,34,0,35,1
1745139987818,MATH 197,001,957876,Kedlaya; Kiran S.,9996,0,9999,3
1745139988846,MCWP 40,A00,892729,Duru; Nur,16,0,20,4
1745139988846,MCWP 40,B00,893304,Montejo; Carolina,20,0,20,0
1745139989871,MCWP 40R,A00,893757,Redela; Pamela Morgan,0,3,20,20
1745139990899,MCWP 50,A00,893758,Morshed; Michael James,4,0,20,16
1745139990899,MCWP 50,B00,893761,Bartulis; Jason Michael,18,0,20,2
1745139991932,MCWP 50R,A00,893766,Compas; Sean Matthew,0,1,20,20
1745139991932,MCWP 50R,B00,893769,Carter; Jennifer A,5,0,20,15
1745139991932,MCWP 50R,C00,893771,Krone; Jarret,0,3,20,20
1745139991932,MCWP 50R,D00,893772,Miller; Elizabeth Deen,4,0,20,16
1745139991932,MCWP 50R,E00,893775,Carter; Andrea L,0,0,20,20
1745139992962,MMW 11R,A01,892721,Herbst; Matthew,22,0,30,8
1745139992962,MMW 11R,A02,892722,Herbst; Matthew,28,0,30,2
1745139993992,MMW 12R,A01,892724,Herbst; Matthew,0,5,16,16
1745139993992,MMW 12R,A02,892725,Herbst; Matthew,0,4,16,16
1745139995019,MMW 13R,A01,892727,Staff,0,29,16,16
1745139995019,MMW 13R,A02,892728,Staff,0,28,16,16
1745139996063,SIO 295LS,A00,894015,Staff,9,0,25,16
1745139997091,SIO 295S,A00,894020,Staff,9,0,25,16
1745139998116,SIOC 290S,A01,894063,Merrifield; Mark A,23,0,25,2
1745139999142,SIOC 291S,A01,894137,Gabriel; Corey John,23,0,25,2
1745140000168,SOCI 117,A01,895339,Staff,5,0,5,0
1745140001196,WES 237B,A00,894149,Staff,20,0,20,0
1745140008352,AESE 279B,A00,891859,Staff,35,0,35,0
1745140009377,AIP 197,001,891854,Staff,70,0,70,0
1745140010404,ANTH 289S,A00,891856,Gagneux; Pascal,12,0,12,0
1745140011431,BENG 196,001,957946,Engler; Adam J.,9996,0,9999,3
1745140012455,CAT 124RS,A01,956906,Staff,8,0,25,17
1745140013482,CAT 125RS,A01,922013,Staff,8,0,25,17
1745140014509,CLRE 250,A00,891860,Morris; Sheldon,9996,0,9999,3
1745140016564,CLRE 251R,A00,907817,Mehta; Ravindra L.,9995,0,9999,4
1745140017589,CLRE 252,A00,891864,Cuomo; Raphael Eduardo,9994,0,9999,5
1745140018615,CLRE 253,A00,891867,Vaida; Florin,9995,0,9999,4
1745140018615,CLRE 253,B00,907819,Staff,9999,0,9999,0
1745140019644,CLRE 259,A00,891868,Patel; Hemal,9998,0,9999,1
1745140020669,CLRE 260,A00,891872,Cuomo; Raphael Eduardo,9999,0,9999,0
1745140021699,CLRE 297,001,891888,Cuomo; Raphael Eduardo,9999,0,9999,0
1745140022725,CSS 201S,A01,892054,Mignozzetti; Umberto,30,0,30,0
1745140023750,CSS 202S,A01,892056,Mignozzetti; Umberto,30,0,30,0
1745140024781,DSC 197,001,956898,Eldridge; Justin Matthew,9998,0,9999,1
1745140025808,DSC 297,001,958000,Mazumdar; Arya,9999,0,9999,0
1745140026834,EAP 100,A00,905686,Staff,9774,0,9999,225
1745140027866,ECE 45,A01,892618,Staff,0,2,50,50
1745140028891,ECE 109,A01,892620,Staff,0,44,0,0
1745140029915,ECE 111,A01,892719,Staff,0,0,50,50
1745140030941,ECE 197,001,957920,Mercier; Patrick Philip,9992,0,9999,7
1745140031970,ECON 178,A01,907814,Zhu; Ying,29,0,35,6
1745140032996,EDS 115,A00,895312,Staff,42,0,45,3
1745140034227,EDS 117,A01,895337,Staff,30,0,30,0
1745140035253,EDS 125,A00,895341,Jones; Gabrielle Anastasia,43,0,45,2
1745140036282,EDS 128A,A01,895459,Fargason; Sharon Gayle,45,0,45,0
1745140037306,EDS 128B,A01,895543,Pappas; Elizabeth,45,0,45,0
1745140038332,EDS 139,A00,897203,Pappas; Elizabeth,45,0,45,0
1745140038332,EDS 139,B00,897209,Fargason; Sharon Gayle,45,0,45,0
1745140039362,EDS 201,A00,895545,Staff,44,0,45,1
1745140040391,EDS 203,A01,895581,Halter; Christopher P.,44,0,45,1
1745140041423,EDS 204R,A01,895625,Heinzman; Erica M.,45,0,45,0
1745140041423,EDS 204R,B01,895693,Halter; Christopher P.,28,0,45,17
1745140042449,EDS 206R,A00,895694,Fargason; Sharon Gayle,22,0,30,8
1745140042449,EDS 206R,B00,895695,Choi; Bailey Miyeon,21,0,30,9
1745140043477,EDS 250,A00,895697,Hemans; Patricia Ann Benitez,44,0,45,1
1745140044502,EDS 281,A00,895701,Meyerott; Theresa Ann,15,0,15,0
1745140045533,EDS 284,A00,895736,Meyerott; Theresa Ann,15,0,15,0
1745140046565,EDS 286,A00,897210,Fine; Sarah,15,0,15,0
1745140047592,EDS 289C,A01,895770,Daly; Alan J.,15,0,15,0
1745140048619,EDS 290,A00,897211,Hofstetter; Carolyn,15,0,15,0
1745140049653,LIGM 5A,A00,896162,Fischer-Grunski; Eva K,16,0,20,4
1745140050680,LIGM 5B,A00,896260,Fischer-Grunski; Eva K,19,0,20,1
1745140051705,LIGM 5C,A00,896308,Fischer-Grunski; Eva K,19,0,20,1
1745140052731,LIIT 5AS,A00,896313,Carnelos; Chiara,18,0,20,2
1745140053764,LIIT 5BS,A00,896416,Carnelos; Chiara,20,0,20,0
1745140054845,LIIT 5CS,A00,896564,Carnelos; Chiara,20,0,20,0
1745140055872,LISP 5A,A00,896588,Munoz Sanchez; Alicia,7,0,20,13
1745140056904,LISP 5B,A00,896653,Munoz Sanchez; Alicia,10,0,20,10
1745140057930,LISP 5C,A00,896655,Munoz Sanchez; Alicia,9,0,20,11
1745140058956,MAE 197,001,957918,Kleissl; Jan,9998,0,9999,1
1745140059981,MATH 2,A01,957937,Staff,34,0,35,1
1745140061012,MATH 197,001,957876,Kedlaya; Kiran S.,9996,0,9999,3
1745140062039,MCWP 40,A00,892729,Duru; Nur,16,0,20,4
1745140062039,MCWP 40,B00,893304,Montejo; Carolina,20,0,20,0
1745140063068,MCWP 40R,A00,893757,Redela; Pamela Morgan,0,3,20,20
1745140064095,MCWP 50,A00,893758,Morshed; Michael James,4,0,20,16
1745140064095,MCWP 50,B00,893761,Bartulis; Jason Michael,18,0,20,2
1745140065124,MCWP 50R,A00,893766,Compas; Sean Matthew,0,1,20,20
1745140065124,MCWP 50R,B00,893769,Carter; Jennifer A,5,0,20,15
1745140065124,MCWP 50R,C00,893771,Krone; Jarret,0,3,20,20
1745140065124,MCWP 50R,D00,893772,Miller; Elizabeth Deen,4,0,20,16
1745140065124,MCWP 50R,E00,893775,Carter; Andrea L,0,0,20,20
1745140066155,MMW 11R,A01,892721,Herbst; Matthew,22,0,30,8
1745140066155,MMW 11R,A02,892722,Herbst; Matthew,28,0,30,2
1745140067185,MMW 12R,A01,892724,Herbst; Matthew,0,5,16,16
1745140067185,MMW 12R,A02,892725,Herbst; Matthew,0,4,16,16
1745140068211,MMW 13R,A01,892727,Staff,0,29,16,16
1745140068211,MMW 13R,A02,892728,Staff,0,28,16,16
1745140069238,SIO 295LS,A00,894015,Staff,9,0,25,16
1745140070267,SIO 295S,A00,894020,Staff,9,0,25,16
1745140071299,SIOC 290S,A01,894063,Merrifield; Mark A,23,0,25,2
1745140072327,SIOC 291S,A01,894137,Gabriel; Corey John,23,0,25,2
1745140073357,SOCI 117,A01,895339,Staff,5,0,5,0
1745140074388,WES 237B,A00,894149,Staff,20,0,20,0
1745140076509,AESE 279B,A00,891859,Staff,35,0,35,0
1745140077541,AIP 197,001,891854,Staff,70,0,70,0
1745140078568,ANTH 289S,A00,891856,Gagneux; Pascal,12,0,12,0
1745140079595,BENG 196,001,957946,Engler; Adam J.,9996,0,9999,3
1745140080623,CAT 124RS,A01,956906,Staff,8,0,25,17
1745140081651,CAT 125RS,A01,922013,Staff,8,0,25,17
1745140082692,CLRE 250,A00,891860,Morris; Sheldon,9996,0,9999,3
1745140084750,CLRE 251R,A00,907817,Mehta; Ravindra L.,9995,0,9999,4
1745140085781,CLRE 252,A00,891864,Cuomo; Raphael Eduardo,9994,0,9999,5
1745140086810,CLRE 253,A00,891867,Vaida; Florin,9995,0,9999,4
1745140086810,CLRE 253,B00,907819,Staff,9999,0,9999,0
1745140087837,CLRE 259,A00,891868,Patel; Hemal,9998,0,9999,1
1745140088863,CLRE 260,A00,891872,Cuomo; Raphael Eduardo,9999,0,9999,0
1745140089893,CLRE 297,001,891888,Cuomo; Raphael Eduardo,9999,0,9999,0
1745140090924,CSS 201S,A01,892054,Mignozzetti; Umberto,30,0,30,0
1745140091950,CSS 202S,A01,892056,Mignozzetti; Umberto,30,0,30,0
1745140092995,DSC 197,001,956898,Eldridge; Justin Matthew,9998,0,9999,1
1745140094022,DSC 297,001,958000,Mazumdar; Arya,9999,0,9999,0
1745140095052,EAP 100,A00,905686,Staff,9774,0,9999,225
1745140096080,ECE 45,A01,892618,Staff,0,2,50,50
1745140097110,ECE 109,A01,892620,Staff,0,44,0,0
1745140098138,ECE 111,A01,892719,Staff,0,0,50,50
1745140099165,ECE 197,001,957920,Mercier; Patrick Philip,9992,0,9999,7
1745140100200,ECON 178,A01,907814,Zhu; Ying,29,0,35,6
1745140101234,EDS 115,A00,895312,Staff,42,0,45,3
1745140102262,EDS 117,A01,895337,Staff,30,0,30,0
1745140103296,EDS 125,A00,895341,Jones; Gabrielle Anastasia,43,0,45,2
1745140104324,EDS 128A,A01,895459,Fargason; Sharon Gayle,45,0,45,0
1745140105353,EDS 128B,A01,895543,Pappas; Elizabeth,45,0,45,0
1745140106381,EDS 139,A00,897203,Pappas; Elizabeth,45,0,45,0
1745140106381,EDS 139,B00,897209,Fargason; Sharon Gayle,45,0,45,0
1745140107409,EDS 201,A00,895545,Staff,44,0,45,1
1745140108441,EDS 203,A01,895581,Halter; Christopher P.,44,0,45,1
1745140109470,EDS 204R,A01,895625,Heinzman; Erica M.,45,0,45,0
1745140109470,EDS 204R,B01,895693,Halter; Christopher P.,28,0,45,17
1745140110506,EDS 206R,A00,895694,Fargason; Sharon Gayle,22,0,30,8
1745140110506,EDS 206R,B00,895695,Choi; Bailey Miyeon,21,0,30,9
1745140111534,EDS 250,A00,895697,Hemans; Patricia Ann Benitez,44,0,45,1
1745140112563,EDS 281,A00,895701,Meyerott; Theresa Ann,15,0,15,0
1745140113594,EDS 284,A00,895736,Meyerott; Theresa Ann,15,0,15,0
1745140114621,EDS 286,A00,897210,Fine; Sarah,15,0,15,0
1745140115655,EDS 289C,A01,895770,Daly; Alan J.,15,0,15,0
1745140116683,EDS 290,A00,897211,Hofstetter; Carolyn,15,0,15,0
1745140117711,LIGM 5A,A00,896162,Fischer-Grunski; Eva K,16,0,20,4
1745140118738,LIGM 5B,A00,896260,Fischer-Grunski; Eva K,19,0,20,1
1745140119765,LIGM 5C,A00,896308,Fischer-Grunski; Eva K,19,0,20,1
1745140120792,LIIT 5AS,A00,896313,Carnelos; Chiara,18,0,20,2
1745140121823,LIIT 5BS,A00,896416,Carnelos; Chiara,20,0,20,0
1745140122855,LIIT 5CS,A00,896564,Carnelos; Chiara,20,0,20,0
1745140123889,LISP 5A,A00,896588,Munoz Sanchez; Alicia,7,0,20,13
1745140124914,LISP 5B,A00,896653,Munoz Sanchez; Alicia,10,0,20,10
1745140125940,LISP 5C,A00,896655,Munoz Sanchez; Alicia,9,0,20,11
1745140126968,MAE 197,001,957918,Kleissl; Jan,9998,0,9999,1
1745140127995,MATH 2,A01,957937,Staff,34,0,35,1
1745140129027,MATH 197,001,957876,Kedlaya; Kiran S.,9996,0,9999,3
1745140130057,MCWP 40,A00,892729,Duru; Nur,16,0,20,4
1745140130057,MCWP 40,B00,893304,Montejo; Carolina,20,0,20,0
1745140131084,MCWP 40R,A00,893757,Redela; Pamela Morgan,0,3,20,20
1745140132112,MCWP 50,A00,893758,Morshed; Michael James,4,0,20,16
1745140132112,MCWP 50,B00,893761,Bartulis; Jason Michael,18,0,20,2
1745140133149,MCWP 50R,A00,893766,Compas; Sean Matthew,0,1,20,20
1745140133149,MCWP 50R,B00,893769,Carter; Jennifer A,5,0,20,15
1745140133149,MCWP 50R,C00,893771,Krone; Jarret,0,3,20,20
1745140133149,MCWP 50R,D00,893772,Miller; Elizabeth Deen,4,0,20,16
1745140133149,MCWP 50R,E00,893775,Carter; Andrea L,0,0,20,20
1745140134181,MMW 11R,A01,892721,Herbst; Matthew,22,0,30,8
1745140134181,MMW 11R,A02,892722,Herbst; Matthew,28,0,30,2
1745140135211,MMW 12R,A01,892724,Herbst; Matthew,0,5,16,16
1745140135211,MMW 12R,A02,892725,Herbst; Matthew,0,4,16,16
1745140136239,MMW 13R,A01,892727,Staff,0,29,16,16
1745140136239,MMW 13R,A02,892728,Staff,0,28,16,16
1745140137265,SIO 295LS,A00,894015,Staff,9,0,25,16
1745140138294,SIO 295S,A00,894020,Staff,9,0,25,16
1745140139322,SIOC 290S,A01,894063,Merrifield; Mark A,23,0,25,2
1745140140357,SIOC 291S,A01,894137,Gabriel; Corey John,23,0,25,2
1745140141395,SOCI 117,A01,895339,Staff,5,0,5,0
1745140142426,WES 237B,A00,894149,Staff,20,0,20,0
1745140145789,AESE 279B,A00,891859,Staff,35,0,35,0
1745140146819,AIP 197,001,891854,Staff,70,0,70,0
1745140147851,ANTH 289S,A00,891856,Gagneux; Pascal,12,0,12,0
1745140148886,BENG 196,001,957946,Engler; Adam J.,9996,0,9999,3
1745140149913,CAT 124RS,A01,956906,Staff,8,0,25,17
1745140150943,CAT 125RS,A01,922013,Staff,8,0,25,17
1745140151973,CLRE 250,A00,891860,Morris; Sheldon,9996,0,9999,3
1745140154029,CLRE 251R,A00,907817,Mehta; Ravindra L.,9995,0,9999,4
1745140155062,CLRE 252,A00,891864,Cuomo; Raphael Eduardo,9994,0,9999,5
1745140156089,CLRE 253,A00,891867,Vaida; Florin,9995,0,9999,4
1745140156089,CLRE 253,B00,907819,Staff,9999,0,9999,0
1745140157114,CLRE 259,A00,891868,Patel; Hemal,9998,0,9999,1
1745140158143,CLRE 260,A00,891872,Cuomo; Raphael Eduardo,9999,0,9999,0
1745140159174,CLRE 297,001,891888,Cuomo; Raphael Eduardo,9999,0,9999,0
1745140160247,CSS 201S,A01,892054,Mignozzetti; Umberto,30,0,30,0
1745140161275,CSS 202S,A01,892056,Mignozzetti; Umberto,30,0,30,0
1745140162303,DSC 197,001,956898,Eldridge; Justin Matthew,9998,0,9999,1
1745140163336,DSC 297,001,958000,Mazumdar; Arya,9999,0,9999,0
1745140164361,EAP 100,A00,905686,Staff,9774,0,9999,225
1745140165390,ECE 45,A01,892618,Staff,0,2,50,50
1745140166418,ECE 109,A01,892620,Staff,0,44,0,0
1745140167452,ECE 111,A01,892719,Staff,0,0,50,50
1745140168483,ECE 197,001,957920,Mercier; Patrick Philip,9992,0,9999,7
1745140169510,ECON 178,A01,907814,Zhu; Ying,29,0,35,6
1745140170541,EDS 115,A00,895312,Staff,42,0,45,3
1745140171569,EDS 117,A01,895337,Staff,30,0,30,0
1745140172597,EDS 125,A00,895341,Jones; Gabrielle Anastasia,43,0,45,2
1745140173630,EDS 128A,A01,895459,Fargason; Sharon Gayle,45,0,45,0
1745140174657,EDS 128B,A01,895543,Pappas; Elizabeth,45,0,45,0
1745140175685,EDS 139,A00,897203,Pappas; Elizabeth,45,0,45,0
1745140175685,EDS 139,B00,897209,Fargason; Sharon Gayle,45,0,45,0
1745140176710,EDS 201,A00,895545,Staff,44,0,45,1
1745140177736,EDS 203,A01,895581,Halter; Christopher P.,44,0,45,1
1745140178768,EDS 204R,A01,895625,Heinzman; Erica M.,45,0,45,0
1745140178768,EDS 204R,B01,895693,Halter; Christopher P.,28,0,45,17
1745140179800,EDS 206R,A00,895694,Fargason; Sharon Gayle,22,0,30,8
1745140179800,EDS 206R,B00,895695,Choi; Bailey Miyeon,21,0,30,9
1745140180827,EDS 250,A00,895697,Hemans; Patricia Ann Benitez,44,0,45,1
1745140181854,EDS 281,A00,895701,Meyerott; Theresa Ann,15,0,15,0
1745140182880,EDS 284,A00,895736,Meyerott; Theresa Ann,15,0,15,0
1745140183911,EDS 286,A00,897210,Fine; Sarah,15,0,15,0
1745140185148,EDS 289C,A01,895770,Daly; Alan J.,15,0,15,0
1745140186175,EDS 290,A00,897211,Hofstetter; Carolyn,15,0,15,0
1745140187209,LIGM 5A,A00,896162,Fischer-Grunski; Eva K,16,0,20,4
1745140188235,LIGM 5B,A00,896260,Fischer-Grunski; Eva K,19,0,20,1
1745140189261,LIGM 5C,A00,896308,Fischer-Grunski; Eva K,19,0,20,1
1745140190294,LIIT 5AS,A00,896313,Carnelos; Chiara,18,0,20,2
1745140191326,LIIT 5BS,A00,896416,Carnelos; Chiara,20,0,20,0
1745140192353,LIIT 5CS,A00,896564,Carnelos; Chiara,20,0,20,0
1745140193382,LISP 5A,A00,896588,Munoz Sanchez; Alicia,7,0,20,13
1745140194409,LISP 5B,A00,896653,Munoz Sanchez; Alicia,10,0,20,10
1745140195435,LISP 5C,A00,896655,Munoz Sanchez; Alicia,9,0,20,11
1745140196467,MAE 197,001,957918,Kleissl; Jan,9998,0,9999,1
1745140197493,MATH 2,A01,957937,Staff,34,0,35,1
1745140198520,MATH 197,001,957876,Kedlaya; Kiran S.,9996,0,9999,3
1745140199549,MCWP 40,A00,892729,Duru; Nur,16,0,20,4
1745140199549,MCWP 40,B00,893304,Montejo; Carolina,20,0,20,0
1745140200582,MCWP 40R,A00,893757,Redela; Pamela Morgan,0,3,20,20
1745140201610,MCWP 50,A00,893758,Morshed; Michael James,4,0,20,16
1745140201610,MCWP 50,B00,893761,Bartulis; Jason Michael,18,0,20,2
1745140202647,MCWP 50R,A00,893766,Compas; Sean Matthew,0,1,20,20
1745140202647,MCWP 50R,B00,893769,Carter; Jennifer A,5,0,20,15
1745140202647,MCWP 50R,C00,893771,Krone; Jarret,0,3,20,20
1745140202647,MCWP 50R,D00,893772,Miller; Elizabeth Deen,4,0,20,16
1745140202647,MCWP 50R,E00,893775,Carter; Andrea L,0,0,20,20
1745140203675,MMW 11R,A01,892721,Herbst; Matthew,22,0,30,8
1745140203675,MMW 11R,A02,892722,Herbst; Matthew,28,0,30,2
1745140204707,MMW 12R,A01,892724,Herbst; Matthew,0,5,16,16
1745140204707,MMW 12R,A02,892725,Herbst; Matthew,0,4,16,16
1745140205739,MMW 13R,A01,892727,Staff,0,29,16,16
1745140205739,MMW 13R,A02,892728,Staff,0,28,16,16
1745140206768,SIO 295LS,A00,894015,Staff,9,0,25,16
1745140207798,SIO 295S,A00,894020,Staff,9,0,25,16
1745140208829,SIOC 290S,A01,894063,Merrifield; Mark A,23,0,25,2
1745140209858,SIOC 291S,A01,894137,Gabriel; Corey John,23,0,25,2
1745140210891,SOCI 117,A01,895339,Staff,5,0,5,0
1745140211917,WES 237B,A00,894149,Staff,20,0,20,0
1745140214032,AESE 279B,A00,891859,Staff,35,0,35,0
1745140215058,AIP 197,001,891854,Staff,70,0,70,0
1745140216086,ANTH 289S,A00,891856,Gagneux; Pascal,12,0,12,0
1745140217113,BENG 196,001,957946,Engler; Adam J.,9996,0,9999,3
1745140218143,CAT 124RS,A01,956906,Staff,8,0,25,17
1745140219170,CAT 125RS,A01,922013,Staff,8,0,25,17
1745140220196,CLRE 250,A00,891860,Morris; Sheldon,9996,0,9999,3
1745140222251,CLRE 251R,A00,907817,Mehta; Ravindra L.,9995,0,9999,4
1745140223279,CLRE 252,A00,891864,Cuomo; Raphael Eduardo,9994,0,9999,5
1745140224307,CLRE 253,A00,891867,Vaida; Florin,9995,0,9999,4
1745140224307,CLRE 253,B00,907819,Staff,9999,0,9999,0
1745140225337,CLRE 259,A00,891868,Patel; Hemal,9998,0,9999,1
1745140226364,CLRE 260,A00,891872,Cuomo; Raphael Eduardo,9999,0,9999,0
1745140227390,CLRE 297,001,891888,Cuomo; Raphael Eduardo,9999,0,9999,0
1745140228424,CSS 201S,A01,892054,Mignozzetti; Umberto,30,0,30,0
1745140229452,CSS 202S,A01,892056,Mignozzetti; Umberto,30,0,30,0
1745140230484,DSC 197,001,956898,Eldridge; Justin Matthew,9998,0,9999,1
1745140231511,DSC 297,001,958000,Mazumdar; Arya,9999,0,9999,0
1745140232542,EAP 100,A00,905686,Staff,9774,0,9999,225
1745140233573,ECE 45,A01,892618,Staff,0,2,50,50
1745140234599,ECE 109,A01,892620,Staff,0,44,0,0
1745140235625,ECE 111,A01,892719,Staff,0,0,50,50
1745140236659,ECE 197,001,957920,Mercier; Patrick Philip,9992,0,9999,7
1745140237694,ECON 178,A01,907814,Zhu; Ying,29,0,35,6
1745140238727,EDS 115,A00,895312,Staff,42,0,45,3
1745140239761,EDS 117,A01,895337,Staff,30,0,30,0
1745140240795,EDS 125,A00,895341,Jones; Gabrielle Anastasia,43,0,45,2
1745140241828,EDS 128A,A01,895459,Fargason; Sharon Gayle,45,0,45,0
1745140242862,EDS 128B,A01,895543,Pappas; Elizabeth,45,0,45,0
1745140243894,EDS 139,A00,897203,Pappas; Elizabeth,45,0,45,0
1745140243894,EDS 139,B00,897209,Fargason; Sharon Gayle,45,0,45,0
1745140244923,EDS 201,A00,895545,Staff,44,0,45,1
1745140245951,EDS 203,A01,895581,Halter; Christopher P.,44,0,45,1
1745140246982,EDS 204R,A01,895625,Heinzman; Erica M.,45,0,45,0
1745140246982,EDS 204R,B01,895693,Halter; Christopher P.,28,0,45,17
1745140248008,EDS 206R,A00,895694,Fargason; Sharon Gayle,22,0,30,8
1745140248008,EDS 206R,B00,895695,Choi; Bailey Miyeon,21,0,30,9
1745140249034,EDS 250,A00,895697,Hemans; Patricia Ann Benitez,44,0,45,1
1745140250061,EDS 281,A00,895701,Meyerott; Theresa Ann,15,0,15,0
1745140251087,EDS 284,A00,895736,Meyerott; Theresa Ann,15,0,15,0
1745140252119,EDS 286,A00,897210,Fine; Sarah,15,0,15,0
1745140253157,EDS 289C,A01,895770,Daly; Alan J.,15,0,15,0
1745140254183,EDS 290,A00,897211,Hofstetter; Carolyn,15,0,15,0
1745140255212,LIGM 5A,A00,896162,Fischer-Grunski; Eva K,16,0,20,4
1745140256240,LIGM 5B,A00,896260,Fischer-Grunski; Eva K,19,0,20,1
1745140257284,LIGM 5C,A00,896308,Fischer-Grunski; Eva K,19,0,20,1
1745140258315,LIIT 5AS,A00,896313,Carnelos; Chiara,18,0,20,2
1745140259342,LIIT 5BS,A00,896416,Carnelos; Chiara,20,0,20,0
1745140260370,LIIT 5CS,A00,896564,Carnelos; Chiara,20,0,20,0
1745140261398,LISP 5A,A00,896588,Munoz Sanchez; Alicia,7,0,20,13
1745140262430,LISP 5B,A00,896653,Munoz Sanchez; Alicia,10,0,20,10
1745140263461,LISP 5C,A00,896655,Munoz Sanchez; Alicia,9,0,20,11
1745140264487,MAE 197,001,957918,Kleissl; Jan,9998,0,9999,1
1745140265519,MATH 2,A01,957937,Staff,34,0,35,1
1745140266548,MATH 197,001,957876,Kedlaya; Kiran S.,9996,0,9999,3
1745140267595,MCWP 40,A00,892729,Duru; Nur,16,0,20,4
1745140267595,MCWP 40,B00,893304,Montejo; Carolina,20,0,20,0
1745140268627,MCWP 40R,A00,893757,Redela; Pamela Morgan,0,3,20,20
1745140269663,MCWP 50,A00,893758,Morshed; Michael James,4,0,20,16
1745140269663,MCWP 50,B00,893761,Bartulis; Jason Michael,18,0,20,2
1745140270700,MCWP 50R,A00,893766,Compas; Sean Matthew,0,1,20,20
1745140270700,MCWP 50R,B00,893769,Carter; Jennifer A,5,0,20,15
1745140270700,MCWP 50R,C00,893771,Krone; Jarret,0,3,20,20
1745140270700,MCWP 50R,D00,893772,Miller; Elizabeth Deen,4,0,20,16
1745140270700,MCWP 50R,E00,893775,Carter; Andrea L,0,0,20,20
1745140271731,MMW 11R,A01,892721,Herbst; Matthew,22,0,30,8
1745140271731,MMW 11R,A02,892722,Herbst; Matthew,28,0,30,2
1745140272762,MMW 12R,A01,892724,Herbst; Matthew,0,5,16,16
1745140272762,MMW 12R,A02,892725,Herbst; Matthew,0,4,16,16
1745140273789,MMW 13R,A01,892727,Staff,0,29,16,16
1745140273789,MMW 13R,A02,892728,Staff,0,28,16,16
1745140274817,SIO 295LS,A00,894015,Staff,9,0,25,16
1745140275846,SIO 295S,A00,894020,Staff,9,0,25,16
1745140276920,SIOC 290S,A01,894063,Merrifield; Mark A,23,0,25,2
1745140277955,SIOC 291S,A01,894137,Gabriel; Corey John,23,0,25,2
1745140278997,SOCI 117,A01,895339,Staff,5,0,5,0
1745140280022,WES 237B,A00,894149,Staff,20,0,20,0
1745140282129,AESE 279B,A00,891859,Staff,35,0,35,0
1745140283153,AIP 197,001,891854,Staff,70,0,70,0
1745140284181,ANTH 289S,A00,891856,Gagneux; Pascal,12,0,12,0
1745140285212,BENG 196,001,957946,Engler; Adam J.,9996,0,9999,3
1745140286242,CAT 124RS,A01,956906,Staff,8,0,25,17
1745140287269,CAT 125RS,A01,922013,Staff,8,0,25,17
1745140288295,CLRE 250,A00,891860,Morris; Sheldon,9996,0,9999,3
1745140290368,CLRE 251R,A00,907817,Mehta; Ravindra L.,9995,0,9999,4
1745140291401,CLRE 252,A00,891864,Cuomo; Raphael Eduardo,9994,0,9999,5
1745140292428,CLRE 253,A00,891867,Vaida; Florin,9995,0,9999,4
1745140292428,CLRE 253,B00,907819,Staff,9999,0,9999,0
1745140293454,CLRE 259,A00,891868,Patel; Hemal,9998,0,9999,1
1745140294481,CLRE 260,A00,891872,Cuomo; Raphael Eduardo,9999,0,9999,0
1745140295514,CLRE 297,001,891888,Cuomo; Raphael Eduardo,9999,0,9999,0
1745140296542,CSS 201S,A01,892054,Mignozzetti; Umberto,30,0,30,0
1745140297568,CSS 202S,A01,892056,Mignozzetti; Umberto,30,0,30,0
1745140298600,DSC 197,001,956898,Eldridge; Justin Matthew,9998,0,9999,1
1745140299627,DSC 297,001,958000,Mazumdar; Arya,9999,0,9999,0
1745140300691,EAP 100,A00,905686,Staff,9774,0,9999,225
1745140309048,ECE 45,A01,892618,Staff,0,2,50,50
1745140310075,ECE 109,A01,892620,Staff,0,44,0,0
1745140311107,ECE 111,A01,892719,Staff,0,0,50,50
1745140312145,ECE 197,001,957920,Mercier; Patrick Philip,9992,0,9999,7
1745140313187,ECON 178,A01,907814,Zhu; Ying,29,0,35,6
1745140314220,EDS 115,A00,895312,Staff,42,0,45,3
1745140315253,EDS 117,A01,895337,Staff,30,0,30,0
1745140316285,EDS 125,A00,895341,Jones; Gabrielle Anastasia,43,0,45,2
1745140317310,EDS 128A,A01,895459,Fargason; Sharon Gayle,45,0,45,0
1745140318337,EDS 128B,A01,895543,Pappas; Elizabeth,45,0,45,0
1745140319364,EDS 139,A00,897203,Pappas; Elizabeth,45,0,45,0
1745140319364,EDS 139,B00,897209,Fargason; Sharon Gayle,45,0,45,0
1745140320390,EDS 201,A00,895545,Staff,44,0,45,1
1745140321416,EDS 203,A01,895581,Halter; Christopher P.,44,0,45,1
1745140322446,EDS 204R,A01,895625,Heinzman; Erica M.,45,0,45,0
1745140322446,EDS 204R,B01,895693,Halter; Christopher P.,28,0,45,17
1745140323473,EDS 206R,A00,895694,Fargason; Sharon Gayle,22,0,30,8
1745140323473,EDS 206R,B00,895695,Choi; Bailey Miyeon,21,0,30,9
1745140324502,EDS 250,A00,895697,Hemans; Patricia Ann Benitez,44,0,45,1
1745140325534,EDS 281,A00,895701,Meyerott; Theresa Ann,15,0,15,0
1745140326562,EDS 284,A00,895736,Meyerott; Theresa Ann,15,0,15,0
1745140327590,EDS 286,A00,897210,Fine; Sarah,15,0,15,0
1745140328618,EDS 289C,A01,895770,Daly; Alan J.,15,0,15,0
1745140329650,EDS 290,A00,897211,Hofstetter; Carolyn,15,0,15,0
1745140330685,LIGM 5A,A00,896162,Fischer-Grunski; Eva K,16,0,20,4
1745140331711,LIGM 5B,A00,896260,Fischer-Grunski; Eva K,19,0,20,1
1745140332738,LIGM 5C,A00,896308,Fischer-Grunski; Eva K,19,0,20,1
1745140333767,LIIT 5AS,A00,896313,Carnelos; Chiara,18,0,20,2
1745140334801,LIIT 5BS,A00,896416,Carnelos; Chiara,20,0,20,0
1745140335834,LIIT 5CS,A00,896564,Carnelos; Chiara,20,0,20,0
1745140336868,LISP 5A,A00,896588,Munoz Sanchez; Alicia,7,0,20,13
1745140337902,LISP 5B,A00,896653,Munoz Sanchez; Alicia,10,0,20,10
1745140338931,LISP 5C,A00,896655,Munoz Sanchez; Alicia,9,0,20,11
1745140339959,MAE 197,001,957918,Kleissl; Jan,9998,0,9999,1
1745140340986,MATH 2,A01,957937,Staff,34,0,35,1
1745140342015,MATH 197,001,957876,Kedlaya; Kiran S.,9996,0,9999,3
1745140343042,MCWP 40,A00,892729,Duru; Nur,16,0,20,4
1745140343042,MCWP 40,B00,893304,Montejo; Carolina,20,0,20,0
1745140344070,MCWP 40R,A00,893757,Redela; Pamela Morgan,0,3,20,20
1745140345099,MCWP 50,A00,893758,Morshed; Michael James,4,0,20,16
1745140345099,MCWP 50,B00,893761,Bartulis; Jason Michael,18,0,20,2
1745140346137,MCWP 50R,A00,893766,Compas; Sean Matthew,0,1,20,20
1745140346137,MCWP 50R,B00,893769,Carter; Jennifer A,5,0,20,15
1745140346137,MCWP 50R,C00,893771,Krone; Jarret,0,3,20,20
1745140346137,MCWP 50R,D00,893772,Miller; Elizabeth Deen,4,0,20,16
1745140346137,MCWP 50R,E00,893775,Carter; Andrea L,0,0,20,20
1745140347165,MMW 11R,A01,892721,Herbst; Matthew,22,0,30,8
1745140347165,MMW 11R,A02,892722,Herbst; Matthew,28,0,30,2
1745140348193,MMW 12R,A01,892724,Herbst; Matthew,0,5,16,16
1745140348193,MMW 12R,A02,892725,Herbst; Matthew,0,4,16,16
1745140349220,MMW 13R,A01,892727,Staff,0,29,16,16
1745140349220,MMW 13R,A02,892728,Staff,0,28,16,16
1745140350249,SIO 295LS,A00,894015,Staff,9,0,25,16
1745140351279,SIO 295S,A00,894020,Staff,9,0,25,16
1745140352307,SIOC 290S,A01,894063,Merrifield; Mark A,23,0,25,2
1745140353331,SIOC 291S,A01,894137,Gabriel; Corey John,23,0,25,2
1745140354356,SOCI 117,A01,895339,Staff,5,0,5,0
1745140355387,WES 237B,A00,894149,Staff,20,0,20,0
1745140357470,AESE 279B,A00,891859,Staff,35,0,35,0
1745140358499,AIP 197,001,891854,Staff,70,0,70,0
1745140359526,ANTH 289S,A00,891856,Gagneux; Pascal,12,0,12,0
1745140360554,BENG 196,001,957946,Engler; Adam J.,9996,0,9999,3
1745140361580,CAT 124RS,A01,956906,Staff,8,0,25,17
1745140362607,CAT 125RS,A01,922013,Staff,8,0,25,17
1745140363639,CLRE 250,A00,891860,Morris; Sheldon,9996,0,9999,3
1745140365692,CLRE 251R,A00,907817,Mehta; Ravindra L.,9995,0,9999,4
1745140366723,CLRE 252,A00,891864,Cuomo; Raphael Eduardo,9994,0,9999,5
1745140367750,CLRE 253,A00,891867,Vaida; Florin,9995,0,9999,4
1745140367750,CLRE 253,B00,907819,Staff,9999,0,9999,0
1745140368780,CLRE 259,A00,891868,Patel; Hemal,9998,0,9999,1
1745140369811,CLRE 260,A00,891872,Cuomo; Raphael Eduardo,9999,0,9999,0
1745140370838,CLRE 297,001,891888,Cuomo; Raphael Eduardo,9999,0,9999,0
1745140371868,CSS 201S,A01,892054,Mignozzetti; Umberto,30,0,30,0
1745140372894,CSS 202S,A01,892056,Mignozzetti; Umberto,30,0,30,0
1745140373920,DSC 197,001,956898,Eldridge; Justin Matthew,9998,0,9999,1
1745140374947,DSC 297,001,958000,Mazumdar; Arya,9999,0,9999,0
1745140375977,EAP 100,A00,905686,Staff,9774,0,9999,225
1745140377011,ECE 45,A01,892618,Staff,0,2,50,50
1745140378041,ECE 109,A01,892620,Staff,0,44,0,0
1745140379067,ECE 111,A01,892719,Staff,0,0,50,50
1745140380098,ECE 197,001,957920,Mercier; Patrick Philip,9992,0,9999,7
1745140381129,ECON 178,A01,907814,Zhu; Ying,29,0,35,6
1745140382171,EDS 115,A00,895312,Staff,42,0,45,3
1745140383202,EDS 117,A01,895337,Staff,30,0,30,0
1745140384234,EDS 125,A00,895341,Jones; Gabrielle Anastasia,43,0,45,2
1745140385265,EDS 128A,A01,895459,Fargason; Sharon Gayle,45,0,45,0
1745140386299,EDS 128B,A01,895543,Pappas; Elizabeth,45,0,45,0
1745140387327,EDS 139,A00,897203,Pappas; Elizabeth,45,0,45,0
1745140387327,EDS 139,B00,897209,Fargason; Sharon Gayle,45,0,45,0
1745140388355,EDS 201,A00,895545,Staff,44,0,45,1
1745140389384,EDS 203,A01,895581,Halter; Christopher P.,44,0,45,1
1745140390420,EDS 204R,A01,895625,Heinzman; Erica M.,45,0,45,0
1745140390420,EDS 204R,B01,895693,Halter; Christopher P.,28,0,45,17
1745140391447,EDS 206R,A00,895694,Fargason; Sharon Gayle,22,0,30,8
1745140391447,EDS 206R,B00,895695,Choi; Bailey Miyeon,21,0,30,9
1745140392476,EDS 250,A00,895697,Hemans; Patricia Ann Benitez,44,0,45,1
1745140393504,EDS 281,A00,895701,Meyerott; Theresa Ann,15,0,15,0
1745140394536,EDS 284,A00,895736,Meyerott; Theresa Ann,15,0,15,0
1745140395577,EDS 286,A00,897210,Fine; Sarah,15,0,15,0
1745140396610,EDS 289C,A01,895770,Daly; Alan J.,15,0,15,0
1745140397640,EDS 290,A00,897211,Hofstetter; Carolyn,15,0,15,0
1745140398673,LIGM 5A,A00,896162,Fischer-Grunski; Eva K,16,0,20,4
1745140399704,LIGM 5B,A00,896260,Fischer-Grunski; Eva K,19,0,20,1
1745140400735,LIGM 5C,A00,896308,Fischer-Grunski; Eva K,19,0,20,1
1745140401762,LIIT 5AS,A00,896313,Carnelos; Chiara,18,0,20,2
1745140402792,LIIT 5BS,A00,896416,Carnelos; Chiara,20,0,20,0
1745140403823,LIIT 5CS,A00,896564,Carnelos; Chiara,20,0,20,0
1745140404855,LISP 5A,A00,896588,Munoz Sanchez; Alicia,7,0,20,13
1745140405881,LISP 5B,A00,896653,Munoz Sanchez; Alicia,10,0,20,10
1745140406908,LISP 5C,A00,896655,Munoz Sanchez; Alicia,9,0,20,11
1745140407936,MAE 197,001,957918,Kleissl; Jan,9998,0,9999,1
1745140408962,MATH 2,A01,957937,Staff,34,0,35,1
1745140409987,MATH 197,001,957876,Kedlaya; Kiran S.,9996,0,9999,3
1745140411015,MCWP 40,A00,892729,Duru; Nur,16,0,20,4
1745140411015,MCWP 40,B00,893304,Montejo; Carolina,20,0,20,0
1745140412041,MCWP 40R,A00,893757,Redela; Pamela Morgan,0,3,20,20
1745140413074,MCWP 50,A00,893758,Morshed; Michael James,4,0,20,16
1745140413074,MCWP 50,B00,893761,Bartulis; Jason Michael,18,0,20,2
1745140414114,MCWP 50R,A00,893766,Compas; Sean Matthew,0,1,20,20
1745140414114,MCWP 50R,B00,893769,Carter; Jennifer A,5,0,20,15
1745140414114,MCWP 50R,C00,893771,Krone; Jarret,0,3,20,20
1745140414114,MCWP 50R,D00,893772,Miller; Elizabeth Deen,4,0,20,16
1745140414114,MCWP 50R,E00,893775,Carter; Andrea L,0,0,20,20
1745140415140,MMW 11R,A01,892721,Herbst; Matthew,22,0,30,8
1745140415140,MMW 11R,A02,892722,Herbst; Matthew,28,0,30,2
1745140416165,MMW 12R,A01,892724,Herbst; Matthew,0,5,16,16
1745140416165,MMW 12R,A02,892725,Herbst; Matthew,0,4,16,16
1745140417194,MMW 13R,A01,892727,Staff,0,29,16,16
1745140417194,MMW 13R,A02,892728,Staff,0,28,16,16
1745140418228,SIO 295LS,A00,894015,Staff,9,0,25,16
1745140419257,SIO 295S,A00,894020,Staff,9,0,25,16
1745140420286,SIOC 290S,A01,894063,Merrifield; Mark A,23,0,25,2
1745140421319,SIOC 291S,A01,894137,Gabriel; Corey John,23,0,25,2
1745140422348,SOCI 117,A01,895339,Staff,5,0,5,0
1745140423374,WES 237B,A00,894149,Staff,20,0,20,0
1745140425463,AESE 279B,A00,891859,Staff,35,0,35,0
1745140426491,AIP 197,001,891854,Staff,70,0,70,0
1745140427519,ANTH 289S,A00,891856,Gagneux; Pascal,12,0,12,0
1745140428546,BENG 196,001,957946,Engler; Adam J.,9996,0,9999,3
1745140429575,CAT 124RS,A01,956906,Staff,8,0,25,17
1745140430604,CAT 125RS,A01,922013,Staff,8,0,25,17
1745140431638,CLRE 250,A00,891860,Morris; Sheldon,9996,0,9999,3
1745140433699,CLRE 251R,A00,907817,Mehta; Ravindra L.,9995,0,9999,4
1745140434730,CLRE 252,A00,891864,Cuomo; Raphael Eduardo,9994,0,9999,5
1745140435757,CLRE 253,A00,891867,Vaida; Florin,9995,0,9999,4
1745140435757,CLRE 253,B00,907819,Staff,9999,0,9999,0
1745140436786,CLRE 259,A00,891868,Patel; Hemal,9998,0,9999,1
1745140437816,CLRE 260,A00,891872,Cuomo; Raphael Eduardo,9999,0,9999,0
1745140438842,CLRE 297,001,891888,Cuomo; Raphael Eduardo,9999,0,9999,0
1745140439878,CSS 201S,A01,892054,Mignozzetti; Umberto,30,0,30,0
1745140440907,CSS 202S,A01,892056,Mignozzetti; Umberto,30,0,30,0
1745140441934,DSC 197,001,956898,Eldridge; Justin Matthew,9998,0,9999,1
1745140442962,DSC 297,001,958000,Mazumdar; Arya,9999,0,9999,0
1745140443988,EAP 100,A00,905686,Staff,9774,0,9999,225
1745140445023,ECE 45,A01,892618,Staff,0,2,50,50
1745140446055,ECE 109,A01,892620,Staff,0,44,0,0
1745140447081,ECE 111,A01,892719,Staff,0,0,50,50
1745140448108,ECE 197,001,957920,Mercier; Patrick Philip,9992,0,9999,7
1745140449144,ECON 178,A01,907814,Zhu; Ying,29,0,35,6
1745140450179,EDS 115,A00,895312,Staff,42,0,45,3
1745140451208,EDS 117,A01,895337,Staff,30,0,30,0
1745140452243,EDS 125,A00,895341,Jones; Gabrielle Anastasia,43,0,45,2
1745140453272,EDS 128A,A01,895459,Fargason; Sharon Gayle,45,0,45,0
1745140454306,EDS 128B,A01,895543,Pappas; Elizabeth,45,0,45,0
1745140455334,EDS 139,A00,897203,Pappas; Elizabeth,45,0,45,0
1745140455334,EDS 139,B00,897209,Fargason; Sharon Gayle,45,0,45,0
1745140456364,EDS 201,A00,895545,Staff,44,0,45,1
1745140457397,EDS 203,A01,895581,Halter; Christopher P.,44,0,45,1
1745140458434,EDS 204R,A01,895625,Heinzman; Erica M.,45,0,45,0
1745140458434,EDS 204R,B01,895693,Halter; Christopher P.,28,0,45,17
1745140459470,EDS 206R,A00,895694,Fargason; Sharon Gayle,22,0,30,8
1745140459470,EDS 206R,B00,895695,Choi; Bailey Miyeon,21,0,30,9
1745140460498,EDS 250,A00,895697,Hemans; Patricia Ann Benitez,44,0,45,1
1745140461532,EDS 281,A00,895701,Meyerott; Theresa Ann,15,0,15,0
1745140462565,EDS 284,A00,895736,Meyerott; Theresa Ann,15,0,15,0
1745140463595,EDS 286,A00,897210,Fine; Sarah,15,0,15,0
1745140464626,EDS 289C,A01,895770,Daly; Alan J.,15,0,15,0
1745140465653,EDS 290,A00,897211,Hofstetter; Carolyn,15,0,15,0
1745140466691,LIGM 5A,A00,896162,Fischer-Grunski; Eva K,16,0,20,4
1745140467720,LIGM 5B,A00,896260,Fischer-Grunski; Eva K,19,0,20,1
1745140468749,LIGM 5C,A00,896308,Fischer-Grunski; Eva K,19,0,20,1
1745140469783,LIIT 5AS,A00,896313,Carnelos; Chiara,18,0,20,2
1745140470815,LIIT 5BS,A00,896416,Carnelos; Chiara,20,0,20,0
1745140471850,LIIT 5CS,A00,896564,Carnelos; Chiara,20,0,20,0
1745140472878,LISP 5A,A00,896588,Munoz Sanchez; Alicia,7,0,20,13
1745140473911,LISP 5B,A00,896653,Munoz Sanchez; Alicia,10,0,20,10
1745140474942,LISP 5C,A00,896655,Munoz Sanchez; Alicia,9,0,20,11
1745140475972,MAE 197,001,957918,Kleissl; Jan,9998,0,9999,1
1745140477002,MATH 2,A01,957937,Staff,34,0,35,1
1745140478030,MATH 197,001,957876,Kedlaya; Kiran S.,9996,0,9999,3
1745140479061,MCWP 40,A00,892729,Duru; Nur,16,0,20,4
1745140479061,MCWP 40,B00,893304,Montejo; Carolina,20,0,20,0
1745140480100,MCWP 40R,A00,893757,Redela; Pamela Morgan,0,3,20,20
1745140481134,MCWP 50,A00,893758,Morshed; Michael James,4,0,20,16
1745140481134,MCWP 50,B00,893761,Bartulis; Jason Michael,18,0,20,2
1745140482172,MCWP 50R,A00,893766,Compas; Sean Matthew,0,1,20,20
1745140482172,MCWP 50R,B00,893769,Carter; Jennifer A,5,0,20,15
1745140482172,MCWP 50R,C00,893771,Krone; Jarret,0,3,20,20
1745140482172,MCWP 50R,D00,893772,Miller; Elizabeth Deen,4,0,20,16
1745140482172,MCWP 50R,E00,893775,Carter; Andrea L,0,0,20,20
1745140483199,MMW 11R,A01,892721,Herbst; Matthew,22,0,30,8
1745140483199,MMW 11R,A02,892722,Herbst; Matthew,28,0,30,2
1745140484229,MMW 12R,A01,892724,Herbst; Matthew,0,5,16,16
1745140484229,MMW 12R,A02,892725,Herbst; Matthew,0,4,16,16
1745140485254,MMW 13R,A01,892727,Staff,0,29,16,16
1745140485254,MMW 13R,A02,892728,Staff,0,28,16,16
1745140486282,SIO 295LS,A00,894015,Staff,9,0,25,16
1745140487313,SIO 295S,A00,894020,Staff,9,0,25,16
1745140488347,SIOC 290S,A01,894063,Merrifield; Mark A,23,0,25,2
1745140489381,SIOC 291S,A01,894137,Gabriel; Corey John,23,0,25,2
1745140490411,SOCI 117,A01,895339,Staff,5,0,5,0
1745140491440,WES 237B,A00,894149,Staff,20,0,20,0
1745140493552,AESE 279B,A00,891859,Staff,35,0,35,0
1745140494582,AIP 197,001,891854,Staff,70,0,70,0
1745140495610,ANTH 289S,A00,891856,Gagneux; Pascal,12,0,12,0
1745140496639,BENG 196,001,957946,Engler; Adam J.,9996,0,9999,3
1745140497668,CAT 124RS,A01,956906,Staff,8,0,25,17
1745140498695,CAT 125RS,A01,922013,Staff,8,0,25,17
1745140499724,CLRE 250,A00,891860,Morris; Sheldon,9996,0,9999,3
1745140501787,CLRE 251R,A00,907817,Mehta; Ravindra L.,9995,0,9999,4
1745140502813,CLRE 252,A00,891864,Cuomo; Raphael Eduardo,9994,0,9999,5
1745140503841,CLRE 253,A00,891867,Vaida; Florin,9995,0,9999,4
1745140503841,CLRE 253,B00,907819,Staff,9999,0,9999,0
1745140504873,CLRE 259,A00,891868,Patel; Hemal,9998,0,9999,1
1745140505901,CLRE 260,A00,891872,Cuomo; Raphael Eduardo,9999,0,9999,0
1745140506931,CLRE 297,001,891888,Cuomo; Raphael Eduardo,9999,0,9999,0
1745140507960,CSS 201S,A01,892054,Mignozzetti; Umberto,30,0,30,0
1745140508990,CSS 202S,A01,892056,Mignozzetti; Umberto,30,0,30,0
1745140510017,DSC 197,001,956898,Eldridge; Justin Matthew,9998,0,9999,1
1745140511049,DSC 297,001,958000,Mazumdar; Arya,9999,0,9999,0
1745140512075,EAP 100,A00,905686,Staff,9774,0,9999,225
1745140513109,ECE 45,A01,892618,Staff,0,2,50,50
1745140514141,ECE 109,A01,892620,Staff,0,44,0,0
1745140515168,ECE 111,A01,892719,Staff,0,0,50,50
1745140516196,ECE 197,001,957920,Mercier; Patrick Philip,9992,0,9999,7
1745140517232,ECON 178,A01,907814,Zhu; Ying,29,0,35,6
1745140518261,EDS 115,A00,895312,Staff,42,0,45,3
1745140519289,EDS 117,A01,895337,Staff,30,0,30,0
1745140520317,EDS 125,A00,895341,Jones; Gabrielle Anastasia,43,0,45,2
1745140521345,EDS 128A,A01,895459,Fargason; Sharon Gayle,45,0,45,0
1745140522380,EDS 128B,A01,895543,Pappas; Elizabeth,45,0,45,0
1745140523406,EDS 139,A00,897203,Pappas; Elizabeth,45,0,45,0
1745140523406,EDS 139,B00,897209,Fargason; Sharon Gayle,45,0,45,0
1745140524432,EDS 201,A00,895545,Staff,44,0,45,1
1745140525461,EDS 203,A01,895581,Halter; Christopher P.,44,0,45,1
1745140526493,EDS 204R,A01,895625,Heinzman; Erica M.,45,0,45,0
1745140526493,EDS 204R,B01,895693,Halter; Christopher P.,28,0,45,17
1745140527542,EDS 206R,A00,895694,Fargason; Sharon Gayle,22,0,30,8
1745140527542,EDS 206R,B00,895695,Choi; Bailey Miyeon,21,0,30,9
1745140528576,EDS 250,A00,895697,Hemans; Patricia Ann Benitez,44,0,45,1
1745140529611,EDS 281,A00,895701,Meyerott; Theresa Ann,15,0,15,0
1745140530644,EDS 284,A00,895736,Meyerott; Theresa Ann,15,0,15,0
1745140531678,EDS 286,A00,897210,Fine; Sarah,15,0,15,0
1745140532707,EDS 289C,A01,895770,Daly; Alan J.,15,0,15,0
1745140533738,EDS 290,A00,897211,Hofstetter; Carolyn,15,0,15,0
1745140534768,LIGM 5A,A00,896162,Fischer-Grunski; Eva K,16,0,20,4
1745140535794,LIGM 5B,A00,896260,Fischer-Grunski; Eva K,19,0,20,1
1745140536828,LIGM 5C,A00,896308,Fischer-Grunski; Eva K,19,0,20,1
1745140537856,LIIT 5AS,A00,896313,Carnelos; Chiara,18,0,20,2
1745140538886,LIIT 5BS,A00,896416,Carnelos; Chiara,20,0,20,0
1745140539919,LIIT 5CS,A00,896564,Carnelos; Chiara,20,0,20,0
1745140540953,LISP 5A,A00,896588,Munoz Sanchez; Alicia,7,0,20,13
1745140541983,LISP 5B,A00,896653,Munoz Sanchez; Alicia,10,0,20,10
1745140543009,LISP 5C,A00,896655,Munoz Sanchez; Alicia,9,0,20,11
1745140544042,MAE 197,001,957918,Kleissl; Jan,9998,0,9999,1
1745140545070,MATH 2,A01,957937,Staff,34,0,35,1
1745140546100,MATH 197,001,957876,Kedlaya; Kiran S.,9996,0,9999,3
1745140547129,MCWP 40,A00,892729,Duru; Nur,16,0,20,4
1745140547129,MCWP 40,B00,893304,Montejo; Carolina,20,0,20,0
1745140548159,MCWP 40R,A00,893757,Redela; Pamela Morgan,0,3,20,20
1745140549187,MCWP 50,A00,893758,Morshed; Michael James,4,0,20,16
1745140549187,MCWP 50,B00,893761,Bartulis; Jason Michael,18,0,20,2
1745140550227,MCWP 50R,A00,893766,Compas; Sean Matthew,0,1,20,20
1745140550227,MCWP 50R,B00,893769,Carter; Jennifer A,5,0,20,15
1745140550227,MCWP 50R,C00,893771,Krone; Jarret,0,3,20,20
1745140550227,MCWP 50R,D00,893772,Miller; Elizabeth Deen,4,0,20,16
1745140550227,MCWP 50R,E00,893775,Carter; Andrea L,0,0,20,20
1745140551261,MMW 11R,A01,892721,Herbst; Matthew,22,0,30,8
1745140551261,MMW 11R,A02,892722,Herbst; Matthew,28,0,30,2
1745140552290,MMW 12R,A01,892724,Herbst; Matthew,0,5,16,16
1745140552290,MMW 12R,A02,892725,Herbst; Matthew,0,4,16,16
1745140553316,MMW 13R,A01,892727,Staff,0,29,16,16
1745140553316,MMW 13R,A02,892728,Staff,0,28,16,16
1745140554348,SIO 295LS,A00,894015,Staff,9,0,25,16
1745140555379,SIO 295S,A00,894020,Staff,9,0,25,16
1745140556406,SIOC 290S,A01,894063,Merrifield; Mark A,23,0,25,2
1745140557443,SIOC 291S,A01,894137,Gabriel; Corey John,23,0,25,2
1745140558470,SOCI 117,A01,895339,Staff,5,0,5,0
1745140559500,WES 237B,A00,894149,Staff,20,0,20,0
1745140561587,AESE 279B,A00,891859,Staff,35,0,35,0
1745140562614,AIP 197,001,891854,Staff,70,0,70,0
1745140563643,ANTH 289S,A00,891856,Gagneux; Pascal,12,0,12,0
1745140564673,BENG 196,001,957946,Engler; Adam J.,9996,0,9999,3
1745140565704,CAT 124RS,A01,956906,Staff,8,0,25,17
1745140566734,CAT 125RS,A01,922013,Staff,8,0,25,17
1745140567761,CLRE 250,A00,891860,Morris; Sheldon,9996,0,9999,3
1745140569832,CLRE 251R,A00,907817,Mehta; Ravindra L.,9995,0,9999,4
1745140570860,CLRE 252,A00,891864,Cuomo; Raphael Eduardo,9994,0,9999,5
1745140571895,CLRE 253,A00,891867,Vaida; Florin,9995,0,9999,4
1745140571895,CLRE 253,B00,907819,Staff,9999,0,9999,0
1745140572921,CLRE 259,A00,891868,Patel; Hemal,9998,0,9999,1
1745140573948,CLRE 260,A00,891872,Cuomo; Raphael Eduardo,9999,0,9999,0
1745140574975,CLRE 297,001,891888,Cuomo; Raphael Eduardo,9999,0,9999,0
1745140576004,CSS 201S,A01,892054,Mignozzetti; Umberto,30,0,30,0
1745140577031,CSS 202S,A01,892056,Mignozzetti; Umberto,30,0,30,0
1745140578063,DSC 197,001,956898,Eldridge; Justin Matthew,9998,0,9999,1
1745140579093,DSC 297,001,958000,Mazumdar; Arya,9999,0,9999,0
1745140580125,EAP 100,A00,905686,Staff,9774,0,9999,225
1745140581159,ECE 45,A01,892618,Staff,0,2,50,50
1745140582186,ECE 109,A01,892620,Staff,0,44,0,0
1745140583218,ECE 111,A01,892719,Staff,0,0,50,50
1745140584252,ECE 197,001,957920,Mercier; Patrick Philip,9992,0,9999,7
1745140585279,ECON 178,A01,907814,Zhu; Ying,29,0,35,6
1745140586308,EDS 115,A00,895312,Staff,42,0,45,3
1745140587337,EDS 117,A01,895337,Staff,30,0,30,0
1745140588368,EDS 125,A00,895341,Jones; Gabrielle Anastasia,43,0,45,2
1745140589395,EDS 128A,A01,895459,Fargason; Sharon Gayle,45,0,45,0
1745140590421,EDS 128B,A01,895543,Pappas; Elizabeth,45,0,45,0
1745140591452,EDS 139,A00,897203,Pappas; Elizabeth,45,0,45,0
1745140591452,EDS 139,B00,897209,Fargason; Sharon Gayle,45,0,45,0
1745140592481,EDS 201,A00,895545,Staff,44,0,45,1
1745140593512,EDS 203,A01,895581,Halter; Christopher P.,44,0,45,1
1745140594546,EDS 204R,A01,895625,Heinzman; Erica M.,45,0,45,0
1745140594546,EDS 204R,B01,895693,Halter; Christopher P.,28,0,45,17
1745140595574,EDS 206R,A00,895694,Fargason; Sharon Gayle,22,0,30,8
1745140595574,EDS 206R,B00,895695,Choi; Bailey Miyeon,21,0,30,9
1745140596601,EDS 250,A00,895697,Hemans; Patricia Ann Benitez,44,0,45,1
1745140597632,EDS 281,A00,895701,Meyerott; Theresa Ann,15,0,15,0
1745140598663,EDS 284,A00,895736,Meyerott; Theresa Ann,15,0,15,0
1745140599690,EDS 286,A00,897210,Fine; Sarah,15,0,15,0
1745140600715,EDS 289C,A01,895770,Daly; Alan J.,15,0,15,0
1745140601741,EDS 290,A00,897211,Hofstetter; Carolyn,15,0,15,0
1745140602770,LIGM 5A,A00,896162,Fischer-Grunski; Eva K,16,0,20,4
1745140603797,LIGM 5B,A00,896260,Fischer-Grunski; Eva K,19,0,20,1
1745140604823,LIGM 5C,A00,896308,Fischer-Grunski; Eva K,19,0,20,1
1745140605854,LIIT 5AS,A00,896313,Carnelos; Chiara,18,0,20,2
1745140606885,LIIT 5BS,A00,896416,Carnelos; Chiara,20,0,20,0
1745140607913,LIIT 5CS,A00,896564,Carnelos; Chiara,20,0,20,0
1745140608940,LISP 5A,A00,896588,Munoz Sanchez; Alicia,7,0,20,13
1745140609972,LISP 5B,A00,896653,Munoz Sanchez; Alicia,10,0,20,10
1745140611002,LISP 5C,A00,896655,Munoz Sanchez; Alicia,9,0,20,11
1745140612034,MAE 197,001,957918,Kleissl; Jan,9998,0,9999,1
1745140613064,MATH 2,A01,957937,Staff,34,0,35,1
1745140614090,MATH 197,001,957876,Kedlaya; Kiran S.,9996,0,9999,3
1745140615119,MCWP 40,A00,892729,Duru; Nur,16,0,20,4
1745140615119,MCWP 40,B00,893304,Montejo; Carolina,20,0,20,0
1745140616146,MCWP 40R,A00,893757,Redela; Pamela Morgan,0,3,20,20
1745140617180,MCWP 50,A00,893758,Morshed; Michael James,4,0,20,16
1745140617180,MCWP 50,B00,893761,Bartulis; Jason Michael,18,0,20,2
1745140618218,MCWP 50R,A00,893766,Compas; Sean Matthew,0,1,20,20
1745140618218,MCWP 50R,B00,893769,Carter; Jennifer A,5,0,20,15
1745140618218,MCWP 50R,C00,893771,Krone; Jarret,0,3,20,20
1745140618218,MCWP 50R,D00,893772,Miller; Elizabeth Deen,4,0,20,16
1745140618218,MCWP 50R,E00,893775,Carter; Andrea L,0,0,20,20
1745140619244,MMW 11R,A01,892721,Herbst; Matthew,22,0,30,8
1745140619244,MMW 11R,A02,892722,Herbst; Matthew,28,0,30,2
1745140620274,MMW 12R,A01,892724,Herbst; Matthew,0,5,16,16
1745140620274,MMW 12R,A02,892725,Herbst; Matthew,0,4,16,16
1745140621302,MMW 13R,A01,892727,Staff,0,29,16,16
1745140621302,MMW 13R,A02,892728,Staff,0,28,16,16
1745140622333,SIO 295LS,A00,894015,Staff,9,0,25,16
1745140623363,SIO 295S,A00,894020,Staff,9,0,25,16
1745140624427,SIOC 290S,A01,894063,Merrifield; Mark A,23,0,25,2
1745140625460,SIOC 291S,A01,894137,Gabriel; Corey John,23,0,25,2
1745140626491,SOCI 117,A01,895339,Staff,5,0,5,0
1745140627516,WES 237B,A00,894149,Staff,20,0,20,0
1745140629605,AESE 279B,A00,891859,Staff,35,0,35,0
1745140630630,AIP 197,001,891854,Staff,70,0,70,0
1745140631656,ANTH 289S,A00,891856,Gagneux; Pascal,12,0,12,0
1745140632685,BENG 196,001,957946,Engler; Adam J.,9996,0,9999,3
1745140633712,CAT 124RS,A01,956906,Staff,8,0,25,17
1745140634739,CAT 125RS,A01,922013,Staff,8,0,25,17
1745140635767,CLRE 250,A00,891860,Morris; Sheldon,9996,0,9999,3
1745140637822,CLRE 251R,A00,907817,Mehta; Ravindra L.,9995,0,9999,4
1745140638852,CLRE 252,A00,891864,Cuomo; Raphael Eduardo,9994,0,9999,5
1745140639878,CLRE 253,A00,891867,Vaida; Florin,9995,0,9999,4
1745140639878,CLRE 253,B00,907819,Staff,9999,0,9999,0
1745140640904,CLRE 259,A00,891868,Patel; Hemal,9998,0,9999,1
1745140641929,CLRE 260,A00,891872,Cuomo; Raphael Eduardo,9999,0,9999,0
1745140642953,CLRE 297,001,891888,Cuomo; Raphael Eduardo,9999,0,9999,0
1745140643987,CSS 201S,A01,892054,Mignozzetti; Umberto,30,0,30,0
1745140645014,CSS 202S,A01,892056,Mignozzetti; Umberto,30,0,30,0
1745140646594,DSC 197,001,956898,Eldridge; Justin Matthew,9998,0,9999,1
1745140647622,DSC 297,001,958000,Mazumdar; Arya,9999,0,9999,0
1745140648650,EAP 100,A00,905686,Staff,9774,0,9999,225
1745140649678,ECE 45,A01,892618,Staff,0,2,50,50
1745140650710,ECE 109,A01,892620,Staff,0,44,0,0
1745140651735,ECE 111,A01,892719,Staff,0,0,50,50
1745140652766,ECE 197,001,957920,Mercier; Patrick Philip,9992,0,9999,7
1745140653798,ECON 178,A01,907814,Zhu; Ying,29,0,35,6
1745140654826,EDS 115,A00,895312,Staff,42,0,45,3
1745140655852,EDS 117,A01,895337,Staff,30,0,30,0
1745140656884,EDS 125,A00,895341,Jones; Gabrielle Anastasia,43,0,45,2
1745140657918,EDS 128A,A01,895459,Fargason; Sharon Gayle,45,0,45,0
1745140658944,EDS 128B,A01,895543,Pappas; Elizabeth,45,0,45,0
1745140659975,EDS 139,A00,897203,Pappas; Elizabeth,45,0,45,0
1745140659975,EDS 139,B00,897209,Fargason; Sharon Gayle,45,0,45,0
1745140661001,EDS 201,A00,895545,Staff,44,0,45,1
1745140662028,EDS 203,A01,895581,Halter; Christopher P.,44,0,45,1
1745140663056,EDS 204R,A01,895625,Heinzman; Erica M.,45,0,45,0
1745140663056,EDS 204R,B01,895693,Halter; Christopher P.,28,0,45,17
1745140664083,EDS 206R,A00,895694,Fargason; Sharon Gayle,22,0,30,8
1745140664083,EDS 206R,B00,895695,Choi; Bailey Miyeon,21,0,30,9
1745140665109,EDS 250,A00,895697,Hemans; Patricia Ann Benitez,44,0,45,1
1745140666137,EDS 281,A00,895701,Meyerott; Theresa Ann,15,0,15,0
1745140667166,EDS 284,A00,895736,Meyerott; Theresa Ann,15,0,15,0
1745140668198,EDS 286,A00,897210,Fine; Sarah,15,0,15,0
1745140669228,EDS 289C,A01,895770,Daly; Alan J.,15,0,15,0
1745140670260,EDS 290,A00,897211,Hofstetter; Carolyn,15,0,15,0
1745140671297,LIGM 5A,A00,896162,Fischer-Grunski; Eva K,16,0,20,4
1745140672336,LIGM 5B,A00,896260,Fischer-Grunski; Eva K,19,0,20,1
1745140673363,LIGM 5C,A00,896308,Fischer-Grunski; Eva K,19,0,20,1
1745140674395,LIIT 5AS,A00,896313,Carnelos; Chiara,18,0,20,2
1745140675427,LIIT 5BS,A00,896416,Carnelos; Chiara,20,0,20,0
1745140676453,LIIT 5CS,A00,896564,Carnelos; Chiara,20,0,20,0
1745140677480,LISP 5A,A00,896588,Munoz Sanchez; Alicia,7,0,20,13
1745140678507,LISP 5B,A00,896653,Munoz Sanchez; Alicia,10,0,20,10
1745140679533,LISP 5C,A00,896655,Munoz Sanchez; Alicia,9,0,20,11
1745140680560,MAE 197,001,957918,Kleissl; Jan,9998,0,9999,1
1745140681588,MATH 2,A01,957937,Staff,34,0,35,1
1745140682620,MATH 197,001,957876,Kedlaya; Kiran S.,9996,0,9999,3
1745140683648,MCWP 40,A00,892729,Duru; Nur,16,0,20,4
1745140683648,MCWP 40,B00,893304,Montejo; Carolina,20,0,20,0
1745140684683,MCWP 40R,A00,893757,Redela; Pamela Morgan,0,3,20,20
1745140685713,MCWP 50,A00,893758,Morshed; Michael James,4,0,20,16
1745140685713,MCWP 50,B00,893761,Bartulis; Jason Michael,18,0,20,2
1745140686745,MCWP 50R,A00,893766,Compas; Sean Matthew,0,1,20,20
1745140686745,MCWP 50R,B00,893769,Carter; Jennifer A,5,0,20,15
1745140686745,MCWP 50R,C00,893771,Krone; Jarret,0,3,20,20
1745140686745,MCWP 50R,D00,893772,Miller; Elizabeth Deen,4,0,20,16
1745140686745,MCWP 50R,E00,893775,Carter; Andrea L,0,0,20,20
1745140687772,MMW 11R,A01,892721,Herbst; Matthew,22,0,30,8
1745140687772,MMW 11R,A02,892722,Herbst; Matthew,28,0,30,2
1745140688803,MMW 12R,A01,892724,Herbst; Matthew,0,5,16,16
1745140688803,MMW 12R,A02,892725,Herbst; Matthew,0,4,16,16
1745140689835,MMW 13R,A01,892727,Staff,0,29,16,16
1745140689835,MMW 13R,A02,892728,Staff,0,28,16,16
1745140690867,SIO 295LS,A00,894015,Staff,9,0,25,16
1745140691897,SIO 295S,A00,894020,Staff,9,0,25,16
1745140692924,SIOC 290S,A01,894063,Merrifield; Mark A,23,0,25,2
1745140693952,SIOC 291S,A01,894137,Gabriel; Corey John,23,0,25,2
1745140694982,SOCI 117,A01,895339,Staff,5,0,5,0
1745140696019,WES 237B,A00,894149,Staff,20,0,20,0
1745140698126,AESE 279B,A00,891859,Staff,35,0,35,0
1745140699156,AIP 197,001,891854,Staff,70,0,70,0
1745140700182,ANTH 289S,A00,891856,Gagneux; Pascal,12,0,12,0
1745140701209,BENG 196,001,957946,Engler; Adam J.,9996,0,9999,3
1745140702233,CAT 124RS,A01,956906,Staff,8,0,25,17
1745140703261,CAT 125RS,A01,922013,Staff,8,0,25,17
1745140704292,CLRE 250,A00,891860,Morris; Sheldon,9996,0,9999,3
1745140706348,CLRE 251R,A00,907817,Mehta; Ravindra L.,9995,0,9999,4
1745140707374,CLRE 252,A00,891864,Cuomo; Raphael Eduardo,9994,0,9999,5
1745140708400,CLRE 253,A00,891867,Vaida; Florin,9995,0,9999,4
1745140708400,CLRE 253,B00,907819,Staff,9999,0,9999,0
1745140709426,CLRE 259,A00,891868,Patel; Hemal,9998,0,9999,1
1745140710458,CLRE 260,A00,891872,Cuomo; Raphael Eduardo,9999,0,9999,0
1745140711488,CLRE 297,001,891888,Cuomo; Raphael Eduardo,9999,0,9999,0
1745140712522,CSS 201S,A01,892054,Mignozzetti; Umberto,30,0,30,0
1745140713550,CSS 202S,A01,892056,Mignozzetti; Umberto,30,0,30,0
1745140714576,DSC 197,001,956898,Eldridge; Justin Matthew,9998,0,9999,1
1745140715603,DSC 297,001,958000,Mazumdar; Arya,9999,0,9999,0
1745140716634,EAP 100,A00,905686,Staff,9774,0,9999,225
1745140717661,ECE 45,A01,892618,Staff,0,2,50,50
1745140718687,ECE 109,A01,892620,Staff,0,44,0,0
1745140719713,ECE 111,A01,892719,Staff,0,0,50,50
1745140720744,ECE 197,001,957920,Mercier; Patrick Philip,9992,0,9999,7
1745140721772,ECON 178,A01,907814,Zhu; Ying,29,0,35,6
1745140722803,EDS 115,A00,895312,Staff,42,0,45,3
1745140723831,EDS 117,A01,895337,Staff,30,0,30,0
1745140724858,EDS 125,A00,895341,Jones; Gabrielle Anastasia,43,0,45,2
1745140725885,EDS 128A,A01,895459,Fargason; Sharon Gayle,45,0,45,0
1745140726917,EDS 128B,A01,895543,Pappas; Elizabeth,45,0,45,0
1745140727946,EDS 139,A00,897203,Pappas; Elizabeth,45,0,45,0
1745140727946,EDS 139,B00,897209,Fargason; Sharon Gayle,45,0,45,0
1745140728971,EDS 201,A00,895545,Staff,44,0,45,1
1745140729999,EDS 203,A01,895581,Halter; Christopher P.,44,0,45,1
1745140731032,EDS 204R,A01,895625,Heinzman; Erica M.,45,0,45,0
1745140731032,EDS 204R,B01,895693,Halter; Christopher P.,28,0,45,17
1745140732066,EDS 206R,A00,895694,Fargason; Sharon Gayle,22,0,30,8
1745140732066,EDS 206R,B00,895695,Choi; Bailey Miyeon,21,0,30,9
1745140733095,EDS 250,A00,895697,Hemans; Patricia Ann Benitez,44,0,45,1
1745140734165,EDS 281,A00,895701,Meyerott; Theresa Ann,15,0,15,0
1745140735193,EDS 284,A00,895736,Meyerott; Theresa Ann,15,0,15,0
1745140736222,EDS 286,A00,897210,Fine; Sarah,15,0,15,0
1745140737247,EDS 289C,A01,895770,Daly; Alan J.,15,0,15,0
1745140738274,EDS 290,A00,897211,Hofstetter; Carolyn,15,0,15,0
1745140739308,LIGM 5A,A00,896162,Fischer-Grunski; Eva K,16,0,20,4
1745140740341,LIGM 5B,A00,896260,Fischer-Grunski; Eva K,19,0,20,1
1745140741370,LIGM 5C,A00,896308,Fischer-Grunski; Eva K,19,0,20,1
1745140742404,LIIT 5AS,A00,896313,Carnelos; Chiara,18,0,20,2
1745140743431,LIIT 5BS,A00,896416,Carnelos; Chiara,20,0,20,0
1745140744462,LIIT 5CS,A00,896564,Carnelos; Chiara,20,0,20,0
1745140745490,LISP 5A,A00,896588,Munoz Sanchez; Alicia,7,0,20,13
1745140746516,LISP 5B,A00,896653,Munoz Sanchez; Alicia,10,0,20,10
1745140747543,LISP 5C,A00,896655,Munoz Sanchez; Alicia,9,0,20,11
1745140748570,MAE 197,001,957918,Kleissl; Jan,9998,0,9999,1
1745140749603,MATH 2,A01,957937,Staff,34,0,35,1
1745140750631,MATH 197,001,957876,Kedlaya; Kiran S.,9996,0,9999,3
1745140751658,MCWP 40,A00,892729,Duru; Nur,16,0,20,4
1745140751658,MCWP 40,B00,893304,Montejo; Carolina,20,0,20,0
1745140752686,MCWP 40R,A00,893757,Redela; Pamela Morgan,0,3,20,20
1745140753720,MCWP 50,A00,893758,Morshed; Michael James,4,0,20,16
1745140753720,MCWP 50,B00,893761,Bartulis; Jason Michael,18,0,20,2
1745140754759,MCWP 50R,A00,893766,Compas; Sean Matthew,0,1,20,20
1745140754759,MCWP 50R,B00,893769,Carter; Jennifer A,5,0,20,15
1745140754759,MCWP 50R,C00,893771,Krone; Jarret,0,3,20,20
1745140754759,MCWP 50R,D00,893772,Miller; Elizabeth Deen,4,0,20,16
1745140754759,MCWP 50R,E00,893775,Carter; Andrea L,0,0,20,20
1745140755785,MMW 11R,A01,892721,Herbst; Matthew,22,0,30,8
1745140755785,MMW 11R,A02,892722,Herbst; Matthew,28,0,30,2
1745140756814,MMW 12R,A01,892724,Herbst; Matthew,0,5,16,16
1745140756814,MMW 12R,A02,892725,Herbst; Matthew,0,4,16,16
1745140757845,MMW 13R,A01,892727,Staff,0,29,16,16
1745140757845,MMW 13R,A02,892728,Staff,0,28,16,16
1745140758877,SIO 295LS,A00,894015,Staff,9,0,25,16
1745140759906,SIO 295S,A00,894020,Staff,9,0,25,16
1745140760939,SIOC 290S,A01,894063,Merrifield; Mark A,23,0,25,2
1745140761967,SIOC 291S,A01,894137,Gabriel; Corey John,23,0,25,2
1745140762999,SOCI 117,A01,895339,Staff,5,0,5,0
1745140764026,WES 237B,A00,894149,Staff,20,0,20,0
1745140766116,AESE 279B,A00,891859,Staff,35,0,35,0
1745140767141,AIP 197,001,891854,Staff,70,0,70,0
1745140768171,ANTH 289S,A00,891856,Gagneux; Pascal,12,0,12,0
1745140769198,BENG 196,001,957946,Engler; Adam J.,9996,0,9999,3
1745140770225,CAT 124RS,A01,956906,Staff,8,0,25,17
1745140771252,CAT 125RS,A01,922013,Staff,8,0,25,17
1745140772279,CLRE 250,A00,891860,Morris; Sheldon,9996,0,9999,3
1745140774341,CLRE 251R,A00,907817,Mehta; Ravindra L.,9995,0,9999,4
1745140775371,CLRE 252,A00,891864,Cuomo; Raphael Eduardo,9994,0,9999,5
1745140776398,CLRE 253,A00,891867,Vaida; Florin,9995,0,9999,4
1745140776398,CLRE 253,B00,907819,Staff,9999,0,9999,0
1745140777425,CLRE 259,A00,891868,Patel; Hemal,9998,0,9999,1
1745140778453,CLRE 260,A00,891872,Cuomo; Raphael Eduardo,9999,0,9999,0
1745140779480,CLRE 297,001,891888,Cuomo; Raphael Eduardo,9999,0,9999,0
1745140780507,CSS 201S,A01,892054,Mignozzetti; Umberto,30,0,30,0
1745140781534,CSS 202S,A01,892056,Mignozzetti; Umberto,30,0,30,0
1745140782561,DSC 197,001,956898,Eldridge; Justin Matthew,9998,0,9999,1
1745140783592,DSC 297,001,958000,Mazumdar; Arya,9999,0,9999,0
1745140784624,EAP 100,A00,905686,Staff,9774,0,9999,225
1745140785652,ECE 45,A01,892618,Staff,0,2,50,50
1745140786679,ECE 109,A01,892620,Staff,0,44,0,0
1745140787705,ECE 111,A01,892719,Staff,0,0,50,50
1745140788738,ECE 197,001,957920,Mercier; Patrick Philip,9992,0,9999,7
1745140789773,ECON 178,A01,907814,Zhu; Ying,29,0,35,6
1745140790801,EDS 115,A00,895312,Staff,42,0,45,3
1745140791826,EDS 117,A01,895337,Staff,30,0,30,0
1745140792855,EDS 125,A00,895341,Jones; Gabrielle Anastasia,43,0,45,2
1745140793882,EDS 128A,A01,895459,Fargason; Sharon Gayle,45,0,45,0
1745140794914,EDS 128B,A01,895543,Pappas; Elizabeth,45,0,45,0
1745140795944,EDS 139,A00,897203,Pappas; Elizabeth,45,0,45,0
1745140795944,EDS 139,B00,897209,Fargason; Sharon Gayle,45,0,45,0
1745140796971,EDS 201,A00,895545,Staff,44,0,45,1
1745140797997,EDS 203,A01,895581,Halter; Christopher P.,44,0,45,1
1745140799023,EDS 204R,A01,895625,Heinzman; Erica M.,45,0,45,0
1745140799023,EDS 204R,B01,895693,Halter; Christopher P.,28,0,45,17
1745140800048,EDS 206R,A00,895694,Fargason; Sharon Gayle,22,0,30,8
1745140800048,EDS 206R,B00,895695,Choi; Bailey Miyeon,21,0,30,9
1745140801076,EDS 250,A00,895697,Hemans; Patricia Ann Benitez,44,0,45,1
1745140802108,EDS 281,A00,895701,Meyerott; Theresa Ann,15,0,15,0
1745140803140,EDS 284,A00,895736,Meyerott; Theresa Ann,15,0,15,0
1745140804166,EDS 286,A00,897210,Fine; Sarah,15,0,15,0
1745140805194,EDS 289C,A01,895770,Daly; Alan J.,15,0,15,0
1745140806222,EDS 290,A00,897211,Hofstetter; Carolyn,15,0,15,0
1745140807252,LIGM 5A,A00,896162,Fischer-Grunski; Eva K,16,0,20,4
1745140808278,LIGM 5B,A00,896260,Fischer-Grunski; Eva K,19,0,20,1
1745140809308,LIGM 5C,A00,896308,Fischer-Grunski; Eva K,19,0,20,1
1745140810335,LIIT 5AS,A00,896313,Carnelos; Chiara,18,0,20,2
1745140811363,LIIT 5BS,A00,896416,Carnelos; Chiara,20,0,20,0
1745140812400,LIIT 5CS,A00,896564,Carnelos; Chiara,20,0,20,0
1745140813430,LISP 5A,A00,896588,Munoz Sanchez; Alicia,7,0,20,13
1745140814461,LISP 5B,A00,896653,Munoz Sanchez; Alicia,10,0,20,10
1745140815487,LISP 5C,A00,896655,Munoz Sanchez; Alicia,9,0,20,11
1745140816515,MAE 197,001,957918,Kleissl; Jan,9998,0,9999,1
1745140817540,MATH 2,A01,957937,Staff,34,0,35,1
1745140818567,MATH 197,001,957876,Kedlaya; Kiran S.,9996,0,9999,3
1745140819594,MCWP 40,A00,892729,Duru; Nur,16,0,20,4
1745140819594,MCWP 40,B00,893304,Montejo; Carolina,20,0,20,0
1745140820620,MCWP 40R,A00,893757,Redela; Pamela Morgan,0,3,20,20
1745140821652,MCWP 50,A00,893758,Morshed; Michael James,4,0,20,16
1745140821652,MCWP 50,B00,893761,Bartulis; Jason Michael,18,0,20,2
1745140822686,MCWP 50R,A00,893766,Compas; Sean Matthew,0,1,20,20
1745140822686,MCWP 50R,B00,893769,Carter; Jennifer A,5,0,20,15
1745140822686,MCWP 50R,C00,893771,Krone; Jarret,0,3,20,20
1745140822686,MCWP 50R,D00,893772,Miller; Elizabeth Deen,4,0,20,16
1745140822686,MCWP 50R,E00,893775,Carter; Andrea L,0,0,20,20
1745140823712,MMW 11R,A01,892721,Herbst; Matthew,22,0,30,8
1745140823712,MMW 11R,A02,892722,Herbst; Matthew,28,0,30,2
1745140824739,MMW 12R,A01,892724,Herbst; Matthew,0,5,16,16
1745140824739,MMW 12R,A02,892725,Herbst; Matthew,0,4,16,16
1745140825766,MMW 13R,A01,892727,Staff,0,29,16,16
1745140825766,MMW 13R,A02,892728,Staff,0,28,16,16
1745140826796,SIO 295LS,A00,894015,Staff,9,0,25,16
1745140827823,SIO 295S,A00,894020,Staff,9,0,25,16
1745140828851,SIOC 290S,A01,894063,Merrifield; Mark A,23,0,25,2
1745140829879,SIOC 291S,A01,894137,Gabriel; Corey John,23,0,25,2
1745140830906,SOCI 117,A01,895339,Staff,5,0,5,0
1745140831931,WES 237B,A00,894149,Staff,20,0,20,0
1745140834006,AESE 279B,A00,891859,Staff,35,0,35,0
1745140835031,AIP 197,001,891854,Staff,70,0,70,0
1745140836057,ANTH 289S,A00,891856,Gagneux; Pascal,12,0,12,0
1745140837087,BENG 196,001,957946,Engler; Adam J.,9996,0,9999,3
1745140838170,CAT 124RS,A01,956906,Staff,8,0,25,17
1745140839202,CAT 125RS,A01,922013,Staff,8,0,25,17
1745140840233,CLRE 250,A00,891860,Morris; Sheldon,9996,0,9999,3
1745140842291,CLRE 251R,A00,907817,Mehta; Ravindra L.,9995,0,9999,4
1745140843322,CLRE 252,A00,891864,Cuomo; Raphael Eduardo,9994,0,9999,5
1745140844351,CLRE 253,A00,891867,Vaida; Florin,9995,0,9999,4
1745140844351,CLRE 253,B00,907819,Staff,9999,0,9999,0
1745140845382,CLRE 259,A00,891868,Patel; Hemal,9998,0,9999,1
1745140846409,CLRE 260,A00,891872,Cuomo; Raphael Eduardo,9999,0,9999,0
1745140847439,CLRE 297,001,891888,Cuomo; Raphael Eduardo,9999,0,9999,0
1745140848465,CSS 201S,A01,892054,Mignozzetti; Umberto,30,0,30,0
1745140849493,CSS 202S,A01,892056,Mignozzetti; Umberto,30,0,30,0
1745140850525,DSC 197,001,956898,Eldridge; Justin Matthew,9998,0,9999,1
1745140851555,DSC 297,001,958000,Mazumdar; Arya,9999,0,9999,0
1745140852584,EAP 100,A00,905686,Staff,9774,0,9999,225
1745140853615,ECE 45,A01,892618,Staff,0,2,50,50
1745140854642,ECE 109,A01,892620,Staff,0,44,0,0
1745140855674,ECE 111,A01,892719,Staff,0,0,50,50
1745140856702,ECE 197,001,957920,Mercier; Patrick Philip,9992,0,9999,7
1745140857729,ECON 178,A01,907814,Zhu; Ying,29,0,35,6
1745140858762,EDS 115,A00,895312,Staff,42,0,45,3
1745140859793,EDS 117,A01,895337,Staff,30,0,30,0
1745140860819,EDS 125,A00,895341,Jones; Gabrielle Anastasia,43,0,45,2
1745140861846,EDS 128A,A01,895459,Fargason; Sharon Gayle,45,0,45,0
1745140862873,EDS 128B,A01,895543,Pappas; Elizabeth,45,0,45,0
1745140863902,EDS 139,A00,897203,Pappas; Elizabeth,45,0,45,0
1745140863902,EDS 139,B00,897209,Fargason; Sharon Gayle,45,0,45,0
1745140864931,EDS 201,A00,895545,Staff,44,0,45,1
1745140865959,EDS 203,A01,895581,Halter; Christopher P.,44,0,45,1
1745140866984,EDS 204R,A01,895625,Heinzman; Erica M.,45,0,45,0
1745140866984,EDS 204R,B01,895693,Halter; Christopher P.,28,0,45,17
1745140868014,EDS 206R,A00,895694,Fargason; Sharon Gayle,22,0,30,8
1745140868014,EDS 206R,B00,895695,Choi; Bailey Miyeon,21,0,30,9
1745140869045,EDS 250,A00,895697,Hemans; Patricia Ann Benitez,44,0,45,1
1745140870076,EDS 281,A00,895701,Meyerott; Theresa Ann,15,0,15,0
1745140871105,EDS 284,A00,895736,Meyerott; Theresa Ann,15,0,15,0
1745140872136,EDS 286,A00,897210,Fine; Sarah,15,0,15,0
1745140873162,EDS 289C,A01,895770,Daly; Alan J.,15,0,15,0
1745140874189,EDS 290,A00,897211,Hofstetter; Carolyn,15,0,15,0
1745140875216,LIGM 5A,A00,896162,Fischer-Grunski; Eva K,16,0,20,4
1745140876241,LIGM 5B,A00,896260,Fischer-Grunski; Eva K,19,0,20,1
1745140877267,LIGM 5C,A00,896308,Fischer-Grunski; Eva K,19,0,20,1
1745140878298,LIIT 5AS,A00,896313,Carnelos; Chiara,18,0,20,2
1745140879325,LIIT 5BS,A00,896416,Carnelos; Chiara,20,0,20,0
1745140880355,LIIT 5CS,A00,896564,Carnelos; Chiara,20,0,20,0
1745140881386,LISP 5A,A00,896588,Munoz Sanchez; Alicia,7,0,20,13
1745140882413,LISP 5B,A00,896653,Munoz Sanchez; Alicia,10,0,20,10
1745140883440,LISP 5C,A00,896655,Munoz Sanchez; Alicia,9,0,20,11
1745140884471,MAE 197,001,957918,Kleissl; Jan,9998,0,9999,1
1745140885497,MATH 2,A01,957937,Staff,34,0,35,1
1745140886523,MATH 197,001,957876,Kedlaya; Kiran S.,9996,0,9999,3
1745140887547,MCWP 40,A00,892729,Duru; Nur,16,0,20,4
1745140887547,MCWP 40,B00,893304,Montejo; Carolina,20,0,20,0
1745140888571,MCWP 40R,A00,893757,Redela; Pamela Morgan,0,3,20,20
1745140889627,MCWP 50,A00,893758,Morshed; Michael James,4,0,20,16
1745140889627,MCWP 50,B00,893761,Bartulis; Jason Michael,18,0,20,2
1745140890653,MCWP 50R,A00,893766,Compas; Sean Matthew,0,1,20,20
1745140890653,MCWP 50R,B00,893769,Carter; Jennifer A,5,0,20,15
1745140890653,MCWP 50R,C00,893771,Krone; Jarret,0,3,20,20
1745140890653,MCWP 50R,D00,893772,Miller; Elizabeth Deen,4,0,20,16
1745140890653,MCWP 50R,E00,893775,Carter; Andrea L,0,0,20,20
1745140891679,MMW 11R,A01,892721,Herbst; Matthew,22,0,30,8
1745140891679,MMW 11R,A02,892722,Herbst; Matthew,28,0,30,2
1745140892709,MMW 12R,A01,892724,Herbst; Matthew,0,5,16,16
1745140892709,MMW 12R,A02,892725,Herbst; Matthew,0,4,16,16
1745140893737,MMW 13R,A01,892727,Staff,0,29,16,16
1745140893737,MMW 13R,A02,892728,Staff,0,28,16,16
1745140894761,SIO 295LS,A00,894015,Staff,9,0,25,16
1745140895787,SIO 295S,A00,894020,Staff,9,0,25,16
1745140896817,SIOC 290S,A01,894063,Merrifield; Mark A,23,0,25,2
1745140897845,SIOC 291S,A01,894137,Gabriel; Corey John,23,0,25,2
1745140898875,SOCI 117,A01,895339,Staff,5,0,5,0
1745140899902,WES 237B,A00,894149,Staff,20,0,20,0
1745140901982,AESE 279B,A00,891859,Staff,35,0,35,0
1745140903008,AIP 197,001,891854,Staff,70,0,70,0
1745140904035,ANTH 289S,A00,891856,Gagneux; Pascal,12,0,12,0
1745140905059,BENG 196,001,957946,Engler; Adam J.,9996,0,9999,3
1745140906086,CAT 124RS,A01,956906,Staff,8,0,25,17
1745140907113,CAT 125RS,A01,922013,Staff,8,0,25,17
1745140908143,CLRE 250,A00,891860,Morris; Sheldon,9996,0,9999,3
1745140910196,CLRE 251R,A00,907817,Mehta; Ravindra L.,9995,0,9999,4
1745140911221,CLRE 252,A00,891864,Cuomo; Raphael Eduardo,9994,0,9999,5
1745140912246,CLRE 253,A00,891867,Vaida; Florin,9995,0,9999,4
1745140912246,CLRE 253,B00,907819,Staff,9999,0,9999,0
1745140913275,CLRE 259,A00,891868,Patel; Hemal,9998,0,9999,1
1745140914302,CLRE 260,A00,891872,Cuomo; Raphael Eduardo,9999,0,9999,0
1745140915329,CLRE 297,001,891888,Cuomo; Raphael Eduardo,9999,0,9999,0
1745140916360,CSS 201S,A01,892054,Mignozzetti; Umberto,30,0,30,0
1745140917392,CSS 202S,A01,892056,Mignozzetti; Umberto,30,0,30,0
1745140918423,DSC 197,001,956898,Eldridge; Justin Matthew,9998,0,9999,1
1745140919448,DSC 297,001,958000,Mazumdar; Arya,9999,0,9999,0
1745140920479,EAP 100,A00,905686,Staff,9774,0,9999,225
1745140921507,ECE 45,A01,892618,Staff,0,2,50,50
1745140922534,ECE 109,A01,892620,Staff,0,44,0,0
1745140923562,ECE 111,A01,892719,Staff,0,0,50,50
1745140924589,ECE 197,001,957920,Mercier; Patrick Philip,9992,0,9999,7
1745140925616,ECON 178,A01,907814,Zhu; Ying,29,0,35,6
1745140926646,EDS 115,A00,895312,Staff,42,0,45,3
1745140927674,EDS 117,A01,895337,Staff,30,0,30,0
1745140928704,EDS 125,A00,895341,Jones; Gabrielle Anastasia,43,0,45,2
1745140929731,EDS 128A,A01,895459,Fargason; Sharon Gayle,45,0,45,0
1745140930757,EDS 128B,A01,895543,Pappas; Elizabeth,45,0,45,0
1745140931786,EDS 139,A00,897203,Pappas; Elizabeth,45,0,45,0
1745140931786,EDS 139,B00,897209,Fargason; Sharon Gayle,45,0,45,0
1745140932811,EDS 201,A00,895545,Staff,44,0,45,1
1745140933838,EDS 203,A01,895581,Halter; Christopher P.,44,0,45,1
1745140934864,EDS 204R,A01,895625,Heinzman; Erica M.,45,0,45,0
1745140934864,EDS 204R,B01,895693,Halter; Christopher P.,28,0,45,17
1745140935888,EDS 206R,A00,895694,Fargason; Sharon Gayle,22,0,30,8
1745140935888,EDS 206R,B00,895695,Choi; Bailey Miyeon,21,0,30,9
1745140936913,EDS 250,A00,895697,Hemans; Patricia Ann Benitez,44,0,45,1
1745140937939,EDS 281,A00,895701,Meyerott; Theresa Ann,15,0,15,0
1745140938967,EDS 284,A00,895736,Meyerott; Theresa Ann,15,0,15,0
1745140939992,EDS 286,A00,897210,Fine; Sarah,15,0,15,0
1745140941025,EDS 289C,A01,895770,Daly; Alan J.,15,0,15,0
1745140942090,EDS 290,A00,897211,Hofstetter; Carolyn,15,0,15,0
1745140943117,LIGM 5A,A00,896162,Fischer-Grunski; Eva K,16,0,20,4
1745140944149,LIGM 5B,A00,896260,Fischer-Grunski; Eva K,19,0,20,1
1745140945177,LIGM 5C,A00,896308,Fischer-Grunski; Eva K,19,0,20,1
1745140946202,LIIT 5AS,A00,896313,Carnelos; Chiara,18,0,20,2
1745140947233,LIIT 5BS,A00,896416,Carnelos; Chiara,20,0,20,0
1745140948258,LIIT 5CS,A00,896564,Carnelos; Chiara,20,0,20,0
1745140949284,LISP 5A,A00,896588,Munoz Sanchez; Alicia,7,0,20,13
1745140950313,LISP 5B,A00,896653,Munoz Sanchez; Alicia,10,0,20,10
1745140951340,LISP 5C,A00,896655,Munoz Sanchez; Alicia,9,0,20,11
1745140952370,MAE 197,001,957918,Kleissl; Jan,9998,0,9999,1
1745140953395,MATH 2,A01,957937,Staff,34,0,35,1
1745140954419,MATH 197,001,957876,Kedlaya; Kiran S.,9996,0,9999,3
1745140955448,MCWP 40,A00,892729,Duru; Nur,16,0,20,4
1745140955448,MCWP 40,B00,893304,Montejo; Carolina,20,0,20,0
1745140956473,MCWP 40R,A00,893757,Redela; Pamela Morgan,0,3,20,20
1745140957505,MCWP 50,A00,893758,Morshed; Michael James,4,0,20,16
1745140957505,MCWP 50,B00,893761,Bartulis; Jason Michael,18,0,20,2
1745140958534,MCWP 50R,A00,893766,Compas; Sean Matthew,0,1,20,20
1745140958534,MCWP 50R,B00,893769,Carter; Jennifer A,5,0,20,15
1745140958534,MCWP 50R,C00,893771,Krone; Jarret,0,3,20,20
1745140958534,MCWP 50R,D00,893772,Miller; Elizabeth Deen,4,0,20,16
1745140958534,MCWP 50R,E00,893775,Carter; Andrea L,0,0,20,20
1745140959567,MMW 11R,A01,892721,Herbst; Matthew,22,0,30,8
1745140959567,MMW 11R,A02,892722,Herbst; Matthew,28,0,30,2
1745140960595,MMW 12R,A01,892724,Herbst; Matthew,0,5,16,16
1745140960595,MMW 12R,A02,892725,Herbst; Matthew,0,4,16,16
1745140961625,MMW 13R,A01,892727,Staff,0,29,16,16
1745140961625,MMW 13R,A02,892728,Staff,0,28,16,16
1745140962650,SIO 295LS,A00,894015,Staff,9,0,25,16
1745140963674,SIO 295S,A00,894020,Staff,9,0,25,16
1745140964700,SIOC 290S,A01,894063,Merrifield; Mark A,23,0,25,2
1745140965732,SIOC 291S,A01,894137,Gabriel; Corey John,23,0,25,2
1745140966760,SOCI 117,A01,895339,Staff,5,0,5,0
1745140967789,WES 237B,A00,894149,Staff,20,0,20,0
1745140969883,AESE 279B,A00,891859,Staff,35,0,35,0
1745140970907,AIP 197,001,891854,Staff,70,0,70,0
1745140971941,ANTH 289S,A00,891856,Gagneux; Pascal,12,0,12,0
1745140972970,BENG 196,001,957946,Engler; Adam J.,9996,0,9999,3
1745140973997,CAT 124RS,A01,956906,Staff,8,0,25,17
1745140975023,CAT 125RS,A01,922013,Staff,8,0,25,17
1745140976050,CLRE 250,A00,891860,Morris; Sheldon,9996,0,9999,3
1745140978107,CLRE 251R,A00,907817,Mehta; Ravindra L.,9995,0,9999,4
1745140979135,CLRE 252,A00,891864,Cuomo; Raphael Eduardo,9994,0,9999,5
1745140980160,CLRE 253,A00,891867,Vaida; Florin,9995,0,9999,4
1745140980160,CLRE 253,B00,907819,Staff,9999,0,9999,0
1745140981187,CLRE 259,A00,891868,Patel; Hemal,9998,0,9999,1
1745140982217,CLRE 260,A00,891872,Cuomo; Raphael Eduardo,9999,0,9999,0
1745140983242,CLRE 297,001,891888,Cuomo; Raphael Eduardo,9999,0,9999,0
1745140984268,CSS 201S,A01,892054,Mignozzetti; Umberto,30,0,30,0
1745140985302,CSS 202S,A01,892056,Mignozzetti; Umberto,30,0,30,0
1745140986333,DSC 197,001,956898,Eldridge; Justin Matthew,9998,0,9999,1
1745140987362,DSC 297,001,958000,Mazumdar; Arya,9999,0,9999,0
1745140988388,EAP 100,A00,905686,Staff,9774,0,9999,225
1745140989418,ECE 45,A01,892618,Staff,0,2,50,50
1745140990443,ECE 109,A01,892620,Staff,0,44,0,0
1745140991473,ECE 111,A01,892719,Staff,0,0,50,50
1745140992500,ECE 197,001,957920,Mercier; Patrick Philip,9992,0,9999,7
1745140993527,ECON 178,A01,907814,Zhu; Ying,29,0,35,6
1745140994552,EDS 115,A00,895312,Staff,42,0,45,3
1745140995577,EDS 117,A01,895337,Staff,30,0,30,0
1745140996604,EDS 125,A00,895341,Jones; Gabrielle Anastasia,43,0,45,2
1745140997630,EDS 128A,A01,895459,Fargason; Sharon Gayle,45,0,45,0
1745140998657,EDS 128B,A01,895543,Pappas; Elizabeth,45,0,45,0
1745140999684,EDS 139,A00,897203,Pappas; Elizabeth,45,0,45,0
1745140999684,EDS 139,B00,897209,Fargason; Sharon Gayle,45,0,45,0
1745141000710,EDS 201,A00,895545,Staff,44,0,45,1
1745141001736,EDS 203,A01,895581,Halter; Christopher P.,44,0,45,1
1745141002765,EDS 204R,A01,895625,Heinzman; Erica M.,45,0,45,0
1745141002765,EDS 204R,B01,895693,Halter; Christopher P.,28,0,45,17
1745141003791,EDS 206R,A00,895694,Fargason; Sharon Gayle,22,0,30,8
1745141003791,EDS 206R,B00,895695,Choi; Bailey Miyeon,21,0,30,9
1745141004818,EDS 250,A00,895697,Hemans; Patricia Ann Benitez,44,0,45,1
1745141005845,EDS 281,A00,895701,Meyerott; Theresa Ann,15,0,15,0
1745141006873,EDS 284,A00,895736,Meyerott; Theresa Ann,15,0,15,0
1745141007900,EDS 286,A00,897210,Fine; Sarah,15,0,15,0
1745141008930,EDS 289C,A01,895770,Daly; Alan J.,15,0,15,0
1745141009956,EDS 290,A00,897211,Hofstetter; Carolyn,15,0,15,0
1745141010986,LIGM 5A,A00,896162,Fischer-Grunski; Eva K,16,0,20,4
1745141012012,LIGM 5B,A00,896260,Fischer-Grunski; Eva K,19,0,20,1
1745141013039,LIGM 5C,A00,896308,Fischer-Grunski; Eva K,19,0,20,1
1745141014065,LIIT 5AS,A00,896313,Carnelos; Chiara,18,0,20,2
1745141015092,LIIT 5BS,A00,896416,Carnelos; Chiara,20,0,20,0
1745141016120,LIIT 5CS,A00,896564,Carnelos; Chiara,20,0,20,0
1745141017151,LISP 5A,A00,896588,Munoz Sanchez; Alicia,7,0,20,13
1745141018182,LISP 5B,A00,896653,Munoz Sanchez; Alicia,10,0,20,10
1745141019213,LISP 5C,A00,896655,Munoz Sanchez; Alicia,9,0,20,11
1745141020243,MAE 197,001,957918,Kleissl; Jan,9998,0,9999,1
1745141021269,MATH 2,A01,957937,Staff,34,0,35,1
1745141022295,MATH 197,001,957876,Kedlaya; Kiran S.,9996,0,9999,3
1745141023322,MCWP 40,A00,892729,Duru; Nur,16,0,20,4
1745141023322,MCWP 40,B00,893304,Montejo; Carolina,20,0,20,0
1745141024349,MCWP 40R,A00,893757,Redela; Pamela Morgan,0,3,20,20
1745141025378,MCWP 50,A00,893758,Morshed; Michael James,4,0,20,16
1745141025378,MCWP 50,B00,893761,Bartulis; Jason Michael,18,0,20,2
1745141026412,MCWP 50R,A00,893766,Compas; Sean Matthew,0,1,20,20
1745141026412,MCWP 50R,B00,893769,Carter; Jennifer A,5,0,20,15
1745141026412,MCWP 50R,C00,893771,Krone; Jarret,0,3,20,20
1745141026412,MCWP 50R,D00,893772,Miller; Elizabeth Deen,4,0,20,16
1745141026412,MCWP 50R,E00,893775,Carter; Andrea L,0,0,20,20
1745141027442,MMW 11R,A01,892721,Herbst; Matthew,22,0,30,8
1745141027442,MMW 11R,A02,892722,Herbst; Matthew,28,0,30,2
1745141028468,MMW 12R,A01,892724,Herbst; Matthew,0,5,16,16
1745141028468,MMW 12R,A02,892725,Herbst; Matthew,0,4,16,16
1745141029495,MMW 13R,A01,892727,Staff,0,29,16,16
1745141029495,MMW 13R,A02,892728,Staff,0,28,16,16
1745141030525,SIO 295LS,A00,894015,Staff,9,0,25,16
1745141031554,SIO 295S,A00,894020,Staff,9,0,25,16
1745141032581,SIOC 290S,A01,894063,Merrifield; Mark A,23,0,25,2
1745141033611,SIOC 291S,A01,894137,Gabriel; Corey John,23,0,25,2
1745141034641,SOCI 117,A01,895339,Staff,5,0,5,0
1745141035669,WES 237B,A00,894149,Staff,20,0,20,0
1745141037753,AESE 279B,A00,891859,Staff,35,0,35,0
1745141038780,AIP 197,001,891854,Staff,70,0,70,0
1745141039806,ANTH 289S,A00,891856,Gagneux; Pascal,12,0,12,0
1745141040838,BENG 196,001,957946,Engler; Adam J.,9996,0,9999,3
1745141041863,CAT 124RS,A01,956906,Staff,8,0,25,17
1745141042892,CAT 125RS,A01,922013,Staff,8,0,25,17
1745141043922,CLRE 250,A00,891860,Morris; Sheldon,9996,0,9999,3
1745141046022,CLRE 251R,A00,907817,Mehta; Ravindra L.,9995,0,9999,4
1745141047050,CLRE 252,A00,891864,Cuomo; Raphael Eduardo,9994,0,9999,5
1745141048080,CLRE 253,A00,891867,Vaida; Florin,9995,0,9999,4
1745141048080,CLRE 253,B00,907819,Staff,9999,0,9999,0
1745141049105,CLRE 259,A00,891868,Patel; Hemal,9998,0,9999,1
1745141050135,CLRE 260,A00,891872,Cuomo; Raphael Eduardo,9999,0,9999,0
1745141051163,CLRE 297,001,891888,Cuomo; Raphael Eduardo,9999,0,9999,0
1745141052195,CSS 201S,A01,892054,Mignozzetti; Umberto,30,0,30,0
1745141053229,CSS 202S,A01,892056,Mignozzetti; Umberto,30,0,30,0
1745141054257,DSC 197,001,956898,Eldridge; Justin Matthew,9998,0,9999,1
1745141055282,DSC 297,001,958000,Mazumdar; Arya,9999,0,9999,0
1745141056308,EAP 100,A00,905686,Staff,9774,0,9999,225
1745141057334,ECE 45,A01,892618,Staff,0,2,50,50
1745141058362,ECE 109,A01,892620,Staff,0,44,0,0
1745141059396,ECE 111,A01,892719,Staff,0,0,50,50
1745141060426,ECE 197,001,957920,Mercier; Patrick Philip,9992,0,9999,7
1745141061452,ECON 178,A01,907814,Zhu; Ying,29,0,35,6
1745141062482,EDS 115,A00,895312,Staff,42,0,45,3
1745141063510,EDS 117,A01,895337,Staff,30,0,30,0
1745141064540,EDS 125,A00,895341,Jones; Gabrielle Anastasia,43,0,45,2
1745141065571,EDS 128A,A01,895459,Fargason; Sharon Gayle,45,0,45,0
1745141066599,EDS 128B,A01,895543,Pappas; Elizabeth,45,0,45,0
1745141067626,EDS 139,A00,897203,Pappas; Elizabeth,45,0,45,0
1745141067626,EDS 139,B00,897209,Fargason; Sharon Gayle,45,0,45,0
1745141068651,EDS 201,A00,895545,Staff,44,0,45,1
1745141069679,EDS 203,A01,895581,Halter; Christopher P.,44,0,45,1
1745141070707,EDS 204R,A01,895625,Heinzman; Erica M.,45,0,45,0
1745141070707,EDS 204R,B01,895693,Halter; Christopher P.,28,0,45,17
1745141071734,EDS 206R,A00,895694,Fargason; Sharon Gayle,22,0,30,8
1745141071734,EDS 206R,B00,895695,Choi; Bailey Miyeon,21,0,30,9
1745141072762,EDS 250,A00,895697,Hemans; Patricia Ann Benitez,44,0,45,1
1745141073790,EDS 281,A00,895701,Meyerott; Theresa Ann,15,0,15,0
1745141074820,EDS 284,A00,895736,Meyerott; Theresa Ann,15,0,15,0
1745141075846,EDS 286,A00,897210,Fine; Sarah,15,0,15,0
1745141076872,EDS 289C,A01,895770,Daly; Alan J.,15,0,15,0
1745141077938,EDS 290,A00,897211,Hofstetter; Carolyn,15,0,15,0
1745141078971,LIGM 5A,A00,896162,Fischer-Grunski; Eva K,16,0,20,4
1745141080003,LIGM 5B,A00,896260,Fischer-Grunski; Eva K,19,0,20,1
1745141081034,LIGM 5C,A00,896308,Fischer-Grunski; Eva K,19,0,20,1
1745141082064,LIIT 5AS,A00,896313,Carnelos; Chiara,18,0,20,2
1745141083091,LIIT 5BS,A00,896416,Carnelos; Chiara,20,0,20,0
1745141084118,LIIT 5CS,A00,896564,Carnelos; Chiara,20,0,20,0
1745141085144,LISP 5A,A00,896588,Munoz Sanchez; Alicia,7,0,20,13
1745141086176,LISP 5B,A00,896653,Munoz Sanchez; Alicia,10,0,20,10
1745141087207,LISP 5C,A00,896655,Munoz Sanchez; Alicia,9,0,20,11
1745141088236,MAE 197,001,957918,Kleissl; Jan,9998,0,9999,1
1745141089261,MATH 2,A01,957937,Staff,34,0,35,1
1745141090288,MATH 197,001,957876,Kedlaya; Kiran S.,9996,0,9999,3
1745141091316,MCWP 40,A00,892729,Duru; Nur,16,0,20,4
1745141091316,MCWP 40,B00,893304,Montejo; Carolina,20,0,20,0
1745141092344,MCWP 40R,A00,893757,Redela; Pamela Morgan,0,3,20,20
1745141093375,MCWP 50,A00,893758,Morshed; Michael James,4,0,20,16
1745141093375,MCWP 50,B00,893761,Bartulis; Jason Michael,18,0,20,2
1745141094408,MCWP 50R,A00,893766,Compas; Sean Matthew,0,1,20,20
1745141094408,MCWP 50R,B00,893769,Carter; Jennifer A,5,0,20,15
1745141094408,MCWP 50R,C00,893771,Krone; Jarret,0,3,20,20
1745141094408,MCWP 50R,D00,893772,Miller; Elizabeth Deen,4,0,20,16
1745141094408,MCWP 50R,E00,893775,Carter; Andrea L,0,0,20,20
1745141095940,MMW 11R,A01,892721,Herbst; Matthew,22,0,30,8
1745141095940,MMW 11R,A02,892722,Herbst; Matthew,28,0,30,2
1745141096966,MMW 12R,A01,892724,Herbst; Matthew,0,5,16,16
1745141096966,MMW 12R,A02,892725,Herbst; Matthew,0,4,16,16
1745141097996,MMW 13R,A01,892727,Staff,0,29,16,16
1745141097996,MMW 13R,A02,892728,Staff,0,28,16,16
1745141099027,SIO 295LS,A00,894015,Staff,9,0,25,16
1745141100055,SIO 295S,A00,894020,Staff,9,0,25,16
1745141101084,SIOC 290S,A01,894063,Merrifield; Mark A,23,0,25,2
1745141102112,SIOC 291S,A01,894137,Gabriel; Corey John,23,0,25,2
1745141103138,SOCI 117,A01,895339,Staff,5,0,5,0
1745141104168,WES 237B,A00,894149,Staff,20,0,20,0
1745141106247,AESE 279B,A00,891859,Staff,35,0,35,0
1745141107275,AIP 197,001,891854,Staff,70,0,70,0
1745141108301,ANTH 289S,A00,891856,Gagneux; Pascal,12,0,12,0
1745141109330,BENG 196,001,957946,Engler; Adam J.,9996,0,9999,3
1745141110359,CAT 124RS,A01,956906,Staff,8,0,25,17
1745141111384,CAT 125RS,A01,922013,Staff,8,0,25,17
1745141112420,CLRE 250,A00,891860,Morris; Sheldon,9996,0,9999,3
1745141114475,CLRE 251R,A00,907817,Mehta; Ravindra L.,9995,0,9999,4
1745141115501,CLRE 252,A00,891864,Cuomo; Raphael Eduardo,9994,0,9999,5
1745141116527,CLRE 253,A00,891867,Vaida; Florin,9995,0,9999,4
1745141116527,CLRE 253,B00,907819,Staff,9999,0,9999,0
1745141117554,CLRE 259,A00,891868,Patel; Hemal,9998,0,9999,1
1745141118583,CLRE 260,A00,891872,Cuomo; Raphael Eduardo,9999,0,9999,0
1745141119612,CLRE 297,001,891888,Cuomo; Raphael Eduardo,9999,0,9999,0
1745141120645,CSS 201S,A01,892054,Mignozzetti; Umberto,30,0,30,0
1745141121674,CSS 202S,A01,892056,Mignozzetti; Umberto,30,0,30,0
1745141122708,DSC 197,001,956898,Eldridge; Justin Matthew,9998,0,9999,1
1745141123733,DSC 297,001,958000,Mazumdar; Arya,9999,0,9999,0
1745141124758,EAP 100,A00,905686,Staff,9774,0,9999,225
1745141125787,ECE 45,A01,892618,Staff,0,2,50,50
1745141126813,ECE 109,A01,892620,Staff,0,44,0,0
1745141127839,ECE 111,A01,892719,Staff,0,0,50,50
1745141128873,ECE 197,001,957920,Mercier; Patrick Philip,9992,0,9999,7
1745141129899,ECON 178,A01,907814,Zhu; Ying,29,0,35,6
1745141130928,EDS 115,A00,895312,Staff,42,0,45,3
1745141131953,EDS 117,A01,895337,Staff,30,0,30,0
1745141132979,EDS 125,A00,895341,Jones; Gabrielle Anastasia,43,0,45,2
1745141134013,EDS 128A,A01,895459,Fargason; Sharon Gayle,45,0,45,0
1745141135042,EDS 128B,A01,895543,Pappas; Elizabeth,45,0,45,0
1745141136069,EDS 139,A00,897203,Pappas; Elizabeth,45,0,45,0
1745141136069,EDS 139,B00,897209,Fargason; Sharon Gayle,45,0,45,0
1745141137096,EDS 201,A00,895545,Staff,44,0,45,1
1745141138125,EDS 203,A01,895581,Halter; Christopher P.,44,0,45,1
1745141139151,EDS 204R,A01,895625,Heinzman; Erica M.,45,0,45,0
1745141139151,EDS 204R,B01,895693,Halter; Christopher P.,28,0,45,17
1745141140178,EDS 206R,A00,895694,Fargason; Sharon Gayle,22,0,30,8
1745141140178,EDS 206R,B00,895695,Choi; Bailey Miyeon,21,0,30,9
1745141141208,EDS 250,A00,895697,Hemans; Patricia Ann Benitez,44,0,45,1
1745141142234,EDS 281,A00,895701,Meyerott; Theresa Ann,15,0,15,0
1745141143259,EDS 284,A00,895736,Meyerott; Theresa Ann,15,0,15,0
1745141144286,EDS 286,A00,897210,Fine; Sarah,15,0,15,0
1745141145317,EDS 289C,A01,895770,Daly; Alan J.,15,0,15,0
1745141146345,EDS 290,A00,897211,Hofstetter; Carolyn,15,0,15,0
1745141147373,LIGM 5A,A00,896162,Fischer-Grunski; Eva K,16,0,20,4
1745141148403,LIGM 5B,A00,896260,Fischer-Grunski; Eva K,19,0,20,1
1745141149433,LIGM 5C,A00,896308,Fischer-Grunski; Eva K,19,0,20,1
1745141150461,LIIT 5AS,A00,896313,Carnelos; Chiara,18,0,20,2
1745141151487,LIIT 5BS,A00,896416,Carnelos; Chiara,20,0,20,0
1745141152517,LIIT 5CS,A00,896564,Carnelos; Chiara,20,0,20,0
1745141153544,LISP 5A,A00,896588,Munoz Sanchez; Alicia,7,0,20,13
1745141154571,LISP 5B,A00,896653,Munoz Sanchez; Alicia,10,0,20,10
1745141155602,LISP 5C,A00,896655,Munoz Sanchez; Alicia,9,0,20,11
1745141156630,MAE 197,001,957918,Kleissl; Jan,9998,0,9999,1
1745141157655,MATH 2,A01,957937,Staff,34,0,35,1
1745141158683,MATH 197,001,957876,Kedlaya; Kiran S.,9996,0,9999,3
1745141159712,MCWP 40,A00,892729,Duru; Nur,16,0,20,4
1745141159712,MCWP 40,B00,893304,Montejo; Carolina,20,0,20,0
1745141160739,MCWP 40R,A00,893757,Redela; Pamela Morgan,0,3,20,20
1745141161767,MCWP 50,A00,893758,Morshed; Michael James,4,0,20,16
1745141161767,MCWP 50,B00,893761,Bartulis; Jason Michael,18,0,20,2
1745141162803,MCWP 50R,A00,893766,Compas; Sean Matthew,0,1,20,20
1745141162803,MCWP 50R,B00,893769,Carter; Jennifer A,5,0,20,15
1745141162803,MCWP 50R,C00,893771,Krone; Jarret,0,3,20,20
1745141162803,MCWP 50R,D00,893772,Miller; Elizabeth Deen,4,0,20,16
1745141162803,MCWP 50R,E00,893775,Carter; Andrea L,0,0,20,20
1745141163832,MMW 11R,A01,892721,Herbst; Matthew,22,0,30,8
1745141163832,MMW 11R,A02,892722,Herbst; Matthew,28,0,30,2
1745141164862,MMW 12R,A01,892724,Herbst; Matthew,0,5,16,16
1745141164862,MMW 12R,A02,892725,Herbst; Matthew,0,4,16,16
1745141165891,MMW 13R,A01,892727,Staff,0,29,16,16
1745141165891,MMW 13R,A02,892728,Staff,0,28,16,16
1745141166919,SIO 295LS,A00,894015,Staff,9,0,25,16
1745141167946,SIO 295S,A00,894020,Staff,9,0,25,16
1745141168974,SIOC 290S,A01,894063,Merrifield; Mark A,23,0,25,2
1745141170002,SIOC 291S,A01,894137,Gabriel; Corey John,23,0,25,2
1745141171029,SOCI 117,A01,895339,Staff,5,0,5,0
1745141172054,WES 237B,A00,894149,Staff,20,0,20,0
1745141174132,AESE 279B,A00,891859,Staff,35,0,35,0
1745141175160,AIP 197,001,891854,Staff,70,0,70,0
1745141176191,ANTH 289S,A00,891856,Gagneux; Pascal,12,0,12,0
1745141177221,BENG 196,001,957946,Engler; Adam J.,9996,0,9999,3
1745141178251,CAT 124RS,A01,956906,Staff,8,0,25,17
1745141179276,CAT 125RS,A01,922013,Staff,8,0,25,17
1745141180302,CLRE 250,A00,891860,Morris; Sheldon,9996,0,9999,3
1745141182387,CLRE 251R,A00,907817,Mehta; Ravindra L.,9995,0,9999,4
1745141183417,CLRE 252,A00,891864,Cuomo; Raphael Eduardo,9994,0,9999,5
1745141184446,CLRE 253,A00,891867,Vaida; Florin,9995,0,9999,4
1745141184446,CLRE 253,B00,907819,Staff,9999,0,9999,0
1745141185473,CLRE 259,A00,891868,Patel; Hemal,9998,0,9999,1
1745141186499,CLRE 260,A00,891872,Cuomo; Raphael Eduardo,9999,0,9999,0
1745141187526,CLRE 297,001,891888,Cuomo; Raphael Eduardo,9999,0,9999,0
1745141188552,CSS 201S,A01,892054,Mignozzetti; Umberto,30,0,30,0
1745141189579,CSS 202S,A01,892056,Mignozzetti; Umberto,30,0,30,0
1745141190605,DSC 197,001,956898,Eldridge; Justin Matthew,9998,0,9999,1
1745141191633,DSC 297,001,958000,Mazumdar; Arya,9999,0,9999,0
1745141192662,EAP 100,A00,905686,Staff,9774,0,9999,225
1745141193687,ECE 45,A01,892618,Staff,0,2,50,50
1745141194713,ECE 109,A01,892620,Staff,0,44,0,0
1745141195738,ECE 111,A01,892719,Staff,0,0,50,50
1745141196769,ECE 197,001,957920,Mercier; Patrick Philip,9992,0,9999,7
1745141197800,ECON 178,A01,907814,Zhu; Ying,29,0,35,6
1745141198827,EDS 115,A00,895312,Staff,42,0,45,3
1745141199853,EDS 117,A01,895337,Staff,30,0,30,0
1745141200877,EDS 125,A00,895341,Jones; Gabrielle Anastasia,43,0,45,2
1745141201905,EDS 128A,A01,895459,Fargason; Sharon Gayle,45,0,45,0
1745141202929,EDS 128B,A01,895543,Pappas; Elizabeth,45,0,45,0
1745141203958,EDS 139,A00,897203,Pappas; Elizabeth,45,0,45,0
1745141203958,EDS 139,B00,897209,Fargason; Sharon Gayle,45,0,45,0
1745141204987,EDS 201,A00,895545,Staff,44,0,45,1
1745141206017,EDS 203,A01,895581,Halter; Christopher P.,44,0,45,1
1745141207047,EDS 204R,A01,895625,Heinzman; Erica M.,45,0,45,0
1745141207047,EDS 204R,B01,895693,Halter; Christopher P.,28,0,45,17
1745141208076,EDS 206R,A00,895694,Fargason; Sharon Gayle,22,0,30,8
1745141208076,EDS 206R,B00,895695,Choi; Bailey Miyeon,21,0,30,9
1745141209102,EDS 250,A00,895697,Hemans; Patricia Ann Benitez,44,0,45,1
1745141210137,EDS 281,A00,895701,Meyerott; Theresa Ann,15,0,15,0
1745141211164,EDS 284,A00,895736,Meyerott; Theresa Ann,15,0,15,0
1745141212194,EDS 286,A00,897210,Fine; Sarah,15,0,15,0
1745141213222,EDS 289C,A01,895770,Daly; Alan J.,15,0,15,0
1745141214246,EDS 290,A00,897211,Hofstetter; Carolyn,15,0,15,0
1745141215276,LIGM 5A,A00,896162,Fischer-Grunski; Eva K,16,0,20,4
1745141216303,LIGM 5B,A00,896260,Fischer-Grunski; Eva K,19,0,20,1
1745141217329,LIGM 5C,A00,896308,Fischer-Grunski; Eva K,19,0,20,1
1745141218355,LIIT 5AS,A00,896313,Carnelos; Chiara,18,0,20,2
1745141219386,LIIT 5BS,A00,896416,Carnelos; Chiara,20,0,20,0
1745141220415,LIIT 5CS,A00,896564,Carnelos; Chiara,20,0,20,0
1745141221443,LISP 5A,A00,896588,Munoz Sanchez; Alicia,7,0,20,13
1745141222470,LISP 5B,A00,896653,Munoz Sanchez; Alicia,10,0,20,10
1745141223501,LISP 5C,A00,896655,Munoz Sanchez; Alicia,9,0,20,11
1745141224530,MAE 197,001,957918,Kleissl; Jan,9998,0,9999,1
1745141225559,MATH 2,A01,957937,Staff,34,0,35,1
1745141226590,MATH 197,001,957876,Kedlaya; Kiran S.,9996,0,9999,3
1745141227615,MCWP 40,A00,892729,Duru; Nur,16,0,20,4
1745141227615,MCWP 40,B00,893304,Montejo; Carolina,20,0,20,0
1745141228641,MCWP 40R,A00,893757,Redela; Pamela Morgan,0,3,20,20
1745141229667,MCWP 50,A00,893758,Morshed; Michael James,4,0,20,16
1745141229667,MCWP 50,B00,893761,Bartulis; Jason Michael,18,0,20,2
1745141230695,MCWP 50R,A00,893766,Compas; Sean Matthew,0,1,20,20
1745141230695,MCWP 50R,B00,893769,Carter; Jennifer A,5,0,20,15
1745141230695,MCWP 50R,C00,893771,Krone; Jarret,0,3,20,20
1745141230695,MCWP 50R,D00,893772,Miller; Elizabeth Deen,4,0,20,16
1745141230695,MCWP 50R,E00,893775,Carter; Andrea L,0,0,20,20
1745141231725,MMW 11R,A01,892721,Herbst; Matthew,22,0,30,8
1745141231725,MMW 11R,A02,892722,Herbst; Matthew,28,0,30,2
1745141232751,MMW 12R,A01,892724,Herbst; Matthew,0,5,16,16
1745141232751,MMW 12R,A02,892725,Herbst; Matthew,0,4,16,16
1745141233778,MMW 13R,A01,892727,Staff,0,29,16,16
1745141233778,MMW 13R,A02,892728,Staff,0,28,16,16
1745141234806,SIO 295LS,A00,894015,Staff,9,0,25,16
1745141235838,SIO 295S,A00,894020,Staff,9,0,25,16
1745141236863,SIOC 290S,A01,894063,Merrifield; Mark A,23,0,25,2
1745141237891,SIOC 291S,A01,894137,Gabriel; Corey John,23,0,25,2
1745141238917,SOCI 117,A01,895339,Staff,5,0,5,0
1745141239943,WES 237B,A00,894149,Staff,20,0,20,0
1745141242029,AESE 279B,A00,891859,Staff,35,0,35,0
1745141243057,AIP 197,001,891854,Staff,70,0,70,0
1745141244081,ANTH 289S,A00,891856,Gagneux; Pascal,12,0,12,0
1745141245107,BENG 196,001,957946,Engler; Adam J.,9996,0,9999,3
1745141246134,CAT 124RS,A01,956906,Staff,8,0,25,17
1745141247163,CAT 125RS,A01,922013,Staff,8,0,25,17
1745141248192,CLRE 250,A00,891860,Morris; Sheldon,9996,0,9999,3
1745141250243,CLRE 251R,A00,907817,Mehta; Ravindra L.,9995,0,9999,4
1745141251270,CLRE 252,A00,891864,Cuomo; Raphael Eduardo,9994,0,9999,5
1745141252300,CLRE 253,A00,891867,Vaida; Florin,9995,0,9999,4
1745141252300,CLRE 253,B00,907819,Staff,9999,0,9999,0
1745141253324,CLRE 259,A00,891868,Patel; Hemal,9998,0,9999,1
1745141254354,CLRE 260,A00,891872,Cuomo; Raphael Eduardo,9999,0,9999,0
1745141255382,CLRE 297,001,891888,Cuomo; Raphael Eduardo,9999,0,9999,0
1745141256409,CSS 201S,A01,892054,Mignozzetti; Umberto,30,0,30,0
1745141257436,CSS 202S,A01,892056,Mignozzetti; Umberto,30,0,30,0
1745141258462,DSC 197,001,956898,Eldridge; Justin Matthew,9998,0,9999,1
1745141259489,DSC 297,001,958000,Mazumdar; Arya,9999,0,9999,0
1745141260521,EAP 100,A00,905686,Staff,9774,0,9999,225
1745141261551,ECE 45,A01,892618,Staff,0,2,50,50
1745141262582,ECE 109,A01,892620,Staff,0,44,0,0
1745141263610,ECE 111,A01,892719,Staff,0,0,50,50
1745141264641,ECE 197,001,957920,Mercier; Patrick Philip,9992,0,9999,7
1745141265668,ECON 178,A01,907814,Zhu; Ying,29,0,35,6
1745141266695,EDS 115,A00,895312,Staff,42,0,45,3
1745141267720,EDS 117,A01,895337,Staff,30,0,30,0
1745141268748,EDS 125,A00,895341,Jones; Gabrielle Anastasia,43,0,45,2
1745141269780,EDS 128A,A01,895459,Fargason; Sharon Gayle,45,0,45,0
1745141270810,EDS 128B,A01,895543,Pappas; Elizabeth,45,0,45,0
1745141271839,EDS 139,A00,897203,Pappas; Elizabeth,45,0,45,0
1745141271839,EDS 139,B00,897209,Fargason; Sharon Gayle,45,0,45,0
1745141272866,EDS 201,A00,895545,Staff,44,0,45,1
1745141273892,EDS 203,A01,895581,Halter; Christopher P.,44,0,45,1
1745141274926,EDS 204R,A01,895625,Heinzman; Erica M.,45,0,45,0
1745141274926,EDS 204R,B01,895693,Halter; Christopher P.,28,0,45,17
1745141275954,EDS 206R,A00,895694,Fargason; Sharon Gayle,22,0,30,8
1745141275954,EDS 206R,B00,895695,Choi; Bailey Miyeon,21,0,30,9
1745141276978,EDS 250,A00,895697,Hemans; Patricia Ann Benitez,44,0,45,1
1745141278006,EDS 281,A00,895701,Meyerott; Theresa Ann,15,0,15,0
1745141279038,EDS 284,A00,895736,Meyerott; Theresa Ann,15,0,15,0
1745141280067,EDS 286,A00,897210,Fine; Sarah,15,0,15,0
1745141281095,EDS 289C,A01,895770,Daly; Alan J.,15,0,15,0
1745141282121,EDS 290,A00,897211,Hofstetter; Carolyn,15,0,15,0
1745141283695,LIGM 5A,A00,896162,Fischer-Grunski; Eva K,16,0,20,4
1745141284722,LIGM 5B,A00,896260,Fischer-Grunski; Eva K,19,0,20,1
1745141285753,LIGM 5C,A00,896308,Fischer-Grunski; Eva K,19,0,20,1
1745141286783,LIIT 5AS,A00,896313,Carnelos; Chiara,18,0,20,2
1745141287809,LIIT 5BS,A00,896416,Carnelos; Chiara,20,0,20,0
1745141288835,LIIT 5CS,A00,896564,Carnelos; Chiara,20,0,20,0
1745141289862,LISP 5A,A00,896588,Munoz Sanchez; Alicia,7,0,20,13
1745141290892,LISP 5B,A00,896653,Munoz Sanchez; Alicia,10,0,20,10
1745141291918,LISP 5C,A00,896655,Munoz Sanchez; Alicia,9,0,20,11
1745141292948,MAE 197,001,957918,Kleissl; Jan,9998,0,9999,1
1745141293974,MATH 2,A01,957937,Staff,34,0,35,1
1745141295000,MATH 197,001,957876,Kedlaya; Kiran S.,9996,0,9999,3
1745141296027,MCWP 40,A00,892729,Duru; Nur,16,0,20,4
1745141296027,MCWP 40,B00,893304,Montejo; Carolina,20,0,20,0
1745141297058,MCWP 40R,A00,893757,Redela; Pamela Morgan,0,3,20,20
1745141298088,MCWP 50,A00,893758,Morshed; Michael James,4,0,20,16
1745141298088,MCWP 50,B00,893761,Bartulis; Jason Michael,18,0,20,2
1745141299122,MCWP 50R,A00,893766,Compas; Sean Matthew,0,1,20,20
1745141299122,MCWP 50R,B00,893769,Carter; Jennifer A,5,0,20,15
1745141299122,MCWP 50R,C00,893771,Krone; Jarret,0,3,20,20
1745141299122,MCWP 50R,D00,893772,Miller; Elizabeth Deen,4,0,20,16
1745141299122,MCWP 50R,E00,893775,Carter; Andrea L,0,0,20,20
1745141300155,MMW 11R,A01,892721,Herbst; Matthew,22,0,30,8
1745141300155,MMW 11R,A02,892722,Herbst; Matthew,28,0,30,2
1745141301182,MMW 12R,A01,892724,Herbst; Matthew,0,5,16,16
1745141301182,MMW 12R,A02,892725,Herbst; Matthew,0,4,16,16
1745141302210,MMW 13R,A01,892727,Staff,0,29,16,16
1745141302210,MMW 13R,A02,892728,Staff,0,28,16,16
1745141303235,SIO 295LS,A00,894015,Staff,9,0,25,16
1745141304262,SIO 295S,A00,894020,Staff,9,0,25,16
1745141305294,SIOC 290S,A01,894063,Merrifield; Mark A,23,0,25,2
1745141306325,SIOC 291S,A01,894137,Gabriel; Corey John,23,0,25,2
1745141307351,SOCI 117,A01,895339,Staff,5,0,5,0
1745141308377,WES 237B,A00,894149,Staff,20,0,20,0
1745141310446,AESE 279B,A00,891859,Staff,35,0,35,0
1745141311473,AIP 197,001,891854,Staff,70,0,70,0
1745141312502,ANTH 289S,A00,891856,Gagneux; Pascal,12,0,12,0
1745141313528,BENG 196,001,957946,Engler; Adam J.,9996,0,9999,3
1745141314558,CAT 124RS,A01,956906,Staff,8,0,25,17
1745141315585,CAT 125RS,A01,922013,Staff,8,0,25,17
1745141316616,CLRE 250,A00,891860,Morris; Sheldon,9996,0,9999,3
1745141318670,CLRE 251R,A00,907817,Mehta; Ravindra L.,9995,0,9999,4
1745141319699,CLRE 252,A00,891864,Cuomo; Raphael Eduardo,9994,0,9999,5
1745141320727,CLRE 253,A00,891867,Vaida; Florin,9995,0,9999,4
1745141320727,CLRE 253,B00,907819,Staff,9999,0,9999,0
1745141321757,CLRE 259,A00,891868,Patel; Hemal,9998,0,9999,1
1745141322784,CLRE 260,A00,891872,Cuomo; Raphael Eduardo,9999,0,9999,0
1745141323810,CLRE 297,001,891888,Cuomo; Raphael Eduardo,9999,0,9999,0
1745141324837,CSS 201S,A01,892054,Mignozzetti; Umberto,30,0,30,0
1745141325865,CSS 202S,A01,892056,Mignozzetti; Umberto,30,0,30,0
1745141326892,DSC 197,001,956898,Eldridge; Justin Matthew,9998,0,9999,1
1745141327917,DSC 297,001,958000,Mazumdar; Arya,9999,0,9999,0
1745141328946,EAP 100,A00,905686,Staff,9774,0,9999,225
1745141329972,ECE 45,A01,892618,Staff,0,2,50,50
1745141330997,ECE 109,A01,892620,Staff,0,44,0,0
1745141332027,ECE 111,A01,892719,Staff,0,0,50,50
1745141333056,ECE 197,001,957920,Mercier; Patrick Philip,9992,0,9999,7
1745141334088,ECON 178,A01,907814,Zhu; Ying,29,0,35,6
1745141335115,EDS 115,A00,895312,Staff,42,0,45,3
1745141336141,EDS 117,A01,895337,Staff,30,0,30,0
1745141337168,EDS 125,A00,895341,Jones; Gabrielle Anastasia,43,0,45,2
1745141338195,EDS 128A,A01,895459,Fargason; Sharon Gayle,45,0,45,0
1745141339225,EDS 128B,A01,895543,Pappas; Elizabeth,45,0,45,0
1745141340255,EDS 139,A00,897203,Pappas; Elizabeth,45,0,45,0
1745141340255,EDS 139,B00,897209,Fargason; Sharon Gayle,45,0,45,0
1745141341285,EDS 201,A00,895545,Staff,44,0,45,1
1745141342317,EDS 203,A01,895581,Halter; Christopher P.,44,0,45,1
1745141343349,EDS 204R,A01,895625,Heinzman; Erica M.,45,0,45,0
1745141343349,EDS 204R,B01,895693,Halter; Christopher P.,28,0,45,17
1745141344377,EDS 206R,A00,895694,Fargason; Sharon Gayle,22,0,30,8
1745141344377,EDS 206R,B00,895695,Choi; Bailey Miyeon,21,0,30,9
1745141345403,EDS 250,A00,895697,Hemans; Patricia Ann Benitez,44,0,45,1
1745141346430,EDS 281,A00,895701,Meyerott; Theresa Ann,15,0,15,0
1745141347457,EDS 284,A00,895736,Meyerott; Theresa Ann,15,0,15,0
1745141348484,EDS 286,A00,897210,Fine; Sarah,15,0,15,0
1745141349510,EDS 289C,A01,895770,Daly; Alan J.,15,0,15,0
1745141350536,EDS 290,A00,897211,Hofstetter; Carolyn,15,0,15,0
1745141351563,LIGM 5A,A00,896162,Fischer-Grunski; Eva K,16,0,20,4
1745141352591,LIGM 5B,A00,896260,Fischer-Grunski; Eva K,19,0,20,1
1745141353617,LIGM 5C,A00,896308,Fischer-Grunski; Eva K,19,0,20,1
1745141354646,LIIT 5AS,A00,896313,Carnelos; Chiara,18,0,20,2
1745141355677,LIIT 5BS,A00,896416,Carnelos; Chiara,20,0,20,0
1745141356704,LIIT 5CS,A00,896564,Carnelos; Chiara,20,0,20,0
1745141357731,LISP 5A,A00,896588,Munoz Sanchez; Alicia,7,0,20,13
1745141358758,LISP 5B,A00,896653,Munoz Sanchez; Alicia,10,0,20,10
1745141359787,LISP 5C,A00,896655,Munoz Sanchez; Alicia,9,0,20,11
1745141360814,MAE 197,001,957918,Kleissl; Jan,9998,0,9999,1
1745141361844,MATH 2,A01,957937,Staff,34,0,35,1
1745141362872,MATH 197,001,957876,Kedlaya; Kiran S.,9996,0,9999,3
1745141363901,MCWP 40,A00,892729,Duru; Nur,16,0,20,4
1745141363901,MCWP 40,B00,893304,Montejo; Carolina,20,0,20,0
1745141364926,MCWP 40R,A00,893757,Redela; Pamela Morgan,0,3,20,20
1745141365951,MCWP 50,A00,893758,Morshed; Michael James,4,0,20,16
1745141365951,MCWP 50,B00,893761,Bartulis; Jason Michael,18,0,20,2
1745141366977,MCWP 50R,A00,893766,Compas; Sean Matthew,0,1,20,20
1745141366977,MCWP 50R,B00,893769,Carter; Jennifer A,5,0,20,15
1745141366977,MCWP 50R,C00,893771,Krone; Jarret,0,3,20,20
1745141366977,MCWP 50R,D00,893772,Miller; Elizabeth Deen,4,0,20,16
1745141366977,MCWP 50R,E00,893775,Carter; Andrea L,0,0,20,20
1745141368007,MMW 11R,A01,892721,Herbst; Matthew,22,0,30,8
1745141368007,MMW 11R,A02,892722,Herbst; Matthew,28,0,30,2
1745141369035,MMW 12R,A01,892724,Herbst; Matthew,0,5,16,16
1745141369035,MMW 12R,A02,892725,Herbst; Matthew,0,4,16,16
1745141370062,MMW 13R,A01,892727,Staff,0,29,16,16
1745141370062,MMW 13R,A02,892728,Staff,0,28,16,16
1745141371088,SIO 295LS,A00,894015,Staff,9,0,25,16
1745141372117,SIO 295S,A00,894020,Staff,9,0,25,16
1745141373142,SIOC 290S,A01,894063,Merrifield; Mark A,23,0,25,2
1745141374170,SIOC 291S,A01,894137,Gabriel; Corey John,23,0,25,2
1745141375196,SOCI 117,A01,895339,Staff,5,0,5,0
1745141376222,WES 237B,A00,894149,Staff,20,0,20,0
1745141378301,AESE 279B,A00,891859,Staff,35,0,35,0
1745141379324,AIP 197,001,891854,Staff,70,0,70,0
1745141380351,ANTH 289S,A00,891856,Gagneux; Pascal,12,0,12,0
1745141381377,BENG 196,001,957946,Engler; Adam J.,9996,0,9999,3
1745141382402,CAT 124RS,A01,956906,Staff,8,0,25,17
1745141383428,CAT 125RS,A01,922013,Staff,8,0,25,17
1745141384454,CLRE 250,A00,891860,Morris; Sheldon,9996,0,9999,3
1745141386511,CLRE 251R,A00,907817,Mehta; Ravindra L.,9995,0,9999,4
1745141387539,CLRE 252,A00,891864,Cuomo; Raphael Eduardo,9994,0,9999,5
1745141388565,CLRE 253,A00,891867,Vaida; Florin,9995,0,9999,4
1745141388565,CLRE 253,B00,907819,Staff,9999,0,9999,0
1745141389593,CLRE 259,A00,891868,Patel; Hemal,9998,0,9999,1
1745141390617,CLRE 260,A00,891872,Cuomo; Raphael Eduardo,9999,0,9999,0
1745141391643,CLRE 297,001,891888,Cuomo; Raphael Eduardo,9999,0,9999,0
1745141392670,CSS 201S,A01,892054,Mignozzetti; Umberto,30,0,30,0
1745141393700,CSS 202S,A01,892056,Mignozzetti; Umberto,30,0,30,0
1745141394726,DSC 197,001,956898,Eldridge; Justin Matthew,9998,0,9999,1
1745141395755,DSC 297,001,958000,Mazumdar; Arya,9999,0,9999,0
1745141396781,EAP 100,A00,905686,Staff,9774,0,9999,225
1745141397807,ECE 45,A01,892618,Staff,0,2,50,50
1745141398832,ECE 109,A01,892620,Staff,0,44,0,0
1745141399858,ECE 111,A01,892719,Staff,0,0,50,50
1745141400884,ECE 197,001,957920,Mercier; Patrick Philip,9992,0,9999,7
1745141401911,ECON 178,A01,907814,Zhu; Ying,29,0,35,6
1745141402938,EDS 115,A00,895312,Staff,42,0,45,3
1745141403963,EDS 117,A01,895337,Staff,30,0,30,0
1745141404993,EDS 125,A00,895341,Jones; Gabrielle Anastasia,43,0,45,2
1745141406023,EDS 128A,A01,895459,Fargason; Sharon Gayle,45,0,45,0
1745141407050,EDS 128B,A01,895543,Pappas; Elizabeth,45,0,45,0
1745141408077,EDS 139,A00,897203,Pappas; Elizabeth,45,0,45,0
1745141408077,EDS 139,B00,897209,Fargason; Sharon Gayle,45,0,45,0
1745141409103,EDS 201,A00,895545,Staff,44,0,45,1
1745141410130,EDS 203,A01,895581,Halter; Christopher P.,44,0,45,1
1745141411157,EDS 204R,A01,895625,Heinzman; Erica M.,45,0,45,0
1745141411157,EDS 204R,B01,895693,Halter; Christopher P.,28,0,45,17
1745141412182,EDS 206R,A00,895694,Fargason; Sharon Gayle,22,0,30,8
1745141412182,EDS 206R,B00,895695,Choi; Bailey Miyeon,21,0,30,9
1745141413209,EDS 250,A00,895697,Hemans; Patricia Ann Benitez,44,0,45,1
1745141414234,EDS 281,A00,895701,Meyerott; Theresa Ann,15,0,15,0
1745141415260,EDS 284,A00,895736,Meyerott; Theresa Ann,15,0,15,0
1745141416287,EDS 286,A00,897210,Fine; Sarah,15,0,15,0
1745141417312,EDS 289C,A01,895770,Daly; Alan J.,15,0,15,0
1745141418338,EDS 290,A00,897211,Hofstetter; Carolyn,15,0,15,0
1745141419366,LIGM 5A,A00,896162,Fischer-Grunski; Eva K,16,0,20,4
1745141420392,LIGM 5B,A00,896260,Fischer-Grunski; Eva K,19,0,20,1
1745141421418,LIGM 5C,A00,896308,Fischer-Grunski; Eva K,19,0,20,1
1745141422443,LIIT 5AS,A00,896313,Carnelos; Chiara,18,0,20,2
1745141423470,LIIT 5BS,A00,896416,Carnelos; Chiara,20,0,20,0
1745141424497,LIIT 5CS,A00,896564,Carnelos; Chiara,20,0,20,0
1745141425527,LISP 5A,A00,896588,Munoz Sanchez; Alicia,7,0,20,13
1745141426555,LISP 5B,A00,896653,Munoz Sanchez; Alicia,10,0,20,10
1745141427585,LISP 5C,A00,896655,Munoz Sanchez; Alicia,9,0,20,11
1745141428611,MAE 197,001,957918,Kleissl; Jan,9998,0,9999,1
1745141429640,MATH 2,A01,957937,Staff,34,0,35,1
1745141430667,MATH 197,001,957876,Kedlaya; Kiran S.,9996,0,9999,3
1745141431701,MCWP 40,A00,892729,Duru; Nur,16,0,20,4
1745141431701,MCWP 40,B00,893304,Montejo; Carolina,20,0,20,0
1745141432728,MCWP 40R,A00,893757,Redela; Pamela Morgan,0,3,20,20
1745141433755,MCWP 50,A00,893758,Morshed; Michael James,4,0,20,16
1745141433755,MCWP 50,B00,893761,Bartulis; Jason Michael,18,0,20,2
1745141434785,MCWP 50R,A00,893766,Compas; Sean Matthew,0,1,20,20
1745141434785,MCWP 50R,B00,893769,Carter; Jennifer A,5,0,20,15
1745141434785,MCWP 50R,C00,893771,Krone; Jarret,0,3,20,20
1745141434785,MCWP 50R,D00,893772,Miller; Elizabeth Deen,4,0,20,16
1745141434785,MCWP 50R,E00,893775,Carter; Andrea L,0,0,20,20
1745141435812,MMW 11R,A01,892721,Herbst; Matthew,22,0,30,8
1745141435812,MMW 11R,A02,892722,Herbst; Matthew,28,0,30,2
1745141436838,MMW 12R,A01,892724,Herbst; Matthew,0,5,16,16
1745141436838,MMW 12R,A02,892725,Herbst; Matthew,0,4,16,16
1745141437867,MMW 13R,A01,892727,Staff,0,29,16,16
1745141437867,MMW 13R,A02,892728,Staff,0,28,16,16
1745141438893,SIO 295LS,A00,894015,Staff,9,0,25,16
1745141439923,SIO 295S,A00,894020,Staff,9,0,25,16
1745141440950,SIOC 290S,A01,894063,Merrifield; Mark A,23,0,25,2
1745141441976,SIOC 291S,A01,894137,Gabriel; Corey John,23,0,25,2
1745141443004,SOCI 117,A01,895339,Staff,5,0,5,0
1745141444030,WES 237B,A00,894149,Staff,20,0,20,0
1745141446096,AESE 279B,A00,891859,Staff,35,0,35,0
1745141447121,AIP 197,001,891854,Staff,70,0,70,0
1745141448148,ANTH 289S,A00,891856,Gagneux; Pascal,12,0,12,0
1745141449172,BENG 196,001,957946,Engler; Adam J.,9996,0,9999,3
1745141450202,CAT 124RS,A01,956906,Staff,8,0,25,17
1745141451232,CAT 125RS,A01,922013,Staff,8,0,25,17
1745141452259,CLRE 250,A00,891860,Morris; Sheldon,9996,0,9999,3
1745141454313,CLRE 251R,A00,907817,Mehta; Ravindra L.,9995,0,9999,4
1745141455338,CLRE 252,A00,891864,Cuomo; Raphael Eduardo,9994,0,9999,5
1745141456366,CLRE 253,A00,891867,Vaida; Florin,9995,0,9999,4
1745141456366,CLRE 253,B00,907819,Staff,9999,0,9999,0
1745141457396,CLRE 259,A00,891868,Patel; Hemal,9998,0,9999,1
1745141458422,CLRE 260,A00,891872,Cuomo; Raphael Eduardo,9999,0,9999,0
1745141459452,CLRE 297,001,891888,Cuomo; Raphael Eduardo,9999,0,9999,0
1745141460484,CSS 201S,A01,892054,Mignozzetti; Umberto,30,0,30,0
1745141461516,CSS 202S,A01,892056,Mignozzetti; Umberto,30,0,30,0
1745141462545,DSC 197,001,956898,Eldridge; Justin Matthew,9998,0,9999,1
1745141463576,DSC 297,001,958000,Mazumdar; Arya,9999,0,9999,0
1745141464606,EAP 100,A00,905686,Staff,9774,0,9999,225
1745141465634,ECE 45,A01,892618,Staff,0,2,50,50
1745141466660,ECE 109,A01,892620,Staff,0,44,0,0
1745141467689,ECE 111,A01,892719,Staff,0,0,50,50
1745141468714,ECE 197,001,957920,Mercier; Patrick Philip,9992,0,9999,7
1745141469742,ECON 178,A01,907814,Zhu; Ying,29,0,35,6
1745141470768,EDS 115,A00,895312,Staff,42,0,45,3
1745141471794,EDS 117,A01,895337,Staff,30,0,30,0
1745141472820,EDS 125,A00,895341,Jones; Gabrielle Anastasia,43,0,45,2
1745141473847,EDS 128A,A01,895459,Fargason; Sharon Gayle,45,0,45,0
1745141474873,EDS 128B,A01,895543,Pappas; Elizabeth,45,0,45,0
1745141475899,EDS 139,A00,897203,Pappas; Elizabeth,45,0,45,0
1745141475899,EDS 139,B00,897209,Fargason; Sharon Gayle,45,0,45,0
1745141476924,EDS 201,A00,895545,Staff,44,0,45,1
1745141477951,EDS 203,A01,895581,Halter; Christopher P.,44,0,45,1
1745141478980,EDS 204R,A01,895625,Heinzman; Erica M.,45,0,45,0
1745141478980,EDS 204R,B01,895693,Halter; Christopher P.,28,0,45,17
1745141480007,EDS 206R,A00,895694,Fargason; Sharon Gayle,22,0,30,8
1745141480007,EDS 206R,B00,895695,Choi; Bailey Miyeon,21,0,30,9
1745141481033,EDS 250,A00,895697,Hemans; Patricia Ann Benitez,44,0,45,1
1745141482060,EDS 281,A00,895701,Meyerott; Theresa Ann,15,0,15,0
1745141483089,EDS 284,A00,895736,Meyerott; Theresa Ann,15,0,15,0
1745141484115,EDS 286,A00,897210,Fine; Sarah,15,0,15,0
1745141485141,EDS 289C,A01,895770,Daly; Alan J.,15,0,15,0
1745141486170,EDS 290,A00,897211,Hofstetter; Carolyn,15,0,15,0
1745141487201,LIGM 5A,A00,896162,Fischer-Grunski; Eva K,16,0,20,4
1745141488228,LIGM 5B,A00,896260,Fischer-Grunski; Eva K,19,0,20,1
1745141489258,LIGM 5C,A00,896308,Fischer-Grunski; Eva K,19,0,20,1
1745141490283,LIIT 5AS,A00,896313,Carnelos; Chiara,18,0,20,2
1745141491309,LIIT 5BS,A00,896416,Carnelos; Chiara,20,0,20,0
1745141492339,LIIT 5CS,A00,896564,Carnelos; Chiara,20,0,20,0
1745141493364,LISP 5A,A00,896588,Munoz Sanchez; Alicia,7,0,20,13
1745141494389,LISP 5B,A00,896653,Munoz Sanchez; Alicia,10,0,20,10
1745141495418,LISP 5C,A00,896655,Munoz Sanchez; Alicia,9,0,20,11
1745141496447,MAE 197,001,957918,Kleissl; Jan,9998,0,9999,1
1745141497476,MATH 2,A01,957937,Staff,34,0,35,1
1745141498505,MATH 197,001,957876,Kedlaya; Kiran S.,9996,0,9999,3
1745141499534,MCWP 40,A00,892729,Duru; Nur,16,0,20,4
1745141499534,MCWP 40,B00,893304,Montejo; Carolina,20,0,20,0
1745141500565,MCWP 40R,A00,893757,Redela; Pamela Morgan,0,3,20,20
1745141501590,MCWP 50,A00,893758,Morshed; Michael James,4,0,20,16
1745141501590,MCWP 50,B00,893761,Bartulis; Jason Michael,18,0,20,2
1745141502622,MCWP 50R,A00,893766,Compas; Sean Matthew,0,1,20,20
1745141502622,MCWP 50R,B00,893769,Carter; Jennifer A,5,0,20,15
1745141502622,MCWP 50R,C00,893771,Krone; Jarret,0,3,20,20
1745141502622,MCWP 50R,D00,893772,Miller; Elizabeth Deen,4,0,20,16
1745141502622,MCWP 50R,E00,893775,Carter; Andrea L,0,0,20,20
1745141503651,MMW 11R,A01,892721,Herbst; Matthew,22,0,30,8
1745141503651,MMW 11R,A02,892722,Herbst; Matthew,28,0,30,2
1745141504678,MMW 12R,A01,892724,Herbst; Matthew,0,5,16,16
1745141504678,MMW 12R,A02,892725,Herbst; Matthew,0,4,16,16
1745141505703,MMW 13R,A01,892727,Staff,0,29,16,16
1745141505703,MMW 13R,A02,892728,Staff,0,28,16,16
1745141506729,SIO 295LS,A00,894015,Staff,9,0,25,16
1745141507756,SIO 295S,A00,894020,Staff,9,0,25,16
1745141508787,SIOC 290S,A01,894063,Merrifield; Mark A,23,0,25,2
1745141509820,SIOC 291S,A01,894137,Gabriel; Corey John,23,0,25,2
1745141510847,SOCI 117,A01,895339,Staff,5,0,5,0
1745141511875,WES 237B,A00,894149,Staff,20,0,20,0
1745141513949,AESE 279B,A00,891859,Staff,35,0,35,0
1745141514975,AIP 197,001,891854,Staff,70,0,70,0
1745141516001,ANTH 289S,A00,891856,Gagneux; Pascal,12,0,12,0
1745141517028,BENG 196,001,957946,Engler; Adam J.,9996,0,9999,3
1745141518057,CAT 124RS,A01,956906,Staff,8,0,25,17
1745141519085,CAT 125RS,A01,922013,Staff,8,0,25,17
1745141520114,CLRE 250,A00,891860,Morris; Sheldon,9996,0,9999,3
1745141522168,CLRE 251R,A00,907817,Mehta; Ravindra L.,9995,0,9999,4
1745141523196,CLRE 252,A00,891864,Cuomo; Raphael Eduardo,9994,0,9999,5
1745141524232,CLRE 253,A00,891867,Vaida; Florin,9995,0,9999,4
1745141524232,CLRE 253,B00,907819,Staff,9999,0,9999,0
1745141525261,CLRE 259,A00,891868,Patel; Hemal,9998,0,9999,1
1745141526287,CLRE 260,A00,891872,Cuomo; Raphael Eduardo,9999,0,9999,0
1745141527314,CLRE 297,001,891888,Cuomo; Raphael Eduardo,9999,0,9999,0
1745141528341,CSS 201S,A01,892054,Mignozzetti; Umberto,30,0,30,0
1745141529366,CSS 202S,A01,892056,Mignozzetti; Umberto,30,0,30,0
1745141530392,DSC 197,001,956898,Eldridge; Justin Matthew,9998,0,9999,1
1745141531417,DSC 297,001,958000,Mazumdar; Arya,9999,0,9999,0
1745141532444,EAP 100,A00,905686,Staff,9774,0,9999,225
1745141533476,ECE 45,A01,892618,Staff,0,2,50,50
1745141534507,ECE 109,A01,892620,Staff,0,44,0,0
1745141535585,ECE 111,A01,892719,Staff,0,0,50,50
1745141536615,ECE 197,001,957920,Mercier; Patrick Philip,9992,0,9999,7
1745141537649,ECON 178,A01,907814,Zhu; Ying,29,0,35,6
1745141538679,EDS 115,A00,895312,Staff,42,0,45,3
1745141539711,EDS 117,A01,895337,Staff,30,0,30,0
1745141540739,EDS 125,A00,895341,Jones; Gabrielle Anastasia,43,0,45,2
1745141541765,EDS 128A,A01,895459,Fargason; Sharon Gayle,45,0,45,0
1745141542793,EDS 128B,A01,895543,Pappas; Elizabeth,45,0,45,0
1745141543819,EDS 139,A00,897203,Pappas; Elizabeth,45,0,45,0
1745141543819,EDS 139,B00,897209,Fargason; Sharon Gayle,45,0,45,0
1745141544848,EDS 201,A00,895545,Staff,44,0,45,1
1745141545878,EDS 203,A01,895581,Halter; Christopher P.,44,0,45,1
1745141546906,EDS 204R,A01,895625,Heinzman; Erica M.,45,0,45,0
1745141546906,EDS 204R,B01,895693,Halter; Christopher P.,28,0,45,17
1745141547933,EDS 206R,A00,895694,Fargason; Sharon Gayle,22,0,30,8
1745141547933,EDS 206R,B00,895695,Choi; Bailey Miyeon,21,0,30,9
1745141548958,EDS 250,A00,895697,Hemans; Patricia Ann Benitez,44,0,45,1
1745141549992,EDS 281,A00,895701,Meyerott; Theresa Ann,15,0,15,0
1745141551023,EDS 284,A00,895736,Meyerott; Theresa Ann,15,0,15,0
1745141552051,EDS 286,A00,897210,Fine; Sarah,15,0,15,0
1745141553080,EDS 289C,A01,895770,Daly; Alan J.,15,0,15,0
1745141554109,EDS 290,A00,897211,Hofstetter; Carolyn,15,0,15,0
1745141555146,LIGM 5A,A00,896162,Fischer-Grunski; Eva K,16,0,20,4
1745141556171,LIGM 5B,A00,896260,Fischer-Grunski; Eva K,19,0,20,1
1745141557201,LIGM 5C,A00,896308,Fischer-Grunski; Eva K,19,0,20,1
1745141558226,LIIT 5AS,A00,896313,Carnelos; Chiara,18,0,20,2
1745141559252,LIIT 5BS,A00,896416,Carnelos; Chiara,20,0,20,0
1745141560278,LIIT 5CS,A00,896564,Carnelos; Chiara,20,0,20,0
1745141561305,LISP 5A,A00,896588,Munoz Sanchez; Alicia,7,0,20,13
1745141562331,LISP 5B,A00,896653,Munoz Sanchez; Alicia,10,0,20,10
1745141563360,LISP 5C,A00,896655,Munoz Sanchez; Alicia,9,0,20,11
1745141564389,MAE 197,001,957918,Kleissl; Jan,9998,0,9999,1
1745141565419,MATH 2,A01,957937,Staff,34,0,35,1
1745141566448,MATH 197,001,957876,Kedlaya; Kiran S.,9996,0,9999,3
1745141567476,MCWP 40,A00,892729,Duru; Nur,16,0,20,4
1745141567476,MCWP 40,B00,893304,Montejo; Carolina,20,0,20,0
1745141568507,MCWP 40R,A00,893757,Redela; Pamela Morgan,0,3,20,20
1745141569534,MCWP 50,A00,893758,Morshed; Michael James,4,0,20,16
1745141569534,MCWP 50,B00,893761,Bartulis; Jason Michael,18,0,20,2
1745141570571,MCWP 50R,A00,893766,Compas; Sean Matthew,0,1,20,20
1745141570571,MCWP 50R,B00,893769,Carter; Jennifer A,5,0,20,15
1745141570571,MCWP 50R,C00,893771,Krone; Jarret,0,3,20,20
1745141570571,MCWP 50R,D00,893772,Miller; Elizabeth Deen,4,0,20,16
1745141570571,MCWP 50R,E00,893775,Carter; Andrea L,0,0,20,20
1745141571602,MMW 11R,A01,892721,Herbst; Matthew,22,0,30,8
1745141571602,MMW 11R,A02,892722,Herbst; Matthew,28,0,30,2
1745141572626,MMW 12R,A01,892724,Herbst; Matthew,0,5,16,16
1745141572626,MMW 12R,A02,892725,Herbst; Matthew,0,4,16,16
1745141573652,MMW 13R,A01,892727,Staff,0,29,16,16
1745141573652,MMW 13R,A02,892728,Staff,0,28,16,16
1745141574681,SIO 295LS,A00,894015,Staff,9,0,25,16
1745141575706,SIO 295S,A00,894020,Staff,9,0,25,16
1745141576736,SIOC 290S,A01,894063,Merrifield; Mark A,23,0,25,2
1745141577767,SIOC 291S,A01,894137,Gabriel; Corey John,23,0,25,2
1745141578797,SOCI 117,A01,895339,Staff,5,0,5,0
1745141579821,WES 237B,A00,894149,Staff,20,0,20,0
1745141581921,AESE 279B,A00,891859,Staff,35,0,35,0
1745141582949,AIP 197,001,891854,Staff,70,0,70,0
1745141583979,ANTH 289S,A00,891856,Gagneux; Pascal,12,0,12,0
1745141585008,BENG 196,001,957946,Engler; Adam J.,9996,0,9999,3
1745141586035,CAT 124RS,A01,956906,Staff,8,0,25,17
1745141587060,CAT 125RS,A01,922013,Staff,8,0,25,17
1745141588087,CLRE 250,A00,891860,Morris; Sheldon,9996,0,9999,3
1745141590143,CLRE 251R,A00,907817,Mehta; Ravindra L.,9995,0,9999,4
1745141591171,CLRE 252,A00,891864,Cuomo; Raphael Eduardo,9994,0,9999,5
1745141592199,CLRE 253,A00,891867,Vaida; Florin,9995,0,9999,4
1745141592199,CLRE 253,B00,907819,Staff,9999,0,9999,0
1745141593228,CLRE 259,A00,891868,Patel; Hemal,9998,0,9999,1
1745141594254,CLRE 260,A00,891872,Cuomo; Raphael Eduardo,9999,0,9999,0
1745141595283,CLRE 297,001,891888,Cuomo; Raphael Eduardo,9999,0,9999,0
1745141596315,CSS 201S,A01,892054,Mignozzetti; Umberto,30,0,30,0
1745141597341,CSS 202S,A01,892056,Mignozzetti; Umberto,30,0,30,0
1745141598369,DSC 197,001,956898,Eldridge; Justin Matthew,9998,0,9999,1
1745141599397,DSC 297,001,958000,Mazumdar; Arya,9999,0,9999,0
1745141600423,EAP 100,A00,905686,Staff,9774,0,9999,225
1745141601452,ECE 45,A01,892618,Staff,0,2,50,50
1745141602477,ECE 109,A01,892620,Staff,0,44,0,0
1745141603501,ECE 111,A01,892719,Staff,0,0,50,50
1745141604527,ECE 197,001,957920,Mercier; Patrick Philip,9992,0,9999,7
1745141605553,ECON 178,A01,907814,Zhu; Ying,29,0,35,6
1745141606580,EDS 115,A00,895312,Staff,42,0,45,3
1745141607606,EDS 117,A01,895337,Staff,30,0,30,0
1745141608632,EDS 125,A00,895341,Jones; Gabrielle Anastasia,43,0,45,2
1745141609660,EDS 128A,A01,895459,Fargason; Sharon Gayle,45,0,45,0
1745141610686,EDS 128B,A01,895543,Pappas; Elizabeth,45,0,45,0
1745141611712,EDS 139,A00,897203,Pappas; Elizabeth,45,0,45,0
1745141611712,EDS 139,B00,897209,Fargason; Sharon Gayle,45,0,45,0
1745141612739,EDS 201,A00,895545,Staff,44,0,45,1
1745141613766,EDS 203,A01,895581,Halter; Christopher P.,44,0,45,1
1745141614793,EDS 204R,A01,895625,Heinzman; Erica M.,45,0,45,0
1745141614793,EDS 204R,B01,895693,Halter; Christopher P.,28,0,45,17
1745141615841,EDS 206R,A00,895694,Fargason; Sharon Gayle,22,0,30,8
1745141615841,EDS 206R,B00,895695,Choi; Bailey Miyeon,21,0,30,9
1745141616866,EDS 250,A00,895697,Hemans; Patricia Ann Benitez,44,0,45,1
1745141617891,EDS 281,A00,895701,Meyerott; Theresa Ann,15,0,15,0
1745141618923,EDS 284,A00,895736,Meyerott; Theresa Ann,15,0,15,0
1745141619948,EDS 286,A00,897210,Fine; Sarah,15,0,15,0
1745141620975,EDS 289C,A01,895770,Daly; Alan J.,15,0,15,0
1745141622002,EDS 290,A00,897211,Hofstetter; Carolyn,15,0,15,0
1745141623026,LIGM 5A,A00,896162,Fischer-Grunski; Eva K,16,0,20,4
1745141624052,LIGM 5B,A00,896260,Fischer-Grunski; Eva K,19,0,20,1
1745141625078,LIGM 5C,A00,896308,Fischer-Grunski; Eva K,19,0,20,1
1745141626105,LIIT 5AS,A00,896313,Carnelos; Chiara,18,0,20,2
1745141627134,LIIT 5BS,A00,896416,Carnelos; Chiara,20,0,20,0
1745141628160,LIIT 5CS,A00,896564,Carnelos; Chiara,20,0,20,0
1745141629185,LISP 5A,A00,896588,Munoz Sanchez; Alicia,7,0,20,13
1745141630211,LISP 5B,A00,896653,Munoz Sanchez; Alicia,10,0,20,10
1745141631241,LISP 5C,A00,896655,Munoz Sanchez; Alicia,9,0,20,11
1745141632269,MAE 197,001,957918,Kleissl; Jan,9998,0,9999,1
1745141633298,MATH 2,A01,957937,Staff,34,0,35,1
1745141634325,MATH 197,001,957876,Kedlaya; Kiran S.,9996,0,9999,3
1745141635351,MCWP 40,A00,892729,Duru; Nur,16,0,20,4
1745141635351,MCWP 40,B00,893304,Montejo; Carolina,20,0,20,0
1745141636377,MCWP 40R,A00,893757,Redela; Pamela Morgan,0,3,20,20
1745141637401,MCWP 50,A00,893758,Morshed; Michael James,4,0,20,16
1745141637401,MCWP 50,B00,893761,Bartulis; Jason Michael,18,0,20,2
1745141638434,MCWP 50R,A00,893766,Compas; Sean Matthew,0,1,20,20
1745141638434,MCWP 50R,B00,893769,Carter; Jennifer A,5,0,20,15
1745141638434,MCWP 50R,C00,893771,Krone; Jarret,0,3,20,20
1745141638434,MCWP 50R,D00,893772,Miller; Elizabeth Deen,4,0,20,16
1745141638434,MCWP 50R,E00,893775,Carter; Andrea L,0,0,20,20
1745141639465,MMW 11R,A01,892721,Herbst; Matthew,22,0,30,8
1745141639465,MMW 11R,A02,892722,Herbst; Matthew,28,0,30,2
1745141640492,MMW 12R,A01,892724,Herbst; Matthew,0,5,16,16
1745141640492,MMW 12R,A02,892725,Herbst; Matthew,0,4,16,16
1745141641519,MMW 13R,A01,892727,Staff,0,29,16,16
1745141641519,MMW 13R,A02,892728,Staff,0,28,16,16
1745141642545,SIO 295LS,A00,894015,Staff,9,0,25,16
1745141643574,SIO 295S,A00,894020,Staff,9,0,25,16
1745141644601,SIOC 290S,A01,894063,Merrifield; Mark A,23,0,25,2
1745141645631,SIOC 291S,A01,894137,Gabriel; Corey John,23,0,25,2
1745141646660,SOCI 117,A01,895339,Staff,5,0,5,0
1745141647689,WES 237B,A00,894149,Staff,20,0,20,0
1745141649776,AESE 279B,A00,891859,Staff,35,0,35,0
1745141650805,AIP 197,001,891854,Staff,70,0,70,0
1745141651831,ANTH 289S,A00,891856,Gagneux; Pascal,12,0,12,0
1745141652861,BENG 196,001,957946,Engler; Adam J.,9996,0,9999,3
1745141653886,CAT 124RS,A01,956906,Staff,8,0,25,17
1745141654910,CAT 125RS,A01,922013,Staff,8,0,25,17
1745141655938,CLRE 250,A00,891860,Morris; Sheldon,9996,0,9999,3
1745141657987,CLRE 251R,A00,907817,Mehta; Ravindra L.,9995,0,9999,4
1745141659014,CLRE 252,A00,891864,Cuomo; Raphael Eduardo,9994,0,9999,5
1745141660040,CLRE 253,A00,891867,Vaida; Florin,9995,0,9999,4
1745141660040,CLRE 253,B00,907819,Staff,9999,0,9999,0
1745141661065,CLRE 259,A00,891868,Patel; Hemal,9998,0,9999,1
1745141662090,CLRE 260,A00,891872,Cuomo; Raphael Eduardo,9999,0,9999,0
1745141663120,CLRE 297,001,891888,Cuomo; Raphael Eduardo,9999,0,9999,0
1745141664146,CSS 201S,A01,892054,Mignozzetti; Umberto,30,0,30,0
1745141665177,CSS 202S,A01,892056,Mignozzetti; Umberto,30,0,30,0
1745141666203,DSC 197,001,956898,Eldridge; Justin Matthew,9998,0,9999,1
1745141667234,DSC 297,001,958000,Mazumdar; Arya,9999,0,9999,0
1745141668259,EAP 100,A00,905686,Staff,9774,0,9999,225
1745141669283,ECE 45,A01,892618,Staff,0,2,50,50
1745141670313,ECE 109,A01,892620,Staff,0,44,0,0
1745141671338,ECE 111,A01,892719,Staff,0,0,50,50
1745141672365,ECE 197,001,957920,Mercier; Patrick Philip,9992,0,9999,7
1745141673391,ECON 178,A01,907814,Zhu; Ying,29,0,35,6
1745141674416,EDS 115,A00,895312,Staff,42,0,45,3
1745141675444,EDS 117,A01,895337,Staff,30,0,30,0
1745141676474,EDS 125,A00,895341,Jones; Gabrielle Anastasia,43,0,45,2
1745141677499,EDS 128A,A01,895459,Fargason; Sharon Gayle,45,0,45,0
1745141678526,EDS 128B,A01,895543,Pappas; Elizabeth,45,0,45,0
1745141679557,EDS 139,A00,897203,Pappas; Elizabeth,45,0,45,0
1745141679557,EDS 139,B00,897209,Fargason; Sharon Gayle,45,0,45,0
1745141680585,EDS 201,A00,895545,Staff,44,0,45,1
1745141681610,EDS 203,A01,895581,Halter; Christopher P.,44,0,45,1
1745141682634,EDS 204R,A01,895625,Heinzman; Erica M.,45,0,45,0
1745141682634,EDS 204R,B01,895693,Halter; Christopher P.,28,0,45,17
1745141683659,EDS 206R,A00,895694,Fargason; Sharon Gayle,22,0,30,8
1745141683659,EDS 206R,B00,895695,Choi; Bailey Miyeon,21,0,30,9
1745141684689,EDS 250,A00,895697,Hemans; Patricia Ann Benitez,44,0,45,1
1745141685720,EDS 281,A00,895701,Meyerott; Theresa Ann,15,0,15,0
1745141686747,EDS 284,A00,895736,Meyerott; Theresa Ann,15,0,15,0
1745141687774,EDS 286,A00,897210,Fine; Sarah,15,0,15,0
1745141688801,EDS 289C,A01,895770,Daly; Alan J.,15,0,15,0
1745141689826,EDS 290,A00,897211,Hofstetter; Carolyn,15,0,15,0
1745141690856,LIGM 5A,A00,896162,Fischer-Grunski; Eva K,16,0,20,4
1745141691888,LIGM 5B,A00,896260,Fischer-Grunski; Eva K,19,0,20,1
1745141692917,LIGM 5C,A00,896308,Fischer-Grunski; Eva K,19,0,20,1
1745141693949,LIIT 5AS,A00,896313,Carnelos; Chiara,18,0,20,2
1745141694976,LIIT 5BS,A00,896416,Carnelos; Chiara,20,0,20,0
1745141696005,LIIT 5CS,A00,896564,Carnelos; Chiara,20,0,20,0
1745141697034,LISP 5A,A00,896588,Munoz Sanchez; Alicia,7,0,20,13
1745141698060,LISP 5B,A00,896653,Munoz Sanchez; Alicia,10,0,20,10
1745141699090,LISP 5C,A00,896655,Munoz Sanchez; Alicia,9,0,20,11
1745141700121,MAE 197,001,957918,Kleissl; Jan,9998,0,9999,1
1745141701148,MATH 2,A01,957937,Staff,34,0,35,1
1745141702178,MATH 197,001,957876,Kedlaya; Kiran S.,9996,0,9999,3
1745141703209,MCWP 40,A00,892729,Duru; Nur,16,0,20,4
1745141703209,MCWP 40,B00,893304,Montejo; Carolina,20,0,20,0
1745141704237,MCWP 40R,A00,893757,Redela; Pamela Morgan,0,3,20,20
1745141705263,MCWP 50,A00,893758,Morshed; Michael James,4,0,20,16
1745141705263,MCWP 50,B00,893761,Bartulis; Jason Michael,18,0,20,2
1745141706292,MCWP 50R,A00,893766,Compas; Sean Matthew,0,1,20,20
1745141706292,MCWP 50R,B00,893769,Carter; Jennifer A,5,0,20,15
1745141706292,MCWP 50R,C00,893771,Krone; Jarret,0,3,20,20
1745141706292,MCWP 50R,D00,893772,Miller; Elizabeth Deen,4,0,20,16
1745141706292,MCWP 50R,E00,893775,Carter; Andrea L,0,0,20,20
1745141707316,MMW 11R,A01,892721,Herbst; Matthew,22,0,30,8
1745141707316,MMW 11R,A02,892722,Herbst; Matthew,28,0,30,2
1745141708342,MMW 12R,A01,892724,Herbst; Matthew,0,5,16,16
1745141708342,MMW 12R,A02,892725,Herbst; Matthew,0,4,16,16
1745141709369,MMW 13R,A01,892727,Staff,0,29,16,16
1745141709369,MMW 13R,A02,892728,Staff,0,28,16,16
1745141710398,SIO 295LS,A00,894015,Staff,9,0,25,16
1745141711428,SIO 295S,A00,894020,Staff,9,0,25,16
1745141712459,SIOC 290S,A01,894063,Merrifield; Mark A,23,0,25,2
1745141713486,SIOC 291S,A01,894137,Gabriel; Corey John,23,0,25,2
1745141714512,SOCI 117,A01,895339,Staff,5,0,5,0
1745141715542,WES 237B,A00,894149,Staff,20,0,20,0
1745141717618,AESE 279B,A00,891859,Staff,35,0,35,0
1745141718648,AIP 197,001,891854,Staff,70,0,70,0
1745141719676,ANTH 289S,A00,891856,Gagneux; Pascal,12,0,12,0
1745141720704,BENG 196,001,957946,Engler; Adam J.,9996,0,9999,3
1745141721729,CAT 124RS,A01,956906,Staff,8,0,25,17
1745141722755,CAT 125RS,A01,922013,Staff,8,0,25,17
1745141723784,CLRE 250,A00,891860,Morris; Sheldon,9996,0,9999,3
1745141725850,CLRE 251R,A00,907817,Mehta; Ravindra L.,9995,0,9999,4
1745141726880,CLRE 252,A00,891864,Cuomo; Raphael Eduardo,9994,0,9999,5
1745141727909,CLRE 253,A00,891867,Vaida; Florin,9995,0,9999,4
1745141727909,CLRE 253,B00,907819,Staff,9999,0,9999,0
1745141728936,CLRE 259,A00,891868,Patel; Hemal,9998,0,9999,1
1745141729961,CLRE 260,A00,891872,Cuomo; Raphael Eduardo,9999,0,9999,0
1745141730986,CLRE 297,001,891888,Cuomo; Raphael Eduardo,9999,0,9999,0
1745141732018,CSS 201S,A01,892054,Mignozzetti; Umberto,30,0,30,0
1745141733088,CSS 202S,A01,892056,Mignozzetti; Umberto,30,0,30,0
1745141734119,DSC 197,001,956898,Eldridge; Justin Matthew,9998,0,9999,1
1745141735145,DSC 297,001,958000,Mazumdar; Arya,9999,0,9999,0
1745141736171,EAP 100,A00,905686,Staff,9774,0,9999,225
1745141737197,ECE 45,A01,892618,Staff,0,2,50,50
1745141738223,ECE 109,A01,892620,Staff,0,44,0,0
1745141739250,ECE 111,A01,892719,Staff,0,0,50,50
1745141740276,ECE 197,001,957920,Mercier; Patrick Philip,9992,0,9999,7
1745141741307,ECON 178,A01,907814,Zhu; Ying,29,0,35,6
1745141742338,EDS 115,A00,895312,Staff,42,0,45,3
1745141743364,EDS 117,A01,895337,Staff,30,0,30,0
1745141744396,EDS 125,A00,895341,Jones; Gabrielle Anastasia,43,0,45,2
1745141745422,EDS 128A,A01,895459,Fargason; Sharon Gayle,45,0,45,0
1745141746447,EDS 128B,A01,895543,Pappas; Elizabeth,45,0,45,0
1745141747472,EDS 139,A00,897203,Pappas; Elizabeth,45,0,45,0
1745141747472,EDS 139,B00,897209,Fargason; Sharon Gayle,45,0,45,0
1745141748498,EDS 201,A00,895545,Staff,44,0,45,1
1745141749525,EDS 203,A01,895581,Halter; Christopher P.,44,0,45,1
1745141750555,EDS 204R,A01,895625,Heinzman; Erica M.,45,0,45,0
1745141750555,EDS 204R,B01,895693,Halter; Christopher P.,28,0,45,17
1745141751580,EDS 206R,A00,895694,Fargason; Sharon Gayle,22,0,30,8
1745141751580,EDS 206R,B00,895695,Choi; Bailey Miyeon,21,0,30,9
1745141752606,EDS 250,A00,895697,Hemans; Patricia Ann Benitez,44,0,45,1
1745141753632,EDS 281,A00,895701,Meyerott; Theresa Ann,15,0,15,0
1745141754661,EDS 284,A00,895736,Meyerott; Theresa Ann,15,0,15,0
1745141755691,EDS 286,A00,897210,Fine; Sarah,15,0,15,0
1745141756721,EDS 289C,A01,895770,Daly; Alan J.,15,0,15,0
1745141757750,EDS 290,A00,897211,Hofstetter; Carolyn,15,0,15,0
1745141758779,LIGM 5A,A00,896162,Fischer-Grunski; Eva K,16,0,20,4
1745141759811,LIGM 5B,A00,896260,Fischer-Grunski; Eva K,19,0,20,1
1745141760836,LIGM 5C,A00,896308,Fischer-Grunski; Eva K,19,0,20,1
1745141761861,LIIT 5AS,A00,896313,Carnelos; Chiara,18,0,20,2
1745141762896,LIIT 5BS,A00,896416,Carnelos; Chiara,20,0,20,0
1745141763921,LIIT 5CS,A00,896564,Carnelos; Chiara,20,0,20,0
1745141764945,LISP 5A,A00,896588,Munoz Sanchez; Alicia,7,0,20,13
1745141765971,LISP 5B,A00,896653,Munoz Sanchez; Alicia,10,0,20,10
1745141766997,LISP 5C,A00,896655,Munoz Sanchez; Alicia,9,0,20,11
1745141768028,MAE 197,001,957918,Kleissl; Jan,9998,0,9999,1
1745141769055,MATH 2,A01,957937,Staff,34,0,35,1
1745141770083,MATH 197,001,957876,Kedlaya; Kiran S.,9996,0,9999,3
1745141771107,MCWP 40,A00,892729,Duru; Nur,16,0,20,4
1745141771107,MCWP 40,B00,893304,Montejo; Carolina,20,0,20,0
1745141772132,MCWP 40R,A00,893757,Redela; Pamela Morgan,0,3,20,20
1745141773157,MCWP 50,A00,893758,Morshed; Michael James,4,0,20,16
1745141773157,MCWP 50,B00,893761,Bartulis; Jason Michael,18,0,20,2
1745141774182,MCWP 50R,A00,893766,Compas; Sean Matthew,0,1,20,20
1745141774182,MCWP 50R,B00,893769,Carter; Jennifer A,5,0,20,15
1745141774182,MCWP 50R,C00,893771,Krone; Jarret,0,3,20,20
1745141774182,MCWP 50R,D00,893772,Miller; Elizabeth Deen,4,0,20,16
1745141774182,MCWP 50R,E00,893775,Carter; Andrea L,0,0,20,20
1745141775209,MMW 11R,A01,892721,Herbst; Matthew,22,0,30,8
1745141775209,MMW 11R,A02,892722,Herbst; Matthew,28,0,30,2
1745141776234,MMW 12R,A01,892724,Herbst; Matthew,0,5,16,16
1745141776234,MMW 12R,A02,892725,Herbst; Matthew,0,4,16,16
1745141777262,MMW 13R,A01,892727,Staff,0,29,16,16
1745141777262,MMW 13R,A02,892728,Staff,0,28,16,16
1745141778291,SIO 295LS,A00,894015,Staff,9,0,25,16
1745141779321,SIO 295S,A00,894020,Staff,9,0,25,16
1745141780352,SIOC 290S,A01,894063,Merrifield; Mark A,23,0,25,2
1745141781384,SIOC 291S,A01,894137,Gabriel; Corey John,23,0,25,2
1745141782412,SOCI 117,A01,895339,Staff,5,0,5,0
1745141783440,WES 237B,A00,894149,Staff,20,0,20,0
1745141785521,AESE 279B,A00,891859,Staff,35,0,35,0
1745141786549,AIP 197,001,891854,Staff,70,0,70,0
1745141787574,ANTH 289S,A00,891856,Gagneux; Pascal,12,0,12,0
1745141788602,BENG 196,001,957946,Engler; Adam J.,9996,0,9999,3
1745141789632,CAT 124RS,A01,956906,Staff,8,0,25,17
1745141790658,CAT 125RS,A01,922013,Staff,8,0,25,17
1745141791684,CLRE 250,A00,891860,Morris; Sheldon,9996,0,9999,3
1745141793735,CLRE 251R,A00,907817,Mehta; Ravindra L.,9995,0,9999,4
1745141794764,CLRE 252,A00,891864,Cuomo; Raphael Eduardo,9994,0,9999,5
1745141795793,CLRE 253,A00,891867,Vaida; Florin,9995,0,9999,4
1745141795793,CLRE 253,B00,907819,Staff,9999,0,9999,0
1745141796823,CLRE 259,A00,891868,Patel; Hemal,9998,0,9999,1
1745141797852,CLRE 260,A00,891872,Cuomo; Raphael Eduardo,9999,0,9999,0
1745141798884,CLRE 297,001,891888,Cuomo; Raphael Eduardo,9999,0,9999,0
1745141799910,CSS 201S,A01,892054,Mignozzetti; Umberto,30,0,30,0
1745141800936,CSS 202S,A01,892056,Mignozzetti; Umberto,30,0,30,0
1745141801961,DSC 197,001,956898,Eldridge; Justin Matthew,9998,0,9999,1
1745141802988,DSC 297,001,958000,Mazumdar; Arya,9999,0,9999,0
1745141804017,EAP 100,A00,905686,Staff,9774,0,9999,225
1745141805046,ECE 45,A01,892618,Staff,0,2,50,50
1745141806071,ECE 109,A01,892620,Staff,0,44,0,0
1745141807099,ECE 111,A01,892719,Staff,0,0,50,50
1745141808123,ECE 197,001,957920,Mercier; Patrick Philip,9992,0,9999,7
1745141809153,ECON 178,A01,907814,Zhu; Ying,29,0,35,6
1745141810195,EDS 115,A00,895312,Staff,42,0,45,3
1745141811221,EDS 117,A01,895337,Staff,30,0,30,0
1745141812246,EDS 125,A00,895341,Jones; Gabrielle Anastasia,43,0,45,2
1745141813272,EDS 128A,A01,895459,Fargason; Sharon Gayle,45,0,45,0
1745141814298,EDS 128B,A01,895543,Pappas; Elizabeth,45,0,45,0
1745141815324,EDS 139,A00,897203,Pappas; Elizabeth,45,0,45,0
1745141815324,EDS 139,B00,897209,Fargason; Sharon Gayle,45,0,45,0
1745141816351,EDS 201,A00,895545,Staff,44,0,45,1
1745141817380,EDS 203,A01,895581,Halter; Christopher P.,44,0,45,1
1745141818408,EDS 204R,A01,895625,Heinzman; Erica M.,45,0,45,0
1745141818408,EDS 204R,B01,895693,Halter; Christopher P.,28,0,45,17
1745141819435,EDS 206R,A00,895694,Fargason; Sharon Gayle,22,0,30,8
1745141819435,EDS 206R,B00,895695,Choi; Bailey Miyeon,21,0,30,9
1745141820463,EDS 250,A00,895697,Hemans; Patricia Ann Benitez,44,0,45,1
1745141821490,EDS 281,A00,895701,Meyerott; Theresa Ann,15,0,15,0
1745141822517,EDS 284,A00,895736,Meyerott; Theresa Ann,15,0,15,0
1745141823545,EDS 286,A00,897210,Fine; Sarah,15,0,15,0
1745141824573,EDS 289C,A01,895770,Daly; Alan J.,15,0,15,0
1745141825604,EDS 290,A00,897211,Hofstetter; Carolyn,15,0,15,0
1745141826630,LIGM 5A,A00,896162,Fischer-Grunski; Eva K,16,0,20,4
1745141827656,LIGM 5B,A00,896260,Fischer-Grunski; Eva K,19,0,20,1
1745141828685,LIGM 5C,A00,896308,Fischer-Grunski; Eva K,19,0,20,1
1745141829715,LIIT 5AS,A00,896313,Carnelos; Chiara,18,0,20,2
1745141830745,LIIT 5BS,A00,896416,Carnelos; Chiara,20,0,20,0
1745141831769,LIIT 5CS,A00,896564,Carnelos; Chiara,20,0,20,0
1745141832798,LISP 5A,A00,896588,Munoz Sanchez; Alicia,7,0,20,13
1745141833824,LISP 5B,A00,896653,Munoz Sanchez; Alicia,10,0,20,10
1745141834853,LISP 5C,A00,896655,Munoz Sanchez; Alicia,9,0,20,11
1745141835882,MAE 197,001,957918,Kleissl; Jan,9998,0,9999,1
1745141836911,MATH 2,A01,957937,Staff,34,0,35,1
1745141837936,MATH 197,001,957876,Kedlaya; Kiran S.,9996,0,9999,3
1745141838964,MCWP 40,A00,892729,Duru; Nur,16,0,20,4
1745141838964,MCWP 40,B00,893304,Montejo; Carolina,20,0,20,0
1745141839989,MCWP 40R,A00,893757,Redela; Pamela Morgan,0,3,20,20
1745141841019,MCWP 50,A00,893758,Morshed; Michael James,4,0,20,16
1745141841019,MCWP 50,B00,893761,Bartulis; Jason Michael,18,0,20,2
1745141842045,MCWP 50R,A00,893766,Compas; Sean Matthew,0,1,20,20
1745141842045,MCWP 50R,B00,893769,Carter; Jennifer A,5,0,20,15
1745141842045,MCWP 50R,C00,893771,Krone; Jarret,0,3,20,20
1745141842045,MCWP 50R,D00,893772,Miller; Elizabeth Deen,4,0,20,16
1745141842045,MCWP 50R,E00,893775,Carter; Andrea L,0,0,20,20
1745141843072,MMW 11R,A01,892721,Herbst; Matthew,22,0,30,8
1745141843072,MMW 11R,A02,892722,Herbst; Matthew,28,0,30,2
1745141844098,MMW 12R,A01,892724,Herbst; Matthew,0,5,16,16
1745141844098,MMW 12R,A02,892725,Herbst; Matthew,0,4,16,16
1745141845125,MMW 13R,A01,892727,Staff,0,29,16,16
1745141845125,MMW 13R,A02,892728,Staff,0,28,16,16
1745141846150,SIO 295LS,A00,894015,Staff,9,0,25,16
1745141847179,SIO 295S,A00,894020,Staff,9,0,25,16
1745141848205,SIOC 290S,A01,894063,Merrifield; Mark A,23,0,25,2
1745141849235,SIOC 291S,A01,894137,Gabriel; Corey John,23,0,25,2
1745141850262,SOCI 117,A01,895339,Staff,5,0,5,0
1745141851289,WES 237B,A00,894149,Staff,20,0,20,0
1745141853351,AESE 279B,A00,891859,Staff,35,0,35,0
1745141854376,AIP 197,001,891854,Staff,70,0,70,0
1745141855402,ANTH 289S,A00,891856,Gagneux; Pascal,12,0,12,0
1745141856426,BENG 196,001,957946,Engler; Adam J.,9996,0,9999,3
1745141857451,CAT 124RS,A01,956906,Staff,8,0,25,17
1745141858477,CAT 125RS,A01,922013,Staff,8,0,25,17
1745141859505,CLRE 250,A00,891860,Morris; Sheldon,9996,0,9999,3
1745141861556,CLRE 251R,A00,907817,Mehta; Ravindra L.,9995,0,9999,4
1745141862582,CLRE 252,A00,891864,Cuomo; Raphael Eduardo,9994,0,9999,5
1745141863608,CLRE 253,A00,891867,Vaida; Florin,9995,0,9999,4
1745141863608,CLRE 253,B00,907819,Staff,9999,0,9999,0
1745141864632,CLRE 259,A00,891868,Patel; Hemal,9998,0,9999,1
1745141865657,CLRE 260,A00,891872,Cuomo; Raphael Eduardo,9999,0,9999,0
1745141866683,CLRE 297,001,891888,Cuomo; Raphael Eduardo,9999,0,9999,0
1745141867709,CSS 201S,A01,892054,Mignozzetti; Umberto,30,0,30,0
1745141868736,CSS 202S,A01,892056,Mignozzetti; Umberto,30,0,30,0
1745141869762,DSC 197,001,956898,Eldridge; Justin Matthew,9998,0,9999,1
1745141870791,DSC 297,001,958000,Mazumdar; Arya,9999,0,9999,0
1745141871817,EAP 100,A00,905686,Staff,9774,0,9999,225
1745141872844,ECE 45,A01,892618,Staff,0,2,50,50
1745141873872,ECE 109,A01,892620,Staff,0,44,0,0
1745141874897,ECE 111,A01,892719,Staff,0,0,50,50
1745141875924,ECE 197,001,957920,Mercier; Patrick Philip,9992,0,9999,7
1745141876949,ECON 178,A01,907814,Zhu; Ying,29,0,35,6
1745141877977,EDS 115,A00,895312,Staff,42,0,45,3
1745141879003,EDS 117,A01,895337,Staff,30,0,30,0
1745141880034,EDS 125,A00,895341,Jones; Gabrielle Anastasia,43,0,45,2
1745141881059,EDS 128A,A01,895459,Fargason; Sharon Gayle,45,0,45,0
1745141882085,EDS 128B,A01,895543,Pappas; Elizabeth,45,0,45,0
1745141883109,EDS 139,A00,897203,Pappas; Elizabeth,45,0,45,0
1745141883109,EDS 139,B00,897209,Fargason; Sharon Gayle,45,0,45,0
1745141884138,EDS 201,A00,895545,Staff,44,0,45,1
1745141885167,EDS 203,A01,895581,Halter; Christopher P.,44,0,45,1
1745141886193,EDS 204R,A01,895625,Heinzman; Erica M.,45,0,45,0
1745141886193,EDS 204R,B01,895693,Halter; Christopher P.,28,0,45,17
1745141887221,EDS 206R,A00,895694,Fargason; Sharon Gayle,22,0,30,8
1745141887221,EDS 206R,B00,895695,Choi; Bailey Miyeon,21,0,30,9
1745141888246,EDS 250,A00,895697,Hemans; Patricia Ann Benitez,44,0,45,1
1745141889271,EDS 281,A00,895701,Meyerott; Theresa Ann,15,0,15,0
1745141890297,EDS 284,A00,895736,Meyerott; Theresa Ann,15,0,15,0
1745141891321,EDS 286,A00,897210,Fine; Sarah,15,0,15,0
1745141892346,EDS 289C,A01,895770,Daly; Alan J.,15,0,15,0
1745141893374,EDS 290,A00,897211,Hofstetter; Carolyn,15,0,15,0
1745141894401,LIGM 5A,A00,896162,Fischer-Grunski; Eva K,16,0,20,4
1745141895426,LIGM 5B,A00,896260,Fischer-Grunski; Eva K,19,0,20,1
1745141896458,LIGM 5C,A00,896308,Fischer-Grunski; Eva K,19,0,20,1
1745141897483,LIIT 5AS,A00,896313,Carnelos; Chiara,18,0,20,2
1745141898509,LIIT 5BS,A00,896416,Carnelos; Chiara,20,0,20,0
1745141899535,LIIT 5CS,A00,896564,Carnelos; Chiara,20,0,20,0
1745141900561,LISP 5A,A00,896588,Munoz Sanchez; Alicia,7,0,20,13
1745141901589,LISP 5B,A00,896653,Munoz Sanchez; Alicia,10,0,20,10
1745141902617,LISP 5C,A00,896655,Munoz Sanchez; Alicia,9,0,20,11
1745141903644,MAE 197,001,957918,Kleissl; Jan,9998,0,9999,1
1745141904668,MATH 2,A01,957937,Staff,34,0,35,1
1745141905694,MATH 197,001,957876,Kedlaya; Kiran S.,9996,0,9999,3
1745141906721,MCWP 40,A00,892729,Duru; Nur,16,0,20,4
1745141906721,MCWP 40,B00,893304,Montejo; Carolina,20,0,20,0
1745141907747,MCWP 40R,A00,893757,Redela; Pamela Morgan,0,3,20,20
1745141908775,MCWP 50,A00,893758,Morshed; Michael James,4,0,20,16
1745141908775,MCWP 50,B00,893761,Bartulis; Jason Michael,18,0,20,2
1745141909844,MCWP 50R,A00,893766,Compas; Sean Matthew,0,1,20,20
1745141909844,MCWP 50R,B00,893769,Carter; Jennifer A,5,0,20,15
1745141909844,MCWP 50R,C00,893771,Krone; Jarret,0,3,20,20
1745141909844,MCWP 50R,D00,893772,Miller; Elizabeth Deen,4,0,20,16
1745141909844,MCWP 50R,E00,893775,Carter; Andrea L,0,0,20,20
1745141910869,MMW 11R,A01,892721,Herbst; Matthew,22,0,30,8
1745141910869,MMW 11R,A02,892722,Herbst; Matthew,28,0,30,2
1745141911897,MMW 12R,A01,892724,Herbst; Matthew,0,5,16,16
1745141911897,MMW 12R,A02,892725,Herbst; Matthew,0,4,16,16
1745141912924,MMW 13R,A01,892727,Staff,0,29,16,16
1745141912924,MMW 13R,A02,892728,Staff,0,28,16,16
1745141913951,SIO 295LS,A00,894015,Staff,9,0,25,16
1745141914977,SIO 295S,A00,894020,Staff,9,0,25,16
1745141916001,SIOC 290S,A01,894063,Merrifield; Mark A,23,0,25,2
1745141917026,SIOC 291S,A01,894137,Gabriel; Corey John,23,0,25,2
1745141918054,SOCI 117,A01,895339,Staff,5,0,5,0
1745141919082,WES 237B,A00,894149,Staff,20,0,20,0
1745141921178,AESE 279B,A00,891859,Staff,35,0,35,0
1745141922202,AIP 197,001,891854,Staff,70,0,70,0
1745141923228,ANTH 289S,A00,891856,Gagneux; Pascal,12,0,12,0
1745141924256,BENG 196,001,957946,Engler; Adam J.,9996,0,9999,3
1745141925284,CAT 124RS,A01,956906,Staff,8,0,25,17
1745141926314,CAT 125RS,A01,922013,Staff,8,0,25,17
1745141927340,CLRE 250,A00,891860,Morris; Sheldon,9996,0,9999,3
1745141929391,CLRE 251R,A00,907817,Mehta; Ravindra L.,9995,0,9999,4
1745141930418,CLRE 252,A00,891864,Cuomo; Raphael Eduardo,9994,0,9999,5
1745141931448,CLRE 253,A00,891867,Vaida; Florin,9995,0,9999,4
1745141931448,CLRE 253,B00,907819,Staff,9999,0,9999,0
1745141932474,CLRE 259,A00,891868,Patel; Hemal,9998,0,9999,1
1745141933501,CLRE 260,A00,891872,Cuomo; Raphael Eduardo,9999,0,9999,0
1745141934527,CLRE 297,001,891888,Cuomo; Raphael Eduardo,9999,0,9999,0
1745141935555,CSS 201S,A01,892054,Mignozzetti; Umberto,30,0,30,0
1745141936581,CSS 202S,A01,892056,Mignozzetti; Umberto,30,0,30,0
1745141937605,DSC 197,001,956898,Eldridge; Justin Matthew,9998,0,9999,1
1745141938635,DSC 297,001,958000,Mazumdar; Arya,9999,0,9999,0
1745141939664,EAP 100,A00,905686,Staff,9774,0,9999,225
1745141940698,ECE 45,A01,892618,Staff,0,2,50,50
1745141941725,ECE 109,A01,892620,Staff,0,44,0,0
1745141942754,ECE 111,A01,892719,Staff,0,0,50,50
1745141943778,ECE 197,001,957920,Mercier; Patrick Philip,9992,0,9999,7
1745141944803,ECON 178,A01,907814,Zhu; Ying,29,0,35,6
1745141945831,EDS 115,A00,895312,Staff,42,0,45,3
1745141946863,EDS 117,A01,895337,Staff,30,0,30,0
1745141947889,EDS 125,A00,895341,Jones; Gabrielle Anastasia,43,0,45,2
1745141948916,EDS 128A,A01,895459,Fargason; Sharon Gayle,45,0,45,0
1745141949941,EDS 128B,A01,895543,Pappas; Elizabeth,45,0,45,0
1745141950968,EDS 139,A00,897203,Pappas; Elizabeth,45,0,45,0
1745141950968,EDS 139,B00,897209,Fargason; Sharon Gayle,45,0,45,0
1745141951992,EDS 201,A00,895545,Staff,44,0,45,1
1745141953018,EDS 203,A01,895581,Halter; Christopher P.,44,0,45,1
1745141954045,EDS 204R,A01,895625,Heinzman; Erica M.,45,0,45,0
1745141954045,EDS 204R,B01,895693,Halter; Christopher P.,28,0,45,17
1745141955072,EDS 206R,A00,895694,Fargason; Sharon Gayle,22,0,30,8
1745141955072,EDS 206R,B00,895695,Choi; Bailey Miyeon,21,0,30,9
1745141956096,EDS 250,A00,895697,Hemans; Patricia Ann Benitez,44,0,45,1
1745141957122,EDS 281,A00,895701,Meyerott; Theresa Ann,15,0,15,0
1745141958149,EDS 284,A00,895736,Meyerott; Theresa Ann,15,0,15,0
1745141959175,EDS 286,A00,897210,Fine; Sarah,15,0,15,0
1745141960202,EDS 289C,A01,895770,Daly; Alan J.,15,0,15,0
1745141961230,EDS 290,A00,897211,Hofstetter; Carolyn,15,0,15,0
1745141962259,LIGM 5A,A00,896162,Fischer-Grunski; Eva K,16,0,20,4
1745141963283,LIGM 5B,A00,896260,Fischer-Grunski; Eva K,19,0,20,1
1745141964312,LIGM 5C,A00,896308,Fischer-Grunski; Eva K,19,0,20,1
1745141965337,LIIT 5AS,A00,896313,Carnelos; Chiara,18,0,20,2
1745141966362,LIIT 5BS,A00,896416,Carnelos; Chiara,20,0,20,0
1745141967391,LIIT 5CS,A00,896564,Carnelos; Chiara,20,0,20,0
1745141968421,LISP 5A,A00,896588,Munoz Sanchez; Alicia,7,0,20,13
1745141969447,LISP 5B,A00,896653,Munoz Sanchez; Alicia,10,0,20,10
1745141970472,LISP 5C,A00,896655,Munoz Sanchez; Alicia,9,0,20,11
1745141971496,MAE 197,001,957918,Kleissl; Jan,9998,0,9999,1
1745141972522,MATH 2,A01,957937,Staff,34,0,35,1
1745141973549,MATH 197,001,957876,Kedlaya; Kiran S.,9996,0,9999,3
1745141974579,MCWP 40,A00,892729,Duru; Nur,16,0,20,4
1745141974579,MCWP 40,B00,893304,Montejo; Carolina,20,0,20,0
1745141975606,MCWP 40R,A00,893757,Redela; Pamela Morgan,0,3,20,20
1745141976633,MCWP 50,A00,893758,Morshed; Michael James,4,0,20,16
1745141976633,MCWP 50,B00,893761,Bartulis; Jason Michael,18,0,20,2
1745141977663,MCWP 50R,A00,893766,Compas; Sean Matthew,0,1,20,20
1745141977663,MCWP 50R,B00,893769,Carter; Jennifer A,5,0,20,15
1745141977663,MCWP 50R,C00,893771,Krone; Jarret,0,3,20,20
1745141977663,MCWP 50R,D00,893772,Miller; Elizabeth Deen,4,0,20,16
1745141977663,MCWP 50R,E00,893775,Carter; Andrea L,0,0,20,20
1745141978689,MMW 11R,A01,892721,Herbst; Matthew,22,0,30,8
1745141978689,MMW 11R,A02,892722,Herbst; Matthew,28,0,30,2
1745141979713,MMW 12R,A01,892724,Herbst; Matthew,0,5,16,16
1745141979713,MMW 12R,A02,892725,Herbst; Matthew,0,4,16,16
1745141980742,MMW 13R,A01,892727,Staff,0,29,16,16
1745141980742,MMW 13R,A02,892728,Staff,0,28,16,16
1745141981771,SIO 295LS,A00,894015,Staff,9,0,25,16
1745141982798,SIO 295S,A00,894020,Staff,9,0,25,16
1745141983826,SIOC 290S,A01,894063,Merrifield; Mark A,23,0,25,2
1745141984856,SIOC 291S,A01,894137,Gabriel; Corey John,23,0,25,2
1745141985883,SOCI 117,A01,895339,Staff,5,0,5,0
1745141986908,WES 237B,A00,894149,Staff,20,0,20,0
1745141988988,AESE 279B,A00,891859,Staff,35,0,35,0
1745141990016,AIP 197,001,891854,Staff,70,0,70,0
1745141991043,ANTH 289S,A00,891856,Gagneux; Pascal,12,0,12,0
1745141992070,BENG 196,001,957946,Engler; Adam J.,9996,0,9999,3
1745141993099,CAT 124RS,A01,956906,Staff,8,0,25,17
1745141994123,CAT 125RS,A01,922013,Staff,8,0,25,17
1745141995148,CLRE 250,A00,891860,Morris; Sheldon,9996,0,9999,3
1745141997198,CLRE 251R,A00,907817,Mehta; Ravindra L.,9995,0,9999,4
1745141998224,CLRE 252,A00,891864,Cuomo; Raphael Eduardo,9994,0,9999,5
1745141999254,CLRE 253,A00,891867,Vaida; Florin,9995,0,9999,4
1745141999254,CLRE 253,B00,907819,Staff,9999,0,9999,0
1745142000292,CLRE 259,A00,891868,Patel; Hemal,9998,0,9999,1
1745142001324,CLRE 260,A00,891872,Cuomo; Raphael Eduardo,9999,0,9999,0
1745142002349,CLRE 297,001,891888,Cuomo; Raphael Eduardo,9999,0,9999,0
1745142003385,CSS 201S,A01,892054,Mignozzetti; Umberto,30,0,30,0
1745142004423,CSS 202S,A01,892056,Mignozzetti; Umberto,30,0,30,0
1745142005455,DSC 197,001,956898,Eldridge; Justin Matthew,9998,0,9999,1
1745142006484,DSC 297,001,958000,Mazumdar; Arya,9999,0,9999,0
1745142007512,EAP 100,A00,905686,Staff,9774,0,9999,225
1745142008540,ECE 45,A01,892618,Staff,0,2,50,50
1745142009568,ECE 109,A01,892620,Staff,0,44,0,0
1745142010594,ECE 111,A01,892719,Staff,0,0,50,50
1745142011620,ECE 197,001,957920,Mercier; Patrick Philip,9992,0,9999,7
1745142012654,ECON 178,A01,907814,Zhu; Ying,29,0,35,6
1745142013684,EDS 115,A00,895312,Staff,42,0,45,3
1745142014710,EDS 117,A01,895337,Staff,30,0,30,0
1745142015737,EDS 125,A00,895341,Jones; Gabrielle Anastasia,43,0,45,2
1745142016764,EDS 128A,A01,895459,Fargason; Sharon Gayle,45,0,45,0
1745142017793,EDS 128B,A01,895543,Pappas; Elizabeth,45,0,45,0
1745142018822,EDS 139,A00,897203,Pappas; Elizabeth,45,0,45,0
1745142018822,EDS 139,B00,897209,Fargason; Sharon Gayle,45,0,45,0
1745142019854,EDS 201,A00,895545,Staff,44,0,45,1
1745142020879,EDS 203,A01,895581,Halter; Christopher P.,44,0,45,1
1745142021906,EDS 204R,A01,895625,Heinzman; Erica M.,45,0,45,0
1745142021906,EDS 204R,B01,895693,Halter; Christopher P.,28,0,45,17
1745142022934,EDS 206R,A00,895694,Fargason; Sharon Gayle,22,0,30,8
1745142022934,EDS 206R,B00,895695,Choi; Bailey Miyeon,21,0,30,9
1745142023963,EDS 250,A00,895697,Hemans; Patricia Ann Benitez,44,0,45,1
1745142024990,EDS 281,A00,895701,Meyerott; Theresa Ann,15,0,15,0
1745142026016,EDS 284,A00,895736,Meyerott; Theresa Ann,15,0,15,0
1745142027044,EDS 286,A00,897210,Fine; Sarah,15,0,15,0
1745142028070,EDS 289C,A01,895770,Daly; Alan J.,15,0,15,0
1745142029099,EDS 290,A00,897211,Hofstetter; Carolyn,15,0,15,0
1745142030126,LIGM 5A,A00,896162,Fischer-Grunski; Eva K,16,0,20,4
1745142031151,LIGM 5B,A00,896260,Fischer-Grunski; Eva K,19,0,20,1
1745142032176,LIGM 5C,A00,896308,Fischer-Grunski; Eva K,19,0,20,1
1745142033205,LIIT 5AS,A00,896313,Carnelos; Chiara,18,0,20,2
1745142034232,LIIT 5BS,A00,896416,Carnelos; Chiara,20,0,20,0
1745142035259,LIIT 5CS,A00,896564,Carnelos; Chiara,20,0,20,0
1745142036285,LISP 5A,A00,896588,Munoz Sanchez; Alicia,7,0,20,13
1745142037314,LISP 5B,A00,896653,Munoz Sanchez; Alicia,10,0,20,10
1745142038346,LISP 5C,A00,896655,Munoz Sanchez; Alicia,9,0,20,11
1745142039374,MAE 197,001,957918,Kleissl; Jan,9998,0,9999,1
1745142040400,MATH 2,A01,957937,Staff,34,0,35,1
1745142041425,MATH 197,001,957876,Kedlaya; Kiran S.,9996,0,9999,3
1745142042484,MCWP 40,A00,892729,Duru; Nur,16,0,20,4
1745142042484,MCWP 40,B00,893304,Montejo; Carolina,20,0,20,0
1745142043516,MCWP 40R,A00,893757,Redela; Pamela Morgan,0,3,20,20
1745142044541,MCWP 50,A00,893758,Morshed; Michael James,4,0,20,16
1745142044541,MCWP 50,B00,893761,Bartulis; Jason Michael,18,0,20,2
1745142045568,MCWP 50R,A00,893766,Compas; Sean Matthew,0,1,20,20
1745142045568,MCWP 50R,B00,893769,Carter; Jennifer A,5,0,20,15
1745142045568,MCWP 50R,C00,893771,Krone; Jarret,0,3,20,20
1745142045568,MCWP 50R,D00,893772,Miller; Elizabeth Deen,4,0,20,16
1745142045568,MCWP 50R,E00,893775,Carter; Andrea L,0,0,20,20
1745142046596,MMW 11R,A01,892721,Herbst; Matthew,22,0,30,8
1745142046596,MMW 11R,A02,892722,Herbst; Matthew,28,0,30,2
1745142047624,MMW 12R,A01,892724,Herbst; Matthew,0,5,16,16
1745142047624,MMW 12R,A02,892725,Herbst; Matthew,0,4,16,16
1745142048650,MMW 13R,A01,892727,Staff,0,29,16,16
1745142048650,MMW 13R,A02,892728,Staff,0,28,16,16
1745142049681,SIO 295LS,A00,894015,Staff,9,0,25,16
1745142050707,SIO 295S,A00,894020,Staff,9,0,25,16
1745142051734,SIOC 290S,A01,894063,Merrifield; Mark A,23,0,25,2
1745142052759,SIOC 291S,A01,894137,Gabriel; Corey John,23,0,25,2
1745142053785,SOCI 117,A01,895339,Staff,5,0,5,0
1745142054832,WES 237B,A00,894149,Staff,20,0,20,0
1745142056898,AESE 279B,A00,891859,Staff,35,0,35,0
1745142057923,AIP 197,001,891854,Staff,70,0,70,0
1745142058948,ANTH 289S,A00,891856,Gagneux; Pascal,12,0,12,0
1745142059975,BENG 196,001,957946,Engler; Adam J.,9996,0,9999,3
1745142061005,CAT 124RS,A01,956906,Staff,8,0,25,17
1745142062030,CAT 125RS,A01,922013,Staff,8,0,25,17
1745142063056,CLRE 250,A00,891860,Morris; Sheldon,9996,0,9999,3
1745142065110,CLRE 251R,A00,907817,Mehta; Ravindra L.,9995,0,9999,4
1745142066135,CLRE 252,A00,891864,Cuomo; Raphael Eduardo,9994,0,9999,5
1745142067160,CLRE 253,A00,891867,Vaida; Florin,9995,0,9999,4
1745142067160,CLRE 253,B00,907819,Staff,9999,0,9999,0
1745142068191,CLRE 259,A00,891868,Patel; Hemal,9998,0,9999,1
1745142069220,CLRE 260,A00,891872,Cuomo; Raphael Eduardo,9999,0,9999,0
1745142070244,CLRE 297,001,891888,Cuomo; Raphael Eduardo,9999,0,9999,0
1745142071272,CSS 201S,A01,892054,Mignozzetti; Umberto,30,0,30,0
1745142072302,CSS 202S,A01,892056,Mignozzetti; Umberto,30,0,30,0
1745142073328,DSC 197,001,956898,Eldridge; Justin Matthew,9998,0,9999,1
1745142074357,DSC 297,001,958000,Mazumdar; Arya,9999,0,9999,0
1745142075389,EAP 100,A00,905686,Staff,9774,0,9999,225
1745142076421,ECE 45,A01,892618,Staff,0,2,50,50
1745142077446,ECE 109,A01,892620,Staff,0,44,0,0
1745142078473,ECE 111,A01,892719,Staff,0,0,50,50
1745142079497,ECE 197,001,957920,Mercier; Patrick Philip,9992,0,9999,7
1745142080528,ECON 178,A01,907814,Zhu; Ying,29,0,35,6
1745142081554,EDS 115,A00,895312,Staff,42,0,45,3
1745142082581,EDS 117,A01,895337,Staff,30,0,30,0
1745142083611,EDS 125,A00,895341,Jones; Gabrielle Anastasia,43,0,45,2
1745142084635,EDS 128A,A01,895459,Fargason; Sharon Gayle,45,0,45,0
1745142085663,EDS 128B,A01,895543,Pappas; Elizabeth,45,0,45,0
1745142086692,EDS 139,A00,897203,Pappas; Elizabeth,45,0,45,0
1745142086692,EDS 139,B00,897209,Fargason; Sharon Gayle,45,0,45,0
1745142087721,EDS 201,A00,895545,Staff,44,0,45,1
1745142088749,EDS 203,A01,895581,Halter; Christopher P.,44,0,45,1
1745142089779,EDS 204R,A01,895625,Heinzman; Erica M.,45,0,45,0
1745142089779,EDS 204R,B01,895693,Halter; Christopher P.,28,0,45,17
1745142090807,EDS 206R,A00,895694,Fargason; Sharon Gayle,22,0,30,8
1745142090807,EDS 206R,B00,895695,Choi; Bailey Miyeon,21,0,30,9
1745142091830,EDS 250,A00,895697,Hemans; Patricia Ann Benitez,44,0,45,1
1745142092860,EDS 281,A00,895701,Meyerott; Theresa Ann,15,0,15,0
1745142093886,EDS 284,A00,895736,Meyerott; Theresa Ann,15,0,15,0
1745142094912,EDS 286,A00,897210,Fine; Sarah,15,0,15,0
1745142095941,EDS 289C,A01,895770,Daly; Alan J.,15,0,15,0
1745142096968,EDS 290,A00,897211,Hofstetter; Carolyn,15,0,15,0
1745142097995,LIGM 5A,A00,896162,Fischer-Grunski; Eva K,16,0,20,4
1745142099019,LIGM 5B,A00,896260,Fischer-Grunski; Eva K,19,0,20,1
1745142100050,LIGM 5C,A00,896308,Fischer-Grunski; Eva K,19,0,20,1
1745142101075,LIIT 5AS,A00,896313,Carnelos; Chiara,18,0,20,2
1745142102101,LIIT 5BS,A00,896416,Carnelos; Chiara,20,0,20,0
1745142103129,LIIT 5CS,A00,896564,Carnelos; Chiara,20,0,20,0
1745142104164,LISP 5A,A00,896588,Munoz Sanchez; Alicia,7,0,20,13
1745142105189,LISP 5B,A00,896653,Munoz Sanchez; Alicia,10,0,20,10
1745142106221,LISP 5C,A00,896655,Munoz Sanchez; Alicia,9,0,20,11
1745142107303,MAE 197,001,957918,Kleissl; Jan,9998,0,9999,1
1745142108333,MATH 2,A01,957937,Staff,34,0,35,1
1745142109362,MATH 197,001,957876,Kedlaya; Kiran S.,9996,0,9999,3
1745142110389,MCWP 40,A00,892729,Duru; Nur,16,0,20,4
1745142110389,MCWP 40,B00,893304,Montejo; Carolina,20,0,20,0
1745142111415,MCWP 40R,A00,893757,Redela; Pamela Morgan,0,3,20,20
1745142112446,MCWP 50,A00,893758,Morshed; Michael James,4,0,20,16
1745142112446,MCWP 50,B00,893761,Bartulis; Jason Michael,18,0,20,2
1745142113494,MCWP 50R,A00,893766,Compas; Sean Matthew,0,1,20,20
1745142113494,MCWP 50R,B00,893769,Carter; Jennifer A,5,0,20,15
1745142113494,MCWP 50R,C00,893771,Krone; Jarret,0,3,20,20
1745142113494,MCWP 50R,D00,893772,Miller; Elizabeth Deen,4,0,20,16
1745142113494,MCWP 50R,E00,893775,Carter; Andrea L,0,0,20,20
1745142114519,MMW 11R,A01,892721,Herbst; Matthew,22,0,30,8
1745142114519,MMW 11R,A02,892722,Herbst; Matthew,28,0,30,2
1745142115545,MMW 12R,A01,892724,Herbst; Matthew,0,5,16,16
1745142115545,MMW 12R,A02,892725,Herbst; Matthew,0,4,16,16
1745142116571,MMW 13R,A01,892727,Staff,0,29,16,16
1745142116571,MMW 13R,A02,892728,Staff,0,28,16,16
1745142117600,SIO 295LS,A00,894015,Staff,9,0,25,16
1745142118629,SIO 295S,A00,894020,Staff,9,0,25,16
1745142119660,SIOC 290S,A01,894063,Merrifield; Mark A,23,0,25,2
1745142120686,SIOC 291S,A01,894137,Gabriel; Corey John,23,0,25,2
1745142121713,SOCI 117,A01,895339,Staff,5,0,5,0
1745142122753,WES 237B,A00,894149,Staff,20,0,20,0
1745142124836,AESE 279B,A00,891859,Staff,35,0,35,0
1745142125865,AIP 197,001,891854,Staff,70,0,70,0
1745142126897,ANTH 289S,A00,891856,Gagneux; Pascal,12,0,12,0
1745142127920,BENG 196,001,957946,Engler; Adam J.,9996,0,9999,3
1745142128948,CAT 124RS,A01,956906,Staff,8,0,25,17
1745142129974,CAT 125RS,A01,922013,Staff,8,0,25,17
1745142130998,CLRE 250,A00,891860,Morris; Sheldon,9996,0,9999,3
1745142133052,CLRE 251R,A00,907817,Mehta; Ravindra L.,9995,0,9999,4
1745142134077,CLRE 252,A00,891864,Cuomo; Raphael Eduardo,9994,0,9999,5
1745142135103,CLRE 253,A00,891867,Vaida; Florin,9995,0,9999,4
1745142135103,CLRE 253,B00,907819,Staff,9999,0,9999,0
1745142136131,CLRE 259,A00,891868,Patel; Hemal,9998,0,9999,1
1745142137159,CLRE 260,A00,891872,Cuomo; Raphael Eduardo,9999,0,9999,0
1745142138184,CLRE 297,001,891888,Cuomo; Raphael Eduardo,9999,0,9999,0
1745142139211,CSS 201S,A01,892054,Mignozzetti; Umberto,30,0,30,0
1745142140239,CSS 202S,A01,892056,Mignozzetti; Umberto,30,0,30,0
1745142141265,DSC 197,001,956898,Eldridge; Justin Matthew,9998,0,9999,1
1745142142289,DSC 297,001,958000,Mazumdar; Arya,9999,0,9999,0
1745142143315,EAP 100,A00,905686,Staff,9774,0,9999,225
1745142144343,ECE 45,A01,892618,Staff,0,2,50,50
1745142145370,ECE 109,A01,892620,Staff,0,44,0,0
1745142146395,ECE 111,A01,892719,Staff,0,0,50,50
1745142147420,ECE 197,001,957920,Mercier; Patrick Philip,9992,0,9999,7
1745142148446,ECON 178,A01,907814,Zhu; Ying,29,0,35,6
1745142149475,EDS 115,A00,895312,Staff,42,0,45,3
1745142150505,EDS 117,A01,895337,Staff,30,0,30,0
1745142151532,EDS 125,A00,895341,Jones; Gabrielle Anastasia,43,0,45,2
1745142152558,EDS 128A,A01,895459,Fargason; Sharon Gayle,45,0,45,0
1745142153586,EDS 128B,A01,895543,Pappas; Elizabeth,45,0,45,0
1745142154612,EDS 139,A00,897203,Pappas; Elizabeth,45,0,45,0
1745142154612,EDS 139,B00,897209,Fargason; Sharon Gayle,45,0,45,0
1745142155639,EDS 201,A00,895545,Staff,44,0,45,1
1745142156680,EDS 203,A01,895581,Halter; Christopher P.,44,0,45,1
1745142157707,EDS 204R,A01,895625,Heinzman; Erica M.,45,0,45,0
1745142157707,EDS 204R,B01,895693,Halter; Christopher P.,28,0,45,17
1745142158736,EDS 206R,A00,895694,Fargason; Sharon Gayle,22,0,30,8
1745142158736,EDS 206R,B00,895695,Choi; Bailey Miyeon,21,0,30,9
1745142159766,EDS 250,A00,895697,Hemans; Patricia Ann Benitez,44,0,45,1
1745142160792,EDS 281,A00,895701,Meyerott; Theresa Ann,15,0,15,0
1745142161818,EDS 284,A00,895736,Meyerott; Theresa Ann,15,0,15,0
1745142162846,EDS 286,A00,897210,Fine; Sarah,15,0,15,0
1745142163875,EDS 289C,A01,895770,Daly; Alan J.,15,0,15,0
1745142164901,EDS 290,A00,897211,Hofstetter; Carolyn,15,0,15,0
1745142165929,LIGM 5A,A00,896162,Fischer-Grunski; Eva K,16,0,20,4
1745142166954,LIGM 5B,A00,896260,Fischer-Grunski; Eva K,19,0,20,1
1745142167980,LIGM 5C,A00,896308,Fischer-Grunski; Eva K,19,0,20,1
1745142169005,LIIT 5AS,A00,896313,Carnelos; Chiara,18,0,20,2
1745142170031,LIIT 5BS,A00,896416,Carnelos; Chiara,20,0,20,0
1745142171060,LIIT 5CS,A00,896564,Carnelos; Chiara,20,0,20,0
1745142172087,LISP 5A,A00,896588,Munoz Sanchez; Alicia,7,0,20,13
1745142173115,LISP 5B,A00,896653,Munoz Sanchez; Alicia,10,0,20,10
1745142174144,LISP 5C,A00,896655,Munoz Sanchez; Alicia,9,0,20,11
1745142175171,MAE 197,001,957918,Kleissl; Jan,9998,0,9999,1
1745142176196,MATH 2,A01,957937,Staff,34,0,35,1
1745142177223,MATH 197,001,957876,Kedlaya; Kiran S.,9996,0,9999,3
1745142178250,MCWP 40,A00,892729,Duru; Nur,16,0,20,4
1745142178250,MCWP 40,B00,893304,Montejo; Carolina,20,0,20,0
1745142179277,MCWP 40R,A00,893757,Redela; Pamela Morgan,0,3,20,20
1745142180304,MCWP 50,A00,893758,Morshed; Michael James,4,0,20,16
1745142180304,MCWP 50,B00,893761,Bartulis; Jason Michael,18,0,20,2
1745142181343,MCWP 50R,A00,893766,Compas; Sean Matthew,0,1,20,20
1745142181343,MCWP 50R,B00,893769,Carter; Jennifer A,5,0,20,15
1745142181343,MCWP 50R,C00,893771,Krone; Jarret,0,3,20,20
1745142181343,MCWP 50R,D00,893772,Miller; Elizabeth Deen,4,0,20,16
1745142181343,MCWP 50R,E00,893775,Carter; Andrea L,0,0,20,20
1745142182380,MMW 11R,A01,892721,Herbst; Matthew,22,0,30,8
1745142182380,MMW 11R,A02,892722,Herbst; Matthew,28,0,30,2
1745142183404,MMW 12R,A01,892724,Herbst; Matthew,0,5,16,16
1745142183404,MMW 12R,A02,892725,Herbst; Matthew,0,4,16,16
1745142184428,MMW 13R,A01,892727,Staff,0,29,16,16
1745142184428,MMW 13R,A02,892728,Staff,0,28,16,16
1745142185456,SIO 295LS,A00,894015,Staff,9,0,25,16
1745142186484,SIO 295S,A00,894020,Staff,9,0,25,16
1745142187515,SIOC 290S,A01,894063,Merrifield; Mark A,23,0,25,2
1745142188539,SIOC 291S,A01,894137,Gabriel; Corey John,23,0,25,2
1745142189568,SOCI 117,A01,895339,Staff,5,0,5,0
1745142190596,WES 237B,A00,894149,Staff,20,0,20,0
1745142192668,AESE 279B,A00,891859,Staff,35,0,35,0
1745142193693,AIP 197,001,891854,Staff,70,0,70,0
1745142194721,ANTH 289S,A00,891856,Gagneux; Pascal,12,0,12,0
1745142195752,BENG 196,001,957946,Engler; Adam J.,9996,0,9999,3
1745142196779,CAT 124RS,A01,956906,Staff,8,0,25,17
1745142197804,CAT 125RS,A01,922013,Staff,8,0,25,17
1745142198830,CLRE 250,A00,891860,Morris; Sheldon,9996,0,9999,3
1745142200885,CLRE 251R,A00,907817,Mehta; Ravindra L.,9995,0,9999,4
1745142201912,CLRE 252,A00,891864,Cuomo; Raphael Eduardo,9994,0,9999,5
1745142202939,CLRE 253,A00,891867,Vaida; Florin,9995,0,9999,4
1745142202939,CLRE 253,B00,907819,Staff,9999,0,9999,0
1745142203966,CLRE 259,A00,891868,Patel; Hemal,9998,0,9999,1
1745142204990,CLRE 260,A00,891872,Cuomo; Raphael Eduardo,9999,0,9999,0
1745142206016,CLRE 297,001,891888,Cuomo; Raphael Eduardo,9999,0,9999,0
1745142207047,CSS 201S,A01,892054,Mignozzetti; Umberto,30,0,30,0
1745142208080,CSS 202S,A01,892056,Mignozzetti; Umberto,30,0,30,0
1745142209106,DSC 197,001,956898,Eldridge; Justin Matthew,9998,0,9999,1
1745142210135,DSC 297,001,958000,Mazumdar; Arya,9999,0,9999,0
1745142211160,EAP 100,A00,905686,Staff,9774,0,9999,225
1745142212187,ECE 45,A01,892618,Staff,0,2,50,50
1745142213217,ECE 109,A01,892620,Staff,0,44,0,0
1745142214243,ECE 111,A01,892719,Staff,0,0,50,50
1745142215268,ECE 197,001,957920,Mercier; Patrick Philip,9992,0,9999,7
1745142216295,ECON 178,A01,907814,Zhu; Ying,29,0,35,6
1745142217324,EDS 115,A00,895312,Staff,42,0,45,3
1745142218353,EDS 117,A01,895337,Staff,30,0,30,0
1745142219386,EDS 125,A00,895341,Jones; Gabrielle Anastasia,43,0,45,2
1745142220416,EDS 128A,A01,895459,Fargason; Sharon Gayle,45,0,45,0
1745142221443,EDS 128B,A01,895543,Pappas; Elizabeth,45,0,45,0
1745142222468,EDS 139,A00,897203,Pappas; Elizabeth,45,0,45,0
1745142222468,EDS 139,B00,897209,Fargason; Sharon Gayle,45,0,45,0
1745142223497,EDS 201,A00,895545,Staff,44,0,45,1
1745142224523,EDS 203,A01,895581,Halter; Christopher P.,44,0,45,1
1745142225550,EDS 204R,A01,895625,Heinzman; Erica M.,45,0,45,0
1745142225550,EDS 204R,B01,895693,Halter; Christopher P.,28,0,45,17
1745142226581,EDS 206R,A00,895694,Fargason; Sharon Gayle,22,0,30,8
1745142226581,EDS 206R,B00,895695,Choi; Bailey Miyeon,21,0,30,9
1745142227611,EDS 250,A00,895697,Hemans; Patricia Ann Benitez,44,0,45,1
1745142228639,EDS 281,A00,895701,Meyerott; Theresa Ann,15,0,15,0
1745142229671,EDS 284,A00,895736,Meyerott; Theresa Ann,15,0,15,0
1745142230713,EDS 286,A00,897210,Fine; Sarah,15,0,15,0
1745142231740,EDS 289C,A01,895770,Daly; Alan J.,15,0,15,0
1745142232766,EDS 290,A00,897211,Hofstetter; Carolyn,15,0,15,0
1745142233802,LIGM 5A,A00,896162,Fischer-Grunski; Eva K,16,0,20,4
1745142234829,LIGM 5B,A00,896260,Fischer-Grunski; Eva K,19,0,20,1
1745142235855,LIGM 5C,A00,896308,Fischer-Grunski; Eva K,19,0,20,1
1745142236883,LIIT 5AS,A00,896313,Carnelos; Chiara,18,0,20,2
1745142237913,LIIT 5BS,A00,896416,Carnelos; Chiara,20,0,20,0
1745142238938,LIIT 5CS,A00,896564,Carnelos; Chiara,20,0,20,0
1745142239965,LISP 5A,A00,896588,Munoz Sanchez; Alicia,7,0,20,13
1745142240991,LISP 5B,A00,896653,Munoz Sanchez; Alicia,10,0,20,10
1745142242018,LISP 5C,A00,896655,Munoz Sanchez; Alicia,9,0,20,11
1745142243042,MAE 197,001,957918,Kleissl; Jan,9998,0,9999,1
1745142244068,MATH 2,A01,957937,Staff,34,0,35,1
1745142245095,MATH 197,001,957876,Kedlaya; Kiran S.,9996,0,9999,3
1745142246124,MCWP 40,A00,892729,Duru; Nur,16,0,20,4
1745142246124,MCWP 40,B00,893304,Montejo; Carolina,20,0,20,0
1745142247150,MCWP 40R,A00,893757,Redela; Pamela Morgan,0,3,20,20
1745142248177,MCWP 50,A00,893758,Morshed; Michael James,4,0,20,16
1745142248177,MCWP 50,B00,893761,Bartulis; Jason Michael,18,0,20,2
1745142249207,MCWP 50R,A00,893766,Compas; Sean Matthew,0,1,20,20
1745142249207,MCWP 50R,B00,893769,Carter; Jennifer A,5,0,20,15
1745142249207,MCWP 50R,C00,893771,Krone; Jarret,0,3,20,20
1745142249207,MCWP 50R,D00,893772,Miller; Elizabeth Deen,4,0,20,16
1745142249207,MCWP 50R,E00,893775,Carter; Andrea L,0,0,20,20
1745142250235,MMW 11R,A01,892721,Herbst; Matthew,22,0,30,8
1745142250235,MMW 11R,A02,892722,Herbst; Matthew,28,0,30,2
1745142251263,MMW 12R,A01,892724,Herbst; Matthew,0,5,16,16
1745142251263,MMW 12R,A02,892725,Herbst; Matthew,0,4,16,16
1745142252292,MMW 13R,A01,892727,Staff,0,29,16,16
1745142252292,MMW 13R,A02,892728,Staff,0,28,16,16
1745142253319,SIO 295LS,A00,894015,Staff,9,0,25,16
1745142254345,SIO 295S,A00,894020,Staff,9,0,25,16
1745142255374,SIOC 290S,A01,894063,Merrifield; Mark A,23,0,25,2
1745142256405,SIOC 291S,A01,894137,Gabriel; Corey John,23,0,25,2
1745142257436,SOCI 117,A01,895339,Staff,5,0,5,0
1745142258462,WES 237B,A00,894149,Staff,20,0,20,0
1745142260536,AESE 279B,A00,891859,Staff,35,0,35,0
1745142261566,AIP 197,001,891854,Staff,70,0,70,0
1745142262597,ANTH 289S,A00,891856,Gagneux; Pascal,12,0,12,0
1745142263626,BENG 196,001,957946,Engler; Adam J.,9996,0,9999,3
1745142264653,CAT 124RS,A01,956906,Staff,8,0,25,17
1745142265680,CAT 125RS,A01,922013,Staff,8,0,25,17
1745142266713,CLRE 250,A00,891860,Morris; Sheldon,9996,0,9999,3
1745142268767,CLRE 251R,A00,907817,Mehta; Ravindra L.,9995,0,9999,4
1745142269795,CLRE 252,A00,891864,Cuomo; Raphael Eduardo,9994,0,9999,5
1745142270825,CLRE 253,A00,891867,Vaida; Florin,9995,0,9999,4
1745142270825,CLRE 253,B00,907819,Staff,9999,0,9999,0
1745142271852,CLRE 259,A00,891868,Patel; Hemal,9998,0,9999,1
1745142272882,CLRE 260,A00,891872,Cuomo; Raphael Eduardo,9999,0,9999,0
1745142273908,CLRE 297,001,891888,Cuomo; Raphael Eduardo,9999,0,9999,0
1745142274953,CSS 201S,A01,892054,Mignozzetti; Umberto,30,0,30,0
1745142275978,CSS 202S,A01,892056,Mignozzetti; Umberto,30,0,30,0
1745142277010,DSC 197,001,956898,Eldridge; Justin Matthew,9998,0,9999,1
1745142278038,DSC 297,001,958000,Mazumdar; Arya,9999,0,9999,0
1745142279066,EAP 100,A00,905686,Staff,9774,0,9999,225
1745142280097,ECE 45,A01,892618,Staff,0,2,50,50
1745142281127,ECE 109,A01,892620,Staff,0,44,0,0
1745142282156,ECE 111,A01,892719,Staff,0,0,50,50
1745142283185,ECE 197,001,957920,Mercier; Patrick Philip,9992,0,9999,7
1745142284213,ECON 178,A01,907814,Zhu; Ying,29,0,35,6
1745142285239,EDS 115,A00,895312,Staff,42,0,45,3
1745142286266,EDS 117,A01,895337,Staff,30,0,30,0
1745142287296,EDS 125,A00,895341,Jones; Gabrielle Anastasia,43,0,45,2
1745142288327,EDS 128A,A01,895459,Fargason; Sharon Gayle,45,0,45,0
1745142289353,EDS 128B,A01,895543,Pappas; Elizabeth,45,0,45,0
1745142290380,EDS 139,A00,897203,Pappas; Elizabeth,45,0,45,0
1745142290380,EDS 139,B00,897209,Fargason; Sharon Gayle,45,0,45,0
1745142291408,EDS 201,A00,895545,Staff,44,0,45,1
1745142292442,EDS 203,A01,895581,Halter; Christopher P.,44,0,45,1
1745142293472,EDS 204R,A01,895625,Heinzman; Erica M.,45,0,45,0
1745142293472,EDS 204R,B01,895693,Halter; Christopher P.,28,0,45,17
1745142294500,EDS 206R,A00,895694,Fargason; Sharon Gayle,22,0,30,8
1745142294500,EDS 206R,B00,895695,Choi; Bailey Miyeon,21,0,30,9
1745142295528,EDS 250,A00,895697,Hemans; Patricia Ann Benitez,44,0,45,1
1745142296559,EDS 281,A00,895701,Meyerott; Theresa Ann,15,0,15,0
1745142297585,EDS 284,A00,895736,Meyerott; Theresa Ann,15,0,15,0
1745142298618,EDS 286,A00,897210,Fine; Sarah,15,0,15,0
1745142299647,EDS 289C,A01,895770,Daly; Alan J.,15,0,15,0
1745142300677,EDS 290,A00,897211,Hofstetter; Carolyn,15,0,15,0
1745142301706,LIGM 5A,A00,896162,Fischer-Grunski; Eva K,16,0,20,4
1745142302739,LIGM 5B,A00,896260,Fischer-Grunski; Eva K,19,0,20,1
1745142303766,LIGM 5C,A00,896308,Fischer-Grunski; Eva K,19,0,20,1
1745142304797,LIIT 5AS,A00,896313,Carnelos; Chiara,18,0,20,2
1745142305825,LIIT 5BS,A00,896416,Carnelos; Chiara,20,0,20,0
1745142306856,LIIT 5CS,A00,896564,Carnelos; Chiara,20,0,20,0
1745142307885,LISP 5A,A00,896588,Munoz Sanchez; Alicia,7,0,20,13
1745142308911,LISP 5B,A00,896653,Munoz Sanchez; Alicia,10,0,20,10
1745142309940,LISP 5C,A00,896655,Munoz Sanchez; Alicia,9,0,20,11
1745142310968,MAE 197,001,957918,Kleissl; Jan,9998,0,9999,1
1745142311995,MATH 2,A01,957937,Staff,34,0,35,1
1745142313021,MATH 197,001,957876,Kedlaya; Kiran S.,9996,0,9999,3
1745142314055,MCWP 40,A00,892729,Duru; Nur,16,0,20,4
1745142314055,MCWP 40,B00,893304,Montejo; Carolina,20,0,20,0
1745142315082,MCWP 40R,A00,893757,Redela; Pamela Morgan,0,3,20,20
1745142316113,MCWP 50,A00,893758,Morshed; Michael James,4,0,20,16
1745142316113,MCWP 50,B00,893761,Bartulis; Jason Michael,18,0,20,2
1745142317151,MCWP 50R,A00,893766,Compas; Sean Matthew,0,1,20,20
1745142317151,MCWP 50R,B00,893769,Carter; Jennifer A,5,0,20,15
1745142317151,MCWP 50R,C00,893771,Krone; Jarret,0,3,20,20
1745142317151,MCWP 50R,D00,893772,Miller; Elizabeth Deen,4,0,20,16
1745142317151,MCWP 50R,E00,893775,Carter; Andrea L,0,0,20,20
1745142318184,MMW 11R,A01,892721,Herbst; Matthew,22,0,30,8
1745142318184,MMW 11R,A02,892722,Herbst; Matthew,28,0,30,2
1745142319210,MMW 12R,A01,892724,Herbst; Matthew,0,5,16,16
1745142319210,MMW 12R,A02,892725,Herbst; Matthew,0,4,16,16
1745142320242,MMW 13R,A01,892727,Staff,0,29,16,16
1745142320242,MMW 13R,A02,892728,Staff,0,28,16,16
1745142321273,SIO 295LS,A00,894015,Staff,9,0,25,16
1745142322303,SIO 295S,A00,894020,Staff,9,0,25,16
1745142323332,SIOC 290S,A01,894063,Merrifield; Mark A,23,0,25,2
1745142324365,SIOC 291S,A01,894137,Gabriel; Corey John,23,0,25,2
1745142325391,SOCI 117,A01,895339,Staff,5,0,5,0
1745142326419,WES 237B,A00,894149,Staff,20,0,20,0
1745142328526,AESE 279B,A00,891859,Staff,35,0,35,0
1745142329552,AIP 197,001,891854,Staff,70,0,70,0
1745142330594,ANTH 289S,A00,891856,Gagneux; Pascal,12,0,12,0
1745142331621,BENG 196,001,957946,Engler; Adam J.,9996,0,9999,3
1745142332653,CAT 124RS,A01,956906,Staff,8,0,25,17
1745142333679,CAT 125RS,A01,922013,Staff,8,0,25,17
1745142334712,CLRE 250,A00,891860,Morris; Sheldon,9996,0,9999,3
1745142336769,CLRE 251R,A00,907817,Mehta; Ravindra L.,9995,0,9999,4
1745142337800,CLRE 252,A00,891864,Cuomo; Raphael Eduardo,9994,0,9999,5
1745142338832,CLRE 253,A00,891867,Vaida; Florin,9995,0,9999,4
1745142338832,CLRE 253,B00,907819,Staff,9999,0,9999,0
1745142339860,CLRE 259,A00,891868,Patel; Hemal,9998,0,9999,1
1745142340887,CLRE 260,A00,891872,Cuomo; Raphael Eduardo,9999,0,9999,0
1745142341911,CLRE 297,001,891888,Cuomo; Raphael Eduardo,9999,0,9999,0
1745142342938,CSS 201S,A01,892054,Mignozzetti; Umberto,30,0,30,0
1745142343966,CSS 202S,A01,892056,Mignozzetti; Umberto,30,0,30,0
1745142344997,DSC 197,001,956898,Eldridge; Justin Matthew,9998,0,9999,1
1745142346026,DSC 297,001,958000,Mazumdar; Arya,9999,0,9999,0
1745142347055,EAP 100,A00,905686,Staff,9774,0,9999,225
1745142348086,ECE 45,A01,892618,Staff,0,2,50,50
1745142349114,ECE 109,A01,892620,Staff,0,44,0,0
1745142350141,ECE 111,A01,892719,Staff,0,0,50,50
1745142351182,ECE 197,001,957920,Mercier; Patrick Philip,9992,0,9999,7
1745142352209,ECON 178,A01,907814,Zhu; Ying,29,0,35,6
1745142353235,EDS 115,A00,895312,Staff,42,0,45,3
1745142354264,EDS 117,A01,895337,Staff,30,0,30,0
1745142355290,EDS 125,A00,895341,Jones; Gabrielle Anastasia,43,0,45,2
1745142356317,EDS 128A,A01,895459,Fargason; Sharon Gayle,45,0,45,0
1745142357344,EDS 128B,A01,895543,Pappas; Elizabeth,45,0,45,0
1745142358373,EDS 139,A00,897203,Pappas; Elizabeth,45,0,45,0
1745142358373,EDS 139,B00,897209,Fargason; Sharon Gayle,45,0,45,0
1745142369274,EDS 201,A00,895545,Staff,44,0,45,1
1745142370301,EDS 203,A01,895581,Halter; Christopher P.,44,0,45,1
1745142371335,EDS 204R,A01,895625,Heinzman; Erica M.,45,0,45,0
1745142371335,EDS 204R,B01,895693,Halter; Christopher P.,28,0,45,17
1745142372366,EDS 206R,A00,895694,Fargason; Sharon Gayle,22,0,30,8
1745142372366,EDS 206R,B00,895695,Choi; Bailey Miyeon,21,0,30,9
1745142373391,EDS 250,A00,895697,Hemans; Patricia Ann Benitez,44,0,45,1
1745142374421,EDS 281,A00,895701,Meyerott; Theresa Ann,15,0,15,0
1745142375447,EDS 284,A00,895736,Meyerott; Theresa Ann,15,0,15,0
1745142376473,EDS 286,A00,897210,Fine; Sarah,15,0,15,0
1745142377505,EDS 289C,A01,895770,Daly; Alan J.,15,0,15,0
1745142378532,EDS 290,A00,897211,Hofstetter; Carolyn,15,0,15,0
1745142379562,LIGM 5A,A00,896162,Fischer-Grunski; Eva K,16,0,20,4
1745142380589,LIGM 5B,A00,896260,Fischer-Grunski; Eva K,19,0,20,1
1745142381615,LIGM 5C,A00,896308,Fischer-Grunski; Eva K,19,0,20,1
1745142382642,LIIT 5AS,A00,896313,Carnelos; Chiara,18,0,20,2
1745142383669,LIIT 5BS,A00,896416,Carnelos; Chiara,20,0,20,0
1745142384697,LIIT 5CS,A00,896564,Carnelos; Chiara,20,0,20,0
1745142385725,LISP 5A,A00,896588,Munoz Sanchez; Alicia,7,0,20,13
1745142386752,LISP 5B,A00,896653,Munoz Sanchez; Alicia,10,0,20,10
1745142387779,LISP 5C,A00,896655,Munoz Sanchez; Alicia,9,0,20,11
1745142388806,MAE 197,001,957918,Kleissl; Jan,9998,0,9999,1
1745142389832,MATH 2,A01,957937,Staff,34,0,35,1
1745142390858,MATH 197,001,957876,Kedlaya; Kiran S.,9996,0,9999,3
1745142391889,MCWP 40,A00,892729,Duru; Nur,16,0,20,4
1745142391889,MCWP 40,B00,893304,Montejo; Carolina,20,0,20,0
1745142392915,MCWP 40R,A00,893757,Redela; Pamela Morgan,0,3,20,20
1745142393942,MCWP 50,A00,893758,Morshed; Michael James,4,0,20,16
1745142393942,MCWP 50,B00,893761,Bartulis; Jason Michael,18,0,20,2
1745142394976,MCWP 50R,A00,893766,Compas; Sean Matthew,0,1,20,20
1745142394976,MCWP 50R,B00,893769,Carter; Jennifer A,5,0,20,15
1745142394976,MCWP 50R,C00,893771,Krone; Jarret,0,3,20,20
1745142394976,MCWP 50R,D00,893772,Miller; Elizabeth Deen,4,0,20,16
1745142394976,MCWP 50R,E00,893775,Carter; Andrea L,0,0,20,20
1745142396006,MMW 11R,A01,892721,Herbst; Matthew,22,0,30,8
1745142396006,MMW 11R,A02,892722,Herbst; Matthew,28,0,30,2
1745142397034,MMW 12R,A01,892724,Herbst; Matthew,0,5,16,16
1745142397034,MMW 12R,A02,892725,Herbst; Matthew,0,4,16,16
1745142398059,MMW 13R,A01,892727,Staff,0,29,16,16
1745142398059,MMW 13R,A02,892728,Staff,0,28,16,16
1745142399084,SIO 295LS,A00,894015,Staff,9,0,25,16
1745142400112,SIO 295S,A00,894020,Staff,9,0,25,16
1745142401145,SIOC 290S,A01,894063,Merrifield; Mark A,23,0,25,2
1745142402179,SIOC 291S,A01,894137,Gabriel; Corey John,23,0,25,2
1745142403204,SOCI 117,A01,895339,Staff,5,0,5,0
1745142404230,WES 237B,A00,894149,Staff,20,0,20,0
1745142406308,AESE 279B,A00,891859,Staff,35,0,35,0
1745142407333,AIP 197,001,891854,Staff,70,0,70,0
1745142408362,ANTH 289S,A00,891856,Gagneux; Pascal,12,0,12,0
1745142409389,BENG 196,001,957946,Engler; Adam J.,9996,0,9999,3
1745142410414,CAT 124RS,A01,956906,Staff,8,0,25,17
1745142411443,CAT 125RS,A01,922013,Staff,8,0,25,17
1745142412468,CLRE 250,A00,891860,Morris; Sheldon,9996,0,9999,3
1745142414520,CLRE 251R,A00,907817,Mehta; Ravindra L.,9995,0,9999,4
1745142415546,CLRE 252,A00,891864,Cuomo; Raphael Eduardo,9994,0,9999,5
1745142416572,CLRE 253,A00,891867,Vaida; Florin,9995,0,9999,4
1745142416572,CLRE 253,B00,907819,Staff,9999,0,9999,0
1745142417599,CLRE 259,A00,891868,Patel; Hemal,9998,0,9999,1
1745142418629,CLRE 260,A00,891872,Cuomo; Raphael Eduardo,9999,0,9999,0
1745142419657,CLRE 297,001,891888,Cuomo; Raphael Eduardo,9999,0,9999,0
1745142420685,CSS 201S,A01,892054,Mignozzetti; Umberto,30,0,30,0
1745142421715,CSS 202S,A01,892056,Mignozzetti; Umberto,30,0,30,0
1745142422744,DSC 197,001,956898,Eldridge; Justin Matthew,9998,0,9999,1
1745142423774,DSC 297,001,958000,Mazumdar; Arya,9999,0,9999,0
1745142424801,EAP 100,A00,905686,Staff,9774,0,9999,225
1745142425830,ECE 45,A01,892618,Staff,0,2,50,50
1745142426857,ECE 109,A01,892620,Staff,0,44,0,0
1745142427883,ECE 111,A01,892719,Staff,0,0,50,50
1745142428908,ECE 197,001,957920,Mercier; Patrick Philip,9992,0,9999,7
1745142429935,ECON 178,A01,907814,Zhu; Ying,29,0,35,6
1745142430960,EDS 115,A00,895312,Staff,42,0,45,3
1745142431991,EDS 117,A01,895337,Staff,30,0,30,0
1745142433018,EDS 125,A00,895341,Jones; Gabrielle Anastasia,43,0,45,2
1745142434044,EDS 128A,A01,895459,Fargason; Sharon Gayle,45,0,45,0
1745142435070,EDS 128B,A01,895543,Pappas; Elizabeth,45,0,45,0
1745142436099,EDS 139,A00,897203,Pappas; Elizabeth,45,0,45,0
1745142436099,EDS 139,B00,897209,Fargason; Sharon Gayle,45,0,45,0
1745142437126,EDS 201,A00,895545,Staff,44,0,45,1
1745142438161,EDS 203,A01,895581,Halter; Christopher P.,44,0,45,1
1745142439189,EDS 204R,A01,895625,Heinzman; Erica M.,45,0,45,0
1745142439189,EDS 204R,B01,895693,Halter; Christopher P.,28,0,45,17
1745142440218,EDS 206R,A00,895694,Fargason; Sharon Gayle,22,0,30,8
1745142440218,EDS 206R,B00,895695,Choi; Bailey Miyeon,21,0,30,9
1745142441246,EDS 250,A00,895697,Hemans; Patricia Ann Benitez,44,0,45,1
1745142442270,EDS 281,A00,895701,Meyerott; Theresa Ann,15,0,15,0
1745142443303,EDS 284,A00,895736,Meyerott; Theresa Ann,15,0,15,0
1745142444330,EDS 286,A00,897210,Fine; Sarah,15,0,15,0
1745142445356,EDS 289C,A01,895770,Daly; Alan J.,15,0,15,0
1745142446384,EDS 290,A00,897211,Hofstetter; Carolyn,15,0,15,0
1745142447411,LIGM 5A,A00,896162,Fischer-Grunski; Eva K,16,0,20,4
1745142448437,LIGM 5B,A00,896260,Fischer-Grunski; Eva K,19,0,20,1
1745142449467,LIGM 5C,A00,896308,Fischer-Grunski; Eva K,19,0,20,1
1745142450492,LIIT 5AS,A00,896313,Carnelos; Chiara,18,0,20,2
1745142451523,LIIT 5BS,A00,896416,Carnelos; Chiara,20,0,20,0
1745142452554,LIIT 5CS,A00,896564,Carnelos; Chiara,20,0,20,0
1745142453579,LISP 5A,A00,896588,Munoz Sanchez; Alicia,7,0,20,13
1745142454604,LISP 5B,A00,896653,Munoz Sanchez; Alicia,10,0,20,10
1745142455631,LISP 5C,A00,896655,Munoz Sanchez; Alicia,9,0,20,11
1745142456662,MAE 197,001,957918,Kleissl; Jan,9998,0,9999,1
1745142457688,MATH 2,A01,957937,Staff,34,0,35,1
1745142458717,MATH 197,001,957876,Kedlaya; Kiran S.,9996,0,9999,3
1745142459750,MCWP 40,A00,892729,Duru; Nur,15,0,20,5
1745142459750,MCWP 40,B00,893304,Montejo; Carolina,20,0,20,0
1745142460778,MCWP 40R,A00,893757,Redela; Pamela Morgan,0,3,20,20
1745142461809,MCWP 50,A00,893758,Morshed; Michael James,4,0,20,16
1745142461809,MCWP 50,B00,893761,Bartulis; Jason Michael,18,0,20,2
1745142462834,MCWP 50R,A00,893766,Compas; Sean Matthew,0,1,20,20
1745142462834,MCWP 50R,B00,893769,Carter; Jennifer A,5,0,20,15
1745142462834,MCWP 50R,C00,893771,Krone; Jarret,0,3,20,20
1745142462834,MCWP 50R,D00,893772,Miller; Elizabeth Deen,4,0,20,16
1745142462834,MCWP 50R,E00,893775,Carter; Andrea L,0,0,20,20
1745142463865,MMW 11R,A01,892721,Herbst; Matthew,22,0,30,8
1745142463865,MMW 11R,A02,892722,Herbst; Matthew,28,0,30,2
1745142464894,MMW 12R,A01,892724,Herbst; Matthew,0,5,16,16
1745142464894,MMW 12R,A02,892725,Herbst; Matthew,0,4,16,16
1745142465922,MMW 13R,A01,892727,Staff,0,29,16,16
1745142465922,MMW 13R,A02,892728,Staff,0,28,16,16
1745142466949,SIO 295LS,A00,894015,Staff,9,0,25,16
1745142467979,SIO 295S,A00,894020,Staff,9,0,25,16
1745142469005,SIOC 290S,A01,894063,Merrifield; Mark A,23,0,25,2
1745142470030,SIOC 291S,A01,894137,Gabriel; Corey John,23,0,25,2
1745142471055,SOCI 117,A01,895339,Staff,5,0,5,0
1745142472083,WES 237B,A00,894149,Staff,20,0,20,0
1745142474186,AESE 279B,A00,891859,Staff,35,0,35,0
1745142475214,AIP 197,001,891854,Staff,70,0,70,0
1745142476240,ANTH 289S,A00,891856,Gagneux; Pascal,12,0,12,0
1745142477268,BENG 196,001,957946,Engler; Adam J.,9996,0,9999,3
1745142478293,CAT 124RS,A01,956906,Staff,8,0,25,17
1745142479325,CAT 125RS,A01,922013,Staff,8,0,25,17
1745142480351,CLRE 250,A00,891860,Morris; Sheldon,9996,0,9999,3
1745142482413,CLRE 251R,A00,907817,Mehta; Ravindra L.,9995,0,9999,4
1745142483442,CLRE 252,A00,891864,Cuomo; Raphael Eduardo,9994,0,9999,5
1745142484470,CLRE 253,A00,891867,Vaida; Florin,9995,0,9999,4
1745142484470,CLRE 253,B00,907819,Staff,9999,0,9999,0
1745142485514,CLRE 259,A00,891868,Patel; Hemal,9998,0,9999,1
1745142486538,CLRE 260,A00,891872,Cuomo; Raphael Eduardo,9999,0,9999,0
1745142487569,CLRE 297,001,891888,Cuomo; Raphael Eduardo,9999,0,9999,0
1745142488596,CSS 201S,A01,892054,Mignozzetti; Umberto,30,0,30,0
1745142489621,CSS 202S,A01,892056,Mignozzetti; Umberto,30,0,30,0
1745142490648,DSC 197,001,956898,Eldridge; Justin Matthew,9998,0,9999,1
1745142491679,DSC 297,001,958000,Mazumdar; Arya,9999,0,9999,0
1745142492705,EAP 100,A00,905686,Staff,9774,0,9999,225
1745142493730,ECE 45,A01,892618,Staff,0,2,50,50
1745142494756,ECE 109,A01,892620,Staff,0,44,0,0
1745142495786,ECE 111,A01,892719,Staff,0,0,50,50
1745142496815,ECE 197,001,957920,Mercier; Patrick Philip,9992,0,9999,7
1745142497842,ECON 178,A01,907814,Zhu; Ying,29,0,35,6
1745142498869,EDS 115,A00,895312,Staff,42,0,45,3
1745142499894,EDS 117,A01,895337,Staff,30,0,30,0
1745142500920,EDS 125,A00,895341,Jones; Gabrielle Anastasia,43,0,45,2
1745142501946,EDS 128A,A01,895459,Fargason; Sharon Gayle,45,0,45,0
1745142502976,EDS 128B,A01,895543,Pappas; Elizabeth,45,0,45,0
1745142504001,EDS 139,A00,897203,Pappas; Elizabeth,45,0,45,0
1745142504001,EDS 139,B00,897209,Fargason; Sharon Gayle,45,0,45,0
1745142505029,EDS 201,A00,895545,Staff,44,0,45,1
1745142506055,EDS 203,A01,895581,Halter; Christopher P.,44,0,45,1
1745142507084,EDS 204R,A01,895625,Heinzman; Erica M.,45,0,45,0
1745142507084,EDS 204R,B01,895693,Halter; Christopher P.,28,0,45,17
1745142508114,EDS 206R,A00,895694,Fargason; Sharon Gayle,22,0,30,8
1745142508114,EDS 206R,B00,895695,Choi; Bailey Miyeon,21,0,30,9
1745142509142,EDS 250,A00,895697,Hemans; Patricia Ann Benitez,44,0,45,1
1745142510171,EDS 281,A00,895701,Meyerott; Theresa Ann,15,0,15,0
1745142511196,EDS 284,A00,895736,Meyerott; Theresa Ann,15,0,15,0
1745142512225,EDS 286,A00,897210,Fine; Sarah,15,0,15,0
1745142513251,EDS 289C,A01,895770,Daly; Alan J.,15,0,15,0
1745142514277,EDS 290,A00,897211,Hofstetter; Carolyn,15,0,15,0
1745142515308,LIGM 5A,A00,896162,Fischer-Grunski; Eva K,16,0,20,4
1745142516336,LIGM 5B,A00,896260,Fischer-Grunski; Eva K,19,0,20,1
1745142517364,LIGM 5C,A00,896308,Fischer-Grunski; Eva K,19,0,20,1
1745142518394,LIIT 5AS,A00,896313,Carnelos; Chiara,18,0,20,2
1745142519421,LIIT 5BS,A00,896416,Carnelos; Chiara,20,0,20,0
1745142520448,LIIT 5CS,A00,896564,Carnelos; Chiara,20,0,20,0
1745142521476,LISP 5A,A00,896588,Munoz Sanchez; Alicia,7,0,20,13
1745142522501,LISP 5B,A00,896653,Munoz Sanchez; Alicia,10,0,20,10
1745142523532,LISP 5C,A00,896655,Munoz Sanchez; Alicia,9,0,20,11
1745142524556,MAE 197,001,957918,Kleissl; Jan,9998,0,9999,1
1745142525593,MATH 2,A01,957937,Staff,34,0,35,1
1745142526619,MATH 197,001,957876,Kedlaya; Kiran S.,9996,0,9999,3
1745142527651,MCWP 40,A00,892729,Duru; Nur,15,0,20,5
1745142527651,MCWP 40,B00,893304,Montejo; Carolina,20,0,20,0
1745142528677,MCWP 40R,A00,893757,Redela; Pamela Morgan,0,3,20,20
1745142529703,MCWP 50,A00,893758,Morshed; Michael James,4,0,20,16
1745142529703,MCWP 50,B00,893761,Bartulis; Jason Michael,18,0,20,2
1745142530738,MCWP 50R,A00,893766,Compas; Sean Matthew,0,1,20,20
1745142530738,MCWP 50R,B00,893769,Carter; Jennifer A,5,0,20,15
1745142530738,MCWP 50R,C00,893771,Krone; Jarret,0,3,20,20
1745142530738,MCWP 50R,D00,893772,Miller; Elizabeth Deen,4,0,20,16
1745142530738,MCWP 50R,E00,893775,Carter; Andrea L,0,0,20,20
1745142531818,MMW 11R,A01,892721,Herbst; Matthew,22,0,30,8
1745142531818,MMW 11R,A02,892722,Herbst; Matthew,28,0,30,2
1745142532846,MMW 12R,A01,892724,Herbst; Matthew,0,5,16,16
1745142532846,MMW 12R,A02,892725,Herbst; Matthew,0,4,16,16
1745142533876,MMW 13R,A01,892727,Staff,0,29,16,16
1745142533876,MMW 13R,A02,892728,Staff,0,28,16,16
1745142534905,SIO 295LS,A00,894015,Staff,9,0,25,16
1745142535932,SIO 295S,A00,894020,Staff,9,0,25,16
1745142536964,SIOC 290S,A01,894063,Merrifield; Mark A,23,0,25,2
1745142537995,SIOC 291S,A01,894137,Gabriel; Corey John,23,0,25,2
1745142539021,SOCI 117,A01,895339,Staff,5,0,5,0
1745142540050,WES 237B,A00,894149,Staff,20,0,20,0
1745142542134,AESE 279B,A00,891859,Staff,35,0,35,0
1745142543162,AIP 197,001,891854,Staff,70,0,70,0
1745142544194,ANTH 289S,A00,891856,Gagneux; Pascal,12,0,12,0
1745142545222,BENG 196,001,957946,Engler; Adam J.,9996,0,9999,3
1745142546245,CAT 124RS,A01,956906,Staff,8,0,25,17
1745142547273,CAT 125RS,A01,922013,Staff,8,0,25,17
1745142548305,CLRE 250,A00,891860,Morris; Sheldon,9996,0,9999,3
1745142550362,CLRE 251R,A00,907817,Mehta; Ravindra L.,9995,0,9999,4
1745142551389,CLRE 252,A00,891864,Cuomo; Raphael Eduardo,9994,0,9999,5
1745142552416,CLRE 253,A00,891867,Vaida; Florin,9995,0,9999,4
1745142552416,CLRE 253,B00,907819,Staff,9999,0,9999,0
1745142553443,CLRE 259,A00,891868,Patel; Hemal,9998,0,9999,1
1745142554471,CLRE 260,A00,891872,Cuomo; Raphael Eduardo,9999,0,9999,0
1745142555500,CLRE 297,001,891888,Cuomo; Raphael Eduardo,9999,0,9999,0
1745142556527,CSS 201S,A01,892054,Mignozzetti; Umberto,30,0,30,0
1745142557555,CSS 202S,A01,892056,Mignozzetti; Umberto,30,0,30,0
1745142558581,DSC 197,001,956898,Eldridge; Justin Matthew,9998,0,9999,1
1745142559626,DSC 297,001,958000,Mazumdar; Arya,9999,0,9999,0
1745142560654,EAP 100,A00,905686,Staff,9774,0,9999,225
1745142561681,ECE 45,A01,892618,Staff,0,2,50,50
1745142562707,ECE 109,A01,892620,Staff,0,44,0,0
1745142563737,ECE 111,A01,892719,Staff,0,0,50,50
1745142564768,ECE 197,001,957920,Mercier; Patrick Philip,9992,0,9999,7
1745142565801,ECON 178,A01,907814,Zhu; Ying,29,0,35,6
1745142566829,EDS 115,A00,895312,Staff,42,0,45,3
1745142567859,EDS 117,A01,895337,Staff,30,0,30,0
1745142568889,EDS 125,A00,895341,Jones; Gabrielle Anastasia,43,0,45,2
1745142569916,EDS 128A,A01,895459,Fargason; Sharon Gayle,45,0,45,0
1745142570943,EDS 128B,A01,895543,Pappas; Elizabeth,45,0,45,0
1745142571971,EDS 139,A00,897203,Pappas; Elizabeth,45,0,45,0
1745142571971,EDS 139,B00,897209,Fargason; Sharon Gayle,45,0,45,0
1745142572997,EDS 201,A00,895545,Staff,44,0,45,1
1745142574024,EDS 203,A01,895581,Halter; Christopher P.,44,0,45,1
1745142575052,EDS 204R,A01,895625,Heinzman; Erica M.,45,0,45,0
1745142575052,EDS 204R,B01,895693,Halter; Christopher P.,28,0,45,17
1745142576077,EDS 206R,A00,895694,Fargason; Sharon Gayle,22,0,30,8
1745142576077,EDS 206R,B00,895695,Choi; Bailey Miyeon,21,0,30,9
1745142577103,EDS 250,A00,895697,Hemans; Patricia Ann Benitez,44,0,45,1
1745142578135,EDS 281,A00,895701,Meyerott; Theresa Ann,15,0,15,0
1745142579164,EDS 284,A00,895736,Meyerott; Theresa Ann,15,0,15,0
1745142580195,EDS 286,A00,897210,Fine; Sarah,15,0,15,0
1745142581222,EDS 289C,A01,895770,Daly; Alan J.,15,0,15,0
1745142582250,EDS 290,A00,897211,Hofstetter; Carolyn,15,0,15,0
1745142583280,LIGM 5A,A00,896162,Fischer-Grunski; Eva K,16,0,20,4
1745142584307,LIGM 5B,A00,896260,Fischer-Grunski; Eva K,19,0,20,1
1745142585337,LIGM 5C,A00,896308,Fischer-Grunski; Eva K,19,0,20,1
1745142586362,LIIT 5AS,A00,896313,Carnelos; Chiara,18,0,20,2
1745142587394,LIIT 5BS,A00,896416,Carnelos; Chiara,20,0,20,0
1745142588422,LIIT 5CS,A00,896564,Carnelos; Chiara,20,0,20,0
1745142589448,LISP 5A,A00,896588,Munoz Sanchez; Alicia,7,0,20,13
1745142590479,LISP 5B,A00,896653,Munoz Sanchez; Alicia,10,0,20,10
1745142591506,LISP 5C,A00,896655,Munoz Sanchez; Alicia,9,0,20,11
1745142592538,MAE 197,001,957918,Kleissl; Jan,9998,0,9999,1
1745142593564,MATH 2,A01,957937,Staff,34,0,35,1
1745142594595,MATH 197,001,957876,Kedlaya; Kiran S.,9996,0,9999,3
1745142595636,MCWP 40,A00,892729,Duru; Nur,15,0,20,5
1745142595636,MCWP 40,B00,893304,Montejo; Carolina,20,0,20,0
1745142596664,MCWP 40R,A00,893757,Redela; Pamela Morgan,0,3,20,20
1745142597692,MCWP 50,A00,893758,Morshed; Michael James,4,0,20,16
1745142597692,MCWP 50,B00,893761,Bartulis; Jason Michael,18,0,20,2
1745142598719,MCWP 50R,A00,893766,Compas; Sean Matthew,0,1,20,20
1745142598719,MCWP 50R,B00,893769,Carter; Jennifer A,5,0,20,15
1745142598719,MCWP 50R,C00,893771,Krone; Jarret,0,3,20,20
1745142598719,MCWP 50R,D00,893772,Miller; Elizabeth Deen,4,0,20,16
1745142598719,MCWP 50R,E00,893775,Carter; Andrea L,0,0,20,20
1745142599749,MMW 11R,A01,892721,Herbst; Matthew,22,0,30,8
1745142599749,MMW 11R,A02,892722,Herbst; Matthew,28,0,30,2
1745142600776,MMW 12R,A01,892724,Herbst; Matthew,0,5,16,16
1745142600776,MMW 12R,A02,892725,Herbst; Matthew,0,4,16,16
1745142601804,MMW 13R,A01,892727,Staff,0,29,16,16
1745142601804,MMW 13R,A02,892728,Staff,0,28,16,16
1745142602830,SIO 295LS,A00,894015,Staff,9,0,25,16
1745142603856,SIO 295S,A00,894020,Staff,9,0,25,16
1745142604889,SIOC 290S,A01,894063,Merrifield; Mark A,23,0,25,2
1745142605916,SIOC 291S,A01,894137,Gabriel; Corey John,23,0,25,2
1745142606945,SOCI 117,A01,895339,Staff,5,0,5,0
1745142607970,WES 237B,A00,894149,Staff,20,0,20,0
1745142610047,AESE 279B,A00,891859,Staff,35,0,35,0
1745142611074,AIP 197,001,891854,Staff,70,0,70,0
1745142612102,ANTH 289S,A00,891856,Gagneux; Pascal,12,0,12,0
1745142613127,BENG 196,001,957946,Engler; Adam J.,9996,0,9999,3
1745142614152,CAT 124RS,A01,956906,Staff,8,0,25,17
1745142615181,CAT 125RS,A01,922013,Staff,8,0,25,17
1745142616211,CLRE 250,A00,891860,Morris; Sheldon,9996,0,9999,3
1745142618264,CLRE 251R,A00,907817,Mehta; Ravindra L.,9995,0,9999,4
1745142619291,CLRE 252,A00,891864,Cuomo; Raphael Eduardo,9994,0,9999,5
1745142620318,CLRE 253,A00,891867,Vaida; Florin,9995,0,9999,4
1745142620318,CLRE 253,B00,907819,Staff,9999,0,9999,0
1745142621346,CLRE 259,A00,891868,Patel; Hemal,9998,0,9999,1
1745142622372,CLRE 260,A00,891872,Cuomo; Raphael Eduardo,9999,0,9999,0
1745142623401,CLRE 297,001,891888,Cuomo; Raphael Eduardo,9999,0,9999,0
1745142624429,CSS 201S,A01,892054,Mignozzetti; Umberto,30,0,30,0
1745142625463,CSS 202S,A01,892056,Mignozzetti; Umberto,30,0,30,0
1745142626493,DSC 197,001,956898,Eldridge; Justin Matthew,9998,0,9999,1
1745142627520,DSC 297,001,958000,Mazumdar; Arya,9999,0,9999,0
1745142628547,EAP 100,A00,905686,Staff,9774,0,9999,225
1745142629624,ECE 45,A01,892618,Staff,0,2,50,50
1745142630654,ECE 109,A01,892620,Staff,0,44,0,0
1745142631681,ECE 111,A01,892719,Staff,0,0,50,50
1745142632709,ECE 197,001,957920,Mercier; Patrick Philip,9992,0,9999,7
1745142633740,ECON 178,A01,907814,Zhu; Ying,29,0,35,6
1745142634766,EDS 115,A00,895312,Staff,42,0,45,3
1745142635830,EDS 117,A01,895337,Staff,30,0,30,0
1745142636860,EDS 125,A00,895341,Jones; Gabrielle Anastasia,43,0,45,2
1745142637888,EDS 128A,A01,895459,Fargason; Sharon Gayle,45,0,45,0
1745142638920,EDS 128B,A01,895543,Pappas; Elizabeth,45,0,45,0
1745142639950,EDS 139,A00,897203,Pappas; Elizabeth,45,0,45,0
1745142639950,EDS 139,B00,897209,Fargason; Sharon Gayle,45,0,45,0
1745142640976,EDS 201,A00,895545,Staff,44,0,45,1
1745142642004,EDS 203,A01,895581,Halter; Christopher P.,44,0,45,1
1745142643032,EDS 204R,A01,895625,Heinzman; Erica M.,45,0,45,0
1745142643032,EDS 204R,B01,895693,Halter; Christopher P.,28,0,45,17
1745142644059,EDS 206R,A00,895694,Fargason; Sharon Gayle,22,0,30,8
1745142644059,EDS 206R,B00,895695,Choi; Bailey Miyeon,21,0,30,9
1745142645086,EDS 250,A00,895697,Hemans; Patricia Ann Benitez,44,0,45,1
1745142646116,EDS 281,A00,895701,Meyerott; Theresa Ann,15,0,15,0
1745142647142,EDS 284,A00,895736,Meyerott; Theresa Ann,15,0,15,0
1745142648173,EDS 286,A00,897210,Fine; Sarah,15,0,15,0
1745142649200,EDS 289C,A01,895770,Daly; Alan J.,15,0,15,0
1745142650229,EDS 290,A00,897211,Hofstetter; Carolyn,15,0,15,0
1745142651257,LIGM 5A,A00,896162,Fischer-Grunski; Eva K,16,0,20,4
1745142652283,LIGM 5B,A00,896260,Fischer-Grunski; Eva K,19,0,20,1
1745142653309,LIGM 5C,A00,896308,Fischer-Grunski; Eva K,19,0,20,1
1745142654340,LIIT 5AS,A00,896313,Carnelos; Chiara,18,0,20,2
1745142655364,LIIT 5BS,A00,896416,Carnelos; Chiara,20,0,20,0
1745142656388,LIIT 5CS,A00,896564,Carnelos; Chiara,20,0,20,0
1745142657416,LISP 5A,A00,896588,Munoz Sanchez; Alicia,7,0,20,13
1745142658443,LISP 5B,A00,896653,Munoz Sanchez; Alicia,10,0,20,10
1745142659473,LISP 5C,A00,896655,Munoz Sanchez; Alicia,9,0,20,11
1745142660502,MAE 197,001,957918,Kleissl; Jan,9998,0,9999,1
1745142661529,MATH 2,A01,957937,Staff,34,0,35,1
1745142662555,MATH 197,001,957876,Kedlaya; Kiran S.,9996,0,9999,3
1745142663582,MCWP 40,A00,892729,Duru; Nur,15,0,20,5
1745142663582,MCWP 40,B00,893304,Montejo; Carolina,20,0,20,0
1745142664612,MCWP 40R,A00,893757,Redela; Pamela Morgan,0,3,20,20
1745142665636,MCWP 50,A00,893758,Morshed; Michael James,4,0,20,16
1745142665636,MCWP 50,B00,893761,Bartulis; Jason Michael,18,0,20,2
1745142666668,MCWP 50R,A00,893766,Compas; Sean Matthew,0,1,20,20
1745142666668,MCWP 50R,B00,893769,Carter; Jennifer A,5,0,20,15
1745142666668,MCWP 50R,C00,893771,Krone; Jarret,0,3,20,20
1745142666668,MCWP 50R,D00,893772,Miller; Elizabeth Deen,4,0,20,16
1745142666668,MCWP 50R,E00,893775,Carter; Andrea L,0,0,20,20
1745142667696,MMW 11R,A01,892721,Herbst; Matthew,22,0,30,8
1745142667696,MMW 11R,A02,892722,Herbst; Matthew,28,0,30,2
1745142668725,MMW 12R,A01,892724,Herbst; Matthew,0,5,16,16
1745142668725,MMW 12R,A02,892725,Herbst; Matthew,0,4,16,16
1745142669752,MMW 13R,A01,892727,Staff,0,29,16,16
1745142669752,MMW 13R,A02,892728,Staff,0,28,16,16
1745142670776,SIO 295LS,A00,894015,Staff,9,0,25,16
1745142671806,SIO 295S,A00,894020,Staff,9,0,25,16
1745142672836,SIOC 290S,A01,894063,Merrifield; Mark A,23,0,25,2
1745142673861,SIOC 291S,A01,894137,Gabriel; Corey John,23,0,25,2
1745142674888,SOCI 117,A01,895339,Staff,5,0,5,0
1745142675912,WES 237B,A00,894149,Staff,20,0,20,0
1745142678022,AESE 279B,A00,891859,Staff,35,0,35,0
1745142679046,AIP 197,001,891854,Staff,70,0,70,0
1745142680072,ANTH 289S,A00,891856,Gagneux; Pascal,12,0,12,0
1745142681097,BENG 196,001,957946,Engler; Adam J.,9996,0,9999,3
1745142682122,CAT 124RS,A01,956906,Staff,8,0,25,17
1745142683149,CAT 125RS,A01,922013,Staff,8,0,25,17
1745142684181,CLRE 250,A00,891860,Morris; Sheldon,9996,0,9999,3
1745142686234,CLRE 251R,A00,907817,Mehta; Ravindra L.,9995,0,9999,4
1745142687259,CLRE 252,A00,891864,Cuomo; Raphael Eduardo,9994,0,9999,5
1745142688282,CLRE 253,A00,891867,Vaida; Florin,9995,0,9999,4
1745142688282,CLRE 253,B00,907819,Staff,9999,0,9999,0
1745142689313,CLRE 259,A00,891868,Patel; Hemal,9998,0,9999,1
1745142690340,CLRE 260,A00,891872,Cuomo; Raphael Eduardo,9999,0,9999,0
1745142691369,CLRE 297,001,891888,Cuomo; Raphael Eduardo,9999,0,9999,0
1745142692403,CSS 201S,A01,892054,Mignozzetti; Umberto,30,0,30,0
1745142693432,CSS 202S,A01,892056,Mignozzetti; Umberto,30,0,30,0
1745142694459,DSC 197,001,956898,Eldridge; Justin Matthew,9998,0,9999,1
1745142695486,DSC 297,001,958000,Mazumdar; Arya,9999,0,9999,0
1745142696510,EAP 100,A00,905686,Staff,9774,0,9999,225
1745142697543,ECE 45,A01,892618,Staff,0,2,50,50
1745142698569,ECE 109,A01,892620,Staff,0,44,0,0
1745142699595,ECE 111,A01,892719,Staff,0,0,50,50
1745142700627,ECE 197,001,957920,Mercier; Patrick Philip,9992,0,9999,7
1745142701654,ECON 178,A01,907814,Zhu; Ying,29,0,35,6
1745142702678,EDS 115,A00,895312,Staff,42,0,45,3
1745142703704,EDS 117,A01,895337,Staff,30,0,30,0
1745142704734,EDS 125,A00,895341,Jones; Gabrielle Anastasia,43,0,45,2
1745142705760,EDS 128A,A01,895459,Fargason; Sharon Gayle,45,0,45,0
1745142706787,EDS 128B,A01,895543,Pappas; Elizabeth,45,0,45,0
1745142707814,EDS 139,A00,897203,Pappas; Elizabeth,45,0,45,0
1745142707814,EDS 139,B00,897209,Fargason; Sharon Gayle,45,0,45,0
1745142708840,EDS 201,A00,895545,Staff,44,0,45,1
1745142709871,EDS 203,A01,895581,Halter; Christopher P.,44,0,45,1
1745142710899,EDS 204R,A01,895625,Heinzman; Erica M.,45,0,45,0
1745142710899,EDS 204R,B01,895693,Halter; Christopher P.,28,0,45,17
1745142711925,EDS 206R,A00,895694,Fargason; Sharon Gayle,22,0,30,8
1745142711925,EDS 206R,B00,895695,Choi; Bailey Miyeon,21,0,30,9
1745142712951,EDS 250,A00,895697,Hemans; Patricia Ann Benitez,44,0,45,1
1745142713977,EDS 281,A00,895701,Meyerott; Theresa Ann,15,0,15,0
1745142715002,EDS 284,A00,895736,Meyerott; Theresa Ann,15,0,15,0
1745142716027,EDS 286,A00,897210,Fine; Sarah,15,0,15,0
1745142717052,EDS 289C,A01,895770,Daly; Alan J.,15,0,15,0
1745142718080,EDS 290,A00,897211,Hofstetter; Carolyn,15,0,15,0
1745142719109,LIGM 5A,A00,896162,Fischer-Grunski; Eva K,16,0,20,4
1745142720136,LIGM 5B,A00,896260,Fischer-Grunski; Eva K,19,0,20,1
1745142721167,LIGM 5C,A00,896308,Fischer-Grunski; Eva K,19,0,20,1
1745142722198,LIIT 5AS,A00,896313,Carnelos; Chiara,18,0,20,2
1745142723228,LIIT 5BS,A00,896416,Carnelos; Chiara,20,0,20,0
1745142724254,LIIT 5CS,A00,896564,Carnelos; Chiara,20,0,20,0
1745142725287,LISP 5A,A00,896588,Munoz Sanchez; Alicia,7,0,20,13
1745142726315,LISP 5B,A00,896653,Munoz Sanchez; Alicia,10,0,20,10
1745142727342,LISP 5C,A00,896655,Munoz Sanchez; Alicia,9,0,20,11
1745142728372,MAE 197,001,957918,Kleissl; Jan,9998,0,9999,1
1745142729402,MATH 2,A01,957937,Staff,34,0,35,1
1745142730430,MATH 197,001,957876,Kedlaya; Kiran S.,9996,0,9999,3
1745142731461,MCWP 40,A00,892729,Duru; Nur,15,0,20,5
1745142731461,MCWP 40,B00,893304,Montejo; Carolina,20,0,20,0
1745142732486,MCWP 40R,A00,893757,Redela; Pamela Morgan,0,3,20,20
1745142733516,MCWP 50,A00,893758,Morshed; Michael James,4,0,20,16
1745142733516,MCWP 50,B00,893761,Bartulis; Jason Michael,18,0,20,2
1745142734544,MCWP 50R,A00,893766,Compas; Sean Matthew,0,1,20,20
1745142734544,MCWP 50R,B00,893769,Carter; Jennifer A,5,0,20,15
1745142734544,MCWP 50R,C00,893771,Krone; Jarret,0,3,20,20
1745142734544,MCWP 50R,D00,893772,Miller; Elizabeth Deen,4,0,20,16
1745142734544,MCWP 50R,E00,893775,Carter; Andrea L,0,0,20,20
1745142735575,MMW 11R,A01,892721,Herbst; Matthew,22,0,30,8
1745142735575,MMW 11R,A02,892722,Herbst; Matthew,28,0,30,2
1745142736601,MMW 12R,A01,892724,Herbst; Matthew,0,5,16,16
1745142736601,MMW 12R,A02,892725,Herbst; Matthew,0,4,16,16
1745142737626,MMW 13R,A01,892727,Staff,0,29,16,16
1745142737626,MMW 13R,A02,892728,Staff,0,28,16,16
1745142738656,SIO 295LS,A00,894015,Staff,9,0,25,16
1745142739721,SIO 295S,A00,894020,Staff,9,0,25,16
1745142740749,SIOC 290S,A01,894063,Merrifield; Mark A,23,0,25,2
1745142741781,SIOC 291S,A01,894137,Gabriel; Corey John,23,0,25,2
1745142742808,SOCI 117,A01,895339,Staff,5,0,5,0
1745142743834,WES 237B,A00,894149,Staff,20,0,20,0
1745142745940,AESE 279B,A00,891859,Staff,35,0,35,0
1745142746965,AIP 197,001,891854,Staff,70,0,70,0
1745142747996,ANTH 289S,A00,891856,Gagneux; Pascal,12,0,12,0
1745142749023,BENG 196,001,957946,Engler; Adam J.,9996,0,9999,3
1745142750055,CAT 124RS,A01,956906,Staff,8,0,25,17
1745142751083,CAT 125RS,A01,922013,Staff,8,0,25,17
1745142752110,CLRE 250,A00,891860,Morris; Sheldon,9996,0,9999,3
1745142754166,CLRE 251R,A00,907817,Mehta; Ravindra L.,9995,0,9999,4
1745142755192,CLRE 252,A00,891864,Cuomo; Raphael Eduardo,9994,0,9999,5
1745142756221,CLRE 253,A00,891867,Vaida; Florin,9995,0,9999,4
1745142756221,CLRE 253,B00,907819,Staff,9999,0,9999,0
1745142757248,CLRE 259,A00,891868,Patel; Hemal,9998,0,9999,1
1745142758277,CLRE 260,A00,891872,Cuomo; Raphael Eduardo,9999,0,9999,0
1745142759305,CLRE 297,001,891888,Cuomo; Raphael Eduardo,9999,0,9999,0
1745142760335,CSS 201S,A01,892054,Mignozzetti; Umberto,30,0,30,0
1745142761366,CSS 202S,A01,892056,Mignozzetti; Umberto,30,0,30,0
1745142762396,DSC 197,001,956898,Eldridge; Justin Matthew,9998,0,9999,1
1745142763421,DSC 297,001,958000,Mazumdar; Arya,9999,0,9999,0
1745142764449,EAP 100,A00,905686,Staff,9774,0,9999,225
1745142765476,ECE 45,A01,892618,Staff,0,2,50,50
1745142766507,ECE 109,A01,892620,Staff,0,44,0,0
1745142767535,ECE 111,A01,892719,Staff,0,0,50,50
1745142768563,ECE 197,001,957920,Mercier; Patrick Philip,9992,0,9999,7
1745142769595,ECON 178,A01,907814,Zhu; Ying,29,0,35,6
1745142770620,EDS 115,A00,895312,Staff,42,0,45,3
1745142771648,EDS 117,A01,895337,Staff,30,0,30,0
1745142772679,EDS 125,A00,895341,Jones; Gabrielle Anastasia,43,0,45,2
1745142773705,EDS 128A,A01,895459,Fargason; Sharon Gayle,45,0,45,0
1745142774730,EDS 128B,A01,895543,Pappas; Elizabeth,45,0,45,0
1745142775769,EDS 139,A00,897203,Pappas; Elizabeth,45,0,45,0
1745142775769,EDS 139,B00,897209,Fargason; Sharon Gayle,45,0,45,0
1745142776795,EDS 201,A00,895545,Staff,44,0,45,1
1745142777828,EDS 203,A01,895581,Halter; Christopher P.,44,0,45,1
1745142778857,EDS 204R,A01,895625,Heinzman; Erica M.,45,0,45,0
1745142778857,EDS 204R,B01,895693,Halter; Christopher P.,28,0,45,17
1745142779884,EDS 206R,A00,895694,Fargason; Sharon Gayle,22,0,30,8
1745142779884,EDS 206R,B00,895695,Choi; Bailey Miyeon,21,0,30,9
1745142780912,EDS 250,A00,895697,Hemans; Patricia Ann Benitez,44,0,45,1
1745142781936,EDS 281,A00,895701,Meyerott; Theresa Ann,15,0,15,0
1745142782965,EDS 284,A00,895736,Meyerott; Theresa Ann,15,0,15,0
1745142783995,EDS 286,A00,897210,Fine; Sarah,15,0,15,0
1745142785021,EDS 289C,A01,895770,Daly; Alan J.,15,0,15,0
1745142786048,EDS 290,A00,897211,Hofstetter; Carolyn,15,0,15,0
1745142787076,LIGM 5A,A00,896162,Fischer-Grunski; Eva K,16,0,20,4
1745142788104,LIGM 5B,A00,896260,Fischer-Grunski; Eva K,19,0,20,1
1745142789137,LIGM 5C,A00,896308,Fischer-Grunski; Eva K,19,0,20,1
1745142790164,LIIT 5AS,A00,896313,Carnelos; Chiara,18,0,20,2
1745142791192,LIIT 5BS,A00,896416,Carnelos; Chiara,20,0,20,0
1745142792218,LIIT 5CS,A00,896564,Carnelos; Chiara,20,0,20,0
1745142793250,LISP 5A,A00,896588,Munoz Sanchez; Alicia,7,0,20,13
1745142794276,LISP 5B,A00,896653,Munoz Sanchez; Alicia,10,0,20,10
1745142795302,LISP 5C,A00,896655,Munoz Sanchez; Alicia,9,0,20,11
1745142796329,MAE 197,001,957918,Kleissl; Jan,9998,0,9999,1
1745142797356,MATH 2,A01,957937,Staff,34,0,35,1
1745142798383,MATH 197,001,957876,Kedlaya; Kiran S.,9996,0,9999,3
1745142799411,MCWP 40,A00,892729,Duru; Nur,15,0,20,5
1745142799411,MCWP 40,B00,893304,Montejo; Carolina,20,0,20,0
1745142800444,MCWP 40R,A00,893757,Redela; Pamela Morgan,0,3,20,20
1745142801474,MCWP 50,A00,893758,Morshed; Michael James,4,0,20,16
1745142801474,MCWP 50,B00,893761,Bartulis; Jason Michael,18,0,20,2
1745142802501,MCWP 50R,A00,893766,Compas; Sean Matthew,0,1,20,20
1745142802501,MCWP 50R,B00,893769,Carter; Jennifer A,5,0,20,15
1745142802501,MCWP 50R,C00,893771,Krone; Jarret,0,3,20,20
1745142802501,MCWP 50R,D00,893772,Miller; Elizabeth Deen,4,0,20,16
1745142802501,MCWP 50R,E00,893775,Carter; Andrea L,0,0,20,20
1745142803528,MMW 11R,A01,892721,Herbst; Matthew,22,0,30,8
1745142803528,MMW 11R,A02,892722,Herbst; Matthew,28,0,30,2
1745142804556,MMW 12R,A01,892724,Herbst; Matthew,0,5,16,16
1745142804556,MMW 12R,A02,892725,Herbst; Matthew,0,4,16,16
1745142805585,MMW 13R,A01,892727,Staff,0,29,16,16
1745142805585,MMW 13R,A02,892728,Staff,0,28,16,16
1745142806612,SIO 295LS,A00,894015,Staff,9,0,25,16
1745142807639,SIO 295S,A00,894020,Staff,9,0,25,16
1745142808674,SIOC 290S,A01,894063,Merrifield; Mark A,23,0,25,2
1745142809701,SIOC 291S,A01,894137,Gabriel; Corey John,23,0,25,2
1745142810727,SOCI 117,A01,895339,Staff,5,0,5,0
1745142811754,WES 237B,A00,894149,Staff,20,0,20,0
1745142813864,AESE 279B,A00,891859,Staff,35,0,35,0
1745142814890,AIP 197,001,891854,Staff,70,0,70,0
1745142815918,ANTH 289S,A00,891856,Gagneux; Pascal,12,0,12,0
1745142816945,BENG 196,001,957946,Engler; Adam J.,9996,0,9999,3
1745142817972,CAT 124RS,A01,956906,Staff,8,0,25,17
1745142818996,CAT 125RS,A01,922013,Staff,8,0,25,17
1745142820025,CLRE 250,A00,891860,Morris; Sheldon,9996,0,9999,3
1745142822075,CLRE 251R,A00,907817,Mehta; Ravindra L.,9995,0,9999,4
1745142823105,CLRE 252,A00,891864,Cuomo; Raphael Eduardo,9994,0,9999,5
1745142824132,CLRE 253,A00,891867,Vaida; Florin,9995,0,9999,4
1745142824132,CLRE 253,B00,907819,Staff,9999,0,9999,0
1745142825158,CLRE 259,A00,891868,Patel; Hemal,9998,0,9999,1
1745142826184,CLRE 260,A00,891872,Cuomo; Raphael Eduardo,9999,0,9999,0
1745142827212,CLRE 297,001,891888,Cuomo; Raphael Eduardo,9999,0,9999,0
1745142828239,CSS 201S,A01,892054,Mignozzetti; Umberto,30,0,30,0
1745142829265,CSS 202S,A01,892056,Mignozzetti; Umberto,30,0,30,0
1745142830290,DSC 197,001,956898,Eldridge; Justin Matthew,9998,0,9999,1
1745142831319,DSC 297,001,958000,Mazumdar; Arya,9999,0,9999,0
1745142832351,EAP 100,A00,905686,Staff,9774,0,9999,225
1745142833378,ECE 45,A01,892618,Staff,0,2,50,50
1745142834408,ECE 109,A01,892620,Staff,0,44,0,0
1745142835435,ECE 111,A01,892719,Staff,0,0,50,50
1745142836461,ECE 197,001,957920,Mercier; Patrick Philip,9992,0,9999,7
1745142837487,ECON 178,A01,907814,Zhu; Ying,29,0,35,6
1745142838517,EDS 115,A00,895312,Staff,42,0,45,3
1745142839544,EDS 117,A01,895337,Staff,30,0,30,0
1745142840583,EDS 125,A00,895341,Jones; Gabrielle Anastasia,43,0,45,2
1745142841616,EDS 128A,A01,895459,Fargason; Sharon Gayle,45,0,45,0
1745142842643,EDS 128B,A01,895543,Pappas; Elizabeth,45,0,45,0
1745142843712,EDS 139,A00,897203,Pappas; Elizabeth,45,0,45,0
1745142843712,EDS 139,B00,897209,Fargason; Sharon Gayle,45,0,45,0
1745142844737,EDS 201,A00,895545,Staff,44,0,45,1
1745142845763,EDS 203,A01,895581,Halter; Christopher P.,44,0,45,1
1745142846791,EDS 204R,A01,895625,Heinzman; Erica M.,45,0,45,0
1745142846791,EDS 204R,B01,895693,Halter; Christopher P.,28,0,45,17
1745142847823,EDS 206R,A00,895694,Fargason; Sharon Gayle,22,0,30,8
1745142847823,EDS 206R,B00,895695,Choi; Bailey Miyeon,21,0,30,9
1745142848852,EDS 250,A00,895697,Hemans; Patricia Ann Benitez,44,0,45,1
1745142849876,EDS 281,A00,895701,Meyerott; Theresa Ann,15,0,15,0
1745142850902,EDS 284,A00,895736,Meyerott; Theresa Ann,15,0,15,0
1745142851929,EDS 286,A00,897210,Fine; Sarah,15,0,15,0
1745142852954,EDS 289C,A01,895770,Daly; Alan J.,15,0,15,0
1745142853984,EDS 290,A00,897211,Hofstetter; Carolyn,15,0,15,0
1745142855016,LIGM 5A,A00,896162,Fischer-Grunski; Eva K,16,0,20,4
1745142856047,LIGM 5B,A00,896260,Fischer-Grunski; Eva K,19,0,20,1
1745142857077,LIGM 5C,A00,896308,Fischer-Grunski; Eva K,19,0,20,1
1745142858108,LIIT 5AS,A00,896313,Carnelos; Chiara,18,0,20,2
1745142859137,LIIT 5BS,A00,896416,Carnelos; Chiara,20,0,20,0
1745142860169,LIIT 5CS,A00,896564,Carnelos; Chiara,20,0,20,0
1745142861196,LISP 5A,A00,896588,Munoz Sanchez; Alicia,7,0,20,13
1745142862224,LISP 5B,A00,896653,Munoz Sanchez; Alicia,10,0,20,10
1745142863252,LISP 5C,A00,896655,Munoz Sanchez; Alicia,9,0,20,11
1745142864280,MAE 197,001,957918,Kleissl; Jan,9998,0,9999,1
1745142865309,MATH 2,A01,957937,Staff,34,0,35,1
1745142866335,MATH 197,001,957876,Kedlaya; Kiran S.,9996,0,9999,3
1745142867362,MCWP 40,A00,892729,Duru; Nur,15,0,20,5
1745142867362,MCWP 40,B00,893304,Montejo; Carolina,20,0,20,0
1745142868388,MCWP 40R,A00,893757,Redela; Pamela Morgan,0,3,20,20
1745142869416,MCWP 50,A00,893758,Morshed; Michael James,4,0,20,16
1745142869416,MCWP 50,B00,893761,Bartulis; Jason Michael,18,0,20,2
1745142870442,MCWP 50R,A00,893766,Compas; Sean Matthew,0,1,20,20
1745142870442,MCWP 50R,B00,893769,Carter; Jennifer A,5,0,20,15
1745142870442,MCWP 50R,C00,893771,Krone; Jarret,0,3,20,20
1745142870442,MCWP 50R,D00,893772,Miller; Elizabeth Deen,4,0,20,16
1745142870442,MCWP 50R,E00,893775,Carter; Andrea L,0,0,20,20
1745142871467,MMW 11R,A01,892721,Herbst; Matthew,22,0,30,8
1745142871467,MMW 11R,A02,892722,Herbst; Matthew,28,0,30,2
1745142872494,MMW 12R,A01,892724,Herbst; Matthew,0,5,16,16
1745142872494,MMW 12R,A02,892725,Herbst; Matthew,0,4,16,16
1745142873521,MMW 13R,A01,892727,Staff,0,29,16,16
1745142873521,MMW 13R,A02,892728,Staff,0,28,16,16
1745142874548,SIO 295LS,A00,894015,Staff,9,0,25,16
1745142875574,SIO 295S,A00,894020,Staff,9,0,25,16
1745142876600,SIOC 290S,A01,894063,Merrifield; Mark A,23,0,25,2
1745142877629,SIOC 291S,A01,894137,Gabriel; Corey John,23,0,25,2
1745142878658,SOCI 117,A01,895339,Staff,5,0,5,0
1745142879689,WES 237B,A00,894149,Staff,20,0,20,0
1745142881778,AESE 279B,A00,891859,Staff,35,0,35,0
1745142882808,AIP 197,001,891854,Staff,70,0,70,0
1745142883835,ANTH 289S,A00,891856,Gagneux; Pascal,12,0,12,0
1745142884862,BENG 196,001,957946,Engler; Adam J.,9996,0,9999,3
1745142885889,CAT 124RS,A01,956906,Staff,8,0,25,17
1745142886915,CAT 125RS,A01,922013,Staff,8,0,25,17
1745142887944,CLRE 250,A00,891860,Morris; Sheldon,9996,0,9999,3
1745142889995,CLRE 251R,A00,907817,Mehta; Ravindra L.,9995,0,9999,4
1745142891021,CLRE 252,A00,891864,Cuomo; Raphael Eduardo,9994,0,9999,5
1745142892053,CLRE 253,A00,891867,Vaida; Florin,9995,0,9999,4
1745142892053,CLRE 253,B00,907819,Staff,9999,0,9999,0
1745142893078,CLRE 259,A00,891868,Patel; Hemal,9998,0,9999,1
1745142894106,CLRE 260,A00,891872,Cuomo; Raphael Eduardo,9999,0,9999,0
1745142895138,CLRE 297,001,891888,Cuomo; Raphael Eduardo,9999,0,9999,0
1745142896169,CSS 201S,A01,892054,Mignozzetti; Umberto,30,0,30,0
1745142897201,CSS 202S,A01,892056,Mignozzetti; Umberto,30,0,30,0
1745142898227,DSC 197,001,956898,Eldridge; Justin Matthew,9998,0,9999,1
1745142899255,DSC 297,001,958000,Mazumdar; Arya,9999,0,9999,0
1745142900286,EAP 100,A00,905686,Staff,9774,0,9999,225
1745142901318,ECE 45,A01,892618,Staff,0,2,50,50
1745142902345,ECE 109,A01,892620,Staff,0,44,0,0
1745142903374,ECE 111,A01,892719,Staff,0,0,50,50
1745142904401,ECE 197,001,957920,Mercier; Patrick Philip,9992,0,9999,7
1745142905430,ECON 178,A01,907814,Zhu; Ying,29,0,35,6
1745142906456,EDS 115,A00,895312,Staff,42,0,45,3
1745142907482,EDS 117,A01,895337,Staff,30,0,30,0
1745142908513,EDS 125,A00,895341,Jones; Gabrielle Anastasia,43,0,45,2
1745142909539,EDS 128A,A01,895459,Fargason; Sharon Gayle,45,0,45,0
1745142910572,EDS 128B,A01,895543,Pappas; Elizabeth,45,0,45,0
1745142911598,EDS 139,A00,897203,Pappas; Elizabeth,45,0,45,0
1745142911598,EDS 139,B00,897209,Fargason; Sharon Gayle,45,0,45,0
1745142912623,EDS 201,A00,895545,Staff,44,0,45,1
1745142913654,EDS 203,A01,895581,Halter; Christopher P.,44,0,45,1
1745142914683,EDS 204R,A01,895625,Heinzman; Erica M.,45,0,45,0
1745142914683,EDS 204R,B01,895693,Halter; Christopher P.,28,0,45,17
1745142915712,EDS 206R,A00,895694,Fargason; Sharon Gayle,22,0,30,8
1745142915712,EDS 206R,B00,895695,Choi; Bailey Miyeon,21,0,30,9
1745142916738,EDS 250,A00,895697,Hemans; Patricia Ann Benitez,44,0,45,1
1745142917775,EDS 281,A00,895701,Meyerott; Theresa Ann,15,0,15,0
1745142918799,EDS 284,A00,895736,Meyerott; Theresa Ann,15,0,15,0
1745142919830,EDS 286,A00,897210,Fine; Sarah,15,0,15,0
1745142920858,EDS 289C,A01,895770,Daly; Alan J.,15,0,15,0
1745142921890,EDS 290,A00,897211,Hofstetter; Carolyn,15,0,15,0
1745142922923,LIGM 5A,A00,896162,Fischer-Grunski; Eva K,16,0,20,4
1745142923956,LIGM 5B,A00,896260,Fischer-Grunski; Eva K,19,0,20,1
1745142924985,LIGM 5C,A00,896308,Fischer-Grunski; Eva K,19,0,20,1
1745142926012,LIIT 5AS,A00,896313,Carnelos; Chiara,18,0,20,2
1745142927040,LIIT 5BS,A00,896416,Carnelos; Chiara,20,0,20,0
1745142928067,LIIT 5CS,A00,896564,Carnelos; Chiara,20,0,20,0
1745142929096,LISP 5A,A00,896588,Munoz Sanchez; Alicia,7,0,20,13
1745142930121,LISP 5B,A00,896653,Munoz Sanchez; Alicia,10,0,20,10
1745142931149,LISP 5C,A00,896655,Munoz Sanchez; Alicia,9,0,20,11
1745142932178,MAE 197,001,957918,Kleissl; Jan,9998,0,9999,1
1745142933209,MATH 2,A01,957937,Staff,34,0,35,1
1745142934240,MATH 197,001,957876,Kedlaya; Kiran S.,9996,0,9999,3
1745142935268,MCWP 40,A00,892729,Duru; Nur,15,0,20,5
1745142935268,MCWP 40,B00,893304,Montejo; Carolina,20,0,20,0
1745142936295,MCWP 40R,A00,893757,Redela; Pamela Morgan,0,3,20,20
1745142937321,MCWP 50,A00,893758,Morshed; Michael James,4,0,20,16
1745142937321,MCWP 50,B00,893761,Bartulis; Jason Michael,18,0,20,2
1745142938350,MCWP 50R,A00,893766,Compas; Sean Matthew,0,1,20,20
1745142938350,MCWP 50R,B00,893769,Carter; Jennifer A,5,0,20,15
1745142938350,MCWP 50R,C00,893771,Krone; Jarret,0,3,20,20
1745142938350,MCWP 50R,D00,893772,Miller; Elizabeth Deen,4,0,20,16
1745142938350,MCWP 50R,E00,893775,Carter; Andrea L,0,0,20,20
1745142939377,MMW 11R,A01,892721,Herbst; Matthew,22,0,30,8
1745142939377,MMW 11R,A02,892722,Herbst; Matthew,28,0,30,2
1745142940402,MMW 12R,A01,892724,Herbst; Matthew,0,5,16,16
1745142940402,MMW 12R,A02,892725,Herbst; Matthew,0,4,16,16
1745142941431,MMW 13R,A01,892727,Staff,0,29,16,16
1745142941431,MMW 13R,A02,892728,Staff,0,28,16,16
1745142942460,SIO 295LS,A00,894015,Staff,9,0,25,16
1745142943488,SIO 295S,A00,894020,Staff,9,0,25,16
1745142944514,SIOC 290S,A01,894063,Merrifield; Mark A,23,0,25,2
1745142945543,SIOC 291S,A01,894137,Gabriel; Corey John,23,0,25,2
1745142946569,SOCI 117,A01,895339,Staff,5,0,5,0
1745142947650,WES 237B,A00,894149,Staff,20,0,20,0
1745142949721,AESE 279B,A00,891859,Staff,35,0,35,0
1745142950750,AIP 197,001,891854,Staff,70,0,70,0
1745142951778,ANTH 289S,A00,891856,Gagneux; Pascal,12,0,12,0
1745142952805,BENG 196,001,957946,Engler; Adam J.,9996,0,9999,3
1745142953832,CAT 124RS,A01,956906,Staff,8,0,25,17
1745142954862,CAT 125RS,A01,922013,Staff,8,0,25,17
1745142955898,CLRE 250,A00,891860,Morris; Sheldon,9996,0,9999,3
1745142957954,CLRE 251R,A00,907817,Mehta; Ravindra L.,9995,0,9999,4
1745142958981,CLRE 252,A00,891864,Cuomo; Raphael Eduardo,9994,0,9999,5
1745142960013,CLRE 253,A00,891867,Vaida; Florin,9995,0,9999,4
1745142960013,CLRE 253,B00,907819,Staff,9999,0,9999,0
1745142961039,CLRE 259,A00,891868,Patel; Hemal,9998,0,9999,1
1745142962066,CLRE 260,A00,891872,Cuomo; Raphael Eduardo,9999,0,9999,0
1745142963094,CLRE 297,001,891888,Cuomo; Raphael Eduardo,9999,0,9999,0
1745142964127,CSS 201S,A01,892054,Mignozzetti; Umberto,30,0,30,0
1745142965154,CSS 202S,A01,892056,Mignozzetti; Umberto,30,0,30,0
1745142966184,DSC 197,001,956898,Eldridge; Justin Matthew,9998,0,9999,1
1745142967215,DSC 297,001,958000,Mazumdar; Arya,9999,0,9999,0
1745142968241,EAP 100,A00,905686,Staff,9774,0,9999,225
1745142969272,ECE 45,A01,892618,Staff,0,2,50,50
1745142970297,ECE 109,A01,892620,Staff,0,44,0,0
1745142971321,ECE 111,A01,892719,Staff,0,0,50,50
1745142972347,ECE 197,001,957920,Mercier; Patrick Philip,9992,0,9999,7
1745142973374,ECON 178,A01,907814,Zhu; Ying,29,0,35,6
1745142974401,EDS 115,A00,895312,Staff,42,0,45,3
1745142975427,EDS 117,A01,895337,Staff,30,0,30,0
1745142976459,EDS 125,A00,895341,Jones; Gabrielle Anastasia,43,0,45,2
1745142977486,EDS 128A,A01,895459,Fargason; Sharon Gayle,45,0,45,0
1745142978516,EDS 128B,A01,895543,Pappas; Elizabeth,45,0,45,0
1745142979545,EDS 139,A00,897203,Pappas; Elizabeth,45,0,45,0
1745142979545,EDS 139,B00,897209,Fargason; Sharon Gayle,45,0,45,0
1745142980571,EDS 201,A00,895545,Staff,44,0,45,1
1745142981611,EDS 203,A01,895581,Halter; Christopher P.,44,0,45,1
1745142982637,EDS 204R,A01,895625,Heinzman; Erica M.,45,0,45,0
1745142982637,EDS 204R,B01,895693,Halter; Christopher P.,28,0,45,17
1745142983663,EDS 206R,A00,895694,Fargason; Sharon Gayle,22,0,30,8
1745142983663,EDS 206R,B00,895695,Choi; Bailey Miyeon,21,0,30,9
1745142984689,EDS 250,A00,895697,Hemans; Patricia Ann Benitez,44,0,45,1
1745142985723,EDS 281,A00,895701,Meyerott; Theresa Ann,15,0,15,0
1745142986762,EDS 284,A00,895736,Meyerott; Theresa Ann,15,0,15,0
1745142987789,EDS 286,A00,897210,Fine; Sarah,15,0,15,0
1745142988829,EDS 289C,A01,895770,Daly; Alan J.,15,0,15,0
1745142989863,EDS 290,A00,897211,Hofstetter; Carolyn,15,0,15,0
1745142990905,LIGM 5A,A00,896162,Fischer-Grunski; Eva K,16,0,20,4
1745142991932,LIGM 5B,A00,896260,Fischer-Grunski; Eva K,19,0,20,1
1745143001080,LIGM 5C,A00,896308,Fischer-Grunski; Eva K,19,0,20,1
1745143002104,LIIT 5AS,A00,896313,Carnelos; Chiara,18,0,20,2
1745143003146,LIIT 5BS,A00,896416,Carnelos; Chiara,20,0,20,0
1745143004173,LIIT 5CS,A00,896564,Carnelos; Chiara,20,0,20,0
1745143005201,LISP 5A,A00,896588,Munoz Sanchez; Alicia,7,0,20,13
1745143006251,LISP 5B,A00,896653,Munoz Sanchez; Alicia,10,0,20,10
1745143007277,LISP 5C,A00,896655,Munoz Sanchez; Alicia,9,0,20,11
1745143008303,MAE 197,001,957918,Kleissl; Jan,9998,0,9999,1
1745143009330,MATH 2,A01,957937,Staff,34,0,35,1
1745143010356,MATH 197,001,957876,Kedlaya; Kiran S.,9996,0,9999,3
1745143011401,MCWP 40,A00,892729,Duru; Nur,15,0,20,5
1745143011401,MCWP 40,B00,893304,Montejo; Carolina,20,0,20,0
1745143012440,MCWP 40R,A00,893757,Redela; Pamela Morgan,0,3,20,20
1745143013466,MCWP 50,A00,893758,Morshed; Michael James,4,0,20,16
1745143013466,MCWP 50,B00,893761,Bartulis; Jason Michael,18,0,20,2
1745143014510,MCWP 50R,A00,893766,Compas; Sean Matthew,0,1,20,20
1745143014510,MCWP 50R,B00,893769,Carter; Jennifer A,5,0,20,15
1745143014510,MCWP 50R,C00,893771,Krone; Jarret,0,3,20,20
1745143014510,MCWP 50R,D00,893772,Miller; Elizabeth Deen,4,0,20,16
1745143014510,MCWP 50R,E00,893775,Carter; Andrea L,0,0,20,20
1745143015550,MMW 11R,A01,892721,Herbst; Matthew,22,0,30,8
1745143015550,MMW 11R,A02,892722,Herbst; Matthew,28,0,30,2
1745143016585,MMW 12R,A01,892724,Herbst; Matthew,0,5,16,16
1745143016585,MMW 12R,A02,892725,Herbst; Matthew,0,4,16,16
1745143017610,MMW 13R,A01,892727,Staff,0,29,16,16
1745143017610,MMW 13R,A02,892728,Staff,0,28,16,16
1745143018636,SIO 295LS,A00,894015,Staff,9,0,25,16
1745143019679,SIO 295S,A00,894020,Staff,9,0,25,16
1745143020733,SIOC 290S,A01,894063,Merrifield; Mark A,23,0,25,2
1745143021759,SIOC 291S,A01,894137,Gabriel; Corey John,23,0,25,2
1745143022796,SOCI 117,A01,895339,Staff,5,0,5,0
1745143023822,WES 237B,A00,894149,Staff,20,0,20,0
1745143025903,AESE 279B,A00,891859,Staff,35,0,35,0
1745143026929,AIP 197,001,891854,Staff,70,0,70,0
1745143027954,ANTH 289S,A00,891856,Gagneux; Pascal,12,0,12,0
1745143028989,BENG 196,001,957946,Engler; Adam J.,9996,0,9999,3
1745143030016,CAT 124RS,A01,956906,Staff,8,0,25,17
1745143031103,CAT 125RS,A01,922013,Staff,8,0,25,17
1745143032128,CLRE 250,A00,891860,Morris; Sheldon,9996,0,9999,3
1745143034190,CLRE 251R,A00,907817,Mehta; Ravindra L.,9995,0,9999,4
1745143035216,CLRE 252,A00,891864,Cuomo; Raphael Eduardo,9994,0,9999,5
1745143036253,CLRE 253,A00,891867,Vaida; Florin,9995,0,9999,4
1745143036253,CLRE 253,B00,907819,Staff,9999,0,9999,0
1745143037287,CLRE 259,A00,891868,Patel; Hemal,9998,0,9999,1
1745143038314,CLRE 260,A00,891872,Cuomo; Raphael Eduardo,9999,0,9999,0
1745143039338,CLRE 297,001,891888,Cuomo; Raphael Eduardo,9999,0,9999,0
1745143040365,CSS 201S,A01,892054,Mignozzetti; Umberto,30,0,30,0
1745143041389,CSS 202S,A01,892056,Mignozzetti; Umberto,30,0,30,0
1745143042425,DSC 197,001,956898,Eldridge; Justin Matthew,9998,0,9999,1
1745143043449,DSC 297,001,958000,Mazumdar; Arya,9999,0,9999,0
1745143044482,EAP 100,A00,905686,Staff,9774,0,9999,225
1745143045557,ECE 45,A01,892618,Staff,0,2,50,50
1745143046583,ECE 109,A01,892620,Staff,0,44,0,0
1745143047621,ECE 111,A01,892719,Staff,0,0,50,50
1745143048647,ECE 197,001,957920,Mercier; Patrick Philip,9992,0,9999,7
1745143049704,ECON 178,A01,907814,Zhu; Ying,29,0,35,6
1745143050729,EDS 115,A00,895312,Staff,42,0,45,3
1745143061154,EDS 117,A01,895337,Staff,30,0,30,0
1745143062194,EDS 125,A00,895341,Jones; Gabrielle Anastasia,43,0,45,2
1745143063221,EDS 128A,A01,895459,Fargason; Sharon Gayle,45,0,45,0
1745143064248,EDS 128B,A01,895543,Pappas; Elizabeth,45,0,45,0
1745143065276,EDS 139,A00,897203,Pappas; Elizabeth,45,0,45,0
1745143065276,EDS 139,B00,897209,Fargason; Sharon Gayle,45,0,45,0
1745143066302,EDS 201,A00,895545,Staff,44,0,45,1
1745143067328,EDS 203,A01,895581,Halter; Christopher P.,44,0,45,1
1745143068354,EDS 204R,A01,895625,Heinzman; Erica M.,45,0,45,0
1745143068354,EDS 204R,B01,895693,Halter; Christopher P.,28,0,45,17
1745143069393,EDS 206R,A00,895694,Fargason; Sharon Gayle,22,0,30,8
1745143069393,EDS 206R,B00,895695,Choi; Bailey Miyeon,21,0,30,9
1745143070430,EDS 250,A00,895697,Hemans; Patricia Ann Benitez,44,0,45,1
1745143071455,EDS 281,A00,895701,Meyerott; Theresa Ann,15,0,15,0
1745143072482,EDS 284,A00,895736,Meyerott; Theresa Ann,15,0,15,0
1745143073519,EDS 286,A00,897210,Fine; Sarah,15,0,15,0
1745143074545,EDS 289C,A01,895770,Daly; Alan J.,15,0,15,0
1745143075572,EDS 290,A00,897211,Hofstetter; Carolyn,15,0,15,0
1745143076610,LIGM 5A,A00,896162,Fischer-Grunski; Eva K,16,0,20,4
1745143077637,LIGM 5B,A00,896260,Fischer-Grunski; Eva K,19,0,20,1
1745143078663,LIGM 5C,A00,896308,Fischer-Grunski; Eva K,19,0,20,1
1745143079710,LIIT 5AS,A00,896313,Carnelos; Chiara,18,0,20,2
1745143080737,LIIT 5BS,A00,896416,Carnelos; Chiara,20,0,20,0
1745143081763,LIIT 5CS,A00,896564,Carnelos; Chiara,20,0,20,0
1745143082807,LISP 5A,A00,896588,Munoz Sanchez; Alicia,7,0,20,13
1745143083834,LISP 5B,A00,896653,Munoz Sanchez; Alicia,10,0,20,10
1745143084861,LISP 5C,A00,896655,Munoz Sanchez; Alicia,9,0,20,11
1745143085893,MAE 197,001,957918,Kleissl; Jan,9998,0,9999,1
1745143086920,MATH 2,A01,957937,Staff,34,0,35,1
1745143087956,MATH 197,001,957876,Kedlaya; Kiran S.,9996,0,9999,3
1745143088992,MCWP 40,A00,892729,Duru; Nur,15,0,20,5
1745143088992,MCWP 40,B00,893304,Montejo; Carolina,20,0,20,0
1745143090019,MCWP 40R,A00,893757,Redela; Pamela Morgan,0,3,20,20
1745143091054,MCWP 50,A00,893758,Morshed; Michael James,4,0,20,16
1745143091054,MCWP 50,B00,893761,Bartulis; Jason Michael,18,0,20,2
1745143092088,MCWP 50R,A00,893766,Compas; Sean Matthew,0,1,20,20
1745143092088,MCWP 50R,B00,893769,Carter; Jennifer A,5,0,20,15
1745143092088,MCWP 50R,C00,893771,Krone; Jarret,0,3,20,20
1745143092088,MCWP 50R,D00,893772,Miller; Elizabeth Deen,4,0,20,16
1745143092088,MCWP 50R,E00,893775,Carter; Andrea L,0,0,20,20
1745143093115,MMW 11R,A01,892721,Herbst; Matthew,22,0,30,8
1745143093115,MMW 11R,A02,892722,Herbst; Matthew,28,0,30,2
1745143094141,MMW 12R,A01,892724,Herbst; Matthew,0,5,16,16
1745143094141,MMW 12R,A02,892725,Herbst; Matthew,0,4,16,16
1745143095174,MMW 13R,A01,892727,Staff,0,29,16,16
1745143095174,MMW 13R,A02,892728,Staff,0,28,16,16
1745143096200,SIO 295LS,A00,894015,Staff,9,0,25,16
1745143097232,SIO 295S,A00,894020,Staff,9,0,25,16
1745143098272,SIOC 290S,A01,894063,Merrifield; Mark A,23,0,25,2
1745143099300,SIOC 291S,A01,894137,Gabriel; Corey John,23,0,25,2
1745143100332,SOCI 117,A01,895339,Staff,5,0,5,0
1745143101366,WES 237B,A00,894149,Staff,20,0,20,0
1745143103430,AESE 279B,A00,891859,Staff,35,0,35,0
1745143104455,AIP 197,001,891854,Staff,70,0,70,0
1745143105488,ANTH 289S,A00,891856,Gagneux; Pascal,12,0,12,0
1745143106516,BENG 196,001,957946,Engler; Adam J.,9996,0,9999,3
1745143107548,CAT 124RS,A01,956906,Staff,8,0,25,17
1745143108576,CAT 125RS,A01,922013,Staff,8,0,25,17
1745143109609,CLRE 250,A00,891860,Morris; Sheldon,9996,0,9999,3
1745143111663,CLRE 251R,A00,907817,Mehta; Ravindra L.,9995,0,9999,4
1745143112690,CLRE 252,A00,891864,Cuomo; Raphael Eduardo,9994,0,9999,5
1745143113722,CLRE 253,A00,891867,Vaida; Florin,9995,0,9999,4
1745143113722,CLRE 253,B00,907819,Staff,9999,0,9999,0
1745143114756,CLRE 259,A00,891868,Patel; Hemal,9998,0,9999,1
1745143115788,CLRE 260,A00,891872,Cuomo; Raphael Eduardo,9999,0,9999,0
1745143116814,CLRE 297,001,891888,Cuomo; Raphael Eduardo,9999,0,9999,0
1745143117850,CSS 201S,A01,892054,Mignozzetti; Umberto,30,0,30,0
1745143118876,CSS 202S,A01,892056,Mignozzetti; Umberto,30,0,30,0
1745143119902,DSC 197,001,956898,Eldridge; Justin Matthew,9998,0,9999,1
1745143120936,DSC 297,001,958000,Mazumdar; Arya,9999,0,9999,0
1745143121962,EAP 100,A00,905686,Staff,9774,0,9999,225
1745143122994,ECE 45,A01,892618,Staff,0,2,50,50
1745143124020,ECE 109,A01,892620,Staff,0,44,0,0
1745143125054,ECE 111,A01,892719,Staff,0,0,50,50
1745143126081,ECE 197,001,957920,Mercier; Patrick Philip,9992,0,9999,7
1745143127108,ECON 178,A01,907814,Zhu; Ying,29,0,35,6
1745143128134,EDS 115,A00,895312,Staff,42,0,45,3
1745143129159,EDS 117,A01,895337,Staff,30,0,30,0
1745143130186,EDS 125,A00,895341,Jones; Gabrielle Anastasia,43,0,45,2
1745143131213,EDS 128A,A01,895459,Fargason; Sharon Gayle,45,0,45,0
1745143132240,EDS 128B,A01,895543,Pappas; Elizabeth,45,0,45,0
1745143133265,EDS 139,A00,897203,Pappas; Elizabeth,45,0,45,0
1745143133265,EDS 139,B00,897209,Fargason; Sharon Gayle,45,0,45,0
1745143134295,EDS 201,A00,895545,Staff,44,0,45,1
1745143135322,EDS 203,A01,895581,Halter; Christopher P.,44,0,45,1
1745143136352,EDS 204R,A01,895625,Heinzman; Erica M.,45,0,45,0
1745143136352,EDS 204R,B01,895693,Halter; Christopher P.,28,0,45,17
1745143137379,EDS 206R,A00,895694,Fargason; Sharon Gayle,22,0,30,8
1745143137379,EDS 206R,B00,895695,Choi; Bailey Miyeon,21,0,30,9
1745143138404,EDS 250,A00,895697,Hemans; Patricia Ann Benitez,44,0,45,1
1745143139433,EDS 281,A00,895701,Meyerott; Theresa Ann,15,0,15,0
1745143140465,EDS 284,A00,895736,Meyerott; Theresa Ann,15,0,15,0
1745143141491,EDS 286,A00,897210,Fine; Sarah,15,0,15,0
1745143142523,EDS 289C,A01,895770,Daly; Alan J.,15,0,15,0
1745143143549,EDS 290,A00,897211,Hofstetter; Carolyn,15,0,15,0
1745143144576,LIGM 5A,A00,896162,Fischer-Grunski; Eva K,16,0,20,4
1745143145603,LIGM 5B,A00,896260,Fischer-Grunski; Eva K,19,0,20,1
1745143146629,LIGM 5C,A00,896308,Fischer-Grunski; Eva K,19,0,20,1
1745143147655,LIIT 5AS,A00,896313,Carnelos; Chiara,18,0,20,2
1745143148682,LIIT 5BS,A00,896416,Carnelos; Chiara,20,0,20,0
1745143149716,LIIT 5CS,A00,896564,Carnelos; Chiara,20,0,20,0
1745143150741,LISP 5A,A00,896588,Munoz Sanchez; Alicia,7,0,20,13
1745143151768,LISP 5B,A00,896653,Munoz Sanchez; Alicia,10,0,20,10
1745143152798,LISP 5C,A00,896655,Munoz Sanchez; Alicia,9,0,20,11
1745143153845,MAE 197,001,957918,Kleissl; Jan,9998,0,9999,1
1745143154879,MATH 2,A01,957937,Staff,34,0,35,1
1745143155906,MATH 197,001,957876,Kedlaya; Kiran S.,9996,0,9999,3
1745143156932,MCWP 40,A00,892729,Duru; Nur,15,0,20,5
1745143156932,MCWP 40,B00,893304,Montejo; Carolina,20,0,20,0
1745143157956,MCWP 40R,A00,893757,Redela; Pamela Morgan,0,3,20,20
1745143158989,MCWP 50,A00,893758,Morshed; Michael James,4,0,20,16
1745143158989,MCWP 50,B00,893761,Bartulis; Jason Michael,18,0,20,2
1745143160017,MCWP 50R,A00,893766,Compas; Sean Matthew,0,1,20,20
1745143160017,MCWP 50R,B00,893769,Carter; Jennifer A,5,0,20,15
1745143160017,MCWP 50R,C00,893771,Krone; Jarret,0,3,20,20
1745143160017,MCWP 50R,D00,893772,Miller; Elizabeth Deen,4,0,20,16
1745143160017,MCWP 50R,E00,893775,Carter; Andrea L,0,0,20,20
1745143161042,MMW 11R,A01,892721,Herbst; Matthew,22,0,30,8
1745143161042,MMW 11R,A02,892722,Herbst; Matthew,28,0,30,2
1745143162078,MMW 12R,A01,892724,Herbst; Matthew,0,5,16,16
1745143162078,MMW 12R,A02,892725,Herbst; Matthew,0,4,16,16
1745143163103,MMW 13R,A01,892727,Staff,0,29,16,16
1745143163103,MMW 13R,A02,892728,Staff,0,28,16,16
1745143164135,SIO 295LS,A00,894015,Staff,9,0,25,16
1745143165167,SIO 295S,A00,894020,Staff,9,0,25,16
1745143166192,SIOC 290S,A01,894063,Merrifield; Mark A,23,0,25,2
1745143167218,SIOC 291S,A01,894137,Gabriel; Corey John,23,0,25,2
1745143168247,SOCI 117,A01,895339,Staff,5,0,5,0
1745143169272,WES 237B,A00,894149,Staff,20,0,20,0
1745143171348,AESE 279B,A00,891859,Staff,35,0,35,0
1745143172387,AIP 197,001,891854,Staff,70,0,70,0
1745143173413,ANTH 289S,A00,891856,Gagneux; Pascal,12,0,12,0
1745143174438,BENG 196,001,957946,Engler; Adam J.,9996,0,9999,3
1745143175463,CAT 124RS,A01,956906,Staff,8,0,25,17
1745143176495,CAT 125RS,A01,922013,Staff,8,0,25,17
1745143177522,CLRE 250,A00,891860,Morris; Sheldon,9996,0,9999,3
1745143179575,CLRE 251R,A00,907817,Mehta; Ravindra L.,9995,0,9999,4
1745143180601,CLRE 252,A00,891864,Cuomo; Raphael Eduardo,9994,0,9999,5
1745143181633,CLRE 253,A00,891867,Vaida; Florin,9995,0,9999,4
1745143181633,CLRE 253,B00,907819,Staff,9999,0,9999,0
1745143182664,CLRE 259,A00,891868,Patel; Hemal,9998,0,9999,1
1745143183690,CLRE 260,A00,891872,Cuomo; Raphael Eduardo,9999,0,9999,0
1745143184719,CLRE 297,001,891888,Cuomo; Raphael Eduardo,9999,0,9999,0
1745143185751,CSS 201S,A01,892054,Mignozzetti; Umberto,30,0,30,0
1745143186784,CSS 202S,A01,892056,Mignozzetti; Umberto,30,0,30,0
1745143187815,DSC 197,001,956898,Eldridge; Justin Matthew,9998,0,9999,1
1745143188845,DSC 297,001,958000,Mazumdar; Arya,9999,0,9999,0
1745143189881,EAP 100,A00,905686,Staff,9774,0,9999,225
1745143190905,ECE 45,A01,892618,Staff,0,2,50,50
1745143191930,ECE 109,A01,892620,Staff,0,44,0,0
1745143192960,ECE 111,A01,892719,Staff,0,0,50,50
1745143193986,ECE 197,001,957920,Mercier; Patrick Philip,9992,0,9999,7
1745143195013,ECON 178,A01,907814,Zhu; Ying,29,0,35,6
1745143196041,EDS 115,A00,895312,Staff,42,0,45,3
1745143197067,EDS 117,A01,895337,Staff,30,0,30,0
1745143198093,EDS 125,A00,895341,Jones; Gabrielle Anastasia,43,0,45,2
1745143199123,EDS 128A,A01,895459,Fargason; Sharon Gayle,45,0,45,0
1745143200152,EDS 128B,A01,895543,Pappas; Elizabeth,45,0,45,0
1745143201188,EDS 139,A00,897203,Pappas; Elizabeth,45,0,45,0
1745143201188,EDS 139,B00,897209,Fargason; Sharon Gayle,45,0,45,0
1745143202223,EDS 201,A00,895545,Staff,44,0,45,1
1745143203255,EDS 203,A01,895581,Halter; Christopher P.,44,0,45,1
1745143204286,EDS 204R,A01,895625,Heinzman; Erica M.,45,0,45,0
1745143204286,EDS 204R,B01,895693,Halter; Christopher P.,28,0,45,17
1745143205312,EDS 206R,A00,895694,Fargason; Sharon Gayle,22,0,30,8
1745143205312,EDS 206R,B00,895695,Choi; Bailey Miyeon,21,0,30,9
1745143206340,EDS 250,A00,895697,Hemans; Patricia Ann Benitez,44,0,45,1
1745143207370,EDS 281,A00,895701,Meyerott; Theresa Ann,15,0,15,0
1745143208396,EDS 284,A00,895736,Meyerott; Theresa Ann,15,0,15,0
1745143209424,EDS 286,A00,897210,Fine; Sarah,15,0,15,0
1745143210451,EDS 289C,A01,895770,Daly; Alan J.,15,0,15,0
1745143211479,EDS 290,A00,897211,Hofstetter; Carolyn,15,0,15,0
1745143212505,LIGM 5A,A00,896162,Fischer-Grunski; Eva K,16,0,20,4
1745143213532,LIGM 5B,A00,896260,Fischer-Grunski; Eva K,19,0,20,1
1745143214559,LIGM 5C,A00,896308,Fischer-Grunski; Eva K,19,0,20,1
1745143215589,LIIT 5AS,A00,896313,Carnelos; Chiara,18,0,20,2
1745143216616,LIIT 5BS,A00,896416,Carnelos; Chiara,20,0,20,0
1745143217642,LIIT 5CS,A00,896564,Carnelos; Chiara,20,0,20,0
1745143218669,LISP 5A,A00,896588,Munoz Sanchez; Alicia,7,0,20,13
1745143219701,LISP 5B,A00,896653,Munoz Sanchez; Alicia,10,0,20,10
1745143220731,LISP 5C,A00,896655,Munoz Sanchez; Alicia,9,0,20,11
1745143221758,MAE 197,001,957918,Kleissl; Jan,9998,0,9999,1
1745143222782,MATH 2,A01,957937,Staff,34,0,35,1
1745143223813,MATH 197,001,957876,Kedlaya; Kiran S.,9996,0,9999,3
1745143224846,MCWP 40,A00,892729,Duru; Nur,15,0,20,5
1745143224846,MCWP 40,B00,893304,Montejo; Carolina,20,0,20,0
1745143225877,MCWP 40R,A00,893757,Redela; Pamela Morgan,0,3,20,20
1745143226906,MCWP 50,A00,893758,Morshed; Michael James,4,0,20,16
1745143226906,MCWP 50,B00,893761,Bartulis; Jason Michael,18,0,20,2
1745143227937,MCWP 50R,A00,893766,Compas; Sean Matthew,0,1,20,20
1745143227937,MCWP 50R,B00,893769,Carter; Jennifer A,5,0,20,15
1745143227937,MCWP 50R,C00,893771,Krone; Jarret,0,3,20,20
1745143227937,MCWP 50R,D00,893772,Miller; Elizabeth Deen,4,0,20,16
1745143227937,MCWP 50R,E00,893775,Carter; Andrea L,0,0,20,20
1745143228970,MMW 11R,A01,892721,Herbst; Matthew,22,0,30,8
1745143228970,MMW 11R,A02,892722,Herbst; Matthew,28,0,30,2
1745143229999,MMW 12R,A01,892724,Herbst; Matthew,0,5,16,16
1745143229999,MMW 12R,A02,892725,Herbst; Matthew,0,4,16,16
1745143231025,MMW 13R,A01,892727,Staff,0,29,16,16
1745143231025,MMW 13R,A02,892728,Staff,0,28,16,16
1745143232051,SIO 295LS,A00,894015,Staff,9,0,25,16
1745143233075,SIO 295S,A00,894020,Staff,9,0,25,16
1745143234102,SIOC 290S,A01,894063,Merrifield; Mark A,23,0,25,2
1745143235130,SIOC 291S,A01,894137,Gabriel; Corey John,23,0,25,2
1745143236162,SOCI 117,A01,895339,Staff,5,0,5,0
1745143237190,WES 237B,A00,894149,Staff,20,0,20,0
1745143239258,AESE 279B,A00,891859,Staff,35,0,35,0
1745143240286,AIP 197,001,891854,Staff,70,0,70,0
1745143241316,ANTH 289S,A00,891856,Gagneux; Pascal,12,0,12,0
1745143242346,BENG 196,001,957946,Engler; Adam J.,9996,0,9999,3
1745143243373,CAT 124RS,A01,956906,Staff,8,0,25,17
1745143244399,CAT 125RS,A01,922013,Staff,8,0,25,17
1745143245428,CLRE 250,A00,891860,Morris; Sheldon,9996,0,9999,3
1745143247485,CLRE 251R,A00,907817,Mehta; Ravindra L.,9995,0,9999,4
1745143248514,CLRE 252,A00,891864,Cuomo; Raphael Eduardo,9994,0,9999,5
1745143249543,CLRE 253,A00,891867,Vaida; Florin,9995,0,9999,4
1745143249543,CLRE 253,B00,907819,Staff,9999,0,9999,0
1745143250574,CLRE 259,A00,891868,Patel; Hemal,9998,0,9999,1
1745143251600,CLRE 260,A00,891872,Cuomo; Raphael Eduardo,9999,0,9999,0
1745143252626,CLRE 297,001,891888,Cuomo; Raphael Eduardo,9999,0,9999,0
1745143253652,CSS 201S,A01,892054,Mignozzetti; Umberto,30,0,30,0
1745143254691,CSS 202S,A01,892056,Mignozzetti; Umberto,30,0,30,0
1745143255720,DSC 197,001,956898,Eldridge; Justin Matthew,9998,0,9999,1
1745143256747,DSC 297,001,958000,Mazumdar; Arya,9999,0,9999,0
1745143257771,EAP 100,A00,905686,Staff,9774,0,9999,225
1745143258796,ECE 45,A01,892618,Staff,0,2,50,50
1745143259827,ECE 109,A01,892620,Staff,0,44,0,0
1745143260858,ECE 111,A01,892719,Staff,0,0,50,50
1745143261895,ECE 197,001,957920,Mercier; Patrick Philip,9992,0,9999,7
1745143262925,ECON 178,A01,907814,Zhu; Ying,29,0,35,6
1745143263952,EDS 115,A00,895312,Staff,42,0,45,3
1745143264983,EDS 117,A01,895337,Staff,30,0,30,0
1745143266013,EDS 125,A00,895341,Jones; Gabrielle Anastasia,43,0,45,2
1745143267041,EDS 128A,A01,895459,Fargason; Sharon Gayle,45,0,45,0
1745143268066,EDS 128B,A01,895543,Pappas; Elizabeth,45,0,45,0
1745143269094,EDS 139,A00,897203,Pappas; Elizabeth,45,0,45,0
1745143269094,EDS 139,B00,897209,Fargason; Sharon Gayle,45,0,45,0
1745143270123,EDS 201,A00,895545,Staff,44,0,45,1
1745143271153,EDS 203,A01,895581,Halter; Christopher P.,44,0,45,1
1745143272179,EDS 204R,A01,895625,Heinzman; Erica M.,45,0,45,0
1745143272179,EDS 204R,B01,895693,Halter; Christopher P.,28,0,45,17
1745143273206,EDS 206R,A00,895694,Fargason; Sharon Gayle,22,0,30,8
1745143273206,EDS 206R,B00,895695,Choi; Bailey Miyeon,21,0,30,9
1745143274235,EDS 250,A00,895697,Hemans; Patricia Ann Benitez,44,0,45,1
1745143275266,EDS 281,A00,895701,Meyerott; Theresa Ann,15,0,15,0
1745143276821,EDS 284,A00,895736,Meyerott; Theresa Ann,15,0,15,0
1745143277847,EDS 286,A00,897210,Fine; Sarah,15,0,15,0
1745143278874,EDS 289C,A01,895770,Daly; Alan J.,15,0,15,0
1745143279903,EDS 290,A00,897211,Hofstetter; Carolyn,15,0,15,0
1745143280929,LIGM 5A,A00,896162,Fischer-Grunski; Eva K,16,0,20,4
1745143281956,LIGM 5B,A00,896260,Fischer-Grunski; Eva K,19,0,20,1
1745143282987,LIGM 5C,A00,896308,Fischer-Grunski; Eva K,19,0,20,1
1745143284017,LIIT 5AS,A00,896313,Carnelos; Chiara,18,0,20,2
1745143285047,LIIT 5BS,A00,896416,Carnelos; Chiara,20,0,20,0
1745143286072,LIIT 5CS,A00,896564,Carnelos; Chiara,20,0,20,0
1745143287099,LISP 5A,A00,896588,Munoz Sanchez; Alicia,7,0,20,13
1745143288130,LISP 5B,A00,896653,Munoz Sanchez; Alicia,10,0,20,10
1745143289159,LISP 5C,A00,896655,Munoz Sanchez; Alicia,9,0,20,11
1745143290186,MAE 197,001,957918,Kleissl; Jan,9998,0,9999,1
1745143291213,MATH 2,A01,957937,Staff,34,0,35,1
1745143292241,MATH 197,001,957876,Kedlaya; Kiran S.,9996,0,9999,3
1745143293266,MCWP 40,A00,892729,Duru; Nur,15,0,20,5
1745143293266,MCWP 40,B00,893304,Montejo; Carolina,20,0,20,0
1745143294294,MCWP 40R,A00,893757,Redela; Pamela Morgan,0,3,20,20
1745143295322,MCWP 50,A00,893758,Morshed; Michael James,4,0,20,16
1745143295322,MCWP 50,B00,893761,Bartulis; Jason Michael,18,0,20,2
1745143296353,MCWP 50R,A00,893766,Compas; Sean Matthew,0,1,20,20
1745143296353,MCWP 50R,B00,893769,Carter; Jennifer A,5,0,20,15
1745143296353,MCWP 50R,C00,893771,Krone; Jarret,0,3,20,20
1745143296353,MCWP 50R,D00,893772,Miller; Elizabeth Deen,4,0,20,16
1745143296353,MCWP 50R,E00,893775,Carter; Andrea L,0,0,20,20
1745143297378,MMW 11R,A01,892721,Herbst; Matthew,22,0,30,8
1745143297378,MMW 11R,A02,892722,Herbst; Matthew,28,0,30,2
1745143298404,MMW 12R,A01,892724,Herbst; Matthew,0,5,16,16
1745143298404,MMW 12R,A02,892725,Herbst; Matthew,0,4,16,16
1745143299430,MMW 13R,A01,892727,Staff,0,29,16,16
1745143299430,MMW 13R,A02,892728,Staff,0,28,16,16
1745143300456,SIO 295LS,A00,894015,Staff,9,0,25,16
1745143301482,SIO 295S,A00,894020,Staff,9,0,25,16
1745143302509,SIOC 290S,A01,894063,Merrifield; Mark A,23,0,25,2
1745143303534,SIOC 291S,A01,894137,Gabriel; Corey John,23,0,25,2
1745143304559,SOCI 117,A01,895339,Staff,5,0,5,0
1745143305588,WES 237B,A00,894149,Staff,20,0,20,0
1745143307668,AESE 279B,A00,891859,Staff,35,0,35,0
1745143308693,AIP 197,001,891854,Staff,70,0,70,0
1745143309719,ANTH 289S,A00,891856,Gagneux; Pascal,12,0,12,0
1745143310745,BENG 196,001,957946,Engler; Adam J.,9996,0,9999,3
1745143311774,CAT 124RS,A01,956906,Staff,8,0,25,17
1745143312804,CAT 125RS,A01,922013,Staff,8,0,25,17
1745143313833,CLRE 250,A00,891860,Morris; Sheldon,9996,0,9999,3
1745143315889,CLRE 251R,A00,907817,Mehta; Ravindra L.,9995,0,9999,4
1745143316972,CLRE 252,A00,891864,Cuomo; Raphael Eduardo,9994,0,9999,5
1745143318001,CLRE 253,A00,891867,Vaida; Florin,9995,0,9999,4
1745143318001,CLRE 253,B00,907819,Staff,9999,0,9999,0
1745143319026,CLRE 259,A00,891868,Patel; Hemal,9998,0,9999,1
1745143320051,CLRE 260,A00,891872,Cuomo; Raphael Eduardo,9999,0,9999,0
1745143321079,CLRE 297,001,891888,Cuomo; Raphael Eduardo,9999,0,9999,0
1745143322110,CSS 201S,A01,892054,Mignozzetti; Umberto,30,0,30,0
1745143323139,CSS 202S,A01,892056,Mignozzetti; Umberto,30,0,30,0
1745143324164,DSC 197,001,956898,Eldridge; Justin Matthew,9998,0,9999,1
1745143325190,DSC 297,001,958000,Mazumdar; Arya,9999,0,9999,0
1745143326218,EAP 100,A00,905686,Staff,9774,0,9999,225
1745143327802,ECE 45,A01,892618,Staff,0,2,50,50
1745143328828,ECE 109,A01,892620,Staff,0,44,0,0
1745143329852,ECE 111,A01,892719,Staff,0,0,50,50
1745143330879,ECE 197,001,957920,Mercier; Patrick Philip,9992,0,9999,7
1745143331907,ECON 178,A01,907814,Zhu; Ying,29,0,35,6
1745143332931,EDS 115,A00,895312,Staff,42,0,45,3
1745143333957,EDS 117,A01,895337,Staff,30,0,30,0
1745143334982,EDS 125,A00,895341,Jones; Gabrielle Anastasia,43,0,45,2
1745143336010,EDS 128A,A01,895459,Fargason; Sharon Gayle,45,0,45,0
1745143337036,EDS 128B,A01,895543,Pappas; Elizabeth,45,0,45,0
1745143338064,EDS 139,A00,897203,Pappas; Elizabeth,45,0,45,0
1745143338064,EDS 139,B00,897209,Fargason; Sharon Gayle,45,0,45,0
1745143339092,EDS 201,A00,895545,Staff,44,0,45,1
1745143340121,EDS 203,A01,895581,Halter; Christopher P.,44,0,45,1
1745143341151,EDS 204R,A01,895625,Heinzman; Erica M.,45,0,45,0
1745143341151,EDS 204R,B01,895693,Halter; Christopher P.,28,0,45,17
1745143342179,EDS 206R,A00,895694,Fargason; Sharon Gayle,22,0,30,8
1745143342179,EDS 206R,B00,895695,Choi; Bailey Miyeon,21,0,30,9
1745143343204,EDS 250,A00,895697,Hemans; Patricia Ann Benitez,44,0,45,1
1745143344231,EDS 281,A00,895701,Meyerott; Theresa Ann,15,0,15,0
1745143345260,EDS 284,A00,895736,Meyerott; Theresa Ann,15,0,15,0
1745143346288,EDS 286,A00,897210,Fine; Sarah,15,0,15,0
1745143347318,EDS 289C,A01,895770,Daly; Alan J.,15,0,15,0
1745143348346,EDS 290,A00,897211,Hofstetter; Carolyn,15,0,15,0
1745143349376,LIGM 5A,A00,896162,Fischer-Grunski; Eva K,16,0,20,4
1745143350400,LIGM 5B,A00,896260,Fischer-Grunski; Eva K,19,0,20,1
1745143351425,LIGM 5C,A00,896308,Fischer-Grunski; Eva K,19,0,20,1
1745143352453,LIIT 5AS,A00,896313,Carnelos; Chiara,18,0,20,2
1745143353480,LIIT 5BS,A00,896416,Carnelos; Chiara,20,0,20,0
1745143354511,LIIT 5CS,A00,896564,Carnelos; Chiara,20,0,20,0
1745143355540,LISP 5A,A00,896588,Munoz Sanchez; Alicia,7,0,20,13
1745143356569,LISP 5B,A00,896653,Munoz Sanchez; Alicia,10,0,20,10
1745143357600,LISP 5C,A00,896655,Munoz Sanchez; Alicia,9,0,20,11
1745143358627,MAE 197,001,957918,Kleissl; Jan,9998,0,9999,1
1745143359652,MATH 2,A01,957937,Staff,34,0,35,1
1745143360678,MATH 197,001,957876,Kedlaya; Kiran S.,9996,0,9999,3
1745143361706,MCWP 40,A00,892729,Duru; Nur,15,0,20,5
1745143361706,MCWP 40,B00,893304,Montejo; Carolina,20,0,20,0
1745143362734,MCWP 40R,A00,893757,Redela; Pamela Morgan,0,3,20,20
1745143363761,MCWP 50,A00,893758,Morshed; Michael James,4,0,20,16
1745143363761,MCWP 50,B00,893761,Bartulis; Jason Michael,18,0,20,2
1745143364800,MCWP 50R,A00,893766,Compas; Sean Matthew,0,1,20,20
1745143364800,MCWP 50R,B00,893769,Carter; Jennifer A,5,0,20,15
1745143364800,MCWP 50R,C00,893771,Krone; Jarret,0,3,20,20
1745143364800,MCWP 50R,D00,893772,Miller; Elizabeth Deen,4,0,20,16
1745143364800,MCWP 50R,E00,893775,Carter; Andrea L,0,0,20,20
1745143365833,MMW 11R,A01,892721,Herbst; Matthew,22,0,30,8
1745143365833,MMW 11R,A02,892722,Herbst; Matthew,28,0,30,2
1745143366861,MMW 12R,A01,892724,Herbst; Matthew,0,5,16,16
1745143366861,MMW 12R,A02,892725,Herbst; Matthew,0,4,16,16
1745143367888,MMW 13R,A01,892727,Staff,0,29,16,16
1745143367888,MMW 13R,A02,892728,Staff,0,28,16,16
1745143368914,SIO 295LS,A00,894015,Staff,9,0,25,16
1745143369942,SIO 295S,A00,894020,Staff,9,0,25,16
1745143370970,SIOC 290S,A01,894063,Merrifield; Mark A,23,0,25,2
1745143372004,SIOC 291S,A01,894137,Gabriel; Corey John,23,0,25,2
1745143373030,SOCI 117,A01,895339,Staff,5,0,5,0
1745143374056,WES 237B,A00,894149,Staff,20,0,20,0
1745143376135,AESE 279B,A00,891859,Staff,35,0,35,0
1745143377166,AIP 197,001,891854,Staff,70,0,70,0
1745143378190,ANTH 289S,A00,891856,Gagneux; Pascal,12,0,12,0
1745143379216,BENG 196,001,957946,Engler; Adam J.,9996,0,9999,3
1745143380243,CAT 124RS,A01,956906,Staff,8,0,25,17
1745143381270,CAT 125RS,A01,922013,Staff,8,0,25,17
1745143382301,CLRE 250,A00,891860,Morris; Sheldon,9996,0,9999,3
1745143384356,CLRE 251R,A00,907817,Mehta; Ravindra L.,9995,0,9999,4
1745143385382,CLRE 252,A00,891864,Cuomo; Raphael Eduardo,9994,0,9999,5
1745143386410,CLRE 253,A00,891867,Vaida; Florin,9995,0,9999,4
1745143386410,CLRE 253,B00,907819,Staff,9999,0,9999,0
1745143387434,CLRE 259,A00,891868,Patel; Hemal,9998,0,9999,1
1745143388460,CLRE 260,A00,891872,Cuomo; Raphael Eduardo,9999,0,9999,0
1745143389486,CLRE 297,001,891888,Cuomo; Raphael Eduardo,9999,0,9999,0
1745143390520,CSS 201S,A01,892054,Mignozzetti; Umberto,30,0,30,0
1745143391555,CSS 202S,A01,892056,Mignozzetti; Umberto,30,0,30,0
1745143392586,DSC 197,001,956898,Eldridge; Justin Matthew,9998,0,9999,1
1745143393611,DSC 297,001,958000,Mazumdar; Arya,9999,0,9999,0
1745143394638,EAP 100,A00,905686,Staff,9774,0,9999,225
1745143395665,ECE 45,A01,892618,Staff,0,2,50,50
1745143396694,ECE 109,A01,892620,Staff,0,44,0,0
1745143397720,ECE 111,A01,892719,Staff,0,0,50,50
1745143398747,ECE 197,001,957920,Mercier; Patrick Philip,9992,0,9999,7
1745143399773,ECON 178,A01,907814,Zhu; Ying,29,0,35,6
1745143400799,EDS 115,A00,895312,Staff,42,0,45,3
1745143401825,EDS 117,A01,895337,Staff,30,0,30,0
1745143402852,EDS 125,A00,895341,Jones; Gabrielle Anastasia,43,0,45,2
1745143403879,EDS 128A,A01,895459,Fargason; Sharon Gayle,45,0,45,0
1745143404906,EDS 128B,A01,895543,Pappas; Elizabeth,45,0,45,0
1745143405937,EDS 139,A00,897203,Pappas; Elizabeth,45,0,45,0
1745143405937,EDS 139,B00,897209,Fargason; Sharon Gayle,45,0,45,0
1745143406963,EDS 201,A00,895545,Staff,44,0,45,1
1745143407988,EDS 203,A01,895581,Halter; Christopher P.,44,0,45,1
1745143409015,EDS 204R,A01,895625,Heinzman; Erica M.,45,0,45,0
1745143409015,EDS 204R,B01,895693,Halter; Christopher P.,28,0,45,17
1745143410041,EDS 206R,A00,895694,Fargason; Sharon Gayle,22,0,30,8
1745143410041,EDS 206R,B00,895695,Choi; Bailey Miyeon,21,0,30,9
1745143411072,EDS 250,A00,895697,Hemans; Patricia Ann Benitez,44,0,45,1
1745143412098,EDS 281,A00,895701,Meyerott; Theresa Ann,15,0,15,0
1745143413123,EDS 284,A00,895736,Meyerott; Theresa Ann,15,0,15,0
1745143414147,EDS 286,A00,897210,Fine; Sarah,15,0,15,0
1745143415172,EDS 289C,A01,895770,Daly; Alan J.,15,0,15,0
1745143416203,EDS 290,A00,897211,Hofstetter; Carolyn,15,0,15,0
1745143417230,LIGM 5A,A00,896162,Fischer-Grunski; Eva K,16,0,20,4
1745143418254,LIGM 5B,A00,896260,Fischer-Grunski; Eva K,19,0,20,1
1745143419281,LIGM 5C,A00,896308,Fischer-Grunski; Eva K,19,0,20,1
1745143420307,LIIT 5AS,A00,896313,Carnelos; Chiara,18,0,20,2
1745143421384,LIIT 5BS,A00,896416,Carnelos; Chiara,20,0,20,0
1745143422412,LIIT 5CS,A00,896564,Carnelos; Chiara,20,0,20,0
1745143423443,LISP 5A,A00,896588,Munoz Sanchez; Alicia,7,0,20,13
1745143424468,LISP 5B,A00,896653,Munoz Sanchez; Alicia,10,0,20,10
1745143425496,LISP 5C,A00,896655,Munoz Sanchez; Alicia,9,0,20,11
1745143426522,MAE 197,001,957918,Kleissl; Jan,9998,0,9999,1
1745143427551,MATH 2,A01,957937,Staff,34,0,35,1
1745143428577,MATH 197,001,957876,Kedlaya; Kiran S.,9996,0,9999,3
1745143429603,MCWP 40,A00,892729,Duru; Nur,15,0,20,5
1745143429603,MCWP 40,B00,893304,Montejo; Carolina,20,0,20,0
1745143430633,MCWP 40R,A00,893757,Redela; Pamela Morgan,0,3,20,20
1745143431665,MCWP 50,A00,893758,Morshed; Michael James,4,0,20,16
1745143431665,MCWP 50,B00,893761,Bartulis; Jason Michael,18,0,20,2
1745143432691,MCWP 50R,A00,893766,Compas; Sean Matthew,0,1,20,20
1745143432691,MCWP 50R,B00,893769,Carter; Jennifer A,5,0,20,15
1745143432691,MCWP 50R,C00,893771,Krone; Jarret,0,3,20,20
1745143432691,MCWP 50R,D00,893772,Miller; Elizabeth Deen,4,0,20,16
1745143432691,MCWP 50R,E00,893775,Carter; Andrea L,0,0,20,20
1745143433717,MMW 11R,A01,892721,Herbst; Matthew,22,0,30,8
1745143433717,MMW 11R,A02,892722,Herbst; Matthew,28,0,30,2
1745143434744,MMW 12R,A01,892724,Herbst; Matthew,0,5,16,16
1745143434744,MMW 12R,A02,892725,Herbst; Matthew,0,4,16,16
1745143435770,MMW 13R,A01,892727,Staff,0,29,16,16
1745143435770,MMW 13R,A02,892728,Staff,0,28,16,16
1745143436796,SIO 295LS,A00,894015,Staff,9,0,25,16
1745143437828,SIO 295S,A00,894020,Staff,9,0,25,16
1745143438859,SIOC 290S,A01,894063,Merrifield; Mark A,23,0,25,2
1745143439891,SIOC 291S,A01,894137,Gabriel; Corey John,23,0,25,2
1745143440920,SOCI 117,A01,895339,Staff,5,0,5,0
1745143441948,WES 237B,A00,894149,Staff,20,0,20,0
1745143444032,AESE 279B,A00,891859,Staff,35,0,35,0
1745143445060,AIP 197,001,891854,Staff,70,0,70,0
1745143446085,ANTH 289S,A00,891856,Gagneux; Pascal,12,0,12,0
1745143447114,BENG 196,001,957946,Engler; Adam J.,9996,0,9999,3
1745143448139,CAT 124RS,A01,956906,Staff,8,0,25,17
1745143449167,CAT 125RS,A01,922013,Staff,8,0,25,17
1745143450197,CLRE 250,A00,891860,Morris; Sheldon,9996,0,9999,3
1745143452250,CLRE 251R,A00,907817,Mehta; Ravindra L.,9995,0,9999,4
1745143453276,CLRE 252,A00,891864,Cuomo; Raphael Eduardo,9994,0,9999,5
1745143454302,CLRE 253,A00,891867,Vaida; Florin,9995,0,9999,4
1745143454302,CLRE 253,B00,907819,Staff,9999,0,9999,0
1745143455330,CLRE 259,A00,891868,Patel; Hemal,9998,0,9999,1
1745143456358,CLRE 260,A00,891872,Cuomo; Raphael Eduardo,9999,0,9999,0
1745143457384,CLRE 297,001,891888,Cuomo; Raphael Eduardo,9999,0,9999,0
1745143458408,CSS 201S,A01,892054,Mignozzetti; Umberto,30,0,30,0
1745143459437,CSS 202S,A01,892056,Mignozzetti; Umberto,30,0,30,0
1745143460462,DSC 197,001,956898,Eldridge; Justin Matthew,9998,0,9999,1
1745143461488,DSC 297,001,958000,Mazumdar; Arya,9999,0,9999,0
1745143462515,EAP 100,A00,905686,Staff,9774,0,9999,225
1745143463539,ECE 45,A01,892618,Staff,0,2,50,50
1745143464568,ECE 109,A01,892620,Staff,0,44,0,0
1745143465594,ECE 111,A01,892719,Staff,0,0,50,50
1745143466620,ECE 197,001,957920,Mercier; Patrick Philip,9992,0,9999,7
1745143467655,ECON 178,A01,907814,Zhu; Ying,29,0,35,6
1745143468684,EDS 115,A00,895312,Staff,42,0,45,3
1745143469711,EDS 117,A01,895337,Staff,30,0,30,0
1745143470737,EDS 125,A00,895341,Jones; Gabrielle Anastasia,43,0,45,2
1745143471763,EDS 128A,A01,895459,Fargason; Sharon Gayle,45,0,45,0
1745143472790,EDS 128B,A01,895543,Pappas; Elizabeth,45,0,45,0
1745143473816,EDS 139,A00,897203,Pappas; Elizabeth,45,0,45,0
1745143473816,EDS 139,B00,897209,Fargason; Sharon Gayle,45,0,45,0
1745143474842,EDS 201,A00,895545,Staff,44,0,45,1
1745143475872,EDS 203,A01,895581,Halter; Christopher P.,44,0,45,1
1745143476903,EDS 204R,A01,895625,Heinzman; Erica M.,45,0,45,0
1745143476903,EDS 204R,B01,895693,Halter; Christopher P.,28,0,45,17
1745143477930,EDS 206R,A00,895694,Fargason; Sharon Gayle,22,0,30,8
1745143477930,EDS 206R,B00,895695,Choi; Bailey Miyeon,21,0,30,9
1745143478961,EDS 250,A00,895697,Hemans; Patricia Ann Benitez,44,0,45,1
1745143479989,EDS 281,A00,895701,Meyerott; Theresa Ann,15,0,15,0
1745143481016,EDS 284,A00,895736,Meyerott; Theresa Ann,15,0,15,0
1745143482042,EDS 286,A00,897210,Fine; Sarah,15,0,15,0
1745143483067,EDS 289C,A01,895770,Daly; Alan J.,15,0,15,0
1745143484097,EDS 290,A00,897211,Hofstetter; Carolyn,15,0,15,0
1745143485122,LIGM 5A,A00,896162,Fischer-Grunski; Eva K,16,0,20,4
1745143486149,LIGM 5B,A00,896260,Fischer-Grunski; Eva K,19,0,20,1
1745143487174,LIGM 5C,A00,896308,Fischer-Grunski; Eva K,19,0,20,1
1745143488200,LIIT 5AS,A00,896313,Carnelos; Chiara,18,0,20,2
1745143489228,LIIT 5BS,A00,896416,Carnelos; Chiara,20,0,20,0
1745143490260,LIIT 5CS,A00,896564,Carnelos; Chiara,20,0,20,0
1745143491290,LISP 5A,A00,896588,Munoz Sanchez; Alicia,7,0,20,13
1745143492318,LISP 5B,A00,896653,Munoz Sanchez; Alicia,10,0,20,10
1745143493902,LISP 5C,A00,896655,Munoz Sanchez; Alicia,9,0,20,11
1745143494931,MAE 197,001,957918,Kleissl; Jan,9998,0,9999,1
1745143495957,MATH 2,A01,957937,Staff,34,0,35,1
1745143496984,MATH 197,001,957876,Kedlaya; Kiran S.,9996,0,9999,3
1745143498010,MCWP 40,A00,892729,Duru; Nur,15,0,20,5
1745143498010,MCWP 40,B00,893304,Montejo; Carolina,20,0,20,0
1745143499040,MCWP 40R,A00,893757,Redela; Pamela Morgan,0,3,20,20
1745143500070,MCWP 50,A00,893758,Morshed; Michael James,4,0,20,16
1745143500070,MCWP 50,B00,893761,Bartulis; Jason Michael,18,0,20,2
1745143501099,MCWP 50R,A00,893766,Compas; Sean Matthew,0,1,20,20
1745143501099,MCWP 50R,B00,893769,Carter; Jennifer A,5,0,20,15
1745143501099,MCWP 50R,C00,893771,Krone; Jarret,0,3,20,20
1745143501099,MCWP 50R,D00,893772,Miller; Elizabeth Deen,4,0,20,16
1745143501099,MCWP 50R,E00,893775,Carter; Andrea L,0,0,20,20
1745143502126,MMW 11R,A01,892721,Herbst; Matthew,22,0,30,8
1745143502126,MMW 11R,A02,892722,Herbst; Matthew,28,0,30,2
1745143503151,MMW 12R,A01,892724,Herbst; Matthew,0,5,16,16
1745143503151,MMW 12R,A02,892725,Herbst; Matthew,0,4,16,16
1745143504176,MMW 13R,A01,892727,Staff,0,29,16,16
1745143504176,MMW 13R,A02,892728,Staff,0,28,16,16
1745143505202,SIO 295LS,A00,894015,Staff,9,0,25,16
1745143506229,SIO 295S,A00,894020,Staff,9,0,25,16
1745143507259,SIOC 290S,A01,894063,Merrifield; Mark A,23,0,25,2
1745143508285,SIOC 291S,A01,894137,Gabriel; Corey John,23,0,25,2
1745143509311,SOCI 117,A01,895339,Staff,5,0,5,0
1745143510338,WES 237B,A00,894149,Staff,20,0,20,0
1745143512404,AESE 279B,A00,891859,Staff,35,0,35,0
1745143513432,AIP 197,001,891854,Staff,70,0,70,0
1745143514459,ANTH 289S,A00,891856,Gagneux; Pascal,12,0,12,0
1745143515488,BENG 196,001,957946,Engler; Adam J.,9996,0,9999,3
1745143516513,CAT 124RS,A01,956906,Staff,8,0,25,17
1745143517539,CAT 125RS,A01,922013,Staff,8,0,25,17
1745143518568,CLRE 250,A00,891860,Morris; Sheldon,9996,0,9999,3
1745143520625,CLRE 251R,A00,907817,Mehta; Ravindra L.,9995,0,9999,4
1745143521650,CLRE 252,A00,891864,Cuomo; Raphael Eduardo,9994,0,9999,5
1745143522675,CLRE 253,A00,891867,Vaida; Florin,9995,0,9999,4
1745143522675,CLRE 253,B00,907819,Staff,9999,0,9999,0
1745143523703,CLRE 259,A00,891868,Patel; Hemal,9998,0,9999,1
1745143524727,CLRE 260,A00,891872,Cuomo; Raphael Eduardo,9999,0,9999,0
1745143525755,CLRE 297,001,891888,Cuomo; Raphael Eduardo,9999,0,9999,0
1745143526785,CSS 201S,A01,892054,Mignozzetti; Umberto,30,0,30,0
1745143527812,CSS 202S,A01,892056,Mignozzetti; Umberto,30,0,30,0
1745143528837,DSC 197,001,956898,Eldridge; Justin Matthew,9998,0,9999,1
1745143529863,DSC 297,001,958000,Mazumdar; Arya,9999,0,9999,0
1745143530891,EAP 100,A00,905686,Staff,9774,0,9999,225
1745143531918,ECE 45,A01,892618,Staff,0,2,50,50
1745143532946,ECE 109,A01,892620,Staff,0,44,0,0
1745143533974,ECE 111,A01,892719,Staff,0,0,50,50
1745143535005,ECE 197,001,957920,Mercier; Patrick Philip,9992,0,9999,7
1745143536030,ECON 178,A01,907814,Zhu; Ying,29,0,35,6
1745143537057,EDS 115,A00,895312,Staff,42,0,45,3
1745143538087,EDS 117,A01,895337,Staff,30,0,30,0
1745143539115,EDS 125,A00,895341,Jones; Gabrielle Anastasia,43,0,45,2
1745143540140,EDS 128A,A01,895459,Fargason; Sharon Gayle,45,0,45,0
1745143541168,EDS 128B,A01,895543,Pappas; Elizabeth,45,0,45,0
1745143542194,EDS 139,A00,897203,Pappas; Elizabeth,45,0,45,0
1745143542194,EDS 139,B00,897209,Fargason; Sharon Gayle,45,0,45,0
1745143543224,EDS 201,A00,895545,Staff,44,0,45,1
1745143544248,EDS 203,A01,895581,Halter; Christopher P.,44,0,45,1
1745143545274,EDS 204R,A01,895625,Heinzman; Erica M.,45,0,45,0
1745143545274,EDS 204R,B01,895693,Halter; Christopher P.,28,0,45,17
1745143546300,EDS 206R,A00,895694,Fargason; Sharon Gayle,22,0,30,8
1745143546300,EDS 206R,B00,895695,Choi; Bailey Miyeon,21,0,30,9
1745143547333,EDS 250,A00,895697,Hemans; Patricia Ann Benitez,44,0,45,1
1745143548361,EDS 281,A00,895701,Meyerott; Theresa Ann,15,0,15,0
1745143549387,EDS 284,A00,895736,Meyerott; Theresa Ann,15,0,15,0
1745143550420,EDS 286,A00,897210,Fine; Sarah,15,0,15,0
1745143551445,EDS 289C,A01,895770,Daly; Alan J.,15,0,15,0
1745143552474,EDS 290,A00,897211,Hofstetter; Carolyn,15,0,15,0
1745143553500,LIGM 5A,A00,896162,Fischer-Grunski; Eva K,16,0,20,4
1745143554531,LIGM 5B,A00,896260,Fischer-Grunski; Eva K,19,0,20,1
1745143555559,LIGM 5C,A00,896308,Fischer-Grunski; Eva K,19,0,20,1
1745143556585,LIIT 5AS,A00,896313,Carnelos; Chiara,18,0,20,2
1745143557617,LIIT 5BS,A00,896416,Carnelos; Chiara,20,0,20,0
1745143558647,LIIT 5CS,A00,896564,Carnelos; Chiara,20,0,20,0
1745143559674,LISP 5A,A00,896588,Munoz Sanchez; Alicia,7,0,20,13
1745143560700,LISP 5B,A00,896653,Munoz Sanchez; Alicia,10,0,20,10
1745143561727,LISP 5C,A00,896655,Munoz Sanchez; Alicia,9,0,20,11
1745143562753,MAE 197,001,957918,Kleissl; Jan,9998,0,9999,1
1745143563780,MATH 2,A01,957937,Staff,34,0,35,1
1745143564805,MATH 197,001,957876,Kedlaya; Kiran S.,9996,0,9999,3
1745143565837,MCWP 40,A00,892729,Duru; Nur,15,0,20,5
1745143565837,MCWP 40,B00,893304,Montejo; Carolina,20,0,20,0
1745143566868,MCWP 40R,A00,893757,Redela; Pamela Morgan,0,3,20,20
1745143567893,MCWP 50,A00,893758,Morshed; Michael James,4,0,20,16
1745143567893,MCWP 50,B00,893761,Bartulis; Jason Michael,18,0,20,2
1745143568918,MCWP 50R,A00,893766,Compas; Sean Matthew,0,1,20,20
1745143568918,MCWP 50R,B00,893769,Carter; Jennifer A,5,0,20,15
1745143568918,MCWP 50R,C00,893771,Krone; Jarret,0,3,20,20
1745143568918,MCWP 50R,D00,893772,Miller; Elizabeth Deen,4,0,20,16
1745143568918,MCWP 50R,E00,893775,Carter; Andrea L,0,0,20,20
1745143569944,MMW 11R,A01,892721,Herbst; Matthew,22,0,30,8
1745143569944,MMW 11R,A02,892722,Herbst; Matthew,28,0,30,2
1745143570971,MMW 12R,A01,892724,Herbst; Matthew,0,5,16,16
1745143570971,MMW 12R,A02,892725,Herbst; Matthew,0,4,16,16
1745143572017,MMW 13R,A01,892727,Staff,0,29,16,16
1745143572017,MMW 13R,A02,892728,Staff,0,28,16,16
1745143573048,SIO 295LS,A00,894015,Staff,9,0,25,16
1745143574074,SIO 295S,A00,894020,Staff,9,0,25,16
1745143575103,SIOC 290S,A01,894063,Merrifield; Mark A,23,0,25,2
1745143576136,SIOC 291S,A01,894137,Gabriel; Corey John,23,0,25,2
1745143577166,SOCI 117,A01,895339,Staff,5,0,5,0
1745143578191,WES 237B,A00,894149,Staff,20,0,20,0
1745143580268,AESE 279B,A00,891859,Staff,35,0,35,0
1745143581295,AIP 197,001,891854,Staff,70,0,70,0
1745143582320,ANTH 289S,A00,891856,Gagneux; Pascal,12,0,12,0
1745143583347,BENG 196,001,957946,Engler; Adam J.,9996,0,9999,3
1745143584377,CAT 124RS,A01,956906,Staff,8,0,25,17
1745143585406,CAT 125RS,A01,922013,Staff,8,0,25,17
1745143586433,CLRE 250,A00,891860,Morris; Sheldon,9996,0,9999,3
1745143588488,CLRE 251R,A00,907817,Mehta; Ravindra L.,9995,0,9999,4
1745143589517,CLRE 252,A00,891864,Cuomo; Raphael Eduardo,9994,0,9999,5
1745143590546,CLRE 253,A00,891867,Vaida; Florin,9995,0,9999,4
1745143590546,CLRE 253,B00,907819,Staff,9999,0,9999,0
1745143591571,CLRE 259,A00,891868,Patel; Hemal,9998,0,9999,1
1745143592596,CLRE 260,A00,891872,Cuomo; Raphael Eduardo,9999,0,9999,0
1745143593624,CLRE 297,001,891888,Cuomo; Raphael Eduardo,9999,0,9999,0
1745143594650,CSS 201S,A01,892054,Mignozzetti; Umberto,30,0,30,0
1745143595676,CSS 202S,A01,892056,Mignozzetti; Umberto,30,0,30,0
1745143596708,DSC 197,001,956898,Eldridge; Justin Matthew,9998,0,9999,1
1745143597733,DSC 297,001,958000,Mazumdar; Arya,9999,0,9999,0
1745143598757,EAP 100,A00,905686,Staff,9774,0,9999,225
1745143599783,ECE 45,A01,892618,Staff,0,2,50,50
1745143600812,ECE 109,A01,892620,Staff,0,44,0,0
1745143601840,ECE 111,A01,892719,Staff,0,0,50,50
1745143602865,ECE 197,001,957920,Mercier; Patrick Philip,9992,0,9999,7
1745143603892,ECON 178,A01,907814,Zhu; Ying,29,0,35,6
1745143604915,EDS 115,A00,895312,Staff,42,0,45,3
1745143605942,EDS 117,A01,895337,Staff,30,0,30,0
1745143606972,EDS 125,A00,895341,Jones; Gabrielle Anastasia,43,0,45,2
1745143607996,EDS 128A,A01,895459,Fargason; Sharon Gayle,45,0,45,0
1745143609026,EDS 128B,A01,895543,Pappas; Elizabeth,45,0,45,0
1745143610055,EDS 139,A00,897203,Pappas; Elizabeth,45,0,45,0
1745143610055,EDS 139,B00,897209,Fargason; Sharon Gayle,45,0,45,0
1745143611083,EDS 201,A00,895545,Staff,44,0,45,1
1745143612109,EDS 203,A01,895581,Halter; Christopher P.,44,0,45,1
1745143613134,EDS 204R,A01,895625,Heinzman; Erica M.,45,0,45,0
1745143613134,EDS 204R,B01,895693,Halter; Christopher P.,28,0,45,17
1745143614159,EDS 206R,A00,895694,Fargason; Sharon Gayle,22,0,30,8
1745143614159,EDS 206R,B00,895695,Choi; Bailey Miyeon,21,0,30,9
1745143615190,EDS 250,A00,895697,Hemans; Patricia Ann Benitez,44,0,45,1
1745143616226,EDS 281,A00,895701,Meyerott; Theresa Ann,15,0,15,0
1745143617252,EDS 284,A00,895736,Meyerott; Theresa Ann,15,0,15,0
1745143618277,EDS 286,A00,897210,Fine; Sarah,15,0,15,0
1745143619306,EDS 289C,A01,895770,Daly; Alan J.,15,0,15,0
1745143620329,EDS 290,A00,897211,Hofstetter; Carolyn,15,0,15,0
1745143621356,LIGM 5A,A00,896162,Fischer-Grunski; Eva K,16,0,20,4
1745143622387,LIGM 5B,A00,896260,Fischer-Grunski; Eva K,19,0,20,1
1745143623417,LIGM 5C,A00,896308,Fischer-Grunski; Eva K,19,0,20,1
1745143624445,LIIT 5AS,A00,896313,Carnelos; Chiara,18,0,20,2
1745143625471,LIIT 5BS,A00,896416,Carnelos; Chiara,20,0,20,0
1745143626501,LIIT 5CS,A00,896564,Carnelos; Chiara,20,0,20,0
1745143627526,LISP 5A,A00,896588,Munoz Sanchez; Alicia,7,0,20,13
1745143628552,LISP 5B,A00,896653,Munoz Sanchez; Alicia,10,0,20,10
1745143629579,LISP 5C,A00,896655,Munoz Sanchez; Alicia,9,0,20,11
1745143630606,MAE 197,001,957918,Kleissl; Jan,9998,0,9999,1
1745143631630,MATH 2,A01,957937,Staff,34,0,35,1
1745143632655,MATH 197,001,957876,Kedlaya; Kiran S.,9996,0,9999,3
1745143633682,MCWP 40,A00,892729,Duru; Nur,15,0,20,5
1745143633682,MCWP 40,B00,893304,Montejo; Carolina,20,0,20,0
1745143634708,MCWP 40R,A00,893757,Redela; Pamela Morgan,0,3,20,20
1745143635734,MCWP 50,A00,893758,Morshed; Michael James,4,0,20,16
1745143635734,MCWP 50,B00,893761,Bartulis; Jason Michael,18,0,20,2
1745143636764,MCWP 50R,A00,893766,Compas; Sean Matthew,0,1,20,20
1745143636764,MCWP 50R,B00,893769,Carter; Jennifer A,5,0,20,15
1745143636764,MCWP 50R,C00,893771,Krone; Jarret,0,3,20,20
1745143636764,MCWP 50R,D00,893772,Miller; Elizabeth Deen,4,0,20,16
1745143636764,MCWP 50R,E00,893775,Carter; Andrea L,0,0,20,20
1745143637793,MMW 11R,A01,892721,Herbst; Matthew,22,0,30,8
1745143637793,MMW 11R,A02,892722,Herbst; Matthew,28,0,30,2
1745143638821,MMW 12R,A01,892724,Herbst; Matthew,0,5,16,16
1745143638821,MMW 12R,A02,892725,Herbst; Matthew,0,4,16,16
1745143639846,MMW 13R,A01,892727,Staff,0,29,16,16
1745143639846,MMW 13R,A02,892728,Staff,0,28,16,16
1745143640872,SIO 295LS,A00,894015,Staff,9,0,25,16
1745143641901,SIO 295S,A00,894020,Staff,9,0,25,16
1745143642928,SIOC 290S,A01,894063,Merrifield; Mark A,23,0,25,2
1745143643954,SIOC 291S,A01,894137,Gabriel; Corey John,23,0,25,2
1745143644979,SOCI 117,A01,895339,Staff,5,0,5,0
1745143646007,WES 237B,A00,894149,Staff,20,0,20,0
1745143648084,AESE 279B,A00,891859,Staff,35,0,35,0
1745143649114,AIP 197,001,891854,Staff,70,0,70,0
1745143650140,ANTH 289S,A00,891856,Gagneux; Pascal,12,0,12,0
1745143651169,BENG 196,001,957946,Engler; Adam J.,9996,0,9999,3
1745143652196,CAT 124RS,A01,956906,Staff,8,0,25,17
1745143653225,CAT 125RS,A01,922013,Staff,8,0,25,17
1745143654249,CLRE 250,A00,891860,Morris; Sheldon,9996,0,9999,3
1745143656301,CLRE 251R,A00,907817,Mehta; Ravindra L.,9995,0,9999,4
1745143657328,CLRE 252,A00,891864,Cuomo; Raphael Eduardo,9994,0,9999,5
1745143658352,CLRE 253,A00,891867,Vaida; Florin,9995,0,9999,4
1745143658352,CLRE 253,B00,907819,Staff,9999,0,9999,0
1745143659381,CLRE 259,A00,891868,Patel; Hemal,9998,0,9999,1
1745143660408,CLRE 260,A00,891872,Cuomo; Raphael Eduardo,9999,0,9999,0
1745143661436,CLRE 297,001,891888,Cuomo; Raphael Eduardo,9999,0,9999,0
1745143662468,CSS 201S,A01,892054,Mignozzetti; Umberto,30,0,30,0
1745143663499,CSS 202S,A01,892056,Mignozzetti; Umberto,30,0,30,0
1745143664528,DSC 197,001,956898,Eldridge; Justin Matthew,9998,0,9999,1
1745143665554,DSC 297,001,958000,Mazumdar; Arya,9999,0,9999,0
1745143666580,EAP 100,A00,905686,Staff,9774,0,9999,225
1745143667608,ECE 45,A01,892618,Staff,0,2,50,50
1745143668635,ECE 109,A01,892620,Staff,0,44,0,0
1745143669661,ECE 111,A01,892719,Staff,0,0,50,50
1745143670687,ECE 197,001,957920,Mercier; Patrick Philip,9992,0,9999,7
1745143671716,ECON 178,A01,907814,Zhu; Ying,29,0,35,6
1745143672741,EDS 115,A00,895312,Staff,42,0,45,3
1745143673765,EDS 117,A01,895337,Staff,30,0,30,0
1745143674790,EDS 125,A00,895341,Jones; Gabrielle Anastasia,43,0,45,2
1745143675817,EDS 128A,A01,895459,Fargason; Sharon Gayle,45,0,45,0
1745143676846,EDS 128B,A01,895543,Pappas; Elizabeth,45,0,45,0
1745143677871,EDS 139,A00,897203,Pappas; Elizabeth,45,0,45,0
1745143677871,EDS 139,B00,897209,Fargason; Sharon Gayle,45,0,45,0
1745143678897,EDS 201,A00,895545,Staff,44,0,45,1
1745143679923,EDS 203,A01,895581,Halter; Christopher P.,44,0,45,1
1745143680951,EDS 204R,A01,895625,Heinzman; Erica M.,45,0,45,0
1745143680951,EDS 204R,B01,895693,Halter; Christopher P.,28,0,45,17
1745143681979,EDS 206R,A00,895694,Fargason; Sharon Gayle,22,0,30,8
1745143681979,EDS 206R,B00,895695,Choi; Bailey Miyeon,21,0,30,9
1745143683004,EDS 250,A00,895697,Hemans; Patricia Ann Benitez,44,0,45,1
1745143684030,EDS 281,A00,895701,Meyerott; Theresa Ann,15,0,15,0
1745143685061,EDS 284,A00,895736,Meyerott; Theresa Ann,15,0,15,0
1745143686087,EDS 286,A00,897210,Fine; Sarah,15,0,15,0
1745143687117,EDS 289C,A01,895770,Daly; Alan J.,15,0,15,0
1745143688144,EDS 290,A00,897211,Hofstetter; Carolyn,15,0,15,0
1745143689171,LIGM 5A,A00,896162,Fischer-Grunski; Eva K,16,0,20,4
1745143690195,LIGM 5B,A00,896260,Fischer-Grunski; Eva K,19,0,20,1
1745143691220,LIGM 5C,A00,896308,Fischer-Grunski; Eva K,19,0,20,1
1745143692245,LIIT 5AS,A00,896313,Carnelos; Chiara,18,0,20,2
1745143693272,LIIT 5BS,A00,896416,Carnelos; Chiara,20,0,20,0
1745143694305,LIIT 5CS,A00,896564,Carnelos; Chiara,20,0,20,0
1745143695336,LISP 5A,A00,896588,Munoz Sanchez; Alicia,7,0,20,13
1745143696366,LISP 5B,A00,896653,Munoz Sanchez; Alicia,10,0,20,10
1745143697397,LISP 5C,A00,896655,Munoz Sanchez; Alicia,9,0,20,11
1745143698423,MAE 197,001,957918,Kleissl; Jan,9998,0,9999,1
1745143699450,MATH 2,A01,957937,Staff,34,0,35,1
1745143700480,MATH 197,001,957876,Kedlaya; Kiran S.,9996,0,9999,3
1745143701508,MCWP 40,A00,892729,Duru; Nur,15,0,20,5
1745143701508,MCWP 40,B00,893304,Montejo; Carolina,20,0,20,0
1745143702539,MCWP 40R,A00,893757,Redela; Pamela Morgan,0,3,20,20
1745143703565,MCWP 50,A00,893758,Morshed; Michael James,4,0,20,16
1745143703565,MCWP 50,B00,893761,Bartulis; Jason Michael,18,0,20,2
1745143704598,MCWP 50R,A00,893766,Compas; Sean Matthew,0,1,20,20
1745143704598,MCWP 50R,B00,893769,Carter; Jennifer A,5,0,20,15
1745143704598,MCWP 50R,C00,893771,Krone; Jarret,0,3,20,20
1745143704598,MCWP 50R,D00,893772,Miller; Elizabeth Deen,4,0,20,16
1745143704598,MCWP 50R,E00,893775,Carter; Andrea L,0,0,20,20
1745143705625,MMW 11R,A01,892721,Herbst; Matthew,22,0,30,8
1745143705625,MMW 11R,A02,892722,Herbst; Matthew,28,0,30,2
1745143706652,MMW 12R,A01,892724,Herbst; Matthew,0,5,16,16
1745143706652,MMW 12R,A02,892725,Herbst; Matthew,0,4,16,16
1745143707677,MMW 13R,A01,892727,Staff,0,29,16,16
1745143707677,MMW 13R,A02,892728,Staff,0,28,16,16
1745143708705,SIO 295LS,A00,894015,Staff,9,0,25,16
1745143709732,SIO 295S,A00,894020,Staff,9,0,25,16
1745143710761,SIOC 290S,A01,894063,Merrifield; Mark A,23,0,25,2
1745143711787,SIOC 291S,A01,894137,Gabriel; Corey John,23,0,25,2
1745143712812,SOCI 117,A01,895339,Staff,5,0,5,0
1745143713838,WES 237B,A00,894149,Staff,20,0,20,0
1745143715926,AESE 279B,A00,891859,Staff,35,0,35,0
1745143716956,AIP 197,001,891854,Staff,70,0,70,0
1745143717983,ANTH 289S,A00,891856,Gagneux; Pascal,12,0,12,0
1745143719013,BENG 196,001,957946,Engler; Adam J.,9996,0,9999,3
1745143720043,CAT 124RS,A01,956906,Staff,8,0,25,17
1745143721072,CAT 125RS,A01,922013,Staff,8,0,25,17
1745143722102,CLRE 250,A00,891860,Morris; Sheldon,9996,0,9999,3
1745143724160,CLRE 251R,A00,907817,Mehta; Ravindra L.,9995,0,9999,4
1745143725187,CLRE 252,A00,891864,Cuomo; Raphael Eduardo,9994,0,9999,5
1745143726218,CLRE 253,A00,891867,Vaida; Florin,9995,0,9999,4
1745143726218,CLRE 253,B00,907819,Staff,9999,0,9999,0
1745143727246,CLRE 259,A00,891868,Patel; Hemal,9998,0,9999,1
1745143728272,CLRE 260,A00,891872,Cuomo; Raphael Eduardo,9999,0,9999,0
1745143729301,CLRE 297,001,891888,Cuomo; Raphael Eduardo,9999,0,9999,0
1745143730328,CSS 201S,A01,892054,Mignozzetti; Umberto,30,0,30,0
1745143731360,CSS 202S,A01,892056,Mignozzetti; Umberto,30,0,30,0
1745143732391,DSC 197,001,956898,Eldridge; Justin Matthew,9998,0,9999,1
1745143733418,DSC 297,001,958000,Mazumdar; Arya,9999,0,9999,0
1745143734444,EAP 100,A00,905686,Staff,9774,0,9999,225
1745143735472,ECE 45,A01,892618,Staff,0,2,50,50
1745143736501,ECE 109,A01,892620,Staff,0,44,0,0
1745143737527,ECE 111,A01,892719,Staff,0,0,50,50
1745143738554,ECE 197,001,957920,Mercier; Patrick Philip,9992,0,9999,7
1745143739581,ECON 178,A01,907814,Zhu; Ying,29,0,35,6
1745143740609,EDS 115,A00,895312,Staff,42,0,45,3
1745143741636,EDS 117,A01,895337,Staff,30,0,30,0
1745143742664,EDS 125,A00,895341,Jones; Gabrielle Anastasia,43,0,45,2
1745143743693,EDS 128A,A01,895459,Fargason; Sharon Gayle,45,0,45,0
1745143744725,EDS 128B,A01,895543,Pappas; Elizabeth,45,0,45,0
1745143745752,EDS 139,A00,897203,Pappas; Elizabeth,45,0,45,0
1745143745752,EDS 139,B00,897209,Fargason; Sharon Gayle,45,0,45,0
1745143746779,EDS 201,A00,895545,Staff,44,0,45,1
1745143747806,EDS 203,A01,895581,Halter; Christopher P.,44,0,45,1
1745143748835,EDS 204R,A01,895625,Heinzman; Erica M.,45,0,45,0
1745143748835,EDS 204R,B01,895693,Halter; Christopher P.,28,0,45,17
1745143749865,EDS 206R,A00,895694,Fargason; Sharon Gayle,22,0,30,8
1745143749865,EDS 206R,B00,895695,Choi; Bailey Miyeon,21,0,30,9
1745143750891,EDS 250,A00,895697,Hemans; Patricia Ann Benitez,44,0,45,1
1745143751917,EDS 281,A00,895701,Meyerott; Theresa Ann,15,0,15,0
1745143752945,EDS 284,A00,895736,Meyerott; Theresa Ann,15,0,15,0
1745143753975,EDS 286,A00,897210,Fine; Sarah,15,0,15,0
1745143755003,EDS 289C,A01,895770,Daly; Alan J.,15,0,15,0
1745143756035,EDS 290,A00,897211,Hofstetter; Carolyn,15,0,15,0
1745143757062,LIGM 5A,A00,896162,Fischer-Grunski; Eva K,16,0,20,4
1745143758146,LIGM 5B,A00,896260,Fischer-Grunski; Eva K,19,0,20,1
1745143759174,LIGM 5C,A00,896308,Fischer-Grunski; Eva K,19,0,20,1
1745143760203,LIIT 5AS,A00,896313,Carnelos; Chiara,18,0,20,2
1745143761229,LIIT 5BS,A00,896416,Carnelos; Chiara,20,0,20,0
1745143762254,LIIT 5CS,A00,896564,Carnelos; Chiara,20,0,20,0
1745143763286,LISP 5A,A00,896588,Munoz Sanchez; Alicia,7,0,20,13
1745143764313,LISP 5B,A00,896653,Munoz Sanchez; Alicia,10,0,20,10
1745143765341,LISP 5C,A00,896655,Munoz Sanchez; Alicia,9,0,20,11
1745143766367,MAE 197,001,957918,Kleissl; Jan,9998,0,9999,1
1745143767394,MATH 2,A01,957937,Staff,34,0,35,1
1745143768420,MATH 197,001,957876,Kedlaya; Kiran S.,9996,0,9999,3
1745143769449,MCWP 40,A00,892729,Duru; Nur,15,0,20,5
1745143769449,MCWP 40,B00,893304,Montejo; Carolina,20,0,20,0
1745143770475,MCWP 40R,A00,893757,Redela; Pamela Morgan,0,3,20,20
1745143771504,MCWP 50,A00,893758,Morshed; Michael James,4,0,20,16
1745143771504,MCWP 50,B00,893761,Bartulis; Jason Michael,18,0,20,2
1745143772537,MCWP 50R,A00,893766,Compas; Sean Matthew,0,1,20,20
1745143772537,MCWP 50R,B00,893769,Carter; Jennifer A,5,0,20,15
1745143772537,MCWP 50R,C00,893771,Krone; Jarret,0,3,20,20
1745143772537,MCWP 50R,D00,893772,Miller; Elizabeth Deen,4,0,20,16
1745143772537,MCWP 50R,E00,893775,Carter; Andrea L,0,0,20,20
1745143773568,MMW 11R,A01,892721,Herbst; Matthew,22,0,30,8
1745143773568,MMW 11R,A02,892722,Herbst; Matthew,28,0,30,2
1745143774594,MMW 12R,A01,892724,Herbst; Matthew,0,5,16,16
1745143774594,MMW 12R,A02,892725,Herbst; Matthew,0,4,16,16
1745143775621,MMW 13R,A01,892727,Staff,0,29,16,16
1745143775621,MMW 13R,A02,892728,Staff,0,28,16,16
1745143776648,SIO 295LS,A00,894015,Staff,9,0,25,16
1745143777676,SIO 295S,A00,894020,Staff,9,0,25,16
1745143778707,SIOC 290S,A01,894063,Merrifield; Mark A,23,0,25,2
1745143779741,SIOC 291S,A01,894137,Gabriel; Corey John,23,0,25,2
1745143780767,SOCI 117,A01,895339,Staff,5,0,5,0
1745143781797,WES 237B,A00,894149,Staff,20,0,20,0
1745143783890,AESE 279B,A00,891859,Staff,35,0,35,0
1745143784915,AIP 197,001,891854,Staff,70,0,70,0
1745143785941,ANTH 289S,A00,891856,Gagneux; Pascal,12,0,12,0
1745143786969,BENG 196,001,957946,Engler; Adam J.,9996,0,9999,3
1745143787994,CAT 124RS,A01,956906,Staff,8,0,25,17
1745143789023,CAT 125RS,A01,922013,Staff,8,0,25,17
1745143790048,CLRE 250,A00,891860,Morris; Sheldon,9996,0,9999,3
1745143792104,CLRE 251R,A00,907817,Mehta; Ravindra L.,9995,0,9999,4
1745143793130,CLRE 252,A00,891864,Cuomo; Raphael Eduardo,9994,0,9999,5
1745143794158,CLRE 253,A00,891867,Vaida; Florin,9995,0,9999,4
1745143794158,CLRE 253,B00,907819,Staff,9999,0,9999,0
1745143795184,CLRE 259,A00,891868,Patel; Hemal,9998,0,9999,1
1745143796211,CLRE 260,A00,891872,Cuomo; Raphael Eduardo,9999,0,9999,0
1745143797238,CLRE 297,001,891888,Cuomo; Raphael Eduardo,9999,0,9999,0
1745143798265,CSS 201S,A01,892054,Mignozzetti; Umberto,30,0,30,0
1745143799297,CSS 202S,A01,892056,Mignozzetti; Umberto,30,0,30,0
1745143800324,DSC 197,001,956898,Eldridge; Justin Matthew,9998,0,9999,1
1745143801351,DSC 297,001,958000,Mazumdar; Arya,9999,0,9999,0
1745143802388,EAP 100,A00,905686,Staff,9774,0,9999,225
1745143803417,ECE 45,A01,892618,Staff,0,2,50,50
1745143804445,ECE 109,A01,892620,Staff,0,44,0,0
1745143805477,ECE 111,A01,892719,Staff,0,0,50,50
1745143806502,ECE 197,001,957920,Mercier; Patrick Philip,9992,0,9999,7
1745143807529,ECON 178,A01,907814,Zhu; Ying,29,0,35,6
1745143808556,EDS 115,A00,895312,Staff,42,0,45,3
1745143809588,EDS 117,A01,895337,Staff,30,0,30,0
1745143810616,EDS 125,A00,895341,Jones; Gabrielle Anastasia,43,0,45,2
1745143811642,EDS 128A,A01,895459,Fargason; Sharon Gayle,45,0,45,0
1745143812667,EDS 128B,A01,895543,Pappas; Elizabeth,45,0,45,0
1745143813695,EDS 139,A00,897203,Pappas; Elizabeth,45,0,45,0
1745143813695,EDS 139,B00,897209,Fargason; Sharon Gayle,45,0,45,0
1745143814722,EDS 201,A00,895545,Staff,44,0,45,1
1745143815748,EDS 203,A01,895581,Halter; Christopher P.,44,0,45,1
1745143816775,EDS 204R,A01,895625,Heinzman; Erica M.,45,0,45,0
1745143816775,EDS 204R,B01,895693,Halter; Christopher P.,28,0,45,17
1745143817806,EDS 206R,A00,895694,Fargason; Sharon Gayle,22,0,30,8
1745143817806,EDS 206R,B00,895695,Choi; Bailey Miyeon,21,0,30,9
1745143818831,EDS 250,A00,895697,Hemans; Patricia Ann Benitez,44,0,45,1
1745143819859,EDS 281,A00,895701,Meyerott; Theresa Ann,15,0,15,0
1745143820889,EDS 284,A00,895736,Meyerott; Theresa Ann,15,0,15,0
1745143821920,EDS 286,A00,897210,Fine; Sarah,15,0,15,0
1745143822951,EDS 289C,A01,895770,Daly; Alan J.,15,0,15,0
1745143824006,EDS 290,A00,897211,Hofstetter; Carolyn,15,0,15,0
1745143825039,LIGM 5A,A00,896162,Fischer-Grunski; Eva K,16,0,20,4
1745143826065,LIGM 5B,A00,896260,Fischer-Grunski; Eva K,19,0,20,1
1745143827089,LIGM 5C,A00,896308,Fischer-Grunski; Eva K,19,0,20,1
1745143828115,LIIT 5AS,A00,896313,Carnelos; Chiara,18,0,20,2
1745143829160,LIIT 5BS,A00,896416,Carnelos; Chiara,20,0,20,0
1745143830192,LIIT 5CS,A00,896564,Carnelos; Chiara,20,0,20,0
1745143831221,LISP 5A,A00,896588,Munoz Sanchez; Alicia,7,0,20,13
1745143832248,LISP 5B,A00,896653,Munoz Sanchez; Alicia,10,0,20,10
1745143833274,LISP 5C,A00,896655,Munoz Sanchez; Alicia,9,0,20,11
1745143834302,MAE 197,001,957918,Kleissl; Jan,9998,0,9999,1
1745143835335,MATH 2,A01,957937,Staff,34,0,35,1
1745143836360,MATH 197,001,957876,Kedlaya; Kiran S.,9996,0,9999,3
1745143837388,MCWP 40,A00,892729,Duru; Nur,15,0,20,5
1745143837388,MCWP 40,B00,893304,Montejo; Carolina,20,0,20,0
1745143838413,MCWP 40R,A00,893757,Redela; Pamela Morgan,0,3,20,20
1745143839442,MCWP 50,A00,893758,Morshed; Michael James,4,0,20,16
1745143839442,MCWP 50,B00,893761,Bartulis; Jason Michael,18,0,20,2
1745143840474,MCWP 50R,A00,893766,Compas; Sean Matthew,0,1,20,20
1745143840474,MCWP 50R,B00,893769,Carter; Jennifer A,5,0,20,15
1745143840474,MCWP 50R,C00,893771,Krone; Jarret,0,3,20,20
1745143840474,MCWP 50R,D00,893772,Miller; Elizabeth Deen,4,0,20,16
1745143840474,MCWP 50R,E00,893775,Carter; Andrea L,0,0,20,20
1745143841500,MMW 11R,A01,892721,Herbst; Matthew,22,0,30,8
1745143841500,MMW 11R,A02,892722,Herbst; Matthew,28,0,30,2
1745143842527,MMW 12R,A01,892724,Herbst; Matthew,0,5,16,16
1745143842527,MMW 12R,A02,892725,Herbst; Matthew,0,4,16,16
1745143843555,MMW 13R,A01,892727,Staff,0,29,16,16
1745143843555,MMW 13R,A02,892728,Staff,0,28,16,16
1745143844586,SIO 295LS,A00,894015,Staff,9,0,25,16
1745143845615,SIO 295S,A00,894020,Staff,9,0,25,16
1745143846640,SIOC 290S,A01,894063,Merrifield; Mark A,23,0,25,2
1745143847669,SIOC 291S,A01,894137,Gabriel; Corey John,23,0,25,2
1745143848696,SOCI 117,A01,895339,Staff,5,0,5,0
1745143849724,WES 237B,A00,894149,Staff,20,0,20,0
1745143851785,AESE 279B,A00,891859,Staff,35,0,35,0
1745143852814,AIP 197,001,891854,Staff,70,0,70,0
1745143853842,ANTH 289S,A00,891856,Gagneux; Pascal,12,0,12,0
1745143854871,BENG 196,001,957946,Engler; Adam J.,9996,0,9999,3
1745143855900,CAT 124RS,A01,956906,Staff,8,0,25,17
1745143856925,CAT 125RS,A01,922013,Staff,8,0,25,17
1745143857955,CLRE 250,A00,891860,Morris; Sheldon,9996,0,9999,3
1745143860010,CLRE 251R,A00,907817,Mehta; Ravindra L.,9995,0,9999,4
1745143861036,CLRE 252,A00,891864,Cuomo; Raphael Eduardo,9994,0,9999,5
1745143862064,CLRE 253,A00,891867,Vaida; Florin,9995,0,9999,4
1745143862064,CLRE 253,B00,907819,Staff,9999,0,9999,0
1745143863090,CLRE 259,A00,891868,Patel; Hemal,9998,0,9999,1
1745143864118,CLRE 260,A00,891872,Cuomo; Raphael Eduardo,9999,0,9999,0
1745143865145,CLRE 297,001,891888,Cuomo; Raphael Eduardo,9999,0,9999,0
1745143866175,CSS 201S,A01,892054,Mignozzetti; Umberto,30,0,30,0
1745143867201,CSS 202S,A01,892056,Mignozzetti; Umberto,30,0,30,0
1745143868230,DSC 197,001,956898,Eldridge; Justin Matthew,9998,0,9999,1
1745143869257,DSC 297,001,958000,Mazumdar; Arya,9999,0,9999,0
1745143870282,EAP 100,A00,905686,Staff,9774,0,9999,225
1745143871309,ECE 45,A01,892618,Staff,0,2,50,50
1745143872338,ECE 109,A01,892620,Staff,0,44,0,0
1745143873366,ECE 111,A01,892719,Staff,0,0,50,50
1745143874393,ECE 197,001,957920,Mercier; Patrick Philip,9992,0,9999,7
1745143875419,ECON 178,A01,907814,Zhu; Ying,29,0,35,6
1745143876447,EDS 115,A00,895312,Staff,42,0,45,3
1745143877476,EDS 117,A01,895337,Staff,30,0,30,0
1745143878505,EDS 125,A00,895341,Jones; Gabrielle Anastasia,43,0,45,2
1745143879532,EDS 128A,A01,895459,Fargason; Sharon Gayle,45,0,45,0
1745143880561,EDS 128B,A01,895543,Pappas; Elizabeth,45,0,45,0
1745143881590,EDS 139,A00,897203,Pappas; Elizabeth,45,0,45,0
1745143881590,EDS 139,B00,897209,Fargason; Sharon Gayle,45,0,45,0
1745143882617,EDS 201,A00,895545,Staff,44,0,45,1
1745143883646,EDS 203,A01,895581,Halter; Christopher P.,44,0,45,1
1745143884712,EDS 204R,A01,895625,Heinzman; Erica M.,45,0,45,0
1745143884712,EDS 204R,B01,895693,Halter; Christopher P.,28,0,45,17
1745143885740,EDS 206R,A00,895694,Fargason; Sharon Gayle,22,0,30,8
1745143885740,EDS 206R,B00,895695,Choi; Bailey Miyeon,21,0,30,9
1745143886770,EDS 250,A00,895697,Hemans; Patricia Ann Benitez,44,0,45,1
1745143887799,EDS 281,A00,895701,Meyerott; Theresa Ann,15,0,15,0
1745143888827,EDS 284,A00,895736,Meyerott; Theresa Ann,15,0,15,0
1745143889856,EDS 286,A00,897210,Fine; Sarah,15,0,15,0
1745143890886,EDS 289C,A01,895770,Daly; Alan J.,15,0,15,0
1745143891913,EDS 290,A00,897211,Hofstetter; Carolyn,15,0,15,0
1745143892937,LIGM 5A,A00,896162,Fischer-Grunski; Eva K,16,0,20,4
1745143893963,LIGM 5B,A00,896260,Fischer-Grunski; Eva K,19,0,20,1
1745143894996,LIGM 5C,A00,896308,Fischer-Grunski; Eva K,19,0,20,1
1745143896025,LIIT 5AS,A00,896313,Carnelos; Chiara,18,0,20,2
1745143897052,LIIT 5BS,A00,896416,Carnelos; Chiara,20,0,20,0
1745143898077,LIIT 5CS,A00,896564,Carnelos; Chiara,20,0,20,0
1745143899103,LISP 5A,A00,896588,Munoz Sanchez; Alicia,7,0,20,13
1745143900129,LISP 5B,A00,896653,Munoz Sanchez; Alicia,10,0,20,10
1745143901155,LISP 5C,A00,896655,Munoz Sanchez; Alicia,9,0,20,11
1745143902182,MAE 197,001,957918,Kleissl; Jan,9998,0,9999,1
1745143903210,MATH 2,A01,957937,Staff,34,0,35,1
1745143904236,MATH 197,001,957876,Kedlaya; Kiran S.,9996,0,9999,3
1745143905261,MCWP 40,A00,892729,Duru; Nur,15,0,20,5
1745143905261,MCWP 40,B00,893304,Montejo; Carolina,20,0,20,0
1745143906288,MCWP 40R,A00,893757,Redela; Pamela Morgan,0,3,20,20
1745143907314,MCWP 50,A00,893758,Morshed; Michael James,4,0,20,16
1745143907314,MCWP 50,B00,893761,Bartulis; Jason Michael,18,0,20,2
1745143908348,MCWP 50R,A00,893766,Compas; Sean Matthew,0,1,20,20
1745143908348,MCWP 50R,B00,893769,Carter; Jennifer A,5,0,20,15
1745143908348,MCWP 50R,C00,893771,Krone; Jarret,0,3,20,20
1745143908348,MCWP 50R,D00,893772,Miller; Elizabeth Deen,4,0,20,16
1745143908348,MCWP 50R,E00,893775,Carter; Andrea L,0,0,20,20
1745143909378,MMW 11R,A01,892721,Herbst; Matthew,22,0,30,8
1745143909378,MMW 11R,A02,892722,Herbst; Matthew,28,0,30,2
1745143910405,MMW 12R,A01,892724,Herbst; Matthew,0,5,16,16
1745143910405,MMW 12R,A02,892725,Herbst; Matthew,0,4,16,16
1745143911431,MMW 13R,A01,892727,Staff,0,29,16,16
1745143911431,MMW 13R,A02,892728,Staff,0,28,16,16
1745143912458,SIO 295LS,A00,894015,Staff,9,0,25,16
1745143913485,SIO 295S,A00,894020,Staff,9,0,25,16
1745143914511,SIOC 290S,A01,894063,Merrifield; Mark A,23,0,25,2
1745143915537,SIOC 291S,A01,894137,Gabriel; Corey John,23,0,25,2
1745143916563,SOCI 117,A01,895339,Staff,5,0,5,0
1745143917589,WES 237B,A00,894149,Staff,20,0,20,0
1745143919654,AESE 279B,A00,891859,Staff,35,0,35,0
1745143920680,AIP 197,001,891854,Staff,70,0,70,0
1745143921708,ANTH 289S,A00,891856,Gagneux; Pascal,12,0,12,0
1745143922740,BENG 196,001,957946,Engler; Adam J.,9996,0,9999,3
1745143923970,CAT 124RS,A01,956906,Staff,8,0,25,17
1745143924997,CAT 125RS,A01,922013,Staff,8,0,25,17
1745143926026,CLRE 250,A00,891860,Morris; Sheldon,9996,0,9999,3
1745143928082,CLRE 251R,A00,907817,Mehta; Ravindra L.,9995,0,9999,4
1745143929109,CLRE 252,A00,891864,Cuomo; Raphael Eduardo,9994,0,9999,5
1745143930140,CLRE 253,A00,891867,Vaida; Florin,9995,0,9999,4
1745143930140,CLRE 253,B00,907819,Staff,9999,0,9999,0
1745143931164,CLRE 259,A00,891868,Patel; Hemal,9998,0,9999,1
1745143932191,CLRE 260,A00,891872,Cuomo; Raphael Eduardo,9999,0,9999,0
1745143933218,CLRE 297,001,891888,Cuomo; Raphael Eduardo,9999,0,9999,0
1745143934245,CSS 201S,A01,892054,Mignozzetti; Umberto,30,0,30,0
1745143935274,CSS 202S,A01,892056,Mignozzetti; Umberto,30,0,30,0
1745143936303,DSC 197,001,956898,Eldridge; Justin Matthew,9998,0,9999,1
1745143937331,DSC 297,001,958000,Mazumdar; Arya,9999,0,9999,0
1745143938357,EAP 100,A00,905686,Staff,9774,0,9999,225
1745143939385,ECE 45,A01,892618,Staff,0,2,50,50
1745143940412,ECE 109,A01,892620,Staff,0,44,0,0
1745143941439,ECE 111,A01,892719,Staff,0,0,50,50
1745143942465,ECE 197,001,957920,Mercier; Patrick Philip,9992,0,9999,7
1745143943495,ECON 178,A01,907814,Zhu; Ying,29,0,35,6
1745143944524,EDS 115,A00,895312,Staff,42,0,45,3
1745143945549,EDS 117,A01,895337,Staff,30,0,30,0
1745143946580,EDS 125,A00,895341,Jones; Gabrielle Anastasia,43,0,45,2
1745143947608,EDS 128A,A01,895459,Fargason; Sharon Gayle,45,0,45,0
1745143948635,EDS 128B,A01,895543,Pappas; Elizabeth,45,0,45,0
1745143949663,EDS 139,A00,897203,Pappas; Elizabeth,45,0,45,0
1745143949663,EDS 139,B00,897209,Fargason; Sharon Gayle,45,0,45,0
1745143950690,EDS 201,A00,895545,Staff,44,0,45,1
1745143951715,EDS 203,A01,895581,Halter; Christopher P.,44,0,45,1
1745143952742,EDS 204R,A01,895625,Heinzman; Erica M.,45,0,45,0
1745143952742,EDS 204R,B01,895693,Halter; Christopher P.,28,0,45,17
1745143953771,EDS 206R,A00,895694,Fargason; Sharon Gayle,22,0,30,8
1745143953771,EDS 206R,B00,895695,Choi; Bailey Miyeon,21,0,30,9
1745143954798,EDS 250,A00,895697,Hemans; Patricia Ann Benitez,44,0,45,1
1745143955831,EDS 281,A00,895701,Meyerott; Theresa Ann,15,0,15,0
1745143956857,EDS 284,A00,895736,Meyerott; Theresa Ann,15,0,15,0
1745143957883,EDS 286,A00,897210,Fine; Sarah,15,0,15,0
1745143958908,EDS 289C,A01,895770,Daly; Alan J.,15,0,15,0
1745143959938,EDS 290,A00,897211,Hofstetter; Carolyn,15,0,15,0
1745143960967,LIGM 5A,A00,896162,Fischer-Grunski; Eva K,16,0,20,4
1745143961993,LIGM 5B,A00,896260,Fischer-Grunski; Eva K,19,0,20,1
1745143963017,LIGM 5C,A00,896308,Fischer-Grunski; Eva K,19,0,20,1
1745143964250,LIIT 5AS,A00,896313,Carnelos; Chiara,18,0,20,2
1745143965282,LIIT 5BS,A00,896416,Carnelos; Chiara,20,0,20,0
1745143966309,LIIT 5CS,A00,896564,Carnelos; Chiara,20,0,20,0
1745143967337,LISP 5A,A00,896588,Munoz Sanchez; Alicia,7,0,20,13
1745143968367,LISP 5B,A00,896653,Munoz Sanchez; Alicia,10,0,20,10
1745143969394,LISP 5C,A00,896655,Munoz Sanchez; Alicia,9,0,20,11
1745143970426,MAE 197,001,957918,Kleissl; Jan,9998,0,9999,1
1745143971455,MATH 2,A01,957937,Staff,34,0,35,1
1745143972485,MATH 197,001,957876,Kedlaya; Kiran S.,9996,0,9999,3
1745143973513,MCWP 40,A00,892729,Duru; Nur,15,0,20,5
1745143973513,MCWP 40,B00,893304,Montejo; Carolina,20,0,20,0
1745143974543,MCWP 40R,A00,893757,Redela; Pamela Morgan,0,3,20,20
1745143975572,MCWP 50,A00,893758,Morshed; Michael James,4,0,20,16
1745143975572,MCWP 50,B00,893761,Bartulis; Jason Michael,18,0,20,2
1745143976601,MCWP 50R,A00,893766,Compas; Sean Matthew,0,1,20,20
1745143976601,MCWP 50R,B00,893769,Carter; Jennifer A,5,0,20,15
1745143976601,MCWP 50R,C00,893771,Krone; Jarret,0,3,20,20
1745143976601,MCWP 50R,D00,893772,Miller; Elizabeth Deen,4,0,20,16
1745143976601,MCWP 50R,E00,893775,Carter; Andrea L,0,0,20,20
1745143977627,MMW 11R,A01,892721,Herbst; Matthew,22,0,30,8
1745143977627,MMW 11R,A02,892722,Herbst; Matthew,28,0,30,2
1745143978654,MMW 12R,A01,892724,Herbst; Matthew,0,5,16,16
1745143978654,MMW 12R,A02,892725,Herbst; Matthew,0,4,16,16
1745143979683,MMW 13R,A01,892727,Staff,0,29,16,16
1745143979683,MMW 13R,A02,892728,Staff,0,28,16,16
1745143980710,SIO 295LS,A00,894015,Staff,9,0,25,16
1745143981736,SIO 295S,A00,894020,Staff,9,0,25,16
1745143982769,SIOC 290S,A01,894063,Merrifield; Mark A,23,0,25,2
1745143983800,SIOC 291S,A01,894137,Gabriel; Corey John,23,0,25,2
1745143984827,SOCI 117,A01,895339,Staff,5,0,5,0
1745143985851,WES 237B,A00,894149,Staff,20,0,20,0
1745143987916,AESE 279B,A00,891859,Staff,35,0,35,0
1745143988941,AIP 197,001,891854,Staff,70,0,70,0
1745143989967,ANTH 289S,A00,891856,Gagneux; Pascal,12,0,12,0
1745143990992,BENG 196,001,957946,Engler; Adam J.,9996,0,9999,3
1745143992021,CAT 124RS,A01,956906,Staff,8,0,25,17
1745143993047,CAT 125RS,A01,922013,Staff,8,0,25,17
1745143994074,CLRE 250,A00,891860,Morris; Sheldon,9996,0,9999,3
1745143996128,CLRE 251R,A00,907817,Mehta; Ravindra L.,9995,0,9999,4
1745143997155,CLRE 252,A00,891864,Cuomo; Raphael Eduardo,9994,0,9999,5
1745143998181,CLRE 253,A00,891867,Vaida; Florin,9995,0,9999,4
1745143998181,CLRE 253,B00,907819,Staff,9999,0,9999,0
1745143999208,CLRE 259,A00,891868,Patel; Hemal,9998,0,9999,1
1745144000233,CLRE 260,A00,891872,Cuomo; Raphael Eduardo,9999,0,9999,0
1745144001262,CLRE 297,001,891888,Cuomo; Raphael Eduardo,9999,0,9999,0
1745144002287,CSS 201S,A01,892054,Mignozzetti; Umberto,30,0,30,0
1745144003316,CSS 202S,A01,892056,Mignozzetti; Umberto,30,0,30,0
1745144004345,DSC 197,001,956898,Eldridge; Justin Matthew,9998,0,9999,1
1745144005371,DSC 297,001,958000,Mazumdar; Arya,9999,0,9999,0
1745144006395,EAP 100,A00,905686,Staff,9774,0,9999,225
1745144007420,ECE 45,A01,892618,Staff,0,2,50,50
1745144008446,ECE 109,A01,892620,Staff,0,44,0,0
1745144009481,ECE 111,A01,892719,Staff,0,0,50,50
1745144010509,ECE 197,001,957920,Mercier; Patrick Philip,9992,0,9999,7
1745144011535,ECON 178,A01,907814,Zhu; Ying,29,0,35,6
1745144012559,EDS 115,A00,895312,Staff,42,0,45,3
1745144013585,EDS 117,A01,895337,Staff,30,0,30,0
1745144014612,EDS 125,A00,895341,Jones; Gabrielle Anastasia,43,0,45,2
1745144015641,EDS 128A,A01,895459,Fargason; Sharon Gayle,45,0,45,0
1745144016667,EDS 128B,A01,895543,Pappas; Elizabeth,45,0,45,0
1745144017699,EDS 139,A00,897203,Pappas; Elizabeth,45,0,45,0
1745144017699,EDS 139,B00,897209,Fargason; Sharon Gayle,45,0,45,0
1745144018726,EDS 201,A00,895545,Staff,44,0,45,1
1745144019755,EDS 203,A01,895581,Halter; Christopher P.,44,0,45,1
1745144020784,EDS 204R,A01,895625,Heinzman; Erica M.,45,0,45,0
1745144020784,EDS 204R,B01,895693,Halter; Christopher P.,28,0,45,17
1745144021813,EDS 206R,A00,895694,Fargason; Sharon Gayle,22,0,30,8
1745144021813,EDS 206R,B00,895695,Choi; Bailey Miyeon,21,0,30,9
1745144022838,EDS 250,A00,895697,Hemans; Patricia Ann Benitez,44,0,45,1
1745144023867,EDS 281,A00,895701,Meyerott; Theresa Ann,15,0,15,0
1745144024892,EDS 284,A00,895736,Meyerott; Theresa Ann,15,0,15,0
1745144025919,EDS 286,A00,897210,Fine; Sarah,15,0,15,0
1745144026944,EDS 289C,A01,895770,Daly; Alan J.,15,0,15,0
1745144027970,EDS 290,A00,897211,Hofstetter; Carolyn,15,0,15,0
1745144028995,LIGM 5A,A00,896162,Fischer-Grunski; Eva K,16,0,20,4
1745144030022,LIGM 5B,A00,896260,Fischer-Grunski; Eva K,19,0,20,1
1745144031053,LIGM 5C,A00,896308,Fischer-Grunski; Eva K,19,0,20,1
1745144032081,LIIT 5AS,A00,896313,Carnelos; Chiara,18,0,20,2
1745144033112,LIIT 5BS,A00,896416,Carnelos; Chiara,20,0,20,0
1745144034144,LIIT 5CS,A00,896564,Carnelos; Chiara,20,0,20,0
1745144035217,LISP 5A,A00,896588,Munoz Sanchez; Alicia,7,0,20,13
1745144036244,LISP 5B,A00,896653,Munoz Sanchez; Alicia,10,0,20,10
1745144037272,LISP 5C,A00,896655,Munoz Sanchez; Alicia,9,0,20,11
1745144038302,MAE 197,001,957918,Kleissl; Jan,9998,0,9999,1
1745144039326,MATH 2,A01,957937,Staff,34,0,35,1
1745144040389,MATH 197,001,957876,Kedlaya; Kiran S.,9996,0,9999,3
1745144041415,MCWP 40,A00,892729,Duru; Nur,15,0,20,5
1745144041415,MCWP 40,B00,893304,Montejo; Carolina,20,0,20,0
1745144042444,MCWP 40R,A00,893757,Redela; Pamela Morgan,0,3,20,20
1745144043473,MCWP 50,A00,893758,Morshed; Michael James,4,0,20,16
1745144043473,MCWP 50,B00,893761,Bartulis; Jason Michael,18,0,20,2
1745144044504,MCWP 50R,A00,893766,Compas; Sean Matthew,0,1,20,20
1745144044504,MCWP 50R,B00,893769,Carter; Jennifer A,5,0,20,15
1745144044504,MCWP 50R,C00,893771,Krone; Jarret,0,3,20,20
1745144044504,MCWP 50R,D00,893772,Miller; Elizabeth Deen,4,0,20,16
1745144044504,MCWP 50R,E00,893775,Carter; Andrea L,0,0,20,20
1745144045532,MMW 11R,A01,892721,Herbst; Matthew,22,0,30,8
1745144045532,MMW 11R,A02,892722,Herbst; Matthew,28,0,30,2
1745144046558,MMW 12R,A01,892724,Herbst; Matthew,0,5,16,16
1745144046558,MMW 12R,A02,892725,Herbst; Matthew,0,4,16,16
1745144047584,MMW 13R,A01,892727,Staff,0,29,16,16
1745144047584,MMW 13R,A02,892728,Staff,0,28,16,16
1745144048615,SIO 295LS,A00,894015,Staff,9,0,25,16
1745144049645,SIO 295S,A00,894020,Staff,9,0,25,16
1745144050670,SIOC 290S,A01,894063,Merrifield; Mark A,23,0,25,2
1745144051702,SIOC 291S,A01,894137,Gabriel; Corey John,23,0,25,2
1745144052730,SOCI 117,A01,895339,Staff,5,0,5,0
1745144053757,WES 237B,A00,894149,Staff,20,0,20,0
1745144055825,AESE 279B,A00,891859,Staff,35,0,35,0
1745144056852,AIP 197,001,891854,Staff,70,0,70,0
1745144057879,ANTH 289S,A00,891856,Gagneux; Pascal,12,0,12,0
1745144058909,BENG 196,001,957946,Engler; Adam J.,9996,0,9999,3
1745144059935,CAT 124RS,A01,956906,Staff,8,0,25,17
1745144060963,CAT 125RS,A01,922013,Staff,8,0,25,17
1745144061991,CLRE 250,A00,891860,Morris; Sheldon,9996,0,9999,3
1745144064049,CLRE 251R,A00,907817,Mehta; Ravindra L.,9995,0,9999,4
1745144065076,CLRE 252,A00,891864,Cuomo; Raphael Eduardo,9994,0,9999,5
1745144066103,CLRE 253,A00,891867,Vaida; Florin,9995,0,9999,4
1745144066103,CLRE 253,B00,907819,Staff,9999,0,9999,0
1745144067129,CLRE 259,A00,891868,Patel; Hemal,9998,0,9999,1
1745144068157,CLRE 260,A00,891872,Cuomo; Raphael Eduardo,9999,0,9999,0
1745144069185,CLRE 297,001,891888,Cuomo; Raphael Eduardo,9999,0,9999,0
1745144070212,CSS 201S,A01,892054,Mignozzetti; Umberto,30,0,30,0
1745144071238,CSS 202S,A01,892056,Mignozzetti; Umberto,30,0,30,0
1745144072266,DSC 197,001,956898,Eldridge; Justin Matthew,9998,0,9999,1
1745144073292,DSC 297,001,958000,Mazumdar; Arya,9999,0,9999,0
1745144074319,EAP 100,A00,905686,Staff,9774,0,9999,225
1745144075346,ECE 45,A01,892618,Staff,0,2,50,50
1745144076372,ECE 109,A01,892620,Staff,0,44,0,0
1745144077400,ECE 111,A01,892719,Staff,0,0,50,50
1745144078429,ECE 197,001,957920,Mercier; Patrick Philip,9992,0,9999,7
1745144079455,ECON 178,A01,907814,Zhu; Ying,29,0,35,6
1745144080480,EDS 115,A00,895312,Staff,42,0,45,3
1745144081505,EDS 117,A01,895337,Staff,30,0,30,0
1745144082531,EDS 125,A00,895341,Jones; Gabrielle Anastasia,43,0,45,2
1745144083560,EDS 128A,A01,895459,Fargason; Sharon Gayle,45,0,45,0
1745144084590,EDS 128B,A01,895543,Pappas; Elizabeth,45,0,45,0
1745144085618,EDS 139,A00,897203,Pappas; Elizabeth,45,0,45,0
1745144085618,EDS 139,B00,897209,Fargason; Sharon Gayle,45,0,45,0
1745144086645,EDS 201,A00,895545,Staff,44,0,45,1
1745144087673,EDS 203,A01,895581,Halter; Christopher P.,44,0,45,1
1745144088703,EDS 204R,A01,895625,Heinzman; Erica M.,45,0,45,0
1745144088703,EDS 204R,B01,895693,Halter; Christopher P.,28,0,45,17
1745144089728,EDS 206R,A00,895694,Fargason; Sharon Gayle,22,0,30,8
1745144089728,EDS 206R,B00,895695,Choi; Bailey Miyeon,21,0,30,9
1745144090758,EDS 250,A00,895697,Hemans; Patricia Ann Benitez,44,0,45,1
1745144091785,EDS 281,A00,895701,Meyerott; Theresa Ann,15,0,15,0
1745144092814,EDS 284,A00,895736,Meyerott; Theresa Ann,15,0,15,0
1745144093841,EDS 286,A00,897210,Fine; Sarah,15,0,15,0
1745144094866,EDS 289C,A01,895770,Daly; Alan J.,15,0,15,0
1745144095892,EDS 290,A00,897211,Hofstetter; Carolyn,15,0,15,0
1745144096922,LIGM 5A,A00,896162,Fischer-Grunski; Eva K,16,0,20,4
1745144097952,LIGM 5B,A00,896260,Fischer-Grunski; Eva K,19,0,20,1
1745144098981,LIGM 5C,A00,896308,Fischer-Grunski; Eva K,19,0,20,1
1745144100010,LIIT 5AS,A00,896313,Carnelos; Chiara,18,0,20,2
1745144101035,LIIT 5BS,A00,896416,Carnelos; Chiara,20,0,20,0
1745144102063,LIIT 5CS,A00,896564,Carnelos; Chiara,20,0,20,0
1745144103087,LISP 5A,A00,896588,Munoz Sanchez; Alicia,7,0,20,13
1745144104112,LISP 5B,A00,896653,Munoz Sanchez; Alicia,10,0,20,10
1745144105141,LISP 5C,A00,896655,Munoz Sanchez; Alicia,9,0,20,11
1745144106167,MAE 197,001,957918,Kleissl; Jan,9998,0,9999,1
1745144107193,MATH 2,A01,957937,Staff,34,0,35,1
1745144108221,MATH 197,001,957876,Kedlaya; Kiran S.,9996,0,9999,3
1745144109246,MCWP 40,A00,892729,Duru; Nur,15,0,20,5
1745144109246,MCWP 40,B00,893304,Montejo; Carolina,20,0,20,0
1745144110277,MCWP 40R,A00,893757,Redela; Pamela Morgan,0,3,20,20
1745144111332,MCWP 50,A00,893758,Morshed; Michael James,4,0,20,16
1745144111332,MCWP 50,B00,893761,Bartulis; Jason Michael,18,0,20,2
1745144112366,MCWP 50R,A00,893766,Compas; Sean Matthew,0,1,20,20
1745144112366,MCWP 50R,B00,893769,Carter; Jennifer A,5,0,20,15
1745144112366,MCWP 50R,C00,893771,Krone; Jarret,0,3,20,20
1745144112366,MCWP 50R,D00,893772,Miller; Elizabeth Deen,4,0,20,16
1745144112366,MCWP 50R,E00,893775,Carter; Andrea L,0,0,20,20
1745144113400,MMW 11R,A01,892721,Herbst; Matthew,22,0,30,8
1745144113400,MMW 11R,A02,892722,Herbst; Matthew,28,0,30,2
1745144114429,MMW 12R,A01,892724,Herbst; Matthew,0,5,16,16
1745144114429,MMW 12R,A02,892725,Herbst; Matthew,0,4,16,16
1745144115455,MMW 13R,A01,892727,Staff,0,29,16,16
1745144115455,MMW 13R,A02,892728,Staff,0,28,16,16
1745144116480,SIO 295LS,A00,894015,Staff,9,0,25,16
1745144117506,SIO 295S,A00,894020,Staff,9,0,25,16
1745144118533,SIOC 290S,A01,894063,Merrifield; Mark A,23,0,25,2
1745144119565,SIOC 291S,A01,894137,Gabriel; Corey John,23,0,25,2
1745144120594,SOCI 117,A01,895339,Staff,5,0,5,0
1745144121623,WES 237B,A00,894149,Staff,20,0,20,0
1745144123703,AESE 279B,A00,891859,Staff,35,0,35,0
1745144124727,AIP 197,001,891854,Staff,70,0,70,0
1745144125781,ANTH 289S,A00,891856,Gagneux; Pascal,12,0,12,0
1745144126806,BENG 196,001,957946,Engler; Adam J.,9996,0,9999,3
1745144127835,CAT 124RS,A01,956906,Staff,8,0,25,17
1745144128866,CAT 125RS,A01,922013,Staff,8,0,25,17
1745144129897,CLRE 250,A00,891860,Morris; Sheldon,9996,0,9999,3
1745144131953,CLRE 251R,A00,907817,Mehta; Ravindra L.,9995,0,9999,4
1745144132983,CLRE 252,A00,891864,Cuomo; Raphael Eduardo,9994,0,9999,5
1745144134012,CLRE 253,A00,891867,Vaida; Florin,9995,0,9999,4
1745144134012,CLRE 253,B00,907819,Staff,9999,0,9999,0
1745144135040,CLRE 259,A00,891868,Patel; Hemal,9998,0,9999,1
1745144136069,CLRE 260,A00,891872,Cuomo; Raphael Eduardo,9999,0,9999,0
1745144137097,CLRE 297,001,891888,Cuomo; Raphael Eduardo,9999,0,9999,0
1745144138124,CSS 201S,A01,892054,Mignozzetti; Umberto,30,0,30,0
1745144139151,CSS 202S,A01,892056,Mignozzetti; Umberto,30,0,30,0
1745144140182,DSC 197,001,956898,Eldridge; Justin Matthew,9998,0,9999,1
1745144141214,DSC 297,001,958000,Mazumdar; Arya,9999,0,9999,0
1745144142240,EAP 100,A00,905686,Staff,9774,0,9999,225
1745144143270,ECE 45,A01,892618,Staff,0,2,50,50
1745144144297,ECE 109,A01,892620,Staff,0,44,0,0
1745144145324,ECE 111,A01,892719,Staff,0,0,50,50
1745144146351,ECE 197,001,957920,Mercier; Patrick Philip,9992,0,9999,7
1745144147383,ECON 178,A01,907814,Zhu; Ying,29,0,35,6
1745144148409,EDS 115,A00,895312,Staff,42,0,45,3
1745144149439,EDS 117,A01,895337,Staff,30,0,30,0
1745144150474,EDS 125,A00,895341,Jones; Gabrielle Anastasia,43,0,45,2
1745144151501,EDS 128A,A01,895459,Fargason; Sharon Gayle,45,0,45,0
1745144152529,EDS 128B,A01,895543,Pappas; Elizabeth,45,0,45,0
1745144153552,EDS 139,A00,897203,Pappas; Elizabeth,45,0,45,0
1745144153552,EDS 139,B00,897209,Fargason; Sharon Gayle,45,0,45,0
1745144154579,EDS 201,A00,895545,Staff,44,0,45,1
1745144155610,EDS 203,A01,895581,Halter; Christopher P.,44,0,45,1
1745144156636,EDS 204R,A01,895625,Heinzman; Erica M.,45,0,45,0
1745144156636,EDS 204R,B01,895693,Halter; Christopher P.,28,0,45,17
1745144157663,EDS 206R,A00,895694,Fargason; Sharon Gayle,22,0,30,8
1745144157663,EDS 206R,B00,895695,Choi; Bailey Miyeon,21,0,30,9
1745144158689,EDS 250,A00,895697,Hemans; Patricia Ann Benitez,44,0,45,1
1745144159734,EDS 281,A00,895701,Meyerott; Theresa Ann,15,0,15,0
1745144160767,EDS 284,A00,895736,Meyerott; Theresa Ann,15,0,15,0
1745144161798,EDS 286,A00,897210,Fine; Sarah,15,0,15,0
1745144162832,EDS 289C,A01,895770,Daly; Alan J.,15,0,15,0
1745144163860,EDS 290,A00,897211,Hofstetter; Carolyn,15,0,15,0
1745144164890,LIGM 5A,A00,896162,Fischer-Grunski; Eva K,16,0,20,4
1745144165915,LIGM 5B,A00,896260,Fischer-Grunski; Eva K,19,0,20,1
1745144166943,LIGM 5C,A00,896308,Fischer-Grunski; Eva K,19,0,20,1
1745144167968,LIIT 5AS,A00,896313,Carnelos; Chiara,18,0,20,2
1745144168996,LIIT 5BS,A00,896416,Carnelos; Chiara,20,0,20,0
1745144170020,LIIT 5CS,A00,896564,Carnelos; Chiara,20,0,20,0
1745144171050,LISP 5A,A00,896588,Munoz Sanchez; Alicia,7,0,20,13
1745144172075,LISP 5B,A00,896653,Munoz Sanchez; Alicia,10,0,20,10
1745144173101,LISP 5C,A00,896655,Munoz Sanchez; Alicia,9,0,20,11
1745144174131,MAE 197,001,957918,Kleissl; Jan,9998,0,9999,1
1745144175159,MATH 2,A01,957937,Staff,34,0,35,1
1745144176186,MATH 197,001,957876,Kedlaya; Kiran S.,9996,0,9999,3
1745144177213,MCWP 40,A00,892729,Duru; Nur,15,0,20,5
1745144177213,MCWP 40,B00,893304,Montejo; Carolina,20,0,20,0
1745144178238,MCWP 40R,A00,893757,Redela; Pamela Morgan,0,3,20,20
1745144179275,MCWP 50,A00,893758,Morshed; Michael James,4,0,20,16
1745144179275,MCWP 50,B00,893761,Bartulis; Jason Michael,18,0,20,2
1745144180305,MCWP 50R,A00,893766,Compas; Sean Matthew,0,1,20,20
1745144180305,MCWP 50R,B00,893769,Carter; Jennifer A,5,0,20,15
1745144180305,MCWP 50R,C00,893771,Krone; Jarret,0,3,20,20
1745144180305,MCWP 50R,D00,893772,Miller; Elizabeth Deen,4,0,20,16
1745144180305,MCWP 50R,E00,893775,Carter; Andrea L,0,0,20,20
1745144181335,MMW 11R,A01,892721,Herbst; Matthew,22,0,30,8
1745144181335,MMW 11R,A02,892722,Herbst; Matthew,28,0,30,2
1745144182361,MMW 12R,A01,892724,Herbst; Matthew,0,5,16,16
1745144182361,MMW 12R,A02,892725,Herbst; Matthew,0,4,16,16
1745144183394,MMW 13R,A01,892727,Staff,0,29,16,16
1745144183394,MMW 13R,A02,892728,Staff,0,28,16,16
1745144184423,SIO 295LS,A00,894015,Staff,9,0,25,16
1745144185448,SIO 295S,A00,894020,Staff,9,0,25,16
1745144186477,SIOC 290S,A01,894063,Merrifield; Mark A,23,0,25,2
1745144187508,SIOC 291S,A01,894137,Gabriel; Corey John,23,0,25,2
1745144188537,SOCI 117,A01,895339,Staff,5,0,5,0
1745144189565,WES 237B,A00,894149,Staff,20,0,20,0
1745144191647,AESE 279B,A00,891859,Staff,35,0,35,0
1745144192672,AIP 197,001,891854,Staff,70,0,70,0
1745144193697,ANTH 289S,A00,891856,Gagneux; Pascal,12,0,12,0
1745144194726,BENG 196,001,957946,Engler; Adam J.,9996,0,9999,3
1745144195752,CAT 124RS,A01,956906,Staff,8,0,25,17
1745144196780,CAT 125RS,A01,922013,Staff,8,0,25,17
1745144197805,CLRE 250,A00,891860,Morris; Sheldon,9996,0,9999,3
1745144199854,CLRE 251R,A00,907817,Mehta; Ravindra L.,9995,0,9999,4
1745144200899,CLRE 252,A00,891864,Cuomo; Raphael Eduardo,9994,0,9999,5
1745144201924,CLRE 253,A00,891867,Vaida; Florin,9995,0,9999,4
1745144201924,CLRE 253,B00,907819,Staff,9999,0,9999,0
1745144202949,CLRE 259,A00,891868,Patel; Hemal,9998,0,9999,1
1745144203975,CLRE 260,A00,891872,Cuomo; Raphael Eduardo,9999,0,9999,0
1745144205000,CLRE 297,001,891888,Cuomo; Raphael Eduardo,9999,0,9999,0
1745144206030,CSS 201S,A01,892054,Mignozzetti; Umberto,30,0,30,0
1745144207057,CSS 202S,A01,892056,Mignozzetti; Umberto,30,0,30,0
1745144208082,DSC 197,001,956898,Eldridge; Justin Matthew,9998,0,9999,1
1745144209110,DSC 297,001,958000,Mazumdar; Arya,9999,0,9999,0
1745144210135,EAP 100,A00,905686,Staff,9774,0,9999,225
1745144211160,ECE 45,A01,892618,Staff,0,2,50,50
1745144212185,ECE 109,A01,892620,Staff,0,44,0,0
1745144213210,ECE 111,A01,892719,Staff,0,0,50,50
1745144214235,ECE 197,001,957920,Mercier; Patrick Philip,9992,0,9999,7
1745144215267,ECON 178,A01,907814,Zhu; Ying,29,0,35,6
1745144216294,EDS 115,A00,895312,Staff,42,0,45,3
1745144217322,EDS 117,A01,895337,Staff,30,0,30,0
1745144218353,EDS 125,A00,895341,Jones; Gabrielle Anastasia,43,0,45,2
1745144219383,EDS 128A,A01,895459,Fargason; Sharon Gayle,45,0,45,0
1745144220413,EDS 128B,A01,895543,Pappas; Elizabeth,45,0,45,0
1745144221440,EDS 139,A00,897203,Pappas; Elizabeth,45,0,45,0
1745144221440,EDS 139,B00,897209,Fargason; Sharon Gayle,45,0,45,0
1745144222470,EDS 201,A00,895545,Staff,44,0,45,1
1745144223499,EDS 203,A01,895581,Halter; Christopher P.,44,0,45,1
1745144224525,EDS 204R,A01,895625,Heinzman; Erica M.,45,0,45,0
1745144224525,EDS 204R,B01,895693,Halter; Christopher P.,28,0,45,17
1745144225555,EDS 206R,A00,895694,Fargason; Sharon Gayle,22,0,30,8
1745144225555,EDS 206R,B00,895695,Choi; Bailey Miyeon,21,0,30,9
1745144226582,EDS 250,A00,895697,Hemans; Patricia Ann Benitez,44,0,45,1
1745144227613,EDS 281,A00,895701,Meyerott; Theresa Ann,15,0,15,0
1745144228641,EDS 284,A00,895736,Meyerott; Theresa Ann,15,0,15,0
1745144229673,EDS 286,A00,897210,Fine; Sarah,15,0,15,0
1745144230704,EDS 289C,A01,895770,Daly; Alan J.,15,0,15,0
1745144231732,EDS 290,A00,897211,Hofstetter; Carolyn,15,0,15,0
1745144232757,LIGM 5A,A00,896162,Fischer-Grunski; Eva K,16,0,20,4
1745144233786,LIGM 5B,A00,896260,Fischer-Grunski; Eva K,19,0,20,1
1745144234813,LIGM 5C,A00,896308,Fischer-Grunski; Eva K,19,0,20,1
1745144235838,LIIT 5AS,A00,896313,Carnelos; Chiara,18,0,20,2
1745144236865,LIIT 5BS,A00,896416,Carnelos; Chiara,20,0,20,0
1745144237892,LIIT 5CS,A00,896564,Carnelos; Chiara,20,0,20,0
1745144238920,LISP 5A,A00,896588,Munoz Sanchez; Alicia,7,0,20,13
1745144239945,LISP 5B,A00,896653,Munoz Sanchez; Alicia,10,0,20,10
1745144240976,LISP 5C,A00,896655,Munoz Sanchez; Alicia,9,0,20,11
1745144242015,MAE 197,001,957918,Kleissl; Jan,9998,0,9999,1
1745144243041,MATH 2,A01,957937,Staff,34,0,35,1
1745144244068,MATH 197,001,957876,Kedlaya; Kiran S.,9996,0,9999,3
1745144245098,MCWP 40,A00,892729,Duru; Nur,15,0,20,5
1745144245098,MCWP 40,B00,893304,Montejo; Carolina,20,0,20,0
1745144246124,MCWP 40R,A00,893757,Redela; Pamela Morgan,0,3,20,20
1745144247150,MCWP 50,A00,893758,Morshed; Michael James,4,0,20,16
1745144247150,MCWP 50,B00,893761,Bartulis; Jason Michael,18,0,20,2
1745144248178,MCWP 50R,A00,893766,Compas; Sean Matthew,0,1,20,20
1745144248178,MCWP 50R,B00,893769,Carter; Jennifer A,5,0,20,15
1745144248178,MCWP 50R,C00,893771,Krone; Jarret,0,3,20,20
1745144248178,MCWP 50R,D00,893772,Miller; Elizabeth Deen,4,0,20,16
1745144248178,MCWP 50R,E00,893775,Carter; Andrea L,0,0,20,20
1745144249204,MMW 11R,A01,892721,Herbst; Matthew,22,0,30,8
1745144249204,MMW 11R,A02,892722,Herbst; Matthew,28,0,30,2
1745144250234,MMW 12R,A01,892724,Herbst; Matthew,0,5,16,16
1745144250234,MMW 12R,A02,892725,Herbst; Matthew,0,4,16,16
1745144251262,MMW 13R,A01,892727,Staff,0,29,16,16
1745144251262,MMW 13R,A02,892728,Staff,0,28,16,16
1745144252288,SIO 295LS,A00,894015,Staff,9,0,25,16
1745144253316,SIO 295S,A00,894020,Staff,9,0,25,16
1745144254340,SIOC 290S,A01,894063,Merrifield; Mark A,23,0,25,2
1745144255367,SIOC 291S,A01,894137,Gabriel; Corey John,23,0,25,2
1745144256396,SOCI 117,A01,895339,Staff,5,0,5,0
1745144257422,WES 237B,A00,894149,Staff,20,0,20,0
1745144259498,AESE 279B,A00,891859,Staff,35,0,35,0
1745144260525,AIP 197,001,891854,Staff,70,0,70,0
1745144261555,ANTH 289S,A00,891856,Gagneux; Pascal,12,0,12,0
1745144262584,BENG 196,001,957946,Engler; Adam J.,9996,0,9999,3
1745144263611,CAT 124RS,A01,956906,Staff,8,0,25,17
1745144264636,CAT 125RS,A01,922013,Staff,8,0,25,17
1745144265665,CLRE 250,A00,891860,Morris; Sheldon,9996,0,9999,3
1745144267720,CLRE 251R,A00,907817,Mehta; Ravindra L.,9995,0,9999,4
1745144268748,CLRE 252,A00,891864,Cuomo; Raphael Eduardo,9994,0,9999,5
1745144269777,CLRE 253,A00,891867,Vaida; Florin,9995,0,9999,4
1745144269777,CLRE 253,B00,907819,Staff,9999,0,9999,0
1745144270806,CLRE 259,A00,891868,Patel; Hemal,9998,0,9999,1
1745144271834,CLRE 260,A00,891872,Cuomo; Raphael Eduardo,9999,0,9999,0
1745144272864,CLRE 297,001,891888,Cuomo; Raphael Eduardo,9999,0,9999,0
1745144273891,CSS 201S,A01,892054,Mignozzetti; Umberto,30,0,30,0
1745144274918,CSS 202S,A01,892056,Mignozzetti; Umberto,30,0,30,0
1745144275945,DSC 197,001,956898,Eldridge; Justin Matthew,9998,0,9999,1
1745144276976,DSC 297,001,958000,Mazumdar; Arya,9999,0,9999,0
1745144278003,EAP 100,A00,905686,Staff,9774,0,9999,225
1745144279033,ECE 45,A01,892618,Staff,0,2,50,50
1745144280058,ECE 109,A01,892620,Staff,0,44,0,0
1745144281085,ECE 111,A01,892719,Staff,0,0,50,50
1745144282110,ECE 197,001,957920,Mercier; Patrick Philip,9992,0,9999,7
1745144283137,ECON 178,A01,907814,Zhu; Ying,29,0,35,6
1745144284164,EDS 115,A00,895312,Staff,42,0,45,3
1745144285189,EDS 117,A01,895337,Staff,30,0,30,0
1745144286215,EDS 125,A00,895341,Jones; Gabrielle Anastasia,43,0,45,2
1745144287246,EDS 128A,A01,895459,Fargason; Sharon Gayle,45,0,45,0
1745144288277,EDS 128B,A01,895543,Pappas; Elizabeth,45,0,45,0
1745144289304,EDS 139,A00,897203,Pappas; Elizabeth,45,0,45,0
1745144289304,EDS 139,B00,897209,Fargason; Sharon Gayle,45,0,45,0
1745144290330,EDS 201,A00,895545,Staff,44,0,45,1
1745144291361,EDS 203,A01,895581,Halter; Christopher P.,44,0,45,1
1745144292397,EDS 204R,A01,895625,Heinzman; Erica M.,45,0,45,0
1745144292397,EDS 204R,B01,895693,Halter; Christopher P.,28,0,45,17
1745144293428,EDS 206R,A00,895694,Fargason; Sharon Gayle,22,0,30,8
1745144293428,EDS 206R,B00,895695,Choi; Bailey Miyeon,21,0,30,9
1745144294458,EDS 250,A00,895697,Hemans; Patricia Ann Benitez,44,0,45,1
1745144295485,EDS 281,A00,895701,Meyerott; Theresa Ann,15,0,15,0
1745144296510,EDS 284,A00,895736,Meyerott; Theresa Ann,15,0,15,0
1745144297536,EDS 286,A00,897210,Fine; Sarah,15,0,15,0
1745144298565,EDS 289C,A01,895770,Daly; Alan J.,15,0,15,0
1745144299593,EDS 290,A00,897211,Hofstetter; Carolyn,15,0,15,0
1745144300623,LIGM 5A,A00,896162,Fischer-Grunski; Eva K,16,0,20,4
1745144301654,LIGM 5B,A00,896260,Fischer-Grunski; Eva K,19,0,20,1
1745144302687,LIGM 5C,A00,896308,Fischer-Grunski; Eva K,19,0,20,1
1745144303713,LIIT 5AS,A00,896313,Carnelos; Chiara,18,0,20,2
1745144304739,LIIT 5BS,A00,896416,Carnelos; Chiara,20,0,20,0
1745144305766,LIIT 5CS,A00,896564,Carnelos; Chiara,20,0,20,0
1745144306796,LISP 5A,A00,896588,Munoz Sanchez; Alicia,7,0,20,13
1745144307826,LISP 5B,A00,896653,Munoz Sanchez; Alicia,10,0,20,10
1745144308855,LISP 5C,A00,896655,Munoz Sanchez; Alicia,9,0,20,11
1745144309882,MAE 197,001,957918,Kleissl; Jan,9998,0,9999,1
1745144310908,MATH 2,A01,957937,Staff,34,0,35,1
1745144311938,MATH 197,001,957876,Kedlaya; Kiran S.,9996,0,9999,3
1745144313006,MCWP 40,A00,892729,Duru; Nur,15,0,20,5
1745144313006,MCWP 40,B00,893304,Montejo; Carolina,20,0,20,0
1745144314034,MCWP 40R,A00,893757,Redela; Pamela Morgan,0,3,20,20
1745144315066,MCWP 50,A00,893758,Morshed; Michael James,4,0,20,16
1745144315066,MCWP 50,B00,893761,Bartulis; Jason Michael,18,0,20,2
1745144316094,MCWP 50R,A00,893766,Compas; Sean Matthew,0,1,20,20
1745144316094,MCWP 50R,B00,893769,Carter; Jennifer A,5,0,20,15
1745144316094,MCWP 50R,C00,893771,Krone; Jarret,0,3,20,20
1745144316094,MCWP 50R,D00,893772,Miller; Elizabeth Deen,4,0,20,16
1745144316094,MCWP 50R,E00,893775,Carter; Andrea L,0,0,20,20
1745144317120,MMW 11R,A01,892721,Herbst; Matthew,22,0,30,8
1745144317120,MMW 11R,A02,892722,Herbst; Matthew,28,0,30,2
1745144318147,MMW 12R,A01,892724,Herbst; Matthew,0,5,16,16
1745144318147,MMW 12R,A02,892725,Herbst; Matthew,0,4,16,16
1745144319176,MMW 13R,A01,892727,Staff,0,29,16,16
1745144319176,MMW 13R,A02,892728,Staff,0,28,16,16
1745144320205,SIO 295LS,A00,894015,Staff,9,0,25,16
1745144321233,SIO 295S,A00,894020,Staff,9,0,25,16
1745144322264,SIOC 290S,A01,894063,Merrifield; Mark A,23,0,25,2
1745144323292,SIOC 291S,A01,894137,Gabriel; Corey John,23,0,25,2
1745144324318,SOCI 117,A01,895339,Staff,5,0,5,0
1745144325344,WES 237B,A00,894149,Staff,20,0,20,0
1745144327408,AESE 279B,A00,891859,Staff,35,0,35,0
1745144328435,AIP 197,001,891854,Staff,70,0,70,0
1745144329461,ANTH 289S,A00,891856,Gagneux; Pascal,12,0,12,0
1745144330488,BENG 196,001,957946,Engler; Adam J.,9996,0,9999,3
1745144331514,CAT 124RS,A01,956906,Staff,8,0,25,17
1745144332540,CAT 125RS,A01,922013,Staff,8,0,25,17
1745144333570,CLRE 250,A00,891860,Morris; Sheldon,9996,0,9999,3
1745144335627,CLRE 251R,A00,907817,Mehta; Ravindra L.,9995,0,9999,4
1745144336653,CLRE 252,A00,891864,Cuomo; Raphael Eduardo,9994,0,9999,5
1745144337681,CLRE 253,A00,891867,Vaida; Florin,9995,0,9999,4
1745144337681,CLRE 253,B00,907819,Staff,9999,0,9999,0
1745144338713,CLRE 259,A00,891868,Patel; Hemal,9998,0,9999,1
1745144339742,CLRE 260,A00,891872,Cuomo; Raphael Eduardo,9999,0,9999,0
1745144340775,CLRE 297,001,891888,Cuomo; Raphael Eduardo,9999,0,9999,0
1745144341807,CSS 201S,A01,892054,Mignozzetti; Umberto,30,0,30,0
1745144342839,CSS 202S,A01,892056,Mignozzetti; Umberto,30,0,30,0
1745144343870,DSC 197,001,956898,Eldridge; Justin Matthew,9998,0,9999,1
1745144344900,DSC 297,001,958000,Mazumdar; Arya,9999,0,9999,0
1745144345931,EAP 100,A00,905686,Staff,9774,0,9999,225
1745144346958,ECE 45,A01,892618,Staff,0,2,50,50
1745144347982,ECE 109,A01,892620,Staff,0,44,0,0
1745144349008,ECE 111,A01,892719,Staff,0,0,50,50
1745144350033,ECE 197,001,957920,Mercier; Patrick Philip,9992,0,9999,7
1745144351060,ECON 178,A01,907814,Zhu; Ying,29,0,35,6
1745144352125,EDS 115,A00,895312,Staff,42,0,45,3
1745144353151,EDS 117,A01,895337,Staff,30,0,30,0
1745144354178,EDS 125,A00,895341,Jones; Gabrielle Anastasia,43,0,45,2
1745144355202,EDS 128A,A01,895459,Fargason; Sharon Gayle,45,0,45,0
1745144356228,EDS 128B,A01,895543,Pappas; Elizabeth,45,0,45,0
1745144357257,EDS 139,A00,897203,Pappas; Elizabeth,45,0,45,0
1745144357257,EDS 139,B00,897209,Fargason; Sharon Gayle,45,0,45,0
1745144358286,EDS 201,A00,895545,Staff,44,0,45,1
1745144359314,EDS 203,A01,895581,Halter; Christopher P.,44,0,45,1
1745144360340,EDS 204R,A01,895625,Heinzman; Erica M.,45,0,45,0
1745144360340,EDS 204R,B01,895693,Halter; Christopher P.,28,0,45,17
1745144361371,EDS 206R,A00,895694,Fargason; Sharon Gayle,22,0,30,8
1745144361371,EDS 206R,B00,895695,Choi; Bailey Miyeon,21,0,30,9
1745144362401,EDS 250,A00,895697,Hemans; Patricia Ann Benitez,44,0,45,1
1745144363431,EDS 281,A00,895701,Meyerott; Theresa Ann,15,0,15,0
1745144364458,EDS 284,A00,895736,Meyerott; Theresa Ann,15,0,15,0
1745144365484,EDS 286,A00,897210,Fine; Sarah,15,0,15,0
1745144366513,EDS 289C,A01,895770,Daly; Alan J.,15,0,15,0
1745144367542,EDS 290,A00,897211,Hofstetter; Carolyn,15,0,15,0
1745144368573,LIGM 5A,A00,896162,Fischer-Grunski; Eva K,16,0,20,4
1745144369604,LIGM 5B,A00,896260,Fischer-Grunski; Eva K,19,0,20,1
1745144370633,LIGM 5C,A00,896308,Fischer-Grunski; Eva K,19,0,20,1
1745144371663,LIIT 5AS,A00,896313,Carnelos; Chiara,18,0,20,2
1745144372691,LIIT 5BS,A00,896416,Carnelos; Chiara,20,0,20,0
1745144373716,LIIT 5CS,A00,896564,Carnelos; Chiara,20,0,20,0
1745144374742,LISP 5A,A00,896588,Munoz Sanchez; Alicia,7,0,20,13
1745144375769,LISP 5B,A00,896653,Munoz Sanchez; Alicia,10,0,20,10
1745144376796,LISP 5C,A00,896655,Munoz Sanchez; Alicia,9,0,20,11
1745144377823,MAE 197,001,957918,Kleissl; Jan,9998,0,9999,1
1745144378853,MATH 2,A01,957937,Staff,34,0,35,1
1745144379881,MATH 197,001,957876,Kedlaya; Kiran S.,9996,0,9999,3
1745144380914,MCWP 40,A00,892729,Duru; Nur,15,0,20,5
1745144380914,MCWP 40,B00,893304,Montejo; Carolina,20,0,20,0
1745144381943,MCWP 40R,A00,893757,Redela; Pamela Morgan,0,3,20,20
1745144382971,MCWP 50,A00,893758,Morshed; Michael James,4,0,20,16
1745144382971,MCWP 50,B00,893761,Bartulis; Jason Michael,18,0,20,2
1745144384006,MCWP 50R,A00,893766,Compas; Sean Matthew,0,1,20,20
1745144384006,MCWP 50R,B00,893769,Carter; Jennifer A,5,0,20,15
1745144384006,MCWP 50R,C00,893771,Krone; Jarret,0,3,20,20
1745144384006,MCWP 50R,D00,893772,Miller; Elizabeth Deen,4,0,20,16
1745144384006,MCWP 50R,E00,893775,Carter; Andrea L,0,0,20,20
1745144385037,MMW 11R,A01,892721,Herbst; Matthew,22,0,30,8
1745144385037,MMW 11R,A02,892722,Herbst; Matthew,28,0,30,2
1745144386062,MMW 12R,A01,892724,Herbst; Matthew,0,5,16,16
1745144386062,MMW 12R,A02,892725,Herbst; Matthew,0,4,16,16
1745144387092,MMW 13R,A01,892727,Staff,0,29,16,16
1745144387092,MMW 13R,A02,892728,Staff,0,28,16,16
1745144388122,SIO 295LS,A00,894015,Staff,9,0,25,16
1745144389151,SIO 295S,A00,894020,Staff,9,0,25,16
1745144390180,SIOC 290S,A01,894063,Merrifield; Mark A,23,0,25,2
1745144391211,SIOC 291S,A01,894137,Gabriel; Corey John,23,0,25,2
1745144392239,SOCI 117,A01,895339,Staff,5,0,5,0
1745144393265,WES 237B,A00,894149,Staff,20,0,20,0
1745144395324,AESE 279B,A00,891859,Staff,35,0,35,0
1745144396351,AIP 197,001,891854,Staff,70,0,70,0
1745144397379,ANTH 289S,A00,891856,Gagneux; Pascal,12,0,12,0
1745144398407,BENG 196,001,957946,Engler; Adam J.,9996,0,9999,3
1745144399433,CAT 124RS,A01,956906,Staff,8,0,25,17
1745144400460,CAT 125RS,A01,922013,Staff,8,0,25,17
1745144401487,CLRE 250,A00,891860,Morris; Sheldon,9996,0,9999,3
1745144403544,CLRE 251R,A00,907817,Mehta; Ravindra L.,9995,0,9999,4
1745144404574,CLRE 252,A00,891864,Cuomo; Raphael Eduardo,9994,0,9999,5
1745144405602,CLRE 253,A00,891867,Vaida; Florin,9995,0,9999,4
1745144405602,CLRE 253,B00,907819,Staff,9999,0,9999,0
1745144406629,CLRE 259,A00,891868,Patel; Hemal,9998,0,9999,1
1745144407657,CLRE 260,A00,891872,Cuomo; Raphael Eduardo,9999,0,9999,0
1745144408683,CLRE 297,001,891888,Cuomo; Raphael Eduardo,9999,0,9999,0
1745144409717,CSS 201S,A01,892054,Mignozzetti; Umberto,30,0,30,0
1745144410748,CSS 202S,A01,892056,Mignozzetti; Umberto,30,0,30,0
1745144411777,DSC 197,001,956898,Eldridge; Justin Matthew,9998,0,9999,1
1745144412802,DSC 297,001,958000,Mazumdar; Arya,9999,0,9999,0
1745144413831,EAP 100,A00,905686,Staff,9774,0,9999,225
1745144414857,ECE 45,A01,892618,Staff,0,2,50,50
1745144415886,ECE 109,A01,892620,Staff,0,44,0,0
1745144416952,ECE 111,A01,892719,Staff,0,0,50,50
1745144417979,ECE 197,001,957920,Mercier; Patrick Philip,9992,0,9999,7
1745144419007,ECON 178,A01,907814,Zhu; Ying,29,0,35,6
1745144420033,EDS 115,A00,895312,Staff,42,0,45,3
1745144421062,EDS 117,A01,895337,Staff,30,0,30,0
1745144422088,EDS 125,A00,895341,Jones; Gabrielle Anastasia,43,0,45,2
1745144423113,EDS 128A,A01,895459,Fargason; Sharon Gayle,45,0,45,0
1745144424140,EDS 128B,A01,895543,Pappas; Elizabeth,45,0,45,0
1745144425166,EDS 139,A00,897203,Pappas; Elizabeth,45,0,45,0
1745144425166,EDS 139,B00,897209,Fargason; Sharon Gayle,45,0,45,0
1745144426190,EDS 201,A00,895545,Staff,44,0,45,1
1745144427216,EDS 203,A01,895581,Halter; Christopher P.,44,0,45,1
1745144428244,EDS 204R,A01,895625,Heinzman; Erica M.,45,0,45,0
1745144428244,EDS 204R,B01,895693,Halter; Christopher P.,28,0,45,17
1745144429274,EDS 206R,A00,895694,Fargason; Sharon Gayle,22,0,30,8
1745144429274,EDS 206R,B00,895695,Choi; Bailey Miyeon,21,0,30,9
1745144430299,EDS 250,A00,895697,Hemans; Patricia Ann Benitez,44,0,45,1
1745144431326,EDS 281,A00,895701,Meyerott; Theresa Ann,15,0,15,0
1745144432357,EDS 284,A00,895736,Meyerott; Theresa Ann,15,0,15,0
1745144433389,EDS 286,A00,897210,Fine; Sarah,15,0,15,0
1745144434418,EDS 289C,A01,895770,Daly; Alan J.,15,0,15,0
1745144435448,EDS 290,A00,897211,Hofstetter; Carolyn,15,0,15,0
1745144436475,LIGM 5A,A00,896162,Fischer-Grunski; Eva K,16,0,20,4
1745144437505,LIGM 5B,A00,896260,Fischer-Grunski; Eva K,19,0,20,1
1745144438536,LIGM 5C,A00,896308,Fischer-Grunski; Eva K,19,0,20,1
1745144439562,LIIT 5AS,A00,896313,Carnelos; Chiara,18,0,20,2
1745144440588,LIIT 5BS,A00,896416,Carnelos; Chiara,20,0,20,0
1745144441614,LIIT 5CS,A00,896564,Carnelos; Chiara,20,0,20,0
1745144442640,LISP 5A,A00,896588,Munoz Sanchez; Alicia,7,0,20,13
1745144443667,LISP 5B,A00,896653,Munoz Sanchez; Alicia,10,0,20,10
1745144444693,LISP 5C,A00,896655,Munoz Sanchez; Alicia,9,0,20,11
1745144445719,MAE 197,001,957918,Kleissl; Jan,9998,0,9999,1
1745144446745,MATH 2,A01,957937,Staff,34,0,35,1
1745144447773,MATH 197,001,957876,Kedlaya; Kiran S.,9996,0,9999,3
1745144448800,MCWP 40,A00,892729,Duru; Nur,15,0,20,5
1745144448800,MCWP 40,B00,893304,Montejo; Carolina,20,0,20,0
1745144449830,MCWP 40R,A00,893757,Redela; Pamela Morgan,0,3,20,20
1745144450856,MCWP 50,A00,893758,Morshed; Michael James,4,0,20,16
1745144450856,MCWP 50,B00,893761,Bartulis; Jason Michael,18,0,20,2
1745144451892,MCWP 50R,A00,893766,Compas; Sean Matthew,0,1,20,20
1745144451892,MCWP 50R,B00,893769,Carter; Jennifer A,5,0,20,15
1745144451892,MCWP 50R,C00,893771,Krone; Jarret,0,3,20,20
1745144451892,MCWP 50R,D00,893772,Miller; Elizabeth Deen,4,0,20,16
1745144451892,MCWP 50R,E00,893775,Carter; Andrea L,0,0,20,20
1745144452922,MMW 11R,A01,892721,Herbst; Matthew,22,0,30,8
1745144452922,MMW 11R,A02,892722,Herbst; Matthew,28,0,30,2
1745144453949,MMW 12R,A01,892724,Herbst; Matthew,0,5,16,16
1745144453949,MMW 12R,A02,892725,Herbst; Matthew,0,4,16,16
1745144454974,MMW 13R,A01,892727,Staff,0,29,16,16
1745144454974,MMW 13R,A02,892728,Staff,0,28,16,16
1745144456001,SIO 295LS,A00,894015,Staff,9,0,25,16
1745144457032,SIO 295S,A00,894020,Staff,9,0,25,16
1745144458060,SIOC 290S,A01,894063,Merrifield; Mark A,23,0,25,2
1745144459089,SIOC 291S,A01,894137,Gabriel; Corey John,23,0,25,2
1745144460122,SOCI 117,A01,895339,Staff,5,0,5,0
1745144461147,WES 237B,A00,894149,Staff,20,0,20,0
1745144463220,AESE 279B,A00,891859,Staff,35,0,35,0
1745144464247,AIP 197,001,891854,Staff,70,0,70,0
1745144465277,ANTH 289S,A00,891856,Gagneux; Pascal,12,0,12,0
1745144466303,BENG 196,001,957946,Engler; Adam J.,9996,0,9999,3
1745144467332,CAT 124RS,A01,956906,Staff,8,0,25,17
1745144468361,CAT 125RS,A01,922013,Staff,8,0,25,17
1745144469394,CLRE 250,A00,891860,Morris; Sheldon,9996,0,9999,3
1745144471445,CLRE 251R,A00,907817,Mehta; Ravindra L.,9995,0,9999,4
1745144472473,CLRE 252,A00,891864,Cuomo; Raphael Eduardo,9994,0,9999,5
1745144473505,CLRE 253,A00,891867,Vaida; Florin,9995,0,9999,4
1745144473505,CLRE 253,B00,907819,Staff,9999,0,9999,0
1745144474532,CLRE 259,A00,891868,Patel; Hemal,9998,0,9999,1
1745144475562,CLRE 260,A00,891872,Cuomo; Raphael Eduardo,9999,0,9999,0
1745144476589,CLRE 297,001,891888,Cuomo; Raphael Eduardo,9999,0,9999,0
1745144477615,CSS 201S,A01,892054,Mignozzetti; Umberto,30,0,30,0
1745144478647,CSS 202S,A01,892056,Mignozzetti; Umberto,30,0,30,0
1745144479679,DSC 197,001,956898,Eldridge; Justin Matthew,9998,0,9999,1
1745144480708,DSC 297,001,958000,Mazumdar; Arya,9999,0,9999,0
1745144481734,EAP 100,A00,905686,Staff,9774,0,9999,225
1745144482761,ECE 45,A01,892618,Staff,0,2,50,50
1745144483791,ECE 109,A01,892620,Staff,0,44,0,0
1745144484817,ECE 111,A01,892719,Staff,0,0,50,50
1745144485848,ECE 197,001,957920,Mercier; Patrick Philip,9992,0,9999,7
1745144486877,ECON 178,A01,907814,Zhu; Ying,29,0,35,6
1745144487906,EDS 115,A00,895312,Staff,42,0,45,3
1745144488932,EDS 117,A01,895337,Staff,30,0,30,0
1745144489958,EDS 125,A00,895341,Jones; Gabrielle Anastasia,43,0,45,2
1745144490986,EDS 128A,A01,895459,Fargason; Sharon Gayle,45,0,45,0
1745144492016,EDS 128B,A01,895543,Pappas; Elizabeth,45,0,45,0
1745144493041,EDS 139,A00,897203,Pappas; Elizabeth,45,0,45,0
1745144493041,EDS 139,B00,897209,Fargason; Sharon Gayle,45,0,45,0
1745144494069,EDS 201,A00,895545,Staff,44,0,45,1
1745144495100,EDS 203,A01,895581,Halter; Christopher P.,44,0,45,1
1745144496130,EDS 204R,A01,895625,Heinzman; Erica M.,45,0,45,0
1745144496130,EDS 204R,B01,895693,Halter; Christopher P.,28,0,45,17
1745144497157,EDS 206R,A00,895694,Fargason; Sharon Gayle,22,0,30,8
1745144497157,EDS 206R,B00,895695,Choi; Bailey Miyeon,21,0,30,9
1745144498183,EDS 250,A00,895697,Hemans; Patricia Ann Benitez,44,0,45,1
1745144499211,EDS 281,A00,895701,Meyerott; Theresa Ann,15,0,15,0
1745144500240,EDS 284,A00,895736,Meyerott; Theresa Ann,15,0,15,0
1745144501267,EDS 286,A00,897210,Fine; Sarah,15,0,15,0
1745144502296,EDS 289C,A01,895770,Daly; Alan J.,15,0,15,0
1745144503323,EDS 290,A00,897211,Hofstetter; Carolyn,15,0,15,0
1745144504350,LIGM 5A,A00,896162,Fischer-Grunski; Eva K,16,0,20,4
1745144505381,LIGM 5B,A00,896260,Fischer-Grunski; Eva K,19,0,20,1
1745144506410,LIGM 5C,A00,896308,Fischer-Grunski; Eva K,19,0,20,1
1745144507437,LIIT 5AS,A00,896313,Carnelos; Chiara,18,0,20,2
1745144508463,LIIT 5BS,A00,896416,Carnelos; Chiara,20,0,20,0
1745144509495,LIIT 5CS,A00,896564,Carnelos; Chiara,20,0,20,0
1745144510521,LISP 5A,A00,896588,Munoz Sanchez; Alicia,7,0,20,13
1745144511547,LISP 5B,A00,896653,Munoz Sanchez; Alicia,10,0,20,10
1745144512571,LISP 5C,A00,896655,Munoz Sanchez; Alicia,9,0,20,11
1745144513600,MAE 197,001,957918,Kleissl; Jan,9998,0,9999,1
1745144514630,MATH 2,A01,957937,Staff,34,0,35,1
1745144515663,MATH 197,001,957876,Kedlaya; Kiran S.,9996,0,9999,3
1745144516698,MCWP 40,A00,892729,Duru; Nur,15,0,20,5
1745144516698,MCWP 40,B00,893304,Montejo; Carolina,20,0,20,0
1745144517724,MCWP 40R,A00,893757,Redela; Pamela Morgan,0,3,20,20
1745144518750,MCWP 50,A00,893758,Morshed; Michael James,4,0,20,16
1745144518750,MCWP 50,B00,893761,Bartulis; Jason Michael,18,0,20,2
1745144519781,MCWP 50R,A00,893766,Compas; Sean Matthew,0,1,20,20
1745144519781,MCWP 50R,B00,893769,Carter; Jennifer A,5,0,20,15
1745144519781,MCWP 50R,C00,893771,Krone; Jarret,0,3,20,20
1745144519781,MCWP 50R,D00,893772,Miller; Elizabeth Deen,4,0,20,16
1745144519781,MCWP 50R,E00,893775,Carter; Andrea L,0,0,20,20
1745144520850,MMW 11R,A01,892721,Herbst; Matthew,22,0,30,8
1745144520850,MMW 11R,A02,892722,Herbst; Matthew,28,0,30,2
1745144521880,MMW 12R,A01,892724,Herbst; Matthew,0,5,16,16
1745144521880,MMW 12R,A02,892725,Herbst; Matthew,0,4,16,16
1745144522905,MMW 13R,A01,892727,Staff,0,29,16,16
1745144522905,MMW 13R,A02,892728,Staff,0,28,16,16
1745144523929,SIO 295LS,A00,894015,Staff,9,0,25,16
1745144524960,SIO 295S,A00,894020,Staff,9,0,25,16
1745144525986,SIOC 290S,A01,894063,Merrifield; Mark A,23,0,25,2
1745144527012,SIOC 291S,A01,894137,Gabriel; Corey John,23,0,25,2
1745144528039,SOCI 117,A01,895339,Staff,5,0,5,0
1745144529064,WES 237B,A00,894149,Staff,20,0,20,0
1745144531132,AESE 279B,A00,891859,Staff,35,0,35,0
1745144532158,AIP 197,001,891854,Staff,70,0,70,0
1745144533187,ANTH 289S,A00,891856,Gagneux; Pascal,12,0,12,0
1745144534217,BENG 196,001,957946,Engler; Adam J.,9996,0,9999,3
1745144535243,CAT 124RS,A01,956906,Staff,8,0,25,17
1745144536270,CAT 125RS,A01,922013,Staff,8,0,25,17
1745144537296,CLRE 250,A00,891860,Morris; Sheldon,9996,0,9999,3
1745144539351,CLRE 251R,A00,907817,Mehta; Ravindra L.,9995,0,9999,4
1745144540378,CLRE 252,A00,891864,Cuomo; Raphael Eduardo,9994,0,9999,5
1745144541407,CLRE 253,A00,891867,Vaida; Florin,9995,0,9999,4
1745144541407,CLRE 253,B00,907819,Staff,9999,0,9999,0
1745144542435,CLRE 259,A00,891868,Patel; Hemal,9998,0,9999,1
1745144543460,CLRE 260,A00,891872,Cuomo; Raphael Eduardo,9999,0,9999,0
1745144544486,CLRE 297,001,891888,Cuomo; Raphael Eduardo,9999,0,9999,0
1745144545513,CSS 201S,A01,892054,Mignozzetti; Umberto,30,0,30,0
1745144546539,CSS 202S,A01,892056,Mignozzetti; Umberto,30,0,30,0
1745144547566,DSC 197,001,956898,Eldridge; Justin Matthew,9998,0,9999,1
1745144548595,DSC 297,001,958000,Mazumdar; Arya,9999,0,9999,0
1745144549624,EAP 100,A00,905686,Staff,9774,0,9999,225
1745144550656,ECE 45,A01,892618,Staff,0,2,50,50
1745144551683,ECE 109,A01,892620,Staff,0,44,0,0
1745144552713,ECE 111,A01,892719,Staff,0,0,50,50
1745144553743,ECE 197,001,957920,Mercier; Patrick Philip,9992,0,9999,7
1745144554770,ECON 178,A01,907814,Zhu; Ying,29,0,35,6
1745144555796,EDS 115,A00,895312,Staff,42,0,45,3
1745144556822,EDS 117,A01,895337,Staff,30,0,30,0
1745144557850,EDS 125,A00,895341,Jones; Gabrielle Anastasia,43,0,45,2
1745144558879,EDS 128A,A01,895459,Fargason; Sharon Gayle,45,0,45,0
1745144559905,EDS 128B,A01,895543,Pappas; Elizabeth,45,0,45,0
1745144560932,EDS 139,A00,897203,Pappas; Elizabeth,45,0,45,0
1745144560932,EDS 139,B00,897209,Fargason; Sharon Gayle,45,0,45,0
1745144561957,EDS 201,A00,895545,Staff,44,0,45,1
1745144562987,EDS 203,A01,895581,Halter; Christopher P.,44,0,45,1
1745144564018,EDS 204R,A01,895625,Heinzman; Erica M.,45,0,45,0
1745144564018,EDS 204R,B01,895693,Halter; Christopher P.,28,0,45,17
1745144565043,EDS 206R,A00,895694,Fargason; Sharon Gayle,22,0,30,8
1745144565043,EDS 206R,B00,895695,Choi; Bailey Miyeon,21,0,30,9
1745144566073,EDS 250,A00,895697,Hemans; Patricia Ann Benitez,44,0,45,1
1745144567102,EDS 281,A00,895701,Meyerott; Theresa Ann,15,0,15,0
1745144568127,EDS 284,A00,895736,Meyerott; Theresa Ann,15,0,15,0
1745144569154,EDS 286,A00,897210,Fine; Sarah,15,0,15,0
1745144570182,EDS 289C,A01,895770,Daly; Alan J.,15,0,15,0
1745144571210,EDS 290,A00,897211,Hofstetter; Carolyn,15,0,15,0
1745144572238,LIGM 5A,A00,896162,Fischer-Grunski; Eva K,16,0,20,4
1745144573266,LIGM 5B,A00,896260,Fischer-Grunski; Eva K,19,0,20,1
1745144574292,LIGM 5C,A00,896308,Fischer-Grunski; Eva K,19,0,20,1
1745144575318,LIIT 5AS,A00,896313,Carnelos; Chiara,18,0,20,2
1745144576346,LIIT 5BS,A00,896416,Carnelos; Chiara,20,0,20,0
1745144577376,LIIT 5CS,A00,896564,Carnelos; Chiara,20,0,20,0
1745144578404,LISP 5A,A00,896588,Munoz Sanchez; Alicia,7,0,20,13
1745144579433,LISP 5B,A00,896653,Munoz Sanchez; Alicia,10,0,20,10
1745144580464,LISP 5C,A00,896655,Munoz Sanchez; Alicia,9,0,20,11
1745144581490,MAE 197,001,957918,Kleissl; Jan,9998,0,9999,1
1745144582516,MATH 2,A01,957937,Staff,34,0,35,1
1745144583540,MATH 197,001,957876,Kedlaya; Kiran S.,9996,0,9999,3
1745144584569,MCWP 40,A00,892729,Duru; Nur,15,0,20,5
1745144584569,MCWP 40,B00,893304,Montejo; Carolina,20,0,20,0
1745144585600,MCWP 40R,A00,893757,Redela; Pamela Morgan,0,3,20,20
1745144586626,MCWP 50,A00,893758,Morshed; Michael James,4,0,20,16
1745144586626,MCWP 50,B00,893761,Bartulis; Jason Michael,18,0,20,2
1745144587652,MCWP 50R,A00,893766,Compas; Sean Matthew,0,1,20,20
1745144587652,MCWP 50R,B00,893769,Carter; Jennifer A,5,0,20,15
1745144587652,MCWP 50R,C00,893771,Krone; Jarret,0,3,20,20
1745144587652,MCWP 50R,D00,893772,Miller; Elizabeth Deen,4,0,20,16
1745144587652,MCWP 50R,E00,893775,Carter; Andrea L,0,0,20,20
1745144588676,MMW 11R,A01,892721,Herbst; Matthew,22,0,30,8
1745144588676,MMW 11R,A02,892722,Herbst; Matthew,28,0,30,2
1745144589701,MMW 12R,A01,892724,Herbst; Matthew,0,5,16,16
1745144589701,MMW 12R,A02,892725,Herbst; Matthew,0,4,16,16
1745144590731,MMW 13R,A01,892727,Staff,0,29,16,16
1745144590731,MMW 13R,A02,892728,Staff,0,28,16,16
1745144591761,SIO 295LS,A00,894015,Staff,9,0,25,16
1745144592788,SIO 295S,A00,894020,Staff,9,0,25,16
1745144593814,SIOC 290S,A01,894063,Merrifield; Mark A,23,0,25,2
1745144594839,SIOC 291S,A01,894137,Gabriel; Corey John,23,0,25,2
1745144595868,SOCI 117,A01,895339,Staff,5,0,5,0
1745144596894,WES 237B,A00,894149,Staff,20,0,20,0
1745144598956,AESE 279B,A00,891859,Staff,35,0,35,0
1745144599982,AIP 197,001,891854,Staff,70,0,70,0
1745144601007,ANTH 289S,A00,891856,Gagneux; Pascal,12,0,12,0
1745144602036,BENG 196,001,957946,Engler; Adam J.,9996,0,9999,3
1745144603060,CAT 124RS,A01,956906,Staff,8,0,25,17
1745144604084,CAT 125RS,A01,922013,Staff,8,0,25,17
1745144605112,CLRE 250,A00,891860,Morris; Sheldon,9996,0,9999,3
1745144607168,CLRE 251R,A00,907817,Mehta; Ravindra L.,9995,0,9999,4
1745144608196,CLRE 252,A00,891864,Cuomo; Raphael Eduardo,9994,0,9999,5
1745144609225,CLRE 253,A00,891867,Vaida; Florin,9995,0,9999,4
1745144609225,CLRE 253,B00,907819,Staff,9999,0,9999,0
1745144610252,CLRE 259,A00,891868,Patel; Hemal,9998,0,9999,1
1745144611278,CLRE 260,A00,891872,Cuomo; Raphael Eduardo,9999,0,9999,0
1745144612304,CLRE 297,001,891888,Cuomo; Raphael Eduardo,9999,0,9999,0
1745144613335,CSS 201S,A01,892054,Mignozzetti; Umberto,30,0,30,0
1745144614364,CSS 202S,A01,892056,Mignozzetti; Umberto,30,0,30,0
1745144615391,DSC 197,001,956898,Eldridge; Justin Matthew,9998,0,9999,1
1745144616416,DSC 297,001,958000,Mazumdar; Arya,9999,0,9999,0
1745144617440,EAP 100,A00,905686,Staff,9774,0,9999,225
1745144618470,ECE 45,A01,892618,Staff,0,2,50,50
1745144619498,ECE 109,A01,892620,Staff,0,44,0,0
1745144620528,ECE 111,A01,892719,Staff,0,0,50,50
1745144621557,ECE 197,001,957920,Mercier; Patrick Philip,9992,0,9999,7
1745144622584,ECON 178,A01,907814,Zhu; Ying,29,0,35,6
1745144623610,EDS 115,A00,895312,Staff,42,0,45,3
1745144624642,EDS 117,A01,895337,Staff,30,0,30,0
1745144625667,EDS 125,A00,895341,Jones; Gabrielle Anastasia,43,0,45,2
1745144626696,EDS 128A,A01,895459,Fargason; Sharon Gayle,45,0,45,0
1745144627723,EDS 128B,A01,895543,Pappas; Elizabeth,45,0,45,0
1745144628752,EDS 139,A00,897203,Pappas; Elizabeth,45,0,45,0
1745144628752,EDS 139,B00,897209,Fargason; Sharon Gayle,45,0,45,0
1745144629783,EDS 201,A00,895545,Staff,44,0,45,1
1745144630811,EDS 203,A01,895581,Halter; Christopher P.,44,0,45,1
1745144631837,EDS 204R,A01,895625,Heinzman; Erica M.,45,0,45,0
1745144631837,EDS 204R,B01,895693,Halter; Christopher P.,28,0,45,17
1745144632863,EDS 206R,A00,895694,Fargason; Sharon Gayle,22,0,30,8
1745144632863,EDS 206R,B00,895695,Choi; Bailey Miyeon,21,0,30,9
1745144633889,EDS 250,A00,895697,Hemans; Patricia Ann Benitez,44,0,45,1
1745144634915,EDS 281,A00,895701,Meyerott; Theresa Ann,15,0,15,0
1745144635951,EDS 284,A00,895736,Meyerott; Theresa Ann,15,0,15,0
1745144636978,EDS 286,A00,897210,Fine; Sarah,15,0,15,0
1745144638009,EDS 289C,A01,895770,Daly; Alan J.,15,0,15,0
1745144639035,EDS 290,A00,897211,Hofstetter; Carolyn,15,0,15,0
1745144640060,LIGM 5A,A00,896162,Fischer-Grunski; Eva K,16,0,20,4
1745144641086,LIGM 5B,A00,896260,Fischer-Grunski; Eva K,19,0,20,1
1745144642112,LIGM 5C,A00,896308,Fischer-Grunski; Eva K,19,0,20,1
1745144643142,LIIT 5AS,A00,896313,Carnelos; Chiara,18,0,20,2
1745144644168,LIIT 5BS,A00,896416,Carnelos; Chiara,20,0,20,0
1745144645196,LIIT 5CS,A00,896564,Carnelos; Chiara,20,0,20,0
1745144646223,LISP 5A,A00,896588,Munoz Sanchez; Alicia,7,0,20,13
1745144647252,LISP 5B,A00,896653,Munoz Sanchez; Alicia,10,0,20,10
1745144648284,LISP 5C,A00,896655,Munoz Sanchez; Alicia,9,0,20,11
1745144649309,MAE 197,001,957918,Kleissl; Jan,9998,0,9999,1
1745144650340,MATH 2,A01,957937,Staff,34,0,35,1
1745144651365,MATH 197,001,957876,Kedlaya; Kiran S.,9996,0,9999,3
1745144652396,MCWP 40,A00,892729,Duru; Nur,15,0,20,5
1745144652396,MCWP 40,B00,893304,Montejo; Carolina,20,0,20,0
1745144653422,MCWP 40R,A00,893757,Redela; Pamela Morgan,0,3,20,20
1745144654448,MCWP 50,A00,893758,Morshed; Michael James,4,0,20,16
1745144654448,MCWP 50,B00,893761,Bartulis; Jason Michael,18,0,20,2
1745144655475,MCWP 50R,A00,893766,Compas; Sean Matthew,0,1,20,20
1745144655475,MCWP 50R,B00,893769,Carter; Jennifer A,5,0,20,15
1745144655475,MCWP 50R,C00,893771,Krone; Jarret,0,3,20,20
1745144655475,MCWP 50R,D00,893772,Miller; Elizabeth Deen,4,0,20,16
1745144655475,MCWP 50R,E00,893775,Carter; Andrea L,0,0,20,20
1745144656502,MMW 11R,A01,892721,Herbst; Matthew,22,0,30,8
1745144656502,MMW 11R,A02,892722,Herbst; Matthew,28,0,30,2
1745144657529,MMW 12R,A01,892724,Herbst; Matthew,0,5,16,16
1745144657529,MMW 12R,A02,892725,Herbst; Matthew,0,4,16,16
1745144658556,MMW 13R,A01,892727,Staff,0,29,16,16
1745144658556,MMW 13R,A02,892728,Staff,0,28,16,16
1745144659583,SIO 295LS,A00,894015,Staff,9,0,25,16
1745144660609,SIO 295S,A00,894020,Staff,9,0,25,16
1745144661640,SIOC 290S,A01,894063,Merrifield; Mark A,23,0,25,2
1745144662671,SIOC 291S,A01,894137,Gabriel; Corey John,23,0,25,2
1745144663699,SOCI 117,A01,895339,Staff,5,0,5,0
1745144664726,WES 237B,A00,894149,Staff,20,0,20,0
1745144666796,AESE 279B,A00,891859,Staff,35,0,35,0
1745144667824,AIP 197,001,891854,Staff,70,0,70,0
1745144668851,ANTH 289S,A00,891856,Gagneux; Pascal,12,0,12,0
1745144669877,BENG 196,001,957946,Engler; Adam J.,9996,0,9999,3
1745144670906,CAT 124RS,A01,956906,Staff,8,0,25,17
1745144671936,CAT 125RS,A01,922013,Staff,8,0,25,17
1745144673009,CLRE 250,A00,891860,Morris; Sheldon,9996,0,9999,3
1745144675070,CLRE 251R,A00,907817,Mehta; Ravindra L.,9995,0,9999,4
1745144676100,CLRE 252,A00,891864,Cuomo; Raphael Eduardo,9994,0,9999,5
1745144677126,CLRE 253,A00,891867,Vaida; Florin,9995,0,9999,4
1745144677126,CLRE 253,B00,907819,Staff,9999,0,9999,0
1745144678154,CLRE 259,A00,891868,Patel; Hemal,9998,0,9999,1
1745144679179,CLRE 260,A00,891872,Cuomo; Raphael Eduardo,9999,0,9999,0
1745144680206,CLRE 297,001,891888,Cuomo; Raphael Eduardo,9999,0,9999,0
1745144681233,CSS 201S,A01,892054,Mignozzetti; Umberto,30,0,30,0
1745144682260,CSS 202S,A01,892056,Mignozzetti; Umberto,30,0,30,0
1745144683285,DSC 197,001,956898,Eldridge; Justin Matthew,9998,0,9999,1
1745144684312,DSC 297,001,958000,Mazumdar; Arya,9999,0,9999,0
1745144685338,EAP 100,A00,905686,Staff,9774,0,9999,225
1745144686368,ECE 45,A01,892618,Staff,0,2,50,50
1745144687398,ECE 109,A01,892620,Staff,0,44,0,0
1745144688423,ECE 111,A01,892719,Staff,0,0,50,50
1745144689449,ECE 197,001,957920,Mercier; Patrick Philip,9992,0,9999,7
1745144690477,ECON 178,A01,907814,Zhu; Ying,29,0,35,6
1745144691503,EDS 115,A00,895312,Staff,42,0,45,3
1745144692532,EDS 117,A01,895337,Staff,30,0,30,0
1745144693559,EDS 125,A00,895341,Jones; Gabrielle Anastasia,43,0,45,2
1745144694585,EDS 128A,A01,895459,Fargason; Sharon Gayle,45,0,45,0
1745144695612,EDS 128B,A01,895543,Pappas; Elizabeth,45,0,45,0
1745144696640,EDS 139,A00,897203,Pappas; Elizabeth,45,0,45,0
1745144696640,EDS 139,B00,897209,Fargason; Sharon Gayle,45,0,45,0
1745144697668,EDS 201,A00,895545,Staff,44,0,45,1
1745144698694,EDS 203,A01,895581,Halter; Christopher P.,44,0,45,1
1745144699720,EDS 204R,A01,895625,Heinzman; Erica M.,45,0,45,0
1745144699720,EDS 204R,B01,895693,Halter; Christopher P.,28,0,45,17
1745144700749,EDS 206R,A00,895694,Fargason; Sharon Gayle,22,0,30,8
1745144700749,EDS 206R,B00,895695,Choi; Bailey Miyeon,21,0,30,9
1745144701782,EDS 250,A00,895697,Hemans; Patricia Ann Benitez,44,0,45,1
1745144702809,EDS 281,A00,895701,Meyerott; Theresa Ann,15,0,15,0
1745144703836,EDS 284,A00,895736,Meyerott; Theresa Ann,15,0,15,0
1745144704863,EDS 286,A00,897210,Fine; Sarah,15,0,15,0
1745144705889,EDS 289C,A01,895770,Daly; Alan J.,15,0,15,0
1745144706916,EDS 290,A00,897211,Hofstetter; Carolyn,15,0,15,0
1745144707943,LIGM 5A,A00,896162,Fischer-Grunski; Eva K,16,0,20,4
1745144708970,LIGM 5B,A00,896260,Fischer-Grunski; Eva K,19,0,20,1
1745144709997,LIGM 5C,A00,896308,Fischer-Grunski; Eva K,19,0,20,1
1745144711023,LIIT 5AS,A00,896313,Carnelos; Chiara,18,0,20,2
1745144712049,LIIT 5BS,A00,896416,Carnelos; Chiara,20,0,20,0
1745144713074,LIIT 5CS,A00,896564,Carnelos; Chiara,20,0,20,0
1745144714100,LISP 5A,A00,896588,Munoz Sanchez; Alicia,7,0,20,13
1745144715126,LISP 5B,A00,896653,Munoz Sanchez; Alicia,10,0,20,10
1745144716154,LISP 5C,A00,896655,Munoz Sanchez; Alicia,9,0,20,11
1745144717180,MAE 197,001,957918,Kleissl; Jan,9998,0,9999,1
1745144718209,MATH 2,A01,957937,Staff,34,0,35,1
1745144719237,MATH 197,001,957876,Kedlaya; Kiran S.,9996,0,9999,3
1745144720270,MCWP 40,A00,892729,Duru; Nur,15,0,20,5
1745144720270,MCWP 40,B00,893304,Montejo; Carolina,20,0,20,0
1745144721296,MCWP 40R,A00,893757,Redela; Pamela Morgan,0,3,20,20
1745144722324,MCWP 50,A00,893758,Morshed; Michael James,4,0,20,16
1745144722324,MCWP 50,B00,893761,Bartulis; Jason Michael,18,0,20,2
1745144723353,MCWP 50R,A00,893766,Compas; Sean Matthew,0,1,20,20
1745144723353,MCWP 50R,B00,893769,Carter; Jennifer A,5,0,20,15
1745144723353,MCWP 50R,C00,893771,Krone; Jarret,0,3,20,20
1745144723353,MCWP 50R,D00,893772,Miller; Elizabeth Deen,4,0,20,16
1745144723353,MCWP 50R,E00,893775,Carter; Andrea L,0,0,20,20
1745144724377,MMW 11R,A01,892721,Herbst; Matthew,22,0,30,8
1745144724377,MMW 11R,A02,892722,Herbst; Matthew,28,0,30,2
1745144725407,MMW 12R,A01,892724,Herbst; Matthew,0,5,16,16
1745144725407,MMW 12R,A02,892725,Herbst; Matthew,0,4,16,16
1745144726435,MMW 13R,A01,892727,Staff,0,29,16,16
1745144726435,MMW 13R,A02,892728,Staff,0,28,16,16
1745144727462,SIO 295LS,A00,894015,Staff,9,0,25,16
1745144728489,SIO 295S,A00,894020,Staff,9,0,25,16
1745144729518,SIOC 290S,A01,894063,Merrifield; Mark A,23,0,25,2
1745144730547,SIOC 291S,A01,894137,Gabriel; Corey John,23,0,25,2
1745144731575,SOCI 117,A01,895339,Staff,5,0,5,0
1745144732602,WES 237B,A00,894149,Staff,20,0,20,0
1745144734693,AESE 279B,A00,891859,Staff,35,0,35,0
1745144735722,AIP 197,001,891854,Staff,70,0,70,0
1745144736756,ANTH 289S,A00,891856,Gagneux; Pascal,12,0,12,0
1745144737783,BENG 196,001,957946,Engler; Adam J.,9996,0,9999,3
1745144738809,CAT 124RS,A01,956906,Staff,8,0,25,17
1745144739834,CAT 125RS,A01,922013,Staff,8,0,25,17
1745144740864,CLRE 250,A00,891860,Morris; Sheldon,9996,0,9999,3
1745144742924,CLRE 251R,A00,907817,Mehta; Ravindra L.,9995,0,9999,4
1745144743951,CLRE 252,A00,891864,Cuomo; Raphael Eduardo,9994,0,9999,5
1745144744977,CLRE 253,A00,891867,Vaida; Florin,9995,0,9999,4
1745144744977,CLRE 253,B00,907819,Staff,9999,0,9999,0
1745144746003,CLRE 259,A00,891868,Patel; Hemal,9998,0,9999,1
1745144747029,CLRE 260,A00,891872,Cuomo; Raphael Eduardo,9999,0,9999,0
1745144748058,CLRE 297,001,891888,Cuomo; Raphael Eduardo,9999,0,9999,0
1745144749089,CSS 201S,A01,892054,Mignozzetti; Umberto,30,0,30,0
1745144750119,CSS 202S,A01,892056,Mignozzetti; Umberto,30,0,30,0
1745144751186,DSC 197,001,956898,Eldridge; Justin Matthew,9998,0,9999,1
1745144752212,DSC 297,001,958000,Mazumdar; Arya,9999,0,9999,0
1745144753241,EAP 100,A00,905686,Staff,9774,0,9999,225
1745144754270,ECE 45,A01,892618,Staff,0,2,50,50
1745144755297,ECE 109,A01,892620,Staff,0,44,0,0
1745144756324,ECE 111,A01,892719,Staff,0,0,50,50
1745144757354,ECE 197,001,957920,Mercier; Patrick Philip,9992,0,9999,7
1745144758385,ECON 178,A01,907814,Zhu; Ying,29,0,35,6
1745144759412,EDS 115,A00,895312,Staff,42,0,45,3
1745144760438,EDS 117,A01,895337,Staff,30,0,30,0
1745144761464,EDS 125,A00,895341,Jones; Gabrielle Anastasia,43,0,45,2
1745144762491,EDS 128A,A01,895459,Fargason; Sharon Gayle,45,0,45,0
1745144763520,EDS 128B,A01,895543,Pappas; Elizabeth,45,0,45,0
1745144764546,EDS 139,A00,897203,Pappas; Elizabeth,45,0,45,0
1745144764546,EDS 139,B00,897209,Fargason; Sharon Gayle,45,0,45,0
1745144765572,EDS 201,A00,895545,Staff,44,0,45,1
1745144766601,EDS 203,A01,895581,Halter; Christopher P.,44,0,45,1
1745144767631,EDS 204R,A01,895625,Heinzman; Erica M.,45,0,45,0
1745144767631,EDS 204R,B01,895693,Halter; Christopher P.,28,0,45,17
1745144768658,EDS 206R,A00,895694,Fargason; Sharon Gayle,22,0,30,8
1745144768658,EDS 206R,B00,895695,Choi; Bailey Miyeon,21,0,30,9
1745144769685,EDS 250,A00,895697,Hemans; Patricia Ann Benitez,44,0,45,1
1745144770710,EDS 281,A00,895701,Meyerott; Theresa Ann,15,0,15,0
1745144771735,EDS 284,A00,895736,Meyerott; Theresa Ann,15,0,15,0
1745144772760,EDS 286,A00,897210,Fine; Sarah,15,0,15,0
1745144773791,EDS 289C,A01,895770,Daly; Alan J.,15,0,15,0
1745144774820,EDS 290,A00,897211,Hofstetter; Carolyn,15,0,15,0
1745144775847,LIGM 5A,A00,896162,Fischer-Grunski; Eva K,16,0,20,4
1745144776874,LIGM 5B,A00,896260,Fischer-Grunski; Eva K,19,0,20,1
1745144777900,LIGM 5C,A00,896308,Fischer-Grunski; Eva K,19,0,20,1
1745144778930,LIIT 5AS,A00,896313,Carnelos; Chiara,18,0,20,2
1745144779955,LIIT 5BS,A00,896416,Carnelos; Chiara,20,0,20,0
1745144780981,LIIT 5CS,A00,896564,Carnelos; Chiara,20,0,20,0
1745144782008,LISP 5A,A00,896588,Munoz Sanchez; Alicia,7,0,20,13
1745144783039,LISP 5B,A00,896653,Munoz Sanchez; Alicia,10,0,20,10
1745144784067,LISP 5C,A00,896655,Munoz Sanchez; Alicia,9,0,20,11
1745144785097,MAE 197,001,957918,Kleissl; Jan,9998,0,9999,1
1745144786124,MATH 2,A01,957937,Staff,34,0,35,1
1745144787149,MATH 197,001,957876,Kedlaya; Kiran S.,9996,0,9999,3
1745144788175,MCWP 40,A00,892729,Duru; Nur,15,0,20,5
1745144788175,MCWP 40,B00,893304,Montejo; Carolina,20,0,20,0
1745144789202,MCWP 40R,A00,893757,Redela; Pamela Morgan,0,3,20,20
1745144790232,MCWP 50,A00,893758,Morshed; Michael James,4,0,20,16
1745144790232,MCWP 50,B00,893761,Bartulis; Jason Michael,18,0,20,2
1745144791260,MCWP 50R,A00,893766,Compas; Sean Matthew,0,1,20,20
1745144791260,MCWP 50R,B00,893769,Carter; Jennifer A,5,0,20,15
1745144791260,MCWP 50R,C00,893771,Krone; Jarret,0,3,20,20
1745144791260,MCWP 50R,D00,893772,Miller; Elizabeth Deen,4,0,20,16
1745144791260,MCWP 50R,E00,893775,Carter; Andrea L,0,0,20,20
1745144792287,MMW 11R,A01,892721,Herbst; Matthew,22,0,30,8
1745144792287,MMW 11R,A02,892722,Herbst; Matthew,28,0,30,2
1745144793313,MMW 12R,A01,892724,Herbst; Matthew,0,5,16,16
1745144793313,MMW 12R,A02,892725,Herbst; Matthew,0,4,16,16
1745144794339,MMW 13R,A01,892727,Staff,0,29,16,16
1745144794339,MMW 13R,A02,892728,Staff,0,28,16,16
1745144795367,SIO 295LS,A00,894015,Staff,9,0,25,16
1745144796398,SIO 295S,A00,894020,Staff,9,0,25,16
1745144797426,SIOC 290S,A01,894063,Merrifield; Mark A,23,0,25,2
1745144798452,SIOC 291S,A01,894137,Gabriel; Corey John,23,0,25,2
1745144799477,SOCI 117,A01,895339,Staff,5,0,5,0
1745144800506,WES 237B,A00,894149,Staff,20,0,20,0
1745144802569,AESE 279B,A00,891859,Staff,35,0,35,0
1745144803596,AIP 197,001,891854,Staff,70,0,70,0
1745144804624,ANTH 289S,A00,891856,Gagneux; Pascal,12,0,12,0
1745144805651,BENG 196,001,957946,Engler; Adam J.,9996,0,9999,3
1745144806678,CAT 124RS,A01,956906,Staff,8,0,25,17
1745144807707,CAT 125RS,A01,922013,Staff,8,0,25,17
1745144808736,CLRE 250,A00,891860,Morris; Sheldon,9996,0,9999,3
1745144810791,CLRE 251R,A00,907817,Mehta; Ravindra L.,9995,0,9999,4
1745144811821,CLRE 252,A00,891864,Cuomo; Raphael Eduardo,9994,0,9999,5
1745144812847,CLRE 253,A00,891867,Vaida; Florin,9995,0,9999,4
1745144812847,CLRE 253,B00,907819,Staff,9999,0,9999,0
1745144813873,CLRE 259,A00,891868,Patel; Hemal,9998,0,9999,1
1745144814898,CLRE 260,A00,891872,Cuomo; Raphael Eduardo,9999,0,9999,0
1745144815928,CLRE 297,001,891888,Cuomo; Raphael Eduardo,9999,0,9999,0
1745144816958,CSS 201S,A01,892054,Mignozzetti; Umberto,30,0,30,0
1745144817986,CSS 202S,A01,892056,Mignozzetti; Umberto,30,0,30,0
1745144819011,DSC 197,001,956898,Eldridge; Justin Matthew,9998,0,9999,1
1745144820037,DSC 297,001,958000,Mazumdar; Arya,9999,0,9999,0
1745144821063,EAP 100,A00,905686,Staff,9774,0,9999,225
1745144822090,ECE 45,A01,892618,Staff,0,2,50,50
1745144823118,ECE 109,A01,892620,Staff,0,44,0,0
1745144824148,ECE 111,A01,892719,Staff,0,0,50,50
1745144825178,ECE 197,001,957920,Mercier; Patrick Philip,9992,0,9999,7
1745144826204,ECON 178,A01,907814,Zhu; Ying,29,0,35,6
1745144827229,EDS 115,A00,895312,Staff,42,0,45,3
1745144828256,EDS 117,A01,895337,Staff,30,0,30,0
1745144829287,EDS 125,A00,895341,Jones; Gabrielle Anastasia,43,0,45,2
1745144830318,EDS 128A,A01,895459,Fargason; Sharon Gayle,45,0,45,0
1745144831346,EDS 128B,A01,895543,Pappas; Elizabeth,45,0,45,0
1745144832379,EDS 139,A00,897203,Pappas; Elizabeth,45,0,45,0
1745144832379,EDS 139,B00,897209,Fargason; Sharon Gayle,45,0,45,0
1745144833406,EDS 201,A00,895545,Staff,44,0,45,1
1745144834433,EDS 203,A01,895581,Halter; Christopher P.,44,0,45,1
1745144835460,EDS 204R,A01,895625,Heinzman; Erica M.,45,0,45,0
1745144835460,EDS 204R,B01,895693,Halter; Christopher P.,28,0,45,17
1745144836491,EDS 206R,A00,895694,Fargason; Sharon Gayle,22,0,30,8
1745144836491,EDS 206R,B00,895695,Choi; Bailey Miyeon,21,0,30,9
1745144837519,EDS 250,A00,895697,Hemans; Patricia Ann Benitez,44,0,45,1
1745144838545,EDS 281,A00,895701,Meyerott; Theresa Ann,15,0,15,0
1745144839574,EDS 284,A00,895736,Meyerott; Theresa Ann,15,0,15,0
1745144840599,EDS 286,A00,897210,Fine; Sarah,15,0,15,0
1745144841625,EDS 289C,A01,895770,Daly; Alan J.,15,0,15,0
1745144842651,EDS 290,A00,897211,Hofstetter; Carolyn,15,0,15,0
1745144843679,LIGM 5A,A00,896162,Fischer-Grunski; Eva K,16,0,20,4
1745144844709,LIGM 5B,A00,896260,Fischer-Grunski; Eva K,19,0,20,1
1745144845735,LIGM 5C,A00,896308,Fischer-Grunski; Eva K,19,0,20,1
1745144846762,LIIT 5AS,A00,896313,Carnelos; Chiara,18,0,20,2
1745144847789,LIIT 5BS,A00,896416,Carnelos; Chiara,20,0,20,0
1745144848814,LIIT 5CS,A00,896564,Carnelos; Chiara,20,0,20,0
1745144849840,LISP 5A,A00,896588,Munoz Sanchez; Alicia,7,0,20,13
1745144850870,LISP 5B,A00,896653,Munoz Sanchez; Alicia,10,0,20,10
1745144851899,LISP 5C,A00,896655,Munoz Sanchez; Alicia,9,0,20,11
1745144852926,MAE 197,001,957918,Kleissl; Jan,9998,0,9999,1
1745144853951,MATH 2,A01,957937,Staff,34,0,35,1
1745144855017,MATH 197,001,957876,Kedlaya; Kiran S.,9996,0,9999,3
1745144856043,MCWP 40,A00,892729,Duru; Nur,15,0,20,5
1745144856043,MCWP 40,B00,893304,Montejo; Carolina,20,0,20,0
1745144857069,MCWP 40R,A00,893757,Redela; Pamela Morgan,0,3,20,20
1745144858096,MCWP 50,A00,893758,Morshed; Michael James,4,0,20,16
1745144858096,MCWP 50,B00,893761,Bartulis; Jason Michael,18,0,20,2
1745144859122,MCWP 50R,A00,893766,Compas; Sean Matthew,0,1,20,20
1745144859122,MCWP 50R,B00,893769,Carter; Jennifer A,5,0,20,15
1745144859122,MCWP 50R,C00,893771,Krone; Jarret,0,3,20,20
1745144859122,MCWP 50R,D00,893772,Miller; Elizabeth Deen,4,0,20,16
1745144859122,MCWP 50R,E00,893775,Carter; Andrea L,0,0,20,20
1745144860148,MMW 11R,A01,892721,Herbst; Matthew,22,0,30,8
1745144860148,MMW 11R,A02,892722,Herbst; Matthew,28,0,30,2
1745144861173,MMW 12R,A01,892724,Herbst; Matthew,0,5,16,16
1745144861173,MMW 12R,A02,892725,Herbst; Matthew,0,4,16,16
1745144862201,MMW 13R,A01,892727,Staff,0,29,16,16
1745144862201,MMW 13R,A02,892728,Staff,0,28,16,16
1745144863225,SIO 295LS,A00,894015,Staff,9,0,25,16
1745144864251,SIO 295S,A00,894020,Staff,9,0,25,16
1745144865282,SIOC 290S,A01,894063,Merrifield; Mark A,23,0,25,2
1745144866312,SIOC 291S,A01,894137,Gabriel; Corey John,23,0,25,2
1745144867339,SOCI 117,A01,895339,Staff,5,0,5,0
1745144868366,WES 237B,A00,894149,Staff,20,0,20,0
1745144870434,AESE 279B,A00,891859,Staff,35,0,35,0
1745144871460,AIP 197,001,891854,Staff,70,0,70,0
1745144872489,ANTH 289S,A00,891856,Gagneux; Pascal,12,0,12,0
1745144873520,BENG 196,001,957946,Engler; Adam J.,9996,0,9999,3
1745144874547,CAT 124RS,A01,956906,Staff,8,0,25,17
1745144875574,CAT 125RS,A01,922013,Staff,8,0,25,17
1745144876599,CLRE 250,A00,891860,Morris; Sheldon,9996,0,9999,3
1745144878655,CLRE 251R,A00,907817,Mehta; Ravindra L.,9995,0,9999,4
1745144879681,CLRE 252,A00,891864,Cuomo; Raphael Eduardo,9994,0,9999,5
1745144880707,CLRE 253,A00,891867,Vaida; Florin,9995,0,9999,4
1745144880707,CLRE 253,B00,907819,Staff,9999,0,9999,0
1745144881737,CLRE 259,A00,891868,Patel; Hemal,9998,0,9999,1
1745144882816,CLRE 260,A00,891872,Cuomo; Raphael Eduardo,9999,0,9999,0
1745144883845,CLRE 297,001,891888,Cuomo; Raphael Eduardo,9999,0,9999,0
1745144884874,CSS 201S,A01,892054,Mignozzetti; Umberto,30,0,30,0
1745144885906,CSS 202S,A01,892056,Mignozzetti; Umberto,30,0,30,0
1745144886934,DSC 197,001,956898,Eldridge; Justin Matthew,9998,0,9999,1
1745144887963,DSC 297,001,958000,Mazumdar; Arya,9999,0,9999,0
1745144888992,EAP 100,A00,905686,Staff,9774,0,9999,225
1745144890024,ECE 45,A01,892618,Staff,0,2,50,50
1745144891051,ECE 109,A01,892620,Staff,0,44,0,0
1745144892081,ECE 111,A01,892719,Staff,0,0,50,50
1745144893108,ECE 197,001,957920,Mercier; Patrick Philip,9992,0,9999,7
1745144894135,ECON 178,A01,907814,Zhu; Ying,29,0,35,6
1745144895165,EDS 115,A00,895312,Staff,42,0,45,3
1745144896194,EDS 117,A01,895337,Staff,30,0,30,0
1745144897220,EDS 125,A00,895341,Jones; Gabrielle Anastasia,43,0,45,2
1745144898246,EDS 128A,A01,895459,Fargason; Sharon Gayle,45,0,45,0
1745144899273,EDS 128B,A01,895543,Pappas; Elizabeth,45,0,45,0
1745144900301,EDS 139,A00,897203,Pappas; Elizabeth,45,0,45,0
1745144900301,EDS 139,B00,897209,Fargason; Sharon Gayle,45,0,45,0
1745144901330,EDS 201,A00,895545,Staff,44,0,45,1
1745144902356,EDS 203,A01,895581,Halter; Christopher P.,44,0,45,1
1745144903383,EDS 204R,A01,895625,Heinzman; Erica M.,45,0,45,0
1745144903383,EDS 204R,B01,895693,Halter; Christopher P.,28,0,45,17
1745144904408,EDS 206R,A00,895694,Fargason; Sharon Gayle,22,0,30,8
1745144904408,EDS 206R,B00,895695,Choi; Bailey Miyeon,21,0,30,9
1745144905434,EDS 250,A00,895697,Hemans; Patricia Ann Benitez,44,0,45,1
1745144906459,EDS 281,A00,895701,Meyerott; Theresa Ann,15,0,15,0
1745144907489,EDS 284,A00,895736,Meyerott; Theresa Ann,15,0,15,0
1745144908519,EDS 286,A00,897210,Fine; Sarah,15,0,15,0
1745144909546,EDS 289C,A01,895770,Daly; Alan J.,15,0,15,0
1745144910575,EDS 290,A00,897211,Hofstetter; Carolyn,15,0,15,0
1745144911604,LIGM 5A,A00,896162,Fischer-Grunski; Eva K,16,0,20,4
1745144912631,LIGM 5B,A00,896260,Fischer-Grunski; Eva K,19,0,20,1
1745144913656,LIGM 5C,A00,896308,Fischer-Grunski; Eva K,19,0,20,1
1745144914683,LIIT 5AS,A00,896313,Carnelos; Chiara,18,0,20,2
1745144915709,LIIT 5BS,A00,896416,Carnelos; Chiara,20,0,20,0
1745144916738,LIIT 5CS,A00,896564,Carnelos; Chiara,20,0,20,0
1745144917768,LISP 5A,A00,896588,Munoz Sanchez; Alicia,7,0,20,13
1745144918794,LISP 5B,A00,896653,Munoz Sanchez; Alicia,10,0,20,10
1745144919823,LISP 5C,A00,896655,Munoz Sanchez; Alicia,9,0,20,11
1745144920849,MAE 197,001,957918,Kleissl; Jan,9998,0,9999,1
1745144921876,MATH 2,A01,957937,Staff,34,0,35,1
1745144922902,MATH 197,001,957876,Kedlaya; Kiran S.,9996,0,9999,3
1745144923934,MCWP 40,A00,892729,Duru; Nur,15,0,20,5
1745144923934,MCWP 40,B00,893304,Montejo; Carolina,20,0,20,0
1745144924960,MCWP 40R,A00,893757,Redela; Pamela Morgan,0,3,20,20
1745144925987,MCWP 50,A00,893758,Morshed; Michael James,4,0,20,16
1745144925987,MCWP 50,B00,893761,Bartulis; Jason Michael,18,0,20,2
1745144927022,MCWP 50R,A00,893766,Compas; Sean Matthew,0,1,20,20
1745144927022,MCWP 50R,B00,893769,Carter; Jennifer A,5,0,20,15
1745144927022,MCWP 50R,C00,893771,Krone; Jarret,0,3,20,20
1745144927022,MCWP 50R,D00,893772,Miller; Elizabeth Deen,4,0,20,16
1745144927022,MCWP 50R,E00,893775,Carter; Andrea L,0,0,20,20
1745144928047,MMW 11R,A01,892721,Herbst; Matthew,22,0,30,8
1745144928047,MMW 11R,A02,892722,Herbst; Matthew,28,0,30,2
1745144929075,MMW 12R,A01,892724,Herbst; Matthew,0,5,16,16
1745144929075,MMW 12R,A02,892725,Herbst; Matthew,0,4,16,16
1745144930101,MMW 13R,A01,892727,Staff,0,29,16,16
1745144930101,MMW 13R,A02,892728,Staff,0,28,16,16
1745144931127,SIO 295LS,A00,894015,Staff,9,0,25,16
1745144932152,SIO 295S,A00,894020,Staff,9,0,25,16
1745144933177,SIOC 290S,A01,894063,Merrifield; Mark A,23,0,25,2
1745144934205,SIOC 291S,A01,894137,Gabriel; Corey John,23,0,25,2
1745144935233,SOCI 117,A01,895339,Staff,5,0,5,0
1745144936259,WES 237B,A00,894149,Staff,20,0,20,0
1745144938327,AESE 279B,A00,891859,Staff,35,0,35,0
1745144939355,AIP 197,001,891854,Staff,70,0,70,0
1745144940382,ANTH 289S,A00,891856,Gagneux; Pascal,12,0,12,0
1745144941410,BENG 196,001,957946,Engler; Adam J.,9996,0,9999,3
1745144942436,CAT 124RS,A01,956906,Staff,8,0,25,17
1745144943466,CAT 125RS,A01,922013,Staff,8,0,25,17
1745144944491,CLRE 250,A00,891860,Morris; Sheldon,9996,0,9999,3
1745144946547,CLRE 251R,A00,907817,Mehta; Ravindra L.,9995,0,9999,4
1745144947577,CLRE 252,A00,891864,Cuomo; Raphael Eduardo,9994,0,9999,5
1745144948603,CLRE 253,A00,891867,Vaida; Florin,9995,0,9999,4
1745144948603,CLRE 253,B00,907819,Staff,9999,0,9999,0
1745144949629,CLRE 259,A00,891868,Patel; Hemal,9998,0,9999,1
1745144950654,CLRE 260,A00,891872,Cuomo; Raphael Eduardo,9999,0,9999,0
1745144951680,CLRE 297,001,891888,Cuomo; Raphael Eduardo,9999,0,9999,0
1745144952707,CSS 201S,A01,892054,Mignozzetti; Umberto,30,0,30,0
1745144953734,CSS 202S,A01,892056,Mignozzetti; Umberto,30,0,30,0
1745144954763,DSC 197,001,956898,Eldridge; Justin Matthew,9998,0,9999,1
1745144955795,DSC 297,001,958000,Mazumdar; Arya,9999,0,9999,0
1745144956820,EAP 100,A00,905686,Staff,9774,0,9999,225
1745144957850,ECE 45,A01,892618,Staff,0,2,50,50
1745144958902,ECE 109,A01,892620,Staff,0,44,0,0
1745144959929,ECE 111,A01,892719,Staff,0,0,50,50
1745144960955,ECE 197,001,957920,Mercier; Patrick Philip,9992,0,9999,7
1745144961985,ECON 178,A01,907814,Zhu; Ying,29,0,35,6
1745144963012,EDS 115,A00,895312,Staff,42,0,45,3
1745144964039,EDS 117,A01,895337,Staff,30,0,30,0
1745144965066,EDS 125,A00,895341,Jones; Gabrielle Anastasia,43,0,45,2
1745144966093,EDS 128A,A01,895459,Fargason; Sharon Gayle,45,0,45,0
1745144967123,EDS 128B,A01,895543,Pappas; Elizabeth,45,0,45,0
1745144968152,EDS 139,A00,897203,Pappas; Elizabeth,45,0,45,0
1745144968152,EDS 139,B00,897209,Fargason; Sharon Gayle,45,0,45,0
1745144969177,EDS 201,A00,895545,Staff,44,0,45,1
1745144970205,EDS 203,A01,895581,Halter; Christopher P.,44,0,45,1
1745144971232,EDS 204R,A01,895625,Heinzman; Erica M.,45,0,45,0
1745144971232,EDS 204R,B01,895693,Halter; Christopher P.,28,0,45,17
1745144972261,EDS 206R,A00,895694,Fargason; Sharon Gayle,22,0,30,8
1745144972261,EDS 206R,B00,895695,Choi; Bailey Miyeon,21,0,30,9
1745144973292,EDS 250,A00,895697,Hemans; Patricia Ann Benitez,44,0,45,1
1745144974323,EDS 281,A00,895701,Meyerott; Theresa Ann,15,0,15,0
1745144975351,EDS 284,A00,895736,Meyerott; Theresa Ann,15,0,15,0
1745144976378,EDS 286,A00,897210,Fine; Sarah,15,0,15,0
1745144977406,EDS 289C,A01,895770,Daly; Alan J.,15,0,15,0
1745144978436,EDS 290,A00,897211,Hofstetter; Carolyn,15,0,15,0
1745144979463,LIGM 5A,A00,896162,Fischer-Grunski; Eva K,16,0,20,4
1745144980489,LIGM 5B,A00,896260,Fischer-Grunski; Eva K,19,0,20,1
1745144981519,LIGM 5C,A00,896308,Fischer-Grunski; Eva K,19,0,20,1
1745144982550,LIIT 5AS,A00,896313,Carnelos; Chiara,18,0,20,2
1745144983576,LIIT 5BS,A00,896416,Carnelos; Chiara,20,0,20,0
1745144984604,LIIT 5CS,A00,896564,Carnelos; Chiara,20,0,20,0
1745144985632,LISP 5A,A00,896588,Munoz Sanchez; Alicia,7,0,20,13
1745144986659,LISP 5B,A00,896653,Munoz Sanchez; Alicia,10,0,20,10
1745144987689,LISP 5C,A00,896655,Munoz Sanchez; Alicia,9,0,20,11
1745144988719,MAE 197,001,957918,Kleissl; Jan,9998,0,9999,1
1745144989747,MATH 2,A01,957937,Staff,34,0,35,1
1745144990772,MATH 197,001,957876,Kedlaya; Kiran S.,9996,0,9999,3
1745144991800,MCWP 40,A00,892729,Duru; Nur,15,0,20,5
1745144991800,MCWP 40,B00,893304,Montejo; Carolina,20,0,20,0
1745144992826,MCWP 40R,A00,893757,Redela; Pamela Morgan,0,3,20,20
1745144993853,MCWP 50,A00,893758,Morshed; Michael James,4,0,20,16
1745144993853,MCWP 50,B00,893761,Bartulis; Jason Michael,18,0,20,2
1745144994885,MCWP 50R,A00,893766,Compas; Sean Matthew,0,1,20,20
1745144994885,MCWP 50R,B00,893769,Carter; Jennifer A,5,0,20,15
1745144994885,MCWP 50R,C00,893771,Krone; Jarret,0,3,20,20
1745144994885,MCWP 50R,D00,893772,Miller; Elizabeth Deen,4,0,20,16
1745144994885,MCWP 50R,E00,893775,Carter; Andrea L,0,0,20,20
1745144995917,MMW 11R,A01,892721,Herbst; Matthew,22,0,30,8
1745144995917,MMW 11R,A02,892722,Herbst; Matthew,28,0,30,2
1745144996944,MMW 12R,A01,892724,Herbst; Matthew,0,5,16,16
1745144996944,MMW 12R,A02,892725,Herbst; Matthew,0,4,16,16
1745144997970,MMW 13R,A01,892727,Staff,0,29,16,16
1745144997970,MMW 13R,A02,892728,Staff,0,28,16,16
1745144998998,SIO 295LS,A00,894015,Staff,9,0,25,16
1745145000024,SIO 295S,A00,894020,Staff,9,0,25,16
1745145001052,SIOC 290S,A01,894063,Merrifield; Mark A,23,0,25,2
1745145002078,SIOC 291S,A01,894137,Gabriel; Corey John,23,0,25,2
1745145003105,SOCI 117,A01,895339,Staff,5,0,5,0
1745145004135,WES 237B,A00,894149,Staff,20,0,20,0
1745145006202,AESE 279B,A00,891859,Staff,35,0,35,0
1745145007227,AIP 197,001,891854,Staff,70,0,70,0
1745145008253,ANTH 289S,A00,891856,Gagneux; Pascal,12,0,12,0
1745145009282,BENG 196,001,957946,Engler; Adam J.,9996,0,9999,3
1745145010308,CAT 124RS,A01,956906,Staff,8,0,25,17
1745145011335,CAT 125RS,A01,922013,Staff,8,0,25,17
1745145012362,CLRE 250,A00,891860,Morris; Sheldon,9996,0,9999,3
1745145014417,CLRE 251R,A00,907817,Mehta; Ravindra L.,9995,0,9999,4
1745145015445,CLRE 252,A00,891864,Cuomo; Raphael Eduardo,9994,0,9999,5
1745145016473,CLRE 253,A00,891867,Vaida; Florin,9995,0,9999,4
1745145016473,CLRE 253,B00,907819,Staff,9999,0,9999,0
1745145017499,CLRE 259,A00,891868,Patel; Hemal,9998,0,9999,1
1745145018529,CLRE 260,A00,891872,Cuomo; Raphael Eduardo,9999,0,9999,0
1745145019556,CLRE 297,001,891888,Cuomo; Raphael Eduardo,9999,0,9999,0
1745145020583,CSS 201S,A01,892054,Mignozzetti; Umberto,30,0,30,0
1745145021609,CSS 202S,A01,892056,Mignozzetti; Umberto,30,0,30,0
1745145022639,DSC 197,001,956898,Eldridge; Justin Matthew,9998,0,9999,1
1745145023662,DSC 297,001,958000,Mazumdar; Arya,9999,0,9999,0
1745145024689,EAP 100,A00,905686,Staff,9774,0,9999,225
1745145025718,ECE 45,A01,892618,Staff,0,2,50,50
1745145026747,ECE 109,A01,892620,Staff,0,44,0,0
1745145027772,ECE 111,A01,892719,Staff,0,0,50,50
1745145028801,ECE 197,001,957920,Mercier; Patrick Philip,9992,0,9999,7
1745145029827,ECON 178,A01,907814,Zhu; Ying,29,0,35,6
1745145030853,EDS 115,A00,895312,Staff,42,0,45,3
1745145031881,EDS 117,A01,895337,Staff,30,0,30,0
1745145032907,EDS 125,A00,895341,Jones; Gabrielle Anastasia,43,0,45,2
1745145033932,EDS 128A,A01,895459,Fargason; Sharon Gayle,45,0,45,0
1745145034962,EDS 128B,A01,895543,Pappas; Elizabeth,45,0,45,0
1745145035989,EDS 139,A00,897203,Pappas; Elizabeth,45,0,45,0
1745145035989,EDS 139,B00,897209,Fargason; Sharon Gayle,45,0,45,0
1745145037015,EDS 201,A00,895545,Staff,44,0,45,1
1745145038042,EDS 203,A01,895581,Halter; Christopher P.,44,0,45,1
1745145039070,EDS 204R,A01,895625,Heinzman; Erica M.,45,0,45,0
1745145039070,EDS 204R,B01,895693,Halter; Christopher P.,28,0,45,17
1745145040096,EDS 206R,A00,895694,Fargason; Sharon Gayle,22,0,30,8
1745145040096,EDS 206R,B00,895695,Choi; Bailey Miyeon,21,0,30,9
1745145041125,EDS 250,A00,895697,Hemans; Patricia Ann Benitez,44,0,45,1
1745145042150,EDS 281,A00,895701,Meyerott; Theresa Ann,15,0,15,0
1745145043178,EDS 284,A00,895736,Meyerott; Theresa Ann,15,0,15,0
1745145044205,EDS 286,A00,897210,Fine; Sarah,15,0,15,0
1745145045231,EDS 289C,A01,895770,Daly; Alan J.,15,0,15,0
1745145046258,EDS 290,A00,897211,Hofstetter; Carolyn,15,0,15,0
1745145047282,LIGM 5A,A00,896162,Fischer-Grunski; Eva K,16,0,20,4
1745145048313,LIGM 5B,A00,896260,Fischer-Grunski; Eva K,19,0,20,1
1745145049339,LIGM 5C,A00,896308,Fischer-Grunski; Eva K,19,0,20,1
1745145050367,LIIT 5AS,A00,896313,Carnelos; Chiara,18,0,20,2
1745145051396,LIIT 5BS,A00,896416,Carnelos; Chiara,20,0,20,0
1745145052425,LIIT 5CS,A00,896564,Carnelos; Chiara,20,0,20,0
1745145053451,LISP 5A,A00,896588,Munoz Sanchez; Alicia,7,0,20,13
1745145054478,LISP 5B,A00,896653,Munoz Sanchez; Alicia,10,0,20,10
1745145055508,LISP 5C,A00,896655,Munoz Sanchez; Alicia,9,0,20,11
1745145056535,MAE 197,001,957918,Kleissl; Jan,9998,0,9999,1
1745145057560,MATH 2,A01,957937,Staff,34,0,35,1
1745145058591,MATH 197,001,957876,Kedlaya; Kiran S.,9996,0,9999,3
1745145059618,MCWP 40,A00,892729,Duru; Nur,15,0,20,5
1745145059618,MCWP 40,B00,893304,Montejo; Carolina,20,0,20,0
1745145060653,MCWP 40R,A00,893757,Redela; Pamela Morgan,0,3,20,20
1745145061680,MCWP 50,A00,893758,Morshed; Michael James,4,0,20,16
1745145061680,MCWP 50,B00,893761,Bartulis; Jason Michael,18,0,20,2
1745145062708,MCWP 50R,A00,893766,Compas; Sean Matthew,0,1,20,20
1745145062708,MCWP 50R,B00,893769,Carter; Jennifer A,5,0,20,15
1745145062708,MCWP 50R,C00,893771,Krone; Jarret,0,3,20,20
1745145062708,MCWP 50R,D00,893772,Miller; Elizabeth Deen,4,0,20,16
1745145062708,MCWP 50R,E00,893775,Carter; Andrea L,0,0,20,20
1745145063735,MMW 11R,A01,892721,Herbst; Matthew,22,0,30,8
1745145063735,MMW 11R,A02,892722,Herbst; Matthew,28,0,30,2
1745145064764,MMW 12R,A01,892724,Herbst; Matthew,0,5,16,16
1745145064764,MMW 12R,A02,892725,Herbst; Matthew,0,4,16,16
1745145065790,MMW 13R,A01,892727,Staff,0,29,16,16
1745145065790,MMW 13R,A02,892728,Staff,0,28,16,16
1745145066817,SIO 295LS,A00,894015,Staff,9,0,25,16
1745145067847,SIO 295S,A00,894020,Staff,9,0,25,16
1745145068874,SIOC 290S,A01,894063,Merrifield; Mark A,23,0,25,2
1745145069907,SIOC 291S,A01,894137,Gabriel; Corey John,23,0,25,2
1745145070936,SOCI 117,A01,895339,Staff,5,0,5,0
1745145071961,WES 237B,A00,894149,Staff,20,0,20,0
1745145074028,AESE 279B,A00,891859,Staff,35,0,35,0
1745145075053,AIP 197,001,891854,Staff,70,0,70,0
1745145076080,ANTH 289S,A00,891856,Gagneux; Pascal,12,0,12,0
1745145077106,BENG 196,001,957946,Engler; Adam J.,9996,0,9999,3
1745145078132,CAT 124RS,A01,956906,Staff,8,0,25,17
1745145079157,CAT 125RS,A01,922013,Staff,8,0,25,17
1745145080187,CLRE 250,A00,891860,Morris; Sheldon,9996,0,9999,3
1745145082246,CLRE 251R,A00,907817,Mehta; Ravindra L.,9995,0,9999,4
1745145083270,CLRE 252,A00,891864,Cuomo; Raphael Eduardo,9994,0,9999,5
1745145084301,CLRE 253,A00,891867,Vaida; Florin,9995,0,9999,4
1745145084301,CLRE 253,B00,907819,Staff,9999,0,9999,0
1745145085329,CLRE 259,A00,891868,Patel; Hemal,9998,0,9999,1
1745145086353,CLRE 260,A00,891872,Cuomo; Raphael Eduardo,9999,0,9999,0
1745145087381,CLRE 297,001,891888,Cuomo; Raphael Eduardo,9999,0,9999,0
1745145088407,CSS 201S,A01,892054,Mignozzetti; Umberto,30,0,30,0
1745145089438,CSS 202S,A01,892056,Mignozzetti; Umberto,30,0,30,0
1745145090466,DSC 197,001,956898,Eldridge; Justin Matthew,9998,0,9999,1
1745145091495,DSC 297,001,958000,Mazumdar; Arya,9999,0,9999,0
1745145092523,EAP 100,A00,905686,Staff,9774,0,9999,225
1745145093554,ECE 45,A01,892618,Staff,0,2,50,50
1745145094579,ECE 109,A01,892620,Staff,0,44,0,0
1745145095608,ECE 111,A01,892719,Staff,0,0,50,50
1745145096635,ECE 197,001,957920,Mercier; Patrick Philip,9992,0,9999,7
1745145097661,ECON 178,A01,907814,Zhu; Ying,29,0,35,6
1745145098688,EDS 115,A00,895312,Staff,42,0,45,3
1745145099715,EDS 117,A01,895337,Staff,30,0,30,0
1745145100746,EDS 125,A00,895341,Jones; Gabrielle Anastasia,43,0,45,2
1745145101771,EDS 128A,A01,895459,Fargason; Sharon Gayle,45,0,45,0
1745145102802,EDS 128B,A01,895543,Pappas; Elizabeth,45,0,45,0
1745145103828,EDS 139,A00,897203,Pappas; Elizabeth,45,0,45,0
1745145103828,EDS 139,B00,897209,Fargason; Sharon Gayle,45,0,45,0
1745145104853,EDS 201,A00,895545,Staff,44,0,45,1
1745145105879,EDS 203,A01,895581,Halter; Christopher P.,44,0,45,1
1745145106907,EDS 204R,A01,895625,Heinzman; Erica M.,45,0,45,0
1745145106907,EDS 204R,B01,895693,Halter; Christopher P.,28,0,45,17
1745145107933,EDS 206R,A00,895694,Fargason; Sharon Gayle,22,0,30,8
1745145107933,EDS 206R,B00,895695,Choi; Bailey Miyeon,21,0,30,9
1745145108959,EDS 250,A00,895697,Hemans; Patricia Ann Benitez,44,0,45,1
1745145109984,EDS 281,A00,895701,Meyerott; Theresa Ann,15,0,15,0
1745145111011,EDS 284,A00,895736,Meyerott; Theresa Ann,15,0,15,0
1745145112038,EDS 286,A00,897210,Fine; Sarah,15,0,15,0
1745145113064,EDS 289C,A01,895770,Daly; Alan J.,15,0,15,0
1745145114090,EDS 290,A00,897211,Hofstetter; Carolyn,15,0,15,0
1745145115116,LIGM 5A,A00,896162,Fischer-Grunski; Eva K,16,0,20,4
1745145116146,LIGM 5B,A00,896260,Fischer-Grunski; Eva K,19,0,20,1
1745145117173,LIGM 5C,A00,896308,Fischer-Grunski; Eva K,19,0,20,1
1745145118205,LIIT 5AS,A00,896313,Carnelos; Chiara,18,0,20,2
1745145119231,LIIT 5BS,A00,896416,Carnelos; Chiara,20,0,20,0
1745145120258,LIIT 5CS,A00,896564,Carnelos; Chiara,20,0,20,0
1745145121285,LISP 5A,A00,896588,Munoz Sanchez; Alicia,7,0,20,13
1745145122315,LISP 5B,A00,896653,Munoz Sanchez; Alicia,10,0,20,10
1745145123344,LISP 5C,A00,896655,Munoz Sanchez; Alicia,9,0,20,11
1745145124370,MAE 197,001,957918,Kleissl; Jan,9998,0,9999,1
1745145125399,MATH 2,A01,957937,Staff,34,0,35,1
1745145126431,MATH 197,001,957876,Kedlaya; Kiran S.,9996,0,9999,3
1745145127462,MCWP 40,A00,892729,Duru; Nur,15,0,20,5
1745145127462,MCWP 40,B00,893304,Montejo; Carolina,20,0,20,0
1745145128488,MCWP 40R,A00,893757,Redela; Pamela Morgan,0,3,20,20
1745145129518,MCWP 50,A00,893758,Morshed; Michael James,4,0,20,16
1745145129518,MCWP 50,B00,893761,Bartulis; Jason Michael,18,0,20,2
1745145130549,MCWP 50R,A00,893766,Compas; Sean Matthew,0,1,20,20
1745145130549,MCWP 50R,B00,893769,Carter; Jennifer A,5,0,20,15
1745145130549,MCWP 50R,C00,893771,Krone; Jarret,0,3,20,20
1745145130549,MCWP 50R,D00,893772,Miller; Elizabeth Deen,4,0,20,16
1745145130549,MCWP 50R,E00,893775,Carter; Andrea L,0,0,20,20
1745145131578,MMW 11R,A01,892721,Herbst; Matthew,22,0,30,8
1745145131578,MMW 11R,A02,892722,Herbst; Matthew,28,0,30,2
1745145132650,MMW 12R,A01,892724,Herbst; Matthew,0,5,16,16
1745145132650,MMW 12R,A02,892725,Herbst; Matthew,0,4,16,16
1745145133676,MMW 13R,A01,892727,Staff,0,29,16,16
1745145133676,MMW 13R,A02,892728,Staff,0,28,16,16
1745145134702,SIO 295LS,A00,894015,Staff,9,0,25,16
1745145135730,SIO 295S,A00,894020,Staff,9,0,25,16
1745145136758,SIOC 290S,A01,894063,Merrifield; Mark A,23,0,25,2
1745145137783,SIOC 291S,A01,894137,Gabriel; Corey John,23,0,25,2
1745145138811,SOCI 117,A01,895339,Staff,5,0,5,0
1745145139838,WES 237B,A00,894149,Staff,20,0,20,0
1745145141917,AESE 279B,A00,891859,Staff,35,0,35,0
1745145142943,AIP 197,001,891854,Staff,70,0,70,0
1745145143969,ANTH 289S,A00,891856,Gagneux; Pascal,12,0,12,0
1745145145000,BENG 196,001,957946,Engler; Adam J.,9996,0,9999,3
1745145146026,CAT 124RS,A01,956906,Staff,8,0,25,17
1745145147054,CAT 125RS,A01,922013,Staff,8,0,25,17
1745145148078,CLRE 250,A00,891860,Morris; Sheldon,9996,0,9999,3
1745145150138,CLRE 251R,A00,907817,Mehta; Ravindra L.,9995,0,9999,4
1745145151166,CLRE 252,A00,891864,Cuomo; Raphael Eduardo,9994,0,9999,5
1745145152194,CLRE 253,A00,891867,Vaida; Florin,9995,0,9999,4
1745145152194,CLRE 253,B00,907819,Staff,9999,0,9999,0
1745145153223,CLRE 259,A00,891868,Patel; Hemal,9998,0,9999,1
1745145154251,CLRE 260,A00,891872,Cuomo; Raphael Eduardo,9999,0,9999,0
1745145155278,CLRE 297,001,891888,Cuomo; Raphael Eduardo,9999,0,9999,0
1745145156308,CSS 201S,A01,892054,Mignozzetti; Umberto,30,0,30,0
1745145157340,CSS 202S,A01,892056,Mignozzetti; Umberto,30,0,30,0
1745145158366,DSC 197,001,956898,Eldridge; Justin Matthew,9998,0,9999,1
1745145159391,DSC 297,001,958000,Mazumdar; Arya,9999,0,9999,0
1745145160420,EAP 100,A00,905686,Staff,9774,0,9999,225
1745145161450,ECE 45,A01,892618,Staff,0,2,50,50
1745145162480,ECE 109,A01,892620,Staff,0,44,0,0
1745145163506,ECE 111,A01,892719,Staff,0,0,50,50
1745145164536,ECE 197,001,957920,Mercier; Patrick Philip,9992,0,9999,7
1745145165563,ECON 178,A01,907814,Zhu; Ying,29,0,35,6
1745145166592,EDS 115,A00,895312,Staff,42,0,45,3
1745145167618,EDS 117,A01,895337,Staff,30,0,30,0
1745145168645,EDS 125,A00,895341,Jones; Gabrielle Anastasia,43,0,45,2
1745145169675,EDS 128A,A01,895459,Fargason; Sharon Gayle,45,0,45,0
1745145170705,EDS 128B,A01,895543,Pappas; Elizabeth,45,0,45,0
1745145171732,EDS 139,A00,897203,Pappas; Elizabeth,45,0,45,0
1745145171732,EDS 139,B00,897209,Fargason; Sharon Gayle,45,0,45,0
1745145172759,EDS 201,A00,895545,Staff,44,0,45,1
1745145173785,EDS 203,A01,895581,Halter; Christopher P.,44,0,45,1
1745145174815,EDS 204R,A01,895625,Heinzman; Erica M.,45,0,45,0
1745145174815,EDS 204R,B01,895693,Halter; Christopher P.,28,0,45,17
1745145175843,EDS 206R,A00,895694,Fargason; Sharon Gayle,22,0,30,8
1745145175843,EDS 206R,B00,895695,Choi; Bailey Miyeon,21,0,30,9
1745145176868,EDS 250,A00,895697,Hemans; Patricia Ann Benitez,44,0,45,1
1745145177897,EDS 281,A00,895701,Meyerott; Theresa Ann,15,0,15,0
1745145178928,EDS 284,A00,895736,Meyerott; Theresa Ann,15,0,15,0
1745145179953,EDS 286,A00,897210,Fine; Sarah,15,0,15,0
1745145180981,EDS 289C,A01,895770,Daly; Alan J.,15,0,15,0
1745145182009,EDS 290,A00,897211,Hofstetter; Carolyn,15,0,15,0
1745145183035,LIGM 5A,A00,896162,Fischer-Grunski; Eva K,16,0,20,4
1745145184065,LIGM 5B,A00,896260,Fischer-Grunski; Eva K,19,0,20,1
1745145185093,LIGM 5C,A00,896308,Fischer-Grunski; Eva K,19,0,20,1
1745145186119,LIIT 5AS,A00,896313,Carnelos; Chiara,18,0,20,2
1745145187142,LIIT 5BS,A00,896416,Carnelos; Chiara,20,0,20,0
1745145188172,LIIT 5CS,A00,896564,Carnelos; Chiara,20,0,20,0
1745145189197,LISP 5A,A00,896588,Munoz Sanchez; Alicia,7,0,20,13
1745145190226,LISP 5B,A00,896653,Munoz Sanchez; Alicia,10,0,20,10
1745145191256,LISP 5C,A00,896655,Munoz Sanchez; Alicia,9,0,20,11
1745145192284,MAE 197,001,957918,Kleissl; Jan,9998,0,9999,1
1745145193313,MATH 2,A01,957937,Staff,34,0,35,1
1745145194343,MATH 197,001,957876,Kedlaya; Kiran S.,9996,0,9999,3
1745145195371,MCWP 40,A00,892729,Duru; Nur,15,0,20,5
1745145195371,MCWP 40,B00,893304,Montejo; Carolina,20,0,20,0
1745145196401,MCWP 40R,A00,893757,Redela; Pamela Morgan,0,3,20,20
1745145197428,MCWP 50,A00,893758,Morshed; Michael James,4,0,20,16
1745145197428,MCWP 50,B00,893761,Bartulis; Jason Michael,18,0,20,2
1745145198457,MCWP 50R,A00,893766,Compas; Sean Matthew,0,1,20,20
1745145198457,MCWP 50R,B00,893769,Carter; Jennifer A,5,0,20,15
1745145198457,MCWP 50R,C00,893771,Krone; Jarret,0,3,20,20
1745145198457,MCWP 50R,D00,893772,Miller; Elizabeth Deen,4,0,20,16
1745145198457,MCWP 50R,E00,893775,Carter; Andrea L,0,0,20,20
1745145199488,MMW 11R,A01,892721,Herbst; Matthew,22,0,30,8
1745145199488,MMW 11R,A02,892722,Herbst; Matthew,28,0,30,2
1745145200517,MMW 12R,A01,892724,Herbst; Matthew,0,5,16,16
1745145200517,MMW 12R,A02,892725,Herbst; Matthew,0,4,16,16
1745145201545,MMW 13R,A01,892727,Staff,0,29,16,16
1745145201545,MMW 13R,A02,892728,Staff,0,28,16,16
1745145202570,SIO 295LS,A00,894015,Staff,9,0,25,16
1745145203595,SIO 295S,A00,894020,Staff,9,0,25,16
1745145204621,SIOC 290S,A01,894063,Merrifield; Mark A,23,0,25,2
1745145205649,SIOC 291S,A01,894137,Gabriel; Corey John,23,0,25,2
1745145206673,SOCI 117,A01,895339,Staff,5,0,5,0
1745145207703,WES 237B,A00,894149,Staff,20,0,20,0
1745145209785,AESE 279B,A00,891859,Staff,35,0,35,0
1745145210815,AIP 197,001,891854,Staff,70,0,70,0
1745145211846,ANTH 289S,A00,891856,Gagneux; Pascal,12,0,12,0
1745145212872,BENG 196,001,957946,Engler; Adam J.,9996,0,9999,3
1745145213897,CAT 124RS,A01,956906,Staff,8,0,25,17
1745145214922,CAT 125RS,A01,922013,Staff,8,0,25,17
1745145215950,CLRE 250,A00,891860,Morris; Sheldon,9996,0,9999,3
1745145218011,CLRE 251R,A00,907817,Mehta; Ravindra L.,9995,0,9999,4
1745145219040,CLRE 252,A00,891864,Cuomo; Raphael Eduardo,9994,0,9999,5
1745145220066,CLRE 253,A00,891867,Vaida; Florin,9995,0,9999,4
1745145220066,CLRE 253,B00,907819,Staff,9999,0,9999,0
1745145221094,CLRE 259,A00,891868,Patel; Hemal,9998,0,9999,1
1745145222120,CLRE 260,A00,891872,Cuomo; Raphael Eduardo,9999,0,9999,0
1745145223146,CLRE 297,001,891888,Cuomo; Raphael Eduardo,9999,0,9999,0
1745145224177,CSS 201S,A01,892054,Mignozzetti; Umberto,30,0,30,0
1745145225208,CSS 202S,A01,892056,Mignozzetti; Umberto,30,0,30,0
1745145226272,DSC 197,001,956898,Eldridge; Justin Matthew,9998,0,9999,1
1745145227298,DSC 297,001,958000,Mazumdar; Arya,9999,0,9999,0
1745145228324,EAP 100,A00,905686,Staff,9774,0,9999,225
1745145229350,ECE 45,A01,892618,Staff,0,2,50,50
1745145230378,ECE 109,A01,892620,Staff,0,44,0,0
1745145231407,ECE 111,A01,892719,Staff,0,0,50,50
1745145232431,ECE 197,001,957920,Mercier; Patrick Philip,9992,0,9999,7
1745145233458,ECON 178,A01,907814,Zhu; Ying,29,0,35,6
1745145234485,EDS 115,A00,895312,Staff,42,0,45,3
1745145235512,EDS 117,A01,895337,Staff,30,0,30,0
1745145236542,EDS 125,A00,895341,Jones; Gabrielle Anastasia,43,0,45,2
1745145237567,EDS 128A,A01,895459,Fargason; Sharon Gayle,45,0,45,0
1745145238597,EDS 128B,A01,895543,Pappas; Elizabeth,45,0,45,0
1745145239629,EDS 139,A00,897203,Pappas; Elizabeth,45,0,45,0
1745145239629,EDS 139,B00,897209,Fargason; Sharon Gayle,45,0,45,0
1745145240655,EDS 201,A00,895545,Staff,44,0,45,1
1745145241687,EDS 203,A01,895581,Halter; Christopher P.,44,0,45,1
1745145242723,EDS 204R,A01,895625,Heinzman; Erica M.,45,0,45,0
1745145242723,EDS 204R,B01,895693,Halter; Christopher P.,28,0,45,17
1745145243749,EDS 206R,A00,895694,Fargason; Sharon Gayle,22,0,30,8
1745145243749,EDS 206R,B00,895695,Choi; Bailey Miyeon,21,0,30,9
1745145244775,EDS 250,A00,895697,Hemans; Patricia Ann Benitez,44,0,45,1
1745145245804,EDS 281,A00,895701,Meyerott; Theresa Ann,15,0,15,0
1745145246832,EDS 284,A00,895736,Meyerott; Theresa Ann,15,0,15,0
1745145247860,EDS 286,A00,897210,Fine; Sarah,15,0,15,0
1745145248885,EDS 289C,A01,895770,Daly; Alan J.,15,0,15,0
1745145249911,EDS 290,A00,897211,Hofstetter; Carolyn,15,0,15,0
1745145250937,LIGM 5A,A00,896162,Fischer-Grunski; Eva K,16,0,20,4
1745145251962,LIGM 5B,A00,896260,Fischer-Grunski; Eva K,19,0,20,1
1745145252990,LIGM 5C,A00,896308,Fischer-Grunski; Eva K,19,0,20,1
1745145254015,LIIT 5AS,A00,896313,Carnelos; Chiara,18,0,20,2
1745145255041,LIIT 5BS,A00,896416,Carnelos; Chiara,20,0,20,0
1745145256073,LIIT 5CS,A00,896564,Carnelos; Chiara,20,0,20,0
1745145257104,LISP 5A,A00,896588,Munoz Sanchez; Alicia,7,0,20,13
1745145258129,LISP 5B,A00,896653,Munoz Sanchez; Alicia,10,0,20,10
1745145259157,LISP 5C,A00,896655,Munoz Sanchez; Alicia,9,0,20,11
1745145260185,MAE 197,001,957918,Kleissl; Jan,9998,0,9999,1
1745145261216,MATH 2,A01,957937,Staff,34,0,35,1
1745145262243,MATH 197,001,957876,Kedlaya; Kiran S.,9996,0,9999,3
1745145263268,MCWP 40,A00,892729,Duru; Nur,15,0,20,5
1745145263268,MCWP 40,B00,893304,Montejo; Carolina,20,0,20,0
1745145264294,MCWP 40R,A00,893757,Redela; Pamela Morgan,0,3,20,20
1745145265321,MCWP 50,A00,893758,Morshed; Michael James,4,0,20,16
1745145265321,MCWP 50,B00,893761,Bartulis; Jason Michael,18,0,20,2
1745145266347,MCWP 50R,A00,893766,Compas; Sean Matthew,0,1,20,20
1745145266347,MCWP 50R,B00,893769,Carter; Jennifer A,5,0,20,15
1745145266347,MCWP 50R,C00,893771,Krone; Jarret,0,3,20,20
1745145266347,MCWP 50R,D00,893772,Miller; Elizabeth Deen,4,0,20,16
1745145266347,MCWP 50R,E00,893775,Carter; Andrea L,0,0,20,20
1745145267377,MMW 11R,A01,892721,Herbst; Matthew,22,0,30,8
1745145267377,MMW 11R,A02,892722,Herbst; Matthew,28,0,30,2
1745145268403,MMW 12R,A01,892724,Herbst; Matthew,0,5,16,16
1745145268403,MMW 12R,A02,892725,Herbst; Matthew,0,4,16,16
1745145269429,MMW 13R,A01,892727,Staff,0,29,16,16
1745145269429,MMW 13R,A02,892728,Staff,0,28,16,16
1745145270457,SIO 295LS,A00,894015,Staff,9,0,25,16
1745145271483,SIO 295S,A00,894020,Staff,9,0,25,16
1745145272509,SIOC 290S,A01,894063,Merrifield; Mark A,23,0,25,2
1745145273537,SIOC 291S,A01,894137,Gabriel; Corey John,23,0,25,2
1745145274562,SOCI 117,A01,895339,Staff,5,0,5,0
1745145275589,WES 237B,A00,894149,Staff,20,0,20,0
1745145277655,AESE 279B,A00,891859,Staff,35,0,35,0
1745145278679,AIP 197,001,891854,Staff,70,0,70,0
1745145279706,ANTH 289S,A00,891856,Gagneux; Pascal,12,0,12,0
1745145280736,BENG 196,001,957946,Engler; Adam J.,9996,0,9999,3
1745145281762,CAT 124RS,A01,956906,Staff,8,0,25,17
1745145282789,CAT 125RS,A01,922013,Staff,8,0,25,17
1745145283815,CLRE 250,A00,891860,Morris; Sheldon,9996,0,9999,3
1745145285867,CLRE 251R,A00,907817,Mehta; Ravindra L.,9995,0,9999,4
1745145286893,CLRE 252,A00,891864,Cuomo; Raphael Eduardo,9994,0,9999,5
1745145287921,CLRE 253,A00,891867,Vaida; Florin,9995,0,9999,4
1745145287921,CLRE 253,B00,907819,Staff,9999,0,9999,0
1745145288950,CLRE 259,A00,891868,Patel; Hemal,9998,0,9999,1
1745145289978,CLRE 260,A00,891872,Cuomo; Raphael Eduardo,9999,0,9999,0
1745145291005,CLRE 297,001,891888,Cuomo; Raphael Eduardo,9999,0,9999,0
1745145292031,CSS 201S,A01,892054,Mignozzetti; Umberto,30,0,30,0
1745145293055,CSS 202S,A01,892056,Mignozzetti; Umberto,30,0,30,0
1745145294082,DSC 197,001,956898,Eldridge; Justin Matthew,9998,0,9999,1
1745145295113,DSC 297,001,958000,Mazumdar; Arya,9999,0,9999,0
1745145296138,EAP 100,A00,905686,Staff,9774,0,9999,225
1745145297164,ECE 45,A01,892618,Staff,0,2,50,50
1745145298193,ECE 109,A01,892620,Staff,0,44,0,0
1745145299223,ECE 111,A01,892719,Staff,0,0,50,50
1745145300251,ECE 197,001,957920,Mercier; Patrick Philip,9992,0,9999,7
1745145301278,ECON 178,A01,907814,Zhu; Ying,29,0,35,6
1745145302303,EDS 115,A00,895312,Staff,42,0,45,3
1745145303329,EDS 117,A01,895337,Staff,30,0,30,0
1745145304359,EDS 125,A00,895341,Jones; Gabrielle Anastasia,43,0,45,2
1745145305389,EDS 128A,A01,895459,Fargason; Sharon Gayle,45,0,45,0
1745145306415,EDS 128B,A01,895543,Pappas; Elizabeth,45,0,45,0
1745145307441,EDS 139,A00,897203,Pappas; Elizabeth,45,0,45,0
1745145307441,EDS 139,B00,897209,Fargason; Sharon Gayle,45,0,45,0
1745145308469,EDS 201,A00,895545,Staff,44,0,45,1
1745145309494,EDS 203,A01,895581,Halter; Christopher P.,44,0,45,1
1745145310519,EDS 204R,A01,895625,Heinzman; Erica M.,45,0,45,0
1745145310519,EDS 204R,B01,895693,Halter; Christopher P.,28,0,45,17
1745145311550,EDS 206R,A00,895694,Fargason; Sharon Gayle,22,0,30,8
1745145311550,EDS 206R,B00,895695,Choi; Bailey Miyeon,21,0,30,9
1745145312579,EDS 250,A00,895697,Hemans; Patricia Ann Benitez,44,0,45,1
1745145313605,EDS 281,A00,895701,Meyerott; Theresa Ann,15,0,15,0
1745145314629,EDS 284,A00,895736,Meyerott; Theresa Ann,15,0,15,0
1745145315658,EDS 286,A00,897210,Fine; Sarah,15,0,15,0
1745145316685,EDS 289C,A01,895770,Daly; Alan J.,15,0,15,0
1745145317712,EDS 290,A00,897211,Hofstetter; Carolyn,15,0,15,0
1745145318742,LIGM 5A,A00,896162,Fischer-Grunski; Eva K,16,0,20,4
1745145319768,LIGM 5B,A00,896260,Fischer-Grunski; Eva K,19,0,20,1
1745145320794,LIGM 5C,A00,896308,Fischer-Grunski; Eva K,19,0,20,1
1745145321823,LIIT 5AS,A00,896313,Carnelos; Chiara,18,0,20,2
1745145322854,LIIT 5BS,A00,896416,Carnelos; Chiara,20,0,20,0
1745145323883,LIIT 5CS,A00,896564,Carnelos; Chiara,20,0,20,0
1745145324907,LISP 5A,A00,896588,Munoz Sanchez; Alicia,7,0,20,13
1745145325934,LISP 5B,A00,896653,Munoz Sanchez; Alicia,10,0,20,10
1745145326961,LISP 5C,A00,896655,Munoz Sanchez; Alicia,9,0,20,11
1745145327988,MAE 197,001,957918,Kleissl; Jan,9998,0,9999,1
1745145329016,MATH 2,A01,957937,Staff,34,0,35,1
1745145330082,MATH 197,001,957876,Kedlaya; Kiran S.,9996,0,9999,3
1745145331109,MCWP 40,A00,892729,Duru; Nur,15,0,20,5
1745145331109,MCWP 40,B00,893304,Montejo; Carolina,20,0,20,0
1745145332135,MCWP 40R,A00,893757,Redela; Pamela Morgan,0,3,20,20
1745145333160,MCWP 50,A00,893758,Morshed; Michael James,4,0,20,16
1745145333160,MCWP 50,B00,893761,Bartulis; Jason Michael,18,0,20,2
1745145334192,MCWP 50R,A00,893766,Compas; Sean Matthew,0,1,20,20
1745145334192,MCWP 50R,B00,893769,Carter; Jennifer A,5,0,20,15
1745145334192,MCWP 50R,C00,893771,Krone; Jarret,0,3,20,20
1745145334192,MCWP 50R,D00,893772,Miller; Elizabeth Deen,4,0,20,16
1745145334192,MCWP 50R,E00,893775,Carter; Andrea L,0,0,20,20
1745145335220,MMW 11R,A01,892721,Herbst; Matthew,22,0,30,8
1745145335220,MMW 11R,A02,892722,Herbst; Matthew,28,0,30,2
1745145336250,MMW 12R,A01,892724,Herbst; Matthew,0,5,16,16
1745145336250,MMW 12R,A02,892725,Herbst; Matthew,0,4,16,16
1745145337280,MMW 13R,A01,892727,Staff,0,29,16,16
1745145337280,MMW 13R,A02,892728,Staff,0,28,16,16
1745145338307,SIO 295LS,A00,894015,Staff,9,0,25,16
1745145339332,SIO 295S,A00,894020,Staff,9,0,25,16
1745145340358,SIOC 290S,A01,894063,Merrifield; Mark A,23,0,25,2
1745145341388,SIOC 291S,A01,894137,Gabriel; Corey John,23,0,25,2
1745145342416,SOCI 117,A01,895339,Staff,5,0,5,0
1745145343444,WES 237B,A00,894149,Staff,20,0,20,0
1745145345522,AESE 279B,A00,891859,Staff,35,0,35,0
1745145346550,AIP 197,001,891854,Staff,70,0,70,0
1745145347576,ANTH 289S,A00,891856,Gagneux; Pascal,12,0,12,0
1745145348603,BENG 196,001,957946,Engler; Adam J.,9996,0,9999,3
1745145349628,CAT 124RS,A01,956906,Staff,8,0,25,17
1745145350655,CAT 125RS,A01,922013,Staff,8,0,25,17
1745145351684,CLRE 250,A00,891860,Morris; Sheldon,9996,0,9999,3
1745145353739,CLRE 251R,A00,907817,Mehta; Ravindra L.,9995,0,9999,4
1745145354766,CLRE 252,A00,891864,Cuomo; Raphael Eduardo,9994,0,9999,5
1745145355792,CLRE 253,A00,891867,Vaida; Florin,9995,0,9999,4
1745145355792,CLRE 253,B00,907819,Staff,9999,0,9999,0
1745145356819,CLRE 259,A00,891868,Patel; Hemal,9998,0,9999,1
1745145357845,CLRE 260,A00,891872,Cuomo; Raphael Eduardo,9999,0,9999,0
1745145358871,CLRE 297,001,891888,Cuomo; Raphael Eduardo,9999,0,9999,0
1745145359897,CSS 201S,A01,892054,Mignozzetti; Umberto,30,0,30,0
1745145360926,CSS 202S,A01,892056,Mignozzetti; Umberto,30,0,30,0
1745145361951,DSC 197,001,956898,Eldridge; Justin Matthew,9998,0,9999,1
1745145362977,DSC 297,001,958000,Mazumdar; Arya,9999,0,9999,0
1745145364002,EAP 100,A00,905686,Staff,9774,0,9999,225
1745145365029,ECE 45,A01,892618,Staff,0,2,50,50
1745145366056,ECE 109,A01,892620,Staff,0,44,0,0
1745145367083,ECE 111,A01,892719,Staff,0,0,50,50
1745145368110,ECE 197,001,957920,Mercier; Patrick Philip,9992,0,9999,7
1745145369136,ECON 178,A01,907814,Zhu; Ying,29,0,35,6
1745145370161,EDS 115,A00,895312,Staff,42,0,45,3
1745145371187,EDS 117,A01,895337,Staff,30,0,30,0
1745145372211,EDS 125,A00,895341,Jones; Gabrielle Anastasia,43,0,45,2
1745145373242,EDS 128A,A01,895459,Fargason; Sharon Gayle,45,0,45,0
1745145374267,EDS 128B,A01,895543,Pappas; Elizabeth,45,0,45,0
1745145375297,EDS 139,A00,897203,Pappas; Elizabeth,45,0,45,0
1745145375297,EDS 139,B00,897209,Fargason; Sharon Gayle,45,0,45,0
1745145376323,EDS 201,A00,895545,Staff,44,0,45,1
1745145377354,EDS 203,A01,895581,Halter; Christopher P.,44,0,45,1
1745145378382,EDS 204R,A01,895625,Heinzman; Erica M.,45,0,45,0
1745145378382,EDS 204R,B01,895693,Halter; Christopher P.,28,0,45,17
1745145379411,EDS 206R,A00,895694,Fargason; Sharon Gayle,22,0,30,8
1745145379411,EDS 206R,B00,895695,Choi; Bailey Miyeon,21,0,30,9
1745145380443,EDS 250,A00,895697,Hemans; Patricia Ann Benitez,44,0,45,1
1745145381471,EDS 281,A00,895701,Meyerott; Theresa Ann,15,0,15,0
1745145382501,EDS 284,A00,895736,Meyerott; Theresa Ann,15,0,15,0
1745145383530,EDS 286,A00,897210,Fine; Sarah,15,0,15,0
1745145384558,EDS 289C,A01,895770,Daly; Alan J.,15,0,15,0
1745145385582,EDS 290,A00,897211,Hofstetter; Carolyn,15,0,15,0
1745145386608,LIGM 5A,A00,896162,Fischer-Grunski; Eva K,16,0,20,4
1745145387638,LIGM 5B,A00,896260,Fischer-Grunski; Eva K,19,0,20,1
1745145388667,LIGM 5C,A00,896308,Fischer-Grunski; Eva K,19,0,20,1
1745145389693,LIIT 5AS,A00,896313,Carnelos; Chiara,18,0,20,2
1745145390718,LIIT 5BS,A00,896416,Carnelos; Chiara,20,0,20,0
1745145391747,LIIT 5CS,A00,896564,Carnelos; Chiara,20,0,20,0
1745145392780,LISP 5A,A00,896588,Munoz Sanchez; Alicia,7,0,20,13
1745145393808,LISP 5B,A00,896653,Munoz Sanchez; Alicia,10,0,20,10
1745145394839,LISP 5C,A00,896655,Munoz Sanchez; Alicia,9,0,20,11
1745145395866,MAE 197,001,957918,Kleissl; Jan,9998,0,9999,1
1745145396893,MATH 2,A01,957937,Staff,34,0,35,1
1745145397919,MATH 197,001,957876,Kedlaya; Kiran S.,9996,0,9999,3
1745145398950,MCWP 40,A00,892729,Duru; Nur,15,0,20,5
1745145398950,MCWP 40,B00,893304,Montejo; Carolina,20,0,20,0
1745145399977,MCWP 40R,A00,893757,Redela; Pamela Morgan,0,3,20,20
1745145401007,MCWP 50,A00,893758,Morshed; Michael James,4,0,20,16
1745145401007,MCWP 50,B00,893761,Bartulis; Jason Michael,18,0,20,2
1745145402033,MCWP 50R,A00,893766,Compas; Sean Matthew,0,1,20,20
1745145402033,MCWP 50R,B00,893769,Carter; Jennifer A,5,0,20,15
1745145402033,MCWP 50R,C00,893771,Krone; Jarret,0,3,20,20
1745145402033,MCWP 50R,D00,893772,Miller; Elizabeth Deen,4,0,20,16
1745145402033,MCWP 50R,E00,893775,Carter; Andrea L,0,0,20,20
1745145403062,MMW 11R,A01,892721,Herbst; Matthew,22,0,30,8
1745145403062,MMW 11R,A02,892722,Herbst; Matthew,28,0,30,2
1745145404090,MMW 12R,A01,892724,Herbst; Matthew,0,5,16,16
1745145404090,MMW 12R,A02,892725,Herbst; Matthew,0,4,16,16
1745145405116,MMW 13R,A01,892727,Staff,0,29,16,16
1745145405116,MMW 13R,A02,892728,Staff,0,28,16,16
1745145406141,SIO 295LS,A00,894015,Staff,9,0,25,16
1745145407167,SIO 295S,A00,894020,Staff,9,0,25,16
1745145408196,SIOC 290S,A01,894063,Merrifield; Mark A,23,0,25,2
1745145409223,SIOC 291S,A01,894137,Gabriel; Corey John,23,0,25,2
1745145410253,SOCI 117,A01,895339,Staff,5,0,5,0
1745145411282,WES 237B,A00,894149,Staff,20,0,20,0
1745145413350,AESE 279B,A00,891859,Staff,35,0,35,0
1745145414375,AIP 197,001,891854,Staff,70,0,70,0
1745145415406,ANTH 289S,A00,891856,Gagneux; Pascal,12,0,12,0
1745145416435,BENG 196,001,957946,Engler; Adam J.,9996,0,9999,3
1745145417461,CAT 124RS,A01,956906,Staff,8,0,25,17
1745145418490,CAT 125RS,A01,922013,Staff,8,0,25,17
1745145419517,CLRE 250,A00,891860,Morris; Sheldon,9996,0,9999,3
1745145421568,CLRE 251R,A00,907817,Mehta; Ravindra L.,9995,0,9999,4
1745145422594,CLRE 252,A00,891864,Cuomo; Raphael Eduardo,9994,0,9999,5
1745145423626,CLRE 253,A00,891867,Vaida; Florin,9995,0,9999,4
1745145423626,CLRE 253,B00,907819,Staff,9999,0,9999,0
1745145424652,CLRE 259,A00,891868,Patel; Hemal,9998,0,9999,1
1745145425677,CLRE 260,A00,891872,Cuomo; Raphael Eduardo,9999,0,9999,0
1745145426702,CLRE 297,001,891888,Cuomo; Raphael Eduardo,9999,0,9999,0
1745145427734,CSS 201S,A01,892054,Mignozzetti; Umberto,30,0,30,0
1745145428758,CSS 202S,A01,892056,Mignozzetti; Umberto,30,0,30,0
1745145429784,DSC 197,001,956898,Eldridge; Justin Matthew,9998,0,9999,1
1745145430811,DSC 297,001,958000,Mazumdar; Arya,9999,0,9999,0
1745145431838,EAP 100,A00,905686,Staff,9774,0,9999,225
1745145432864,ECE 45,A01,892618,Staff,0,2,50,50
1745145433945,ECE 109,A01,892620,Staff,0,44,0,0
1745145434970,ECE 111,A01,892719,Staff,0,0,50,50
1745145435997,ECE 197,001,957920,Mercier; Patrick Philip,9992,0,9999,7
1745145437028,ECON 178,A01,907814,Zhu; Ying,29,0,35,6
1745145438054,EDS 115,A00,895312,Staff,42,0,45,3
1745145439080,EDS 117,A01,895337,Staff,30,0,30,0
1745145440104,EDS 125,A00,895341,Jones; Gabrielle Anastasia,43,0,45,2
1745145441129,EDS 128A,A01,895459,Fargason; Sharon Gayle,45,0,45,0
1745145442156,EDS 128B,A01,895543,Pappas; Elizabeth,45,0,45,0
1745145443183,EDS 139,A00,897203,Pappas; Elizabeth,45,0,45,0
1745145443183,EDS 139,B00,897209,Fargason; Sharon Gayle,45,0,45,0
1745145444213,EDS 201,A00,895545,Staff,44,0,45,1
1745145445238,EDS 203,A01,895581,Halter; Christopher P.,44,0,45,1
1745145446265,EDS 204R,A01,895625,Heinzman; Erica M.,45,0,45,0
1745145446265,EDS 204R,B01,895693,Halter; Christopher P.,28,0,45,17
1745145447291,EDS 206R,A00,895694,Fargason; Sharon Gayle,22,0,30,8
1745145447291,EDS 206R,B00,895695,Choi; Bailey Miyeon,21,0,30,9
1745145448316,EDS 250,A00,895697,Hemans; Patricia Ann Benitez,44,0,45,1
1745145449341,EDS 281,A00,895701,Meyerott; Theresa Ann,15,0,15,0
1745145450366,EDS 284,A00,895736,Meyerott; Theresa Ann,15,0,15,0
1745145451391,EDS 286,A00,897210,Fine; Sarah,15,0,15,0
1745145452420,EDS 289C,A01,895770,Daly; Alan J.,15,0,15,0
1745145453446,EDS 290,A00,897211,Hofstetter; Carolyn,15,0,15,0
1745145454471,LIGM 5A,A00,896162,Fischer-Grunski; Eva K,16,0,20,4
1745145455497,LIGM 5B,A00,896260,Fischer-Grunski; Eva K,19,0,20,1
1745145456523,LIGM 5C,A00,896308,Fischer-Grunski; Eva K,19,0,20,1
1745145457552,LIIT 5AS,A00,896313,Carnelos; Chiara,18,0,20,2
1745145458582,LIIT 5BS,A00,896416,Carnelos; Chiara,20,0,20,0
1745145459613,LIIT 5CS,A00,896564,Carnelos; Chiara,20,0,20,0
1745145460639,LISP 5A,A00,896588,Munoz Sanchez; Alicia,7,0,20,13
1745145461670,LISP 5B,A00,896653,Munoz Sanchez; Alicia,10,0,20,10
1745145462697,LISP 5C,A00,896655,Munoz Sanchez; Alicia,9,0,20,11
1745145463725,MAE 197,001,957918,Kleissl; Jan,9998,0,9999,1
1745145464753,MATH 2,A01,957937,Staff,34,0,35,1
1745145465780,MATH 197,001,957876,Kedlaya; Kiran S.,9996,0,9999,3
1745145466805,MCWP 40,A00,892729,Duru; Nur,15,0,20,5
1745145466805,MCWP 40,B00,893304,Montejo; Carolina,20,0,20,0
1745145467831,MCWP 40R,A00,893757,Redela; Pamela Morgan,0,3,20,20
1745145468858,MCWP 50,A00,893758,Morshed; Michael James,4,0,20,16
1745145468858,MCWP 50,B00,893761,Bartulis; Jason Michael,18,0,20,2
1745145469885,MCWP 50R,A00,893766,Compas; Sean Matthew,0,1,20,20
1745145469885,MCWP 50R,B00,893769,Carter; Jennifer A,5,0,20,15
1745145469885,MCWP 50R,C00,893771,Krone; Jarret,0,3,20,20
1745145469885,MCWP 50R,D00,893772,Miller; Elizabeth Deen,4,0,20,16
1745145469885,MCWP 50R,E00,893775,Carter; Andrea L,0,0,20,20
1745145470910,MMW 11R,A01,892721,Herbst; Matthew,22,0,30,8
1745145470910,MMW 11R,A02,892722,Herbst; Matthew,28,0,30,2
1745145471938,MMW 12R,A01,892724,Herbst; Matthew,0,5,16,16
1745145471938,MMW 12R,A02,892725,Herbst; Matthew,0,4,16,16
1745145472965,MMW 13R,A01,892727,Staff,0,29,16,16
1745145472965,MMW 13R,A02,892728,Staff,0,28,16,16
1745145473992,SIO 295LS,A00,894015,Staff,9,0,25,16
1745145475020,SIO 295S,A00,894020,Staff,9,0,25,16
1745145476045,SIOC 290S,A01,894063,Merrifield; Mark A,23,0,25,2
1745145477074,SIOC 291S,A01,894137,Gabriel; Corey John,23,0,25,2
1745145478099,SOCI 117,A01,895339,Staff,5,0,5,0
1745145479124,WES 237B,A00,894149,Staff,20,0,20,0
1745145481193,AESE 279B,A00,891859,Staff,35,0,35,0
1745145482219,AIP 197,001,891854,Staff,70,0,70,0
1745145483246,ANTH 289S,A00,891856,Gagneux; Pascal,12,0,12,0
1745145484276,BENG 196,001,957946,Engler; Adam J.,9996,0,9999,3
1745145485301,CAT 124RS,A01,956906,Staff,8,0,25,17
1745145486326,CAT 125RS,A01,922013,Staff,8,0,25,17
1745145487354,CLRE 250,A00,891860,Morris; Sheldon,9996,0,9999,3
1745145489407,CLRE 251R,A00,907817,Mehta; Ravindra L.,9995,0,9999,4
1745145490432,CLRE 252,A00,891864,Cuomo; Raphael Eduardo,9994,0,9999,5
1745145491461,CLRE 253,A00,891867,Vaida; Florin,9995,0,9999,4
1745145491461,CLRE 253,B00,907819,Staff,9999,0,9999,0
1745145492484,CLRE 259,A00,891868,Patel; Hemal,9998,0,9999,1
1745145493516,CLRE 260,A00,891872,Cuomo; Raphael Eduardo,9999,0,9999,0
1745145494542,CLRE 297,001,891888,Cuomo; Raphael Eduardo,9999,0,9999,0
1745145495568,CSS 201S,A01,892054,Mignozzetti; Umberto,30,0,30,0
1745145496597,CSS 202S,A01,892056,Mignozzetti; Umberto,30,0,30,0
1745145497621,DSC 197,001,956898,Eldridge; Justin Matthew,9998,0,9999,1
1745145498647,DSC 297,001,958000,Mazumdar; Arya,9999,0,9999,0
1745145499673,EAP 100,A00,905686,Staff,9774,0,9999,225
1745145500700,ECE 45,A01,892618,Staff,0,2,50,50
1745145501728,ECE 109,A01,892620,Staff,0,44,0,0
1745145502755,ECE 111,A01,892719,Staff,0,0,50,50
1745145503779,ECE 197,001,957920,Mercier; Patrick Philip,9992,0,9999,7
1745145504811,ECON 178,A01,907814,Zhu; Ying,29,0,35,6
1745145505837,EDS 115,A00,895312,Staff,42,0,45,3
1745145506865,EDS 117,A01,895337,Staff,30,0,30,0
1745145507896,EDS 125,A00,895341,Jones; Gabrielle Anastasia,43,0,45,2
1745145508926,EDS 128A,A01,895459,Fargason; Sharon Gayle,45,0,45,0
1745145509952,EDS 128B,A01,895543,Pappas; Elizabeth,45,0,45,0
1745145510977,EDS 139,A00,897203,Pappas; Elizabeth,45,0,45,0
1745145510977,EDS 139,B00,897209,Fargason; Sharon Gayle,45,0,45,0
1745145512008,EDS 201,A00,895545,Staff,44,0,45,1
1745145513034,EDS 203,A01,895581,Halter; Christopher P.,44,0,45,1
1745145514060,EDS 204R,A01,895625,Heinzman; Erica M.,45,0,45,0
1745145514060,EDS 204R,B01,895693,Halter; Christopher P.,28,0,45,17
1745145515092,EDS 206R,A00,895694,Fargason; Sharon Gayle,22,0,30,8
1745145515092,EDS 206R,B00,895695,Choi; Bailey Miyeon,21,0,30,9
1745145516121,EDS 250,A00,895697,Hemans; Patricia Ann Benitez,44,0,45,1
1745145517152,EDS 281,A00,895701,Meyerott; Theresa Ann,15,0,15,0
1745145518179,EDS 284,A00,895736,Meyerott; Theresa Ann,15,0,15,0
1745145519207,EDS 286,A00,897210,Fine; Sarah,15,0,15,0
1745145520232,EDS 289C,A01,895770,Daly; Alan J.,15,0,15,0
1745145521258,EDS 290,A00,897211,Hofstetter; Carolyn,15,0,15,0
1745145522284,LIGM 5A,A00,896162,Fischer-Grunski; Eva K,16,0,20,4
1745145523315,LIGM 5B,A00,896260,Fischer-Grunski; Eva K,19,0,20,1
1745145524345,LIGM 5C,A00,896308,Fischer-Grunski; Eva K,19,0,20,1
1745145525371,LIIT 5AS,A00,896313,Carnelos; Chiara,18,0,20,2
1745145526397,LIIT 5BS,A00,896416,Carnelos; Chiara,20,0,20,0
1745145527426,LIIT 5CS,A00,896564,Carnelos; Chiara,20,0,20,0
1745145528452,LISP 5A,A00,896588,Munoz Sanchez; Alicia,7,0,20,13
1745145529479,LISP 5B,A00,896653,Munoz Sanchez; Alicia,10,0,20,10
1745145530509,LISP 5C,A00,896655,Munoz Sanchez; Alicia,9,0,20,11
1745145531534,MAE 197,001,957918,Kleissl; Jan,9998,0,9999,1
1745145532559,MATH 2,A01,957937,Staff,34,0,35,1
1745145533589,MATH 197,001,957876,Kedlaya; Kiran S.,9996,0,9999,3
1745145534623,MCWP 40,A00,892729,Duru; Nur,15,0,20,5
1745145534623,MCWP 40,B00,893304,Montejo; Carolina,20,0,20,0
1745145535651,MCWP 40R,A00,893757,Redela; Pamela Morgan,0,3,20,20
1745145536682,MCWP 50,A00,893758,Morshed; Michael James,4,0,20,16
1745145536682,MCWP 50,B00,893761,Bartulis; Jason Michael,18,0,20,2
1745145537714,MCWP 50R,A00,893766,Compas; Sean Matthew,0,1,20,20
1745145537714,MCWP 50R,B00,893769,Carter; Jennifer A,5,0,20,15
1745145537714,MCWP 50R,C00,893771,Krone; Jarret,0,3,20,20
1745145537714,MCWP 50R,D00,893772,Miller; Elizabeth Deen,4,0,20,16
1745145537714,MCWP 50R,E00,893775,Carter; Andrea L,0,0,20,20
1745145538740,MMW 11R,A01,892721,Herbst; Matthew,22,0,30,8
1745145538740,MMW 11R,A02,892722,Herbst; Matthew,28,0,30,2
1745145539766,MMW 12R,A01,892724,Herbst; Matthew,0,5,16,16
1745145539766,MMW 12R,A02,892725,Herbst; Matthew,0,4,16,16
1745145540792,MMW 13R,A01,892727,Staff,0,29,16,16
1745145540792,MMW 13R,A02,892728,Staff,0,28,16,16
1745145541821,SIO 295LS,A00,894015,Staff,9,0,25,16
1745145542848,SIO 295S,A00,894020,Staff,9,0,25,16
1745145543875,SIOC 290S,A01,894063,Merrifield; Mark A,23,0,25,2
1745145544906,SIOC 291S,A01,894137,Gabriel; Corey John,23,0,25,2
1745145545932,SOCI 117,A01,895339,Staff,5,0,5,0
1745145546961,WES 237B,A00,894149,Staff,20,0,20,0
1745145549037,AESE 279B,A00,891859,Staff,35,0,35,0
1745145550063,AIP 197,001,891854,Staff,70,0,70,0
1745145551091,ANTH 289S,A00,891856,Gagneux; Pascal,12,0,12,0
1745145552118,BENG 196,001,957946,Engler; Adam J.,9996,0,9999,3
1745145553144,CAT 124RS,A01,956906,Staff,8,0,25,17
1745145554174,CAT 125RS,A01,922013,Staff,8,0,25,17
1745145555202,CLRE 250,A00,891860,Morris; Sheldon,9996,0,9999,3
1745145557258,CLRE 251R,A00,907817,Mehta; Ravindra L.,9995,0,9999,4
1745145558284,CLRE 252,A00,891864,Cuomo; Raphael Eduardo,9994,0,9999,5
1745145559325,CLRE 253,A00,891867,Vaida; Florin,9995,0,9999,4
1745145559325,CLRE 253,B00,907819,Staff,9999,0,9999,0
1745145560352,CLRE 259,A00,891868,Patel; Hemal,9998,0,9999,1
1745145561384,CLRE 260,A00,891872,Cuomo; Raphael Eduardo,9999,0,9999,0
1745145562410,CLRE 297,001,891888,Cuomo; Raphael Eduardo,9999,0,9999,0
1745145563440,CSS 201S,A01,892054,Mignozzetti; Umberto,30,0,30,0
1745145564467,CSS 202S,A01,892056,Mignozzetti; Umberto,30,0,30,0
1745145565500,DSC 197,001,956898,Eldridge; Justin Matthew,9998,0,9999,1
1745145566530,DSC 297,001,958000,Mazumdar; Arya,9999,0,9999,0
1745145567557,EAP 100,A00,905686,Staff,9774,0,9999,225
1745145568586,ECE 45,A01,892618,Staff,0,2,50,50
1745145569614,ECE 109,A01,892620,Staff,0,44,0,0
1745145570645,ECE 111,A01,892719,Staff,0,0,50,50
1745145571671,ECE 197,001,957920,Mercier; Patrick Philip,9992,0,9999,7
1745145572740,ECON 178,A01,907814,Zhu; Ying,29,0,35,6
1745145573767,EDS 115,A00,895312,Staff,42,0,45,3
1745145574792,EDS 117,A01,895337,Staff,30,0,30,0
1745145575826,EDS 125,A00,895341,Jones; Gabrielle Anastasia,43,0,45,2
1745145576852,EDS 128A,A01,895459,Fargason; Sharon Gayle,45,0,45,0
1745145577878,EDS 128B,A01,895543,Pappas; Elizabeth,45,0,45,0
1745145578907,EDS 139,A00,897203,Pappas; Elizabeth,45,0,45,0
1745145578907,EDS 139,B00,897209,Fargason; Sharon Gayle,45,0,45,0
1745145579932,EDS 201,A00,895545,Staff,44,0,45,1
1745145580967,EDS 203,A01,895581,Halter; Christopher P.,44,0,45,1
1745145581998,EDS 204R,A01,895625,Heinzman; Erica M.,45,0,45,0
1745145581998,EDS 204R,B01,895693,Halter; Christopher P.,28,0,45,17
1745145583023,EDS 206R,A00,895694,Fargason; Sharon Gayle,22,0,30,8
1745145583023,EDS 206R,B00,895695,Choi; Bailey Miyeon,21,0,30,9
1745145584055,EDS 250,A00,895697,Hemans; Patricia Ann Benitez,44,0,45,1
1745145585083,EDS 281,A00,895701,Meyerott; Theresa Ann,15,0,15,0
1745145586110,EDS 284,A00,895736,Meyerott; Theresa Ann,15,0,15,0
1745145587143,EDS 286,A00,897210,Fine; Sarah,15,0,15,0
1745145588171,EDS 289C,A01,895770,Daly; Alan J.,15,0,15,0
1745145589198,EDS 290,A00,897211,Hofstetter; Carolyn,15,0,15,0
1745145590225,LIGM 5A,A00,896162,Fischer-Grunski; Eva K,16,0,20,4
1745145591251,LIGM 5B,A00,896260,Fischer-Grunski; Eva K,19,0,20,1
1745145592277,LIGM 5C,A00,896308,Fischer-Grunski; Eva K,19,0,20,1
1745145593304,LIIT 5AS,A00,896313,Carnelos; Chiara,18,0,20,2
1745145594331,LIIT 5BS,A00,896416,Carnelos; Chiara,20,0,20,0
1745145595361,LIIT 5CS,A00,896564,Carnelos; Chiara,20,0,20,0
1745145596385,LISP 5A,A00,896588,Munoz Sanchez; Alicia,7,0,20,13
1745145597410,LISP 5B,A00,896653,Munoz Sanchez; Alicia,10,0,20,10
1745145598435,LISP 5C,A00,896655,Munoz Sanchez; Alicia,9,0,20,11
1745145599463,MAE 197,001,957918,Kleissl; Jan,9998,0,9999,1
1745145600490,MATH 2,A01,957937,Staff,34,0,35,1
1745145601518,MATH 197,001,957876,Kedlaya; Kiran S.,9996,0,9999,3
1745145602550,MCWP 40,A00,892729,Duru; Nur,15,0,20,5
1745145602550,MCWP 40,B00,893304,Montejo; Carolina,20,0,20,0
1745145603577,MCWP 40R,A00,893757,Redela; Pamela Morgan,0,3,20,20
1745145604604,MCWP 50,A00,893758,Morshed; Michael James,4,0,20,16
1745145604604,MCWP 50,B00,893761,Bartulis; Jason Michael,18,0,20,2
1745145605631,MCWP 50R,A00,893766,Compas; Sean Matthew,0,1,20,20
1745145605631,MCWP 50R,B00,893769,Carter; Jennifer A,5,0,20,15
1745145605631,MCWP 50R,C00,893771,Krone; Jarret,0,3,20,20
1745145605631,MCWP 50R,D00,893772,Miller; Elizabeth Deen,4,0,20,16
1745145605631,MCWP 50R,E00,893775,Carter; Andrea L,0,0,20,20
1745145606659,MMW 11R,A01,892721,Herbst; Matthew,22,0,30,8
1745145606659,MMW 11R,A02,892722,Herbst; Matthew,28,0,30,2
1745145607685,MMW 12R,A01,892724,Herbst; Matthew,0,5,16,16
1745145607685,MMW 12R,A02,892725,Herbst; Matthew,0,4,16,16
1745145608714,MMW 13R,A01,892727,Staff,0,29,16,16
1745145608714,MMW 13R,A02,892728,Staff,0,28,16,16
1745145609744,SIO 295LS,A00,894015,Staff,9,0,25,16
1745145610769,SIO 295S,A00,894020,Staff,9,0,25,16
1745145611797,SIOC 290S,A01,894063,Merrifield; Mark A,23,0,25,2
1745145612825,SIOC 291S,A01,894137,Gabriel; Corey John,23,0,25,2
1745145613852,SOCI 117,A01,895339,Staff,5,0,5,0
1745145614881,WES 237B,A00,894149,Staff,20,0,20,0
1745145616951,AESE 279B,A00,891859,Staff,35,0,35,0
1745145617978,AIP 197,001,891854,Staff,70,0,70,0
1745145619005,ANTH 289S,A00,891856,Gagneux; Pascal,12,0,12,0
1745145620032,BENG 196,001,957946,Engler; Adam J.,9996,0,9999,3
1745145621057,CAT 124RS,A01,956906,Staff,8,0,25,17
1745145622085,CAT 125RS,A01,922013,Staff,8,0,25,17
1745145623115,CLRE 250,A00,891860,Morris; Sheldon,9996,0,9999,3
1745145625208,CLRE 251R,A00,907817,Mehta; Ravindra L.,9995,0,9999,4
1745145626234,CLRE 252,A00,891864,Cuomo; Raphael Eduardo,9994,0,9999,5
1745145627259,CLRE 253,A00,891867,Vaida; Florin,9995,0,9999,4
1745145627259,CLRE 253,B00,907819,Staff,9999,0,9999,0
1745145628290,CLRE 259,A00,891868,Patel; Hemal,9998,0,9999,1
1745145629317,CLRE 260,A00,891872,Cuomo; Raphael Eduardo,9999,0,9999,0
1745145630343,CLRE 297,001,891888,Cuomo; Raphael Eduardo,9999,0,9999,0
1745145631375,CSS 201S,A01,892054,Mignozzetti; Umberto,30,0,30,0
1745145632401,CSS 202S,A01,892056,Mignozzetti; Umberto,30,0,30,0
1745145633429,DSC 197,001,956898,Eldridge; Justin Matthew,9998,0,9999,1
1745145634458,DSC 297,001,958000,Mazumdar; Arya,9999,0,9999,0
1745145635483,EAP 100,A00,905686,Staff,9774,0,9999,225
1745145636512,ECE 45,A01,892618,Staff,0,2,50,50
1745145637541,ECE 109,A01,892620,Staff,0,44,0,0
1745145638569,ECE 111,A01,892719,Staff,0,0,50,50
1745145639595,ECE 197,001,957920,Mercier; Patrick Philip,9992,0,9999,7
1745145640621,ECON 178,A01,907814,Zhu; Ying,29,0,35,6
1745145641648,EDS 115,A00,895312,Staff,42,0,45,3
1745145642678,EDS 117,A01,895337,Staff,30,0,30,0
1745145643705,EDS 125,A00,895341,Jones; Gabrielle Anastasia,43,0,45,2
1745145644731,EDS 128A,A01,895459,Fargason; Sharon Gayle,45,0,45,0
1745145645763,EDS 128B,A01,895543,Pappas; Elizabeth,45,0,45,0
1745145646793,EDS 139,A00,897203,Pappas; Elizabeth,45,0,45,0
1745145646793,EDS 139,B00,897209,Fargason; Sharon Gayle,45,0,45,0
1745145647819,EDS 201,A00,895545,Staff,44,0,45,1
1745145648847,EDS 203,A01,895581,Halter; Christopher P.,44,0,45,1
1745145649874,EDS 204R,A01,895625,Heinzman; Erica M.,45,0,45,0
1745145649874,EDS 204R,B01,895693,Halter; Christopher P.,28,0,45,17
1745145650901,EDS 206R,A00,895694,Fargason; Sharon Gayle,22,0,30,8
1745145650901,EDS 206R,B00,895695,Choi; Bailey Miyeon,21,0,30,9
1745145651931,EDS 250,A00,895697,Hemans; Patricia Ann Benitez,44,0,45,1
1745145652962,EDS 281,A00,895701,Meyerott; Theresa Ann,15,0,15,0
1745145653987,EDS 284,A00,895736,Meyerott; Theresa Ann,15,0,15,0
1745145655021,EDS 286,A00,897210,Fine; Sarah,15,0,15,0
1745145656048,EDS 289C,A01,895770,Daly; Alan J.,15,0,15,0
1745145657078,EDS 290,A00,897211,Hofstetter; Carolyn,15,0,15,0
1745145658107,LIGM 5A,A00,896162,Fischer-Grunski; Eva K,16,0,20,4
1745145659146,LIGM 5B,A00,896260,Fischer-Grunski; Eva K,19,0,20,1
1745145660177,LIGM 5C,A00,896308,Fischer-Grunski; Eva K,19,0,20,1
1745145661206,LIIT 5AS,A00,896313,Carnelos; Chiara,18,0,20,2
1745145662233,LIIT 5BS,A00,896416,Carnelos; Chiara,20,0,20,0
1745145663258,LIIT 5CS,A00,896564,Carnelos; Chiara,20,0,20,0
1745145664285,LISP 5A,A00,896588,Munoz Sanchez; Alicia,7,0,20,13
1745145665312,LISP 5B,A00,896653,Munoz Sanchez; Alicia,10,0,20,10
1745145666341,LISP 5C,A00,896655,Munoz Sanchez; Alicia,9,0,20,11
1745145667366,MAE 197,001,957918,Kleissl; Jan,9998,0,9999,1
1745145668392,MATH 2,A01,957937,Staff,34,0,35,1
1745145669418,MATH 197,001,957876,Kedlaya; Kiran S.,9996,0,9999,3
1745145670450,MCWP 40,A00,892729,Duru; Nur,15,0,20,5
1745145670450,MCWP 40,B00,893304,Montejo; Carolina,20,0,20,0
1745145671475,MCWP 40R,A00,893757,Redela; Pamela Morgan,0,3,20,20
1745145672505,MCWP 50,A00,893758,Morshed; Michael James,4,0,20,16
1745145672505,MCWP 50,B00,893761,Bartulis; Jason Michael,18,0,20,2
1745145673542,MCWP 50R,A00,893766,Compas; Sean Matthew,0,1,20,20
1745145673542,MCWP 50R,B00,893769,Carter; Jennifer A,5,0,20,15
1745145673542,MCWP 50R,C00,893771,Krone; Jarret,0,3,20,20
1745145673542,MCWP 50R,D00,893772,Miller; Elizabeth Deen,4,0,20,16
1745145673542,MCWP 50R,E00,893775,Carter; Andrea L,0,0,20,20
1745145674570,MMW 11R,A01,892721,Herbst; Matthew,22,0,30,8
1745145674570,MMW 11R,A02,892722,Herbst; Matthew,28,0,30,2
1745145675595,MMW 12R,A01,892724,Herbst; Matthew,0,5,16,16
1745145675595,MMW 12R,A02,892725,Herbst; Matthew,0,4,16,16
1745145676620,MMW 13R,A01,892727,Staff,0,29,16,16
1745145676620,MMW 13R,A02,892728,Staff,0,28,16,16
1745145677647,SIO 295LS,A00,894015,Staff,9,0,25,16
1745145678674,SIO 295S,A00,894020,Staff,9,0,25,16
1745145679701,SIOC 290S,A01,894063,Merrifield; Mark A,23,0,25,2
1745145680729,SIOC 291S,A01,894137,Gabriel; Corey John,23,0,25,2
1745145681757,SOCI 117,A01,895339,Staff,5,0,5,0
1745145682785,WES 237B,A00,894149,Staff,20,0,20,0
1745145684865,AESE 279B,A00,891859,Staff,35,0,35,0
1745145685891,AIP 197,001,891854,Staff,70,0,70,0
1745145686915,ANTH 289S,A00,891856,Gagneux; Pascal,12,0,12,0
1745145687940,BENG 196,001,957946,Engler; Adam J.,9996,0,9999,3
1745145688970,CAT 124RS,A01,956906,Staff,8,0,25,17
1745145689998,CAT 125RS,A01,922013,Staff,8,0,25,17
1745145691047,CLRE 250,A00,891860,Morris; Sheldon,9996,0,9999,3
1745145693102,CLRE 251R,A00,907817,Mehta; Ravindra L.,9995,0,9999,4
1745145694128,CLRE 252,A00,891864,Cuomo; Raphael Eduardo,9994,0,9999,5
1745145695161,CLRE 253,A00,891867,Vaida; Florin,9995,0,9999,4
1745145695161,CLRE 253,B00,907819,Staff,9999,0,9999,0
1745145696190,CLRE 259,A00,891868,Patel; Hemal,9998,0,9999,1
1745145697216,CLRE 260,A00,891872,Cuomo; Raphael Eduardo,9999,0,9999,0
1745145698249,CLRE 297,001,891888,Cuomo; Raphael Eduardo,9999,0,9999,0
1745145699276,CSS 201S,A01,892054,Mignozzetti; Umberto,30,0,30,0
1745145700303,CSS 202S,A01,892056,Mignozzetti; Umberto,30,0,30,0
1745145701331,DSC 197,001,956898,Eldridge; Justin Matthew,9998,0,9999,1
1745145702360,DSC 297,001,958000,Mazumdar; Arya,9999,0,9999,0
1745145703386,EAP 100,A00,905686,Staff,9774,0,9999,225
1745145704414,ECE 45,A01,892618,Staff,0,2,50,50
1745145705443,ECE 109,A01,892620,Staff,0,44,0,0
1745145706469,ECE 111,A01,892719,Staff,0,0,50,50
1745145707497,ECE 197,001,957920,Mercier; Patrick Philip,9992,0,9999,7
1745145708524,ECON 178,A01,907814,Zhu; Ying,29,0,35,6
1745145709553,EDS 115,A00,895312,Staff,42,0,45,3
1745145710578,EDS 117,A01,895337,Staff,30,0,30,0
1745145711606,EDS 125,A00,895341,Jones; Gabrielle Anastasia,43,0,45,2
1745145712630,EDS 128A,A01,895459,Fargason; Sharon Gayle,45,0,45,0
1745145713657,EDS 128B,A01,895543,Pappas; Elizabeth,45,0,45,0
1745145714688,EDS 139,A00,897203,Pappas; Elizabeth,45,0,45,0
1745145714688,EDS 139,B00,897209,Fargason; Sharon Gayle,45,0,45,0
1745145715712,EDS 201,A00,895545,Staff,44,0,45,1
1745145716741,EDS 203,A01,895581,Halter; Christopher P.,44,0,45,1
1745145717770,EDS 204R,A01,895625,Heinzman; Erica M.,45,0,45,0
1745145717770,EDS 204R,B01,895693,Halter; Christopher P.,28,0,45,17
1745145718796,EDS 206R,A00,895694,Fargason; Sharon Gayle,22,0,30,8
1745145718796,EDS 206R,B00,895695,Choi; Bailey Miyeon,21,0,30,9
1745145719821,EDS 250,A00,895697,Hemans; Patricia Ann Benitez,44,0,45,1
1745145720850,EDS 281,A00,895701,Meyerott; Theresa Ann,15,0,15,0
1745145721878,EDS 284,A00,895736,Meyerott; Theresa Ann,15,0,15,0
1745145722904,EDS 286,A00,897210,Fine; Sarah,15,0,15,0
1745145723931,EDS 289C,A01,895770,Daly; Alan J.,15,0,15,0
1745145724958,EDS 290,A00,897211,Hofstetter; Carolyn,15,0,15,0
1745145725985,LIGM 5A,A00,896162,Fischer-Grunski; Eva K,16,0,20,4
1745145727017,LIGM 5B,A00,896260,Fischer-Grunski; Eva K,19,0,20,1
1745145728053,LIGM 5C,A00,896308,Fischer-Grunski; Eva K,19,0,20,1
1745145729077,LIIT 5AS,A00,896313,Carnelos; Chiara,18,0,20,2
1745145730105,LIIT 5BS,A00,896416,Carnelos; Chiara,20,0,20,0
1745145731136,LIIT 5CS,A00,896564,Carnelos; Chiara,20,0,20,0
1745145732164,LISP 5A,A00,896588,Munoz Sanchez; Alicia,7,0,20,13
1745145733190,LISP 5B,A00,896653,Munoz Sanchez; Alicia,10,0,20,10
1745145734220,LISP 5C,A00,896655,Munoz Sanchez; Alicia,9,0,20,11
1745145735246,MAE 197,001,957918,Kleissl; Jan,9998,0,9999,1
1745145736276,MATH 2,A01,957937,Staff,34,0,35,1
1745145737308,MATH 197,001,957876,Kedlaya; Kiran S.,9996,0,9999,3
1745145738340,MCWP 40,A00,892729,Duru; Nur,15,0,20,5
1745145738340,MCWP 40,B00,893304,Montejo; Carolina,20,0,20,0
1745145739370,MCWP 40R,A00,893757,Redela; Pamela Morgan,0,3,20,20
1745145740401,MCWP 50,A00,893758,Morshed; Michael James,4,0,20,16
1745145740401,MCWP 50,B00,893761,Bartulis; Jason Michael,18,0,20,2
1745145741433,MCWP 50R,A00,893766,Compas; Sean Matthew,0,1,20,20
1745145741433,MCWP 50R,B00,893769,Carter; Jennifer A,5,0,20,15
1745145741433,MCWP 50R,C00,893771,Krone; Jarret,0,3,20,20
1745145741433,MCWP 50R,D00,893772,Miller; Elizabeth Deen,4,0,20,16
1745145741433,MCWP 50R,E00,893775,Carter; Andrea L,0,0,20,20
1745145742464,MMW 11R,A01,892721,Herbst; Matthew,22,0,30,8
1745145742464,MMW 11R,A02,892722,Herbst; Matthew,28,0,30,2
1745145743490,MMW 12R,A01,892724,Herbst; Matthew,0,5,16,16
1745145743490,MMW 12R,A02,892725,Herbst; Matthew,0,4,16,16
1745145744521,MMW 13R,A01,892727,Staff,0,29,16,16
1745145744521,MMW 13R,A02,892728,Staff,0,28,16,16
1745145745549,SIO 295LS,A00,894015,Staff,9,0,25,16
1745145746576,SIO 295S,A00,894020,Staff,9,0,25,16
1745145747608,SIOC 290S,A01,894063,Merrifield; Mark A,23,0,25,2
1745145748637,SIOC 291S,A01,894137,Gabriel; Corey John,23,0,25,2
1745145749665,SOCI 117,A01,895339,Staff,5,0,5,0
1745145750715,WES 237B,A00,894149,Staff,20,0,20,0
1745145752791,AESE 279B,A00,891859,Staff,35,0,35,0
1745145753820,AIP 197,001,891854,Staff,70,0,70,0
1745145754845,ANTH 289S,A00,891856,Gagneux; Pascal,12,0,12,0
1745145755870,BENG 196,001,957946,Engler; Adam J.,9996,0,9999,3
1745145756895,CAT 124RS,A01,956906,Staff,8,0,25,17
1745145757923,CAT 125RS,A01,922013,Staff,8,0,25,17
1745145758950,CLRE 250,A00,891860,Morris; Sheldon,9996,0,9999,3
1745145761003,CLRE 251R,A00,907817,Mehta; Ravindra L.,9995,0,9999,4
1745145762040,CLRE 252,A00,891864,Cuomo; Raphael Eduardo,9994,0,9999,5
1745145763069,CLRE 253,A00,891867,Vaida; Florin,9995,0,9999,4
1745145763069,CLRE 253,B00,907819,Staff,9999,0,9999,0
1745145764097,CLRE 259,A00,891868,Patel; Hemal,9998,0,9999,1
1745145765127,CLRE 260,A00,891872,Cuomo; Raphael Eduardo,9999,0,9999,0
1745145766156,CLRE 297,001,891888,Cuomo; Raphael Eduardo,9999,0,9999,0
1745145767181,CSS 201S,A01,892054,Mignozzetti; Umberto,30,0,30,0
1745145768206,CSS 202S,A01,892056,Mignozzetti; Umberto,30,0,30,0
1745145769234,DSC 197,001,956898,Eldridge; Justin Matthew,9998,0,9999,1
1745145770261,DSC 297,001,958000,Mazumdar; Arya,9999,0,9999,0
1745145771285,EAP 100,A00,905686,Staff,9774,0,9999,225
1745145772316,ECE 45,A01,892618,Staff,0,2,50,50
1745145773346,ECE 109,A01,892620,Staff,0,44,0,0
1745145774372,ECE 111,A01,892719,Staff,0,0,50,50
1745145775400,ECE 197,001,957920,Mercier; Patrick Philip,9992,0,9999,7
1745145776426,ECON 178,A01,907814,Zhu; Ying,29,0,35,6
1745145777454,EDS 115,A00,895312,Staff,42,0,45,3
1745145778479,EDS 117,A01,895337,Staff,30,0,30,0
1745145779509,EDS 125,A00,895341,Jones; Gabrielle Anastasia,43,0,45,2
1745145780537,EDS 128A,A01,895459,Fargason; Sharon Gayle,45,0,45,0
1745145781563,EDS 128B,A01,895543,Pappas; Elizabeth,45,0,45,0
1745145782589,EDS 139,A00,897203,Pappas; Elizabeth,45,0,45,0
1745145782589,EDS 139,B00,897209,Fargason; Sharon Gayle,45,0,45,0
1745145783618,EDS 201,A00,895545,Staff,44,0,45,1
1745145784645,EDS 203,A01,895581,Halter; Christopher P.,44,0,45,1
1745145785672,EDS 204R,A01,895625,Heinzman; Erica M.,45,0,45,0
1745145785672,EDS 204R,B01,895693,Halter; Christopher P.,28,0,45,17
1745145786698,EDS 206R,A00,895694,Fargason; Sharon Gayle,22,0,30,8
1745145786698,EDS 206R,B00,895695,Choi; Bailey Miyeon,21,0,30,9
1745145787723,EDS 250,A00,895697,Hemans; Patricia Ann Benitez,44,0,45,1
1745145788751,EDS 281,A00,895701,Meyerott; Theresa Ann,15,0,15,0
1745145789779,EDS 284,A00,895736,Meyerott; Theresa Ann,15,0,15,0
1745145790807,EDS 286,A00,897210,Fine; Sarah,15,0,15,0
1745145791835,EDS 289C,A01,895770,Daly; Alan J.,15,0,15,0
1745145792863,EDS 290,A00,897211,Hofstetter; Carolyn,15,0,15,0
1745145793889,LIGM 5A,A00,896162,Fischer-Grunski; Eva K,16,0,20,4
1745145794915,LIGM 5B,A00,896260,Fischer-Grunski; Eva K,19,0,20,1
1745145795943,LIGM 5C,A00,896308,Fischer-Grunski; Eva K,19,0,20,1
1745145796972,LIIT 5AS,A00,896313,Carnelos; Chiara,18,0,20,2
1745145798004,LIIT 5BS,A00,896416,Carnelos; Chiara,20,0,20,0
1745145799031,LIIT 5CS,A00,896564,Carnelos; Chiara,20,0,20,0
1745145800063,LISP 5A,A00,896588,Munoz Sanchez; Alicia,7,0,20,13
1745145801087,LISP 5B,A00,896653,Munoz Sanchez; Alicia,10,0,20,10
1745145802113,LISP 5C,A00,896655,Munoz Sanchez; Alicia,9,0,20,11
1745145803140,MAE 197,001,957918,Kleissl; Jan,9998,0,9999,1
1745145804166,MATH 2,A01,957937,Staff,34,0,35,1
1745145805191,MATH 197,001,957876,Kedlaya; Kiran S.,9996,0,9999,3
1745145806222,MCWP 40,A00,892729,Duru; Nur,15,0,20,5
1745145806222,MCWP 40,B00,893304,Montejo; Carolina,20,0,20,0
1745145807250,MCWP 40R,A00,893757,Redela; Pamela Morgan,0,3,20,20
1745145808279,MCWP 50,A00,893758,Morshed; Michael James,4,0,20,16
1745145808279,MCWP 50,B00,893761,Bartulis; Jason Michael,18,0,20,2
1745145809310,MCWP 50R,A00,893766,Compas; Sean Matthew,0,1,20,20
1745145809310,MCWP 50R,B00,893769,Carter; Jennifer A,5,0,20,15
1745145809310,MCWP 50R,C00,893771,Krone; Jarret,0,3,20,20
1745145809310,MCWP 50R,D00,893772,Miller; Elizabeth Deen,4,0,20,16
1745145809310,MCWP 50R,E00,893775,Carter; Andrea L,0,0,20,20
1745145810336,MMW 11R,A01,892721,Herbst; Matthew,22,0,30,8
1745145810336,MMW 11R,A02,892722,Herbst; Matthew,28,0,30,2
1745145811366,MMW 12R,A01,892724,Herbst; Matthew,0,5,16,16
1745145811366,MMW 12R,A02,892725,Herbst; Matthew,0,4,16,16
1745145812390,MMW 13R,A01,892727,Staff,0,29,16,16
1745145812390,MMW 13R,A02,892728,Staff,0,28,16,16
1745145813416,SIO 295LS,A00,894015,Staff,9,0,25,16
1745145814444,SIO 295S,A00,894020,Staff,9,0,25,16
1745145815475,SIOC 290S,A01,894063,Merrifield; Mark A,23,0,25,2
1745145816501,SIOC 291S,A01,894137,Gabriel; Corey John,23,0,25,2
1745145817528,SOCI 117,A01,895339,Staff,5,0,5,0
1745145818554,WES 237B,A00,894149,Staff,20,0,20,0
1745145820647,AESE 279B,A00,891859,Staff,35,0,35,0
1745145821672,AIP 197,001,891854,Staff,70,0,70,0
1745145822698,ANTH 289S,A00,891856,Gagneux; Pascal,12,0,12,0
1745145823728,BENG 196,001,957946,Engler; Adam J.,9996,0,9999,3
1745145824757,CAT 124RS,A01,956906,Staff,8,0,25,17
1745145825783,CAT 125RS,A01,922013,Staff,8,0,25,17
1745145826811,CLRE 250,A00,891860,Morris; Sheldon,9996,0,9999,3
1745145828862,CLRE 251R,A00,907817,Mehta; Ravindra L.,9995,0,9999,4
1745145829887,CLRE 252,A00,891864,Cuomo; Raphael Eduardo,9994,0,9999,5
1745145830915,CLRE 253,A00,891867,Vaida; Florin,9995,0,9999,4
1745145830915,CLRE 253,B00,907819,Staff,9999,0,9999,0
1745145831945,CLRE 259,A00,891868,Patel; Hemal,9998,0,9999,1
1745145832975,CLRE 260,A00,891872,Cuomo; Raphael Eduardo,9999,0,9999,0
1745145834004,CLRE 297,001,891888,Cuomo; Raphael Eduardo,9999,0,9999,0
1745145835036,CSS 201S,A01,892054,Mignozzetti; Umberto,30,0,30,0
1745145836064,CSS 202S,A01,892056,Mignozzetti; Umberto,30,0,30,0
1745145837090,DSC 197,001,956898,Eldridge; Justin Matthew,9998,0,9999,1
1745145838116,DSC 297,001,958000,Mazumdar; Arya,9999,0,9999,0
1745145839201,EAP 100,A00,905686,Staff,9774,0,9999,225
1745145840232,ECE 45,A01,892618,Staff,0,2,50,50
1745145841260,ECE 109,A01,892620,Staff,0,44,0,0
1745145842290,ECE 111,A01,892719,Staff,0,0,50,50
1745145843316,ECE 197,001,957920,Mercier; Patrick Philip,9992,0,9999,7
1745145844347,ECON 178,A01,907814,Zhu; Ying,29,0,35,6
1745145845373,EDS 115,A00,895312,Staff,42,0,45,3
1745145846403,EDS 117,A01,895337,Staff,30,0,30,0
1745145847429,EDS 125,A00,895341,Jones; Gabrielle Anastasia,43,0,45,2
1745145848456,EDS 128A,A01,895459,Fargason; Sharon Gayle,45,0,45,0
1745145849483,EDS 128B,A01,895543,Pappas; Elizabeth,45,0,45,0
1745145850509,EDS 139,A00,897203,Pappas; Elizabeth,45,0,45,0
1745145850509,EDS 139,B00,897209,Fargason; Sharon Gayle,45,0,45,0
1745145851535,EDS 201,A00,895545,Staff,44,0,45,1
1745145852566,EDS 203,A01,895581,Halter; Christopher P.,44,0,45,1
1745145853594,EDS 204R,A01,895625,Heinzman; Erica M.,45,0,45,0
1745145853594,EDS 204R,B01,895693,Halter; Christopher P.,28,0,45,17
1745145854620,EDS 206R,A00,895694,Fargason; Sharon Gayle,22,0,30,8
1745145854620,EDS 206R,B00,895695,Choi; Bailey Miyeon,21,0,30,9
1745145855644,EDS 250,A00,895697,Hemans; Patricia Ann Benitez,44,0,45,1
1745145856672,EDS 281,A00,895701,Meyerott; Theresa Ann,15,0,15,0
1745145857700,EDS 284,A00,895736,Meyerott; Theresa Ann,15,0,15,0
1745145858729,EDS 286,A00,897210,Fine; Sarah,15,0,15,0
1745145859760,EDS 289C,A01,895770,Daly; Alan J.,15,0,15,0
1745145860790,EDS 290,A00,897211,Hofstetter; Carolyn,15,0,15,0
1745145861817,LIGM 5A,A00,896162,Fischer-Grunski; Eva K,16,0,20,4
1745145862844,LIGM 5B,A00,896260,Fischer-Grunski; Eva K,19,0,20,1
1745145863870,LIGM 5C,A00,896308,Fischer-Grunski; Eva K,19,0,20,1
1745145864895,LIIT 5AS,A00,896313,Carnelos; Chiara,18,0,20,2
1745145865922,LIIT 5BS,A00,896416,Carnelos; Chiara,20,0,20,0
1745145866952,LIIT 5CS,A00,896564,Carnelos; Chiara,20,0,20,0
1745145867984,LISP 5A,A00,896588,Munoz Sanchez; Alicia,7,0,20,13
1745145869012,LISP 5B,A00,896653,Munoz Sanchez; Alicia,10,0,20,10
1745145870038,LISP 5C,A00,896655,Munoz Sanchez; Alicia,9,0,20,11
1745145871068,MAE 197,001,957918,Kleissl; Jan,9998,0,9999,1
1745145872098,MATH 2,A01,957937,Staff,34,0,35,1
1745145873123,MATH 197,001,957876,Kedlaya; Kiran S.,9996,0,9999,3
1745145874152,MCWP 40,A00,892729,Duru; Nur,15,0,20,5
1745145874152,MCWP 40,B00,893304,Montejo; Carolina,20,0,20,0
1745145875180,MCWP 40R,A00,893757,Redela; Pamela Morgan,0,3,20,20
1745145876205,MCWP 50,A00,893758,Morshed; Michael James,4,0,20,16
1745145876205,MCWP 50,B00,893761,Bartulis; Jason Michael,18,0,20,2
1745145877238,MCWP 50R,A00,893766,Compas; Sean Matthew,0,1,20,20
1745145877238,MCWP 50R,B00,893769,Carter; Jennifer A,5,0,20,15
1745145877238,MCWP 50R,C00,893771,Krone; Jarret,0,3,20,20
1745145877238,MCWP 50R,D00,893772,Miller; Elizabeth Deen,4,0,20,16
1745145877238,MCWP 50R,E00,893775,Carter; Andrea L,0,0,20,20
1745145878266,MMW 11R,A01,892721,Herbst; Matthew,22,0,30,8
1745145878266,MMW 11R,A02,892722,Herbst; Matthew,28,0,30,2
1745145879291,MMW 12R,A01,892724,Herbst; Matthew,0,5,16,16
1745145879291,MMW 12R,A02,892725,Herbst; Matthew,0,4,16,16
1745145880317,MMW 13R,A01,892727,Staff,0,29,16,16
1745145880317,MMW 13R,A02,892728,Staff,0,28,16,16
1745145881345,SIO 295LS,A00,894015,Staff,9,0,25,16
1745145882387,SIO 295S,A00,894020,Staff,9,0,25,16
1745145883415,SIOC 290S,A01,894063,Merrifield; Mark A,23,0,25,2
1745145884441,SIOC 291S,A01,894137,Gabriel; Corey John,23,0,25,2
1745145885466,SOCI 117,A01,895339,Staff,5,0,5,0
1745145886491,WES 237B,A00,894149,Staff,20,0,20,0
1745145888576,AESE 279B,A00,891859,Staff,35,0,35,0
1745145889602,AIP 197,001,891854,Staff,70,0,70,0
1745145890628,ANTH 289S,A00,891856,Gagneux; Pascal,12,0,12,0
1745145891656,BENG 196,001,957946,Engler; Adam J.,9996,0,9999,3
1745145892684,CAT 124RS,A01,956906,Staff,8,0,25,17
1745145893713,CAT 125RS,A01,922013,Staff,8,0,25,17
1745145894738,CLRE 250,A00,891860,Morris; Sheldon,9996,0,9999,3
1745145896796,CLRE 251R,A00,907817,Mehta; Ravindra L.,9995,0,9999,4
1745145897825,CLRE 252,A00,891864,Cuomo; Raphael Eduardo,9994,0,9999,5
1745145898852,CLRE 253,A00,891867,Vaida; Florin,9995,0,9999,4
1745145898852,CLRE 253,B00,907819,Staff,9999,0,9999,0
1745145899883,CLRE 259,A00,891868,Patel; Hemal,9998,0,9999,1
1745145900913,CLRE 260,A00,891872,Cuomo; Raphael Eduardo,9999,0,9999,0
1745145901945,CLRE 297,001,891888,Cuomo; Raphael Eduardo,9999,0,9999,0
1745145902972,CSS 201S,A01,892054,Mignozzetti; Umberto,30,0,30,0
1745145904005,CSS 202S,A01,892056,Mignozzetti; Umberto,30,0,30,0
1745145905032,DSC 197,001,956898,Eldridge; Justin Matthew,9998,0,9999,1
1745145906057,DSC 297,001,958000,Mazumdar; Arya,9999,0,9999,0
1745145907088,EAP 100,A00,905686,Staff,9774,0,9999,225
1745145908118,ECE 45,A01,892618,Staff,0,2,50,50
1745145909143,ECE 109,A01,892620,Staff,0,44,0,0
1745145910170,ECE 111,A01,892719,Staff,0,0,50,50
1745145911194,ECE 197,001,957920,Mercier; Patrick Philip,9992,0,9999,7
1745145912222,ECON 178,A01,907814,Zhu; Ying,29,0,35,6
1745145913248,EDS 115,A00,895312,Staff,42,0,45,3
1745145914279,EDS 117,A01,895337,Staff,30,0,30,0
1745145915307,EDS 125,A00,895341,Jones; Gabrielle Anastasia,43,0,45,2
1745145916333,EDS 128A,A01,895459,Fargason; Sharon Gayle,45,0,45,0
1745145917359,EDS 128B,A01,895543,Pappas; Elizabeth,45,0,45,0
1745145918387,EDS 139,A00,897203,Pappas; Elizabeth,45,0,45,0
1745145918387,EDS 139,B00,897209,Fargason; Sharon Gayle,45,0,45,0
1745145919417,EDS 201,A00,895545,Staff,44,0,45,1
1745145920447,EDS 203,A01,895581,Halter; Christopher P.,44,0,45,1
1745145921473,EDS 204R,A01,895625,Heinzman; Erica M.,45,0,45,0
1745145921473,EDS 204R,B01,895693,Halter; Christopher P.,28,0,45,17
1745145922498,EDS 206R,A00,895694,Fargason; Sharon Gayle,22,0,30,8
1745145922498,EDS 206R,B00,895695,Choi; Bailey Miyeon,21,0,30,9
1745145923528,EDS 250,A00,895697,Hemans; Patricia Ann Benitez,44,0,45,1
1745145924553,EDS 281,A00,895701,Meyerott; Theresa Ann,15,0,15,0
1745145925581,EDS 284,A00,895736,Meyerott; Theresa Ann,15,0,15,0
1745145926609,EDS 286,A00,897210,Fine; Sarah,15,0,15,0
1745145927636,EDS 289C,A01,895770,Daly; Alan J.,15,0,15,0
1745145928663,EDS 290,A00,897211,Hofstetter; Carolyn,15,0,15,0
1745145929694,LIGM 5A,A00,896162,Fischer-Grunski; Eva K,16,0,20,4
1745145930727,LIGM 5B,A00,896260,Fischer-Grunski; Eva K,19,0,20,1
1745145931754,LIGM 5C,A00,896308,Fischer-Grunski; Eva K,19,0,20,1
1745145932783,LIIT 5AS,A00,896313,Carnelos; Chiara,18,0,20,2
1745145933809,LIIT 5BS,A00,896416,Carnelos; Chiara,20,0,20,0
1745145934835,LIIT 5CS,A00,896564,Carnelos; Chiara,20,0,20,0
1745145935863,LISP 5A,A00,896588,Munoz Sanchez; Alicia,7,0,20,13
1745145936888,LISP 5B,A00,896653,Munoz Sanchez; Alicia,10,0,20,10
1745145937914,LISP 5C,A00,896655,Munoz Sanchez; Alicia,9,0,20,11
1745145938940,MAE 197,001,957918,Kleissl; Jan,9998,0,9999,1
1745145939967,MATH 2,A01,957937,Staff,34,0,35,1
1745145940999,MATH 197,001,957876,Kedlaya; Kiran S.,9996,0,9999,3
1745145942024,MCWP 40,A00,892729,Duru; Nur,15,0,20,5
1745145942024,MCWP 40,B00,893304,Montejo; Carolina,20,0,20,0
1745145943095,MCWP 40R,A00,893757,Redela; Pamela Morgan,0,3,20,20
1745145944126,MCWP 50,A00,893758,Morshed; Michael James,4,0,20,16
1745145944126,MCWP 50,B00,893761,Bartulis; Jason Michael,18,0,20,2
1745145945152,MCWP 50R,A00,893766,Compas; Sean Matthew,0,1,20,20
1745145945152,MCWP 50R,B00,893769,Carter; Jennifer A,5,0,20,15
1745145945152,MCWP 50R,C00,893771,Krone; Jarret,0,3,20,20
1745145945152,MCWP 50R,D00,893772,Miller; Elizabeth Deen,4,0,20,16
1745145945152,MCWP 50R,E00,893775,Carter; Andrea L,0,0,20,20
1745145946179,MMW 11R,A01,892721,Herbst; Matthew,22,0,30,8
1745145946179,MMW 11R,A02,892722,Herbst; Matthew,28,0,30,2
1745145947211,MMW 12R,A01,892724,Herbst; Matthew,0,5,16,16
1745145947211,MMW 12R,A02,892725,Herbst; Matthew,0,4,16,16
1745145948237,MMW 13R,A01,892727,Staff,0,29,16,16
1745145948237,MMW 13R,A02,892728,Staff,0,28,16,16
1745145949263,SIO 295LS,A00,894015,Staff,9,0,25,16
1745145950292,SIO 295S,A00,894020,Staff,9,0,25,16
1745145951319,SIOC 290S,A01,894063,Merrifield; Mark A,23,0,25,2
1745145952350,SIOC 291S,A01,894137,Gabriel; Corey John,23,0,25,2
1745145953379,SOCI 117,A01,895339,Staff,5,0,5,0
1745145954406,WES 237B,A00,894149,Staff,20,0,20,0
1745145956476,AESE 279B,A00,891859,Staff,35,0,35,0
1745145957506,AIP 197,001,891854,Staff,70,0,70,0
1745145958531,ANTH 289S,A00,891856,Gagneux; Pascal,12,0,12,0
1745145959557,BENG 196,001,957946,Engler; Adam J.,9996,0,9999,3
1745145960587,CAT 124RS,A01,956906,Staff,8,0,25,17
1745145961620,CAT 125RS,A01,922013,Staff,8,0,25,17
1745145962646,CLRE 250,A00,891860,Morris; Sheldon,9996,0,9999,3
1745145964706,CLRE 251R,A00,907817,Mehta; Ravindra L.,9995,0,9999,4
1745145965737,CLRE 252,A00,891864,Cuomo; Raphael Eduardo,9994,0,9999,5
1745145966764,CLRE 253,A00,891867,Vaida; Florin,9995,0,9999,4
1745145966764,CLRE 253,B00,907819,Staff,9999,0,9999,0
1745145967791,CLRE 259,A00,891868,Patel; Hemal,9998,0,9999,1
1745145968823,CLRE 260,A00,891872,Cuomo; Raphael Eduardo,9999,0,9999,0
1745145969853,CLRE 297,001,891888,Cuomo; Raphael Eduardo,9999,0,9999,0
1745145970887,CSS 201S,A01,892054,Mignozzetti; Umberto,30,0,30,0
1745145971917,CSS 202S,A01,892056,Mignozzetti; Umberto,30,0,30,0
1745145972943,DSC 197,001,956898,Eldridge; Justin Matthew,9998,0,9999,1
1745145973971,DSC 297,001,958000,Mazumdar; Arya,9999,0,9999,0
1745145974999,EAP 100,A00,905686,Staff,9774,0,9999,225
1745145976024,ECE 45,A01,892618,Staff,0,2,50,50
1745145977050,ECE 109,A01,892620,Staff,0,44,0,0
1745145978075,ECE 111,A01,892719,Staff,0,0,50,50
1745145979100,ECE 197,001,957920,Mercier; Patrick Philip,9992,0,9999,7
1745145980125,ECON 178,A01,907814,Zhu; Ying,29,0,35,6
1745145981152,EDS 115,A00,895312,Staff,42,0,45,3
1745145982178,EDS 117,A01,895337,Staff,30,0,30,0
1745145983208,EDS 125,A00,895341,Jones; Gabrielle Anastasia,43,0,45,2
1745145984238,EDS 128A,A01,895459,Fargason; Sharon Gayle,45,0,45,0
1745145985264,EDS 128B,A01,895543,Pappas; Elizabeth,45,0,45,0
1745145986290,EDS 139,A00,897203,Pappas; Elizabeth,45,0,45,0
1745145986290,EDS 139,B00,897209,Fargason; Sharon Gayle,45,0,45,0
1745145987317,EDS 201,A00,895545,Staff,44,0,45,1
1745145988348,EDS 203,A01,895581,Halter; Christopher P.,44,0,45,1
1745145989380,EDS 204R,A01,895625,Heinzman; Erica M.,45,0,45,0
1745145989380,EDS 204R,B01,895693,Halter; Christopher P.,28,0,45,17
1745145990408,EDS 206R,A00,895694,Fargason; Sharon Gayle,22,0,30,8
1745145990408,EDS 206R,B00,895695,Choi; Bailey Miyeon,21,0,30,9
1745145991435,EDS 250,A00,895697,Hemans; Patricia Ann Benitez,44,0,45,1
1745145992464,EDS 281,A00,895701,Meyerott; Theresa Ann,15,0,15,0
1745145993489,EDS 284,A00,895736,Meyerott; Theresa Ann,15,0,15,0
1745145994515,EDS 286,A00,897210,Fine; Sarah,15,0,15,0
1745145995545,EDS 289C,A01,895770,Daly; Alan J.,15,0,15,0
1745145996574,EDS 290,A00,897211,Hofstetter; Carolyn,15,0,15,0
1745145997604,LIGM 5A,A00,896162,Fischer-Grunski; Eva K,16,0,20,4
1745145998640,LIGM 5B,A00,896260,Fischer-Grunski; Eva K,19,0,20,1
1745145999666,LIGM 5C,A00,896308,Fischer-Grunski; Eva K,19,0,20,1
1745146000697,LIIT 5AS,A00,896313,Carnelos; Chiara,18,0,20,2
1745146001723,LIIT 5BS,A00,896416,Carnelos; Chiara,20,0,20,0
1745146002749,LIIT 5CS,A00,896564,Carnelos; Chiara,20,0,20,0
1745146003774,LISP 5A,A00,896588,Munoz Sanchez; Alicia,7,0,20,13
1745146004799,LISP 5B,A00,896653,Munoz Sanchez; Alicia,10,0,20,10
1745146005825,LISP 5C,A00,896655,Munoz Sanchez; Alicia,9,0,20,11
1745146006853,MAE 197,001,957918,Kleissl; Jan,9998,0,9999,1
1745146007879,MATH 2,A01,957937,Staff,34,0,35,1
1745146008904,MATH 197,001,957876,Kedlaya; Kiran S.,9996,0,9999,3
1745146009935,MCWP 40,A00,892729,Duru; Nur,15,0,20,5
1745146009935,MCWP 40,B00,893304,Montejo; Carolina,20,0,20,0
1745146010959,MCWP 40R,A00,893757,Redela; Pamela Morgan,0,3,20,20
1745146011984,MCWP 50,A00,893758,Morshed; Michael James,4,0,20,16
1745146011984,MCWP 50,B00,893761,Bartulis; Jason Michael,18,0,20,2
1745146013010,MCWP 50R,A00,893766,Compas; Sean Matthew,0,1,20,20
1745146013010,MCWP 50R,B00,893769,Carter; Jennifer A,5,0,20,15
1745146013010,MCWP 50R,C00,893771,Krone; Jarret,0,3,20,20
1745146013010,MCWP 50R,D00,893772,Miller; Elizabeth Deen,4,0,20,16
1745146013010,MCWP 50R,E00,893775,Carter; Andrea L,0,0,20,20
1745146014077,MMW 11R,A01,892721,Herbst; Matthew,22,0,30,8
1745146014077,MMW 11R,A02,892722,Herbst; Matthew,28,0,30,2
1745146015102,MMW 12R,A01,892724,Herbst; Matthew,0,5,16,16
1745146015102,MMW 12R,A02,892725,Herbst; Matthew,0,4,16,16
1745146016130,MMW 13R,A01,892727,Staff,0,29,16,16
1745146016130,MMW 13R,A02,892728,Staff,0,28,16,16
1745146017164,SIO 295LS,A00,894015,Staff,9,0,25,16
1745146018194,SIO 295S,A00,894020,Staff,9,0,25,16
1745146019220,SIOC 290S,A01,894063,Merrifield; Mark A,23,0,25,2
1745146020246,SIOC 291S,A01,894137,Gabriel; Corey John,23,0,25,2
1745146021271,SOCI 117,A01,895339,Staff,5,0,5,0
1745146022301,WES 237B,A00,894149,Staff,20,0,20,0
1745146024393,AESE 279B,A00,891859,Staff,35,0,35,0
1745146025428,AIP 197,001,891854,Staff,70,0,70,0
1745146026493,ANTH 289S,A00,891856,Gagneux; Pascal,12,0,12,0
1745146027524,BENG 196,001,957946,Engler; Adam J.,9996,0,9999,3
1745146028553,CAT 124RS,A01,956906,Staff,8,0,25,17
1745146029581,CAT 125RS,A01,922013,Staff,8,0,25,17
1745146030610,CLRE 250,A00,891860,Morris; Sheldon,9996,0,9999,3
1745146032665,CLRE 251R,A00,907817,Mehta; Ravindra L.,9995,0,9999,4
1745146033695,CLRE 252,A00,891864,Cuomo; Raphael Eduardo,9994,0,9999,5
1745146034723,CLRE 253,A00,891867,Vaida; Florin,9995,0,9999,4
1745146034723,CLRE 253,B00,907819,Staff,9999,0,9999,0
1745146035750,CLRE 259,A00,891868,Patel; Hemal,9998,0,9999,1
1745146036776,CLRE 260,A00,891872,Cuomo; Raphael Eduardo,9999,0,9999,0
1745146037805,CLRE 297,001,891888,Cuomo; Raphael Eduardo,9999,0,9999,0
1745146038831,CSS 201S,A01,892054,Mignozzetti; Umberto,30,0,30,0
1745146039861,CSS 202S,A01,892056,Mignozzetti; Umberto,30,0,30,0
1745146040889,DSC 197,001,956898,Eldridge; Justin Matthew,9998,0,9999,1
1745146041914,DSC 297,001,958000,Mazumdar; Arya,9999,0,9999,0
1745146042940,EAP 100,A00,905686,Staff,9774,0,9999,225
1745146043965,ECE 45,A01,892618,Staff,0,2,50,50
1745146044993,ECE 109,A01,892620,Staff,0,44,0,0
1745146046018,ECE 111,A01,892719,Staff,0,0,50,50
1745146047042,ECE 197,001,957920,Mercier; Patrick Philip,9992,0,9999,7
1745146048068,ECON 178,A01,907814,Zhu; Ying,29,0,35,6
1745146049097,EDS 115,A00,895312,Staff,42,0,45,3
1745146050125,EDS 117,A01,895337,Staff,30,0,30,0
1745146051154,EDS 125,A00,895341,Jones; Gabrielle Anastasia,43,0,45,2
1745146052180,EDS 128A,A01,895459,Fargason; Sharon Gayle,45,0,45,0
1745146053209,EDS 128B,A01,895543,Pappas; Elizabeth,45,0,45,0
1745146054238,EDS 139,A00,897203,Pappas; Elizabeth,45,0,45,0
1745146054238,EDS 139,B00,897209,Fargason; Sharon Gayle,45,0,45,0
1745146055267,EDS 201,A00,895545,Staff,44,0,45,1
1745146056292,EDS 203,A01,895581,Halter; Christopher P.,44,0,45,1
1745146057317,EDS 204R,A01,895625,Heinzman; Erica M.,45,0,45,0
1745146057317,EDS 204R,B01,895693,Halter; Christopher P.,28,0,45,17
1745146058343,EDS 206R,A00,895694,Fargason; Sharon Gayle,22,0,30,8
1745146058343,EDS 206R,B00,895695,Choi; Bailey Miyeon,21,0,30,9
1745146059372,EDS 250,A00,895697,Hemans; Patricia Ann Benitez,44,0,45,1
1745146060400,EDS 281,A00,895701,Meyerott; Theresa Ann,15,0,15,0
1745146061427,EDS 284,A00,895736,Meyerott; Theresa Ann,15,0,15,0
1745146062454,EDS 286,A00,897210,Fine; Sarah,15,0,15,0
1745146063480,EDS 289C,A01,895770,Daly; Alan J.,15,0,15,0
1745146064507,EDS 290,A00,897211,Hofstetter; Carolyn,15,0,15,0
1745146065538,LIGM 5A,A00,896162,Fischer-Grunski; Eva K,16,0,20,4
1745146066567,LIGM 5B,A00,896260,Fischer-Grunski; Eva K,19,0,20,1
1745146067592,LIGM 5C,A00,896308,Fischer-Grunski; Eva K,19,0,20,1
1745146068621,LIIT 5AS,A00,896313,Carnelos; Chiara,18,0,20,2
1745146069652,LIIT 5BS,A00,896416,Carnelos; Chiara,20,0,20,0
1745146070677,LIIT 5CS,A00,896564,Carnelos; Chiara,20,0,20,0
1745146071704,LISP 5A,A00,896588,Munoz Sanchez; Alicia,7,0,20,13
1745146072732,LISP 5B,A00,896653,Munoz Sanchez; Alicia,10,0,20,10
1745146073757,LISP 5C,A00,896655,Munoz Sanchez; Alicia,9,0,20,11
1745146074787,MAE 197,001,957918,Kleissl; Jan,9998,0,9999,1
1745146075816,MATH 2,A01,957937,Staff,34,0,35,1
1745146076842,MATH 197,001,957876,Kedlaya; Kiran S.,9996,0,9999,3
1745146077870,MCWP 40,A00,892729,Duru; Nur,15,0,20,5
1745146077870,MCWP 40,B00,893304,Montejo; Carolina,20,0,20,0
1745146078897,MCWP 40R,A00,893757,Redela; Pamela Morgan,0,3,20,20
1745146079926,MCWP 50,A00,893758,Morshed; Michael James,4,0,20,16
1745146079926,MCWP 50,B00,893761,Bartulis; Jason Michael,18,0,20,2
1745146080951,MCWP 50R,A00,893766,Compas; Sean Matthew,0,1,20,20
1745146080951,MCWP 50R,B00,893769,Carter; Jennifer A,5,0,20,15
1745146080951,MCWP 50R,C00,893771,Krone; Jarret,0,3,20,20
1745146080951,MCWP 50R,D00,893772,Miller; Elizabeth Deen,4,0,20,16
1745146080951,MCWP 50R,E00,893775,Carter; Andrea L,0,0,20,20
1745146081979,MMW 11R,A01,892721,Herbst; Matthew,22,0,30,8
1745146081979,MMW 11R,A02,892722,Herbst; Matthew,28,0,30,2
1745146083006,MMW 12R,A01,892724,Herbst; Matthew,0,5,16,16
1745146083006,MMW 12R,A02,892725,Herbst; Matthew,0,4,16,16
1745146084033,MMW 13R,A01,892727,Staff,0,29,16,16
1745146084033,MMW 13R,A02,892728,Staff,0,28,16,16
1745146085059,SIO 295LS,A00,894015,Staff,9,0,25,16
1745146086089,SIO 295S,A00,894020,Staff,9,0,25,16
1745146087115,SIOC 290S,A01,894063,Merrifield; Mark A,23,0,25,2
1745146088146,SIOC 291S,A01,894137,Gabriel; Corey John,23,0,25,2
1745146089171,SOCI 117,A01,895339,Staff,5,0,5,0
1745146090197,WES 237B,A00,894149,Staff,20,0,20,0
1745146092279,AESE 279B,A00,891859,Staff,35,0,35,0
1745146093306,AIP 197,001,891854,Staff,70,0,70,0
1745146094333,ANTH 289S,A00,891856,Gagneux; Pascal,12,0,12,0
1745146095360,BENG 196,001,957946,Engler; Adam J.,9996,0,9999,3
1745146096387,CAT 124RS,A01,956906,Staff,8,0,25,17
1745146097416,CAT 125RS,A01,922013,Staff,8,0,25,17
1745146098448,CLRE 250,A00,891860,Morris; Sheldon,9996,0,9999,3
1745146100499,CLRE 251R,A00,907817,Mehta; Ravindra L.,9995,0,9999,4
1745146101525,CLRE 252,A00,891864,Cuomo; Raphael Eduardo,9994,0,9999,5
1745146102552,CLRE 253,A00,891867,Vaida; Florin,9995,0,9999,4
1745146102552,CLRE 253,B00,907819,Staff,9999,0,9999,0
1745146103581,CLRE 259,A00,891868,Patel; Hemal,9998,0,9999,1
1745146104607,CLRE 260,A00,891872,Cuomo; Raphael Eduardo,9999,0,9999,0
1745146105636,CLRE 297,001,891888,Cuomo; Raphael Eduardo,9999,0,9999,0
1745146106661,CSS 201S,A01,892054,Mignozzetti; Umberto,30,0,30,0
1745146107687,CSS 202S,A01,892056,Mignozzetti; Umberto,30,0,30,0
1745146108715,DSC 197,001,956898,Eldridge; Justin Matthew,9998,0,9999,1
1745146109742,DSC 297,001,958000,Mazumdar; Arya,9999,0,9999,0
1745146110770,EAP 100,A00,905686,Staff,9774,0,9999,225
1745146111800,ECE 45,A01,892618,Staff,0,2,50,50
1745146112827,ECE 109,A01,892620,Staff,0,44,0,0
1745146113854,ECE 111,A01,892719,Staff,0,0,50,50
1745146114880,ECE 197,001,957920,Mercier; Patrick Philip,9992,0,9999,7
1745146115908,ECON 178,A01,907814,Zhu; Ying,29,0,35,6
1745146116942,EDS 115,A00,895312,Staff,42,0,45,3
1745146117973,EDS 117,A01,895337,Staff,30,0,30,0
1745146118997,EDS 125,A00,895341,Jones; Gabrielle Anastasia,43,0,45,2
1745146120024,EDS 128A,A01,895459,Fargason; Sharon Gayle,45,0,45,0
1745146121050,EDS 128B,A01,895543,Pappas; Elizabeth,45,0,45,0
1745146122077,EDS 139,A00,897203,Pappas; Elizabeth,45,0,45,0
1745146122077,EDS 139,B00,897209,Fargason; Sharon Gayle,45,0,45,0
1745146123107,EDS 201,A00,895545,Staff,44,0,45,1
1745146124137,EDS 203,A01,895581,Halter; Christopher P.,44,0,45,1
1745146125163,EDS 204R,A01,895625,Heinzman; Erica M.,45,0,45,0
1745146125163,EDS 204R,B01,895693,Halter; Christopher P.,28,0,45,17
1745146126189,EDS 206R,A00,895694,Fargason; Sharon Gayle,22,0,30,8
1745146126189,EDS 206R,B00,895695,Choi; Bailey Miyeon,21,0,30,9
1745146127218,EDS 250,A00,895697,Hemans; Patricia Ann Benitez,44,0,45,1
1745146128246,EDS 281,A00,895701,Meyerott; Theresa Ann,15,0,15,0
1745146129273,EDS 284,A00,895736,Meyerott; Theresa Ann,15,0,15,0
1745146130304,EDS 286,A00,897210,Fine; Sarah,15,0,15,0
1745146131329,EDS 289C,A01,895770,Daly; Alan J.,15,0,15,0
1745146132356,EDS 290,A00,897211,Hofstetter; Carolyn,15,0,15,0
1745146133384,LIGM 5A,A00,896162,Fischer-Grunski; Eva K,16,0,20,4
1745146134414,LIGM 5B,A00,896260,Fischer-Grunski; Eva K,19,0,20,1
1745146135441,LIGM 5C,A00,896308,Fischer-Grunski; Eva K,19,0,20,1
1745146136469,LIIT 5AS,A00,896313,Carnelos; Chiara,18,0,20,2
1745146137496,LIIT 5BS,A00,896416,Carnelos; Chiara,20,0,20,0
1745146138521,LIIT 5CS,A00,896564,Carnelos; Chiara,20,0,20,0
1745146139554,LISP 5A,A00,896588,Munoz Sanchez; Alicia,7,0,20,13
1745146140579,LISP 5B,A00,896653,Munoz Sanchez; Alicia,10,0,20,10
1745146141605,LISP 5C,A00,896655,Munoz Sanchez; Alicia,9,0,20,11
1745146142640,MAE 197,001,957918,Kleissl; Jan,9998,0,9999,1
1745146143666,MATH 2,A01,957937,Staff,34,0,35,1
1745146144697,MATH 197,001,957876,Kedlaya; Kiran S.,9996,0,9999,3
1745146145729,MCWP 40,A00,892729,Duru; Nur,15,0,20,5
1745146145729,MCWP 40,B00,893304,Montejo; Carolina,20,0,20,0
1745146146761,MCWP 40R,A00,893757,Redela; Pamela Morgan,0,3,20,20
1745146147788,MCWP 50,A00,893758,Morshed; Michael James,4,0,20,16
1745146147788,MCWP 50,B00,893761,Bartulis; Jason Michael,18,0,20,2
1745146148821,MCWP 50R,A00,893766,Compas; Sean Matthew,0,1,20,20
1745146148821,MCWP 50R,B00,893769,Carter; Jennifer A,5,0,20,15
1745146148821,MCWP 50R,C00,893771,Krone; Jarret,0,3,20,20
1745146148821,MCWP 50R,D00,893772,Miller; Elizabeth Deen,4,0,20,16
1745146148821,MCWP 50R,E00,893775,Carter; Andrea L,0,0,20,20
1745146149849,MMW 11R,A01,892721,Herbst; Matthew,22,0,30,8
1745146149849,MMW 11R,A02,892722,Herbst; Matthew,28,0,30,2
1745146150877,MMW 12R,A01,892724,Herbst; Matthew,0,5,16,16
1745146150877,MMW 12R,A02,892725,Herbst; Matthew,0,4,16,16
1745146151903,MMW 13R,A01,892727,Staff,0,29,16,16
1745146151903,MMW 13R,A02,892728,Staff,0,28,16,16
1745146152930,SIO 295LS,A00,894015,Staff,9,0,25,16
1745146153955,SIO 295S,A00,894020,Staff,9,0,25,16
1745146154985,SIOC 290S,A01,894063,Merrifield; Mark A,23,0,25,2
1745146156011,SIOC 291S,A01,894137,Gabriel; Corey John,23,0,25,2
1745146157038,SOCI 117,A01,895339,Staff,5,0,5,0
1745146158065,WES 237B,A00,894149,Staff,20,0,20,0
1745146160140,AESE 279B,A00,891859,Staff,35,0,35,0
1745146161166,AIP 197,001,891854,Staff,70,0,70,0
1745146162193,ANTH 289S,A00,891856,Gagneux; Pascal,12,0,12,0
1745146163222,BENG 196,001,957946,Engler; Adam J.,9996,0,9999,3
1745146164248,CAT 124RS,A01,956906,Staff,8,0,25,17
1745146165274,CAT 125RS,A01,922013,Staff,8,0,25,17
1745146166303,CLRE 250,A00,891860,Morris; Sheldon,9996,0,9999,3
1745146168358,CLRE 251R,A00,907817,Mehta; Ravindra L.,9995,0,9999,4
1745146169386,CLRE 252,A00,891864,Cuomo; Raphael Eduardo,9994,0,9999,5
1745146170412,CLRE 253,A00,891867,Vaida; Florin,9995,0,9999,4
1745146170412,CLRE 253,B00,907819,Staff,9999,0,9999,0
1745146171437,CLRE 259,A00,891868,Patel; Hemal,9998,0,9999,1
1745146172465,CLRE 260,A00,891872,Cuomo; Raphael Eduardo,9999,0,9999,0
1745146173491,CLRE 297,001,891888,Cuomo; Raphael Eduardo,9999,0,9999,0
1745146174518,CSS 201S,A01,892054,Mignozzetti; Umberto,30,0,30,0
1745146175545,CSS 202S,A01,892056,Mignozzetti; Umberto,30,0,30,0
1745146176574,DSC 197,001,956898,Eldridge; Justin Matthew,9998,0,9999,1
1745146177600,DSC 297,001,958000,Mazumdar; Arya,9999,0,9999,0
1745146178629,EAP 100,A00,905686,Staff,9774,0,9999,225
1745146179658,ECE 45,A01,892618,Staff,0,2,50,50
1745146180684,ECE 109,A01,892620,Staff,0,44,0,0
1745146181712,ECE 111,A01,892719,Staff,0,0,50,50
1745146182742,ECE 197,001,957920,Mercier; Patrick Philip,9992,0,9999,7
1745146183768,ECON 178,A01,907814,Zhu; Ying,29,0,35,6
1745146184799,EDS 115,A00,895312,Staff,42,0,45,3
1745146185825,EDS 117,A01,895337,Staff,30,0,30,0
1745146186851,EDS 125,A00,895341,Jones; Gabrielle Anastasia,43,0,45,2
1745146187879,EDS 128A,A01,895459,Fargason; Sharon Gayle,45,0,45,0
1745146188907,EDS 128B,A01,895543,Pappas; Elizabeth,45,0,45,0
1745146189933,EDS 139,A00,897203,Pappas; Elizabeth,45,0,45,0
1745146189933,EDS 139,B00,897209,Fargason; Sharon Gayle,45,0,45,0
1745146190958,EDS 201,A00,895545,Staff,44,0,45,1
1745146191987,EDS 203,A01,895581,Halter; Christopher P.,44,0,45,1
1745146193014,EDS 204R,A01,895625,Heinzman; Erica M.,45,0,45,0
1745146193014,EDS 204R,B01,895693,Halter; Christopher P.,28,0,45,17
1745146194038,EDS 206R,A00,895694,Fargason; Sharon Gayle,22,0,30,8
1745146194038,EDS 206R,B00,895695,Choi; Bailey Miyeon,21,0,30,9
1745146195068,EDS 250,A00,895697,Hemans; Patricia Ann Benitez,44,0,45,1
1745146196092,EDS 281,A00,895701,Meyerott; Theresa Ann,15,0,15,0
1745146197116,EDS 284,A00,895736,Meyerott; Theresa Ann,15,0,15,0
1745146198143,EDS 286,A00,897210,Fine; Sarah,15,0,15,0
1745146199169,EDS 289C,A01,895770,Daly; Alan J.,15,0,15,0
1745146200195,EDS 290,A00,897211,Hofstetter; Carolyn,15,0,15,0
1745146201226,LIGM 5A,A00,896162,Fischer-Grunski; Eva K,16,0,20,4
1745146202258,LIGM 5B,A00,896260,Fischer-Grunski; Eva K,19,0,20,1
1745146203288,LIGM 5C,A00,896308,Fischer-Grunski; Eva K,19,0,20,1
1745146204315,LIIT 5AS,A00,896313,Carnelos; Chiara,18,0,20,2
1745146205345,LIIT 5BS,A00,896416,Carnelos; Chiara,20,0,20,0
1745146206370,LIIT 5CS,A00,896564,Carnelos; Chiara,20,0,20,0
1745146207397,LISP 5A,A00,896588,Munoz Sanchez; Alicia,7,0,20,13
1745146208424,LISP 5B,A00,896653,Munoz Sanchez; Alicia,10,0,20,10
1745146209452,LISP 5C,A00,896655,Munoz Sanchez; Alicia,9,0,20,11
1745146210478,MAE 197,001,957918,Kleissl; Jan,9998,0,9999,1
1745146211504,MATH 2,A01,957937,Staff,34,0,35,1
1745146212532,MATH 197,001,957876,Kedlaya; Kiran S.,9996,0,9999,3
1745146213559,MCWP 40,A00,892729,Duru; Nur,15,0,20,5
1745146213559,MCWP 40,B00,893304,Montejo; Carolina,20,0,20,0
1745146214587,MCWP 40R,A00,893757,Redela; Pamela Morgan,0,3,20,20
1745146215614,MCWP 50,A00,893758,Morshed; Michael James,4,0,20,16
1745146215614,MCWP 50,B00,893761,Bartulis; Jason Michael,18,0,20,2
1745146216641,MCWP 50R,A00,893766,Compas; Sean Matthew,0,1,20,20
1745146216641,MCWP 50R,B00,893769,Carter; Jennifer A,5,0,20,15
1745146216641,MCWP 50R,C00,893771,Krone; Jarret,0,3,20,20
1745146216641,MCWP 50R,D00,893772,Miller; Elizabeth Deen,4,0,20,16
1745146216641,MCWP 50R,E00,893775,Carter; Andrea L,0,0,20,20
1745146217670,MMW 11R,A01,892721,Herbst; Matthew,22,0,30,8
1745146217670,MMW 11R,A02,892722,Herbst; Matthew,28,0,30,2
1745146218697,MMW 12R,A01,892724,Herbst; Matthew,0,5,16,16
1745146218697,MMW 12R,A02,892725,Herbst; Matthew,0,4,16,16
1745146219723,MMW 13R,A01,892727,Staff,0,29,16,16
1745146219723,MMW 13R,A02,892728,Staff,0,28,16,16
1745146220753,SIO 295LS,A00,894015,Staff,9,0,25,16
1745146221778,SIO 295S,A00,894020,Staff,9,0,25,16
1745146222810,SIOC 290S,A01,894063,Merrifield; Mark A,23,0,25,2
1745146223840,SIOC 291S,A01,894137,Gabriel; Corey John,23,0,25,2
1745146224866,SOCI 117,A01,895339,Staff,5,0,5,0
1745146225896,WES 237B,A00,894149,Staff,20,0,20,0
1745146227977,AESE 279B,A00,891859,Staff,35,0,35,0
1745146229002,AIP 197,001,891854,Staff,70,0,70,0
1745146230027,ANTH 289S,A00,891856,Gagneux; Pascal,12,0,12,0
1745146231057,BENG 196,001,957946,Engler; Adam J.,9996,0,9999,3
1745146232087,CAT 124RS,A01,956906,Staff,8,0,25,17
1745146233112,CAT 125RS,A01,922013,Staff,8,0,25,17
1745146234141,CLRE 250,A00,891860,Morris; Sheldon,9996,0,9999,3
1745146236195,CLRE 251R,A00,907817,Mehta; Ravindra L.,9995,0,9999,4
1745146237223,CLRE 252,A00,891864,Cuomo; Raphael Eduardo,9994,0,9999,5
1745146238253,CLRE 253,A00,891867,Vaida; Florin,9995,0,9999,4
1745146238253,CLRE 253,B00,907819,Staff,9999,0,9999,0
1745146239281,CLRE 259,A00,891868,Patel; Hemal,9998,0,9999,1
1745146240308,CLRE 260,A00,891872,Cuomo; Raphael Eduardo,9999,0,9999,0
1745146241337,CLRE 297,001,891888,Cuomo; Raphael Eduardo,9999,0,9999,0
1745146242363,CSS 201S,A01,892054,Mignozzetti; Umberto,30,0,30,0
1745146243389,CSS 202S,A01,892056,Mignozzetti; Umberto,30,0,30,0
1745146244416,DSC 197,001,956898,Eldridge; Justin Matthew,9998,0,9999,1
1745146245440,DSC 297,001,958000,Mazumdar; Arya,9999,0,9999,0
1745146246468,EAP 100,A00,905686,Staff,9774,0,9999,225
1745146247493,ECE 45,A01,892618,Staff,0,2,50,50
1745146248519,ECE 109,A01,892620,Staff,0,44,0,0
1745146249550,ECE 111,A01,892719,Staff,0,0,50,50
1745146250578,ECE 197,001,957920,Mercier; Patrick Philip,9992,0,9999,7
1745146251605,ECON 178,A01,907814,Zhu; Ying,29,0,35,6
1745146252634,EDS 115,A00,895312,Staff,42,0,45,3
1745146253658,EDS 117,A01,895337,Staff,30,0,30,0
1745146254685,EDS 125,A00,895341,Jones; Gabrielle Anastasia,43,0,45,2
1745146255715,EDS 128A,A01,895459,Fargason; Sharon Gayle,45,0,45,0
1745146256741,EDS 128B,A01,895543,Pappas; Elizabeth,45,0,45,0
1745146257768,EDS 139,A00,897203,Pappas; Elizabeth,45,0,45,0
1745146257768,EDS 139,B00,897209,Fargason; Sharon Gayle,45,0,45,0
1745146258794,EDS 201,A00,895545,Staff,44,0,45,1
1745146259820,EDS 203,A01,895581,Halter; Christopher P.,44,0,45,1
1745146260846,EDS 204R,A01,895625,Heinzman; Erica M.,45,0,45,0
1745146260846,EDS 204R,B01,895693,Halter; Christopher P.,28,0,45,17
1745146261872,EDS 206R,A00,895694,Fargason; Sharon Gayle,22,0,30,8
1745146261872,EDS 206R,B00,895695,Choi; Bailey Miyeon,21,0,30,9
1745146262901,EDS 250,A00,895697,Hemans; Patricia Ann Benitez,44,0,45,1
1745146263927,EDS 281,A00,895701,Meyerott; Theresa Ann,15,0,15,0
1745146264955,EDS 284,A00,895736,Meyerott; Theresa Ann,15,0,15,0
1745146265980,EDS 286,A00,897210,Fine; Sarah,15,0,15,0
1745146267009,EDS 289C,A01,895770,Daly; Alan J.,15,0,15,0
1745146268036,EDS 290,A00,897211,Hofstetter; Carolyn,15,0,15,0
1745146269100,LIGM 5A,A00,896162,Fischer-Grunski; Eva K,16,0,20,4
1745146270132,LIGM 5B,A00,896260,Fischer-Grunski; Eva K,19,0,20,1
1745146271158,LIGM 5C,A00,896308,Fischer-Grunski; Eva K,19,0,20,1
1745146272190,LIIT 5AS,A00,896313,Carnelos; Chiara,18,0,20,2
1745146273217,LIIT 5BS,A00,896416,Carnelos; Chiara,20,0,20,0
1745146274247,LIIT 5CS,A00,896564,Carnelos; Chiara,20,0,20,0
1745146275273,LISP 5A,A00,896588,Munoz Sanchez; Alicia,7,0,20,13
1745146276298,LISP 5B,A00,896653,Munoz Sanchez; Alicia,10,0,20,10
1745146277329,LISP 5C,A00,896655,Munoz Sanchez; Alicia,9,0,20,11
1745146278357,MAE 197,001,957918,Kleissl; Jan,9998,0,9999,1
1745146279382,MATH 2,A01,957937,Staff,34,0,35,1
1745146280409,MATH 197,001,957876,Kedlaya; Kiran S.,9996,0,9999,3
1745146281438,MCWP 40,A00,892729,Duru; Nur,15,0,20,5
1745146281438,MCWP 40,B00,893304,Montejo; Carolina,20,0,20,0
1745146282468,MCWP 40R,A00,893757,Redela; Pamela Morgan,0,3,20,20
1745146283495,MCWP 50,A00,893758,Morshed; Michael James,4,0,20,16
1745146283495,MCWP 50,B00,893761,Bartulis; Jason Michael,18,0,20,2
1745146284522,MCWP 50R,A00,893766,Compas; Sean Matthew,0,1,20,20
1745146284522,MCWP 50R,B00,893769,Carter; Jennifer A,5,0,20,15
1745146284522,MCWP 50R,C00,893771,Krone; Jarret,0,3,20,20
1745146284522,MCWP 50R,D00,893772,Miller; Elizabeth Deen,4,0,20,16
1745146284522,MCWP 50R,E00,893775,Carter; Andrea L,0,0,20,20
1745146285550,MMW 11R,A01,892721,Herbst; Matthew,22,0,30,8
1745146285550,MMW 11R,A02,892722,Herbst; Matthew,28,0,30,2
1745146286579,MMW 12R,A01,892724,Herbst; Matthew,0,5,16,16
1745146286579,MMW 12R,A02,892725,Herbst; Matthew,0,4,16,16
1745146287603,MMW 13R,A01,892727,Staff,0,29,16,16
1745146287603,MMW 13R,A02,892728,Staff,0,28,16,16
1745146288629,SIO 295LS,A00,894015,Staff,9,0,25,16
1745146289658,SIO 295S,A00,894020,Staff,9,0,25,16
1745146290686,SIOC 290S,A01,894063,Merrifield; Mark A,23,0,25,2
1745146291717,SIOC 291S,A01,894137,Gabriel; Corey John,23,0,25,2
1745146292743,SOCI 117,A01,895339,Staff,5,0,5,0
1745146293770,WES 237B,A00,894149,Staff,20,0,20,0
1745146295856,AESE 279B,A00,891859,Staff,35,0,35,0
1745146296880,AIP 197,001,891854,Staff,70,0,70,0
1745146297911,ANTH 289S,A00,891856,Gagneux; Pascal,12,0,12,0
1745146298939,BENG 196,001,957946,Engler; Adam J.,9996,0,9999,3
1745146299964,CAT 124RS,A01,956906,Staff,8,0,25,17
1745146300992,CAT 125RS,A01,922013,Staff,8,0,25,17
1745146302017,CLRE 250,A00,891860,Morris; Sheldon,9996,0,9999,3
1745146304068,CLRE 251R,A00,907817,Mehta; Ravindra L.,9995,0,9999,4
1745146305098,CLRE 252,A00,891864,Cuomo; Raphael Eduardo,9994,0,9999,5
1745146306128,CLRE 253,A00,891867,Vaida; Florin,9995,0,9999,4
1745146306128,CLRE 253,B00,907819,Staff,9999,0,9999,0
1745146307155,CLRE 259,A00,891868,Patel; Hemal,9998,0,9999,1
1745146308182,CLRE 260,A00,891872,Cuomo; Raphael Eduardo,9999,0,9999,0
1745146309207,CLRE 297,001,891888,Cuomo; Raphael Eduardo,9999,0,9999,0
1745146310233,CSS 201S,A01,892054,Mignozzetti; Umberto,30,0,30,0
1745146311260,CSS 202S,A01,892056,Mignozzetti; Umberto,30,0,30,0
1745146312289,DSC 197,001,956898,Eldridge; Justin Matthew,9998,0,9999,1
1745146313346,DSC 297,001,958000,Mazumdar; Arya,9999,0,9999,0
1745146314374,EAP 100,A00,905686,Staff,9774,0,9999,225
1745146315402,ECE 45,A01,892618,Staff,0,2,50,50
1745146316431,ECE 109,A01,892620,Staff,0,44,0,0
1745146317459,ECE 111,A01,892719,Staff,0,0,50,50
1745146318484,ECE 197,001,957920,Mercier; Patrick Philip,9992,0,9999,7
1745146319511,ECON 178,A01,907814,Zhu; Ying,29,0,35,6
1745146320541,EDS 115,A00,895312,Staff,42,0,45,3
1745146321571,EDS 117,A01,895337,Staff,30,0,30,0
1745146322602,EDS 125,A00,895341,Jones; Gabrielle Anastasia,43,0,45,2
1745146323631,EDS 128A,A01,895459,Fargason; Sharon Gayle,45,0,45,0
1745146324657,EDS 128B,A01,895543,Pappas; Elizabeth,45,0,45,0
1745146325682,EDS 139,A00,897203,Pappas; Elizabeth,45,0,45,0
1745146325682,EDS 139,B00,897209,Fargason; Sharon Gayle,45,0,45,0
1745146326712,EDS 201,A00,895545,Staff,44,0,45,1
1745146327740,EDS 203,A01,895581,Halter; Christopher P.,44,0,45,1
1745146328766,EDS 204R,A01,895625,Heinzman; Erica M.,45,0,45,0
1745146328766,EDS 204R,B01,895693,Halter; Christopher P.,28,0,45,17
1745146329793,EDS 206R,A00,895694,Fargason; Sharon Gayle,22,0,30,8
1745146329793,EDS 206R,B00,895695,Choi; Bailey Miyeon,21,0,30,9
1745146330820,EDS 250,A00,895697,Hemans; Patricia Ann Benitez,44,0,45,1
1745146331844,EDS 281,A00,895701,Meyerott; Theresa Ann,15,0,15,0
1745146332874,EDS 284,A00,895736,Meyerott; Theresa Ann,15,0,15,0
1745146333901,EDS 286,A00,897210,Fine; Sarah,15,0,15,0
1745146334938,EDS 289C,A01,895770,Daly; Alan J.,15,0,15,0
1745146335967,EDS 290,A00,897211,Hofstetter; Carolyn,15,0,15,0
1745146336994,LIGM 5A,A00,896162,Fischer-Grunski; Eva K,16,0,20,4
1745146338020,LIGM 5B,A00,896260,Fischer-Grunski; Eva K,19,0,20,1
1745146339050,LIGM 5C,A00,896308,Fischer-Grunski; Eva K,19,0,20,1
1745146340077,LIIT 5AS,A00,896313,Carnelos; Chiara,18,0,20,2
1745146341106,LIIT 5BS,A00,896416,Carnelos; Chiara,20,0,20,0
1745146342133,LIIT 5CS,A00,896564,Carnelos; Chiara,20,0,20,0
1745146343159,LISP 5A,A00,896588,Munoz Sanchez; Alicia,7,0,20,13
1745146344184,LISP 5B,A00,896653,Munoz Sanchez; Alicia,10,0,20,10
1745146345213,LISP 5C,A00,896655,Munoz Sanchez; Alicia,9,0,20,11
1745146346239,MAE 197,001,957918,Kleissl; Jan,9998,0,9999,1
1745146347265,MATH 2,A01,957937,Staff,34,0,35,1
1745146348290,MATH 197,001,957876,Kedlaya; Kiran S.,9996,0,9999,3
1745146349316,MCWP 40,A00,892729,Duru; Nur,15,0,20,5
1745146349316,MCWP 40,B00,893304,Montejo; Carolina,20,0,20,0
1745146350341,MCWP 40R,A00,893757,Redela; Pamela Morgan,0,3,20,20
1745146351366,MCWP 50,A00,893758,Morshed; Michael James,4,0,20,16
1745146351366,MCWP 50,B00,893761,Bartulis; Jason Michael,18,0,20,2
1745146352401,MCWP 50R,A00,893766,Compas; Sean Matthew,0,1,20,20
1745146352401,MCWP 50R,B00,893769,Carter; Jennifer A,5,0,20,15
1745146352401,MCWP 50R,C00,893771,Krone; Jarret,0,3,20,20
1745146352401,MCWP 50R,D00,893772,Miller; Elizabeth Deen,4,0,20,16
1745146352401,MCWP 50R,E00,893775,Carter; Andrea L,0,0,20,20
1745146353431,MMW 11R,A01,892721,Herbst; Matthew,22,0,30,8
1745146353431,MMW 11R,A02,892722,Herbst; Matthew,28,0,30,2
1745146354456,MMW 12R,A01,892724,Herbst; Matthew,0,5,16,16
1745146354456,MMW 12R,A02,892725,Herbst; Matthew,0,4,16,16
1745146355481,MMW 13R,A01,892727,Staff,0,29,16,16
1745146355481,MMW 13R,A02,892728,Staff,0,28,16,16
1745146356510,SIO 295LS,A00,894015,Staff,9,0,25,16
1745146357534,SIO 295S,A00,894020,Staff,9,0,25,16
1745146358560,SIOC 290S,A01,894063,Merrifield; Mark A,23,0,25,2
1745146359587,SIOC 291S,A01,894137,Gabriel; Corey John,23,0,25,2
1745146360611,SOCI 117,A01,895339,Staff,5,0,5,0
1745146361636,WES 237B,A00,894149,Staff,20,0,20,0
1745146363707,AESE 279B,A00,891859,Staff,35,0,35,0
1745146364731,AIP 197,001,891854,Staff,70,0,70,0
1745146365756,ANTH 289S,A00,891856,Gagneux; Pascal,12,0,12,0
1745146366779,BENG 196,001,957946,Engler; Adam J.,9996,0,9999,3
1745146367808,CAT 124RS,A01,956906,Staff,8,0,25,17
1745146368834,CAT 125RS,A01,922013,Staff,8,0,25,17
1745146369861,CLRE 250,A00,891860,Morris; Sheldon,9996,0,9999,3
1745146371917,CLRE 251R,A00,907817,Mehta; Ravindra L.,9995,0,9999,4
1745146372941,CLRE 252,A00,891864,Cuomo; Raphael Eduardo,9994,0,9999,5
1745146373971,CLRE 253,A00,891867,Vaida; Florin,9995,0,9999,4
1745146373971,CLRE 253,B00,907819,Staff,9999,0,9999,0
1745146374997,CLRE 259,A00,891868,Patel; Hemal,9998,0,9999,1
1745146376021,CLRE 260,A00,891872,Cuomo; Raphael Eduardo,9999,0,9999,0
1745146377046,CLRE 297,001,891888,Cuomo; Raphael Eduardo,9999,0,9999,0
1745146378076,CSS 201S,A01,892054,Mignozzetti; Umberto,30,0,30,0
1745146379101,CSS 202S,A01,892056,Mignozzetti; Umberto,30,0,30,0
1745146380127,DSC 197,001,956898,Eldridge; Justin Matthew,9998,0,9999,1
1745146381154,DSC 297,001,958000,Mazumdar; Arya,9999,0,9999,0
1745146382182,EAP 100,A00,905686,Staff,9774,0,9999,225
1745146383207,ECE 45,A01,892618,Staff,0,2,50,50
1745146384232,ECE 109,A01,892620,Staff,0,44,0,0
1745146385261,ECE 111,A01,892719,Staff,0,0,50,50
1745146386287,ECE 197,001,957920,Mercier; Patrick Philip,9992,0,9999,7
1745146387314,ECON 178,A01,907814,Zhu; Ying,29,0,35,6
1745146388341,EDS 115,A00,895312,Staff,42,0,45,3
1745146389366,EDS 117,A01,895337,Staff,30,0,30,0
1745146390393,EDS 125,A00,895341,Jones; Gabrielle Anastasia,43,0,45,2
1745146391972,EDS 128A,A01,895459,Fargason; Sharon Gayle,45,0,45,0
1745146392997,EDS 128B,A01,895543,Pappas; Elizabeth,45,0,45,0
1745146394021,EDS 139,A00,897203,Pappas; Elizabeth,45,0,45,0
1745146394021,EDS 139,B00,897209,Fargason; Sharon Gayle,45,0,45,0
1745146395049,EDS 201,A00,895545,Staff,44,0,45,1
1745146396073,EDS 203,A01,895581,Halter; Christopher P.,44,0,45,1
1745146397099,EDS 204R,A01,895625,Heinzman; Erica M.,45,0,45,0
1745146397099,EDS 204R,B01,895693,Halter; Christopher P.,28,0,45,17
1745146398127,EDS 206R,A00,895694,Fargason; Sharon Gayle,22,0,30,8
1745146398127,EDS 206R,B00,895695,Choi; Bailey Miyeon,21,0,30,9
1745146399157,EDS 250,A00,895697,Hemans; Patricia Ann Benitez,44,0,45,1
1745146400183,EDS 281,A00,895701,Meyerott; Theresa Ann,15,0,15,0
1745146401213,EDS 284,A00,895736,Meyerott; Theresa Ann,15,0,15,0
1745146402238,EDS 286,A00,897210,Fine; Sarah,15,0,15,0
1745146403264,EDS 289C,A01,895770,Daly; Alan J.,15,0,15,0
1745146404291,EDS 290,A00,897211,Hofstetter; Carolyn,15,0,15,0
1745146405322,LIGM 5A,A00,896162,Fischer-Grunski; Eva K,16,0,20,4
1745146406348,LIGM 5B,A00,896260,Fischer-Grunski; Eva K,19,0,20,1
1745146407430,LIGM 5C,A00,896308,Fischer-Grunski; Eva K,19,0,20,1
1745146408455,LIIT 5AS,A00,896313,Carnelos; Chiara,18,0,20,2
1745146409485,LIIT 5BS,A00,896416,Carnelos; Chiara,20,0,20,0
1745146410510,LIIT 5CS,A00,896564,Carnelos; Chiara,20,0,20,0
1745146411537,LISP 5A,A00,896588,Munoz Sanchez; Alicia,7,0,20,13
1745146412567,LISP 5B,A00,896653,Munoz Sanchez; Alicia,10,0,20,10
1745146413595,LISP 5C,A00,896655,Munoz Sanchez; Alicia,9,0,20,11
1745146414620,MAE 197,001,957918,Kleissl; Jan,9998,0,9999,1
1745146415647,MATH 2,A01,957937,Staff,34,0,35,1
1745146416675,MATH 197,001,957876,Kedlaya; Kiran S.,9996,0,9999,3
1745146417701,MCWP 40,A00,892729,Duru; Nur,15,0,20,5
1745146417701,MCWP 40,B00,893304,Montejo; Carolina,20,0,20,0
1745146418725,MCWP 40R,A00,893757,Redela; Pamela Morgan,0,3,20,20
1745146419754,MCWP 50,A00,893758,Morshed; Michael James,4,0,20,16
1745146419754,MCWP 50,B00,893761,Bartulis; Jason Michael,18,0,20,2
1745146420782,MCWP 50R,A00,893766,Compas; Sean Matthew,0,1,20,20
1745146420782,MCWP 50R,B00,893769,Carter; Jennifer A,5,0,20,15
1745146420782,MCWP 50R,C00,893771,Krone; Jarret,0,3,20,20
1745146420782,MCWP 50R,D00,893772,Miller; Elizabeth Deen,4,0,20,16
1745146420782,MCWP 50R,E00,893775,Carter; Andrea L,0,0,20,20
1745146421813,MMW 11R,A01,892721,Herbst; Matthew,22,0,30,8
1745146421813,MMW 11R,A02,892722,Herbst; Matthew,28,0,30,2
1745146422838,MMW 12R,A01,892724,Herbst; Matthew,0,5,16,16
1745146422838,MMW 12R,A02,892725,Herbst; Matthew,0,4,16,16
1745146423865,MMW 13R,A01,892727,Staff,0,29,16,16
1745146423865,MMW 13R,A02,892728,Staff,0,28,16,16
1745146424892,SIO 295LS,A00,894015,Staff,9,0,25,16
1745146425921,SIO 295S,A00,894020,Staff,9,0,25,16
1745146426945,SIOC 290S,A01,894063,Merrifield; Mark A,23,0,25,2
1745146427970,SIOC 291S,A01,894137,Gabriel; Corey John,23,0,25,2
1745146428998,SOCI 117,A01,895339,Staff,5,0,5,0
1745146430023,WES 237B,A00,894149,Staff,20,0,20,0
1745146432099,AESE 279B,A00,891859,Staff,35,0,35,0
1745146433125,AIP 197,001,891854,Staff,70,0,70,0
1745146434153,ANTH 289S,A00,891856,Gagneux; Pascal,12,0,12,0
1745146435181,BENG 196,001,957946,Engler; Adam J.,9996,0,9999,3
1745146436208,CAT 124RS,A01,956906,Staff,8,0,25,17
1745146437233,CAT 125RS,A01,922013,Staff,8,0,25,17
1745146438260,CLRE 250,A00,891860,Morris; Sheldon,9996,0,9999,3
1745146440313,CLRE 251R,A00,907817,Mehta; Ravindra L.,9995,0,9999,4
1745146441337,CLRE 252,A00,891864,Cuomo; Raphael Eduardo,9994,0,9999,5
1745146442367,CLRE 253,A00,891867,Vaida; Florin,9995,0,9999,4
1745146442367,CLRE 253,B00,907819,Staff,9999,0,9999,0
1745146443392,CLRE 259,A00,891868,Patel; Hemal,9998,0,9999,1
1745146444417,CLRE 260,A00,891872,Cuomo; Raphael Eduardo,9999,0,9999,0
1745146445445,CLRE 297,001,891888,Cuomo; Raphael Eduardo,9999,0,9999,0
1745146446473,CSS 201S,A01,892054,Mignozzetti; Umberto,30,0,30,0
1745146447499,CSS 202S,A01,892056,Mignozzetti; Umberto,30,0,30,0
1745146448527,DSC 197,001,956898,Eldridge; Justin Matthew,9998,0,9999,1
1745146449552,DSC 297,001,958000,Mazumdar; Arya,9999,0,9999,0
1745146450578,EAP 100,A00,905686,Staff,9774,0,9999,225
1745146451603,ECE 45,A01,892618,Staff,0,2,50,50
1745146452629,ECE 109,A01,892620,Staff,0,44,0,0
1745146453656,ECE 111,A01,892719,Staff,0,0,50,50
1745146454692,ECE 197,001,957920,Mercier; Patrick Philip,9992,0,9999,7
1745146455723,ECON 178,A01,907814,Zhu; Ying,29,0,35,6
1745146456749,EDS 115,A00,895312,Staff,42,0,45,3
1745146457774,EDS 117,A01,895337,Staff,30,0,30,0
1745146458799,EDS 125,A00,895341,Jones; Gabrielle Anastasia,43,0,45,2
1745146459831,EDS 128A,A01,895459,Fargason; Sharon Gayle,45,0,45,0
1745146460857,EDS 128B,A01,895543,Pappas; Elizabeth,45,0,45,0
1745146461885,EDS 139,A00,897203,Pappas; Elizabeth,45,0,45,0
1745146461885,EDS 139,B00,897209,Fargason; Sharon Gayle,45,0,45,0
1745146462909,EDS 201,A00,895545,Staff,44,0,45,1
1745146463938,EDS 203,A01,895581,Halter; Christopher P.,44,0,45,1
1745146464962,EDS 204R,A01,895625,Heinzman; Erica M.,45,0,45,0
1745146464962,EDS 204R,B01,895693,Halter; Christopher P.,28,0,45,17
1745146465992,EDS 206R,A00,895694,Fargason; Sharon Gayle,22,0,30,8
1745146465992,EDS 206R,B00,895695,Choi; Bailey Miyeon,21,0,30,9
1745146467018,EDS 250,A00,895697,Hemans; Patricia Ann Benitez,44,0,45,1
1745146468047,EDS 281,A00,895701,Meyerott; Theresa Ann,15,0,15,0
1745146469072,EDS 284,A00,895736,Meyerott; Theresa Ann,15,0,15,0
1745146470101,EDS 286,A00,897210,Fine; Sarah,15,0,15,0
1745146471126,EDS 289C,A01,895770,Daly; Alan J.,15,0,15,0
1745146472154,EDS 290,A00,897211,Hofstetter; Carolyn,15,0,15,0
1745146473179,LIGM 5A,A00,896162,Fischer-Grunski; Eva K,16,0,20,4
1745146474205,LIGM 5B,A00,896260,Fischer-Grunski; Eva K,19,0,20,1
1745146475230,LIGM 5C,A00,896308,Fischer-Grunski; Eva K,19,0,20,1
1745146476258,LIIT 5AS,A00,896313,Carnelos; Chiara,18,0,20,2
1745146477282,LIIT 5BS,A00,896416,Carnelos; Chiara,20,0,20,0
1745146478311,LIIT 5CS,A00,896564,Carnelos; Chiara,20,0,20,0
1745146479335,LISP 5A,A00,896588,Munoz Sanchez; Alicia,7,0,20,13
1745146480361,LISP 5B,A00,896653,Munoz Sanchez; Alicia,10,0,20,10
1745146481387,LISP 5C,A00,896655,Munoz Sanchez; Alicia,9,0,20,11
1745146482414,MAE 197,001,957918,Kleissl; Jan,9998,0,9999,1
1745146483445,MATH 2,A01,957937,Staff,34,0,35,1
1745146484471,MATH 197,001,957876,Kedlaya; Kiran S.,9996,0,9999,3
1745146485498,MCWP 40,A00,892729,Duru; Nur,15,0,20,5
1745146485498,MCWP 40,B00,893304,Montejo; Carolina,20,0,20,0
1745146486525,MCWP 40R,A00,893757,Redela; Pamela Morgan,0,3,20,20
1745146487552,MCWP 50,A00,893758,Morshed; Michael James,4,0,20,16
1745146487552,MCWP 50,B00,893761,Bartulis; Jason Michael,18,0,20,2
1745146488583,MCWP 50R,A00,893766,Compas; Sean Matthew,0,1,20,20
1745146488583,MCWP 50R,B00,893769,Carter; Jennifer A,5,0,20,15
1745146488583,MCWP 50R,C00,893771,Krone; Jarret,0,3,20,20
1745146488583,MCWP 50R,D00,893772,Miller; Elizabeth Deen,4,0,20,16
1745146488583,MCWP 50R,E00,893775,Carter; Andrea L,0,0,20,20
1745146489608,MMW 11R,A01,892721,Herbst; Matthew,22,0,30,8
1745146489608,MMW 11R,A02,892722,Herbst; Matthew,28,0,30,2
1745146490633,MMW 12R,A01,892724,Herbst; Matthew,0,5,16,16
1745146490633,MMW 12R,A02,892725,Herbst; Matthew,0,4,16,16
1745146491658,MMW 13R,A01,892727,Staff,0,29,16,16
1745146491658,MMW 13R,A02,892728,Staff,0,28,16,16
1745146492688,SIO 295LS,A00,894015,Staff,9,0,25,16
1745146493715,SIO 295S,A00,894020,Staff,9,0,25,16
1745146494746,SIOC 290S,A01,894063,Merrifield; Mark A,23,0,25,2
1745146495772,SIOC 291S,A01,894137,Gabriel; Corey John,23,0,25,2
1745146496798,SOCI 117,A01,895339,Staff,5,0,5,0
1745146497825,WES 237B,A00,894149,Staff,20,0,20,0
1745146499897,AESE 279B,A00,891859,Staff,35,0,35,0
1745146500925,AIP 197,001,891854,Staff,70,0,70,0
1745146501955,ANTH 289S,A00,891856,Gagneux; Pascal,12,0,12,0
1745146502979,BENG 196,001,957946,Engler; Adam J.,9996,0,9999,3
1745146504007,CAT 124RS,A01,956906,Staff,8,0,25,17
1745146505035,CAT 125RS,A01,922013,Staff,8,0,25,17
1745146506060,CLRE 250,A00,891860,Morris; Sheldon,9996,0,9999,3
1745146508115,CLRE 251R,A00,907817,Mehta; Ravindra L.,9995,0,9999,4
1745146509142,CLRE 252,A00,891864,Cuomo; Raphael Eduardo,9994,0,9999,5
1745146510176,CLRE 253,A00,891867,Vaida; Florin,9995,0,9999,4
1745146510176,CLRE 253,B00,907819,Staff,9999,0,9999,0
1745146511243,CLRE 259,A00,891868,Patel; Hemal,9998,0,9999,1
1745146512269,CLRE 260,A00,891872,Cuomo; Raphael Eduardo,9999,0,9999,0
1745146513295,CLRE 297,001,891888,Cuomo; Raphael Eduardo,9999,0,9999,0
1745146514323,CSS 201S,A01,892054,Mignozzetti; Umberto,30,0,30,0
1745146515350,CSS 202S,A01,892056,Mignozzetti; Umberto,30,0,30,0
1745146516378,DSC 197,001,956898,Eldridge; Justin Matthew,9998,0,9999,1
1745146517408,DSC 297,001,958000,Mazumdar; Arya,9999,0,9999,0
1745146518433,EAP 100,A00,905686,Staff,9774,0,9999,225
1745146519462,ECE 45,A01,892618,Staff,0,2,50,50
1745146520492,ECE 109,A01,892620,Staff,0,44,0,0
1745146521518,ECE 111,A01,892719,Staff,0,0,50,50
1745146522543,ECE 197,001,957920,Mercier; Patrick Philip,9992,0,9999,7
1745146523572,ECON 178,A01,907814,Zhu; Ying,29,0,35,6
1745146524601,EDS 115,A00,895312,Staff,42,0,45,3
1745146525627,EDS 117,A01,895337,Staff,30,0,30,0
1745146526653,EDS 125,A00,895341,Jones; Gabrielle Anastasia,43,0,45,2
1745146527678,EDS 128A,A01,895459,Fargason; Sharon Gayle,45,0,45,0
1745146528703,EDS 128B,A01,895543,Pappas; Elizabeth,45,0,45,0
1745146529731,EDS 139,A00,897203,Pappas; Elizabeth,45,0,45,0
1745146529731,EDS 139,B00,897209,Fargason; Sharon Gayle,45,0,45,0
1745146530779,EDS 201,A00,895545,Staff,44,0,45,1
1745146531805,EDS 203,A01,895581,Halter; Christopher P.,44,0,45,1
1745146532837,EDS 204R,A01,895625,Heinzman; Erica M.,45,0,45,0
1745146532837,EDS 204R,B01,895693,Halter; Christopher P.,28,0,45,17
1745146533867,EDS 206R,A00,895694,Fargason; Sharon Gayle,22,0,30,8
1745146533867,EDS 206R,B00,895695,Choi; Bailey Miyeon,21,0,30,9
1745146534897,EDS 250,A00,895697,Hemans; Patricia Ann Benitez,44,0,45,1
1745146535924,EDS 281,A00,895701,Meyerott; Theresa Ann,15,0,15,0
1745146536949,EDS 284,A00,895736,Meyerott; Theresa Ann,15,0,15,0
1745146537974,EDS 286,A00,897210,Fine; Sarah,15,0,15,0
1745146539000,EDS 289C,A01,895770,Daly; Alan J.,15,0,15,0
1745146540030,EDS 290,A00,897211,Hofstetter; Carolyn,15,0,15,0
1745146541058,LIGM 5A,A00,896162,Fischer-Grunski; Eva K,16,0,20,4
1745146542086,LIGM 5B,A00,896260,Fischer-Grunski; Eva K,19,0,20,1
1745146543113,LIGM 5C,A00,896308,Fischer-Grunski; Eva K,19,0,20,1
1745146544142,LIIT 5AS,A00,896313,Carnelos; Chiara,18,0,20,2
1745146545168,LIIT 5BS,A00,896416,Carnelos; Chiara,20,0,20,0
1745146546194,LIIT 5CS,A00,896564,Carnelos; Chiara,20,0,20,0
1745146547221,LISP 5A,A00,896588,Munoz Sanchez; Alicia,7,0,20,13
1745146548246,LISP 5B,A00,896653,Munoz Sanchez; Alicia,10,0,20,10
1745146549272,LISP 5C,A00,896655,Munoz Sanchez; Alicia,9,0,20,11
1745146550297,MAE 197,001,957918,Kleissl; Jan,9998,0,9999,1
1745146551323,MATH 2,A01,957937,Staff,34,0,35,1
1745146552351,MATH 197,001,957876,Kedlaya; Kiran S.,9996,0,9999,3
1745146553378,MCWP 40,A00,892729,Duru; Nur,15,0,20,5
1745146553378,MCWP 40,B00,893304,Montejo; Carolina,20,0,20,0
1745146554406,MCWP 40R,A00,893757,Redela; Pamela Morgan,0,3,20,20
1745146555436,MCWP 50,A00,893758,Morshed; Michael James,4,0,20,16
1745146555436,MCWP 50,B00,893761,Bartulis; Jason Michael,18,0,20,2
1745146556463,MCWP 50R,A00,893766,Compas; Sean Matthew,0,1,20,20
1745146556463,MCWP 50R,B00,893769,Carter; Jennifer A,5,0,20,15
1745146556463,MCWP 50R,C00,893771,Krone; Jarret,0,3,20,20
1745146556463,MCWP 50R,D00,893772,Miller; Elizabeth Deen,4,0,20,16
1745146556463,MCWP 50R,E00,893775,Carter; Andrea L,0,0,20,20
1745146557492,MMW 11R,A01,892721,Herbst; Matthew,22,0,30,8
1745146557492,MMW 11R,A02,892722,Herbst; Matthew,28,0,30,2
1745146558517,MMW 12R,A01,892724,Herbst; Matthew,0,5,16,16
1745146558517,MMW 12R,A02,892725,Herbst; Matthew,0,4,16,16
1745146559542,MMW 13R,A01,892727,Staff,0,29,16,16
1745146559542,MMW 13R,A02,892728,Staff,0,28,16,16
1745146560571,SIO 295LS,A00,894015,Staff,9,0,25,16
1745146561598,SIO 295S,A00,894020,Staff,9,0,25,16
1745146562623,SIOC 290S,A01,894063,Merrifield; Mark A,23,0,25,2
1745146563653,SIOC 291S,A01,894137,Gabriel; Corey John,23,0,25,2
1745146564681,SOCI 117,A01,895339,Staff,5,0,5,0
1745146565706,WES 237B,A00,894149,Staff,20,0,20,0
1745146567788,AESE 279B,A00,891859,Staff,35,0,35,0
1745146568813,AIP 197,001,891854,Staff,70,0,70,0
1745146569847,ANTH 289S,A00,891856,Gagneux; Pascal,12,0,12,0
1745146570874,BENG 196,001,957946,Engler; Adam J.,9996,0,9999,3
1745146571900,CAT 124RS,A01,956906,Staff,8,0,25,17
1745146572929,CAT 125RS,A01,922013,Staff,8,0,25,17
1745146573953,CLRE 250,A00,891860,Morris; Sheldon,9996,0,9999,3
1745146576002,CLRE 251R,A00,907817,Mehta; Ravindra L.,9995,0,9999,4
1745146577049,CLRE 252,A00,891864,Cuomo; Raphael Eduardo,9994,0,9999,5
1745146578075,CLRE 253,A00,891867,Vaida; Florin,9995,0,9999,4
1745146578075,CLRE 253,B00,907819,Staff,9999,0,9999,0
1745146579103,CLRE 259,A00,891868,Patel; Hemal,9998,0,9999,1
1745146580129,CLRE 260,A00,891872,Cuomo; Raphael Eduardo,9999,0,9999,0
1745146581157,CLRE 297,001,891888,Cuomo; Raphael Eduardo,9999,0,9999,0
1745146582187,CSS 201S,A01,892054,Mignozzetti; Umberto,30,0,30,0
1745146583217,CSS 202S,A01,892056,Mignozzetti; Umberto,30,0,30,0
1745146584242,DSC 197,001,956898,Eldridge; Justin Matthew,9998,0,9999,1
1745146585271,DSC 297,001,958000,Mazumdar; Arya,9999,0,9999,0
1745146586298,EAP 100,A00,905686,Staff,9774,0,9999,225
1745146587328,ECE 45,A01,892618,Staff,0,2,50,50
1745146588354,ECE 109,A01,892620,Staff,0,44,0,0
1745146589379,ECE 111,A01,892719,Staff,0,0,50,50
1745146590409,ECE 197,001,957920,Mercier; Patrick Philip,9992,0,9999,7
1745146591433,ECON 178,A01,907814,Zhu; Ying,29,0,35,6
1745146592458,EDS 115,A00,895312,Staff,42,0,45,3
1745146593487,EDS 117,A01,895337,Staff,30,0,30,0
1745146594512,EDS 125,A00,895341,Jones; Gabrielle Anastasia,43,0,45,2
1745146595538,EDS 128A,A01,895459,Fargason; Sharon Gayle,45,0,45,0
1745146596564,EDS 128B,A01,895543,Pappas; Elizabeth,45,0,45,0
1745146597589,EDS 139,A00,897203,Pappas; Elizabeth,45,0,45,0
1745146597589,EDS 139,B00,897209,Fargason; Sharon Gayle,45,0,45,0
1745146598653,EDS 201,A00,895545,Staff,44,0,45,1
1745146599678,EDS 203,A01,895581,Halter; Christopher P.,44,0,45,1
1745146600707,EDS 204R,A01,895625,Heinzman; Erica M.,45,0,45,0
1745146600707,EDS 204R,B01,895693,Halter; Christopher P.,28,0,45,17
1745146601741,EDS 206R,A00,895694,Fargason; Sharon Gayle,22,0,30,8
1745146601741,EDS 206R,B00,895695,Choi; Bailey Miyeon,21,0,30,9
1745146602768,EDS 250,A00,895697,Hemans; Patricia Ann Benitez,44,0,45,1
1745146603797,EDS 281,A00,895701,Meyerott; Theresa Ann,15,0,15,0
1745146604823,EDS 284,A00,895736,Meyerott; Theresa Ann,15,0,15,0
1745146605849,EDS 286,A00,897210,Fine; Sarah,15,0,15,0
1745146606877,EDS 289C,A01,895770,Daly; Alan J.,15,0,15,0
1745146607905,EDS 290,A00,897211,Hofstetter; Carolyn,15,0,15,0
1745146608929,LIGM 5A,A00,896162,Fischer-Grunski; Eva K,16,0,20,4
1745146609959,LIGM 5B,A00,896260,Fischer-Grunski; Eva K,19,0,20,1
1745146610987,LIGM 5C,A00,896308,Fischer-Grunski; Eva K,19,0,20,1
1745146612014,LIIT 5AS,A00,896313,Carnelos; Chiara,18,0,20,2
1745146613040,LIIT 5BS,A00,896416,Carnelos; Chiara,20,0,20,0
1745146614069,LIIT 5CS,A00,896564,Carnelos; Chiara,20,0,20,0
1745146615096,LISP 5A,A00,896588,Munoz Sanchez; Alicia,7,0,20,13
1745146616122,LISP 5B,A00,896653,Munoz Sanchez; Alicia,10,0,20,10
1745146617151,LISP 5C,A00,896655,Munoz Sanchez; Alicia,9,0,20,11
1745146618179,MAE 197,001,957918,Kleissl; Jan,9998,0,9999,1
1745146619205,MATH 2,A01,957937,Staff,34,0,35,1
1745146620231,MATH 197,001,957876,Kedlaya; Kiran S.,9996,0,9999,3
1745146621260,MCWP 40,A00,892729,Duru; Nur,15,0,20,5
1745146621260,MCWP 40,B00,893304,Montejo; Carolina,20,0,20,0
1745146622287,MCWP 40R,A00,893757,Redela; Pamela Morgan,0,3,20,20
1745146623313,MCWP 50,A00,893758,Morshed; Michael James,4,0,20,16
1745146623313,MCWP 50,B00,893761,Bartulis; Jason Michael,18,0,20,2
1745146624345,MCWP 50R,A00,893766,Compas; Sean Matthew,0,1,20,20
1745146624345,MCWP 50R,B00,893769,Carter; Jennifer A,5,0,20,15
1745146624345,MCWP 50R,C00,893771,Krone; Jarret,0,3,20,20
1745146624345,MCWP 50R,D00,893772,Miller; Elizabeth Deen,4,0,20,16
1745146624345,MCWP 50R,E00,893775,Carter; Andrea L,0,0,20,20
1745146625373,MMW 11R,A01,892721,Herbst; Matthew,22,0,30,8
1745146625373,MMW 11R,A02,892722,Herbst; Matthew,28,0,30,2
1745146626400,MMW 12R,A01,892724,Herbst; Matthew,0,5,16,16
1745146626400,MMW 12R,A02,892725,Herbst; Matthew,0,4,16,16
1745146627428,MMW 13R,A01,892727,Staff,0,29,16,16
1745146627428,MMW 13R,A02,892728,Staff,0,28,16,16
1745146628454,SIO 295LS,A00,894015,Staff,9,0,25,16
1745146629480,SIO 295S,A00,894020,Staff,9,0,25,16
1745146630506,SIOC 290S,A01,894063,Merrifield; Mark A,23,0,25,2
1745146631539,SIOC 291S,A01,894137,Gabriel; Corey John,23,0,25,2
1745146632565,SOCI 117,A01,895339,Staff,5,0,5,0
1745146633603,WES 237B,A00,894149,Staff,20,0,20,0
1745146635703,AESE 279B,A00,891859,Staff,35,0,35,0
1745146636732,AIP 197,001,891854,Staff,70,0,70,0
1745146637761,ANTH 289S,A00,891856,Gagneux; Pascal,12,0,12,0
1745146638787,BENG 196,001,957946,Engler; Adam J.,9996,0,9999,3
1745146639818,CAT 124RS,A01,956906,Staff,8,0,25,17
1745146640844,CAT 125RS,A01,922013,Staff,8,0,25,17
1745146641869,CLRE 250,A00,891860,Morris; Sheldon,9996,0,9999,3
1745146643921,CLRE 251R,A00,907817,Mehta; Ravindra L.,9995,0,9999,4
1745146644946,CLRE 252,A00,891864,Cuomo; Raphael Eduardo,9994,0,9999,5
1745146645976,CLRE 253,A00,891867,Vaida; Florin,9995,0,9999,4
1745146645976,CLRE 253,B00,907819,Staff,9999,0,9999,0
1745146647005,CLRE 259,A00,891868,Patel; Hemal,9998,0,9999,1
1745146648033,CLRE 260,A00,891872,Cuomo; Raphael Eduardo,9999,0,9999,0
1745146649058,CLRE 297,001,891888,Cuomo; Raphael Eduardo,9999,0,9999,0
1745146650082,CSS 201S,A01,892054,Mignozzetti; Umberto,30,0,30,0
1745146651108,CSS 202S,A01,892056,Mignozzetti; Umberto,30,0,30,0
1745146652134,DSC 197,001,956898,Eldridge; Justin Matthew,9998,0,9999,1
1745146653162,DSC 297,001,958000,Mazumdar; Arya,9999,0,9999,0
1745146654189,EAP 100,A00,905686,Staff,9774,0,9999,225
1745146655215,ECE 45,A01,892618,Staff,0,2,50,50
1745146656240,ECE 109,A01,892620,Staff,0,44,0,0
1745146657268,ECE 111,A01,892719,Staff,0,0,50,50
1745146658294,ECE 197,001,957920,Mercier; Patrick Philip,9992,0,9999,7
1745146659320,ECON 178,A01,907814,Zhu; Ying,29,0,35,6
1745146660350,EDS 115,A00,895312,Staff,42,0,45,3
1745146661375,EDS 117,A01,895337,Staff,30,0,30,0
1745146662401,EDS 125,A00,895341,Jones; Gabrielle Anastasia,43,0,45,2
1745146663426,EDS 128A,A01,895459,Fargason; Sharon Gayle,45,0,45,0
1745146664453,EDS 128B,A01,895543,Pappas; Elizabeth,45,0,45,0
1745146665482,EDS 139,A00,897203,Pappas; Elizabeth,45,0,45,0
1745146665482,EDS 139,B00,897209,Fargason; Sharon Gayle,45,0,45,0
1745146666507,EDS 201,A00,895545,Staff,44,0,45,1
1745146667535,EDS 203,A01,895581,Halter; Christopher P.,44,0,45,1
1745146668563,EDS 204R,A01,895625,Heinzman; Erica M.,45,0,45,0
1745146668563,EDS 204R,B01,895693,Halter; Christopher P.,28,0,45,17
1745146669636,EDS 206R,A00,895694,Fargason; Sharon Gayle,22,0,30,8
1745146669636,EDS 206R,B00,895695,Choi; Bailey Miyeon,21,0,30,9
1745146670666,EDS 250,A00,895697,Hemans; Patricia Ann Benitez,44,0,45,1
1745146671692,EDS 281,A00,895701,Meyerott; Theresa Ann,15,0,15,0
1745146672719,EDS 284,A00,895736,Meyerott; Theresa Ann,15,0,15,0
1745146673748,EDS 286,A00,897210,Fine; Sarah,15,0,15,0
1745146674773,EDS 289C,A01,895770,Daly; Alan J.,15,0,15,0
1745146675802,EDS 290,A00,897211,Hofstetter; Carolyn,15,0,15,0
1745146676835,LIGM 5A,A00,896162,Fischer-Grunski; Eva K,16,0,20,4
1745146677860,LIGM 5B,A00,896260,Fischer-Grunski; Eva K,19,0,20,1
1745146678886,LIGM 5C,A00,896308,Fischer-Grunski; Eva K,19,0,20,1
1745146679912,LIIT 5AS,A00,896313,Carnelos; Chiara,18,0,20,2
1745146680940,LIIT 5BS,A00,896416,Carnelos; Chiara,20,0,20,0
1745146681969,LIIT 5CS,A00,896564,Carnelos; Chiara,20,0,20,0
1745146682995,LISP 5A,A00,896588,Munoz Sanchez; Alicia,7,0,20,13
1745146684022,LISP 5B,A00,896653,Munoz Sanchez; Alicia,10,0,20,10
1745146685051,LISP 5C,A00,896655,Munoz Sanchez; Alicia,9,0,20,11
1745146686076,MAE 197,001,957918,Kleissl; Jan,9998,0,9999,1
1745146687103,MATH 2,A01,957937,Staff,34,0,35,1
1745146688134,MATH 197,001,957876,Kedlaya; Kiran S.,9996,0,9999,3
1745146689166,MCWP 40,A00,892729,Duru; Nur,15,0,20,5
1745146689166,MCWP 40,B00,893304,Montejo; Carolina,20,0,20,0
1745146690191,MCWP 40R,A00,893757,Redela; Pamela Morgan,0,3,20,20
1745146691215,MCWP 50,A00,893758,Morshed; Michael James,4,0,20,16
1745146691215,MCWP 50,B00,893761,Bartulis; Jason Michael,18,0,20,2
1745146692242,MCWP 50R,A00,893766,Compas; Sean Matthew,0,1,20,20
1745146692242,MCWP 50R,B00,893769,Carter; Jennifer A,5,0,20,15
1745146692242,MCWP 50R,C00,893771,Krone; Jarret,0,3,20,20
1745146692242,MCWP 50R,D00,893772,Miller; Elizabeth Deen,4,0,20,16
1745146692242,MCWP 50R,E00,893775,Carter; Andrea L,0,0,20,20
1745146693271,MMW 11R,A01,892721,Herbst; Matthew,22,0,30,8
1745146693271,MMW 11R,A02,892722,Herbst; Matthew,28,0,30,2
1745146694296,MMW 12R,A01,892724,Herbst; Matthew,0,5,16,16
1745146694296,MMW 12R,A02,892725,Herbst; Matthew,0,4,16,16
1745146695323,MMW 13R,A01,892727,Staff,0,29,16,16
1745146695323,MMW 13R,A02,892728,Staff,0,28,16,16
1745146696348,SIO 295LS,A00,894015,Staff,9,0,25,16
1745146697376,SIO 295S,A00,894020,Staff,9,0,25,16
1745146698402,SIOC 290S,A01,894063,Merrifield; Mark A,23,0,25,2
1745146699429,SIOC 291S,A01,894137,Gabriel; Corey John,23,0,25,2
1745146700455,SOCI 117,A01,895339,Staff,5,0,5,0
1745146701484,WES 237B,A00,894149,Staff,20,0,20,0
1745146703559,AESE 279B,A00,891859,Staff,35,0,35,0
1745146704584,AIP 197,001,891854,Staff,70,0,70,0
1745146705611,ANTH 289S,A00,891856,Gagneux; Pascal,12,0,12,0
1745146706637,BENG 196,001,957946,Engler; Adam J.,9996,0,9999,3
1745146707663,CAT 124RS,A01,956906,Staff,8,0,25,17
1745146708690,CAT 125RS,A01,922013,Staff,8,0,25,17
1745146709715,CLRE 250,A00,891860,Morris; Sheldon,9996,0,9999,3
1745146711771,CLRE 251R,A00,907817,Mehta; Ravindra L.,9995,0,9999,4
1745146712795,CLRE 252,A00,891864,Cuomo; Raphael Eduardo,9994,0,9999,5
1745146713819,CLRE 253,A00,891867,Vaida; Florin,9995,0,9999,4
1745146713819,CLRE 253,B00,907819,Staff,9999,0,9999,0
1745146714845,CLRE 259,A00,891868,Patel; Hemal,9998,0,9999,1
1745146715872,CLRE 260,A00,891872,Cuomo; Raphael Eduardo,9999,0,9999,0
1745146716899,CLRE 297,001,891888,Cuomo; Raphael Eduardo,9999,0,9999,0
1745146717931,CSS 201S,A01,892054,Mignozzetti; Umberto,30,0,30,0
1745146718956,CSS 202S,A01,892056,Mignozzetti; Umberto,30,0,30,0
1745146719981,DSC 197,001,956898,Eldridge; Justin Matthew,9998,0,9999,1
1745146721010,DSC 297,001,958000,Mazumdar; Arya,9999,0,9999,0
1745146722039,EAP 100,A00,905686,Staff,9774,0,9999,225
1745146723104,ECE 45,A01,892618,Staff,0,2,50,50
1745146724130,ECE 109,A01,892620,Staff,0,44,0,0
1745146725161,ECE 111,A01,892719,Staff,0,0,50,50
1745146726186,ECE 197,001,957920,Mercier; Patrick Philip,9992,0,9999,7
1745146727216,ECON 178,A01,907814,Zhu; Ying,29,0,35,6
1745146728245,EDS 115,A00,895312,Staff,42,0,45,3
1745146729274,EDS 117,A01,895337,Staff,30,0,30,0
1745146730301,EDS 125,A00,895341,Jones; Gabrielle Anastasia,43,0,45,2
1745146731327,EDS 128A,A01,895459,Fargason; Sharon Gayle,45,0,45,0
1745146732357,EDS 128B,A01,895543,Pappas; Elizabeth,45,0,45,0
1745146733384,EDS 139,A00,897203,Pappas; Elizabeth,45,0,45,0
1745146733384,EDS 139,B00,897209,Fargason; Sharon Gayle,45,0,45,0
1745146734411,EDS 201,A00,895545,Staff,44,0,45,1
1745146735441,EDS 203,A01,895581,Halter; Christopher P.,44,0,45,1
1745146736470,EDS 204R,A01,895625,Heinzman; Erica M.,45,0,45,0
1745146736470,EDS 204R,B01,895693,Halter; Christopher P.,28,0,45,17
1745146737500,EDS 206R,A00,895694,Fargason; Sharon Gayle,22,0,30,8
1745146737500,EDS 206R,B00,895695,Choi; Bailey Miyeon,21,0,30,9
1745146738524,EDS 250,A00,895697,Hemans; Patricia Ann Benitez,44,0,45,1
1745146739552,EDS 281,A00,895701,Meyerott; Theresa Ann,15,0,15,0
1745146740580,EDS 284,A00,895736,Meyerott; Theresa Ann,15,0,15,0
1745146741606,EDS 286,A00,897210,Fine; Sarah,15,0,15,0
1745146742636,EDS 289C,A01,895770,Daly; Alan J.,15,0,15,0
1745146743662,EDS 290,A00,897211,Hofstetter; Carolyn,15,0,15,0
1745146744702,LIGM 5A,A00,896162,Fischer-Grunski; Eva K,16,0,20,4
1745146745731,LIGM 5B,A00,896260,Fischer-Grunski; Eva K,19,0,20,1
1745146746762,LIGM 5C,A00,896308,Fischer-Grunski; Eva K,19,0,20,1
1745146747789,LIIT 5AS,A00,896313,Carnelos; Chiara,18,0,20,2
1745146748812,LIIT 5BS,A00,896416,Carnelos; Chiara,20,0,20,0
1745146749839,LIIT 5CS,A00,896564,Carnelos; Chiara,20,0,20,0
1745146750871,LISP 5A,A00,896588,Munoz Sanchez; Alicia,7,0,20,13
1745146751898,LISP 5B,A00,896653,Munoz Sanchez; Alicia,10,0,20,10
1745146752927,LISP 5C,A00,896655,Munoz Sanchez; Alicia,9,0,20,11
1745146753954,MAE 197,001,957918,Kleissl; Jan,9998,0,9999,1
1745146754978,MATH 2,A01,957937,Staff,34,0,35,1
1745146756005,MATH 197,001,957876,Kedlaya; Kiran S.,9996,0,9999,3
1745146757030,MCWP 40,A00,892729,Duru; Nur,15,0,20,5
1745146757030,MCWP 40,B00,893304,Montejo; Carolina,20,0,20,0
1745146758055,MCWP 40R,A00,893757,Redela; Pamela Morgan,0,3,20,20
1745146759080,MCWP 50,A00,893758,Morshed; Michael James,4,0,20,16
1745146759080,MCWP 50,B00,893761,Bartulis; Jason Michael,18,0,20,2
1745146760179,MCWP 50R,A00,893766,Compas; Sean Matthew,0,1,20,20
1745146760179,MCWP 50R,B00,893769,Carter; Jennifer A,5,0,20,15
1745146760179,MCWP 50R,C00,893771,Krone; Jarret,0,3,20,20
1745146760179,MCWP 50R,D00,893772,Miller; Elizabeth Deen,4,0,20,16
1745146760179,MCWP 50R,E00,893775,Carter; Andrea L,0,0,20,20
1745146761207,MMW 11R,A01,892721,Herbst; Matthew,22,0,30,8
1745146761207,MMW 11R,A02,892722,Herbst; Matthew,28,0,30,2
1745146762232,MMW 12R,A01,892724,Herbst; Matthew,0,5,16,16
1745146762232,MMW 12R,A02,892725,Herbst; Matthew,0,4,16,16
1745146763259,MMW 13R,A01,892727,Staff,0,29,16,16
1745146763259,MMW 13R,A02,892728,Staff,0,28,16,16
1745146764284,SIO 295LS,A00,894015,Staff,9,0,25,16
1745146765311,SIO 295S,A00,894020,Staff,9,0,25,16
1745146766340,SIOC 290S,A01,894063,Merrifield; Mark A,23,0,25,2
1745146767369,SIOC 291S,A01,894137,Gabriel; Corey John,23,0,25,2
1745146768400,SOCI 117,A01,895339,Staff,5,0,5,0
1745146769427,WES 237B,A00,894149,Staff,20,0,20,0
1745146771538,AESE 279B,A00,891859,Staff,35,0,35,0
1745146772563,AIP 197,001,891854,Staff,70,0,70,0
1745146773587,ANTH 289S,A00,891856,Gagneux; Pascal,12,0,12,0
1745146774615,BENG 196,001,957946,Engler; Adam J.,9996,0,9999,3
1745146775644,CAT 124RS,A01,956906,Staff,8,0,25,17
1745146776668,CAT 125RS,A01,922013,Staff,8,0,25,17
1745146777697,CLRE 250,A00,891860,Morris; Sheldon,9996,0,9999,3
1745146779816,CLRE 251R,A00,907817,Mehta; Ravindra L.,9995,0,9999,4
1745146780840,CLRE 252,A00,891864,Cuomo; Raphael Eduardo,9994,0,9999,5
1745146781867,CLRE 253,A00,891867,Vaida; Florin,9995,0,9999,4
1745146781867,CLRE 253,B00,907819,Staff,9999,0,9999,0
1745146782893,CLRE 259,A00,891868,Patel; Hemal,9998,0,9999,1
1745146783916,CLRE 260,A00,891872,Cuomo; Raphael Eduardo,9999,0,9999,0
1745146784954,CLRE 297,001,891888,Cuomo; Raphael Eduardo,9999,0,9999,0
1745146785982,CSS 201S,A01,892054,Mignozzetti; Umberto,30,0,30,0
1745146787032,CSS 202S,A01,892056,Mignozzetti; Umberto,30,0,30,0
1745146788056,DSC 197,001,956898,Eldridge; Justin Matthew,9998,0,9999,1
1745146789126,DSC 297,001,958000,Mazumdar; Arya,9999,0,9999,0
1745146790152,EAP 100,A00,905686,Staff,9774,0,9999,225
1745146791179,ECE 45,A01,892618,Staff,0,2,50,50
1745146792202,ECE 109,A01,892620,Staff,0,44,0,0
1745146793226,ECE 111,A01,892719,Staff,0,0,50,50
1745146794258,ECE 197,001,957920,Mercier; Patrick Philip,9992,0,9999,7
1745146795283,ECON 178,A01,907814,Zhu; Ying,29,0,35,6
1745146796307,EDS 115,A00,895312,Staff,42,0,45,3
1745146797331,EDS 117,A01,895337,Staff,30,0,30,0
1745146798355,EDS 125,A00,895341,Jones; Gabrielle Anastasia,43,0,45,2
1745146799380,EDS 128A,A01,895459,Fargason; Sharon Gayle,45,0,45,0
1745146800420,EDS 128B,A01,895543,Pappas; Elizabeth,45,0,45,0
1745146801445,EDS 139,A00,897203,Pappas; Elizabeth,45,0,45,0
1745146801445,EDS 139,B00,897209,Fargason; Sharon Gayle,45,0,45,0
1745146802478,EDS 201,A00,895545,Staff,44,0,45,1
1745146803504,EDS 203,A01,895581,Halter; Christopher P.,44,0,45,1
1745146804538,EDS 204R,A01,895625,Heinzman; Erica M.,45,0,45,0
1745146804538,EDS 204R,B01,895693,Halter; Christopher P.,28,0,45,17
1745146805566,EDS 206R,A00,895694,Fargason; Sharon Gayle,22,0,30,8
1745146805566,EDS 206R,B00,895695,Choi; Bailey Miyeon,21,0,30,9
1745146806591,EDS 250,A00,895697,Hemans; Patricia Ann Benitez,44,0,45,1
1745146807615,EDS 281,A00,895701,Meyerott; Theresa Ann,15,0,15,0
1745146808639,EDS 284,A00,895736,Meyerott; Theresa Ann,15,0,15,0
1745146809664,EDS 286,A00,897210,Fine; Sarah,15,0,15,0
1745146810693,EDS 289C,A01,895770,Daly; Alan J.,15,0,15,0
1745146811722,EDS 290,A00,897211,Hofstetter; Carolyn,15,0,15,0
1745146812755,LIGM 5A,A00,896162,Fischer-Grunski; Eva K,16,0,20,4
1745146813781,LIGM 5B,A00,896260,Fischer-Grunski; Eva K,19,0,20,1
1745146814812,LIGM 5C,A00,896308,Fischer-Grunski; Eva K,19,0,20,1
1745146815841,LIIT 5AS,A00,896313,Carnelos; Chiara,18,0,20,2
1745146816870,LIIT 5BS,A00,896416,Carnelos; Chiara,20,0,20,0
1745146817901,LIIT 5CS,A00,896564,Carnelos; Chiara,20,0,20,0
1745146818950,LISP 5A,A00,896588,Munoz Sanchez; Alicia,7,0,20,13
1745146819977,LISP 5B,A00,896653,Munoz Sanchez; Alicia,10,0,20,10
1745146821002,LISP 5C,A00,896655,Munoz Sanchez; Alicia,9,0,20,11
1745146822027,MAE 197,001,957918,Kleissl; Jan,9998,0,9999,1
1745146823052,MATH 2,A01,957937,Staff,34,0,35,1
1745146824079,MATH 197,001,957876,Kedlaya; Kiran S.,9996,0,9999,3
1745146825111,MCWP 40,A00,892729,Duru; Nur,15,0,20,5
1745146825111,MCWP 40,B00,893304,Montejo; Carolina,20,0,20,0
1745146826142,MCWP 40R,A00,893757,Redela; Pamela Morgan,0,3,20,20
1745146827174,MCWP 50,A00,893758,Morshed; Michael James,4,0,20,16
1745146827174,MCWP 50,B00,893761,Bartulis; Jason Michael,18,0,20,2
1745146828211,MCWP 50R,A00,893766,Compas; Sean Matthew,0,1,20,20
1745146828211,MCWP 50R,B00,893769,Carter; Jennifer A,5,0,20,15
1745146828211,MCWP 50R,C00,893771,Krone; Jarret,0,3,20,20
1745146828211,MCWP 50R,D00,893772,Miller; Elizabeth Deen,4,0,20,16
1745146828211,MCWP 50R,E00,893775,Carter; Andrea L,0,0,20,20
1745146829238,MMW 11R,A01,892721,Herbst; Matthew,22,0,30,8
1745146829238,MMW 11R,A02,892722,Herbst; Matthew,28,0,30,2
1745146830264,MMW 12R,A01,892724,Herbst; Matthew,0,5,16,16
1745146830264,MMW 12R,A02,892725,Herbst; Matthew,0,4,16,16
1745146831294,MMW 13R,A01,892727,Staff,0,29,16,16
1745146831294,MMW 13R,A02,892728,Staff,0,28,16,16
1745146832323,SIO 295LS,A00,894015,Staff,9,0,25,16
1745146833349,SIO 295S,A00,894020,Staff,9,0,25,16
1745146834377,SIOC 290S,A01,894063,Merrifield; Mark A,23,0,25,2
1745146835409,SIOC 291S,A01,894137,Gabriel; Corey John,23,0,25,2
1745146836444,SOCI 117,A01,895339,Staff,5,0,5,0
1745146837469,WES 237B,A00,894149,Staff,20,0,20,0
1745146839545,AESE 279B,A00,891859,Staff,35,0,35,0
1745146840571,AIP 197,001,891854,Staff,70,0,70,0
1745146841602,ANTH 289S,A00,891856,Gagneux; Pascal,12,0,12,0
1745146842633,BENG 196,001,957946,Engler; Adam J.,9996,0,9999,3
1745146843658,CAT 124RS,A01,956906,Staff,8,0,25,17
1745146844685,CAT 125RS,A01,922013,Staff,8,0,25,17
1745146845711,CLRE 250,A00,891860,Morris; Sheldon,9996,0,9999,3
1745146847766,CLRE 251R,A00,907817,Mehta; Ravindra L.,9995,0,9999,4
1745146848793,CLRE 252,A00,891864,Cuomo; Raphael Eduardo,9994,0,9999,5
1745146849819,CLRE 253,A00,891867,Vaida; Florin,9995,0,9999,4
1745146849819,CLRE 253,B00,907819,Staff,9999,0,9999,0
1745146850843,CLRE 259,A00,891868,Patel; Hemal,9998,0,9999,1
1745146851874,CLRE 260,A00,891872,Cuomo; Raphael Eduardo,9999,0,9999,0
1745146852901,CLRE 297,001,891888,Cuomo; Raphael Eduardo,9999,0,9999,0
1745146853927,CSS 201S,A01,892054,Mignozzetti; Umberto,30,0,30,0
1745146854955,CSS 202S,A01,892056,Mignozzetti; Umberto,30,0,30,0
1745146855988,DSC 197,001,956898,Eldridge; Justin Matthew,9998,0,9999,1
1745146857013,DSC 297,001,958000,Mazumdar; Arya,9999,0,9999,0
1745146858038,EAP 100,A00,905686,Staff,9774,0,9999,225
1745146859063,ECE 45,A01,892618,Staff,0,2,50,50
1745146860094,ECE 109,A01,892620,Staff,0,44,0,0
1745146861126,ECE 111,A01,892719,Staff,0,0,50,50
1745146862155,ECE 197,001,957920,Mercier; Patrick Philip,9992,0,9999,7
1745146863183,ECON 178,A01,907814,Zhu; Ying,29,0,35,6
1745146864214,EDS 115,A00,895312,Staff,42,0,45,3
1745146865240,EDS 117,A01,895337,Staff,30,0,30,0
1745146866267,EDS 125,A00,895341,Jones; Gabrielle Anastasia,43,0,45,2
1745146867293,EDS 128A,A01,895459,Fargason; Sharon Gayle,45,0,45,0
1745146868322,EDS 128B,A01,895543,Pappas; Elizabeth,45,0,45,0
1745146869346,EDS 139,A00,897203,Pappas; Elizabeth,45,0,45,0
1745146869346,EDS 139,B00,897209,Fargason; Sharon Gayle,45,0,45,0
1745146870373,EDS 201,A00,895545,Staff,44,0,45,1
1745146871400,EDS 203,A01,895581,Halter; Christopher P.,44,0,45,1
1745146872427,EDS 204R,A01,895625,Heinzman; Erica M.,45,0,45,0
1745146872427,EDS 204R,B01,895693,Halter; Christopher P.,28,0,45,17
1745146873457,EDS 206R,A00,895694,Fargason; Sharon Gayle,22,0,30,8
1745146873457,EDS 206R,B00,895695,Choi; Bailey Miyeon,21,0,30,9
1745146874487,EDS 250,A00,895697,Hemans; Patricia Ann Benitez,44,0,45,1
1745146875516,EDS 281,A00,895701,Meyerott; Theresa Ann,15,0,15,0
1745146876542,EDS 284,A00,895736,Meyerott; Theresa Ann,15,0,15,0
1745146877568,EDS 286,A00,897210,Fine; Sarah,15,0,15,0
1745146878598,EDS 289C,A01,895770,Daly; Alan J.,15,0,15,0
1745146879625,EDS 290,A00,897211,Hofstetter; Carolyn,15,0,15,0
1745146880656,LIGM 5A,A00,896162,Fischer-Grunski; Eva K,16,0,20,4
1745146881681,LIGM 5B,A00,896260,Fischer-Grunski; Eva K,19,0,20,1
1745146882724,LIGM 5C,A00,896308,Fischer-Grunski; Eva K,19,0,20,1
1745146883750,LIIT 5AS,A00,896313,Carnelos; Chiara,18,0,20,2
1745146884800,LIIT 5BS,A00,896416,Carnelos; Chiara,20,0,20,0
1745146885826,LIIT 5CS,A00,896564,Carnelos; Chiara,20,0,20,0
1745146886855,LISP 5A,A00,896588,Munoz Sanchez; Alicia,7,0,20,13
1745146887887,LISP 5B,A00,896653,Munoz Sanchez; Alicia,10,0,20,10
1745146888913,LISP 5C,A00,896655,Munoz Sanchez; Alicia,9,0,20,11
1745146889937,MAE 197,001,957918,Kleissl; Jan,9998,0,9999,1
1745146890964,MATH 2,A01,957937,Staff,34,0,35,1
1745146891993,MATH 197,001,957876,Kedlaya; Kiran S.,9996,0,9999,3
1745146893022,MCWP 40,A00,892729,Duru; Nur,15,0,20,5
1745146893022,MCWP 40,B00,893304,Montejo; Carolina,20,0,20,0
1745146894046,MCWP 40R,A00,893757,Redela; Pamela Morgan,0,3,20,20
1745146895073,MCWP 50,A00,893758,Morshed; Michael James,4,0,20,16
1745146895073,MCWP 50,B00,893761,Bartulis; Jason Michael,18,0,20,2
1745146896100,MCWP 50R,A00,893766,Compas; Sean Matthew,0,1,20,20
1745146896100,MCWP 50R,B00,893769,Carter; Jennifer A,5,0,20,15
1745146896100,MCWP 50R,C00,893771,Krone; Jarret,0,3,20,20
1745146896100,MCWP 50R,D00,893772,Miller; Elizabeth Deen,4,0,20,16
1745146896100,MCWP 50R,E00,893775,Carter; Andrea L,0,0,20,20
1745146897132,MMW 11R,A01,892721,Herbst; Matthew,22,0,30,8
1745146897132,MMW 11R,A02,892722,Herbst; Matthew,28,0,30,2
1745146898156,MMW 12R,A01,892724,Herbst; Matthew,0,5,16,16
1745146898156,MMW 12R,A02,892725,Herbst; Matthew,0,4,16,16
1745146900216,MMW 13R,A01,892727,Staff,0,29,16,16
1745146900216,MMW 13R,A02,892728,Staff,0,28,16,16
1745146901242,SIO 295LS,A00,894015,Staff,9,0,25,16
1745146902266,SIO 295S,A00,894020,Staff,9,0,25,16
1745146903294,SIOC 290S,A01,894063,Merrifield; Mark A,23,0,25,2
1745146904319,SIOC 291S,A01,894137,Gabriel; Corey John,23,0,25,2
1745146905352,SOCI 117,A01,895339,Staff,5,0,5,0
1745146906380,WES 237B,A00,894149,Staff,20,0,20,0
1745146908459,AESE 279B,A00,891859,Staff,35,0,35,0
1745146909487,AIP 197,001,891854,Staff,70,0,70,0
1745146910513,ANTH 289S,A00,891856,Gagneux; Pascal,12,0,12,0
1745146911540,BENG 196,001,957946,Engler; Adam J.,9996,0,9999,3
1745146912575,CAT 124RS,A01,956906,Staff,8,0,25,17
1745146913602,CAT 125RS,A01,922013,Staff,8,0,25,17
1745146914638,CLRE 250,A00,891860,Morris; Sheldon,9996,0,9999,3
1745146916692,CLRE 251R,A00,907817,Mehta; Ravindra L.,9995,0,9999,4
1745146917718,CLRE 252,A00,891864,Cuomo; Raphael Eduardo,9994,0,9999,5
1745146918750,CLRE 253,A00,891867,Vaida; Florin,9995,0,9999,4
1745146918750,CLRE 253,B00,907819,Staff,9999,0,9999,0
1745146919775,CLRE 259,A00,891868,Patel; Hemal,9998,0,9999,1
1745146920801,CLRE 260,A00,891872,Cuomo; Raphael Eduardo,9999,0,9999,0
1745146921826,CLRE 297,001,891888,Cuomo; Raphael Eduardo,9999,0,9999,0
1745146922864,CSS 201S,A01,892054,Mignozzetti; Umberto,30,0,30,0
1745146923888,CSS 202S,A01,892056,Mignozzetti; Umberto,30,0,30,0
1745146924913,DSC 197,001,956898,Eldridge; Justin Matthew,9998,0,9999,1
1745146925945,DSC 297,001,958000,Mazumdar; Arya,9999,0,9999,0
1745146926976,EAP 100,A00,905686,Staff,9774,0,9999,225
1745146928000,ECE 45,A01,892618,Staff,0,2,50,50
1745146929026,ECE 109,A01,892620,Staff,0,44,0,0
1745146930062,ECE 111,A01,892719,Staff,0,0,50,50
1745146931086,ECE 197,001,957920,Mercier; Patrick Philip,9992,0,9999,7
1745146932124,ECON 178,A01,907814,Zhu; Ying,29,0,35,6
1745146933157,EDS 115,A00,895312,Staff,42,0,45,3
1745146934184,EDS 117,A01,895337,Staff,30,0,30,0
1745146935213,EDS 125,A00,895341,Jones; Gabrielle Anastasia,43,0,45,2
1745146936245,EDS 128A,A01,895459,Fargason; Sharon Gayle,45,0,45,0
1745146937271,EDS 128B,A01,895543,Pappas; Elizabeth,45,0,45,0
1745146938297,EDS 139,A00,897203,Pappas; Elizabeth,45,0,45,0
1745146938297,EDS 139,B00,897209,Fargason; Sharon Gayle,45,0,45,0
1745146939327,EDS 201,A00,895545,Staff,44,0,45,1
1745146940353,EDS 203,A01,895581,Halter; Christopher P.,44,0,45,1
1745146941408,EDS 204R,A01,895625,Heinzman; Erica M.,45,0,45,0
1745146941408,EDS 204R,B01,895693,Halter; Christopher P.,28,0,45,17
1745146942436,EDS 206R,A00,895694,Fargason; Sharon Gayle,22,0,30,8
1745146942436,EDS 206R,B00,895695,Choi; Bailey Miyeon,21,0,30,9
1745146943462,EDS 250,A00,895697,Hemans; Patricia Ann Benitez,44,0,45,1
1745146944487,EDS 281,A00,895701,Meyerott; Theresa Ann,15,0,15,0
1745146945513,EDS 284,A00,895736,Meyerott; Theresa Ann,15,0,15,0
1745146946548,EDS 286,A00,897210,Fine; Sarah,15,0,15,0
1745146947575,EDS 289C,A01,895770,Daly; Alan J.,15,0,15,0
1745146948656,EDS 290,A00,897211,Hofstetter; Carolyn,15,0,15,0
1745146949703,LIGM 5A,A00,896162,Fischer-Grunski; Eva K,16,0,20,4
1745146950740,LIGM 5B,A00,896260,Fischer-Grunski; Eva K,19,0,20,1
1745146951779,LIGM 5C,A00,896308,Fischer-Grunski; Eva K,19,0,20,1
1745146952805,LIIT 5AS,A00,896313,Carnelos; Chiara,18,0,20,2
1745146953832,LIIT 5BS,A00,896416,Carnelos; Chiara,20,0,20,0
1745146954858,LIIT 5CS,A00,896564,Carnelos; Chiara,20,0,20,0
1745146955884,LISP 5A,A00,896588,Munoz Sanchez; Alicia,7,0,20,13
1745146956910,LISP 5B,A00,896653,Munoz Sanchez; Alicia,10,0,20,10
1745146957937,LISP 5C,A00,896655,Munoz Sanchez; Alicia,9,0,20,11
1745146958966,MAE 197,001,957918,Kleissl; Jan,9998,0,9999,1
1745146959990,MATH 2,A01,957937,Staff,34,0,35,1
1745146961026,MATH 197,001,957876,Kedlaya; Kiran S.,9996,0,9999,3
1745146962054,MCWP 40,A00,892729,Duru; Nur,15,0,20,5
1745146962054,MCWP 40,B00,893304,Montejo; Carolina,20,0,20,0
1745146963081,MCWP 40R,A00,893757,Redela; Pamela Morgan,0,3,20,20
1745146964108,MCWP 50,A00,893758,Morshed; Michael James,4,0,20,16
1745146964108,MCWP 50,B00,893761,Bartulis; Jason Michael,18,0,20,2
1745146965142,MCWP 50R,A00,893766,Compas; Sean Matthew,0,1,20,20
1745146965142,MCWP 50R,B00,893769,Carter; Jennifer A,5,0,20,15
1745146965142,MCWP 50R,C00,893771,Krone; Jarret,0,3,20,20
1745146965142,MCWP 50R,D00,893772,Miller; Elizabeth Deen,4,0,20,16
1745146965142,MCWP 50R,E00,893775,Carter; Andrea L,0,0,20,20
1745146966174,MMW 11R,A01,892721,Herbst; Matthew,22,0,30,8
1745146966174,MMW 11R,A02,892722,Herbst; Matthew,28,0,30,2
1745146967200,MMW 12R,A01,892724,Herbst; Matthew,0,5,16,16
1745146967200,MMW 12R,A02,892725,Herbst; Matthew,0,4,16,16
1745146968228,MMW 13R,A01,892727,Staff,0,29,16,16
1745146968228,MMW 13R,A02,892728,Staff,0,28,16,16
1745146969253,SIO 295LS,A00,894015,Staff,9,0,25,16
1745146970282,SIO 295S,A00,894020,Staff,9,0,25,16
1745146971308,SIOC 290S,A01,894063,Merrifield; Mark A,23,0,25,2
1745146972334,SIOC 291S,A01,894137,Gabriel; Corey John,23,0,25,2
1745146973361,SOCI 117,A01,895339,Staff,5,0,5,0
1745146974386,WES 237B,A00,894149,Staff,20,0,20,0
1745146976479,AESE 279B,A00,891859,Staff,35,0,35,0
1745146977504,AIP 197,001,891854,Staff,70,0,70,0
1745146978530,ANTH 289S,A00,891856,Gagneux; Pascal,12,0,12,0
1745146979556,BENG 196,001,957946,Engler; Adam J.,9996,0,9999,3
1745146980583,CAT 124RS,A01,956906,Staff,8,0,25,17
1745146981611,CAT 125RS,A01,922013,Staff,8,0,25,17
1745146982638,CLRE 250,A00,891860,Morris; Sheldon,9996,0,9999,3
1745146984694,CLRE 251R,A00,907817,Mehta; Ravindra L.,9995,0,9999,4
1745146985722,CLRE 252,A00,891864,Cuomo; Raphael Eduardo,9994,0,9999,5
1745146986748,CLRE 253,A00,891867,Vaida; Florin,9995,0,9999,4
1745146986748,CLRE 253,B00,907819,Staff,9999,0,9999,0
1745146987774,CLRE 259,A00,891868,Patel; Hemal,9998,0,9999,1
1745146988805,CLRE 260,A00,891872,Cuomo; Raphael Eduardo,9999,0,9999,0
1745146989830,CLRE 297,001,891888,Cuomo; Raphael Eduardo,9999,0,9999,0
1745146990858,CSS 201S,A01,892054,Mignozzetti; Umberto,30,0,30,0
1745146991892,CSS 202S,A01,892056,Mignozzetti; Umberto,30,0,30,0
1745146992921,DSC 197,001,956898,Eldridge; Justin Matthew,9998,0,9999,1
1745146993952,DSC 297,001,958000,Mazumdar; Arya,9999,0,9999,0
1745146994979,EAP 100,A00,905686,Staff,9774,0,9999,225
1745146996010,ECE 45,A01,892618,Staff,0,2,50,50
1745146997036,ECE 109,A01,892620,Staff,0,44,0,0
1745146998062,ECE 111,A01,892719,Staff,0,0,50,50
1745146999090,ECE 197,001,957920,Mercier; Patrick Philip,9992,0,9999,7
1745147000119,ECON 178,A01,907814,Zhu; Ying,29,0,35,6
1745147001145,EDS 115,A00,895312,Staff,42,0,45,3
1745147002171,EDS 117,A01,895337,Staff,30,0,30,0
1745147003199,EDS 125,A00,895341,Jones; Gabrielle Anastasia,43,0,45,2
1745147004226,EDS 128A,A01,895459,Fargason; Sharon Gayle,45,0,45,0
1745147005252,EDS 128B,A01,895543,Pappas; Elizabeth,45,0,45,0
1745147006279,EDS 139,A00,897203,Pappas; Elizabeth,45,0,45,0
1745147006279,EDS 139,B00,897209,Fargason; Sharon Gayle,45,0,45,0
1745147007306,EDS 201,A00,895545,Staff,44,0,45,1
1745147008330,EDS 203,A01,895581,Halter; Christopher P.,44,0,45,1
1745147009360,EDS 204R,A01,895625,Heinzman; Erica M.,45,0,45,0
1745147009360,EDS 204R,B01,895693,Halter; Christopher P.,28,0,45,17
1745147010387,EDS 206R,A00,895694,Fargason; Sharon Gayle,22,0,30,8
1745147010387,EDS 206R,B00,895695,Choi; Bailey Miyeon,21,0,30,9
1745147011414,EDS 250,A00,895697,Hemans; Patricia Ann Benitez,44,0,45,1
1745147012442,EDS 281,A00,895701,Meyerott; Theresa Ann,15,0,15,0
1745147013468,EDS 284,A00,895736,Meyerott; Theresa Ann,15,0,15,0
1745147014496,EDS 286,A00,897210,Fine; Sarah,15,0,15,0
1745147015521,EDS 289C,A01,895770,Daly; Alan J.,15,0,15,0
1745147016548,EDS 290,A00,897211,Hofstetter; Carolyn,15,0,15,0
1745147017576,LIGM 5A,A00,896162,Fischer-Grunski; Eva K,16,0,20,4
1745147018602,LIGM 5B,A00,896260,Fischer-Grunski; Eva K,19,0,20,1
1745147019627,LIGM 5C,A00,896308,Fischer-Grunski; Eva K,19,0,20,1
1745147020654,LIIT 5AS,A00,896313,Carnelos; Chiara,18,0,20,2
1745147021681,LIIT 5BS,A00,896416,Carnelos; Chiara,20,0,20,0
1745147022712,LIIT 5CS,A00,896564,Carnelos; Chiara,20,0,20,0
1745147023738,LISP 5A,A00,896588,Munoz Sanchez; Alicia,7,0,20,13
1745147024764,LISP 5B,A00,896653,Munoz Sanchez; Alicia,10,0,20,10
1745147025793,LISP 5C,A00,896655,Munoz Sanchez; Alicia,9,0,20,11
1745147026820,MAE 197,001,957918,Kleissl; Jan,9998,0,9999,1
1745147027848,MATH 2,A01,957937,Staff,34,0,35,1
1745147028873,MATH 197,001,957876,Kedlaya; Kiran S.,9996,0,9999,3
1745147029898,MCWP 40,A00,892729,Duru; Nur,15,0,20,5
1745147029898,MCWP 40,B00,893304,Montejo; Carolina,20,0,20,0
1745147030924,MCWP 40R,A00,893757,Redela; Pamela Morgan,0,3,20,20
1745147031953,MCWP 50,A00,893758,Morshed; Michael James,4,0,20,16
1745147031953,MCWP 50,B00,893761,Bartulis; Jason Michael,18,0,20,2
1745147032980,MCWP 50R,A00,893766,Compas; Sean Matthew,0,1,20,20
1745147032980,MCWP 50R,B00,893769,Carter; Jennifer A,5,0,20,15
1745147032980,MCWP 50R,C00,893771,Krone; Jarret,0,3,20,20
1745147032980,MCWP 50R,D00,893772,Miller; Elizabeth Deen,4,0,20,16
1745147032980,MCWP 50R,E00,893775,Carter; Andrea L,0,0,20,20
1745147034006,MMW 11R,A01,892721,Herbst; Matthew,22,0,30,8
1745147034006,MMW 11R,A02,892722,Herbst; Matthew,28,0,30,2
1745147035032,MMW 12R,A01,892724,Herbst; Matthew,0,5,16,16
1745147035032,MMW 12R,A02,892725,Herbst; Matthew,0,4,16,16
1745147036060,MMW 13R,A01,892727,Staff,0,29,16,16
1745147036060,MMW 13R,A02,892728,Staff,0,28,16,16
1745147037086,SIO 295LS,A00,894015,Staff,9,0,25,16
1745147038112,SIO 295S,A00,894020,Staff,9,0,25,16
1745147039148,SIOC 290S,A01,894063,Merrifield; Mark A,23,0,25,2
1745147040174,SIOC 291S,A01,894137,Gabriel; Corey John,23,0,25,2
1745147041200,SOCI 117,A01,895339,Staff,5,0,5,0
1745147042249,WES 237B,A00,894149,Staff,20,0,20,0
1745147044330,AESE 279B,A00,891859,Staff,35,0,35,0
1745147045356,AIP 197,001,891854,Staff,70,0,70,0
1745147046383,ANTH 289S,A00,891856,Gagneux; Pascal,12,0,12,0
1745147047407,BENG 196,001,957946,Engler; Adam J.,9996,0,9999,3
1745147048433,CAT 124RS,A01,956906,Staff,8,0,25,17
1745147049459,CAT 125RS,A01,922013,Staff,8,0,25,17
1745147050485,CLRE 250,A00,891860,Morris; Sheldon,9996,0,9999,3
1745147052536,CLRE 251R,A00,907817,Mehta; Ravindra L.,9995,0,9999,4
1745147053561,CLRE 252,A00,891864,Cuomo; Raphael Eduardo,9994,0,9999,5
1745147054586,CLRE 253,A00,891867,Vaida; Florin,9995,0,9999,4
1745147054586,CLRE 253,B00,907819,Staff,9999,0,9999,0
1745147056784,CLRE 259,A00,891868,Patel; Hemal,9998,0,9999,1
1745147057812,CLRE 260,A00,891872,Cuomo; Raphael Eduardo,9999,0,9999,0
1745147058845,CLRE 297,001,891888,Cuomo; Raphael Eduardo,9999,0,9999,0
1745147059875,CSS 201S,A01,892054,Mignozzetti; Umberto,30,0,30,0
1745147060908,CSS 202S,A01,892056,Mignozzetti; Umberto,30,0,30,0
1745147061945,DSC 197,001,956898,Eldridge; Justin Matthew,9998,0,9999,1
1745147062974,DSC 297,001,958000,Mazumdar; Arya,9999,0,9999,0
1745147064002,EAP 100,A00,905686,Staff,9774,0,9999,225
1745147065028,ECE 45,A01,892618,Staff,0,2,50,50
1745147066052,ECE 109,A01,892620,Staff,0,44,0,0
1745147067085,ECE 111,A01,892719,Staff,0,0,50,50
1745147068111,ECE 197,001,957920,Mercier; Patrick Philip,9992,0,9999,7
1745147069137,ECON 178,A01,907814,Zhu; Ying,29,0,35,6
1745147070162,EDS 115,A00,895312,Staff,42,0,45,3
1745147071186,EDS 117,A01,895337,Staff,30,0,30,0
1745147072212,EDS 125,A00,895341,Jones; Gabrielle Anastasia,43,0,45,2
1745147073256,EDS 128A,A01,895459,Fargason; Sharon Gayle,45,0,45,0
1745147074286,EDS 128B,A01,895543,Pappas; Elizabeth,45,0,45,0
1745147075311,EDS 139,A00,897203,Pappas; Elizabeth,45,0,45,0
1745147075311,EDS 139,B00,897209,Fargason; Sharon Gayle,45,0,45,0
1745147076335,EDS 201,A00,895545,Staff,44,0,45,1
1745147077361,EDS 203,A01,895581,Halter; Christopher P.,44,0,45,1
1745147078386,EDS 204R,A01,895625,Heinzman; Erica M.,45,0,45,0
1745147078386,EDS 204R,B01,895693,Halter; Christopher P.,28,0,45,17
1745147079413,EDS 206R,A00,895694,Fargason; Sharon Gayle,22,0,30,8
1745147079413,EDS 206R,B00,895695,Choi; Bailey Miyeon,21,0,30,9
1745147080439,EDS 250,A00,895697,Hemans; Patricia Ann Benitez,44,0,45,1
1745147081467,EDS 281,A00,895701,Meyerott; Theresa Ann,15,0,15,0
1745147082492,EDS 284,A00,895736,Meyerott; Theresa Ann,15,0,15,0
1745147083517,EDS 286,A00,897210,Fine; Sarah,15,0,15,0
1745147084542,EDS 289C,A01,895770,Daly; Alan J.,15,0,15,0
1745147085572,EDS 290,A00,897211,Hofstetter; Carolyn,15,0,15,0
1745147086598,LIGM 5A,A00,896162,Fischer-Grunski; Eva K,16,0,20,4
1745147087625,LIGM 5B,A00,896260,Fischer-Grunski; Eva K,19,0,20,1
1745147088652,LIGM 5C,A00,896308,Fischer-Grunski; Eva K,19,0,20,1
1745147089688,LIIT 5AS,A00,896313,Carnelos; Chiara,18,0,20,2
1745147090715,LIIT 5BS,A00,896416,Carnelos; Chiara,20,0,20,0
1745147091743,LIIT 5CS,A00,896564,Carnelos; Chiara,20,0,20,0
1745147092769,LISP 5A,A00,896588,Munoz Sanchez; Alicia,7,0,20,13
1745147093794,LISP 5B,A00,896653,Munoz Sanchez; Alicia,10,0,20,10
1745147094821,LISP 5C,A00,896655,Munoz Sanchez; Alicia,9,0,20,11
1745147095846,MAE 197,001,957918,Kleissl; Jan,9998,0,9999,1
1745147096871,MATH 2,A01,957937,Staff,34,0,35,1
1745147097895,MATH 197,001,957876,Kedlaya; Kiran S.,9996,0,9999,3
1745147098922,MCWP 40,A00,892729,Duru; Nur,15,0,20,5
1745147098922,MCWP 40,B00,893304,Montejo; Carolina,20,0,20,0
1745147099948,MCWP 40R,A00,893757,Redela; Pamela Morgan,0,3,20,20
1745147100976,MCWP 50,A00,893758,Morshed; Michael James,4,0,20,16
1745147100976,MCWP 50,B00,893761,Bartulis; Jason Michael,18,0,20,2
1745147102012,MCWP 50R,A00,893766,Compas; Sean Matthew,0,1,20,20
1745147102012,MCWP 50R,B00,893769,Carter; Jennifer A,5,0,20,15
1745147102012,MCWP 50R,C00,893771,Krone; Jarret,0,3,20,20
1745147102012,MCWP 50R,D00,893772,Miller; Elizabeth Deen,4,0,20,16
1745147102012,MCWP 50R,E00,893775,Carter; Andrea L,0,0,20,20
1745147103038,MMW 11R,A01,892721,Herbst; Matthew,22,0,30,8
1745147103038,MMW 11R,A02,892722,Herbst; Matthew,28,0,30,2
1745147104066,MMW 12R,A01,892724,Herbst; Matthew,0,5,16,16
1745147104066,MMW 12R,A02,892725,Herbst; Matthew,0,4,16,16
1745147105095,MMW 13R,A01,892727,Staff,0,29,16,16
1745147105095,MMW 13R,A02,892728,Staff,0,28,16,16
1745147106122,SIO 295LS,A00,894015,Staff,9,0,25,16
1745147107147,SIO 295S,A00,894020,Staff,9,0,25,16
1745147108173,SIOC 290S,A01,894063,Merrifield; Mark A,23,0,25,2
1745147109205,SIOC 291S,A01,894137,Gabriel; Corey John,23,0,25,2
1745147110230,SOCI 117,A01,895339,Staff,5,0,5,0
1745147111256,WES 237B,A00,894149,Staff,20,0,20,0
1745147113351,AESE 279B,A00,891859,Staff,35,0,35,0
1745147114377,AIP 197,001,891854,Staff,70,0,70,0
1745147115407,ANTH 289S,A00,891856,Gagneux; Pascal,12,0,12,0
1745147116434,BENG 196,001,957946,Engler; Adam J.,9996,0,9999,3
1745147117462,CAT 124RS,A01,956906,Staff,8,0,25,17
1745147118488,CAT 125RS,A01,922013,Staff,8,0,25,17
1745147119515,CLRE 250,A00,891860,Morris; Sheldon,9996,0,9999,3
1745147121566,CLRE 251R,A00,907817,Mehta; Ravindra L.,9995,0,9999,4
1745147122596,CLRE 252,A00,891864,Cuomo; Raphael Eduardo,9994,0,9999,5
1745147123621,CLRE 253,A00,891867,Vaida; Florin,9995,0,9999,4
1745147123621,CLRE 253,B00,907819,Staff,9999,0,9999,0
1745147124652,CLRE 259,A00,891868,Patel; Hemal,9998,0,9999,1
1745147125677,CLRE 260,A00,891872,Cuomo; Raphael Eduardo,9999,0,9999,0
1745147126702,CLRE 297,001,891888,Cuomo; Raphael Eduardo,9999,0,9999,0
1745147127732,CSS 201S,A01,892054,Mignozzetti; Umberto,30,0,30,0
1745147128759,CSS 202S,A01,892056,Mignozzetti; Umberto,30,0,30,0
1745147129785,DSC 197,001,956898,Eldridge; Justin Matthew,9998,0,9999,1
1745147130811,DSC 297,001,958000,Mazumdar; Arya,9999,0,9999,0
1745147131837,EAP 100,A00,905686,Staff,9774,0,9999,225
1745147132866,ECE 45,A01,892618,Staff,0,2,50,50
1745147133895,ECE 109,A01,892620,Staff,0,44,0,0
1745147134923,ECE 111,A01,892719,Staff,0,0,50,50
1745147135953,ECE 197,001,957920,Mercier; Patrick Philip,9992,0,9999,7
1745147136979,ECON 178,A01,907814,Zhu; Ying,29,0,35,6
1745147138005,EDS 115,A00,895312,Staff,42,0,45,3
1745147139033,EDS 117,A01,895337,Staff,30,0,30,0
1745147140058,EDS 125,A00,895341,Jones; Gabrielle Anastasia,43,0,45,2
1745147141088,EDS 128A,A01,895459,Fargason; Sharon Gayle,45,0,45,0
1745147142115,EDS 128B,A01,895543,Pappas; Elizabeth,45,0,45,0
1745147143141,EDS 139,A00,897203,Pappas; Elizabeth,45,0,45,0
1745147143141,EDS 139,B00,897209,Fargason; Sharon Gayle,45,0,45,0
1745147144166,EDS 201,A00,895545,Staff,44,0,45,1
1745147145194,EDS 203,A01,895581,Halter; Christopher P.,44,0,45,1
1745147146221,EDS 204R,A01,895625,Heinzman; Erica M.,45,0,45,0
1745147146221,EDS 204R,B01,895693,Halter; Christopher P.,28,0,45,17
1745147147250,EDS 206R,A00,895694,Fargason; Sharon Gayle,22,0,30,8
1745147147250,EDS 206R,B00,895695,Choi; Bailey Miyeon,21,0,30,9
1745147148281,EDS 250,A00,895697,Hemans; Patricia Ann Benitez,44,0,45,1
1745147149307,EDS 281,A00,895701,Meyerott; Theresa Ann,15,0,15,0
1745147150337,EDS 284,A00,895736,Meyerott; Theresa Ann,15,0,15,0
1745147151368,EDS 286,A00,897210,Fine; Sarah,15,0,15,0
1745147152399,EDS 289C,A01,895770,Daly; Alan J.,15,0,15,0
1745147153426,EDS 290,A00,897211,Hofstetter; Carolyn,15,0,15,0
1745147154461,LIGM 5A,A00,896162,Fischer-Grunski; Eva K,16,0,20,4
1745147155486,LIGM 5B,A00,896260,Fischer-Grunski; Eva K,19,0,20,1
1745147156532,LIGM 5C,A00,896308,Fischer-Grunski; Eva K,19,0,20,1
1745147157565,LIIT 5AS,A00,896313,Carnelos; Chiara,18,0,20,2
1745147158589,LIIT 5BS,A00,896416,Carnelos; Chiara,20,0,20,0
1745147159623,LIIT 5CS,A00,896564,Carnelos; Chiara,20,0,20,0
1745147160649,LISP 5A,A00,896588,Munoz Sanchez; Alicia,7,0,20,13
1745147161674,LISP 5B,A00,896653,Munoz Sanchez; Alicia,10,0,20,10
1745147162704,LISP 5C,A00,896655,Munoz Sanchez; Alicia,9,0,20,11
1745147163730,MAE 197,001,957918,Kleissl; Jan,9998,0,9999,1
1745147164762,MATH 2,A01,957937,Staff,34,0,35,1
1745147165791,MATH 197,001,957876,Kedlaya; Kiran S.,9996,0,9999,3
1745147166831,MCWP 40,A00,892729,Duru; Nur,15,0,20,5
1745147166831,MCWP 40,B00,893304,Montejo; Carolina,20,0,20,0
1745147167867,MCWP 40R,A00,893757,Redela; Pamela Morgan,0,3,20,20
1745147168894,MCWP 50,A00,893758,Morshed; Michael James,4,0,20,16
1745147168894,MCWP 50,B00,893761,Bartulis; Jason Michael,18,0,20,2
1745147169933,MCWP 50R,A00,893766,Compas; Sean Matthew,0,1,20,20
1745147169933,MCWP 50R,B00,893769,Carter; Jennifer A,5,0,20,15
1745147169933,MCWP 50R,C00,893771,Krone; Jarret,0,3,20,20
1745147169933,MCWP 50R,D00,893772,Miller; Elizabeth Deen,4,0,20,16
1745147169933,MCWP 50R,E00,893775,Carter; Andrea L,0,0,20,20
1745147170961,MMW 11R,A01,892721,Herbst; Matthew,22,0,30,8
1745147170961,MMW 11R,A02,892722,Herbst; Matthew,28,0,30,2
1745147171991,MMW 12R,A01,892724,Herbst; Matthew,0,5,16,16
1745147171991,MMW 12R,A02,892725,Herbst; Matthew,0,4,16,16
1745147173017,MMW 13R,A01,892727,Staff,0,29,16,16
1745147173017,MMW 13R,A02,892728,Staff,0,28,16,16
1745147174043,SIO 295LS,A00,894015,Staff,9,0,25,16
1745147175068,SIO 295S,A00,894020,Staff,9,0,25,16
1745147176106,SIOC 290S,A01,894063,Merrifield; Mark A,23,0,25,2
1745147177135,SIOC 291S,A01,894137,Gabriel; Corey John,23,0,25,2
1745147178161,SOCI 117,A01,895339,Staff,5,0,5,0
1745147179194,WES 237B,A00,894149,Staff,20,0,20,0
1745147181297,AESE 279B,A00,891859,Staff,35,0,35,0
1745147182323,AIP 197,001,891854,Staff,70,0,70,0
1745147183350,ANTH 289S,A00,891856,Gagneux; Pascal,12,0,12,0
1745147184391,BENG 196,001,957946,Engler; Adam J.,9996,0,9999,3
1745147185415,CAT 124RS,A01,956906,Staff,8,0,25,17
1745147186450,CAT 125RS,A01,922013,Staff,8,0,25,17
1745147187484,CLRE 250,A00,891860,Morris; Sheldon,9996,0,9999,3
1745147189536,CLRE 251R,A00,907817,Mehta; Ravindra L.,9995,0,9999,4
1745147190560,CLRE 252,A00,891864,Cuomo; Raphael Eduardo,9994,0,9999,5
1745147191587,CLRE 253,A00,891867,Vaida; Florin,9995,0,9999,4
1745147191587,CLRE 253,B00,907819,Staff,9999,0,9999,0
1745147192612,CLRE 259,A00,891868,Patel; Hemal,9998,0,9999,1
1745147193638,CLRE 260,A00,891872,Cuomo; Raphael Eduardo,9999,0,9999,0
1745147194664,CLRE 297,001,891888,Cuomo; Raphael Eduardo,9999,0,9999,0
1745147195693,CSS 201S,A01,892054,Mignozzetti; Umberto,30,0,30,0
1745147196721,CSS 202S,A01,892056,Mignozzetti; Umberto,30,0,30,0
1745147197755,DSC 197,001,956898,Eldridge; Justin Matthew,9998,0,9999,1
1745147198779,DSC 297,001,958000,Mazumdar; Arya,9999,0,9999,0
1745147199806,EAP 100,A00,905686,Staff,9774,0,9999,225
1745147200832,ECE 45,A01,892618,Staff,0,2,50,50
1745147201859,ECE 109,A01,892620,Staff,0,44,0,0
1745147202886,ECE 111,A01,892719,Staff,0,0,50,50
1745147203913,ECE 197,001,957920,Mercier; Patrick Philip,9992,0,9999,7
1745147204939,ECON 178,A01,907814,Zhu; Ying,29,0,35,6
1745147205965,EDS 115,A00,895312,Staff,42,0,45,3
1745147206991,EDS 117,A01,895337,Staff,30,0,30,0
1745147208017,EDS 125,A00,895341,Jones; Gabrielle Anastasia,43,0,45,2
1745147209043,EDS 128A,A01,895459,Fargason; Sharon Gayle,45,0,45,0
1745147210069,EDS 128B,A01,895543,Pappas; Elizabeth,45,0,45,0
1745147211094,EDS 139,A00,897203,Pappas; Elizabeth,45,0,45,0
1745147211094,EDS 139,B00,897209,Fargason; Sharon Gayle,45,0,45,0
1745147212119,EDS 201,A00,895545,Staff,44,0,45,1
1745147213152,EDS 203,A01,895581,Halter; Christopher P.,44,0,45,1
1745147214221,EDS 204R,A01,895625,Heinzman; Erica M.,45,0,45,0
1745147214221,EDS 204R,B01,895693,Halter; Christopher P.,28,0,45,17
1745147215254,EDS 206R,A00,895694,Fargason; Sharon Gayle,22,0,30,8
1745147215254,EDS 206R,B00,895695,Choi; Bailey Miyeon,21,0,30,9
1745147216281,EDS 250,A00,895697,Hemans; Patricia Ann Benitez,44,0,45,1
1745147217308,EDS 281,A00,895701,Meyerott; Theresa Ann,15,0,15,0
1745147218334,EDS 284,A00,895736,Meyerott; Theresa Ann,15,0,15,0
1745147219361,EDS 286,A00,897210,Fine; Sarah,15,0,15,0
1745147220394,EDS 289C,A01,895770,Daly; Alan J.,15,0,15,0
1745147221427,EDS 290,A00,897211,Hofstetter; Carolyn,15,0,15,0
1745147222456,LIGM 5A,A00,896162,Fischer-Grunski; Eva K,16,0,20,4
1745147223486,LIGM 5B,A00,896260,Fischer-Grunski; Eva K,19,0,20,1
1745147224512,LIGM 5C,A00,896308,Fischer-Grunski; Eva K,19,0,20,1
1745147225539,LIIT 5AS,A00,896313,Carnelos; Chiara,18,0,20,2
1745147226563,LIIT 5BS,A00,896416,Carnelos; Chiara,20,0,20,0
1745147227590,LIIT 5CS,A00,896564,Carnelos; Chiara,20,0,20,0
1745147228616,LISP 5A,A00,896588,Munoz Sanchez; Alicia,7,0,20,13
1745147229642,LISP 5B,A00,896653,Munoz Sanchez; Alicia,10,0,20,10
1745147230668,LISP 5C,A00,896655,Munoz Sanchez; Alicia,9,0,20,11
1745147231698,MAE 197,001,957918,Kleissl; Jan,9998,0,9999,1
1745147232723,MATH 2,A01,957937,Staff,34,0,35,1
1745147233758,MATH 197,001,957876,Kedlaya; Kiran S.,9996,0,9999,3
1745147234798,MCWP 40,A00,892729,Duru; Nur,15,0,20,5
1745147234798,MCWP 40,B00,893304,Montejo; Carolina,20,0,20,0
1745147235832,MCWP 40R,A00,893757,Redela; Pamela Morgan,0,3,20,20
1745147236857,MCWP 50,A00,893758,Morshed; Michael James,4,0,20,16
1745147236857,MCWP 50,B00,893761,Bartulis; Jason Michael,18,0,20,2
1745147237884,MCWP 50R,A00,893766,Compas; Sean Matthew,0,1,20,20
1745147237884,MCWP 50R,B00,893769,Carter; Jennifer A,5,0,20,15
1745147237884,MCWP 50R,C00,893771,Krone; Jarret,0,3,20,20
1745147237884,MCWP 50R,D00,893772,Miller; Elizabeth Deen,4,0,20,16
1745147237884,MCWP 50R,E00,893775,Carter; Andrea L,0,0,20,20
1745147238910,MMW 11R,A01,892721,Herbst; Matthew,22,0,30,8
1745147238910,MMW 11R,A02,892722,Herbst; Matthew,28,0,30,2
1745147239937,MMW 12R,A01,892724,Herbst; Matthew,0,5,16,16
1745147239937,MMW 12R,A02,892725,Herbst; Matthew,0,4,16,16
1745147240962,MMW 13R,A01,892727,Staff,0,29,16,16
1745147240962,MMW 13R,A02,892728,Staff,0,28,16,16
1745147241987,SIO 295LS,A00,894015,Staff,9,0,25,16
1745147243014,SIO 295S,A00,894020,Staff,9,0,25,16
1745147244039,SIOC 290S,A01,894063,Merrifield; Mark A,23,0,25,2
1745147245072,SIOC 291S,A01,894137,Gabriel; Corey John,23,0,25,2
1745147246099,SOCI 117,A01,895339,Staff,5,0,5,0
1745147247128,WES 237B,A00,894149,Staff,20,0,20,0
1745147249227,AESE 279B,A00,891859,Staff,35,0,35,0
1745147250260,AIP 197,001,891854,Staff,70,0,70,0
1745147251291,ANTH 289S,A00,891856,Gagneux; Pascal,12,0,12,0
1745147252324,BENG 196,001,957946,Engler; Adam J.,9996,0,9999,3
1745147253349,CAT 124RS,A01,956906,Staff,8,0,25,17
1745147254381,CAT 125RS,A01,922013,Staff,8,0,25,17
1745147255407,CLRE 250,A00,891860,Morris; Sheldon,9996,0,9999,3
1745147257461,CLRE 251R,A00,907817,Mehta; Ravindra L.,9995,0,9999,4
1745147258487,CLRE 252,A00,891864,Cuomo; Raphael Eduardo,9994,0,9999,5
1745147259522,CLRE 253,A00,891867,Vaida; Florin,9995,0,9999,4
1745147259522,CLRE 253,B00,907819,Staff,9999,0,9999,0
1745147260548,CLRE 259,A00,891868,Patel; Hemal,9998,0,9999,1
1745147261579,CLRE 260,A00,891872,Cuomo; Raphael Eduardo,9999,0,9999,0
1745147262604,CLRE 297,001,891888,Cuomo; Raphael Eduardo,9999,0,9999,0
1745147263644,CSS 201S,A01,892054,Mignozzetti; Umberto,30,0,30,0
1745147264691,CSS 202S,A01,892056,Mignozzetti; Umberto,30,0,30,0
1745147265717,DSC 197,001,956898,Eldridge; Justin Matthew,9998,0,9999,1
1745147266749,DSC 297,001,958000,Mazumdar; Arya,9999,0,9999,0
1745147267775,EAP 100,A00,905686,Staff,9774,0,9999,225
1745147268801,ECE 45,A01,892618,Staff,0,2,50,50
1745147269828,ECE 109,A01,892620,Staff,0,44,0,0
1745147270861,ECE 111,A01,892719,Staff,0,0,50,50
1745147271894,ECE 197,001,957920,Mercier; Patrick Philip,9992,0,9999,7
1745147272921,ECON 178,A01,907814,Zhu; Ying,29,0,35,6
1745147273949,EDS 115,A00,895312,Staff,42,0,45,3
1745147274975,EDS 117,A01,895337,Staff,30,0,30,0
1745147276002,EDS 125,A00,895341,Jones; Gabrielle Anastasia,43,0,45,2
1745147277039,EDS 128A,A01,895459,Fargason; Sharon Gayle,45,0,45,0
1745147278064,EDS 128B,A01,895543,Pappas; Elizabeth,45,0,45,0
1745147279096,EDS 139,A00,897203,Pappas; Elizabeth,45,0,45,0
1745147279096,EDS 139,B00,897209,Fargason; Sharon Gayle,45,0,45,0
1745147280127,EDS 201,A00,895545,Staff,44,0,45,1
1745147281161,EDS 203,A01,895581,Halter; Christopher P.,44,0,45,1
1745147282239,EDS 204R,A01,895625,Heinzman; Erica M.,45,0,45,0
1745147282239,EDS 204R,B01,895693,Halter; Christopher P.,28,0,45,17
1745147283265,EDS 206R,A00,895694,Fargason; Sharon Gayle,22,0,30,8
1745147283265,EDS 206R,B00,895695,Choi; Bailey Miyeon,21,0,30,9
1745147284300,EDS 250,A00,895697,Hemans; Patricia Ann Benitez,44,0,45,1
1745147285331,EDS 281,A00,895701,Meyerott; Theresa Ann,15,0,15,0
1745147286364,EDS 284,A00,895736,Meyerott; Theresa Ann,15,0,15,0
1745147287398,EDS 286,A00,897210,Fine; Sarah,15,0,15,0
